reg;jour;P_f;P_h;P;pop_f;pop_h;cl_age90;pop
01;2020-05-13;0;0;0;19979;20155;09;40134
01;2020-05-13;0;0;0;24994;25489;19;50483
01;2020-05-13;0;0;0;17868;16690;29;34558
01;2020-05-13;0;0;0;22328;14821;39;37149
01;2020-05-13;0;0;0;28652;20276;49;48928
01;2020-05-13;0;0;0;33264;27260;59;60524
01;2020-05-13;0;0;0;27135;23978;69;51113
01;2020-05-13;0;0;0;18401;14661;79;33062
01;2020-05-13;0;0;0;9633;6375;89;16008
01;2020-05-13;0;0;0;3410;1510;90;4920
01;2020-05-13;0;0;0;205664;171215;0;376879
02;2020-05-13;0;0;0;16881;17110;09;33991
02;2020-05-13;0;0;0;21410;21604;19;43014
02;2020-05-13;0;0;0;16017;15479;29;31496
02;2020-05-13;0;0;0;19825;14455;39;34280
02;2020-05-13;1;0;1;24719;18248;49;42967
02;2020-05-13;0;2;2;34361;28310;59;62671
02;2020-05-13;1;0;1;28061;24495;69;52556
02;2020-05-13;0;0;0;18231;15278;79;33509
02;2020-05-13;0;0;0;11090;7677;89;18767
02;2020-05-13;0;0;0;3992;1506;90;5498
02;2020-05-13;2;2;4;194587;164162;0;358749
03;2020-05-13;0;0;0;31123;30920;09;62043
03;2020-05-13;0;0;0;29370;29268;19;58638
03;2020-05-13;0;0;0;21458;18963;29;40421
03;2020-05-13;0;0;0;21276;18326;39;39602
03;2020-05-13;0;0;0;18164;16593;49;34757
03;2020-05-13;0;0;0;13469;13557;59;27026
03;2020-05-13;0;0;0;8776;8670;69;17446
03;2020-05-13;0;0;0;3777;3591;79;7368
03;2020-05-13;0;0;0;1649;1072;89;2721
03;2020-05-13;0;0;0;485;184;90;669
03;2020-05-13;0;0;0;149547;141144;0;290691
04;2020-05-13;0;0;0;60314;61377;09;121691
04;2020-05-13;0;0;0;66065;68387;19;134452
04;2020-05-13;1;0;1;51059;47156;29;98215
04;2020-05-13;0;0;0;58788;45780;39;104568
04;2020-05-13;0;0;0;61408;52207;49;113615
04;2020-05-13;0;0;0;64838;60759;59;125597
04;2020-05-13;0;0;0;47008;42843;69;89851
04;2020-05-13;0;0;0;25509;21184;79;46693
04;2020-05-13;0;0;0;13168;7647;89;20815
04;2020-05-13;0;0;0;3209;1253;90;4462
04;2020-05-13;1;0;1;451366;408593;0;859959
05;2020-05-13;0;0;0;362.366008612902;341.338819562748;09;703.704828175651
05;2020-05-13;0;0;0;353.376145114279;370.349735405642;19;723.725880519921
05;2020-05-13;0;0;0;218.593559489256;256.539602589476;29;475.133162078732
05;2020-05-13;0;0;0;404.225408693299;360.321910454353;39;764.547319147651
05;2020-05-13;0;0;0;520.067953604221;497.108383964256;49;1017.17633756848
05;2020-05-13;0;0;0;468.146063921917;510.087601910415;59;978.233665832332
05;2020-05-13;0;0;0;340.368470050554;334.366842191253;69;674.735312241807
05;2020-05-13;0;0;0;212.598666888387;192.597753227106;79;405.196420115493
05;2020-05-13;0;0;0;148.727797095705;61.8681715431829;89;210.595968638888
05;2020-05-13;0;0;0;32.9601271090696;10.9909785719784;90;43.9511056810479
05;2020-05-13;0;0;0;3061.43020057959;2935.56979942041;0;5997
06;2020-05-13;0;0;0;42583;42380;09;84963
06;2020-05-13;1;0;1;33369;31925;19;65294
06;2020-05-13;1;1;2;21571;15080;29;36651
06;2020-05-13;0;1;1;21550;16147;39;37697
06;2020-05-13;0;1;1;14193;13939;49;28132
06;2020-05-13;0;3;3;7171;7597;59;14768
06;2020-05-13;0;1;1;3629;4117;69;7746
06;2020-05-13;0;0;0;1577;1457;79;3034
06;2020-05-13;0;0;0;531;474;89;1005
06;2020-05-13;0;0;0;88;93;90;181
06;2020-05-13;2;7;9;146262;133209;0;279471
07;2020-05-13;0;0;0;485;549;09;1034
07;2020-05-13;0;0;0;403;432;19;835
07;2020-05-13;0;0;0;764;841;29;1605
07;2020-05-13;0;0;0;824;928;39;1752
07;2020-05-13;0;0;0;788;1020;49;1808
07;2020-05-13;0;0;0;678;870;59;1548
07;2020-05-13;0;0;0;360;382;69;742
07;2020-05-13;0;0;0;231;190;79;421
07;2020-05-13;0;0;0;114;67;89;181
07;2020-05-13;0;0;0;24;11;90;35
07;2020-05-13;0;0;0;4671;5290;0;9961
08;2020-05-13;0;0;0;2715.22592983026;2997.75551488675;09;5712.98144471701
08;2020-05-13;0;0;0;2778.51901080978;3160.9156459093;19;5939.43465671908
08;2020-05-13;0;0;0;2080.8882988764;1718.16634315323;29;3799.05464202964
08;2020-05-13;0;0;0;2701.8582062647;1896.52641413317;39;4598.38462039786
08;2020-05-13;0;0;0;3151.45861023308;2460.52498233809;49;5611.98359257117
08;2020-05-13;0;0;0;2620.29868333099;2422.23566154656;59;5042.53434487755
08;2020-05-13;0;0;0;1621.44173420671;1438.58325779464;69;3060.02499200135
08;2020-05-13;0;0;0;626.575909335673;526.358467843651;79;1152.93437717932
08;2020-05-13;0;0;0;205.018522985054;140.993639349697;89;346.012162334751
08;2020-05-13;0;0;0;50.0325684687745;20.62259870351;90;70.6551671722846
08;2020-05-13;0;0;0;18551.3174743414;16782.6825256586;0;35334
11;2020-05-13;2;3;5;783071;811785;09;1594856
11;2020-05-13;5;3;8;761456;784653;19;1546109
11;2020-05-13;18;11;29;850145;801772;29;1651917
11;2020-05-13;20;14;34;914360;843488;39;1757848
11;2020-05-13;21;14;35;845609;826202;49;1671811
11;2020-05-13;15;20;35;793566;745070;59;1538636
11;2020-05-13;12;23;37;628649;549192;69;1177841
11;2020-05-13;9;17;26;434606;358356;79;792962
11;2020-05-13;24;9;33;261425;162933;89;424358
11;2020-05-13;36;5;41;89253;32619;90;121872
11;2020-05-13;162;119;283;6362140;5916070;0;12278210
24;2020-05-13;0;0;0;139720;144686;09;284406
24;2020-05-13;1;0;1;152979;161185;19;314164
24;2020-05-13;4;1;5;122237;126536;29;248773
24;2020-05-13;3;2;5;150359;142009;39;292368
24;2020-05-13;2;1;3;161829;158758;49;320587
24;2020-05-13;2;2;4;172552;168011;59;340563
24;2020-05-13;3;0;3;172509;158177;69;330686
24;2020-05-13;0;3;3;129428;110593;79;240021
24;2020-05-13;0;3;3;87342;56882;89;144224
24;2020-05-13;3;0;3;31210;12071;90;43281
24;2020-05-13;18;12;30;1320165;1238908;0;2559073
27;2020-05-13;0;0;0;143373;149679;09;293052
27;2020-05-13;1;0;1;160962;173003;19;333965
27;2020-05-13;0;1;1;133746;142254;29;276000
27;2020-05-13;1;0;1;160004;155407;39;315411
27;2020-05-13;1;2;3;172333;169564;49;341897
27;2020-05-13;0;0;0;189979;183788;59;373767
27;2020-05-13;1;2;3;192591;178206;69;370797
27;2020-05-13;4;1;5;146876;127546;79;274422
27;2020-05-13;2;0;2;96896;61575;89;158471
27;2020-05-13;0;3;3;33148;12109;90;45257
27;2020-05-13;11;9;20;1429908;1353131;0;2783039
28;2020-05-13;0;0;0;180735;186856;09;367591
28;2020-05-13;2;1;3;200125;213621;19;413746
28;2020-05-13;1;4;5;168922;173007;29;341929
28;2020-05-13;1;1;2;196628;188487;39;385115
28;2020-05-13;2;1;3;205396;201699;49;407095
28;2020-05-13;3;4;7;222002;213866;59;435868
28;2020-05-13;0;0;0;224688;203758;69;428446
28;2020-05-13;1;1;2;163192;135543;79;298735
28;2020-05-13;3;2;5;109691;65377;89;175068
28;2020-05-13;7;2;9;37222;12685;90;49907
28;2020-05-13;21;16;37;1708601;1594899;0;3303500
32;2020-05-13;0;0;0;358062;373689;09;731751
32;2020-05-13;2;0;2;387045;406742;19;793787
32;2020-05-13;4;0;4;342304;348587;29;690891
32;2020-05-13;9;4;13;382485;369972;39;752457
32;2020-05-13;1;8;9;382510;376716;49;759226
32;2020-05-13;1;4;5;386937;376527;59;763464
32;2020-05-13;6;9;15;371211;330938;69;702149
32;2020-05-13;4;5;9;250542;201459;79;452001
32;2020-05-13;7;5;12;163399;89786;89;253185
32;2020-05-13;5;3;8;48384;15367;90;63751
32;2020-05-13;41;39;80;3072879;2889783;0;5962662
44;2020-05-13;2;2;4;291525;306839;09;598364
44;2020-05-13;4;2;6;320255;339504;19;659759
44;2020-05-13;9;6;15;302020;314428;29;616448
44;2020-05-13;13;7;20;342222;333292;39;675514
44;2020-05-13;10;2;12;349727;344491;49;694218
44;2020-05-13;17;9;26;381371;373239;59;754610
44;2020-05-13;7;10;17;367165;335850;69;703015
44;2020-05-13;4;7;11;250387;215436;79;465823
44;2020-05-13;19;8;27;170825;105192;89;276017
44;2020-05-13;9;4;13;51248;16731;90;67979
44;2020-05-13;94;57;151;2826745;2685002;0;5511747
52;2020-05-13;0;0;0;213594;223900;09;437494
52;2020-05-13;0;0;0;240818;255197;19;496015
52;2020-05-13;3;0;3;197010;200630;29;397640
52;2020-05-13;1;0;1;231204;224885;39;456089
52;2020-05-13;4;0;4;243874;243418;49;487292
52;2020-05-13;1;0;1;244100;239116;59;483216
52;2020-05-13;1;1;2;241796;221345;69;463141
52;2020-05-13;2;1;3;177805;149903;79;327708
52;2020-05-13;5;1;6;119561;75822;89;195383
52;2020-05-13;2;0;2;42559;15260;90;57819
52;2020-05-13;19;3;22;1952321;1849476;0;3801797
53;2020-05-13;2;0;2;173813;182358;09;356171
53;2020-05-13;1;0;1;202720;214740;19;417460
53;2020-05-13;0;0;0;163116;173196;29;336312
53;2020-05-13;1;1;2;190526;187674;39;378200
53;2020-05-13;0;1;1;212098;212015;49;424113
53;2020-05-13;2;0;2;223699;219176;59;442875
53;2020-05-13;0;1;1;227435;209274;69;436709
53;2020-05-13;0;0;0;169992;140910;79;310902
53;2020-05-13;1;0;1;118117;69883;89;188000
53;2020-05-13;0;0;0;37370;12267;90;49637
53;2020-05-13;7;3;10;1718886;1621493;0;3340379
75;2020-05-13;0;0;0;293104;305291;09;598395
75;2020-05-13;1;0;1;337141;357785;19;694926
75;2020-05-13;6;4;10;295024;300618;29;595642
75;2020-05-13;2;3;5;347871;331233;39;679104
75;2020-05-13;8;3;11;384742;372771;49;757513
75;2020-05-13;5;0;5;413361;390880;59;804241
75;2020-05-13;1;0;1;425623;384060;69;809683
75;2020-05-13;1;0;1;325086;276298;79;601384
75;2020-05-13;0;2;2;213986;139308;89;353294
75;2020-05-13;2;0;2;77600;28200;90;105800
75;2020-05-13;26;12;38;3113538;2886444;0;5999982
76;2020-05-13;0;0;0;305956;318589;09;624545
76;2020-05-13;0;0;0;338942;356969;19;695911
76;2020-05-13;4;8;12;316210;319570;29;635780
76;2020-05-13;2;4;6;356758;337587;39;694345
76;2020-05-13;5;2;7;376541;363812;49;740353
76;2020-05-13;5;1;6;402608;383750;59;786358
76;2020-05-13;0;1;1;394889;358997;69;753886
76;2020-05-13;2;3;5;308664;263806;79;572470
76;2020-05-13;7;0;7;195838;129272;89;325110
76;2020-05-13;10;2;12;69372;26728;90;96100
76;2020-05-13;35;22;57;3065778;2859080;0;5924858
84;2020-05-13;0;0;0;459549;481088;09;940637
84;2020-05-13;3;0;3;487711;511905;19;999616
84;2020-05-13;5;1;6;443824;451094;29;894918
84;2020-05-13;2;1;3;512522;493262;39;1005784
84;2020-05-13;4;2;6;520248;515106;49;1035354
84;2020-05-13;5;4;9;529611;514848;59;1044459
84;2020-05-13;2;2;4;486720;439940;69;926660
84;2020-05-13;4;4;8;372151;315211;79;687362
84;2020-05-13;5;2;7;237198;150524;89;387722
84;2020-05-13;8;2;10;81185;28680;90;109865
84;2020-05-13;39;18;57;4130719;3901658;0;8032377
93;2020-05-13;1;1;2;268834;283093;09;551927
93;2020-05-13;0;1;1;280751;296087;19;576838
93;2020-05-13;6;3;9;254404;255552;29;509956
93;2020-05-13;6;3;9;310704;288398;39;599102
93;2020-05-13;3;4;7;325559;305827;49;631386
93;2020-05-13;7;3;10;353104;325389;59;678493
93;2020-05-13;2;4;6;336327;296459;69;632786
93;2020-05-13;8;7;15;279820;229699;79;509519
93;2020-05-13;8;8;16;171274;113716;89;284990
93;2020-05-13;6;5;11;58896;21758;90;80654
93;2020-05-13;48;39;87;2639673;2415978;0;5055651
94;2020-05-13;0;0;0;16311;17433;09;33744
94;2020-05-13;0;0;0;16679;18132;19;34811
94;2020-05-13;1;0;1;16782;16579;29;33361
94;2020-05-13;2;2;4;23044;20580;39;43624
94;2020-05-13;0;0;0;23065;22140;49;45205
94;2020-05-13;0;0;0;24549;23421;59;47970
94;2020-05-13;0;1;1;23212;21883;69;45095
94;2020-05-13;0;0;0;19544;17141;79;36685
94;2020-05-13;0;0;0;11227;8178;89;19405
94;2020-05-13;0;0;0;3332;1447;90;4779
94;2020-05-13;3;3;6;177745;166934;0;344679
01;2020-05-14;0;0;0;19979;20155;09;40134
01;2020-05-14;0;0;0;24994;25489;19;50483
01;2020-05-14;0;0;0;17868;16690;29;34558
01;2020-05-14;0;0;0;22328;14821;39;37149
01;2020-05-14;0;0;0;28652;20276;49;48928
01;2020-05-14;0;0;0;33264;27260;59;60524
01;2020-05-14;0;0;0;27135;23978;69;51113
01;2020-05-14;0;0;0;18401;14661;79;33062
01;2020-05-14;0;0;0;9633;6375;89;16008
01;2020-05-14;0;0;0;3410;1510;90;4920
01;2020-05-14;0;0;0;205664;171215;0;376879
02;2020-05-14;0;0;4;16881;17110;09;33991
02;2020-05-14;0;0;0;21410;21604;19;43014
02;2020-05-14;0;0;0;16017;15479;29;31496
02;2020-05-14;0;0;0;19825;14455;39;34280
02;2020-05-14;0;0;0;24719;18248;49;42967
02;2020-05-14;0;0;0;34361;28310;59;62671
02;2020-05-14;0;0;0;28061;24495;69;52556
02;2020-05-14;0;0;0;18231;15278;79;33509
02;2020-05-14;0;0;0;11090;7677;89;18767
02;2020-05-14;0;0;0;3992;1506;90;5498
02;2020-05-14;0;0;4;194587;164162;0;358749
03;2020-05-14;0;0;0;31123;30920;09;62043
03;2020-05-14;0;0;0;29370;29268;19;58638
03;2020-05-14;0;0;0;21458;18963;29;40421
03;2020-05-14;0;0;0;21276;18326;39;39602
03;2020-05-14;0;0;0;18164;16593;49;34757
03;2020-05-14;0;0;0;13469;13557;59;27026
03;2020-05-14;0;0;0;8776;8670;69;17446
03;2020-05-14;0;0;0;3777;3591;79;7368
03;2020-05-14;0;0;0;1649;1072;89;2721
03;2020-05-14;0;0;0;485;184;90;669
03;2020-05-14;0;0;0;149547;141144;0;290691
04;2020-05-14;0;0;0;60314;61377;09;121691
04;2020-05-14;0;0;0;66065;68387;19;134452
04;2020-05-14;0;0;0;51059;47156;29;98215
04;2020-05-14;0;0;0;58788;45780;39;104568
04;2020-05-14;0;0;0;61408;52207;49;113615
04;2020-05-14;0;0;0;64838;60759;59;125597
04;2020-05-14;1;0;1;47008;42843;69;89851
04;2020-05-14;0;0;0;25509;21184;79;46693
04;2020-05-14;0;0;0;13168;7647;89;20815
04;2020-05-14;0;0;0;3209;1253;90;4462
04;2020-05-14;1;0;1;451366;408593;0;859959
05;2020-05-14;0;0;0;362.366008612902;341.338819562748;09;703.704828175651
05;2020-05-14;0;0;0;353.376145114279;370.349735405642;19;723.725880519921
05;2020-05-14;0;0;0;218.593559489256;256.539602589476;29;475.133162078732
05;2020-05-14;0;0;0;404.225408693299;360.321910454353;39;764.547319147651
05;2020-05-14;0;0;0;520.067953604221;497.108383964256;49;1017.17633756848
05;2020-05-14;0;0;0;468.146063921917;510.087601910415;59;978.233665832332
05;2020-05-14;0;0;0;340.368470050554;334.366842191253;69;674.735312241807
05;2020-05-14;0;0;0;212.598666888387;192.597753227106;79;405.196420115493
05;2020-05-14;0;0;0;148.727797095705;61.8681715431829;89;210.595968638888
05;2020-05-14;0;0;0;32.9601271090696;10.9909785719784;90;43.9511056810479
05;2020-05-14;0;0;0;3061.43020057959;2935.56979942041;0;5997
06;2020-05-14;0;0;0;42583;42380;09;84963
06;2020-05-14;0;0;0;33369;31925;19;65294
06;2020-05-14;1;0;1;21571;15080;29;36651
06;2020-05-14;2;0;2;21550;16147;39;37697
06;2020-05-14;2;1;3;14193;13939;49;28132
06;2020-05-14;1;1;2;7171;7597;59;14768
06;2020-05-14;1;0;1;3629;4117;69;7746
06;2020-05-14;0;0;0;1577;1457;79;3034
06;2020-05-14;0;0;0;531;474;89;1005
06;2020-05-14;0;0;0;88;93;90;181
06;2020-05-14;7;2;9;146262;133209;0;279471
07;2020-05-14;0;0;0;485;549;09;1034
07;2020-05-14;0;0;0;403;432;19;835
07;2020-05-14;0;0;0;764;841;29;1605
07;2020-05-14;0;0;0;824;928;39;1752
07;2020-05-14;0;0;0;788;1020;49;1808
07;2020-05-14;0;0;0;678;870;59;1548
07;2020-05-14;0;0;0;360;382;69;742
07;2020-05-14;0;0;0;231;190;79;421
07;2020-05-14;0;0;0;114;67;89;181
07;2020-05-14;0;0;0;24;11;90;35
07;2020-05-14;0;0;0;4671;5290;0;9961
08;2020-05-14;0;0;0;2715.22592983026;2997.75551488675;09;5712.98144471701
08;2020-05-14;0;0;0;2778.51901080978;3160.9156459093;19;5939.43465671908
08;2020-05-14;0;0;0;2080.8882988764;1718.16634315323;29;3799.05464202964
08;2020-05-14;0;0;0;2701.8582062647;1896.52641413317;39;4598.38462039786
08;2020-05-14;0;0;0;3151.45861023308;2460.52498233809;49;5611.98359257117
08;2020-05-14;0;0;0;2620.29868333099;2422.23566154656;59;5042.53434487755
08;2020-05-14;0;0;0;1621.44173420671;1438.58325779464;69;3060.02499200135
08;2020-05-14;0;0;0;626.575909335673;526.358467843651;79;1152.93437717932
08;2020-05-14;0;0;0;205.018522985054;140.993639349697;89;346.012162334751
08;2020-05-14;0;0;0;50.0325684687745;20.62259870351;90;70.6551671722846
08;2020-05-14;0;0;0;18551.3174743414;16782.6825256586;0;35334
11;2020-05-14;2;3;5;783071;811785;09;1594856
11;2020-05-14;4;9;15;761456;784653;19;1546109
11;2020-05-14;18;14;33;850145;801772;29;1651917
11;2020-05-14;26;23;49;914360;843488;39;1757848
11;2020-05-14;19;23;44;845609;826202;49;1671811
11;2020-05-14;30;13;44;793566;745070;59;1538636
11;2020-05-14;9;19;34;628649;549192;69;1177841
11;2020-05-14;9;14;23;434606;358356;79;792962
11;2020-05-14;30;14;47;261425;162933;89;424358
11;2020-05-14;27;3;30;89253;32619;90;121872
11;2020-05-14;182;136;335;6362140;5916070;0;12278210
24;2020-05-14;2;0;2;139720;144686;09;284406
24;2020-05-14;0;0;0;152979;161185;19;314164
24;2020-05-14;1;2;3;122237;126536;29;248773
24;2020-05-14;2;1;3;150359;142009;39;292368
24;2020-05-14;3;3;6;161829;158758;49;320587
24;2020-05-14;1;1;2;172552;168011;59;340563
24;2020-05-14;1;1;2;172509;158177;69;330686
24;2020-05-14;3;0;3;129428;110593;79;240021
24;2020-05-14;4;3;7;87342;56882;89;144224
24;2020-05-14;3;2;5;31210;12071;90;43281
24;2020-05-14;20;13;33;1320165;1238908;0;2559073
27;2020-05-14;1;0;1;143373;149679;09;293052
27;2020-05-14;0;2;2;160962;173003;19;333965
27;2020-05-14;0;1;1;133746;142254;29;276000
27;2020-05-14;2;4;6;160004;155407;39;315411
27;2020-05-14;1;0;1;172333;169564;49;341897
27;2020-05-14;2;0;2;189979;183788;59;373767
27;2020-05-14;0;2;2;192591;178206;69;370797
27;2020-05-14;1;2;3;146876;127546;79;274422
27;2020-05-14;3;5;8;96896;61575;89;158471
27;2020-05-14;5;1;6;33148;12109;90;45257
27;2020-05-14;16;17;33;1429908;1353131;0;2783039
28;2020-05-14;0;0;0;180735;186856;09;367591
28;2020-05-14;0;0;0;200125;213621;19;413746
28;2020-05-14;1;0;1;168922;173007;29;341929
28;2020-05-14;3;1;4;196628;188487;39;385115
28;2020-05-14;1;1;2;205396;201699;49;407095
28;2020-05-14;4;2;6;222002;213866;59;435868
28;2020-05-14;0;2;2;224688;203758;69;428446
28;2020-05-14;1;1;2;163192;135543;79;298735
28;2020-05-14;1;4;5;109691;65377;89;175068
28;2020-05-14;2;0;2;37222;12685;90;49907
28;2020-05-14;15;11;26;1708601;1594899;0;3303500
32;2020-05-14;1;0;1;358062;373689;09;731751
32;2020-05-14;1;1;2;387045;406742;19;793787
32;2020-05-14;5;3;8;342304;348587;29;690891
32;2020-05-14;4;3;7;382485;369972;39;752457
32;2020-05-14;6;4;10;382510;376716;49;759226
32;2020-05-14;11;11;22;386937;376527;59;763464
32;2020-05-14;4;3;7;371211;330938;69;702149
32;2020-05-14;3;3;6;250542;201459;79;452001
32;2020-05-14;12;3;15;163399;89786;89;253185
32;2020-05-14;14;2;16;48384;15367;90;63751
32;2020-05-14;62;35;97;3072879;2889783;0;5962662
44;2020-05-14;0;0;0;291525;306839;09;598364
44;2020-05-14;0;1;1;320255;339504;19;659759
44;2020-05-14;5;7;12;302020;314428;29;616448
44;2020-05-14;9;0;9;342222;333292;39;675514
44;2020-05-14;6;9;15;349727;344491;49;694218
44;2020-05-14;5;10;15;381371;373239;59;754610
44;2020-05-14;5;1;6;367165;335850;69;703015
44;2020-05-14;7;4;11;250387;215436;79;465823
44;2020-05-14;13;13;26;170825;105192;89;276017
44;2020-05-14;12;2;14;51248;16731;90;67979
44;2020-05-14;62;48;110;2826745;2685002;0;5511747
52;2020-05-14;0;0;0;213594;223900;09;437494
52;2020-05-14;1;0;1;240818;255197;19;496015
52;2020-05-14;3;2;5;197010;200630;29;397640
52;2020-05-14;2;1;3;231204;224885;39;456089
52;2020-05-14;2;1;3;243874;243418;49;487292
52;2020-05-14;0;1;1;244100;239116;59;483216
52;2020-05-14;1;0;1;241796;221345;69;463141
52;2020-05-14;1;2;3;177805;149903;79;327708
52;2020-05-14;4;4;8;119561;75822;89;195383
52;2020-05-14;0;0;0;42559;15260;90;57819
52;2020-05-14;14;11;25;1952321;1849476;0;3801797
53;2020-05-14;1;1;2;173813;182358;09;356171
53;2020-05-14;1;1;2;202720;214740;19;417460
53;2020-05-14;0;1;1;163116;173196;29;336312
53;2020-05-14;1;1;2;190526;187674;39;378200
53;2020-05-14;2;3;5;212098;212015;49;424113
53;2020-05-14;1;2;3;223699;219176;59;442875
53;2020-05-14;0;1;1;227435;209274;69;436709
53;2020-05-14;0;0;0;169992;140910;79;310902
53;2020-05-14;1;1;2;118117;69883;89;188000
53;2020-05-14;0;0;0;37370;12267;90;49637
53;2020-05-14;7;11;18;1718886;1621493;0;3340379
75;2020-05-14;0;0;0;293104;305291;09;598395
75;2020-05-14;1;1;2;337141;357785;19;694926
75;2020-05-14;0;0;0;295024;300618;29;595642
75;2020-05-14;2;2;4;347871;331233;39;679104
75;2020-05-14;5;1;6;384742;372771;49;757513
75;2020-05-14;2;1;3;413361;390880;59;804241
75;2020-05-14;2;0;2;425623;384060;69;809683
75;2020-05-14;2;1;3;325086;276298;79;601384
75;2020-05-14;0;0;0;213986;139308;89;353294
75;2020-05-14;2;1;3;77600;28200;90;105800
75;2020-05-14;16;7;23;3113538;2886444;0;5999982
76;2020-05-14;0;0;0;305956;318589;09;624545
76;2020-05-14;0;2;3;338942;356969;19;695911
76;2020-05-14;4;25;29;316210;319570;29;635780
76;2020-05-14;0;5;5;356758;337587;39;694345
76;2020-05-14;3;0;4;376541;363812;49;740353
76;2020-05-14;5;3;9;402608;383750;59;786358
76;2020-05-14;1;3;10;394889;358997;69;753886
76;2020-05-14;2;1;3;308664;263806;79;572470
76;2020-05-14;5;4;12;195838;129272;89;325110
76;2020-05-14;10;2;12;69372;26728;90;96100
76;2020-05-14;30;46;88;3065778;2859080;0;5924858
84;2020-05-14;0;1;1;459549;481088;09;940637
84;2020-05-14;5;5;10;487711;511905;19;999616
84;2020-05-14;9;4;13;443824;451094;29;894918
84;2020-05-14;5;5;10;512522;493262;39;1005784
84;2020-05-14;10;3;13;520248;515106;49;1035354
84;2020-05-14;4;4;8;529611;514848;59;1044459
84;2020-05-14;4;4;8;486720;439940;69;926660
84;2020-05-14;5;8;13;372151;315211;79;687362
84;2020-05-14;12;4;16;237198;150524;89;387722
84;2020-05-14;9;2;11;81185;28680;90;109865
84;2020-05-14;63;40;103;4130719;3901658;0;8032377
93;2020-05-14;1;0;2;268834;283093;09;551927
93;2020-05-14;1;3;4;280751;296087;19;576838
93;2020-05-14;6;2;8;254404;255552;29;509956
93;2020-05-14;4;4;8;310704;288398;39;599102
93;2020-05-14;5;4;9;325559;305827;49;631386
93;2020-05-14;5;4;9;353104;325389;59;678493
93;2020-05-14;4;4;8;336327;296459;69;632786
93;2020-05-14;4;7;11;279820;229699;79;509519
93;2020-05-14;7;7;14;171274;113716;89;284990
93;2020-05-14;17;1;18;58896;21758;90;80654
93;2020-05-14;54;37;92;2639673;2415978;0;5055651
94;2020-05-14;0;0;0;16311;17433;09;33744
94;2020-05-14;0;0;0;16679;18132;19;34811
94;2020-05-14;0;0;0;16782;16579;29;33361
94;2020-05-14;1;0;1;23044;20580;39;43624
94;2020-05-14;0;0;0;23065;22140;49;45205
94;2020-05-14;1;0;1;24549;23421;59;47970
94;2020-05-14;0;0;0;23212;21883;69;45095
94;2020-05-14;0;0;0;19544;17141;79;36685
94;2020-05-14;1;0;1;11227;8178;89;19405
94;2020-05-14;0;0;0;3332;1447;90;4779
94;2020-05-14;3;0;3;177745;166934;0;344679
01;2020-05-15;0;0;0;19979;20155;09;40134
01;2020-05-15;0;0;0;24994;25489;19;50483
01;2020-05-15;0;0;0;17868;16690;29;34558
01;2020-05-15;0;0;0;22328;14821;39;37149
01;2020-05-15;0;0;0;28652;20276;49;48928
01;2020-05-15;0;0;0;33264;27260;59;60524
01;2020-05-15;0;0;0;27135;23978;69;51113
01;2020-05-15;0;0;0;18401;14661;79;33062
01;2020-05-15;0;0;0;9633;6375;89;16008
01;2020-05-15;0;0;0;3410;1510;90;4920
01;2020-05-15;0;0;0;205664;171215;0;376879
02;2020-05-15;0;0;0;16881;17110;09;33991
02;2020-05-15;0;0;0;21410;21604;19;43014
02;2020-05-15;0;0;0;16017;15479;29;31496
02;2020-05-15;0;0;0;19825;14455;39;34280
02;2020-05-15;0;0;0;24719;18248;49;42967
02;2020-05-15;0;0;0;34361;28310;59;62671
02;2020-05-15;0;0;0;28061;24495;69;52556
02;2020-05-15;0;0;0;18231;15278;79;33509
02;2020-05-15;0;0;0;11090;7677;89;18767
02;2020-05-15;0;0;0;3992;1506;90;5498
02;2020-05-15;0;0;0;194587;164162;0;358749
03;2020-05-15;0;0;0;31123;30920;09;62043
03;2020-05-15;0;0;0;29370;29268;19;58638
03;2020-05-15;0;0;0;21458;18963;29;40421
03;2020-05-15;0;0;0;21276;18326;39;39602
03;2020-05-15;0;0;0;18164;16593;49;34757
03;2020-05-15;0;0;0;13469;13557;59;27026
03;2020-05-15;0;0;0;8776;8670;69;17446
03;2020-05-15;0;0;0;3777;3591;79;7368
03;2020-05-15;0;0;0;1649;1072;89;2721
03;2020-05-15;0;0;0;485;184;90;669
03;2020-05-15;0;0;0;149547;141144;0;290691
04;2020-05-15;0;0;0;60314;61377;09;121691
04;2020-05-15;1;0;1;66065;68387;19;134452
04;2020-05-15;0;0;0;51059;47156;29;98215
04;2020-05-15;0;0;0;58788;45780;39;104568
04;2020-05-15;0;0;0;61408;52207;49;113615
04;2020-05-15;0;0;0;64838;60759;59;125597
04;2020-05-15;0;0;0;47008;42843;69;89851
04;2020-05-15;0;0;0;25509;21184;79;46693
04;2020-05-15;0;0;0;13168;7647;89;20815
04;2020-05-15;0;0;0;3209;1253;90;4462
04;2020-05-15;1;0;1;451366;408593;0;859959
05;2020-05-15;0;0;0;362.366008612902;341.338819562748;09;703.704828175651
05;2020-05-15;0;0;0;353.376145114279;370.349735405642;19;723.725880519921
05;2020-05-15;0;0;0;218.593559489256;256.539602589476;29;475.133162078732
05;2020-05-15;0;0;0;404.225408693299;360.321910454353;39;764.547319147651
05;2020-05-15;0;0;0;520.067953604221;497.108383964256;49;1017.17633756848
05;2020-05-15;0;0;0;468.146063921917;510.087601910415;59;978.233665832332
05;2020-05-15;0;0;0;340.368470050554;334.366842191253;69;674.735312241807
05;2020-05-15;0;0;0;212.598666888387;192.597753227106;79;405.196420115493
05;2020-05-15;0;0;0;148.727797095705;61.8681715431829;89;210.595968638888
05;2020-05-15;0;0;0;32.9601271090696;10.9909785719784;90;43.9511056810479
05;2020-05-15;0;0;0;3061.43020057959;2935.56979942041;0;5997
06;2020-05-15;0;0;0;42583;42380;09;84963
06;2020-05-15;0;0;0;33369;31925;19;65294
06;2020-05-15;0;0;0;21571;15080;29;36651
06;2020-05-15;2;5;7;21550;16147;39;37697
06;2020-05-15;1;1;2;14193;13939;49;28132
06;2020-05-15;1;1;2;7171;7597;59;14768
06;2020-05-15;0;1;1;3629;4117;69;7746
06;2020-05-15;0;0;0;1577;1457;79;3034
06;2020-05-15;0;0;0;531;474;89;1005
06;2020-05-15;0;0;0;88;93;90;181
06;2020-05-15;4;8;12;146262;133209;0;279471
07;2020-05-15;0;0;0;485;549;09;1034
07;2020-05-15;0;0;0;403;432;19;835
07;2020-05-15;0;0;0;764;841;29;1605
07;2020-05-15;0;0;0;824;928;39;1752
07;2020-05-15;0;0;0;788;1020;49;1808
07;2020-05-15;0;0;0;678;870;59;1548
07;2020-05-15;0;0;0;360;382;69;742
07;2020-05-15;0;0;0;231;190;79;421
07;2020-05-15;0;0;0;114;67;89;181
07;2020-05-15;0;0;0;24;11;90;35
07;2020-05-15;0;0;0;4671;5290;0;9961
08;2020-05-15;0;0;0;2715.22592983026;2997.75551488675;09;5712.98144471701
08;2020-05-15;0;0;0;2778.51901080978;3160.9156459093;19;5939.43465671908
08;2020-05-15;0;0;0;2080.8882988764;1718.16634315323;29;3799.05464202964
08;2020-05-15;0;0;0;2701.8582062647;1896.52641413317;39;4598.38462039786
08;2020-05-15;0;0;0;3151.45861023308;2460.52498233809;49;5611.98359257117
08;2020-05-15;0;0;0;2620.29868333099;2422.23566154656;59;5042.53434487755
08;2020-05-15;0;0;0;1621.44173420671;1438.58325779464;69;3060.02499200135
08;2020-05-15;0;0;0;626.575909335673;526.358467843651;79;1152.93437717932
08;2020-05-15;0;0;0;205.018522985054;140.993639349697;89;346.012162334751
08;2020-05-15;0;0;0;50.0325684687745;20.62259870351;90;70.6551671722846
08;2020-05-15;0;0;0;18551.3174743414;16782.6825256586;0;35334
11;2020-05-15;1;2;3;783071;811785;09;1594856
11;2020-05-15;5;6;11;761456;784653;19;1546109
11;2020-05-15;18;16;36;850145;801772;29;1651917
11;2020-05-15;15;15;31;914360;843488;39;1757848
11;2020-05-15;19;13;33;845609;826202;49;1671811
11;2020-05-15;19;16;36;793566;745070;59;1538636
11;2020-05-15;11;15;26;628649;549192;69;1177841
11;2020-05-15;10;12;24;434606;358356;79;792962
11;2020-05-15;31;14;48;261425;162933;89;424358
11;2020-05-15;19;3;24;89253;32619;90;121872
11;2020-05-15;148;112;273;6362140;5916070;0;12278210
24;2020-05-15;3;0;3;139720;144686;09;284406
24;2020-05-15;2;2;4;152979;161185;19;314164
24;2020-05-15;1;1;2;122237;126536;29;248773
24;2020-05-15;7;2;9;150359;142009;39;292368
24;2020-05-15;3;4;7;161829;158758;49;320587
24;2020-05-15;3;2;5;172552;168011;59;340563
24;2020-05-15;3;2;5;172509;158177;69;330686
24;2020-05-15;3;1;4;129428;110593;79;240021
24;2020-05-15;5;3;8;87342;56882;89;144224
24;2020-05-15;4;2;6;31210;12071;90;43281
24;2020-05-15;35;19;54;1320165;1238908;0;2559073
27;2020-05-15;0;0;0;143373;149679;09;293052
27;2020-05-15;0;1;1;160962;173003;19;333965
27;2020-05-15;3;2;5;133746;142254;29;276000
27;2020-05-15;5;0;5;160004;155407;39;315411
27;2020-05-15;3;1;4;172333;169564;49;341897
27;2020-05-15;2;3;5;189979;183788;59;373767
27;2020-05-15;1;5;6;192591;178206;69;370797
27;2020-05-15;6;4;10;146876;127546;79;274422
27;2020-05-15;14;3;17;96896;61575;89;158471
27;2020-05-15;7;3;10;33148;12109;90;45257
27;2020-05-15;41;22;64;1429908;1353131;0;2783039
28;2020-05-15;0;0;0;180735;186856;09;367591
28;2020-05-15;0;0;0;200125;213621;19;413746
28;2020-05-15;2;0;2;168922;173007;29;341929
28;2020-05-15;2;1;3;196628;188487;39;385115
28;2020-05-15;3;1;4;205396;201699;49;407095
28;2020-05-15;2;0;2;222002;213866;59;435868
28;2020-05-15;1;1;2;224688;203758;69;428446
28;2020-05-15;1;0;1;163192;135543;79;298735
28;2020-05-15;6;1;7;109691;65377;89;175068
28;2020-05-15;0;2;2;37222;12685;90;49907
28;2020-05-15;17;6;23;1708601;1594899;0;3303500
32;2020-05-15;1;1;2;358062;373689;09;731751
32;2020-05-15;2;2;5;387045;406742;19;793787
32;2020-05-15;5;0;5;342304;348587;29;690891
32;2020-05-15;4;0;5;382485;369972;39;752457
32;2020-05-15;2;9;12;382510;376716;49;759226
32;2020-05-15;5;5;10;386937;376527;59;763464
32;2020-05-15;1;3;4;371211;330938;69;702149
32;2020-05-15;6;5;11;250542;201459;79;452001
32;2020-05-15;15;2;17;163399;89786;89;253185
32;2020-05-15;12;3;15;48384;15367;90;63751
32;2020-05-15;53;30;86;3072879;2889783;0;5962662
44;2020-05-15;0;1;1;291525;306839;09;598364
44;2020-05-15;1;4;6;320255;339504;19;659759
44;2020-05-15;10;7;17;302020;314428;29;616448
44;2020-05-15;5;13;18;342222;333292;39;675514
44;2020-05-15;10;3;13;349727;344491;49;694218
44;2020-05-15;3;7;10;381371;373239;59;754610
44;2020-05-15;10;9;19;367165;335850;69;703015
44;2020-05-15;10;10;20;250387;215436;79;465823
44;2020-05-15;22;8;30;170825;105192;89;276017
44;2020-05-15;11;3;14;51248;16731;90;67979
44;2020-05-15;83;66;150;2826745;2685002;0;5511747
52;2020-05-15;0;1;1;213594;223900;09;437494
52;2020-05-15;0;1;1;240818;255197;19;496015
52;2020-05-15;1;2;3;197010;200630;29;397640
52;2020-05-15;4;3;7;231204;224885;39;456089
52;2020-05-15;3;4;7;243874;243418;49;487292
52;2020-05-15;3;1;4;244100;239116;59;483216
52;2020-05-15;1;2;3;241796;221345;69;463141
52;2020-05-15;0;2;2;177805;149903;79;327708
52;2020-05-15;2;2;4;119561;75822;89;195383
52;2020-05-15;2;3;5;42559;15260;90;57819
52;2020-05-15;16;21;37;1952321;1849476;0;3801797
53;2020-05-15;0;1;1;173813;182358;09;356171
53;2020-05-15;1;3;4;202720;214740;19;417460
53;2020-05-15;6;19;25;163116;173196;29;336312
53;2020-05-15;2;13;16;190526;187674;39;378200
53;2020-05-15;4;9;13;212098;212015;49;424113
53;2020-05-15;4;10;15;223699;219176;59;442875
53;2020-05-15;1;3;4;227435;209274;69;436709
53;2020-05-15;0;0;0;169992;140910;79;310902
53;2020-05-15;1;0;1;118117;69883;89;188000
53;2020-05-15;1;0;2;37370;12267;90;49637
53;2020-05-15;20;58;81;1718886;1621493;0;3340379
75;2020-05-15;1;0;1;293104;305291;09;598395
75;2020-05-15;1;1;2;337141;357785;19;694926
75;2020-05-15;6;3;9;295024;300618;29;595642
75;2020-05-15;3;2;5;347871;331233;39;679104
75;2020-05-15;1;1;2;384742;372771;49;757513
75;2020-05-15;3;0;3;413361;390880;59;804241
75;2020-05-15;0;1;1;425623;384060;69;809683
75;2020-05-15;0;1;1;325086;276298;79;601384
75;2020-05-15;0;1;2;213986;139308;89;353294
75;2020-05-15;3;0;4;77600;28200;90;105800
75;2020-05-15;18;10;30;3113538;2886444;0;5999982
76;2020-05-15;1;0;1;305956;318589;09;624545
76;2020-05-15;1;1;2;338942;356969;19;695911
76;2020-05-15;4;2;8;316210;319570;29;635780
76;2020-05-15;3;1;5;356758;337587;39;694345
76;2020-05-15;1;1;3;376541;363812;49;740353
76;2020-05-15;6;2;9;402608;383750;59;786358
76;2020-05-15;2;4;6;394889;358997;69;753886
76;2020-05-15;7;3;12;308664;263806;79;572470
76;2020-05-15;3;2;7;195838;129272;89;325110
76;2020-05-15;5;3;10;69372;26728;90;96100
76;2020-05-15;34;19;64;3065778;2859080;0;5924858
84;2020-05-15;1;1;2;459549;481088;09;940637
84;2020-05-15;2;2;4;487711;511905;19;999616
84;2020-05-15;3;8;11;443824;451094;29;894918
84;2020-05-15;5;7;12;512522;493262;39;1005784
84;2020-05-15;1;5;6;520248;515106;49;1035354
84;2020-05-15;3;8;11;529611;514848;59;1044459
84;2020-05-15;5;1;6;486720;439940;69;926660
84;2020-05-15;4;3;7;372151;315211;79;687362
84;2020-05-15;3;5;8;237198;150524;89;387722
84;2020-05-15;9;2;11;81185;28680;90;109865
84;2020-05-15;36;42;78;4130719;3901658;0;8032377
93;2020-05-15;0;1;1;268834;283093;09;551927
93;2020-05-15;0;0;0;280751;296087;19;576838
93;2020-05-15;5;4;9;254404;255552;29;509956
93;2020-05-15;6;3;9;310704;288398;39;599102
93;2020-05-15;5;2;7;325559;305827;49;631386
93;2020-05-15;9;3;12;353104;325389;59;678493
93;2020-05-15;3;2;5;336327;296459;69;632786
93;2020-05-15;5;4;9;279820;229699;79;509519
93;2020-05-15;7;3;10;171274;113716;89;284990
93;2020-05-15;8;3;11;58896;21758;90;80654
93;2020-05-15;48;26;74;2639673;2415978;0;5055651
94;2020-05-15;0;0;0;16311;17433;09;33744
94;2020-05-15;0;0;0;16679;18132;19;34811
94;2020-05-15;0;0;0;16782;16579;29;33361
94;2020-05-15;0;0;0;23044;20580;39;43624
94;2020-05-15;0;0;0;23065;22140;49;45205
94;2020-05-15;0;0;0;24549;23421;59;47970
94;2020-05-15;0;0;0;23212;21883;69;45095
94;2020-05-15;0;0;0;19544;17141;79;36685
94;2020-05-15;1;0;1;11227;8178;89;19405
94;2020-05-15;0;0;0;3332;1447;90;4779
94;2020-05-15;1;0;1;177745;166934;0;344679
01;2020-05-16;0;0;0;19979;20155;09;40134
01;2020-05-16;0;0;0;24994;25489;19;50483
01;2020-05-16;0;0;0;17868;16690;29;34558
01;2020-05-16;0;0;0;22328;14821;39;37149
01;2020-05-16;0;0;0;28652;20276;49;48928
01;2020-05-16;0;0;0;33264;27260;59;60524
01;2020-05-16;0;0;0;27135;23978;69;51113
01;2020-05-16;0;0;0;18401;14661;79;33062
01;2020-05-16;0;0;0;9633;6375;89;16008
01;2020-05-16;0;0;0;3410;1510;90;4920
01;2020-05-16;0;0;0;205664;171215;0;376879
02;2020-05-16;0;0;0;16881;17110;09;33991
02;2020-05-16;0;1;1;21410;21604;19;43014
02;2020-05-16;0;0;0;16017;15479;29;31496
02;2020-05-16;0;0;0;19825;14455;39;34280
02;2020-05-16;0;0;0;24719;18248;49;42967
02;2020-05-16;0;0;0;34361;28310;59;62671
02;2020-05-16;0;0;0;28061;24495;69;52556
02;2020-05-16;0;0;0;18231;15278;79;33509
02;2020-05-16;0;0;0;11090;7677;89;18767
02;2020-05-16;0;0;0;3992;1506;90;5498
02;2020-05-16;0;1;1;194587;164162;0;358749
03;2020-05-16;0;0;0;31123;30920;09;62043
03;2020-05-16;0;0;0;29370;29268;19;58638
03;2020-05-16;0;0;0;21458;18963;29;40421
03;2020-05-16;0;1;1;21276;18326;39;39602
03;2020-05-16;0;0;0;18164;16593;49;34757
03;2020-05-16;0;0;0;13469;13557;59;27026
03;2020-05-16;0;0;0;8776;8670;69;17446
03;2020-05-16;0;0;0;3777;3591;79;7368
03;2020-05-16;0;0;0;1649;1072;89;2721
03;2020-05-16;0;0;0;485;184;90;669
03;2020-05-16;0;1;1;149547;141144;0;290691
04;2020-05-16;0;0;0;60314;61377;09;121691
04;2020-05-16;0;0;0;66065;68387;19;134452
04;2020-05-16;0;1;1;51059;47156;29;98215
04;2020-05-16;0;0;0;58788;45780;39;104568
04;2020-05-16;0;0;0;61408;52207;49;113615
04;2020-05-16;0;0;0;64838;60759;59;125597
04;2020-05-16;0;0;0;47008;42843;69;89851
04;2020-05-16;0;0;0;25509;21184;79;46693
04;2020-05-16;0;0;0;13168;7647;89;20815
04;2020-05-16;0;0;0;3209;1253;90;4462
04;2020-05-16;0;1;1;451366;408593;0;859959
05;2020-05-16;0;0;0;362.366008612902;341.338819562748;09;703.704828175651
05;2020-05-16;0;0;0;353.376145114279;370.349735405642;19;723.725880519921
05;2020-05-16;0;0;0;218.593559489256;256.539602589476;29;475.133162078732
05;2020-05-16;0;0;0;404.225408693299;360.321910454353;39;764.547319147651
05;2020-05-16;0;0;0;520.067953604221;497.108383964256;49;1017.17633756848
05;2020-05-16;0;0;0;468.146063921917;510.087601910415;59;978.233665832332
05;2020-05-16;0;0;0;340.368470050554;334.366842191253;69;674.735312241807
05;2020-05-16;0;0;0;212.598666888387;192.597753227106;79;405.196420115493
05;2020-05-16;0;0;0;148.727797095705;61.8681715431829;89;210.595968638888
05;2020-05-16;0;0;0;32.9601271090696;10.9909785719784;90;43.9511056810479
05;2020-05-16;0;0;0;3061.43020057959;2935.56979942041;0;5997
06;2020-05-16;0;0;0;42583;42380;09;84963
06;2020-05-16;0;0;0;33369;31925;19;65294
06;2020-05-16;0;0;0;21571;15080;29;36651
06;2020-05-16;0;0;0;21550;16147;39;37697
06;2020-05-16;0;0;0;14193;13939;49;28132
06;2020-05-16;0;0;0;7171;7597;59;14768
06;2020-05-16;0;0;0;3629;4117;69;7746
06;2020-05-16;0;0;0;1577;1457;79;3034
06;2020-05-16;0;0;0;531;474;89;1005
06;2020-05-16;0;0;0;88;93;90;181
06;2020-05-16;0;0;0;146262;133209;0;279471
07;2020-05-16;0;0;0;485;549;09;1034
07;2020-05-16;0;0;0;403;432;19;835
07;2020-05-16;0;0;0;764;841;29;1605
07;2020-05-16;0;0;0;824;928;39;1752
07;2020-05-16;0;0;0;788;1020;49;1808
07;2020-05-16;0;0;0;678;870;59;1548
07;2020-05-16;0;0;0;360;382;69;742
07;2020-05-16;0;0;0;231;190;79;421
07;2020-05-16;0;0;0;114;67;89;181
07;2020-05-16;0;0;0;24;11;90;35
07;2020-05-16;0;0;0;4671;5290;0;9961
08;2020-05-16;0;0;0;2715.22592983026;2997.75551488675;09;5712.98144471701
08;2020-05-16;0;0;0;2778.51901080978;3160.9156459093;19;5939.43465671908
08;2020-05-16;0;0;0;2080.8882988764;1718.16634315323;29;3799.05464202964
08;2020-05-16;0;0;0;2701.8582062647;1896.52641413317;39;4598.38462039786
08;2020-05-16;0;0;0;3151.45861023308;2460.52498233809;49;5611.98359257117
08;2020-05-16;0;0;0;2620.29868333099;2422.23566154656;59;5042.53434487755
08;2020-05-16;0;0;0;1621.44173420671;1438.58325779464;69;3060.02499200135
08;2020-05-16;0;0;0;626.575909335673;526.358467843651;79;1152.93437717932
08;2020-05-16;0;0;0;205.018522985054;140.993639349697;89;346.012162334751
08;2020-05-16;0;0;0;50.0325684687745;20.62259870351;90;70.6551671722846
08;2020-05-16;0;0;0;18551.3174743414;16782.6825256586;0;35334
11;2020-05-16;0;0;0;783071;811785;09;1594856
11;2020-05-16;2;1;3;761456;784653;19;1546109
11;2020-05-16;3;2;5;850145;801772;29;1651917
11;2020-05-16;0;5;5;914360;843488;39;1757848
11;2020-05-16;5;3;8;845609;826202;49;1671811
11;2020-05-16;1;8;9;793566;745070;59;1538636
11;2020-05-16;2;3;5;628649;549192;69;1177841
11;2020-05-16;2;6;8;434606;358356;79;792962
11;2020-05-16;3;7;10;261425;162933;89;424358
11;2020-05-16;10;0;10;89253;32619;90;121872
11;2020-05-16;28;35;63;6362140;5916070;0;12278210
24;2020-05-16;0;0;0;139720;144686;09;284406
24;2020-05-16;0;1;1;152979;161185;19;314164
24;2020-05-16;2;8;10;122237;126536;29;248773
24;2020-05-16;1;2;3;150359;142009;39;292368
24;2020-05-16;3;5;8;161829;158758;49;320587
24;2020-05-16;2;2;4;172552;168011;59;340563
24;2020-05-16;2;0;2;172509;158177;69;330686
24;2020-05-16;0;1;1;129428;110593;79;240021
24;2020-05-16;2;2;4;87342;56882;89;144224
24;2020-05-16;2;0;2;31210;12071;90;43281
24;2020-05-16;14;21;35;1320165;1238908;0;2559073
27;2020-05-16;3;0;3;143373;149679;09;293052
27;2020-05-16;0;0;0;160962;173003;19;333965
27;2020-05-16;3;0;3;133746;142254;29;276000
27;2020-05-16;1;0;1;160004;155407;39;315411
27;2020-05-16;2;1;3;172333;169564;49;341897
27;2020-05-16;1;0;1;189979;183788;59;373767
27;2020-05-16;2;2;4;192591;178206;69;370797
27;2020-05-16;1;0;1;146876;127546;79;274422
27;2020-05-16;2;1;3;96896;61575;89;158471
27;2020-05-16;4;0;4;33148;12109;90;45257
27;2020-05-16;19;4;23;1429908;1353131;0;2783039
28;2020-05-16;0;0;0;180735;186856;09;367591
28;2020-05-16;0;0;0;200125;213621;19;413746
28;2020-05-16;0;0;0;168922;173007;29;341929
28;2020-05-16;0;1;1;196628;188487;39;385115
28;2020-05-16;1;0;1;205396;201699;49;407095
28;2020-05-16;2;0;2;222002;213866;59;435868
28;2020-05-16;0;0;0;224688;203758;69;428446
28;2020-05-16;1;1;2;163192;135543;79;298735
28;2020-05-16;0;0;0;109691;65377;89;175068
28;2020-05-16;0;0;0;37222;12685;90;49907
28;2020-05-16;4;2;6;1708601;1594899;0;3303500
32;2020-05-16;0;1;1;358062;373689;09;731751
32;2020-05-16;1;0;1;387045;406742;19;793787
32;2020-05-16;3;0;3;342304;348587;29;690891
32;2020-05-16;1;1;2;382485;369972;39;752457
32;2020-05-16;0;1;1;382510;376716;49;759226
32;2020-05-16;1;3;4;386937;376527;59;763464
32;2020-05-16;0;0;0;371211;330938;69;702149
32;2020-05-16;3;1;4;250542;201459;79;452001
32;2020-05-16;6;2;9;163399;89786;89;253185
32;2020-05-16;5;0;5;48384;15367;90;63751
32;2020-05-16;20;9;30;3072879;2889783;0;5962662
44;2020-05-16;0;0;0;291525;306839;09;598364
44;2020-05-16;0;1;1;320255;339504;19;659759
44;2020-05-16;1;0;1;302020;314428;29;616448
44;2020-05-16;1;3;4;342222;333292;39;675514
44;2020-05-16;2;2;4;349727;344491;49;694218
44;2020-05-16;0;2;2;381371;373239;59;754610
44;2020-05-16;3;4;7;367165;335850;69;703015
44;2020-05-16;2;1;3;250387;215436;79;465823
44;2020-05-16;7;4;11;170825;105192;89;276017
44;2020-05-16;4;2;6;51248;16731;90;67979
44;2020-05-16;20;19;39;2826745;2685002;0;5511747
52;2020-05-16;1;2;3;213594;223900;09;437494
52;2020-05-16;0;1;1;240818;255197;19;496015
52;2020-05-16;3;1;4;197010;200630;29;397640
52;2020-05-16;0;0;0;231204;224885;39;456089
52;2020-05-16;4;0;4;243874;243418;49;487292
52;2020-05-16;0;1;1;244100;239116;59;483216
52;2020-05-16;1;1;2;241796;221345;69;463141
52;2020-05-16;1;1;2;177805;149903;79;327708
52;2020-05-16;0;0;0;119561;75822;89;195383
52;2020-05-16;0;0;0;42559;15260;90;57819
52;2020-05-16;10;7;17;1952321;1849476;0;3801797
53;2020-05-16;0;1;1;173813;182358;09;356171
53;2020-05-16;0;2;2;202720;214740;19;417460
53;2020-05-16;1;2;3;163116;173196;29;336312
53;2020-05-16;1;2;3;190526;187674;39;378200
53;2020-05-16;0;3;3;212098;212015;49;424113
53;2020-05-16;2;2;4;223699;219176;59;442875
53;2020-05-16;0;0;0;227435;209274;69;436709
53;2020-05-16;0;0;0;169992;140910;79;310902
53;2020-05-16;0;0;0;118117;69883;89;188000
53;2020-05-16;1;0;1;37370;12267;90;49637
53;2020-05-16;5;12;17;1718886;1621493;0;3340379
75;2020-05-16;0;0;0;293104;305291;09;598395
75;2020-05-16;0;0;0;337141;357785;19;694926
75;2020-05-16;1;0;1;295024;300618;29;595642
75;2020-05-16;0;0;0;347871;331233;39;679104
75;2020-05-16;2;0;2;384742;372771;49;757513
75;2020-05-16;0;1;1;413361;390880;59;804241
75;2020-05-16;0;0;0;425623;384060;69;809683
75;2020-05-16;1;0;1;325086;276298;79;601384
75;2020-05-16;0;2;2;213986;139308;89;353294
75;2020-05-16;1;0;1;77600;28200;90;105800
75;2020-05-16;5;3;8;3113538;2886444;0;5999982
76;2020-05-16;0;0;0;305956;318589;09;624545
76;2020-05-16;0;0;0;338942;356969;19;695911
76;2020-05-16;1;0;1;316210;319570;29;635780
76;2020-05-16;2;0;2;356758;337587;39;694345
76;2020-05-16;1;0;1;376541;363812;49;740353
76;2020-05-16;0;1;1;402608;383750;59;786358
76;2020-05-16;0;0;0;394889;358997;69;753886
76;2020-05-16;1;0;1;308664;263806;79;572470
76;2020-05-16;1;1;2;195838;129272;89;325110
76;2020-05-16;1;1;2;69372;26728;90;96100
76;2020-05-16;7;3;10;3065778;2859080;0;5924858
84;2020-05-16;2;0;2;459549;481088;09;940637
84;2020-05-16;1;1;2;487711;511905;19;999616
84;2020-05-16;1;1;2;443824;451094;29;894918
84;2020-05-16;2;3;5;512522;493262;39;1005784
84;2020-05-16;1;2;3;520248;515106;49;1035354
84;2020-05-16;2;0;2;529611;514848;59;1044459
84;2020-05-16;1;0;1;486720;439940;69;926660
84;2020-05-16;0;1;1;372151;315211;79;687362
84;2020-05-16;3;3;6;237198;150524;89;387722
84;2020-05-16;1;0;1;81185;28680;90;109865
84;2020-05-16;14;11;25;4130719;3901658;0;8032377
93;2020-05-16;0;0;0;268834;283093;09;551927
93;2020-05-16;1;0;1;280751;296087;19;576838
93;2020-05-16;3;0;3;254404;255552;29;509956
93;2020-05-16;0;0;0;310704;288398;39;599102
93;2020-05-16;0;0;0;325559;305827;49;631386
93;2020-05-16;0;0;0;353104;325389;59;678493
93;2020-05-16;0;1;1;336327;296459;69;632786
93;2020-05-16;3;1;4;279820;229699;79;509519
93;2020-05-16;1;0;1;171274;113716;89;284990
93;2020-05-16;5;0;5;58896;21758;90;80654
93;2020-05-16;13;2;15;2639673;2415978;0;5055651
94;2020-05-16;0;0;0;16311;17433;09;33744
94;2020-05-16;0;0;0;16679;18132;19;34811
94;2020-05-16;0;0;0;16782;16579;29;33361
94;2020-05-16;0;0;0;23044;20580;39;43624
94;2020-05-16;0;0;0;23065;22140;49;45205
94;2020-05-16;0;1;1;24549;23421;59;47970
94;2020-05-16;0;0;0;23212;21883;69;45095
94;2020-05-16;0;0;0;19544;17141;79;36685
94;2020-05-16;0;0;0;11227;8178;89;19405
94;2020-05-16;0;0;0;3332;1447;90;4779
94;2020-05-16;0;1;1;177745;166934;0;344679
01;2020-05-17;0;0;0;19979;20155;09;40134
01;2020-05-17;0;0;0;24994;25489;19;50483
01;2020-05-17;0;0;0;17868;16690;29;34558
01;2020-05-17;0;0;0;22328;14821;39;37149
01;2020-05-17;0;0;0;28652;20276;49;48928
01;2020-05-17;0;0;0;33264;27260;59;60524
01;2020-05-17;0;0;0;27135;23978;69;51113
01;2020-05-17;0;0;0;18401;14661;79;33062
01;2020-05-17;0;0;0;9633;6375;89;16008
01;2020-05-17;0;0;0;3410;1510;90;4920
01;2020-05-17;0;0;0;205664;171215;0;376879
02;2020-05-17;0;0;0;16881;17110;09;33991
02;2020-05-17;0;0;0;21410;21604;19;43014
02;2020-05-17;0;0;0;16017;15479;29;31496
02;2020-05-17;0;0;0;19825;14455;39;34280
02;2020-05-17;0;0;0;24719;18248;49;42967
02;2020-05-17;0;0;0;34361;28310;59;62671
02;2020-05-17;0;0;0;28061;24495;69;52556
02;2020-05-17;0;0;0;18231;15278;79;33509
02;2020-05-17;0;0;0;11090;7677;89;18767
02;2020-05-17;0;0;0;3992;1506;90;5498
02;2020-05-17;0;0;0;194587;164162;0;358749
03;2020-05-17;0;0;0;31123;30920;09;62043
03;2020-05-17;0;0;0;29370;29268;19;58638
03;2020-05-17;0;0;0;21458;18963;29;40421
03;2020-05-17;0;0;0;21276;18326;39;39602
03;2020-05-17;0;0;0;18164;16593;49;34757
03;2020-05-17;0;0;0;13469;13557;59;27026
03;2020-05-17;0;0;0;8776;8670;69;17446
03;2020-05-17;0;0;0;3777;3591;79;7368
03;2020-05-17;0;0;0;1649;1072;89;2721
03;2020-05-17;0;0;0;485;184;90;669
03;2020-05-17;0;0;0;149547;141144;0;290691
04;2020-05-17;0;0;0;60314;61377;09;121691
04;2020-05-17;0;0;0;66065;68387;19;134452
04;2020-05-17;1;1;2;51059;47156;29;98215
04;2020-05-17;0;0;0;58788;45780;39;104568
04;2020-05-17;0;0;0;61408;52207;49;113615
04;2020-05-17;1;0;1;64838;60759;59;125597
04;2020-05-17;0;0;0;47008;42843;69;89851
04;2020-05-17;0;0;0;25509;21184;79;46693
04;2020-05-17;0;0;0;13168;7647;89;20815
04;2020-05-17;0;0;0;3209;1253;90;4462
04;2020-05-17;2;1;3;451366;408593;0;859959
05;2020-05-17;0;0;0;362.366008612902;341.338819562748;09;703.704828175651
05;2020-05-17;0;0;0;353.376145114279;370.349735405642;19;723.725880519921
05;2020-05-17;0;0;0;218.593559489256;256.539602589476;29;475.133162078732
05;2020-05-17;0;0;0;404.225408693299;360.321910454353;39;764.547319147651
05;2020-05-17;0;0;0;520.067953604221;497.108383964256;49;1017.17633756848
05;2020-05-17;0;0;0;468.146063921917;510.087601910415;59;978.233665832332
05;2020-05-17;0;0;0;340.368470050554;334.366842191253;69;674.735312241807
05;2020-05-17;0;0;0;212.598666888387;192.597753227106;79;405.196420115493
05;2020-05-17;0;0;0;148.727797095705;61.8681715431829;89;210.595968638888
05;2020-05-17;0;0;0;32.9601271090696;10.9909785719784;90;43.9511056810479
05;2020-05-17;0;0;0;3061.43020057959;2935.56979942041;0;5997
06;2020-05-17;0;0;0;42583;42380;09;84963
06;2020-05-17;0;0;0;33369;31925;19;65294
06;2020-05-17;0;0;0;21571;15080;29;36651
06;2020-05-17;0;0;0;21550;16147;39;37697
06;2020-05-17;0;0;0;14193;13939;49;28132
06;2020-05-17;0;0;0;7171;7597;59;14768
06;2020-05-17;0;0;0;3629;4117;69;7746
06;2020-05-17;0;0;0;1577;1457;79;3034
06;2020-05-17;0;0;0;531;474;89;1005
06;2020-05-17;0;0;0;88;93;90;181
06;2020-05-17;0;0;0;146262;133209;0;279471
07;2020-05-17;0;0;0;485;549;09;1034
07;2020-05-17;0;0;0;403;432;19;835
07;2020-05-17;0;0;0;764;841;29;1605
07;2020-05-17;0;0;0;824;928;39;1752
07;2020-05-17;0;0;0;788;1020;49;1808
07;2020-05-17;0;0;0;678;870;59;1548
07;2020-05-17;0;0;0;360;382;69;742
07;2020-05-17;0;0;0;231;190;79;421
07;2020-05-17;0;0;0;114;67;89;181
07;2020-05-17;0;0;0;24;11;90;35
07;2020-05-17;0;0;0;4671;5290;0;9961
08;2020-05-17;0;0;0;2715.22592983026;2997.75551488675;09;5712.98144471701
08;2020-05-17;0;0;0;2778.51901080978;3160.9156459093;19;5939.43465671908
08;2020-05-17;0;0;0;2080.8882988764;1718.16634315323;29;3799.05464202964
08;2020-05-17;0;0;0;2701.8582062647;1896.52641413317;39;4598.38462039786
08;2020-05-17;0;0;0;3151.45861023308;2460.52498233809;49;5611.98359257117
08;2020-05-17;0;0;0;2620.29868333099;2422.23566154656;59;5042.53434487755
08;2020-05-17;0;0;0;1621.44173420671;1438.58325779464;69;3060.02499200135
08;2020-05-17;0;0;0;626.575909335673;526.358467843651;79;1152.93437717932
08;2020-05-17;0;0;0;205.018522985054;140.993639349697;89;346.012162334751
08;2020-05-17;0;0;0;50.0325684687745;20.62259870351;90;70.6551671722846
08;2020-05-17;0;0;0;18551.3174743414;16782.6825256586;0;35334
11;2020-05-17;1;2;3;783071;811785;09;1594856
11;2020-05-17;0;1;1;761456;784653;19;1546109
11;2020-05-17;2;1;3;850145;801772;29;1651917
11;2020-05-17;1;0;1;914360;843488;39;1757848
11;2020-05-17;3;2;5;845609;826202;49;1671811
11;2020-05-17;0;1;1;793566;745070;59;1538636
11;2020-05-17;3;4;7;628649;549192;69;1177841
11;2020-05-17;2;5;7;434606;358356;79;792962
11;2020-05-17;9;2;11;261425;162933;89;424358
11;2020-05-17;9;4;13;89253;32619;90;121872
11;2020-05-17;30;22;52;6362140;5916070;0;12278210
24;2020-05-17;1;1;2;139720;144686;09;284406
24;2020-05-17;0;0;0;152979;161185;19;314164
24;2020-05-17;1;2;3;122237;126536;29;248773
24;2020-05-17;2;2;4;150359;142009;39;292368
24;2020-05-17;0;2;2;161829;158758;49;320587
24;2020-05-17;4;1;5;172552;168011;59;340563
24;2020-05-17;0;0;0;172509;158177;69;330686
24;2020-05-17;0;1;1;129428;110593;79;240021
24;2020-05-17;0;0;0;87342;56882;89;144224
24;2020-05-17;0;0;0;31210;12071;90;43281
24;2020-05-17;8;9;17;1320165;1238908;0;2559073
27;2020-05-17;0;0;0;143373;149679;09;293052
27;2020-05-17;2;0;2;160962;173003;19;333965
27;2020-05-17;0;0;0;133746;142254;29;276000
27;2020-05-17;1;0;1;160004;155407;39;315411
27;2020-05-17;0;0;0;172333;169564;49;341897
27;2020-05-17;0;0;0;189979;183788;59;373767
27;2020-05-17;1;0;1;192591;178206;69;370797
27;2020-05-17;0;3;3;146876;127546;79;274422
27;2020-05-17;0;1;1;96896;61575;89;158471
27;2020-05-17;0;0;0;33148;12109;90;45257
27;2020-05-17;4;4;8;1429908;1353131;0;2783039
28;2020-05-17;0;0;0;180735;186856;09;367591
28;2020-05-17;0;0;0;200125;213621;19;413746
28;2020-05-17;3;0;3;168922;173007;29;341929
28;2020-05-17;0;0;0;196628;188487;39;385115
28;2020-05-17;1;2;3;205396;201699;49;407095
28;2020-05-17;2;0;2;222002;213866;59;435868
28;2020-05-17;0;0;0;224688;203758;69;428446
28;2020-05-17;0;0;0;163192;135543;79;298735
28;2020-05-17;0;0;0;109691;65377;89;175068
28;2020-05-17;0;0;0;37222;12685;90;49907
28;2020-05-17;6;2;8;1708601;1594899;0;3303500
32;2020-05-17;0;0;0;358062;373689;09;731751
32;2020-05-17;0;0;0;387045;406742;19;793787
32;2020-05-17;0;1;1;342304;348587;29;690891
32;2020-05-17;1;1;2;382485;369972;39;752457
32;2020-05-17;1;0;1;382510;376716;49;759226
32;2020-05-17;0;0;0;386937;376527;59;763464
32;2020-05-17;0;1;1;371211;330938;69;702149
32;2020-05-17;0;1;1;250542;201459;79;452001
32;2020-05-17;2;1;3;163399;89786;89;253185
32;2020-05-17;1;0;1;48384;15367;90;63751
32;2020-05-17;5;5;10;3072879;2889783;0;5962662
44;2020-05-17;0;0;0;291525;306839;09;598364
44;2020-05-17;0;0;0;320255;339504;19;659759
44;2020-05-17;0;0;0;302020;314428;29;616448
44;2020-05-17;0;0;0;342222;333292;39;675514
44;2020-05-17;0;0;0;349727;344491;49;694218
44;2020-05-17;3;0;3;381371;373239;59;754610
44;2020-05-17;1;1;2;367165;335850;69;703015
44;2020-05-17;1;0;1;250387;215436;79;465823
44;2020-05-17;0;0;0;170825;105192;89;276017
44;2020-05-17;0;0;0;51248;16731;90;67979
44;2020-05-17;5;1;6;2826745;2685002;0;5511747
52;2020-05-17;0;0;0;213594;223900;09;437494
52;2020-05-17;1;0;1;240818;255197;19;496015
52;2020-05-17;0;0;0;197010;200630;29;397640
52;2020-05-17;0;0;0;231204;224885;39;456089
52;2020-05-17;0;0;0;243874;243418;49;487292
52;2020-05-17;0;0;0;244100;239116;59;483216
52;2020-05-17;0;0;0;241796;221345;69;463141
52;2020-05-17;0;1;1;177805;149903;79;327708
52;2020-05-17;2;0;2;119561;75822;89;195383
52;2020-05-17;0;1;1;42559;15260;90;57819
52;2020-05-17;3;2;5;1952321;1849476;0;3801797
53;2020-05-17;0;0;0;173813;182358;09;356171
53;2020-05-17;0;0;0;202720;214740;19;417460
53;2020-05-17;1;0;1;163116;173196;29;336312
53;2020-05-17;0;1;1;190526;187674;39;378200
53;2020-05-17;0;0;0;212098;212015;49;424113
53;2020-05-17;0;0;0;223699;219176;59;442875
53;2020-05-17;1;0;1;227435;209274;69;436709
53;2020-05-17;0;0;0;169992;140910;79;310902
53;2020-05-17;0;0;0;118117;69883;89;188000
53;2020-05-17;0;0;0;37370;12267;90;49637
53;2020-05-17;2;1;3;1718886;1621493;0;3340379
75;2020-05-17;0;0;0;293104;305291;09;598395
75;2020-05-17;0;0;0;337141;357785;19;694926
75;2020-05-17;0;0;0;295024;300618;29;595642
75;2020-05-17;1;0;1;347871;331233;39;679104
75;2020-05-17;0;0;0;384742;372771;49;757513
75;2020-05-17;0;0;0;413361;390880;59;804241
75;2020-05-17;1;0;1;425623;384060;69;809683
75;2020-05-17;0;0;0;325086;276298;79;601384
75;2020-05-17;0;0;0;213986;139308;89;353294
75;2020-05-17;0;0;0;77600;28200;90;105800
75;2020-05-17;2;0;2;3113538;2886444;0;5999982
76;2020-05-17;0;0;0;305956;318589;09;624545
76;2020-05-17;0;0;0;338942;356969;19;695911
76;2020-05-17;0;1;1;316210;319570;29;635780
76;2020-05-17;0;0;0;356758;337587;39;694345
76;2020-05-17;1;0;1;376541;363812;49;740353
76;2020-05-17;1;0;1;402608;383750;59;786358
76;2020-05-17;0;1;1;394889;358997;69;753886
76;2020-05-17;0;0;0;308664;263806;79;572470
76;2020-05-17;1;0;1;195838;129272;89;325110
76;2020-05-17;0;1;1;69372;26728;90;96100
76;2020-05-17;3;3;6;3065778;2859080;0;5924858
84;2020-05-17;0;1;1;459549;481088;09;940637
84;2020-05-17;0;0;0;487711;511905;19;999616
84;2020-05-17;0;3;3;443824;451094;29;894918
84;2020-05-17;0;0;0;512522;493262;39;1005784
84;2020-05-17;1;0;1;520248;515106;49;1035354
84;2020-05-17;3;0;3;529611;514848;59;1044459
84;2020-05-17;0;0;0;486720;439940;69;926660
84;2020-05-17;0;2;2;372151;315211;79;687362
84;2020-05-17;0;2;2;237198;150524;89;387722
84;2020-05-17;1;0;1;81185;28680;90;109865
84;2020-05-17;5;8;13;4130719;3901658;0;8032377
93;2020-05-17;0;0;0;268834;283093;09;551927
93;2020-05-17;0;0;0;280751;296087;19;576838
93;2020-05-17;0;0;0;254404;255552;29;509956
93;2020-05-17;0;0;0;310704;288398;39;599102
93;2020-05-17;1;0;1;325559;305827;49;631386
93;2020-05-17;0;1;1;353104;325389;59;678493
93;2020-05-17;0;2;2;336327;296459;69;632786
93;2020-05-17;0;0;0;279820;229699;79;509519
93;2020-05-17;1;1;2;171274;113716;89;284990
93;2020-05-17;0;0;0;58896;21758;90;80654
93;2020-05-17;2;4;6;2639673;2415978;0;5055651
94;2020-05-17;0;0;0;16311;17433;09;33744
94;2020-05-17;0;0;0;16679;18132;19;34811
94;2020-05-17;0;0;0;16782;16579;29;33361
94;2020-05-17;0;0;0;23044;20580;39;43624
94;2020-05-17;0;0;0;23065;22140;49;45205
94;2020-05-17;0;0;0;24549;23421;59;47970
94;2020-05-17;0;0;0;23212;21883;69;45095
94;2020-05-17;0;0;0;19544;17141;79;36685
94;2020-05-17;0;0;0;11227;8178;89;19405
94;2020-05-17;0;0;0;3332;1447;90;4779
94;2020-05-17;0;0;0;177745;166934;0;344679
01;2020-05-18;0;0;0;19979;20155;09;40134
01;2020-05-18;0;0;0;24994;25489;19;50483
01;2020-05-18;0;0;0;17868;16690;29;34558
01;2020-05-18;0;0;0;22328;14821;39;37149
01;2020-05-18;0;0;0;28652;20276;49;48928
01;2020-05-18;0;0;0;33264;27260;59;60524
01;2020-05-18;0;0;0;27135;23978;69;51113
01;2020-05-18;0;0;0;18401;14661;79;33062
01;2020-05-18;0;0;0;9633;6375;89;16008
01;2020-05-18;0;0;0;3410;1510;90;4920
01;2020-05-18;0;0;0;205664;171215;0;376879
02;2020-05-18;0;0;0;16881;17110;09;33991
02;2020-05-18;0;0;0;21410;21604;19;43014
02;2020-05-18;0;0;0;16017;15479;29;31496
02;2020-05-18;0;0;0;19825;14455;39;34280
02;2020-05-18;0;2;2;24719;18248;49;42967
02;2020-05-18;0;0;0;34361;28310;59;62671
02;2020-05-18;0;0;0;28061;24495;69;52556
02;2020-05-18;0;0;0;18231;15278;79;33509
02;2020-05-18;0;0;0;11090;7677;89;18767
02;2020-05-18;0;0;0;3992;1506;90;5498
02;2020-05-18;0;2;2;194587;164162;0;358749
03;2020-05-18;0;0;0;31123;30920;09;62043
03;2020-05-18;0;0;0;29370;29268;19;58638
03;2020-05-18;0;1;1;21458;18963;29;40421
03;2020-05-18;0;0;0;21276;18326;39;39602
03;2020-05-18;0;1;1;18164;16593;49;34757
03;2020-05-18;0;0;0;13469;13557;59;27026
03;2020-05-18;1;0;1;8776;8670;69;17446
03;2020-05-18;0;0;0;3777;3591;79;7368
03;2020-05-18;0;0;0;1649;1072;89;2721
03;2020-05-18;0;0;0;485;184;90;669
03;2020-05-18;1;2;3;149547;141144;0;290691
04;2020-05-18;0;0;0;60314;61377;09;121691
04;2020-05-18;0;0;0;66065;68387;19;134452
04;2020-05-18;0;0;0;51059;47156;29;98215
04;2020-05-18;0;0;0;58788;45780;39;104568
04;2020-05-18;0;0;0;61408;52207;49;113615
04;2020-05-18;0;0;0;64838;60759;59;125597
04;2020-05-18;0;0;0;47008;42843;69;89851
04;2020-05-18;0;0;0;25509;21184;79;46693
04;2020-05-18;0;0;0;13168;7647;89;20815
04;2020-05-18;0;0;0;3209;1253;90;4462
04;2020-05-18;0;0;0;451366;408593;0;859959
05;2020-05-18;0;0;0;362.366008612902;341.338819562748;09;703.704828175651
05;2020-05-18;0;0;0;353.376145114279;370.349735405642;19;723.725880519921
05;2020-05-18;0;0;0;218.593559489256;256.539602589476;29;475.133162078732
05;2020-05-18;0;0;0;404.225408693299;360.321910454353;39;764.547319147651
05;2020-05-18;0;0;0;520.067953604221;497.108383964256;49;1017.17633756848
05;2020-05-18;0;0;0;468.146063921917;510.087601910415;59;978.233665832332
05;2020-05-18;0;0;0;340.368470050554;334.366842191253;69;674.735312241807
05;2020-05-18;0;0;0;212.598666888387;192.597753227106;79;405.196420115493
05;2020-05-18;0;0;0;148.727797095705;61.8681715431829;89;210.595968638888
05;2020-05-18;0;0;0;32.9601271090696;10.9909785719784;90;43.9511056810479
05;2020-05-18;0;0;0;3061.43020057959;2935.56979942041;0;5997
06;2020-05-18;0;0;0;42583;42380;09;84963
06;2020-05-18;1;0;1;33369;31925;19;65294
06;2020-05-18;0;0;0;21571;15080;29;36651
06;2020-05-18;1;0;1;21550;16147;39;37697
06;2020-05-18;0;0;0;14193;13939;49;28132
06;2020-05-18;0;0;0;7171;7597;59;14768
06;2020-05-18;0;0;0;3629;4117;69;7746
06;2020-05-18;0;0;0;1577;1457;79;3034
06;2020-05-18;0;0;0;531;474;89;1005
06;2020-05-18;0;0;0;88;93;90;181
06;2020-05-18;2;0;2;146262;133209;0;279471
07;2020-05-18;0;0;0;485;549;09;1034
07;2020-05-18;0;0;0;403;432;19;835
07;2020-05-18;0;0;0;764;841;29;1605
07;2020-05-18;0;0;0;824;928;39;1752
07;2020-05-18;0;0;0;788;1020;49;1808
07;2020-05-18;0;0;0;678;870;59;1548
07;2020-05-18;0;0;0;360;382;69;742
07;2020-05-18;0;0;0;231;190;79;421
07;2020-05-18;0;0;0;114;67;89;181
07;2020-05-18;0;0;0;24;11;90;35
07;2020-05-18;0;0;0;4671;5290;0;9961
08;2020-05-18;0;0;0;2715.22592983026;2997.75551488675;09;5712.98144471701
08;2020-05-18;0;0;0;2778.51901080978;3160.9156459093;19;5939.43465671908
08;2020-05-18;0;0;0;2080.8882988764;1718.16634315323;29;3799.05464202964
08;2020-05-18;0;0;0;2701.8582062647;1896.52641413317;39;4598.38462039786
08;2020-05-18;0;0;0;3151.45861023308;2460.52498233809;49;5611.98359257117
08;2020-05-18;0;0;0;2620.29868333099;2422.23566154656;59;5042.53434487755
08;2020-05-18;0;0;0;1621.44173420671;1438.58325779464;69;3060.02499200135
08;2020-05-18;0;0;0;626.575909335673;526.358467843651;79;1152.93437717932
08;2020-05-18;0;0;0;205.018522985054;140.993639349697;89;346.012162334751
08;2020-05-18;0;0;0;50.0325684687745;20.62259870351;90;70.6551671722846
08;2020-05-18;0;0;0;18551.3174743414;16782.6825256586;0;35334
11;2020-05-18;5;3;9;783071;811785;09;1594856
11;2020-05-18;8;4;12;761456;784653;19;1546109
11;2020-05-18;16;15;31;850145;801772;29;1651917
11;2020-05-18;22;10;34;914360;843488;39;1757848
11;2020-05-18;18;11;29;845609;826202;49;1671811
11;2020-05-18;17;17;34;793566;745070;59;1538636
11;2020-05-18;13;21;34;628649;549192;69;1177841
11;2020-05-18;16;18;34;434606;358356;79;792962
11;2020-05-18;41;18;59;261425;162933;89;424358
11;2020-05-18;39;6;45;89253;32619;90;121872
11;2020-05-18;195;123;321;6362140;5916070;0;12278210
24;2020-05-18;4;1;5;139720;144686;09;284406
24;2020-05-18;2;0;2;152979;161185;19;314164
24;2020-05-18;7;3;10;122237;126536;29;248773
24;2020-05-18;1;2;3;150359;142009;39;292368
24;2020-05-18;3;3;6;161829;158758;49;320587
24;2020-05-18;1;3;4;172552;168011;59;340563
24;2020-05-18;4;1;5;172509;158177;69;330686
24;2020-05-18;2;4;6;129428;110593;79;240021
24;2020-05-18;5;2;7;87342;56882;89;144224
24;2020-05-18;2;1;3;31210;12071;90;43281
24;2020-05-18;31;20;51;1320165;1238908;0;2559073
27;2020-05-18;0;0;0;143373;149679;09;293052
27;2020-05-18;1;1;2;160962;173003;19;333965
27;2020-05-18;1;1;2;133746;142254;29;276000
27;2020-05-18;1;2;3;160004;155407;39;315411
27;2020-05-18;3;3;6;172333;169564;49;341897
27;2020-05-18;2;2;4;189979;183788;59;373767
27;2020-05-18;3;4;7;192591;178206;69;370797
27;2020-05-18;1;1;2;146876;127546;79;274422
27;2020-05-18;7;5;12;96896;61575;89;158471
27;2020-05-18;3;0;3;33148;12109;90;45257
27;2020-05-18;22;19;41;1429908;1353131;0;2783039
28;2020-05-18;0;0;0;180735;186856;09;367591
28;2020-05-18;1;0;1;200125;213621;19;413746
28;2020-05-18;5;0;5;168922;173007;29;341929
28;2020-05-18;0;0;0;196628;188487;39;385115
28;2020-05-18;0;0;0;205396;201699;49;407095
28;2020-05-18;3;0;3;222002;213866;59;435868
28;2020-05-18;1;1;2;224688;203758;69;428446
28;2020-05-18;0;1;1;163192;135543;79;298735
28;2020-05-18;6;2;8;109691;65377;89;175068
28;2020-05-18;8;0;8;37222;12685;90;49907
28;2020-05-18;24;4;28;1708601;1594899;0;3303500
32;2020-05-18;1;0;1;358062;373689;09;731751
32;2020-05-18;2;1;3;387045;406742;19;793787
32;2020-05-18;9;3;12;342304;348587;29;690891
32;2020-05-18;6;7;13;382485;369972;39;752457
32;2020-05-18;5;6;11;382510;376716;49;759226
32;2020-05-18;10;5;15;386937;376527;59;763464
32;2020-05-18;8;7;15;371211;330938;69;702149
32;2020-05-18;1;5;6;250542;201459;79;452001
32;2020-05-18;10;4;14;163399;89786;89;253185
32;2020-05-18;10;0;10;48384;15367;90;63751
32;2020-05-18;62;38;100;3072879;2889783;0;5962662
44;2020-05-18;1;2;3;291525;306839;09;598364
44;2020-05-18;4;5;9;320255;339504;19;659759
44;2020-05-18;14;8;22;302020;314428;29;616448
44;2020-05-18;3;7;10;342222;333292;39;675514
44;2020-05-18;8;13;21;349727;344491;49;694218
44;2020-05-18;14;6;20;381371;373239;59;754610
44;2020-05-18;11;7;18;367165;335850;69;703015
44;2020-05-18;6;11;17;250387;215436;79;465823
44;2020-05-18;20;8;28;170825;105192;89;276017
44;2020-05-18;13;4;17;51248;16731;90;67979
44;2020-05-18;94;71;165;2826745;2685002;0;5511747
52;2020-05-18;1;2;3;213594;223900;09;437494
52;2020-05-18;1;3;4;240818;255197;19;496015
52;2020-05-18;2;1;4;197010;200630;29;397640
52;2020-05-18;2;3;6;231204;224885;39;456089
52;2020-05-18;2;1;3;243874;243418;49;487292
52;2020-05-18;1;1;2;244100;239116;59;483216
52;2020-05-18;0;1;1;241796;221345;69;463141
52;2020-05-18;5;2;7;177805;149903;79;327708
52;2020-05-18;6;3;9;119561;75822;89;195383
52;2020-05-18;7;3;10;42559;15260;90;57819
52;2020-05-18;27;20;49;1952321;1849476;0;3801797
53;2020-05-18;3;1;4;173813;182358;09;356171
53;2020-05-18;2;1;3;202720;214740;19;417460
53;2020-05-18;5;0;5;163116;173196;29;336312
53;2020-05-18;2;2;4;190526;187674;39;378200
53;2020-05-18;2;2;4;212098;212015;49;424113
53;2020-05-18;2;0;2;223699;219176;59;442875
53;2020-05-18;1;0;1;227435;209274;69;436709
53;2020-05-18;0;0;0;169992;140910;79;310902
53;2020-05-18;0;1;1;118117;69883;89;188000
53;2020-05-18;0;0;0;37370;12267;90;49637
53;2020-05-18;17;7;24;1718886;1621493;0;3340379
75;2020-05-18;2;0;2;293104;305291;09;598395
75;2020-05-18;4;2;6;337141;357785;19;694926
75;2020-05-18;7;3;10;295024;300618;29;595642
75;2020-05-18;5;4;9;347871;331233;39;679104
75;2020-05-18;4;2;6;384742;372771;49;757513
75;2020-05-18;6;3;9;413361;390880;59;804241
75;2020-05-18;0;4;4;425623;384060;69;809683
75;2020-05-18;0;0;0;325086;276298;79;601384
75;2020-05-18;1;4;5;213986;139308;89;353294
75;2020-05-18;1;0;1;77600;28200;90;105800
75;2020-05-18;30;22;52;3113538;2886444;0;5999982
76;2020-05-18;0;0;0;305956;318589;09;624545
76;2020-05-18;1;0;1;338942;356969;19;695911
76;2020-05-18;5;3;8;316210;319570;29;635780
76;2020-05-18;2;5;7;356758;337587;39;694345
76;2020-05-18;2;1;3;376541;363812;49;740353
76;2020-05-18;3;1;4;402608;383750;59;786358
76;2020-05-18;5;1;6;394889;358997;69;753886
76;2020-05-18;5;6;11;308664;263806;79;572470
76;2020-05-18;10;4;14;195838;129272;89;325110
76;2020-05-18;24;7;31;69372;26728;90;96100
76;2020-05-18;57;28;85;3065778;2859080;0;5924858
84;2020-05-18;0;0;1;459549;481088;09;940637
84;2020-05-18;1;2;3;487711;511905;19;999616
84;2020-05-18;3;4;7;443824;451094;29;894918
84;2020-05-18;8;2;10;512522;493262;39;1005784
84;2020-05-18;4;5;9;520248;515106;49;1035354
84;2020-05-18;3;1;4;529611;514848;59;1044459
84;2020-05-18;1;4;5;486720;439940;69;926660
84;2020-05-18;5;2;7;372151;315211;79;687362
84;2020-05-18;9;7;16;237198;150524;89;387722
84;2020-05-18;8;3;11;81185;28680;90;109865
84;2020-05-18;42;30;73;4130719;3901658;0;8032377
93;2020-05-18;3;4;7;268834;283093;09;551927
93;2020-05-18;1;1;2;280751;296087;19;576838
93;2020-05-18;6;3;9;254404;255552;29;509956
93;2020-05-18;4;3;7;310704;288398;39;599102
93;2020-05-18;10;6;16;325559;305827;49;631386
93;2020-05-18;7;7;14;353104;325389;59;678493
93;2020-05-18;5;9;14;336327;296459;69;632786
93;2020-05-18;6;8;14;279820;229699;79;509519
93;2020-05-18;10;4;14;171274;113716;89;284990
93;2020-05-18;19;2;21;58896;21758;90;80654
93;2020-05-18;71;48;119;2639673;2415978;0;5055651
94;2020-05-18;0;0;0;16311;17433;09;33744
94;2020-05-18;1;0;1;16679;18132;19;34811
94;2020-05-18;0;0;0;16782;16579;29;33361
94;2020-05-18;0;0;0;23044;20580;39;43624
94;2020-05-18;1;0;1;23065;22140;49;45205
94;2020-05-18;0;0;0;24549;23421;59;47970
94;2020-05-18;0;0;0;23212;21883;69;45095
94;2020-05-18;0;0;0;19544;17141;79;36685
94;2020-05-18;0;0;0;11227;8178;89;19405
94;2020-05-18;0;0;0;3332;1447;90;4779
94;2020-05-18;2;0;2;177745;166934;0;344679
01;2020-05-19;0;0;0;19979;20155;09;40134
01;2020-05-19;0;0;0;24994;25489;19;50483
01;2020-05-19;0;0;0;17868;16690;29;34558
01;2020-05-19;0;0;0;22328;14821;39;37149
01;2020-05-19;0;0;0;28652;20276;49;48928
01;2020-05-19;0;0;0;33264;27260;59;60524
01;2020-05-19;0;0;0;27135;23978;69;51113
01;2020-05-19;0;0;0;18401;14661;79;33062
01;2020-05-19;0;0;0;9633;6375;89;16008
01;2020-05-19;0;0;0;3410;1510;90;4920
01;2020-05-19;0;0;0;205664;171215;0;376879
02;2020-05-19;0;0;0;16881;17110;09;33991
02;2020-05-19;0;0;0;21410;21604;19;43014
02;2020-05-19;0;0;0;16017;15479;29;31496
02;2020-05-19;0;0;0;19825;14455;39;34280
02;2020-05-19;0;0;0;24719;18248;49;42967
02;2020-05-19;0;0;0;34361;28310;59;62671
02;2020-05-19;0;0;0;28061;24495;69;52556
02;2020-05-19;0;0;0;18231;15278;79;33509
02;2020-05-19;0;0;0;11090;7677;89;18767
02;2020-05-19;0;0;0;3992;1506;90;5498
02;2020-05-19;0;0;0;194587;164162;0;358749
03;2020-05-19;0;0;0;31123;30920;09;62043
03;2020-05-19;0;0;0;29370;29268;19;58638
03;2020-05-19;0;0;0;21458;18963;29;40421
03;2020-05-19;0;0;0;21276;18326;39;39602
03;2020-05-19;0;0;0;18164;16593;49;34757
03;2020-05-19;0;0;0;13469;13557;59;27026
03;2020-05-19;0;0;0;8776;8670;69;17446
03;2020-05-19;0;0;0;3777;3591;79;7368
03;2020-05-19;0;0;0;1649;1072;89;2721
03;2020-05-19;0;0;0;485;184;90;669
03;2020-05-19;0;0;0;149547;141144;0;290691
04;2020-05-19;0;0;0;60314;61377;09;121691
04;2020-05-19;0;0;0;66065;68387;19;134452
04;2020-05-19;0;0;0;51059;47156;29;98215
04;2020-05-19;0;0;0;58788;45780;39;104568
04;2020-05-19;0;0;0;61408;52207;49;113615
04;2020-05-19;0;1;1;64838;60759;59;125597
04;2020-05-19;0;0;0;47008;42843;69;89851
04;2020-05-19;0;0;0;25509;21184;79;46693
04;2020-05-19;0;0;0;13168;7647;89;20815
04;2020-05-19;0;0;0;3209;1253;90;4462
04;2020-05-19;0;1;1;451366;408593;0;859959
05;2020-05-19;0;0;0;362.366008612902;341.338819562748;09;703.704828175651
05;2020-05-19;0;0;0;353.376145114279;370.349735405642;19;723.725880519921
05;2020-05-19;0;0;0;218.593559489256;256.539602589476;29;475.133162078732
05;2020-05-19;0;0;0;404.225408693299;360.321910454353;39;764.547319147651
05;2020-05-19;0;0;0;520.067953604221;497.108383964256;49;1017.17633756848
05;2020-05-19;0;0;0;468.146063921917;510.087601910415;59;978.233665832332
05;2020-05-19;0;0;0;340.368470050554;334.366842191253;69;674.735312241807
05;2020-05-19;0;0;0;212.598666888387;192.597753227106;79;405.196420115493
05;2020-05-19;0;0;0;148.727797095705;61.8681715431829;89;210.595968638888
05;2020-05-19;0;0;0;32.9601271090696;10.9909785719784;90;43.9511056810479
05;2020-05-19;0;0;0;3061.43020057959;2935.56979942041;0;5997
06;2020-05-19;0;0;0;42583;42380;09;84963
06;2020-05-19;0;0;0;33369;31925;19;65294
06;2020-05-19;0;0;0;21571;15080;29;36651
06;2020-05-19;0;0;0;21550;16147;39;37697
06;2020-05-19;0;0;0;14193;13939;49;28132
06;2020-05-19;0;0;0;7171;7597;59;14768
06;2020-05-19;0;0;0;3629;4117;69;7746
06;2020-05-19;0;0;0;1577;1457;79;3034
06;2020-05-19;0;0;0;531;474;89;1005
06;2020-05-19;0;0;0;88;93;90;181
06;2020-05-19;0;0;0;146262;133209;0;279471
07;2020-05-19;0;0;0;485;549;09;1034
07;2020-05-19;0;0;0;403;432;19;835
07;2020-05-19;0;0;0;764;841;29;1605
07;2020-05-19;0;0;0;824;928;39;1752
07;2020-05-19;0;0;0;788;1020;49;1808
07;2020-05-19;0;0;0;678;870;59;1548
07;2020-05-19;0;0;0;360;382;69;742
07;2020-05-19;0;0;0;231;190;79;421
07;2020-05-19;0;0;0;114;67;89;181
07;2020-05-19;0;0;0;24;11;90;35
07;2020-05-19;0;0;0;4671;5290;0;9961
08;2020-05-19;0;0;0;2715.22592983026;2997.75551488675;09;5712.98144471701
08;2020-05-19;0;0;0;2778.51901080978;3160.9156459093;19;5939.43465671908
08;2020-05-19;0;0;0;2080.8882988764;1718.16634315323;29;3799.05464202964
08;2020-05-19;0;0;0;2701.8582062647;1896.52641413317;39;4598.38462039786
08;2020-05-19;0;0;0;3151.45861023308;2460.52498233809;49;5611.98359257117
08;2020-05-19;0;0;0;2620.29868333099;2422.23566154656;59;5042.53434487755
08;2020-05-19;0;0;0;1621.44173420671;1438.58325779464;69;3060.02499200135
08;2020-05-19;0;0;0;626.575909335673;526.358467843651;79;1152.93437717932
08;2020-05-19;0;0;0;205.018522985054;140.993639349697;89;346.012162334751
08;2020-05-19;0;0;0;50.0325684687745;20.62259870351;90;70.6551671722846
08;2020-05-19;0;0;0;18551.3174743414;16782.6825256586;0;35334
11;2020-05-19;1;3;5;783071;811785;09;1594856
11;2020-05-19;11;7;18;761456;784653;19;1546109
11;2020-05-19;15;16;31;850145;801772;29;1651917
11;2020-05-19;24;13;37;914360;843488;39;1757848
11;2020-05-19;13;21;34;845609;826202;49;1671811
11;2020-05-19;12;20;32;793566;745070;59;1538636
11;2020-05-19;14;16;30;628649;549192;69;1177841
11;2020-05-19;16;16;32;434606;358356;79;792962
11;2020-05-19;31;14;45;261425;162933;89;424358
11;2020-05-19;43;2;45;89253;32619;90;121872
11;2020-05-19;180;128;311;6362140;5916070;0;12278210
24;2020-05-19;0;0;0;139720;144686;09;284406
24;2020-05-19;1;0;1;152979;161185;19;314164
24;2020-05-19;1;3;4;122237;126536;29;248773
24;2020-05-19;3;3;6;150359;142009;39;292368
24;2020-05-19;4;3;7;161829;158758;49;320587
24;2020-05-19;8;1;9;172552;168011;59;340563
24;2020-05-19;2;1;3;172509;158177;69;330686
24;2020-05-19;4;1;5;129428;110593;79;240021
24;2020-05-19;1;5;6;87342;56882;89;144224
24;2020-05-19;3;1;4;31210;12071;90;43281
24;2020-05-19;27;18;45;1320165;1238908;0;2559073
27;2020-05-19;0;0;0;143373;149679;09;293052
27;2020-05-19;0;1;1;160962;173003;19;333965
27;2020-05-19;5;1;6;133746;142254;29;276000
27;2020-05-19;1;0;1;160004;155407;39;315411
27;2020-05-19;2;0;2;172333;169564;49;341897
27;2020-05-19;1;0;1;189979;183788;59;373767
27;2020-05-19;4;3;7;192591;178206;69;370797
27;2020-05-19;2;1;3;146876;127546;79;274422
27;2020-05-19;8;2;10;96896;61575;89;158471
27;2020-05-19;7;0;7;33148;12109;90;45257
27;2020-05-19;30;8;38;1429908;1353131;0;2783039
28;2020-05-19;0;1;1;180735;186856;09;367591
28;2020-05-19;0;0;0;200125;213621;19;413746
28;2020-05-19;3;1;4;168922;173007;29;341929
28;2020-05-19;1;0;1;196628;188487;39;385115
28;2020-05-19;1;2;3;205396;201699;49;407095
28;2020-05-19;2;0;2;222002;213866;59;435868
28;2020-05-19;0;2;2;224688;203758;69;428446
28;2020-05-19;1;1;2;163192;135543;79;298735
28;2020-05-19;1;1;2;109691;65377;89;175068
28;2020-05-19;3;0;3;37222;12685;90;49907
28;2020-05-19;12;8;20;1708601;1594899;0;3303500
32;2020-05-19;0;1;1;358062;373689;09;731751
32;2020-05-19;2;1;3;387045;406742;19;793787
32;2020-05-19;8;5;13;342304;348587;29;690891
32;2020-05-19;9;2;11;382485;369972;39;752457
32;2020-05-19;15;4;19;382510;376716;49;759226
32;2020-05-19;10;6;16;386937;376527;59;763464
32;2020-05-19;7;6;13;371211;330938;69;702149
32;2020-05-19;6;7;13;250542;201459;79;452001
32;2020-05-19;10;6;16;163399;89786;89;253185
32;2020-05-19;21;4;25;48384;15367;90;63751
32;2020-05-19;88;42;130;3072879;2889783;0;5962662
44;2020-05-19;2;2;4;291525;306839;09;598364
44;2020-05-19;5;1;7;320255;339504;19;659759
44;2020-05-19;12;3;15;302020;314428;29;616448
44;2020-05-19;6;2;8;342222;333292;39;675514
44;2020-05-19;10;8;18;349727;344491;49;694218
44;2020-05-19;12;8;20;381371;373239;59;754610
44;2020-05-19;8;7;15;367165;335850;69;703015
44;2020-05-19;3;7;10;250387;215436;79;465823
44;2020-05-19;13;6;19;170825;105192;89;276017
44;2020-05-19;17;7;24;51248;16731;90;67979
44;2020-05-19;88;51;140;2826745;2685002;0;5511747
52;2020-05-19;0;0;0;213594;223900;09;437494
52;2020-05-19;2;1;3;240818;255197;19;496015
52;2020-05-19;6;1;7;197010;200630;29;397640
52;2020-05-19;4;3;8;231204;224885;39;456089
52;2020-05-19;1;2;3;243874;243418;49;487292
52;2020-05-19;4;2;6;244100;239116;59;483216
52;2020-05-19;1;1;3;241796;221345;69;463141
52;2020-05-19;2;0;2;177805;149903;79;327708
52;2020-05-19;2;3;5;119561;75822;89;195383
52;2020-05-19;3;2;5;42559;15260;90;57819
52;2020-05-19;25;15;42;1952321;1849476;0;3801797
53;2020-05-19;1;1;2;173813;182358;09;356171
53;2020-05-19;0;0;0;202720;214740;19;417460
53;2020-05-19;0;4;4;163116;173196;29;336312
53;2020-05-19;7;8;15;190526;187674;39;378200
53;2020-05-19;9;10;19;212098;212015;49;424113
53;2020-05-19;4;8;12;223699;219176;59;442875
53;2020-05-19;0;1;1;227435;209274;69;436709
53;2020-05-19;0;1;1;169992;140910;79;310902
53;2020-05-19;0;0;0;118117;69883;89;188000
53;2020-05-19;0;0;0;37370;12267;90;49637
53;2020-05-19;21;33;54;1718886;1621493;0;3340379
75;2020-05-19;0;2;2;293104;305291;09;598395
75;2020-05-19;1;1;2;337141;357785;19;694926
75;2020-05-19;10;6;16;295024;300618;29;595642
75;2020-05-19;5;2;7;347871;331233;39;679104
75;2020-05-19;9;2;11;384742;372771;49;757513
75;2020-05-19;7;3;10;413361;390880;59;804241
75;2020-05-19;8;3;11;425623;384060;69;809683
75;2020-05-19;0;5;5;325086;276298;79;601384
75;2020-05-19;7;4;11;213986;139308;89;353294
75;2020-05-19;2;1;3;77600;28200;90;105800
75;2020-05-19;49;29;78;3113538;2886444;0;5999982
76;2020-05-19;1;1;2;305956;318589;09;624545
76;2020-05-19;1;1;2;338942;356969;19;695911
76;2020-05-19;2;3;5;316210;319570;29;635780
76;2020-05-19;1;8;9;356758;337587;39;694345
76;2020-05-19;3;3;6;376541;363812;49;740353
76;2020-05-19;3;3;6;402608;383750;59;786358
76;2020-05-19;2;1;3;394889;358997;69;753886
76;2020-05-19;4;2;6;308664;263806;79;572470
76;2020-05-19;6;2;8;195838;129272;89;325110
76;2020-05-19;5;3;8;69372;26728;90;96100
76;2020-05-19;28;27;55;3065778;2859080;0;5924858
84;2020-05-19;2;2;4;459549;481088;09;940637
84;2020-05-19;1;1;2;487711;511905;19;999616
84;2020-05-19;1;4;5;443824;451094;29;894918
84;2020-05-19;5;6;12;512522;493262;39;1005784
84;2020-05-19;4;7;11;520248;515106;49;1035354
84;2020-05-19;2;3;5;529611;514848;59;1044459
84;2020-05-19;3;3;6;486720;439940;69;926660
84;2020-05-19;3;2;5;372151;315211;79;687362
84;2020-05-19;6;6;12;237198;150524;89;387722
84;2020-05-19;7;3;10;81185;28680;90;109865
84;2020-05-19;34;37;72;4130719;3901658;0;8032377
93;2020-05-19;0;0;0;268834;283093;09;551927
93;2020-05-19;1;2;3;280751;296087;19;576838
93;2020-05-19;3;2;5;254404;255552;29;509956
93;2020-05-19;4;0;4;310704;288398;39;599102
93;2020-05-19;3;2;5;325559;305827;49;631386
93;2020-05-19;1;4;5;353104;325389;59;678493
93;2020-05-19;2;6;9;336327;296459;69;632786
93;2020-05-19;1;5;6;279820;229699;79;509519
93;2020-05-19;6;3;9;171274;113716;89;284990
93;2020-05-19;8;6;14;58896;21758;90;80654
93;2020-05-19;29;30;60;2639673;2415978;0;5055651
94;2020-05-19;0;0;0;16311;17433;09;33744
94;2020-05-19;0;0;0;16679;18132;19;34811
94;2020-05-19;0;0;0;16782;16579;29;33361
94;2020-05-19;1;1;2;23044;20580;39;43624
94;2020-05-19;1;1;2;23065;22140;49;45205
94;2020-05-19;0;0;0;24549;23421;59;47970
94;2020-05-19;1;0;1;23212;21883;69;45095
94;2020-05-19;1;0;1;19544;17141;79;36685
94;2020-05-19;0;0;0;11227;8178;89;19405
94;2020-05-19;0;0;0;3332;1447;90;4779
94;2020-05-19;4;2;6;177745;166934;0;344679
01;2020-05-20;0;0;0;19979;20155;09;40134
01;2020-05-20;0;0;0;24994;25489;19;50483
01;2020-05-20;0;0;0;17868;16690;29;34558
01;2020-05-20;0;0;0;22328;14821;39;37149
01;2020-05-20;0;0;0;28652;20276;49;48928
01;2020-05-20;0;0;0;33264;27260;59;60524
01;2020-05-20;1;0;1;27135;23978;69;51113
01;2020-05-20;0;0;0;18401;14661;79;33062
01;2020-05-20;0;0;0;9633;6375;89;16008
01;2020-05-20;0;0;0;3410;1510;90;4920
01;2020-05-20;1;0;1;205664;171215;0;376879
02;2020-05-20;2;0;2;16881;17110;09;33991
02;2020-05-20;0;0;0;21410;21604;19;43014
02;2020-05-20;2;0;2;16017;15479;29;31496
02;2020-05-20;0;0;0;19825;14455;39;34280
02;2020-05-20;0;0;0;24719;18248;49;42967
02;2020-05-20;0;0;0;34361;28310;59;62671
02;2020-05-20;0;0;0;28061;24495;69;52556
02;2020-05-20;0;0;0;18231;15278;79;33509
02;2020-05-20;0;0;0;11090;7677;89;18767
02;2020-05-20;0;0;0;3992;1506;90;5498
02;2020-05-20;4;0;4;194587;164162;0;358749
03;2020-05-20;0;0;0;31123;30920;09;62043
03;2020-05-20;0;0;0;29370;29268;19;58638
03;2020-05-20;0;0;0;21458;18963;29;40421
03;2020-05-20;0;0;0;21276;18326;39;39602
03;2020-05-20;0;0;0;18164;16593;49;34757
03;2020-05-20;0;0;0;13469;13557;59;27026
03;2020-05-20;0;0;0;8776;8670;69;17446
03;2020-05-20;0;0;0;3777;3591;79;7368
03;2020-05-20;0;0;0;1649;1072;89;2721
03;2020-05-20;0;0;0;485;184;90;669
03;2020-05-20;0;0;0;149547;141144;0;290691
04;2020-05-20;0;0;0;60314;61377;09;121691
04;2020-05-20;0;0;0;66065;68387;19;134452
04;2020-05-20;0;1;1;51059;47156;29;98215
04;2020-05-20;0;0;0;58788;45780;39;104568
04;2020-05-20;0;0;0;61408;52207;49;113615
04;2020-05-20;0;1;1;64838;60759;59;125597
04;2020-05-20;0;0;0;47008;42843;69;89851
04;2020-05-20;0;0;0;25509;21184;79;46693
04;2020-05-20;0;1;1;13168;7647;89;20815
04;2020-05-20;0;0;0;3209;1253;90;4462
04;2020-05-20;0;3;3;451366;408593;0;859959
05;2020-05-20;0;0;0;362.366008612902;341.338819562748;09;703.704828175651
05;2020-05-20;0;0;0;353.376145114279;370.349735405642;19;723.725880519921
05;2020-05-20;0;0;0;218.593559489256;256.539602589476;29;475.133162078732
05;2020-05-20;0;0;0;404.225408693299;360.321910454353;39;764.547319147651
05;2020-05-20;0;0;0;520.067953604221;497.108383964256;49;1017.17633756848
05;2020-05-20;0;0;0;468.146063921917;510.087601910415;59;978.233665832332
05;2020-05-20;0;0;0;340.368470050554;334.366842191253;69;674.735312241807
05;2020-05-20;0;0;0;212.598666888387;192.597753227106;79;405.196420115493
05;2020-05-20;0;0;0;148.727797095705;61.8681715431829;89;210.595968638888
05;2020-05-20;0;0;0;32.9601271090696;10.9909785719784;90;43.9511056810479
05;2020-05-20;0;0;0;3061.43020057959;2935.56979942041;0;5997
06;2020-05-20;0;0;0;42583;42380;09;84963
06;2020-05-20;0;0;0;33369;31925;19;65294
06;2020-05-20;0;0;0;21571;15080;29;36651
06;2020-05-20;0;0;0;21550;16147;39;37697
06;2020-05-20;1;1;2;14193;13939;49;28132
06;2020-05-20;0;0;0;7171;7597;59;14768
06;2020-05-20;0;0;0;3629;4117;69;7746
06;2020-05-20;0;0;0;1577;1457;79;3034
06;2020-05-20;0;0;0;531;474;89;1005
06;2020-05-20;0;0;0;88;93;90;181
06;2020-05-20;1;1;2;146262;133209;0;279471
07;2020-05-20;0;0;0;485;549;09;1034
07;2020-05-20;0;0;0;403;432;19;835
07;2020-05-20;0;0;0;764;841;29;1605
07;2020-05-20;0;0;0;824;928;39;1752
07;2020-05-20;0;0;0;788;1020;49;1808
07;2020-05-20;0;0;0;678;870;59;1548
07;2020-05-20;0;0;0;360;382;69;742
07;2020-05-20;0;0;0;231;190;79;421
07;2020-05-20;0;0;0;114;67;89;181
07;2020-05-20;0;0;0;24;11;90;35
07;2020-05-20;0;0;0;4671;5290;0;9961
08;2020-05-20;0;0;0;2715.22592983026;2997.75551488675;09;5712.98144471701
08;2020-05-20;0;0;0;2778.51901080978;3160.9156459093;19;5939.43465671908
08;2020-05-20;0;0;0;2080.8882988764;1718.16634315323;29;3799.05464202964
08;2020-05-20;0;0;0;2701.8582062647;1896.52641413317;39;4598.38462039786
08;2020-05-20;0;0;0;3151.45861023308;2460.52498233809;49;5611.98359257117
08;2020-05-20;0;0;0;2620.29868333099;2422.23566154656;59;5042.53434487755
08;2020-05-20;0;0;0;1621.44173420671;1438.58325779464;69;3060.02499200135
08;2020-05-20;0;0;0;626.575909335673;526.358467843651;79;1152.93437717932
08;2020-05-20;0;0;0;205.018522985054;140.993639349697;89;346.012162334751
08;2020-05-20;0;0;0;50.0325684687745;20.62259870351;90;70.6551671722846
08;2020-05-20;0;0;0;18551.3174743414;16782.6825256586;0;35334
11;2020-05-20;3;1;4;783071;811785;09;1594856
11;2020-05-20;4;3;7;761456;784653;19;1546109
11;2020-05-20;12;20;32;850145;801772;29;1651917
11;2020-05-20;12;15;27;914360;843488;39;1757848
11;2020-05-20;23;15;39;845609;826202;49;1671811
11;2020-05-20;23;21;44;793566;745070;59;1538636
11;2020-05-20;14;15;29;628649;549192;69;1177841
11;2020-05-20;7;9;16;434606;358356;79;792962
11;2020-05-20;41;11;52;261425;162933;89;424358
11;2020-05-20;29;11;41;89253;32619;90;121872
11;2020-05-20;168;121;291;6362140;5916070;0;12278210
24;2020-05-20;2;1;3;139720;144686;09;284406
24;2020-05-20;6;3;9;152979;161185;19;314164
24;2020-05-20;4;4;8;122237;126536;29;248773
24;2020-05-20;1;6;7;150359;142009;39;292368
24;2020-05-20;7;2;9;161829;158758;49;320587
24;2020-05-20;1;5;6;172552;168011;59;340563
24;2020-05-20;0;0;0;172509;158177;69;330686
24;2020-05-20;3;1;4;129428;110593;79;240021
24;2020-05-20;4;1;5;87342;56882;89;144224
24;2020-05-20;2;0;2;31210;12071;90;43281
24;2020-05-20;30;23;53;1320165;1238908;0;2559073
27;2020-05-20;0;0;0;143373;149679;09;293052
27;2020-05-20;1;1;2;160962;173003;19;333965
27;2020-05-20;5;1;6;133746;142254;29;276000
27;2020-05-20;1;0;1;160004;155407;39;315411
27;2020-05-20;7;1;8;172333;169564;49;341897
27;2020-05-20;1;4;5;189979;183788;59;373767
27;2020-05-20;1;1;2;192591;178206;69;370797
27;2020-05-20;2;2;4;146876;127546;79;274422
27;2020-05-20;1;0;1;96896;61575;89;158471
27;2020-05-20;1;0;1;33148;12109;90;45257
27;2020-05-20;20;10;30;1429908;1353131;0;2783039
28;2020-05-20;0;0;0;180735;186856;09;367591
28;2020-05-20;0;0;0;200125;213621;19;413746
28;2020-05-20;0;1;1;168922;173007;29;341929
28;2020-05-20;2;1;3;196628;188487;39;385115
28;2020-05-20;1;0;1;205396;201699;49;407095
28;2020-05-20;0;1;1;222002;213866;59;435868
28;2020-05-20;0;3;3;224688;203758;69;428446
28;2020-05-20;1;0;1;163192;135543;79;298735
28;2020-05-20;0;0;0;109691;65377;89;175068
28;2020-05-20;2;1;3;37222;12685;90;49907
28;2020-05-20;6;7;13;1708601;1594899;0;3303500
32;2020-05-20;1;2;3;358062;373689;09;731751
32;2020-05-20;6;1;7;387045;406742;19;793787
32;2020-05-20;9;3;12;342304;348587;29;690891
32;2020-05-20;9;7;16;382485;369972;39;752457
32;2020-05-20;13;8;21;382510;376716;49;759226
32;2020-05-20;7;11;18;386937;376527;59;763464
32;2020-05-20;3;7;10;371211;330938;69;702149
32;2020-05-20;6;3;9;250542;201459;79;452001
32;2020-05-20;5;9;14;163399;89786;89;253185
32;2020-05-20;7;1;8;48384;15367;90;63751
32;2020-05-20;66;52;118;3072879;2889783;0;5962662
44;2020-05-20;3;2;5;291525;306839;09;598364
44;2020-05-20;10;5;15;320255;339504;19;659759
44;2020-05-20;10;8;18;302020;314428;29;616448
44;2020-05-20;11;7;18;342222;333292;39;675514
44;2020-05-20;14;10;24;349727;344491;49;694218
44;2020-05-20;17;10;27;381371;373239;59;754610
44;2020-05-20;14;8;22;367165;335850;69;703015
44;2020-05-20;8;11;19;250387;215436;79;465823
44;2020-05-20;25;10;35;170825;105192;89;276017
44;2020-05-20;11;1;12;51248;16731;90;67979
44;2020-05-20;123;72;195;2826745;2685002;0;5511747
52;2020-05-20;3;0;4;213594;223900;09;437494
52;2020-05-20;0;3;3;240818;255197;19;496015
52;2020-05-20;4;5;9;197010;200630;29;397640
52;2020-05-20;8;3;11;231204;224885;39;456089
52;2020-05-20;2;5;7;243874;243418;49;487292
52;2020-05-20;9;4;13;244100;239116;59;483216
52;2020-05-20;0;4;4;241796;221345;69;463141
52;2020-05-20;1;1;2;177805;149903;79;327708
52;2020-05-20;2;3;5;119561;75822;89;195383
52;2020-05-20;3;3;6;42559;15260;90;57819
52;2020-05-20;32;31;64;1952321;1849476;0;3801797
53;2020-05-20;1;0;1;173813;182358;09;356171
53;2020-05-20;1;1;2;202720;214740;19;417460
53;2020-05-20;4;1;5;163116;173196;29;336312
53;2020-05-20;6;6;12;190526;187674;39;378200
53;2020-05-20;4;1;5;212098;212015;49;424113
53;2020-05-20;2;4;6;223699;219176;59;442875
53;2020-05-20;2;0;2;227435;209274;69;436709
53;2020-05-20;0;1;1;169992;140910;79;310902
53;2020-05-20;2;0;2;118117;69883;89;188000
53;2020-05-20;2;0;2;37370;12267;90;49637
53;2020-05-20;24;14;38;1718886;1621493;0;3340379
75;2020-05-20;0;1;1;293104;305291;09;598395
75;2020-05-20;6;0;6;337141;357785;19;694926
75;2020-05-20;4;3;7;295024;300618;29;595642
75;2020-05-20;11;5;17;347871;331233;39;679104
75;2020-05-20;1;4;5;384742;372771;49;757513
75;2020-05-20;4;6;10;413361;390880;59;804241
75;2020-05-20;0;3;3;425623;384060;69;809683
75;2020-05-20;3;4;7;325086;276298;79;601384
75;2020-05-20;2;0;2;213986;139308;89;353294
75;2020-05-20;2;1;3;77600;28200;90;105800
75;2020-05-20;33;27;61;3113538;2886444;0;5999982
76;2020-05-20;0;1;1;305956;318589;09;624545
76;2020-05-20;2;0;2;338942;356969;19;695911
76;2020-05-20;1;1;2;316210;319570;29;635780
76;2020-05-20;2;1;3;356758;337587;39;694345
76;2020-05-20;3;3;6;376541;363812;49;740353
76;2020-05-20;4;1;5;402608;383750;59;786358
76;2020-05-20;0;2;2;394889;358997;69;753886
76;2020-05-20;2;5;7;308664;263806;79;572470
76;2020-05-20;6;5;11;195838;129272;89;325110
76;2020-05-20;8;3;11;69372;26728;90;96100
76;2020-05-20;28;22;51;3065778;2859080;0;5924858
84;2020-05-20;0;1;1;459549;481088;09;940637
84;2020-05-20;0;4;4;487711;511905;19;999616
84;2020-05-20;5;4;9;443824;451094;29;894918
84;2020-05-20;3;7;10;512522;493262;39;1005784
84;2020-05-20;5;4;9;520248;515106;49;1035354
84;2020-05-20;7;2;9;529611;514848;59;1044459
84;2020-05-20;2;1;3;486720;439940;69;926660
84;2020-05-20;1;3;4;372151;315211;79;687362
84;2020-05-20;6;2;8;237198;150524;89;387722
84;2020-05-20;2;1;3;81185;28680;90;109865
84;2020-05-20;31;29;60;4130719;3901658;0;8032377
93;2020-05-20;1;1;2;268834;283093;09;551927
93;2020-05-20;2;0;2;280751;296087;19;576838
93;2020-05-20;4;0;5;254404;255552;29;509956
93;2020-05-20;2;3;5;310704;288398;39;599102
93;2020-05-20;5;2;8;325559;305827;49;631386
93;2020-05-20;7;3;10;353104;325389;59;678493
93;2020-05-20;2;1;3;336327;296459;69;632786
93;2020-05-20;2;4;6;279820;229699;79;509519
93;2020-05-20;9;4;13;171274;113716;89;284990
93;2020-05-20;6;1;7;58896;21758;90;80654
93;2020-05-20;40;19;61;2639673;2415978;0;5055651
94;2020-05-20;0;0;0;16311;17433;09;33744
94;2020-05-20;0;0;0;16679;18132;19;34811
94;2020-05-20;0;0;0;16782;16579;29;33361
94;2020-05-20;0;1;1;23044;20580;39;43624
94;2020-05-20;1;0;1;23065;22140;49;45205
94;2020-05-20;0;1;1;24549;23421;59;47970
94;2020-05-20;0;0;0;23212;21883;69;45095
94;2020-05-20;0;0;0;19544;17141;79;36685
94;2020-05-20;0;0;0;11227;8178;89;19405
94;2020-05-20;0;0;0;3332;1447;90;4779
94;2020-05-20;1;2;3;177745;166934;0;344679
01;2020-05-21;0;0;0;19979;20155;09;40134
01;2020-05-21;0;0;0;24994;25489;19;50483
01;2020-05-21;1;0;1;17868;16690;29;34558
01;2020-05-21;0;0;0;22328;14821;39;37149
01;2020-05-21;0;0;0;28652;20276;49;48928
01;2020-05-21;0;1;1;33264;27260;59;60524
01;2020-05-21;0;0;0;27135;23978;69;51113
01;2020-05-21;0;0;0;18401;14661;79;33062
01;2020-05-21;0;0;0;9633;6375;89;16008
01;2020-05-21;0;0;0;3410;1510;90;4920
01;2020-05-21;1;1;2;205664;171215;0;376879
02;2020-05-21;0;0;0;16881;17110;09;33991
02;2020-05-21;0;0;0;21410;21604;19;43014
02;2020-05-21;0;0;0;16017;15479;29;31496
02;2020-05-21;0;0;0;19825;14455;39;34280
02;2020-05-21;0;0;0;24719;18248;49;42967
02;2020-05-21;0;0;0;34361;28310;59;62671
02;2020-05-21;0;0;0;28061;24495;69;52556
02;2020-05-21;0;0;0;18231;15278;79;33509
02;2020-05-21;0;0;0;11090;7677;89;18767
02;2020-05-21;0;0;0;3992;1506;90;5498
02;2020-05-21;0;0;0;194587;164162;0;358749
03;2020-05-21;0;0;0;31123;30920;09;62043
03;2020-05-21;0;3;3;29370;29268;19;58638
03;2020-05-21;1;6;7;21458;18963;29;40421
03;2020-05-21;1;2;3;21276;18326;39;39602
03;2020-05-21;0;1;1;18164;16593;49;34757
03;2020-05-21;0;0;0;13469;13557;59;27026
03;2020-05-21;0;1;1;8776;8670;69;17446
03;2020-05-21;0;0;0;3777;3591;79;7368
03;2020-05-21;0;0;0;1649;1072;89;2721
03;2020-05-21;0;0;0;485;184;90;669
03;2020-05-21;2;13;15;149547;141144;0;290691
04;2020-05-21;0;0;0;60314;61377;09;121691
04;2020-05-21;0;0;0;66065;68387;19;134452
04;2020-05-21;0;0;0;51059;47156;29;98215
04;2020-05-21;0;0;0;58788;45780;39;104568
04;2020-05-21;0;0;0;61408;52207;49;113615
04;2020-05-21;0;0;0;64838;60759;59;125597
04;2020-05-21;0;0;0;47008;42843;69;89851
04;2020-05-21;0;0;0;25509;21184;79;46693
04;2020-05-21;0;0;0;13168;7647;89;20815
04;2020-05-21;0;0;0;3209;1253;90;4462
04;2020-05-21;0;0;0;451366;408593;0;859959
05;2020-05-21;0;0;0;362.366008612902;341.338819562748;09;703.704828175651
05;2020-05-21;0;0;0;353.376145114279;370.349735405642;19;723.725880519921
05;2020-05-21;0;0;0;218.593559489256;256.539602589476;29;475.133162078732
05;2020-05-21;0;0;0;404.225408693299;360.321910454353;39;764.547319147651
05;2020-05-21;0;0;0;520.067953604221;497.108383964256;49;1017.17633756848
05;2020-05-21;0;0;0;468.146063921917;510.087601910415;59;978.233665832332
05;2020-05-21;0;0;0;340.368470050554;334.366842191253;69;674.735312241807
05;2020-05-21;0;0;0;212.598666888387;192.597753227106;79;405.196420115493
05;2020-05-21;0;0;0;148.727797095705;61.8681715431829;89;210.595968638888
05;2020-05-21;0;0;0;32.9601271090696;10.9909785719784;90;43.9511056810479
05;2020-05-21;0;0;0;3061.43020057959;2935.56979942041;0;5997
06;2020-05-21;0;0;0;42583;42380;09;84963
06;2020-05-21;0;0;0;33369;31925;19;65294
06;2020-05-21;0;0;0;21571;15080;29;36651
06;2020-05-21;0;0;0;21550;16147;39;37697
06;2020-05-21;0;0;0;14193;13939;49;28132
06;2020-05-21;0;0;0;7171;7597;59;14768
06;2020-05-21;0;0;0;3629;4117;69;7746
06;2020-05-21;0;0;0;1577;1457;79;3034
06;2020-05-21;0;0;0;531;474;89;1005
06;2020-05-21;0;0;0;88;93;90;181
06;2020-05-21;0;0;0;146262;133209;0;279471
07;2020-05-21;0;0;0;485;549;09;1034
07;2020-05-21;0;0;0;403;432;19;835
07;2020-05-21;0;0;0;764;841;29;1605
07;2020-05-21;0;0;0;824;928;39;1752
07;2020-05-21;0;0;0;788;1020;49;1808
07;2020-05-21;0;0;0;678;870;59;1548
07;2020-05-21;0;0;0;360;382;69;742
07;2020-05-21;0;0;0;231;190;79;421
07;2020-05-21;0;0;0;114;67;89;181
07;2020-05-21;0;0;0;24;11;90;35
07;2020-05-21;0;0;0;4671;5290;0;9961
08;2020-05-21;0;0;0;2715.22592983026;2997.75551488675;09;5712.98144471701
08;2020-05-21;0;0;0;2778.51901080978;3160.9156459093;19;5939.43465671908
08;2020-05-21;0;0;0;2080.8882988764;1718.16634315323;29;3799.05464202964
08;2020-05-21;0;0;0;2701.8582062647;1896.52641413317;39;4598.38462039786
08;2020-05-21;0;0;0;3151.45861023308;2460.52498233809;49;5611.98359257117
08;2020-05-21;0;0;0;2620.29868333099;2422.23566154656;59;5042.53434487755
08;2020-05-21;0;0;0;1621.44173420671;1438.58325779464;69;3060.02499200135
08;2020-05-21;0;0;0;626.575909335673;526.358467843651;79;1152.93437717932
08;2020-05-21;0;0;0;205.018522985054;140.993639349697;89;346.012162334751
08;2020-05-21;0;0;0;50.0325684687745;20.62259870351;90;70.6551671722846
08;2020-05-21;0;0;0;18551.3174743414;16782.6825256586;0;35334
11;2020-05-21;2;0;2;783071;811785;09;1594856
11;2020-05-21;0;3;3;761456;784653;19;1546109
11;2020-05-21;4;1;5;850145;801772;29;1651917
11;2020-05-21;3;0;3;914360;843488;39;1757848
11;2020-05-21;4;1;5;845609;826202;49;1671811
11;2020-05-21;0;1;1;793566;745070;59;1538636
11;2020-05-21;1;2;3;628649;549192;69;1177841
11;2020-05-21;0;5;5;434606;358356;79;792962
11;2020-05-21;2;5;7;261425;162933;89;424358
11;2020-05-21;7;0;7;89253;32619;90;121872
11;2020-05-21;23;18;41;6362140;5916070;0;12278210
24;2020-05-21;0;2;2;139720;144686;09;284406
24;2020-05-21;0;0;0;152979;161185;19;314164
24;2020-05-21;0;2;2;122237;126536;29;248773
24;2020-05-21;1;0;1;150359;142009;39;292368
24;2020-05-21;1;0;1;161829;158758;49;320587
24;2020-05-21;1;1;2;172552;168011;59;340563
24;2020-05-21;0;0;0;172509;158177;69;330686
24;2020-05-21;0;1;1;129428;110593;79;240021
24;2020-05-21;2;0;2;87342;56882;89;144224
24;2020-05-21;0;0;0;31210;12071;90;43281
24;2020-05-21;5;6;11;1320165;1238908;0;2559073
27;2020-05-21;0;0;0;143373;149679;09;293052
27;2020-05-21;0;0;0;160962;173003;19;333965
27;2020-05-21;0;0;0;133746;142254;29;276000
27;2020-05-21;0;0;0;160004;155407;39;315411
27;2020-05-21;0;0;0;172333;169564;49;341897
27;2020-05-21;0;0;0;189979;183788;59;373767
27;2020-05-21;0;0;0;192591;178206;69;370797
27;2020-05-21;2;3;5;146876;127546;79;274422
27;2020-05-21;0;0;0;96896;61575;89;158471
27;2020-05-21;0;0;0;33148;12109;90;45257
27;2020-05-21;2;3;5;1429908;1353131;0;2783039
28;2020-05-21;0;0;0;180735;186856;09;367591
28;2020-05-21;0;0;0;200125;213621;19;413746
28;2020-05-21;0;1;1;168922;173007;29;341929
28;2020-05-21;0;0;0;196628;188487;39;385115
28;2020-05-21;0;0;0;205396;201699;49;407095
28;2020-05-21;0;0;0;222002;213866;59;435868
28;2020-05-21;0;0;0;224688;203758;69;428446
28;2020-05-21;0;0;0;163192;135543;79;298735
28;2020-05-21;0;1;1;109691;65377;89;175068
28;2020-05-21;1;2;3;37222;12685;90;49907
28;2020-05-21;1;4;5;1708601;1594899;0;3303500
32;2020-05-21;0;1;1;358062;373689;09;731751
32;2020-05-21;1;0;1;387045;406742;19;793787
32;2020-05-21;0;0;0;342304;348587;29;690891
32;2020-05-21;0;0;0;382485;369972;39;752457
32;2020-05-21;2;0;2;382510;376716;49;759226
32;2020-05-21;0;0;0;386937;376527;59;763464
32;2020-05-21;1;1;2;371211;330938;69;702149
32;2020-05-21;4;1;5;250542;201459;79;452001
32;2020-05-21;5;0;5;163399;89786;89;253185
32;2020-05-21;3;3;6;48384;15367;90;63751
32;2020-05-21;16;6;22;3072879;2889783;0;5962662
44;2020-05-21;0;0;0;291525;306839;09;598364
44;2020-05-21;0;0;0;320255;339504;19;659759
44;2020-05-21;0;1;1;302020;314428;29;616448
44;2020-05-21;1;0;1;342222;333292;39;675514
44;2020-05-21;2;1;3;349727;344491;49;694218
44;2020-05-21;0;1;1;381371;373239;59;754610
44;2020-05-21;1;4;5;367165;335850;69;703015
44;2020-05-21;0;2;2;250387;215436;79;465823
44;2020-05-21;3;2;5;170825;105192;89;276017
44;2020-05-21;1;3;4;51248;16731;90;67979
44;2020-05-21;8;14;22;2826745;2685002;0;5511747
52;2020-05-21;0;0;0;213594;223900;09;437494
52;2020-05-21;1;0;1;240818;255197;19;496015
52;2020-05-21;1;2;3;197010;200630;29;397640
52;2020-05-21;2;1;3;231204;224885;39;456089
52;2020-05-21;1;1;2;243874;243418;49;487292
52;2020-05-21;2;0;2;244100;239116;59;483216
52;2020-05-21;0;3;3;241796;221345;69;463141
52;2020-05-21;1;1;2;177805;149903;79;327708
52;2020-05-21;1;1;2;119561;75822;89;195383
52;2020-05-21;0;0;0;42559;15260;90;57819
52;2020-05-21;9;9;18;1952321;1849476;0;3801797
53;2020-05-21;1;1;2;173813;182358;09;356171
53;2020-05-21;2;1;3;202720;214740;19;417460
53;2020-05-21;2;1;3;163116;173196;29;336312
53;2020-05-21;4;2;6;190526;187674;39;378200
53;2020-05-21;2;0;2;212098;212015;49;424113
53;2020-05-21;3;4;7;223699;219176;59;442875
53;2020-05-21;0;0;0;227435;209274;69;436709
53;2020-05-21;1;0;1;169992;140910;79;310902
53;2020-05-21;1;1;2;118117;69883;89;188000
53;2020-05-21;1;0;1;37370;12267;90;49637
53;2020-05-21;17;10;27;1718886;1621493;0;3340379
75;2020-05-21;1;0;1;293104;305291;09;598395
75;2020-05-21;0;0;0;337141;357785;19;694926
75;2020-05-21;0;0;0;295024;300618;29;595642
75;2020-05-21;0;0;0;347871;331233;39;679104
75;2020-05-21;0;0;0;384742;372771;49;757513
75;2020-05-21;0;0;0;413361;390880;59;804241
75;2020-05-21;0;0;0;425623;384060;69;809683
75;2020-05-21;0;0;0;325086;276298;79;601384
75;2020-05-21;0;0;0;213986;139308;89;353294
75;2020-05-21;0;0;0;77600;28200;90;105800
75;2020-05-21;1;0;1;3113538;2886444;0;5999982
76;2020-05-21;0;0;0;305956;318589;09;624545
76;2020-05-21;0;0;0;338942;356969;19;695911
76;2020-05-21;0;0;0;316210;319570;29;635780
76;2020-05-21;0;0;0;356758;337587;39;694345
76;2020-05-21;0;1;1;376541;363812;49;740353
76;2020-05-21;0;0;0;402608;383750;59;786358
76;2020-05-21;0;0;0;394889;358997;69;753886
76;2020-05-21;0;0;0;308664;263806;79;572470
76;2020-05-21;0;0;0;195838;129272;89;325110
76;2020-05-21;0;0;0;69372;26728;90;96100
76;2020-05-21;0;1;1;3065778;2859080;0;5924858
84;2020-05-21;0;0;0;459549;481088;09;940637
84;2020-05-21;1;0;1;487711;511905;19;999616
84;2020-05-21;1;0;1;443824;451094;29;894918
84;2020-05-21;1;1;2;512522;493262;39;1005784
84;2020-05-21;0;0;0;520248;515106;49;1035354
84;2020-05-21;1;1;2;529611;514848;59;1044459
84;2020-05-21;0;0;0;486720;439940;69;926660
84;2020-05-21;2;1;3;372151;315211;79;687362
84;2020-05-21;3;0;3;237198;150524;89;387722
84;2020-05-21;3;0;3;81185;28680;90;109865
84;2020-05-21;12;3;15;4130719;3901658;0;8032377
93;2020-05-21;0;0;0;268834;283093;09;551927
93;2020-05-21;0;0;0;280751;296087;19;576838
93;2020-05-21;0;0;0;254404;255552;29;509956
93;2020-05-21;0;0;0;310704;288398;39;599102
93;2020-05-21;0;1;1;325559;305827;49;631386
93;2020-05-21;0;1;1;353104;325389;59;678493
93;2020-05-21;1;0;1;336327;296459;69;632786
93;2020-05-21;2;1;3;279820;229699;79;509519
93;2020-05-21;2;0;2;171274;113716;89;284990
93;2020-05-21;1;0;1;58896;21758;90;80654
93;2020-05-21;6;3;9;2639673;2415978;0;5055651
94;2020-05-21;0;0;0;16311;17433;09;33744
94;2020-05-21;0;0;0;16679;18132;19;34811
94;2020-05-21;0;0;0;16782;16579;29;33361
94;2020-05-21;0;0;0;23044;20580;39;43624
94;2020-05-21;0;0;0;23065;22140;49;45205
94;2020-05-21;0;0;0;24549;23421;59;47970
94;2020-05-21;0;0;0;23212;21883;69;45095
94;2020-05-21;0;0;0;19544;17141;79;36685
94;2020-05-21;0;0;0;11227;8178;89;19405
94;2020-05-21;0;0;0;3332;1447;90;4779
94;2020-05-21;0;0;0;177745;166934;0;344679
01;2020-05-22;0;0;0;19979;20155;09;40134
01;2020-05-22;0;0;0;24994;25489;19;50483
01;2020-05-22;0;0;0;17868;16690;29;34558
01;2020-05-22;1;0;1;22328;14821;39;37149
01;2020-05-22;1;0;1;28652;20276;49;48928
01;2020-05-22;0;0;0;33264;27260;59;60524
01;2020-05-22;1;0;1;27135;23978;69;51113
01;2020-05-22;0;0;0;18401;14661;79;33062
01;2020-05-22;0;0;0;9633;6375;89;16008
01;2020-05-22;0;0;0;3410;1510;90;4920
01;2020-05-22;3;0;3;205664;171215;0;376879
02;2020-05-22;0;0;0;16881;17110;09;33991
02;2020-05-22;0;0;0;21410;21604;19;43014
02;2020-05-22;0;0;0;16017;15479;29;31496
02;2020-05-22;0;0;0;19825;14455;39;34280
02;2020-05-22;0;0;0;24719;18248;49;42967
02;2020-05-22;0;0;0;34361;28310;59;62671
02;2020-05-22;0;0;0;28061;24495;69;52556
02;2020-05-22;0;0;0;18231;15278;79;33509
02;2020-05-22;0;0;0;11090;7677;89;18767
02;2020-05-22;0;0;0;3992;1506;90;5498
02;2020-05-22;0;0;0;194587;164162;0;358749
03;2020-05-22;0;2;2;31123;30920;09;62043
03;2020-05-22;0;1;1;29370;29268;19;58638
03;2020-05-22;3;2;5;21458;18963;29;40421
03;2020-05-22;4;2;7;21276;18326;39;39602
03;2020-05-22;3;4;7;18164;16593;49;34757
03;2020-05-22;0;0;0;13469;13557;59;27026
03;2020-05-22;0;0;0;8776;8670;69;17446
03;2020-05-22;1;0;1;3777;3591;79;7368
03;2020-05-22;0;0;0;1649;1072;89;2721
03;2020-05-22;0;0;0;485;184;90;669
03;2020-05-22;11;11;23;149547;141144;0;290691
04;2020-05-22;0;0;0;60314;61377;09;121691
04;2020-05-22;0;0;0;66065;68387;19;134452
04;2020-05-22;0;0;0;51059;47156;29;98215
04;2020-05-22;0;0;0;58788;45780;39;104568
04;2020-05-22;0;1;1;61408;52207;49;113615
04;2020-05-22;1;0;1;64838;60759;59;125597
04;2020-05-22;0;0;0;47008;42843;69;89851
04;2020-05-22;0;0;0;25509;21184;79;46693
04;2020-05-22;0;0;0;13168;7647;89;20815
04;2020-05-22;0;0;0;3209;1253;90;4462
04;2020-05-22;1;1;2;451366;408593;0;859959
05;2020-05-22;0;0;0;362.366008612902;341.338819562748;09;703.704828175651
05;2020-05-22;0;0;0;353.376145114279;370.349735405642;19;723.725880519921
05;2020-05-22;0;0;0;218.593559489256;256.539602589476;29;475.133162078732
05;2020-05-22;0;0;0;404.225408693299;360.321910454353;39;764.547319147651
05;2020-05-22;0;0;0;520.067953604221;497.108383964256;49;1017.17633756848
05;2020-05-22;0;0;0;468.146063921917;510.087601910415;59;978.233665832332
05;2020-05-22;0;0;0;340.368470050554;334.366842191253;69;674.735312241807
05;2020-05-22;0;0;0;212.598666888387;192.597753227106;79;405.196420115493
05;2020-05-22;0;0;0;148.727797095705;61.8681715431829;89;210.595968638888
05;2020-05-22;0;0;0;32.9601271090696;10.9909785719784;90;43.9511056810479
05;2020-05-22;0;0;0;3061.43020057959;2935.56979942041;0;5997
06;2020-05-22;0;0;0;42583;42380;09;84963
06;2020-05-22;0;1;1;33369;31925;19;65294
06;2020-05-22;0;0;0;21571;15080;29;36651
06;2020-05-22;0;0;0;21550;16147;39;37697
06;2020-05-22;0;0;0;14193;13939;49;28132
06;2020-05-22;0;0;0;7171;7597;59;14768
06;2020-05-22;0;0;0;3629;4117;69;7746
06;2020-05-22;0;0;0;1577;1457;79;3034
06;2020-05-22;0;0;0;531;474;89;1005
06;2020-05-22;0;0;0;88;93;90;181
06;2020-05-22;0;1;1;146262;133209;0;279471
07;2020-05-22;0;0;0;485;549;09;1034
07;2020-05-22;0;0;0;403;432;19;835
07;2020-05-22;0;0;0;764;841;29;1605
07;2020-05-22;0;0;0;824;928;39;1752
07;2020-05-22;0;0;0;788;1020;49;1808
07;2020-05-22;0;0;0;678;870;59;1548
07;2020-05-22;0;0;0;360;382;69;742
07;2020-05-22;0;0;0;231;190;79;421
07;2020-05-22;0;0;0;114;67;89;181
07;2020-05-22;0;0;0;24;11;90;35
07;2020-05-22;0;0;0;4671;5290;0;9961
08;2020-05-22;0;0;0;2715.22592983026;2997.75551488675;09;5712.98144471701
08;2020-05-22;0;0;0;2778.51901080978;3160.9156459093;19;5939.43465671908
08;2020-05-22;1;0;1;2080.8882988764;1718.16634315323;29;3799.05464202964
08;2020-05-22;0;0;0;2701.8582062647;1896.52641413317;39;4598.38462039786
08;2020-05-22;0;0;0;3151.45861023308;2460.52498233809;49;5611.98359257117
08;2020-05-22;0;0;0;2620.29868333099;2422.23566154656;59;5042.53434487755
08;2020-05-22;0;0;0;1621.44173420671;1438.58325779464;69;3060.02499200135
08;2020-05-22;0;0;0;626.575909335673;526.358467843651;79;1152.93437717932
08;2020-05-22;0;0;0;205.018522985054;140.993639349697;89;346.012162334751
08;2020-05-22;0;0;0;50.0325684687745;20.62259870351;90;70.6551671722846
08;2020-05-22;1;0;1;18551.3174743414;16782.6825256586;0;35334
11;2020-05-22;3;4;7;783071;811785;09;1594856
11;2020-05-22;5;3;8;761456;784653;19;1546109
11;2020-05-22;16;12;28;850145;801772;29;1651917
11;2020-05-22;10;8;18;914360;843488;39;1757848
11;2020-05-22;14;13;27;845609;826202;49;1671811
11;2020-05-22;7;11;18;793566;745070;59;1538636
11;2020-05-22;6;12;18;628649;549192;69;1177841
11;2020-05-22;14;11;25;434606;358356;79;792962
11;2020-05-22;17;12;29;261425;162933;89;424358
11;2020-05-22;16;2;18;89253;32619;90;121872
11;2020-05-22;108;88;196;6362140;5916070;0;12278210
24;2020-05-22;0;0;0;139720;144686;09;284406
24;2020-05-22;0;1;1;152979;161185;19;314164
24;2020-05-22;2;0;2;122237;126536;29;248773
24;2020-05-22;3;2;5;150359;142009;39;292368
24;2020-05-22;1;0;1;161829;158758;49;320587
24;2020-05-22;2;0;2;172552;168011;59;340563
24;2020-05-22;3;0;3;172509;158177;69;330686
24;2020-05-22;1;1;2;129428;110593;79;240021
24;2020-05-22;1;1;2;87342;56882;89;144224
24;2020-05-22;1;0;1;31210;12071;90;43281
24;2020-05-22;14;5;19;1320165;1238908;0;2559073
27;2020-05-22;0;0;1;143373;149679;09;293052
27;2020-05-22;1;0;1;160962;173003;19;333965
27;2020-05-22;3;1;4;133746;142254;29;276000
27;2020-05-22;2;3;5;160004;155407;39;315411
27;2020-05-22;2;3;5;172333;169564;49;341897
27;2020-05-22;5;2;7;189979;183788;59;373767
27;2020-05-22;0;2;2;192591;178206;69;370797
27;2020-05-22;1;3;4;146876;127546;79;274422
27;2020-05-22;2;2;4;96896;61575;89;158471
27;2020-05-22;2;0;2;33148;12109;90;45257
27;2020-05-22;18;16;35;1429908;1353131;0;2783039
28;2020-05-22;0;1;1;180735;186856;09;367591
28;2020-05-22;0;0;1;200125;213621;19;413746
28;2020-05-22;1;0;1;168922;173007;29;341929
28;2020-05-22;1;0;1;196628;188487;39;385115
28;2020-05-22;0;2;2;205396;201699;49;407095
28;2020-05-22;1;0;1;222002;213866;59;435868
28;2020-05-22;0;1;1;224688;203758;69;428446
28;2020-05-22;2;1;3;163192;135543;79;298735
28;2020-05-22;3;1;4;109691;65377;89;175068
28;2020-05-22;2;0;2;37222;12685;90;49907
28;2020-05-22;10;6;17;1708601;1594899;0;3303500
32;2020-05-22;3;1;4;358062;373689;09;731751
32;2020-05-22;4;2;6;387045;406742;19;793787
32;2020-05-22;2;3;5;342304;348587;29;690891
32;2020-05-22;9;6;15;382485;369972;39;752457
32;2020-05-22;9;10;19;382510;376716;49;759226
32;2020-05-22;9;6;15;386937;376527;59;763464
32;2020-05-22;3;4;7;371211;330938;69;702149
32;2020-05-22;15;3;18;250542;201459;79;452001
32;2020-05-22;19;6;25;163399;89786;89;253185
32;2020-05-22;25;4;29;48384;15367;90;63751
32;2020-05-22;98;45;143;3072879;2889783;0;5962662
44;2020-05-22;1;1;2;291525;306839;09;598364
44;2020-05-22;6;1;7;320255;339504;19;659759
44;2020-05-22;9;3;12;302020;314428;29;616448
44;2020-05-22;4;3;7;342222;333292;39;675514
44;2020-05-22;10;6;16;349727;344491;49;694218
44;2020-05-22;11;8;19;381371;373239;59;754610
44;2020-05-22;5;2;7;367165;335850;69;703015
44;2020-05-22;3;7;10;250387;215436;79;465823
44;2020-05-22;6;1;7;170825;105192;89;276017
44;2020-05-22;2;1;3;51248;16731;90;67979
44;2020-05-22;57;33;90;2826745;2685002;0;5511747
52;2020-05-22;0;0;0;213594;223900;09;437494
52;2020-05-22;0;1;1;240818;255197;19;496015
52;2020-05-22;2;1;3;197010;200630;29;397640
52;2020-05-22;2;4;6;231204;224885;39;456089
52;2020-05-22;5;6;11;243874;243418;49;487292
52;2020-05-22;4;2;6;244100;239116;59;483216
52;2020-05-22;0;0;0;241796;221345;69;463141
52;2020-05-22;2;2;4;177805;149903;79;327708
52;2020-05-22;1;2;3;119561;75822;89;195383
52;2020-05-22;2;2;4;42559;15260;90;57819
52;2020-05-22;18;21;39;1952321;1849476;0;3801797
53;2020-05-22;1;1;2;173813;182358;09;356171
53;2020-05-22;0;1;1;202720;214740;19;417460
53;2020-05-22;2;2;4;163116;173196;29;336312
53;2020-05-22;1;1;2;190526;187674;39;378200
53;2020-05-22;0;0;0;212098;212015;49;424113
53;2020-05-22;3;2;5;223699;219176;59;442875
53;2020-05-22;0;2;2;227435;209274;69;436709
53;2020-05-22;1;1;2;169992;140910;79;310902
53;2020-05-22;0;2;2;118117;69883;89;188000
53;2020-05-22;5;2;7;37370;12267;90;49637
53;2020-05-22;13;14;27;1718886;1621493;0;3340379
75;2020-05-22;3;1;4;293104;305291;09;598395
75;2020-05-22;1;2;3;337141;357785;19;694926
75;2020-05-22;2;5;7;295024;300618;29;595642
75;2020-05-22;3;2;5;347871;331233;39;679104
75;2020-05-22;9;0;9;384742;372771;49;757513
75;2020-05-22;5;2;7;413361;390880;59;804241
75;2020-05-22;2;3;5;425623;384060;69;809683
75;2020-05-22;1;2;3;325086;276298;79;601384
75;2020-05-22;3;5;8;213986;139308;89;353294
75;2020-05-22;4;1;5;77600;28200;90;105800
75;2020-05-22;33;23;56;3113538;2886444;0;5999982
76;2020-05-22;0;0;0;305956;318589;09;624545
76;2020-05-22;0;0;0;338942;356969;19;695911
76;2020-05-22;2;1;3;316210;319570;29;635780
76;2020-05-22;2;3;5;356758;337587;39;694345
76;2020-05-22;1;1;2;376541;363812;49;740353
76;2020-05-22;0;0;0;402608;383750;59;786358
76;2020-05-22;0;1;1;394889;358997;69;753886
76;2020-05-22;2;0;2;308664;263806;79;572470
76;2020-05-22;4;0;4;195838;129272;89;325110
76;2020-05-22;5;1;6;69372;26728;90;96100
76;2020-05-22;16;8;24;3065778;2859080;0;5924858
84;2020-05-22;0;1;1;459549;481088;09;940637
84;2020-05-22;1;6;7;487711;511905;19;999616
84;2020-05-22;4;16;20;443824;451094;29;894918
84;2020-05-22;4;2;6;512522;493262;39;1005784
84;2020-05-22;3;2;5;520248;515106;49;1035354
84;2020-05-22;2;3;5;529611;514848;59;1044459
84;2020-05-22;5;2;7;486720;439940;69;926660
84;2020-05-22;2;5;7;372151;315211;79;687362
84;2020-05-22;7;5;12;237198;150524;89;387722
84;2020-05-22;2;2;4;81185;28680;90;109865
84;2020-05-22;30;44;74;4130719;3901658;0;8032377
93;2020-05-22;0;0;0;268834;283093;09;551927
93;2020-05-22;0;0;1;280751;296087;19;576838
93;2020-05-22;3;1;4;254404;255552;29;509956
93;2020-05-22;1;0;2;310704;288398;39;599102
93;2020-05-22;3;1;4;325559;305827;49;631386
93;2020-05-22;6;5;11;353104;325389;59;678493
93;2020-05-22;5;1;7;336327;296459;69;632786
93;2020-05-22;1;2;4;279820;229699;79;509519
93;2020-05-22;3;1;4;171274;113716;89;284990
93;2020-05-22;4;1;5;58896;21758;90;80654
93;2020-05-22;26;12;42;2639673;2415978;0;5055651
94;2020-05-22;0;0;0;16311;17433;09;33744
94;2020-05-22;0;0;0;16679;18132;19;34811
94;2020-05-22;0;0;0;16782;16579;29;33361
94;2020-05-22;0;0;0;23044;20580;39;43624
94;2020-05-22;0;0;0;23065;22140;49;45205
94;2020-05-22;0;0;0;24549;23421;59;47970
94;2020-05-22;0;0;0;23212;21883;69;45095
94;2020-05-22;0;0;0;19544;17141;79;36685
94;2020-05-22;0;0;0;11227;8178;89;19405
94;2020-05-22;0;0;0;3332;1447;90;4779
94;2020-05-22;0;0;0;177745;166934;0;344679
01;2020-05-23;0;0;0;19979;20155;09;40134
01;2020-05-23;0;0;0;24994;25489;19;50483
01;2020-05-23;0;0;0;17868;16690;29;34558
01;2020-05-23;0;0;0;22328;14821;39;37149
01;2020-05-23;0;0;0;28652;20276;49;48928
01;2020-05-23;0;0;0;33264;27260;59;60524
01;2020-05-23;0;0;0;27135;23978;69;51113
01;2020-05-23;0;0;0;18401;14661;79;33062
01;2020-05-23;0;0;0;9633;6375;89;16008
01;2020-05-23;0;0;0;3410;1510;90;4920
01;2020-05-23;0;0;0;205664;171215;0;376879
02;2020-05-23;0;0;0;16881;17110;09;33991
02;2020-05-23;0;0;0;21410;21604;19;43014
02;2020-05-23;0;0;0;16017;15479;29;31496
02;2020-05-23;0;0;0;19825;14455;39;34280
02;2020-05-23;0;0;0;24719;18248;49;42967
02;2020-05-23;0;0;0;34361;28310;59;62671
02;2020-05-23;0;0;0;28061;24495;69;52556
02;2020-05-23;0;0;0;18231;15278;79;33509
02;2020-05-23;0;0;0;11090;7677;89;18767
02;2020-05-23;0;0;0;3992;1506;90;5498
02;2020-05-23;0;0;0;194587;164162;0;358749
03;2020-05-23;0;0;0;31123;30920;09;62043
03;2020-05-23;2;1;5;29370;29268;19;58638
03;2020-05-23;5;4;10;21458;18963;29;40421
03;2020-05-23;2;1;5;21276;18326;39;39602
03;2020-05-23;3;1;4;18164;16593;49;34757
03;2020-05-23;1;2;4;13469;13557;59;27026
03;2020-05-23;0;0;0;8776;8670;69;17446
03;2020-05-23;0;0;0;3777;3591;79;7368
03;2020-05-23;0;0;0;1649;1072;89;2721
03;2020-05-23;0;0;0;485;184;90;669
03;2020-05-23;13;9;28;149547;141144;0;290691
04;2020-05-23;0;0;0;60314;61377;09;121691
04;2020-05-23;0;0;0;66065;68387;19;134452
04;2020-05-23;0;0;0;51059;47156;29;98215
04;2020-05-23;0;0;0;58788;45780;39;104568
04;2020-05-23;0;0;0;61408;52207;49;113615
04;2020-05-23;0;0;0;64838;60759;59;125597
04;2020-05-23;0;1;1;47008;42843;69;89851
04;2020-05-23;0;1;1;25509;21184;79;46693
04;2020-05-23;0;0;0;13168;7647;89;20815
04;2020-05-23;0;0;0;3209;1253;90;4462
04;2020-05-23;0;2;2;451366;408593;0;859959
05;2020-05-23;0;0;0;362.366008612902;341.338819562748;09;703.704828175651
05;2020-05-23;0;0;0;353.376145114279;370.349735405642;19;723.725880519921
05;2020-05-23;0;0;0;218.593559489256;256.539602589476;29;475.133162078732
05;2020-05-23;0;0;0;404.225408693299;360.321910454353;39;764.547319147651
05;2020-05-23;0;0;0;520.067953604221;497.108383964256;49;1017.17633756848
05;2020-05-23;0;0;0;468.146063921917;510.087601910415;59;978.233665832332
05;2020-05-23;0;0;0;340.368470050554;334.366842191253;69;674.735312241807
05;2020-05-23;0;0;0;212.598666888387;192.597753227106;79;405.196420115493
05;2020-05-23;0;0;0;148.727797095705;61.8681715431829;89;210.595968638888
05;2020-05-23;0;0;0;32.9601271090696;10.9909785719784;90;43.9511056810479
05;2020-05-23;0;0;0;3061.43020057959;2935.56979942041;0;5997
06;2020-05-23;0;0;0;42583;42380;09;84963
06;2020-05-23;2;0;2;33369;31925;19;65294
06;2020-05-23;0;0;0;21571;15080;29;36651
06;2020-05-23;0;1;1;21550;16147;39;37697
06;2020-05-23;0;0;0;14193;13939;49;28132
06;2020-05-23;0;0;0;7171;7597;59;14768
06;2020-05-23;0;0;0;3629;4117;69;7746
06;2020-05-23;0;0;0;1577;1457;79;3034
06;2020-05-23;0;0;0;531;474;89;1005
06;2020-05-23;0;0;0;88;93;90;181
06;2020-05-23;2;1;3;146262;133209;0;279471
07;2020-05-23;0;0;0;485;549;09;1034
07;2020-05-23;0;0;0;403;432;19;835
07;2020-05-23;0;0;0;764;841;29;1605
07;2020-05-23;0;0;0;824;928;39;1752
07;2020-05-23;0;0;0;788;1020;49;1808
07;2020-05-23;0;0;0;678;870;59;1548
07;2020-05-23;0;0;0;360;382;69;742
07;2020-05-23;0;0;0;231;190;79;421
07;2020-05-23;0;0;0;114;67;89;181
07;2020-05-23;0;0;0;24;11;90;35
07;2020-05-23;0;0;0;4671;5290;0;9961
08;2020-05-23;0;0;0;2715.22592983026;2997.75551488675;09;5712.98144471701
08;2020-05-23;0;0;0;2778.51901080978;3160.9156459093;19;5939.43465671908
08;2020-05-23;0;0;0;2080.8882988764;1718.16634315323;29;3799.05464202964
08;2020-05-23;0;0;0;2701.8582062647;1896.52641413317;39;4598.38462039786
08;2020-05-23;0;0;0;3151.45861023308;2460.52498233809;49;5611.98359257117
08;2020-05-23;0;0;0;2620.29868333099;2422.23566154656;59;5042.53434487755
08;2020-05-23;0;0;0;1621.44173420671;1438.58325779464;69;3060.02499200135
08;2020-05-23;0;0;0;626.575909335673;526.358467843651;79;1152.93437717932
08;2020-05-23;0;0;0;205.018522985054;140.993639349697;89;346.012162334751
08;2020-05-23;0;0;0;50.0325684687745;20.62259870351;90;70.6551671722846
08;2020-05-23;0;0;0;18551.3174743414;16782.6825256586;0;35334
11;2020-05-23;0;0;0;783071;811785;09;1594856
11;2020-05-23;5;0;5;761456;784653;19;1546109
11;2020-05-23;3;2;5;850145;801772;29;1651917
11;2020-05-23;8;2;10;914360;843488;39;1757848
11;2020-05-23;1;0;1;845609;826202;49;1671811
11;2020-05-23;1;7;8;793566;745070;59;1538636
11;2020-05-23;1;3;4;628649;549192;69;1177841
11;2020-05-23;3;4;7;434606;358356;79;792962
11;2020-05-23;7;3;10;261425;162933;89;424358
11;2020-05-23;2;0;2;89253;32619;90;121872
11;2020-05-23;31;21;52;6362140;5916070;0;12278210
24;2020-05-23;0;0;0;139720;144686;09;284406
24;2020-05-23;0;0;0;152979;161185;19;314164
24;2020-05-23;0;0;0;122237;126536;29;248773
24;2020-05-23;1;0;1;150359;142009;39;292368
24;2020-05-23;0;0;0;161829;158758;49;320587
24;2020-05-23;1;0;1;172552;168011;59;340563
24;2020-05-23;0;1;1;172509;158177;69;330686
24;2020-05-23;2;0;2;129428;110593;79;240021
24;2020-05-23;0;2;2;87342;56882;89;144224
24;2020-05-23;0;0;0;31210;12071;90;43281
24;2020-05-23;4;3;7;1320165;1238908;0;2559073
27;2020-05-23;0;0;0;143373;149679;09;293052
27;2020-05-23;0;0;0;160962;173003;19;333965
27;2020-05-23;2;0;2;133746;142254;29;276000
27;2020-05-23;0;0;0;160004;155407;39;315411
27;2020-05-23;0;1;1;172333;169564;49;341897
27;2020-05-23;1;1;2;189979;183788;59;373767
27;2020-05-23;0;0;0;192591;178206;69;370797
27;2020-05-23;0;2;2;146876;127546;79;274422
27;2020-05-23;3;1;4;96896;61575;89;158471
27;2020-05-23;1;0;1;33148;12109;90;45257
27;2020-05-23;7;5;12;1429908;1353131;0;2783039
28;2020-05-23;0;0;0;180735;186856;09;367591
28;2020-05-23;0;0;0;200125;213621;19;413746
28;2020-05-23;0;0;0;168922;173007;29;341929
28;2020-05-23;0;1;1;196628;188487;39;385115
28;2020-05-23;1;0;1;205396;201699;49;407095
28;2020-05-23;0;1;1;222002;213866;59;435868
28;2020-05-23;0;2;2;224688;203758;69;428446
28;2020-05-23;0;1;1;163192;135543;79;298735
28;2020-05-23;0;0;0;109691;65377;89;175068
28;2020-05-23;0;0;0;37222;12685;90;49907
28;2020-05-23;1;5;6;1708601;1594899;0;3303500
32;2020-05-23;0;0;0;358062;373689;09;731751
32;2020-05-23;5;7;12;387045;406742;19;793787
32;2020-05-23;2;1;3;342304;348587;29;690891
32;2020-05-23;0;1;1;382485;369972;39;752457
32;2020-05-23;2;1;3;382510;376716;49;759226
32;2020-05-23;6;4;10;386937;376527;59;763464
32;2020-05-23;1;4;5;371211;330938;69;702149
32;2020-05-23;2;0;2;250542;201459;79;452001
32;2020-05-23;4;2;6;163399;89786;89;253185
32;2020-05-23;1;0;1;48384;15367;90;63751
32;2020-05-23;23;20;43;3072879;2889783;0;5962662
44;2020-05-23;0;0;0;291525;306839;09;598364
44;2020-05-23;1;0;1;320255;339504;19;659759
44;2020-05-23;0;1;1;302020;314428;29;616448
44;2020-05-23;1;1;2;342222;333292;39;675514
44;2020-05-23;1;0;1;349727;344491;49;694218
44;2020-05-23;1;1;2;381371;373239;59;754610
44;2020-05-23;2;2;4;367165;335850;69;703015
44;2020-05-23;3;4;7;250387;215436;79;465823
44;2020-05-23;2;0;2;170825;105192;89;276017
44;2020-05-23;0;1;1;51248;16731;90;67979
44;2020-05-23;11;10;21;2826745;2685002;0;5511747
52;2020-05-23;0;0;0;213594;223900;09;437494
52;2020-05-23;1;0;1;240818;255197;19;496015
52;2020-05-23;1;0;1;197010;200630;29;397640
52;2020-05-23;2;1;3;231204;224885;39;456089
52;2020-05-23;0;1;1;243874;243418;49;487292
52;2020-05-23;0;0;0;244100;239116;59;483216
52;2020-05-23;0;0;0;241796;221345;69;463141
52;2020-05-23;0;0;0;177805;149903;79;327708
52;2020-05-23;0;1;1;119561;75822;89;195383
52;2020-05-23;1;0;2;42559;15260;90;57819
52;2020-05-23;5;3;9;1952321;1849476;0;3801797
53;2020-05-23;2;0;2;173813;182358;09;356171
53;2020-05-23;1;1;2;202720;214740;19;417460
53;2020-05-23;1;0;1;163116;173196;29;336312
53;2020-05-23;0;0;0;190526;187674;39;378200
53;2020-05-23;0;0;0;212098;212015;49;424113
53;2020-05-23;1;1;2;223699;219176;59;442875
53;2020-05-23;0;0;0;227435;209274;69;436709
53;2020-05-23;2;0;2;169992;140910;79;310902
53;2020-05-23;0;0;0;118117;69883;89;188000
53;2020-05-23;2;1;3;37370;12267;90;49637
53;2020-05-23;9;3;12;1718886;1621493;0;3340379
75;2020-05-23;0;0;0;293104;305291;09;598395
75;2020-05-23;0;0;0;337141;357785;19;694926
75;2020-05-23;1;0;1;295024;300618;29;595642
75;2020-05-23;1;0;1;347871;331233;39;679104
75;2020-05-23;0;3;3;384742;372771;49;757513
75;2020-05-23;0;2;2;413361;390880;59;804241
75;2020-05-23;2;0;2;425623;384060;69;809683
75;2020-05-23;0;3;3;325086;276298;79;601384
75;2020-05-23;1;3;4;213986;139308;89;353294
75;2020-05-23;3;1;4;77600;28200;90;105800
75;2020-05-23;8;12;20;3113538;2886444;0;5999982
76;2020-05-23;0;0;0;305956;318589;09;624545
76;2020-05-23;0;0;0;338942;356969;19;695911
76;2020-05-23;0;0;0;316210;319570;29;635780
76;2020-05-23;0;1;1;356758;337587;39;694345
76;2020-05-23;1;1;2;376541;363812;49;740353
76;2020-05-23;0;0;0;402608;383750;59;786358
76;2020-05-23;0;0;0;394889;358997;69;753886
76;2020-05-23;0;0;0;308664;263806;79;572470
76;2020-05-23;1;1;2;195838;129272;89;325110
76;2020-05-23;4;1;5;69372;26728;90;96100
76;2020-05-23;6;4;10;3065778;2859080;0;5924858
84;2020-05-23;2;2;4;459549;481088;09;940637
84;2020-05-23;0;1;1;487711;511905;19;999616
84;2020-05-23;2;2;4;443824;451094;29;894918
84;2020-05-23;0;1;1;512522;493262;39;1005784
84;2020-05-23;3;1;4;520248;515106;49;1035354
84;2020-05-23;2;1;3;529611;514848;59;1044459
84;2020-05-23;0;0;0;486720;439940;69;926660
84;2020-05-23;1;1;2;372151;315211;79;687362
84;2020-05-23;0;0;0;237198;150524;89;387722
84;2020-05-23;3;0;3;81185;28680;90;109865
84;2020-05-23;13;9;22;4130719;3901658;0;8032377
93;2020-05-23;0;0;0;268834;283093;09;551927
93;2020-05-23;0;0;0;280751;296087;19;576838
93;2020-05-23;1;0;1;254404;255552;29;509956
93;2020-05-23;4;0;4;310704;288398;39;599102
93;2020-05-23;1;0;1;325559;305827;49;631386
93;2020-05-23;1;0;2;353104;325389;59;678493
93;2020-05-23;0;0;0;336327;296459;69;632786
93;2020-05-23;0;0;0;279820;229699;79;509519
93;2020-05-23;3;1;4;171274;113716;89;284990
93;2020-05-23;0;0;0;58896;21758;90;80654
93;2020-05-23;10;1;12;2639673;2415978;0;5055651
94;2020-05-23;0;0;0;16311;17433;09;33744
94;2020-05-23;0;0;0;16679;18132;19;34811
94;2020-05-23;1;0;1;16782;16579;29;33361
94;2020-05-23;0;0;0;23044;20580;39;43624
94;2020-05-23;0;0;0;23065;22140;49;45205
94;2020-05-23;0;0;0;24549;23421;59;47970
94;2020-05-23;0;1;1;23212;21883;69;45095
94;2020-05-23;0;0;0;19544;17141;79;36685
94;2020-05-23;0;0;0;11227;8178;89;19405
94;2020-05-23;0;0;0;3332;1447;90;4779
94;2020-05-23;1;1;2;177745;166934;0;344679
01;2020-05-24;0;0;0;19979;20155;09;40134
01;2020-05-24;1;0;1;24994;25489;19;50483
01;2020-05-24;0;0;0;17868;16690;29;34558
01;2020-05-24;0;0;0;22328;14821;39;37149
01;2020-05-24;0;0;0;28652;20276;49;48928
01;2020-05-24;0;0;0;33264;27260;59;60524
01;2020-05-24;0;0;0;27135;23978;69;51113
01;2020-05-24;0;0;0;18401;14661;79;33062
01;2020-05-24;0;0;0;9633;6375;89;16008
01;2020-05-24;0;0;0;3410;1510;90;4920
01;2020-05-24;1;0;1;205664;171215;0;376879
02;2020-05-24;0;0;0;16881;17110;09;33991
02;2020-05-24;0;0;0;21410;21604;19;43014
02;2020-05-24;0;0;0;16017;15479;29;31496
02;2020-05-24;0;0;0;19825;14455;39;34280
02;2020-05-24;0;0;0;24719;18248;49;42967
02;2020-05-24;0;0;0;34361;28310;59;62671
02;2020-05-24;0;0;0;28061;24495;69;52556
02;2020-05-24;0;0;0;18231;15278;79;33509
02;2020-05-24;0;0;0;11090;7677;89;18767
02;2020-05-24;0;0;0;3992;1506;90;5498
02;2020-05-24;0;0;0;194587;164162;0;358749
03;2020-05-24;0;0;0;31123;30920;09;62043
03;2020-05-24;6;4;12;29370;29268;19;58638
03;2020-05-24;2;5;7;21458;18963;29;40421
03;2020-05-24;1;2;5;21276;18326;39;39602
03;2020-05-24;1;5;6;18164;16593;49;34757
03;2020-05-24;2;0;2;13469;13557;59;27026
03;2020-05-24;0;1;1;8776;8670;69;17446
03;2020-05-24;0;0;0;3777;3591;79;7368
03;2020-05-24;0;0;0;1649;1072;89;2721
03;2020-05-24;0;0;0;485;184;90;669
03;2020-05-24;12;17;33;149547;141144;0;290691
04;2020-05-24;0;0;0;60314;61377;09;121691
04;2020-05-24;1;0;1;66065;68387;19;134452
04;2020-05-24;0;0;0;51059;47156;29;98215
04;2020-05-24;0;0;0;58788;45780;39;104568
04;2020-05-24;0;0;0;61408;52207;49;113615
04;2020-05-24;0;0;0;64838;60759;59;125597
04;2020-05-24;0;0;0;47008;42843;69;89851
04;2020-05-24;0;0;0;25509;21184;79;46693
04;2020-05-24;0;0;0;13168;7647;89;20815
04;2020-05-24;0;0;0;3209;1253;90;4462
04;2020-05-24;1;0;1;451366;408593;0;859959
05;2020-05-24;0;0;0;362.366008612902;341.338819562748;09;703.704828175651
05;2020-05-24;0;0;0;353.376145114279;370.349735405642;19;723.725880519921
05;2020-05-24;0;0;0;218.593559489256;256.539602589476;29;475.133162078732
05;2020-05-24;0;0;0;404.225408693299;360.321910454353;39;764.547319147651
05;2020-05-24;0;0;0;520.067953604221;497.108383964256;49;1017.17633756848
05;2020-05-24;0;0;0;468.146063921917;510.087601910415;59;978.233665832332
05;2020-05-24;0;0;0;340.368470050554;334.366842191253;69;674.735312241807
05;2020-05-24;0;0;0;212.598666888387;192.597753227106;79;405.196420115493
05;2020-05-24;0;0;0;148.727797095705;61.8681715431829;89;210.595968638888
05;2020-05-24;0;0;0;32.9601271090696;10.9909785719784;90;43.9511056810479
05;2020-05-24;0;0;0;3061.43020057959;2935.56979942041;0;5997
06;2020-05-24;0;0;0;42583;42380;09;84963
06;2020-05-24;1;0;1;33369;31925;19;65294
06;2020-05-24;2;0;2;21571;15080;29;36651
06;2020-05-24;2;2;4;21550;16147;39;37697
06;2020-05-24;0;0;0;14193;13939;49;28132
06;2020-05-24;0;0;0;7171;7597;59;14768
06;2020-05-24;0;0;0;3629;4117;69;7746
06;2020-05-24;0;0;0;1577;1457;79;3034
06;2020-05-24;0;0;0;531;474;89;1005
06;2020-05-24;0;0;0;88;93;90;181
06;2020-05-24;5;2;7;146262;133209;0;279471
07;2020-05-24;0;0;0;485;549;09;1034
07;2020-05-24;0;0;0;403;432;19;835
07;2020-05-24;0;0;0;764;841;29;1605
07;2020-05-24;0;0;0;824;928;39;1752
07;2020-05-24;0;0;0;788;1020;49;1808
07;2020-05-24;0;0;0;678;870;59;1548
07;2020-05-24;0;0;0;360;382;69;742
07;2020-05-24;0;0;0;231;190;79;421
07;2020-05-24;0;0;0;114;67;89;181
07;2020-05-24;0;0;0;24;11;90;35
07;2020-05-24;0;0;0;4671;5290;0;9961
08;2020-05-24;0;0;0;2715.22592983026;2997.75551488675;09;5712.98144471701
08;2020-05-24;0;0;0;2778.51901080978;3160.9156459093;19;5939.43465671908
08;2020-05-24;0;0;0;2080.8882988764;1718.16634315323;29;3799.05464202964
08;2020-05-24;0;0;0;2701.8582062647;1896.52641413317;39;4598.38462039786
08;2020-05-24;0;0;0;3151.45861023308;2460.52498233809;49;5611.98359257117
08;2020-05-24;0;0;0;2620.29868333099;2422.23566154656;59;5042.53434487755
08;2020-05-24;0;0;0;1621.44173420671;1438.58325779464;69;3060.02499200135
08;2020-05-24;0;0;0;626.575909335673;526.358467843651;79;1152.93437717932
08;2020-05-24;0;0;0;205.018522985054;140.993639349697;89;346.012162334751
08;2020-05-24;0;0;0;50.0325684687745;20.62259870351;90;70.6551671722846
08;2020-05-24;0;0;0;18551.3174743414;16782.6825256586;0;35334
11;2020-05-24;1;0;1;783071;811785;09;1594856
11;2020-05-24;2;2;4;761456;784653;19;1546109
11;2020-05-24;3;2;5;850145;801772;29;1651917
11;2020-05-24;0;1;1;914360;843488;39;1757848
11;2020-05-24;2;2;4;845609;826202;49;1671811
11;2020-05-24;0;3;3;793566;745070;59;1538636
11;2020-05-24;2;2;4;628649;549192;69;1177841
11;2020-05-24;0;3;3;434606;358356;79;792962
11;2020-05-24;2;0;2;261425;162933;89;424358
11;2020-05-24;2;0;2;89253;32619;90;121872
11;2020-05-24;14;15;29;6362140;5916070;0;12278210
24;2020-05-24;0;0;0;139720;144686;09;284406
24;2020-05-24;0;0;0;152979;161185;19;314164
24;2020-05-24;2;0;2;122237;126536;29;248773
24;2020-05-24;1;0;1;150359;142009;39;292368
24;2020-05-24;0;0;0;161829;158758;49;320587
24;2020-05-24;0;0;0;172552;168011;59;340563
24;2020-05-24;1;1;2;172509;158177;69;330686
24;2020-05-24;0;1;1;129428;110593;79;240021
24;2020-05-24;2;0;2;87342;56882;89;144224
24;2020-05-24;1;0;1;31210;12071;90;43281
24;2020-05-24;7;2;9;1320165;1238908;0;2559073
27;2020-05-24;0;0;0;143373;149679;09;293052
27;2020-05-24;0;0;0;160962;173003;19;333965
27;2020-05-24;1;1;2;133746;142254;29;276000
27;2020-05-24;0;0;0;160004;155407;39;315411
27;2020-05-24;0;0;0;172333;169564;49;341897
27;2020-05-24;0;0;0;189979;183788;59;373767
27;2020-05-24;0;1;1;192591;178206;69;370797
27;2020-05-24;2;0;2;146876;127546;79;274422
27;2020-05-24;1;0;1;96896;61575;89;158471
27;2020-05-24;0;0;0;33148;12109;90;45257
27;2020-05-24;4;2;6;1429908;1353131;0;2783039
28;2020-05-24;0;0;0;180735;186856;09;367591
28;2020-05-24;0;0;0;200125;213621;19;413746
28;2020-05-24;1;1;2;168922;173007;29;341929
28;2020-05-24;0;0;0;196628;188487;39;385115
28;2020-05-24;0;0;0;205396;201699;49;407095
28;2020-05-24;0;0;0;222002;213866;59;435868
28;2020-05-24;0;0;0;224688;203758;69;428446
28;2020-05-24;1;1;2;163192;135543;79;298735
28;2020-05-24;0;0;0;109691;65377;89;175068
28;2020-05-24;0;0;0;37222;12685;90;49907
28;2020-05-24;2;2;4;1708601;1594899;0;3303500
32;2020-05-24;0;0;0;358062;373689;09;731751
32;2020-05-24;0;1;1;387045;406742;19;793787
32;2020-05-24;0;0;0;342304;348587;29;690891
32;2020-05-24;0;0;0;382485;369972;39;752457
32;2020-05-24;1;0;1;382510;376716;49;759226
32;2020-05-24;0;1;1;386937;376527;59;763464
32;2020-05-24;0;1;1;371211;330938;69;702149
32;2020-05-24;0;3;3;250542;201459;79;452001
32;2020-05-24;4;0;4;163399;89786;89;253185
32;2020-05-24;0;1;1;48384;15367;90;63751
32;2020-05-24;5;7;12;3072879;2889783;0;5962662
44;2020-05-24;0;1;1;291525;306839;09;598364
44;2020-05-24;1;0;1;320255;339504;19;659759
44;2020-05-24;0;0;0;302020;314428;29;616448
44;2020-05-24;1;1;2;342222;333292;39;675514
44;2020-05-24;0;0;0;349727;344491;49;694218
44;2020-05-24;0;0;0;381371;373239;59;754610
44;2020-05-24;0;0;0;367165;335850;69;703015
44;2020-05-24;1;0;1;250387;215436;79;465823
44;2020-05-24;1;0;1;170825;105192;89;276017
44;2020-05-24;1;0;1;51248;16731;90;67979
44;2020-05-24;5;2;7;2826745;2685002;0;5511747
52;2020-05-24;1;0;1;213594;223900;09;437494
52;2020-05-24;0;0;0;240818;255197;19;496015
52;2020-05-24;0;2;2;197010;200630;29;397640
52;2020-05-24;0;0;0;231204;224885;39;456089
52;2020-05-24;0;0;0;243874;243418;49;487292
52;2020-05-24;0;0;0;244100;239116;59;483216
52;2020-05-24;1;1;2;241796;221345;69;463141
52;2020-05-24;0;1;1;177805;149903;79;327708
52;2020-05-24;1;0;1;119561;75822;89;195383
52;2020-05-24;1;0;1;42559;15260;90;57819
52;2020-05-24;4;4;8;1952321;1849476;0;3801797
53;2020-05-24;0;0;0;173813;182358;09;356171
53;2020-05-24;1;0;1;202720;214740;19;417460
53;2020-05-24;0;0;0;163116;173196;29;336312
53;2020-05-24;0;0;0;190526;187674;39;378200
53;2020-05-24;2;1;3;212098;212015;49;424113
53;2020-05-24;0;1;1;223699;219176;59;442875
53;2020-05-24;0;0;0;227435;209274;69;436709
53;2020-05-24;1;0;1;169992;140910;79;310902
53;2020-05-24;3;1;4;118117;69883;89;188000
53;2020-05-24;1;0;1;37370;12267;90;49637
53;2020-05-24;8;3;11;1718886;1621493;0;3340379
75;2020-05-24;0;0;0;293104;305291;09;598395
75;2020-05-24;0;0;0;337141;357785;19;694926
75;2020-05-24;0;0;0;295024;300618;29;595642
75;2020-05-24;0;0;0;347871;331233;39;679104
75;2020-05-24;0;0;0;384742;372771;49;757513
75;2020-05-24;0;0;0;413361;390880;59;804241
75;2020-05-24;0;0;0;425623;384060;69;809683
75;2020-05-24;0;0;0;325086;276298;79;601384
75;2020-05-24;0;0;0;213986;139308;89;353294
75;2020-05-24;0;0;0;77600;28200;90;105800
75;2020-05-24;0;0;0;3113538;2886444;0;5999982
76;2020-05-24;0;1;1;305956;318589;09;624545
76;2020-05-24;0;0;0;338942;356969;19;695911
76;2020-05-24;1;0;1;316210;319570;29;635780
76;2020-05-24;0;0;0;356758;337587;39;694345
76;2020-05-24;0;0;0;376541;363812;49;740353
76;2020-05-24;1;1;2;402608;383750;59;786358
76;2020-05-24;0;0;0;394889;358997;69;753886
76;2020-05-24;1;1;2;308664;263806;79;572470
76;2020-05-24;1;0;1;195838;129272;89;325110
76;2020-05-24;0;0;0;69372;26728;90;96100
76;2020-05-24;4;3;7;3065778;2859080;0;5924858
84;2020-05-24;0;0;0;459549;481088;09;940637
84;2020-05-24;0;0;0;487711;511905;19;999616
84;2020-05-24;1;0;1;443824;451094;29;894918
84;2020-05-24;0;0;0;512522;493262;39;1005784
84;2020-05-24;0;0;0;520248;515106;49;1035354
84;2020-05-24;0;0;0;529611;514848;59;1044459
84;2020-05-24;0;0;0;486720;439940;69;926660
84;2020-05-24;0;0;0;372151;315211;79;687362
84;2020-05-24;0;1;1;237198;150524;89;387722
84;2020-05-24;0;0;0;81185;28680;90;109865
84;2020-05-24;1;1;2;4130719;3901658;0;8032377
93;2020-05-24;0;0;0;268834;283093;09;551927
93;2020-05-24;0;0;0;280751;296087;19;576838
93;2020-05-24;1;0;1;254404;255552;29;509956
93;2020-05-24;0;0;0;310704;288398;39;599102
93;2020-05-24;1;0;1;325559;305827;49;631386
93;2020-05-24;0;0;0;353104;325389;59;678493
93;2020-05-24;0;2;2;336327;296459;69;632786
93;2020-05-24;0;0;0;279820;229699;79;509519
93;2020-05-24;0;0;0;171274;113716;89;284990
93;2020-05-24;0;0;0;58896;21758;90;80654
93;2020-05-24;2;2;4;2639673;2415978;0;5055651
94;2020-05-24;0;0;0;16311;17433;09;33744
94;2020-05-24;0;0;0;16679;18132;19;34811
94;2020-05-24;0;0;0;16782;16579;29;33361
94;2020-05-24;0;0;0;23044;20580;39;43624
94;2020-05-24;0;0;0;23065;22140;49;45205
94;2020-05-24;0;0;0;24549;23421;59;47970
94;2020-05-24;0;0;0;23212;21883;69;45095
94;2020-05-24;0;0;0;19544;17141;79;36685
94;2020-05-24;0;0;0;11227;8178;89;19405
94;2020-05-24;0;0;0;3332;1447;90;4779
94;2020-05-24;0;0;0;177745;166934;0;344679
01;2020-05-25;0;0;0;19979;20155;09;40134
01;2020-05-25;0;0;0;24994;25489;19;50483
01;2020-05-25;0;1;1;17868;16690;29;34558
01;2020-05-25;0;0;0;22328;14821;39;37149
01;2020-05-25;0;0;0;28652;20276;49;48928
01;2020-05-25;0;0;0;33264;27260;59;60524
01;2020-05-25;0;0;0;27135;23978;69;51113
01;2020-05-25;0;0;0;18401;14661;79;33062
01;2020-05-25;0;0;0;9633;6375;89;16008
01;2020-05-25;0;0;0;3410;1510;90;4920
01;2020-05-25;0;1;1;205664;171215;0;376879
02;2020-05-25;0;0;0;16881;17110;09;33991
02;2020-05-25;0;0;0;21410;21604;19;43014
02;2020-05-25;0;0;0;16017;15479;29;31496
02;2020-05-25;0;0;0;19825;14455;39;34280
02;2020-05-25;0;0;0;24719;18248;49;42967
02;2020-05-25;0;1;1;34361;28310;59;62671
02;2020-05-25;0;0;0;28061;24495;69;52556
02;2020-05-25;0;0;0;18231;15278;79;33509
02;2020-05-25;0;0;0;11090;7677;89;18767
02;2020-05-25;0;0;0;3992;1506;90;5498
02;2020-05-25;0;1;1;194587;164162;0;358749
03;2020-05-25;0;0;0;31123;30920;09;62043
03;2020-05-25;2;3;5;29370;29268;19;58638
03;2020-05-25;1;3;4;21458;18963;29;40421
03;2020-05-25;4;1;5;21276;18326;39;39602
03;2020-05-25;2;2;5;18164;16593;49;34757
03;2020-05-25;0;0;0;13469;13557;59;27026
03;2020-05-25;0;2;2;8776;8670;69;17446
03;2020-05-25;0;0;0;3777;3591;79;7368
03;2020-05-25;0;0;0;1649;1072;89;2721
03;2020-05-25;0;0;0;485;184;90;669
03;2020-05-25;9;11;21;149547;141144;0;290691
04;2020-05-25;0;0;0;60314;61377;09;121691
04;2020-05-25;1;0;1;66065;68387;19;134452
04;2020-05-25;0;0;0;51059;47156;29;98215
04;2020-05-25;0;0;0;58788;45780;39;104568
04;2020-05-25;0;1;1;61408;52207;49;113615
04;2020-05-25;0;0;0;64838;60759;59;125597
04;2020-05-25;0;0;0;47008;42843;69;89851
04;2020-05-25;0;0;0;25509;21184;79;46693
04;2020-05-25;0;0;0;13168;7647;89;20815
04;2020-05-25;0;0;0;3209;1253;90;4462
04;2020-05-25;1;1;2;451366;408593;0;859959
05;2020-05-25;0;0;0;362.366008612902;341.338819562748;09;703.704828175651
05;2020-05-25;0;0;0;353.376145114279;370.349735405642;19;723.725880519921
05;2020-05-25;0;0;0;218.593559489256;256.539602589476;29;475.133162078732
05;2020-05-25;0;0;0;404.225408693299;360.321910454353;39;764.547319147651
05;2020-05-25;0;0;0;520.067953604221;497.108383964256;49;1017.17633756848
05;2020-05-25;0;0;0;468.146063921917;510.087601910415;59;978.233665832332
05;2020-05-25;0;0;0;340.368470050554;334.366842191253;69;674.735312241807
05;2020-05-25;0;0;0;212.598666888387;192.597753227106;79;405.196420115493
05;2020-05-25;0;0;0;148.727797095705;61.8681715431829;89;210.595968638888
05;2020-05-25;0;0;0;32.9601271090696;10.9909785719784;90;43.9511056810479
05;2020-05-25;0;0;0;3061.43020057959;2935.56979942041;0;5997
06;2020-05-25;0;0;0;42583;42380;09;84963
06;2020-05-25;0;1;1;33369;31925;19;65294
06;2020-05-25;1;1;2;21571;15080;29;36651
06;2020-05-25;1;2;3;21550;16147;39;37697
06;2020-05-25;0;0;0;14193;13939;49;28132
06;2020-05-25;0;0;0;7171;7597;59;14768
06;2020-05-25;0;0;0;3629;4117;69;7746
06;2020-05-25;0;0;0;1577;1457;79;3034
06;2020-05-25;0;0;0;531;474;89;1005
06;2020-05-25;0;0;0;88;93;90;181
06;2020-05-25;2;4;6;146262;133209;0;279471
07;2020-05-25;0;0;0;485;549;09;1034
07;2020-05-25;0;0;0;403;432;19;835
07;2020-05-25;0;0;0;764;841;29;1605
07;2020-05-25;0;0;0;824;928;39;1752
07;2020-05-25;0;0;0;788;1020;49;1808
07;2020-05-25;0;0;0;678;870;59;1548
07;2020-05-25;0;0;0;360;382;69;742
07;2020-05-25;0;0;0;231;190;79;421
07;2020-05-25;0;0;0;114;67;89;181
07;2020-05-25;0;0;0;24;11;90;35
07;2020-05-25;0;0;0;4671;5290;0;9961
08;2020-05-25;0;0;0;2715.22592983026;2997.75551488675;09;5712.98144471701
08;2020-05-25;0;0;0;2778.51901080978;3160.9156459093;19;5939.43465671908
08;2020-05-25;0;0;0;2080.8882988764;1718.16634315323;29;3799.05464202964
08;2020-05-25;0;0;0;2701.8582062647;1896.52641413317;39;4598.38462039786
08;2020-05-25;0;0;0;3151.45861023308;2460.52498233809;49;5611.98359257117
08;2020-05-25;0;0;0;2620.29868333099;2422.23566154656;59;5042.53434487755
08;2020-05-25;0;0;0;1621.44173420671;1438.58325779464;69;3060.02499200135
08;2020-05-25;0;0;0;626.575909335673;526.358467843651;79;1152.93437717932
08;2020-05-25;0;0;0;205.018522985054;140.993639349697;89;346.012162334751
08;2020-05-25;0;0;0;50.0325684687745;20.62259870351;90;70.6551671722846
08;2020-05-25;0;0;0;18551.3174743414;16782.6825256586;0;35334
11;2020-05-25;2;1;4;783071;811785;09;1594856
11;2020-05-25;4;5;10;761456;784653;19;1546109
11;2020-05-25;21;15;36;850145;801772;29;1651917
11;2020-05-25;22;7;30;914360;843488;39;1757848
11;2020-05-25;19;8;27;845609;826202;49;1671811
11;2020-05-25;13;10;23;793566;745070;59;1538636
11;2020-05-25;4;15;19;628649;549192;69;1177841
11;2020-05-25;6;12;18;434606;358356;79;792962
11;2020-05-25;25;7;32;261425;162933;89;424358
11;2020-05-25;23;5;28;89253;32619;90;121872
11;2020-05-25;139;85;227;6362140;5916070;0;12278210
24;2020-05-25;0;1;1;139720;144686;09;284406
24;2020-05-25;1;0;1;152979;161185;19;314164
24;2020-05-25;2;4;6;122237;126536;29;248773
24;2020-05-25;2;2;4;150359;142009;39;292368
24;2020-05-25;3;2;5;161829;158758;49;320587
24;2020-05-25;3;2;5;172552;168011;59;340563
24;2020-05-25;2;3;5;172509;158177;69;330686
24;2020-05-25;2;1;3;129428;110593;79;240021
24;2020-05-25;0;1;1;87342;56882;89;144224
24;2020-05-25;0;0;0;31210;12071;90;43281
24;2020-05-25;15;16;31;1320165;1238908;0;2559073
27;2020-05-25;0;0;0;143373;149679;09;293052
27;2020-05-25;1;0;1;160962;173003;19;333965
27;2020-05-25;0;0;0;133746;142254;29;276000
27;2020-05-25;1;3;4;160004;155407;39;315411
27;2020-05-25;2;0;2;172333;169564;49;341897
27;2020-05-25;4;1;5;189979;183788;59;373767
27;2020-05-25;1;1;2;192591;178206;69;370797
27;2020-05-25;1;0;1;146876;127546;79;274422
27;2020-05-25;3;2;5;96896;61575;89;158471
27;2020-05-25;1;1;2;33148;12109;90;45257
27;2020-05-25;14;8;22;1429908;1353131;0;2783039
28;2020-05-25;0;1;1;180735;186856;09;367591
28;2020-05-25;0;0;0;200125;213621;19;413746
28;2020-05-25;2;0;2;168922;173007;29;341929
28;2020-05-25;0;0;0;196628;188487;39;385115
28;2020-05-25;0;0;0;205396;201699;49;407095
28;2020-05-25;0;0;0;222002;213866;59;435868
28;2020-05-25;0;1;1;224688;203758;69;428446
28;2020-05-25;0;1;1;163192;135543;79;298735
28;2020-05-25;1;1;2;109691;65377;89;175068
28;2020-05-25;4;0;4;37222;12685;90;49907
28;2020-05-25;7;4;11;1708601;1594899;0;3303500
32;2020-05-25;2;2;4;358062;373689;09;731751
32;2020-05-25;4;11;15;387045;406742;19;793787
32;2020-05-25;4;4;8;342304;348587;29;690891
32;2020-05-25;7;4;11;382485;369972;39;752457
32;2020-05-25;7;10;17;382510;376716;49;759226
32;2020-05-25;7;4;11;386937;376527;59;763464
32;2020-05-25;1;3;4;371211;330938;69;702149
32;2020-05-25;6;3;9;250542;201459;79;452001
32;2020-05-25;20;5;25;163399;89786;89;253185
32;2020-05-25;6;0;6;48384;15367;90;63751
32;2020-05-25;64;46;110;3072879;2889783;0;5962662
44;2020-05-25;0;1;1;291525;306839;09;598364
44;2020-05-25;3;1;4;320255;339504;19;659759
44;2020-05-25;5;3;8;302020;314428;29;616448
44;2020-05-25;8;3;11;342222;333292;39;675514
44;2020-05-25;8;3;11;349727;344491;49;694218
44;2020-05-25;8;3;11;381371;373239;59;754610
44;2020-05-25;9;6;15;367165;335850;69;703015
44;2020-05-25;2;5;7;250387;215436;79;465823
44;2020-05-25;11;5;16;170825;105192;89;276017
44;2020-05-25;9;0;9;51248;16731;90;67979
44;2020-05-25;63;30;93;2826745;2685002;0;5511747
52;2020-05-25;1;0;1;213594;223900;09;437494
52;2020-05-25;1;2;3;240818;255197;19;496015
52;2020-05-25;0;1;1;197010;200630;29;397640
52;2020-05-25;3;0;3;231204;224885;39;456089
52;2020-05-25;4;4;8;243874;243418;49;487292
52;2020-05-25;0;3;3;244100;239116;59;483216
52;2020-05-25;1;1;2;241796;221345;69;463141
52;2020-05-25;1;0;1;177805;149903;79;327708
52;2020-05-25;0;1;1;119561;75822;89;195383
52;2020-05-25;1;0;1;42559;15260;90;57819
52;2020-05-25;12;12;24;1952321;1849476;0;3801797
53;2020-05-25;2;0;2;173813;182358;09;356171
53;2020-05-25;1;1;2;202720;214740;19;417460
53;2020-05-25;2;0;2;163116;173196;29;336312
53;2020-05-25;2;2;4;190526;187674;39;378200
53;2020-05-25;1;1;2;212098;212015;49;424113
53;2020-05-25;1;0;1;223699;219176;59;442875
53;2020-05-25;0;1;1;227435;209274;69;436709
53;2020-05-25;1;0;1;169992;140910;79;310902
53;2020-05-25;1;0;1;118117;69883;89;188000
53;2020-05-25;0;0;0;37370;12267;90;49637
53;2020-05-25;11;5;16;1718886;1621493;0;3340379
75;2020-05-25;0;1;1;293104;305291;09;598395
75;2020-05-25;1;0;1;337141;357785;19;694926
75;2020-05-25;4;2;6;295024;300618;29;595642
75;2020-05-25;1;2;3;347871;331233;39;679104
75;2020-05-25;5;2;7;384742;372771;49;757513
75;2020-05-25;2;1;3;413361;390880;59;804241
75;2020-05-25;1;0;1;425623;384060;69;809683
75;2020-05-25;0;0;0;325086;276298;79;601384
75;2020-05-25;4;3;7;213986;139308;89;353294
75;2020-05-25;0;0;0;77600;28200;90;105800
75;2020-05-25;18;11;29;3113538;2886444;0;5999982
76;2020-05-25;1;0;1;305956;318589;09;624545
76;2020-05-25;0;0;0;338942;356969;19;695911
76;2020-05-25;1;1;2;316210;319570;29;635780
76;2020-05-25;3;2;5;356758;337587;39;694345
76;2020-05-25;0;0;0;376541;363812;49;740353
76;2020-05-25;2;0;2;402608;383750;59;786358
76;2020-05-25;3;1;4;394889;358997;69;753886
76;2020-05-25;2;1;3;308664;263806;79;572470
76;2020-05-25;0;1;1;195838;129272;89;325110
76;2020-05-25;3;1;4;69372;26728;90;96100
76;2020-05-25;15;7;22;3065778;2859080;0;5924858
84;2020-05-25;0;0;0;459549;481088;09;940637
84;2020-05-25;0;2;2;487711;511905;19;999616
84;2020-05-25;1;4;5;443824;451094;29;894918
84;2020-05-25;2;3;5;512522;493262;39;1005784
84;2020-05-25;3;2;5;520248;515106;49;1035354
84;2020-05-25;5;2;7;529611;514848;59;1044459
84;2020-05-25;2;4;6;486720;439940;69;926660
84;2020-05-25;0;4;4;372151;315211;79;687362
84;2020-05-25;3;0;3;237198;150524;89;387722
84;2020-05-25;7;0;7;81185;28680;90;109865
84;2020-05-25;23;21;44;4130719;3901658;0;8032377
93;2020-05-25;0;0;0;268834;283093;09;551927
93;2020-05-25;0;0;0;280751;296087;19;576838
93;2020-05-25;1;0;1;254404;255552;29;509956
93;2020-05-25;1;0;1;310704;288398;39;599102
93;2020-05-25;4;2;6;325559;305827;49;631386
93;2020-05-25;2;0;2;353104;325389;59;678493
93;2020-05-25;5;5;11;336327;296459;69;632786
93;2020-05-25;4;1;5;279820;229699;79;509519
93;2020-05-25;3;4;7;171274;113716;89;284990
93;2020-05-25;6;2;8;58896;21758;90;80654
93;2020-05-25;26;14;41;2639673;2415978;0;5055651
94;2020-05-25;0;0;0;16311;17433;09;33744
94;2020-05-25;0;0;0;16679;18132;19;34811
94;2020-05-25;0;0;0;16782;16579;29;33361
94;2020-05-25;0;0;0;23044;20580;39;43624
94;2020-05-25;0;0;0;23065;22140;49;45205
94;2020-05-25;0;0;0;24549;23421;59;47970
94;2020-05-25;0;0;0;23212;21883;69;45095
94;2020-05-25;0;0;0;19544;17141;79;36685
94;2020-05-25;1;0;1;11227;8178;89;19405
94;2020-05-25;0;0;0;3332;1447;90;4779
94;2020-05-25;1;0;1;177745;166934;0;344679
01;2020-05-26;0;0;0;19979;20155;09;40134
01;2020-05-26;0;1;1;24994;25489;19;50483
01;2020-05-26;0;0;0;17868;16690;29;34558
01;2020-05-26;0;0;0;22328;14821;39;37149
01;2020-05-26;0;0;0;28652;20276;49;48928
01;2020-05-26;0;0;0;33264;27260;59;60524
01;2020-05-26;0;0;0;27135;23978;69;51113
01;2020-05-26;0;0;0;18401;14661;79;33062
01;2020-05-26;0;0;0;9633;6375;89;16008
01;2020-05-26;0;0;0;3410;1510;90;4920
01;2020-05-26;0;1;1;205664;171215;0;376879
02;2020-05-26;0;0;0;16881;17110;09;33991
02;2020-05-26;0;0;0;21410;21604;19;43014
02;2020-05-26;0;0;0;16017;15479;29;31496
02;2020-05-26;0;0;0;19825;14455;39;34280
02;2020-05-26;0;0;0;24719;18248;49;42967
02;2020-05-26;1;0;1;34361;28310;59;62671
02;2020-05-26;0;0;0;28061;24495;69;52556
02;2020-05-26;0;0;0;18231;15278;79;33509
02;2020-05-26;0;0;0;11090;7677;89;18767
02;2020-05-26;0;0;0;3992;1506;90;5498
02;2020-05-26;1;0;1;194587;164162;0;358749
03;2020-05-26;1;0;2;31123;30920;09;62043
03;2020-05-26;1;2;4;29370;29268;19;58638
03;2020-05-26;0;4;5;21458;18963;29;40421
03;2020-05-26;3;3;7;21276;18326;39;39602
03;2020-05-26;1;3;7;18164;16593;49;34757
03;2020-05-26;0;0;0;13469;13557;59;27026
03;2020-05-26;0;0;0;8776;8670;69;17446
03;2020-05-26;0;1;1;3777;3591;79;7368
03;2020-05-26;0;1;1;1649;1072;89;2721
03;2020-05-26;0;0;0;485;184;90;669
03;2020-05-26;6;14;27;149547;141144;0;290691
04;2020-05-26;0;0;0;60314;61377;09;121691
04;2020-05-26;0;0;0;66065;68387;19;134452
04;2020-05-26;0;0;0;51059;47156;29;98215
04;2020-05-26;0;0;0;58788;45780;39;104568
04;2020-05-26;1;0;1;61408;52207;49;113615
04;2020-05-26;0;0;0;64838;60759;59;125597
04;2020-05-26;0;1;1;47008;42843;69;89851
04;2020-05-26;0;0;0;25509;21184;79;46693
04;2020-05-26;0;0;0;13168;7647;89;20815
04;2020-05-26;0;0;0;3209;1253;90;4462
04;2020-05-26;1;1;2;451366;408593;0;859959
05;2020-05-26;0;0;0;362.366008612902;341.338819562748;09;703.704828175651
05;2020-05-26;0;0;0;353.376145114279;370.349735405642;19;723.725880519921
05;2020-05-26;0;0;0;218.593559489256;256.539602589476;29;475.133162078732
05;2020-05-26;0;0;0;404.225408693299;360.321910454353;39;764.547319147651
05;2020-05-26;0;0;0;520.067953604221;497.108383964256;49;1017.17633756848
05;2020-05-26;0;0;0;468.146063921917;510.087601910415;59;978.233665832332
05;2020-05-26;0;0;0;340.368470050554;334.366842191253;69;674.735312241807
05;2020-05-26;0;0;0;212.598666888387;192.597753227106;79;405.196420115493
05;2020-05-26;0;0;0;148.727797095705;61.8681715431829;89;210.595968638888
05;2020-05-26;0;0;0;32.9601271090696;10.9909785719784;90;43.9511056810479
05;2020-05-26;0;0;0;3061.43020057959;2935.56979942041;0;5997
06;2020-05-26;2;0;2;42583;42380;09;84963
06;2020-05-26;2;0;2;33369;31925;19;65294
06;2020-05-26;8;2;10;21571;15080;29;36651
06;2020-05-26;5;3;8;21550;16147;39;37697
06;2020-05-26;2;2;4;14193;13939;49;28132
06;2020-05-26;0;1;1;7171;7597;59;14768
06;2020-05-26;0;1;1;3629;4117;69;7746
06;2020-05-26;0;0;0;1577;1457;79;3034
06;2020-05-26;0;0;0;531;474;89;1005
06;2020-05-26;0;0;0;88;93;90;181
06;2020-05-26;19;9;28;146262;133209;0;279471
07;2020-05-26;0;0;0;485;549;09;1034
07;2020-05-26;0;0;0;403;432;19;835
07;2020-05-26;0;0;0;764;841;29;1605
07;2020-05-26;0;0;0;824;928;39;1752
07;2020-05-26;0;0;0;788;1020;49;1808
07;2020-05-26;0;0;0;678;870;59;1548
07;2020-05-26;0;0;0;360;382;69;742
07;2020-05-26;0;0;0;231;190;79;421
07;2020-05-26;0;0;0;114;67;89;181
07;2020-05-26;0;0;0;24;11;90;35
07;2020-05-26;0;0;0;4671;5290;0;9961
08;2020-05-26;0;0;0;2715.22592983026;2997.75551488675;09;5712.98144471701
08;2020-05-26;0;0;0;2778.51901080978;3160.9156459093;19;5939.43465671908
08;2020-05-26;0;0;0;2080.8882988764;1718.16634315323;29;3799.05464202964
08;2020-05-26;0;0;0;2701.8582062647;1896.52641413317;39;4598.38462039786
08;2020-05-26;0;0;0;3151.45861023308;2460.52498233809;49;5611.98359257117
08;2020-05-26;0;0;0;2620.29868333099;2422.23566154656;59;5042.53434487755
08;2020-05-26;0;0;0;1621.44173420671;1438.58325779464;69;3060.02499200135
08;2020-05-26;0;0;0;626.575909335673;526.358467843651;79;1152.93437717932
08;2020-05-26;0;0;0;205.018522985054;140.993639349697;89;346.012162334751
08;2020-05-26;0;0;0;50.0325684687745;20.62259870351;90;70.6551671722846
08;2020-05-26;0;0;0;18551.3174743414;16782.6825256586;0;35334
11;2020-05-26;3;4;15;783071;811785;09;1594856
11;2020-05-26;4;10;14;761456;784653;19;1546109
11;2020-05-26;16;13;29;850145;801772;29;1651917
11;2020-05-26;11;10;21;914360;843488;39;1757848
11;2020-05-26;18;14;32;845609;826202;49;1671811
11;2020-05-26;24;10;34;793566;745070;59;1538636
11;2020-05-26;10;10;20;628649;549192;69;1177841
11;2020-05-26;8;4;12;434606;358356;79;792962
11;2020-05-26;23;7;31;261425;162933;89;424358
11;2020-05-26;44;2;46;89253;32619;90;121872
11;2020-05-26;161;84;256;6362140;5916070;0;12278210
24;2020-05-26;0;0;0;139720;144686;09;284406
24;2020-05-26;0;1;1;152979;161185;19;314164
24;2020-05-26;3;0;3;122237;126536;29;248773
24;2020-05-26;1;2;3;150359;142009;39;292368
24;2020-05-26;1;3;4;161829;158758;49;320587
24;2020-05-26;2;3;5;172552;168011;59;340563
24;2020-05-26;1;1;2;172509;158177;69;330686
24;2020-05-26;0;1;1;129428;110593;79;240021
24;2020-05-26;1;0;1;87342;56882;89;144224
24;2020-05-26;3;1;4;31210;12071;90;43281
24;2020-05-26;12;12;24;1320165;1238908;0;2559073
27;2020-05-26;0;0;0;143373;149679;09;293052
27;2020-05-26;0;0;0;160962;173003;19;333965
27;2020-05-26;1;0;1;133746;142254;29;276000
27;2020-05-26;0;0;0;160004;155407;39;315411
27;2020-05-26;0;2;2;172333;169564;49;341897
27;2020-05-26;3;0;3;189979;183788;59;373767
27;2020-05-26;0;0;0;192591;178206;69;370797
27;2020-05-26;0;0;0;146876;127546;79;274422
27;2020-05-26;1;4;5;96896;61575;89;158471
27;2020-05-26;0;0;0;33148;12109;90;45257
27;2020-05-26;5;6;11;1429908;1353131;0;2783039
28;2020-05-26;0;1;1;180735;186856;09;367591
28;2020-05-26;0;1;1;200125;213621;19;413746
28;2020-05-26;0;0;0;168922;173007;29;341929
28;2020-05-26;2;0;2;196628;188487;39;385115
28;2020-05-26;0;0;0;205396;201699;49;407095
28;2020-05-26;0;2;2;222002;213866;59;435868
28;2020-05-26;1;1;2;224688;203758;69;428446
28;2020-05-26;0;0;0;163192;135543;79;298735
28;2020-05-26;2;1;3;109691;65377;89;175068
28;2020-05-26;0;1;1;37222;12685;90;49907
28;2020-05-26;5;7;12;1708601;1594899;0;3303500
32;2020-05-26;3;0;3;358062;373689;09;731751
32;2020-05-26;4;5;9;387045;406742;19;793787
32;2020-05-26;8;6;14;342304;348587;29;690891
32;2020-05-26;7;4;11;382485;369972;39;752457
32;2020-05-26;11;4;15;382510;376716;49;759226
32;2020-05-26;8;5;13;386937;376527;59;763464
32;2020-05-26;5;5;10;371211;330938;69;702149
32;2020-05-26;6;4;10;250542;201459;79;452001
32;2020-05-26;13;2;16;163399;89786;89;253185
32;2020-05-26;14;2;16;48384;15367;90;63751
32;2020-05-26;79;37;117;3072879;2889783;0;5962662
44;2020-05-26;0;1;1;291525;306839;09;598364
44;2020-05-26;2;4;6;320255;339504;19;659759
44;2020-05-26;7;4;11;302020;314428;29;616448
44;2020-05-26;5;2;7;342222;333292;39;675514
44;2020-05-26;3;6;9;349727;344491;49;694218
44;2020-05-26;8;0;8;381371;373239;59;754610
44;2020-05-26;4;4;8;367165;335850;69;703015
44;2020-05-26;5;3;8;250387;215436;79;465823
44;2020-05-26;11;11;22;170825;105192;89;276017
44;2020-05-26;11;0;11;51248;16731;90;67979
44;2020-05-26;56;35;91;2826745;2685002;0;5511747
52;2020-05-26;0;0;1;213594;223900;09;437494
52;2020-05-26;0;0;0;240818;255197;19;496015
52;2020-05-26;0;2;2;197010;200630;29;397640
52;2020-05-26;4;5;9;231204;224885;39;456089
52;2020-05-26;0;5;5;243874;243418;49;487292
52;2020-05-26;3;3;6;244100;239116;59;483216
52;2020-05-26;3;1;4;241796;221345;69;463141
52;2020-05-26;2;2;4;177805;149903;79;327708
52;2020-05-26;0;0;0;119561;75822;89;195383
52;2020-05-26;4;2;6;42559;15260;90;57819
52;2020-05-26;16;20;37;1952321;1849476;0;3801797
53;2020-05-26;0;0;0;173813;182358;09;356171
53;2020-05-26;1;2;3;202720;214740;19;417460
53;2020-05-26;0;1;1;163116;173196;29;336312
53;2020-05-26;2;1;3;190526;187674;39;378200
53;2020-05-26;2;3;5;212098;212015;49;424113
53;2020-05-26;1;2;3;223699;219176;59;442875
53;2020-05-26;1;1;2;227435;209274;69;436709
53;2020-05-26;0;0;0;169992;140910;79;310902
53;2020-05-26;0;0;0;118117;69883;89;188000
53;2020-05-26;0;1;1;37370;12267;90;49637
53;2020-05-26;7;11;18;1718886;1621493;0;3340379
75;2020-05-26;0;0;0;293104;305291;09;598395
75;2020-05-26;0;0;0;337141;357785;19;694926
75;2020-05-26;4;9;13;295024;300618;29;595642
75;2020-05-26;1;4;5;347871;331233;39;679104
75;2020-05-26;3;6;9;384742;372771;49;757513
75;2020-05-26;7;0;7;413361;390880;59;804241
75;2020-05-26;4;0;4;425623;384060;69;809683
75;2020-05-26;2;2;4;325086;276298;79;601384
75;2020-05-26;1;0;1;213986;139308;89;353294
75;2020-05-26;0;0;0;77600;28200;90;105800
75;2020-05-26;22;21;43;3113538;2886444;0;5999982
76;2020-05-26;0;1;1;305956;318589;09;624545
76;2020-05-26;0;1;1;338942;356969;19;695911
76;2020-05-26;1;2;3;316210;319570;29;635780
76;2020-05-26;0;0;0;356758;337587;39;694345
76;2020-05-26;2;3;5;376541;363812;49;740353
76;2020-05-26;0;0;0;402608;383750;59;786358
76;2020-05-26;0;0;0;394889;358997;69;753886
76;2020-05-26;1;0;1;308664;263806;79;572470
76;2020-05-26;3;1;4;195838;129272;89;325110
76;2020-05-26;1;2;3;69372;26728;90;96100
76;2020-05-26;8;10;18;3065778;2859080;0;5924858
84;2020-05-26;0;0;0;459549;481088;09;940637
84;2020-05-26;1;0;1;487711;511905;19;999616
84;2020-05-26;2;0;2;443824;451094;29;894918
84;2020-05-26;5;2;7;512522;493262;39;1005784
84;2020-05-26;3;1;4;520248;515106;49;1035354
84;2020-05-26;4;5;9;529611;514848;59;1044459
84;2020-05-26;1;5;6;486720;439940;69;926660
84;2020-05-26;5;1;6;372151;315211;79;687362
84;2020-05-26;2;2;4;237198;150524;89;387722
84;2020-05-26;2;1;3;81185;28680;90;109865
84;2020-05-26;25;17;42;4130719;3901658;0;8032377
93;2020-05-26;2;1;3;268834;283093;09;551927
93;2020-05-26;2;1;3;280751;296087;19;576838
93;2020-05-26;0;3;3;254404;255552;29;509956
93;2020-05-26;1;2;3;310704;288398;39;599102
93;2020-05-26;2;4;6;325559;305827;49;631386
93;2020-05-26;3;2;5;353104;325389;59;678493
93;2020-05-26;2;2;4;336327;296459;69;632786
93;2020-05-26;1;3;4;279820;229699;79;509519
93;2020-05-26;1;3;4;171274;113716;89;284990
93;2020-05-26;4;3;7;58896;21758;90;80654
93;2020-05-26;18;24;42;2639673;2415978;0;5055651
94;2020-05-26;0;0;0;16311;17433;09;33744
94;2020-05-26;0;0;0;16679;18132;19;34811
94;2020-05-26;0;0;0;16782;16579;29;33361
94;2020-05-26;0;0;0;23044;20580;39;43624
94;2020-05-26;0;0;0;23065;22140;49;45205
94;2020-05-26;0;0;0;24549;23421;59;47970
94;2020-05-26;0;0;0;23212;21883;69;45095
94;2020-05-26;0;0;0;19544;17141;79;36685
94;2020-05-26;1;0;1;11227;8178;89;19405
94;2020-05-26;0;0;0;3332;1447;90;4779
94;2020-05-26;1;0;1;177745;166934;0;344679
01;2020-05-27;0;0;0;19979;20155;09;40134
01;2020-05-27;0;0;0;24994;25489;19;50483
01;2020-05-27;0;0;0;17868;16690;29;34558
01;2020-05-27;0;0;0;22328;14821;39;37149
01;2020-05-27;0;0;0;28652;20276;49;48928
01;2020-05-27;0;0;0;33264;27260;59;60524
01;2020-05-27;0;0;0;27135;23978;69;51113
01;2020-05-27;0;0;0;18401;14661;79;33062
01;2020-05-27;0;0;0;9633;6375;89;16008
01;2020-05-27;0;0;0;3410;1510;90;4920
01;2020-05-27;0;0;0;205664;171215;0;376879
02;2020-05-27;0;0;0;16881;17110;09;33991
02;2020-05-27;0;0;0;21410;21604;19;43014
02;2020-05-27;0;0;0;16017;15479;29;31496
02;2020-05-27;0;0;0;19825;14455;39;34280
02;2020-05-27;0;0;0;24719;18248;49;42967
02;2020-05-27;0;0;0;34361;28310;59;62671
02;2020-05-27;0;0;0;28061;24495;69;52556
02;2020-05-27;0;0;0;18231;15278;79;33509
02;2020-05-27;0;0;0;11090;7677;89;18767
02;2020-05-27;0;0;0;3992;1506;90;5498
02;2020-05-27;0;0;0;194587;164162;0;358749
03;2020-05-27;0;1;1;31123;30920;09;62043
03;2020-05-27;3;3;6;29370;29268;19;58638
03;2020-05-27;1;2;3;21458;18963;29;40421
03;2020-05-27;1;3;4;21276;18326;39;39602
03;2020-05-27;0;2;2;18164;16593;49;34757
03;2020-05-27;1;1;2;13469;13557;59;27026
03;2020-05-27;0;1;1;8776;8670;69;17446
03;2020-05-27;0;0;0;3777;3591;79;7368
03;2020-05-27;0;1;1;1649;1072;89;2721
03;2020-05-27;0;0;0;485;184;90;669
03;2020-05-27;6;14;20;149547;141144;0;290691
04;2020-05-27;0;0;0;60314;61377;09;121691
04;2020-05-27;0;0;0;66065;68387;19;134452
04;2020-05-27;1;1;2;51059;47156;29;98215
04;2020-05-27;0;0;0;58788;45780;39;104568
04;2020-05-27;0;0;0;61408;52207;49;113615
04;2020-05-27;0;0;0;64838;60759;59;125597
04;2020-05-27;0;0;0;47008;42843;69;89851
04;2020-05-27;0;0;0;25509;21184;79;46693
04;2020-05-27;0;0;0;13168;7647;89;20815
04;2020-05-27;0;0;0;3209;1253;90;4462
04;2020-05-27;1;1;2;451366;408593;0;859959
05;2020-05-27;0;0;0;362.366008612902;341.338819562748;09;703.704828175651
05;2020-05-27;0;0;0;353.376145114279;370.349735405642;19;723.725880519921
05;2020-05-27;0;0;0;218.593559489256;256.539602589476;29;475.133162078732
05;2020-05-27;0;0;0;404.225408693299;360.321910454353;39;764.547319147651
05;2020-05-27;0;0;0;520.067953604221;497.108383964256;49;1017.17633756848
05;2020-05-27;0;0;0;468.146063921917;510.087601910415;59;978.233665832332
05;2020-05-27;0;0;0;340.368470050554;334.366842191253;69;674.735312241807
05;2020-05-27;0;0;0;212.598666888387;192.597753227106;79;405.196420115493
05;2020-05-27;0;0;0;148.727797095705;61.8681715431829;89;210.595968638888
05;2020-05-27;0;0;0;32.9601271090696;10.9909785719784;90;43.9511056810479
05;2020-05-27;0;0;0;3061.43020057959;2935.56979942041;0;5997
06;2020-05-27;0;0;0;42583;42380;09;84963
06;2020-05-27;0;1;1;33369;31925;19;65294
06;2020-05-27;3;1;4;21571;15080;29;36651
06;2020-05-27;2;0;2;21550;16147;39;37697
06;2020-05-27;3;3;6;14193;13939;49;28132
06;2020-05-27;0;0;0;7171;7597;59;14768
06;2020-05-27;1;3;4;3629;4117;69;7746
06;2020-05-27;0;0;0;1577;1457;79;3034
06;2020-05-27;0;0;0;531;474;89;1005
06;2020-05-27;0;0;0;88;93;90;181
06;2020-05-27;9;8;17;146262;133209;0;279471
07;2020-05-27;0;0;0;485;549;09;1034
07;2020-05-27;0;0;0;403;432;19;835
07;2020-05-27;0;0;0;764;841;29;1605
07;2020-05-27;0;0;0;824;928;39;1752
07;2020-05-27;0;0;0;788;1020;49;1808
07;2020-05-27;0;0;0;678;870;59;1548
07;2020-05-27;0;0;0;360;382;69;742
07;2020-05-27;0;0;0;231;190;79;421
07;2020-05-27;0;0;0;114;67;89;181
07;2020-05-27;0;0;0;24;11;90;35
07;2020-05-27;0;0;0;4671;5290;0;9961
08;2020-05-27;0;0;0;2715.22592983026;2997.75551488675;09;5712.98144471701
08;2020-05-27;0;0;0;2778.51901080978;3160.9156459093;19;5939.43465671908
08;2020-05-27;0;0;0;2080.8882988764;1718.16634315323;29;3799.05464202964
08;2020-05-27;0;0;0;2701.8582062647;1896.52641413317;39;4598.38462039786
08;2020-05-27;0;0;0;3151.45861023308;2460.52498233809;49;5611.98359257117
08;2020-05-27;0;0;0;2620.29868333099;2422.23566154656;59;5042.53434487755
08;2020-05-27;0;0;0;1621.44173420671;1438.58325779464;69;3060.02499200135
08;2020-05-27;0;0;0;626.575909335673;526.358467843651;79;1152.93437717932
08;2020-05-27;0;0;0;205.018522985054;140.993639349697;89;346.012162334751
08;2020-05-27;0;0;0;50.0325684687745;20.62259870351;90;70.6551671722846
08;2020-05-27;0;0;0;18551.3174743414;16782.6825256586;0;35334
11;2020-05-27;3;4;7;783071;811785;09;1594856
11;2020-05-27;9;7;16;761456;784653;19;1546109
11;2020-05-27;11;8;19;850145;801772;29;1651917
11;2020-05-27;11;13;24;914360;843488;39;1757848
11;2020-05-27;18;13;31;845609;826202;49;1671811
11;2020-05-27;15;12;28;793566;745070;59;1538636
11;2020-05-27;17;16;33;628649;549192;69;1177841
11;2020-05-27;8;9;17;434606;358356;79;792962
11;2020-05-27;18;15;33;261425;162933;89;424358
11;2020-05-27;34;3;37;89253;32619;90;121872
11;2020-05-27;144;100;245;6362140;5916070;0;12278210
24;2020-05-27;0;0;0;139720;144686;09;284406
24;2020-05-27;1;0;1;152979;161185;19;314164
24;2020-05-27;1;0;2;122237;126536;29;248773
24;2020-05-27;1;0;1;150359;142009;39;292368
24;2020-05-27;2;2;4;161829;158758;49;320587
24;2020-05-27;0;0;0;172552;168011;59;340563
24;2020-05-27;1;3;4;172509;158177;69;330686
24;2020-05-27;1;2;3;129428;110593;79;240021
24;2020-05-27;1;0;1;87342;56882;89;144224
24;2020-05-27;0;0;0;31210;12071;90;43281
24;2020-05-27;8;7;16;1320165;1238908;0;2559073
27;2020-05-27;0;0;0;143373;149679;09;293052
27;2020-05-27;0;0;0;160962;173003;19;333965
27;2020-05-27;1;0;1;133746;142254;29;276000
27;2020-05-27;0;0;0;160004;155407;39;315411
27;2020-05-27;2;0;2;172333;169564;49;341897
27;2020-05-27;0;3;3;189979;183788;59;373767
27;2020-05-27;0;1;1;192591;178206;69;370797
27;2020-05-27;0;4;4;146876;127546;79;274422
27;2020-05-27;2;1;3;96896;61575;89;158471
27;2020-05-27;1;0;1;33148;12109;90;45257
27;2020-05-27;6;9;15;1429908;1353131;0;2783039
28;2020-05-27;0;1;1;180735;186856;09;367591
28;2020-05-27;0;0;0;200125;213621;19;413746
28;2020-05-27;1;0;1;168922;173007;29;341929
28;2020-05-27;1;0;1;196628;188487;39;385115
28;2020-05-27;1;0;1;205396;201699;49;407095
28;2020-05-27;2;0;2;222002;213866;59;435868
28;2020-05-27;1;0;1;224688;203758;69;428446
28;2020-05-27;0;0;0;163192;135543;79;298735
28;2020-05-27;0;0;0;109691;65377;89;175068
28;2020-05-27;1;0;1;37222;12685;90;49907
28;2020-05-27;7;1;8;1708601;1594899;0;3303500
32;2020-05-27;0;2;2;358062;373689;09;731751
32;2020-05-27;4;4;8;387045;406742;19;793787
32;2020-05-27;10;2;12;342304;348587;29;690891
32;2020-05-27;4;3;7;382485;369972;39;752457
32;2020-05-27;7;4;11;382510;376716;49;759226
32;2020-05-27;8;5;13;386937;376527;59;763464
32;2020-05-27;3;1;4;371211;330938;69;702149
32;2020-05-27;8;5;13;250542;201459;79;452001
32;2020-05-27;14;9;23;163399;89786;89;253185
32;2020-05-27;9;2;11;48384;15367;90;63751
32;2020-05-27;67;37;104;3072879;2889783;0;5962662
44;2020-05-27;0;1;1;291525;306839;09;598364
44;2020-05-27;0;1;1;320255;339504;19;659759
44;2020-05-27;7;4;11;302020;314428;29;616448
44;2020-05-27;3;6;9;342222;333292;39;675514
44;2020-05-27;8;1;9;349727;344491;49;694218
44;2020-05-27;4;4;8;381371;373239;59;754610
44;2020-05-27;4;2;6;367165;335850;69;703015
44;2020-05-27;1;2;3;250387;215436;79;465823
44;2020-05-27;3;1;4;170825;105192;89;276017
44;2020-05-27;6;2;8;51248;16731;90;67979
44;2020-05-27;36;24;60;2826745;2685002;0;5511747
52;2020-05-27;1;4;5;213594;223900;09;437494
52;2020-05-27;1;1;2;240818;255197;19;496015
52;2020-05-27;3;3;6;197010;200630;29;397640
52;2020-05-27;4;6;10;231204;224885;39;456089
52;2020-05-27;6;2;8;243874;243418;49;487292
52;2020-05-27;6;3;9;244100;239116;59;483216
52;2020-05-27;3;1;4;241796;221345;69;463141
52;2020-05-27;1;1;2;177805;149903;79;327708
52;2020-05-27;4;1;5;119561;75822;89;195383
52;2020-05-27;5;0;5;42559;15260;90;57819
52;2020-05-27;34;22;56;1952321;1849476;0;3801797
53;2020-05-27;0;0;0;173813;182358;09;356171
53;2020-05-27;1;3;4;202720;214740;19;417460
53;2020-05-27;2;4;6;163116;173196;29;336312
53;2020-05-27;2;1;3;190526;187674;39;378200
53;2020-05-27;2;2;4;212098;212015;49;424113
53;2020-05-27;0;0;0;223699;219176;59;442875
53;2020-05-27;1;0;1;227435;209274;69;436709
53;2020-05-27;1;0;1;169992;140910;79;310902
53;2020-05-27;1;0;1;118117;69883;89;188000
53;2020-05-27;1;0;1;37370;12267;90;49637
53;2020-05-27;11;10;21;1718886;1621493;0;3340379
75;2020-05-27;3;1;4;293104;305291;09;598395
75;2020-05-27;0;3;3;337141;357785;19;694926
75;2020-05-27;3;2;5;295024;300618;29;595642
75;2020-05-27;0;2;2;347871;331233;39;679104
75;2020-05-27;3;6;9;384742;372771;49;757513
75;2020-05-27;4;1;5;413361;390880;59;804241
75;2020-05-27;1;2;3;425623;384060;69;809683
75;2020-05-27;2;2;4;325086;276298;79;601384
75;2020-05-27;1;1;2;213986;139308;89;353294
75;2020-05-27;4;1;5;77600;28200;90;105800
75;2020-05-27;21;21;42;3113538;2886444;0;5999982
76;2020-05-27;0;0;0;305956;318589;09;624545
76;2020-05-27;0;1;1;338942;356969;19;695911
76;2020-05-27;2;2;4;316210;319570;29;635780
76;2020-05-27;2;1;3;356758;337587;39;694345
76;2020-05-27;4;2;6;376541;363812;49;740353
76;2020-05-27;1;4;5;402608;383750;59;786358
76;2020-05-27;2;0;2;394889;358997;69;753886
76;2020-05-27;0;5;5;308664;263806;79;572470
76;2020-05-27;2;0;2;195838;129272;89;325110
76;2020-05-27;3;1;4;69372;26728;90;96100
76;2020-05-27;16;16;32;3065778;2859080;0;5924858
84;2020-05-27;0;1;1;459549;481088;09;940637
84;2020-05-27;0;0;0;487711;511905;19;999616
84;2020-05-27;4;0;4;443824;451094;29;894918
84;2020-05-27;3;3;6;512522;493262;39;1005784
84;2020-05-27;7;2;9;520248;515106;49;1035354
84;2020-05-27;3;4;7;529611;514848;59;1044459
84;2020-05-27;1;4;5;486720;439940;69;926660
84;2020-05-27;3;2;5;372151;315211;79;687362
84;2020-05-27;3;1;4;237198;150524;89;387722
84;2020-05-27;4;1;5;81185;28680;90;109865
84;2020-05-27;28;18;47;4130719;3901658;0;8032377
93;2020-05-27;0;1;1;268834;283093;09;551927
93;2020-05-27;1;1;2;280751;296087;19;576838
93;2020-05-27;3;0;4;254404;255552;29;509956
93;2020-05-27;3;4;7;310704;288398;39;599102
93;2020-05-27;3;4;7;325559;305827;49;631386
93;2020-05-27;3;2;5;353104;325389;59;678493
93;2020-05-27;2;0;2;336327;296459;69;632786
93;2020-05-27;1;3;4;279820;229699;79;509519
93;2020-05-27;1;1;2;171274;113716;89;284990
93;2020-05-27;5;1;6;58896;21758;90;80654
93;2020-05-27;22;17;40;2639673;2415978;0;5055651
94;2020-05-27;0;0;0;16311;17433;09;33744
94;2020-05-27;0;0;0;16679;18132;19;34811
94;2020-05-27;0;0;0;16782;16579;29;33361
94;2020-05-27;0;0;0;23044;20580;39;43624
94;2020-05-27;0;0;0;23065;22140;49;45205
94;2020-05-27;0;0;0;24549;23421;59;47970
94;2020-05-27;0;0;0;23212;21883;69;45095
94;2020-05-27;0;0;0;19544;17141;79;36685
94;2020-05-27;0;0;0;11227;8178;89;19405
94;2020-05-27;0;0;0;3332;1447;90;4779
94;2020-05-27;0;0;0;177745;166934;0;344679
01;2020-05-28;0;0;0;19979;20155;09;40134
01;2020-05-28;0;0;0;24994;25489;19;50483
01;2020-05-28;0;0;0;17868;16690;29;34558
01;2020-05-28;0;0;0;22328;14821;39;37149
01;2020-05-28;1;0;1;28652;20276;49;48928
01;2020-05-28;0;0;0;33264;27260;59;60524
01;2020-05-28;0;0;0;27135;23978;69;51113
01;2020-05-28;0;0;0;18401;14661;79;33062
01;2020-05-28;0;0;0;9633;6375;89;16008
01;2020-05-28;0;0;0;3410;1510;90;4920
01;2020-05-28;1;0;1;205664;171215;0;376879
02;2020-05-28;0;0;0;16881;17110;09;33991
02;2020-05-28;0;0;0;21410;21604;19;43014
02;2020-05-28;0;0;0;16017;15479;29;31496
02;2020-05-28;0;0;0;19825;14455;39;34280
02;2020-05-28;0;0;0;24719;18248;49;42967
02;2020-05-28;1;0;1;34361;28310;59;62671
02;2020-05-28;0;0;0;28061;24495;69;52556
02;2020-05-28;0;0;0;18231;15278;79;33509
02;2020-05-28;1;0;1;11090;7677;89;18767
02;2020-05-28;0;0;0;3992;1506;90;5498
02;2020-05-28;2;0;2;194587;164162;0;358749
03;2020-05-28;0;0;0;31123;30920;09;62043
03;2020-05-28;0;0;0;29370;29268;19;58638
03;2020-05-28;0;0;0;21458;18963;29;40421
03;2020-05-28;0;1;1;21276;18326;39;39602
03;2020-05-28;0;1;1;18164;16593;49;34757
03;2020-05-28;2;0;2;13469;13557;59;27026
03;2020-05-28;0;1;1;8776;8670;69;17446
03;2020-05-28;1;0;1;3777;3591;79;7368
03;2020-05-28;0;0;0;1649;1072;89;2721
03;2020-05-28;0;0;0;485;184;90;669
03;2020-05-28;3;3;6;149547;141144;0;290691
04;2020-05-28;0;1;1;60314;61377;09;121691
04;2020-05-28;1;1;2;66065;68387;19;134452
04;2020-05-28;0;0;0;51059;47156;29;98215
04;2020-05-28;1;0;1;58788;45780;39;104568
04;2020-05-28;0;0;0;61408;52207;49;113615
04;2020-05-28;0;0;0;64838;60759;59;125597
04;2020-05-28;0;1;1;47008;42843;69;89851
04;2020-05-28;0;0;0;25509;21184;79;46693
04;2020-05-28;0;0;0;13168;7647;89;20815
04;2020-05-28;0;0;0;3209;1253;90;4462
04;2020-05-28;2;3;5;451366;408593;0;859959
05;2020-05-28;0;0;0;362.366008612902;341.338819562748;09;703.704828175651
05;2020-05-28;0;0;0;353.376145114279;370.349735405642;19;723.725880519921
05;2020-05-28;0;0;0;218.593559489256;256.539602589476;29;475.133162078732
05;2020-05-28;0;0;0;404.225408693299;360.321910454353;39;764.547319147651
05;2020-05-28;0;0;0;520.067953604221;497.108383964256;49;1017.17633756848
05;2020-05-28;0;0;0;468.146063921917;510.087601910415;59;978.233665832332
05;2020-05-28;0;0;0;340.368470050554;334.366842191253;69;674.735312241807
05;2020-05-28;0;0;0;212.598666888387;192.597753227106;79;405.196420115493
05;2020-05-28;0;0;0;148.727797095705;61.8681715431829;89;210.595968638888
05;2020-05-28;0;0;0;32.9601271090696;10.9909785719784;90;43.9511056810479
05;2020-05-28;0;0;0;3061.43020057959;2935.56979942041;0;5997
06;2020-05-28;0;0;0;42583;42380;09;84963
06;2020-05-28;2;2;4;33369;31925;19;65294
06;2020-05-28;3;20;23;21571;15080;29;36651
06;2020-05-28;4;8;12;21550;16147;39;37697
06;2020-05-28;2;4;6;14193;13939;49;28132
06;2020-05-28;1;2;3;7171;7597;59;14768
06;2020-05-28;1;1;2;3629;4117;69;7746
06;2020-05-28;0;0;0;1577;1457;79;3034
06;2020-05-28;0;0;0;531;474;89;1005
06;2020-05-28;0;0;0;88;93;90;181
06;2020-05-28;13;37;50;146262;133209;0;279471
07;2020-05-28;0;0;0;485;549;09;1034
07;2020-05-28;0;0;0;403;432;19;835
07;2020-05-28;0;0;0;764;841;29;1605
07;2020-05-28;0;0;0;824;928;39;1752
07;2020-05-28;0;0;0;788;1020;49;1808
07;2020-05-28;0;0;0;678;870;59;1548
07;2020-05-28;0;0;0;360;382;69;742
07;2020-05-28;0;0;0;231;190;79;421
07;2020-05-28;0;0;0;114;67;89;181
07;2020-05-28;0;0;0;24;11;90;35
07;2020-05-28;0;0;0;4671;5290;0;9961
08;2020-05-28;0;0;0;2715.22592983026;2997.75551488675;09;5712.98144471701
08;2020-05-28;0;0;0;2778.51901080978;3160.9156459093;19;5939.43465671908
08;2020-05-28;0;0;0;2080.8882988764;1718.16634315323;29;3799.05464202964
08;2020-05-28;0;0;0;2701.8582062647;1896.52641413317;39;4598.38462039786
08;2020-05-28;0;0;0;3151.45861023308;2460.52498233809;49;5611.98359257117
08;2020-05-28;0;0;0;2620.29868333099;2422.23566154656;59;5042.53434487755
08;2020-05-28;0;0;0;1621.44173420671;1438.58325779464;69;3060.02499200135
08;2020-05-28;0;0;0;626.575909335673;526.358467843651;79;1152.93437717932
08;2020-05-28;0;0;0;205.018522985054;140.993639349697;89;346.012162334751
08;2020-05-28;0;0;0;50.0325684687745;20.62259870351;90;70.6551671722846
08;2020-05-28;0;0;0;18551.3174743414;16782.6825256586;0;35334
11;2020-05-28;5;1;6;783071;811785;09;1594856
11;2020-05-28;5;14;19;761456;784653;19;1546109
11;2020-05-28;19;8;27;850145;801772;29;1651917
11;2020-05-28;12;13;25;914360;843488;39;1757848
11;2020-05-28;18;11;29;845609;826202;49;1671811
11;2020-05-28;10;9;19;793566;745070;59;1538636
11;2020-05-28;8;8;16;628649;549192;69;1177841
11;2020-05-28;6;3;9;434606;358356;79;792962
11;2020-05-28;11;4;15;261425;162933;89;424358
11;2020-05-28;12;0;12;89253;32619;90;121872
11;2020-05-28;107;71;179;6362140;5916070;0;12278210
24;2020-05-28;1;1;2;139720;144686;09;284406
24;2020-05-28;1;1;2;152979;161185;19;314164
24;2020-05-28;4;3;7;122237;126536;29;248773
24;2020-05-28;3;2;5;150359;142009;39;292368
24;2020-05-28;4;1;5;161829;158758;49;320587
24;2020-05-28;1;1;2;172552;168011;59;340563
24;2020-05-28;1;1;2;172509;158177;69;330686
24;2020-05-28;2;0;2;129428;110593;79;240021
24;2020-05-28;6;3;9;87342;56882;89;144224
24;2020-05-28;6;2;8;31210;12071;90;43281
24;2020-05-28;29;15;44;1320165;1238908;0;2559073
27;2020-05-28;0;0;0;143373;149679;09;293052
27;2020-05-28;0;0;0;160962;173003;19;333965
27;2020-05-28;4;0;4;133746;142254;29;276000
27;2020-05-28;3;0;3;160004;155407;39;315411
27;2020-05-28;0;0;0;172333;169564;49;341897
27;2020-05-28;1;0;1;189979;183788;59;373767
27;2020-05-28;0;0;0;192591;178206;69;370797
27;2020-05-28;1;1;2;146876;127546;79;274422
27;2020-05-28;1;0;1;96896;61575;89;158471
27;2020-05-28;2;0;2;33148;12109;90;45257
27;2020-05-28;12;1;13;1429908;1353131;0;2783039
28;2020-05-28;0;0;0;180735;186856;09;367591
28;2020-05-28;1;0;1;200125;213621;19;413746
28;2020-05-28;1;1;2;168922;173007;29;341929
28;2020-05-28;0;0;0;196628;188487;39;385115
28;2020-05-28;0;0;0;205396;201699;49;407095
28;2020-05-28;0;1;1;222002;213866;59;435868
28;2020-05-28;0;0;0;224688;203758;69;428446
28;2020-05-28;0;0;0;163192;135543;79;298735
28;2020-05-28;1;0;1;109691;65377;89;175068
28;2020-05-28;1;0;1;37222;12685;90;49907
28;2020-05-28;4;2;6;1708601;1594899;0;3303500
32;2020-05-28;0;0;0;358062;373689;09;731751
32;2020-05-28;2;0;2;387045;406742;19;793787
32;2020-05-28;4;5;9;342304;348587;29;690891
32;2020-05-28;7;2;9;382485;369972;39;752457
32;2020-05-28;10;3;13;382510;376716;49;759226
32;2020-05-28;3;1;4;386937;376527;59;763464
32;2020-05-28;3;4;7;371211;330938;69;702149
32;2020-05-28;1;1;2;250542;201459;79;452001
32;2020-05-28;2;2;4;163399;89786;89;253185
32;2020-05-28;5;0;5;48384;15367;90;63751
32;2020-05-28;37;18;55;3072879;2889783;0;5962662
44;2020-05-28;2;1;3;291525;306839;09;598364
44;2020-05-28;2;1;3;320255;339504;19;659759
44;2020-05-28;4;4;9;302020;314428;29;616448
44;2020-05-28;3;2;6;342222;333292;39;675514
44;2020-05-28;1;3;4;349727;344491;49;694218
44;2020-05-28;5;4;9;381371;373239;59;754610
44;2020-05-28;4;5;9;367165;335850;69;703015
44;2020-05-28;4;3;7;250387;215436;79;465823
44;2020-05-28;9;3;12;170825;105192;89;276017
44;2020-05-28;5;1;6;51248;16731;90;67979
44;2020-05-28;39;27;68;2826745;2685002;0;5511747
52;2020-05-28;0;1;1;213594;223900;09;437494
52;2020-05-28;3;5;8;240818;255197;19;496015
52;2020-05-28;3;1;4;197010;200630;29;397640
52;2020-05-28;1;2;3;231204;224885;39;456089
52;2020-05-28;1;4;5;243874;243418;49;487292
52;2020-05-28;2;4;6;244100;239116;59;483216
52;2020-05-28;1;0;1;241796;221345;69;463141
52;2020-05-28;1;2;3;177805;149903;79;327708
52;2020-05-28;0;1;1;119561;75822;89;195383
52;2020-05-28;6;3;9;42559;15260;90;57819
52;2020-05-28;18;23;41;1952321;1849476;0;3801797
53;2020-05-28;0;1;1;173813;182358;09;356171
53;2020-05-28;0;1;1;202720;214740;19;417460
53;2020-05-28;1;0;1;163116;173196;29;336312
53;2020-05-28;0;1;1;190526;187674;39;378200
53;2020-05-28;2;1;3;212098;212015;49;424113
53;2020-05-28;1;1;2;223699;219176;59;442875
53;2020-05-28;1;0;1;227435;209274;69;436709
53;2020-05-28;2;0;2;169992;140910;79;310902
53;2020-05-28;3;2;5;118117;69883;89;188000
53;2020-05-28;1;0;1;37370;12267;90;49637
53;2020-05-28;11;7;18;1718886;1621493;0;3340379
75;2020-05-28;1;0;1;293104;305291;09;598395
75;2020-05-28;1;1;2;337141;357785;19;694926
75;2020-05-28;1;2;3;295024;300618;29;595642
75;2020-05-28;2;2;4;347871;331233;39;679104
75;2020-05-28;0;4;4;384742;372771;49;757513
75;2020-05-28;0;3;3;413361;390880;59;804241
75;2020-05-28;0;1;1;425623;384060;69;809683
75;2020-05-28;1;0;1;325086;276298;79;601384
75;2020-05-28;1;2;3;213986;139308;89;353294
75;2020-05-28;2;0;2;77600;28200;90;105800
75;2020-05-28;9;15;24;3113538;2886444;0;5999982
76;2020-05-28;1;0;1;305956;318589;09;624545
76;2020-05-28;0;0;0;338942;356969;19;695911
76;2020-05-28;0;0;0;316210;319570;29;635780
76;2020-05-28;3;2;5;356758;337587;39;694345
76;2020-05-28;1;1;2;376541;363812;49;740353
76;2020-05-28;1;0;1;402608;383750;59;786358
76;2020-05-28;0;0;0;394889;358997;69;753886
76;2020-05-28;0;1;1;308664;263806;79;572470
76;2020-05-28;1;0;1;195838;129272;89;325110
76;2020-05-28;2;0;2;69372;26728;90;96100
76;2020-05-28;9;4;13;3065778;2859080;0;5924858
84;2020-05-28;1;1;2;459549;481088;09;940637
84;2020-05-28;2;1;3;487711;511905;19;999616
84;2020-05-28;2;5;7;443824;451094;29;894918
84;2020-05-28;2;0;2;512522;493262;39;1005784
84;2020-05-28;4;2;7;520248;515106;49;1035354
84;2020-05-28;4;2;6;529611;514848;59;1044459
84;2020-05-28;3;2;5;486720;439940;69;926660
84;2020-05-28;1;3;4;372151;315211;79;687362
84;2020-05-28;4;3;7;237198;150524;89;387722
84;2020-05-28;0;0;0;81185;28680;90;109865
84;2020-05-28;23;19;51;4130719;3901658;0;8032377
93;2020-05-28;0;1;1;268834;283093;09;551927
93;2020-05-28;1;0;1;280751;296087;19;576838
93;2020-05-28;1;1;3;254404;255552;29;509956
93;2020-05-28;4;3;9;310704;288398;39;599102
93;2020-05-28;2;8;10;325559;305827;49;631386
93;2020-05-28;3;3;6;353104;325389;59;678493
93;2020-05-28;1;2;5;336327;296459;69;632786
93;2020-05-28;1;3;5;279820;229699;79;509519
93;2020-05-28;4;1;6;171274;113716;89;284990
93;2020-05-28;2;0;2;58896;21758;90;80654
93;2020-05-28;19;22;48;2639673;2415978;0;5055651
94;2020-05-28;0;0;0;16311;17433;09;33744
94;2020-05-28;0;0;0;16679;18132;19;34811
94;2020-05-28;0;0;0;16782;16579;29;33361
94;2020-05-28;1;0;1;23044;20580;39;43624
94;2020-05-28;0;0;0;23065;22140;49;45205
94;2020-05-28;0;0;0;24549;23421;59;47970
94;2020-05-28;1;1;2;23212;21883;69;45095
94;2020-05-28;0;0;0;19544;17141;79;36685
94;2020-05-28;0;0;0;11227;8178;89;19405
94;2020-05-28;0;0;0;3332;1447;90;4779
94;2020-05-28;2;1;3;177745;166934;0;344679
01;2020-05-29;0;0;0;19979;20155;09;40134
01;2020-05-29;0;0;0;24994;25489;19;50483
01;2020-05-29;0;0;0;17868;16690;29;34558
01;2020-05-29;0;0;0;22328;14821;39;37149
01;2020-05-29;0;0;0;28652;20276;49;48928
01;2020-05-29;0;0;0;33264;27260;59;60524
01;2020-05-29;0;0;0;27135;23978;69;51113
01;2020-05-29;0;0;0;18401;14661;79;33062
01;2020-05-29;0;0;0;9633;6375;89;16008
01;2020-05-29;0;0;0;3410;1510;90;4920
01;2020-05-29;0;0;0;205664;171215;0;376879
02;2020-05-29;0;0;0;16881;17110;09;33991
02;2020-05-29;0;0;0;21410;21604;19;43014
02;2020-05-29;0;0;0;16017;15479;29;31496
02;2020-05-29;0;0;0;19825;14455;39;34280
02;2020-05-29;0;0;0;24719;18248;49;42967
02;2020-05-29;1;0;1;34361;28310;59;62671
02;2020-05-29;0;0;0;28061;24495;69;52556
02;2020-05-29;0;0;0;18231;15278;79;33509
02;2020-05-29;0;0;0;11090;7677;89;18767
02;2020-05-29;0;0;0;3992;1506;90;5498
02;2020-05-29;1;0;1;194587;164162;0;358749
03;2020-05-29;1;0;2;31123;30920;09;62043
03;2020-05-29;1;0;2;29370;29268;19;58638
03;2020-05-29;1;3;4;21458;18963;29;40421
03;2020-05-29;1;2;3;21276;18326;39;39602
03;2020-05-29;1;0;1;18164;16593;49;34757
03;2020-05-29;0;3;3;13469;13557;59;27026
03;2020-05-29;1;1;2;8776;8670;69;17446
03;2020-05-29;0;0;0;3777;3591;79;7368
03;2020-05-29;0;0;0;1649;1072;89;2721
03;2020-05-29;0;0;0;485;184;90;669
03;2020-05-29;6;9;17;149547;141144;0;290691
04;2020-05-29;0;0;0;60314;61377;09;121691
04;2020-05-29;0;0;0;66065;68387;19;134452
04;2020-05-29;1;0;1;51059;47156;29;98215
04;2020-05-29;0;0;0;58788;45780;39;104568
04;2020-05-29;0;0;0;61408;52207;49;113615
04;2020-05-29;0;0;0;64838;60759;59;125597
04;2020-05-29;0;0;0;47008;42843;69;89851
04;2020-05-29;0;0;0;25509;21184;79;46693
04;2020-05-29;0;0;0;13168;7647;89;20815
04;2020-05-29;0;0;0;3209;1253;90;4462
04;2020-05-29;1;0;1;451366;408593;0;859959
05;2020-05-29;0;0;0;362.366008612902;341.338819562748;09;703.704828175651
05;2020-05-29;0;0;0;353.376145114279;370.349735405642;19;723.725880519921
05;2020-05-29;0;0;0;218.593559489256;256.539602589476;29;475.133162078732
05;2020-05-29;0;0;0;404.225408693299;360.321910454353;39;764.547319147651
05;2020-05-29;0;0;0;520.067953604221;497.108383964256;49;1017.17633756848
05;2020-05-29;0;0;0;468.146063921917;510.087601910415;59;978.233665832332
05;2020-05-29;0;0;0;340.368470050554;334.366842191253;69;674.735312241807
05;2020-05-29;0;0;0;212.598666888387;192.597753227106;79;405.196420115493
05;2020-05-29;0;0;0;148.727797095705;61.8681715431829;89;210.595968638888
05;2020-05-29;0;0;0;32.9601271090696;10.9909785719784;90;43.9511056810479
05;2020-05-29;0;0;0;3061.43020057959;2935.56979942041;0;5997
06;2020-05-29;0;0;0;42583;42380;09;84963
06;2020-05-29;0;0;0;33369;31925;19;65294
06;2020-05-29;5;3;8;21571;15080;29;36651
06;2020-05-29;3;1;4;21550;16147;39;37697
06;2020-05-29;4;3;7;14193;13939;49;28132
06;2020-05-29;5;3;8;7171;7597;59;14768
06;2020-05-29;0;0;0;3629;4117;69;7746
06;2020-05-29;0;1;1;1577;1457;79;3034
06;2020-05-29;0;0;0;531;474;89;1005
06;2020-05-29;0;0;0;88;93;90;181
06;2020-05-29;17;12;29;146262;133209;0;279471
07;2020-05-29;0;0;0;485;549;09;1034
07;2020-05-29;0;0;0;403;432;19;835
07;2020-05-29;0;0;0;764;841;29;1605
07;2020-05-29;0;0;0;824;928;39;1752
07;2020-05-29;0;0;0;788;1020;49;1808
07;2020-05-29;0;0;0;678;870;59;1548
07;2020-05-29;0;0;0;360;382;69;742
07;2020-05-29;0;0;0;231;190;79;421
07;2020-05-29;0;0;0;114;67;89;181
07;2020-05-29;0;0;0;24;11;90;35
07;2020-05-29;0;0;0;4671;5290;0;9961
08;2020-05-29;0;0;0;2715.22592983026;2997.75551488675;09;5712.98144471701
08;2020-05-29;0;0;0;2778.51901080978;3160.9156459093;19;5939.43465671908
08;2020-05-29;0;0;0;2080.8882988764;1718.16634315323;29;3799.05464202964
08;2020-05-29;0;0;0;2701.8582062647;1896.52641413317;39;4598.38462039786
08;2020-05-29;0;0;0;3151.45861023308;2460.52498233809;49;5611.98359257117
08;2020-05-29;0;1;1;2620.29868333099;2422.23566154656;59;5042.53434487755
08;2020-05-29;0;0;0;1621.44173420671;1438.58325779464;69;3060.02499200135
08;2020-05-29;0;0;0;626.575909335673;526.358467843651;79;1152.93437717932
08;2020-05-29;0;0;0;205.018522985054;140.993639349697;89;346.012162334751
08;2020-05-29;0;0;0;50.0325684687745;20.62259870351;90;70.6551671722846
08;2020-05-29;0;1;1;18551.3174743414;16782.6825256586;0;35334
11;2020-05-29;2;4;11;783071;811785;09;1594856
11;2020-05-29;3;8;11;761456;784653;19;1546109
11;2020-05-29;10;11;21;850145;801772;29;1651917
11;2020-05-29;15;6;21;914360;843488;39;1757848
11;2020-05-29;10;13;23;845609;826202;49;1671811
11;2020-05-29;13;4;17;793566;745070;59;1538636
11;2020-05-29;10;11;21;628649;549192;69;1177841
11;2020-05-29;5;6;11;434606;358356;79;792962
11;2020-05-29;14;6;20;261425;162933;89;424358
11;2020-05-29;12;1;13;89253;32619;90;121872
11;2020-05-29;94;70;169;6362140;5916070;0;12278210
24;2020-05-29;0;0;0;139720;144686;09;284406
24;2020-05-29;1;0;1;152979;161185;19;314164
24;2020-05-29;2;3;5;122237;126536;29;248773
24;2020-05-29;2;1;3;150359;142009;39;292368
24;2020-05-29;2;4;6;161829;158758;49;320587
24;2020-05-29;1;1;2;172552;168011;59;340563
24;2020-05-29;2;2;4;172509;158177;69;330686
24;2020-05-29;1;1;2;129428;110593;79;240021
24;2020-05-29;2;0;2;87342;56882;89;144224
24;2020-05-29;2;1;3;31210;12071;90;43281
24;2020-05-29;15;13;28;1320165;1238908;0;2559073
27;2020-05-29;0;0;0;143373;149679;09;293052
27;2020-05-29;0;0;0;160962;173003;19;333965
27;2020-05-29;0;2;2;133746;142254;29;276000
27;2020-05-29;0;0;0;160004;155407;39;315411
27;2020-05-29;0;1;1;172333;169564;49;341897
27;2020-05-29;1;0;1;189979;183788;59;373767
27;2020-05-29;1;0;1;192591;178206;69;370797
27;2020-05-29;0;1;1;146876;127546;79;274422
27;2020-05-29;2;0;2;96896;61575;89;158471
27;2020-05-29;0;0;0;33148;12109;90;45257
27;2020-05-29;4;4;9;1429908;1353131;0;2783039
28;2020-05-29;0;1;1;180735;186856;09;367591
28;2020-05-29;0;1;1;200125;213621;19;413746
28;2020-05-29;0;1;1;168922;173007;29;341929
28;2020-05-29;0;1;1;196628;188487;39;385115
28;2020-05-29;0;0;0;205396;201699;49;407095
28;2020-05-29;3;0;3;222002;213866;59;435868
28;2020-05-29;0;0;0;224688;203758;69;428446
28;2020-05-29;1;0;1;163192;135543;79;298735
28;2020-05-29;0;2;2;109691;65377;89;175068
28;2020-05-29;0;0;0;37222;12685;90;49907
28;2020-05-29;4;6;10;1708601;1594899;0;3303500
32;2020-05-29;5;2;7;358062;373689;09;731751
32;2020-05-29;3;11;14;387045;406742;19;793787
32;2020-05-29;4;3;8;342304;348587;29;690891
32;2020-05-29;8;3;11;382485;369972;39;752457
32;2020-05-29;4;1;5;382510;376716;49;759226
32;2020-05-29;4;1;5;386937;376527;59;763464
32;2020-05-29;4;5;9;371211;330938;69;702149
32;2020-05-29;4;6;10;250542;201459;79;452001
32;2020-05-29;3;3;6;163399;89786;89;253185
32;2020-05-29;8;2;10;48384;15367;90;63751
32;2020-05-29;47;37;85;3072879;2889783;0;5962662
44;2020-05-29;3;1;4;291525;306839;09;598364
44;2020-05-29;1;0;1;320255;339504;19;659759
44;2020-05-29;8;8;16;302020;314428;29;616448
44;2020-05-29;2;3;5;342222;333292;39;675514
44;2020-05-29;3;7;10;349727;344491;49;694218
44;2020-05-29;8;4;13;381371;373239;59;754610
44;2020-05-29;5;2;7;367165;335850;69;703015
44;2020-05-29;6;5;11;250387;215436;79;465823
44;2020-05-29;3;5;8;170825;105192;89;276017
44;2020-05-29;5;2;7;51248;16731;90;67979
44;2020-05-29;44;37;82;2826745;2685002;0;5511747
52;2020-05-29;0;2;2;213594;223900;09;437494
52;2020-05-29;2;3;5;240818;255197;19;496015
52;2020-05-29;3;3;6;197010;200630;29;397640
52;2020-05-29;2;5;7;231204;224885;39;456089
52;2020-05-29;3;3;6;243874;243418;49;487292
52;2020-05-29;5;1;6;244100;239116;59;483216
52;2020-05-29;0;1;1;241796;221345;69;463141
52;2020-05-29;3;1;4;177805;149903;79;327708
52;2020-05-29;0;1;1;119561;75822;89;195383
52;2020-05-29;1;2;3;42559;15260;90;57819
52;2020-05-29;19;22;41;1952321;1849476;0;3801797
53;2020-05-29;0;0;0;173813;182358;09;356171
53;2020-05-29;1;1;2;202720;214740;19;417460
53;2020-05-29;0;0;0;163116;173196;29;336312
53;2020-05-29;1;0;1;190526;187674;39;378200
53;2020-05-29;0;0;0;212098;212015;49;424113
53;2020-05-29;1;0;1;223699;219176;59;442875
53;2020-05-29;0;0;0;227435;209274;69;436709
53;2020-05-29;0;0;0;169992;140910;79;310902
53;2020-05-29;0;1;1;118117;69883;89;188000
53;2020-05-29;1;0;1;37370;12267;90;49637
53;2020-05-29;4;2;6;1718886;1621493;0;3340379
75;2020-05-29;0;1;1;293104;305291;09;598395
75;2020-05-29;0;1;1;337141;357785;19;694926
75;2020-05-29;2;1;3;295024;300618;29;595642
75;2020-05-29;1;0;1;347871;331233;39;679104
75;2020-05-29;0;0;0;384742;372771;49;757513
75;2020-05-29;1;0;1;413361;390880;59;804241
75;2020-05-29;1;0;1;425623;384060;69;809683
75;2020-05-29;0;1;1;325086;276298;79;601384
75;2020-05-29;3;1;4;213986;139308;89;353294
75;2020-05-29;0;1;1;77600;28200;90;105800
75;2020-05-29;8;6;14;3113538;2886444;0;5999982
76;2020-05-29;0;0;0;305956;318589;09;624545
76;2020-05-29;1;0;1;338942;356969;19;695911
76;2020-05-29;2;1;3;316210;319570;29;635780
76;2020-05-29;2;3;5;356758;337587;39;694345
76;2020-05-29;2;0;2;376541;363812;49;740353
76;2020-05-29;4;4;8;402608;383750;59;786358
76;2020-05-29;1;1;2;394889;358997;69;753886
76;2020-05-29;0;0;0;308664;263806;79;572470
76;2020-05-29;4;0;4;195838;129272;89;325110
76;2020-05-29;1;1;2;69372;26728;90;96100
76;2020-05-29;17;10;27;3065778;2859080;0;5924858
84;2020-05-29;0;0;0;459549;481088;09;940637
84;2020-05-29;1;1;2;487711;511905;19;999616
84;2020-05-29;3;0;3;443824;451094;29;894918
84;2020-05-29;1;1;2;512522;493262;39;1005784
84;2020-05-29;2;2;4;520248;515106;49;1035354
84;2020-05-29;3;4;7;529611;514848;59;1044459
84;2020-05-29;2;0;2;486720;439940;69;926660
84;2020-05-29;3;0;4;372151;315211;79;687362
84;2020-05-29;2;3;5;237198;150524;89;387722
84;2020-05-29;4;0;4;81185;28680;90;109865
84;2020-05-29;21;11;51;4130719;3901658;0;8032377
93;2020-05-29;0;0;0;268834;283093;09;551927
93;2020-05-29;1;0;1;280751;296087;19;576838
93;2020-05-29;1;0;1;254404;255552;29;509956
93;2020-05-29;1;0;1;310704;288398;39;599102
93;2020-05-29;0;1;1;325559;305827;49;631386
93;2020-05-29;1;0;2;353104;325389;59;678493
93;2020-05-29;2;1;3;336327;296459;69;632786
93;2020-05-29;0;2;2;279820;229699;79;509519
93;2020-05-29;3;0;3;171274;113716;89;284990
93;2020-05-29;2;2;4;58896;21758;90;80654
93;2020-05-29;11;6;18;2639673;2415978;0;5055651
94;2020-05-29;0;0;0;16311;17433;09;33744
94;2020-05-29;0;0;0;16679;18132;19;34811
94;2020-05-29;0;0;0;16782;16579;29;33361
94;2020-05-29;0;0;0;23044;20580;39;43624
94;2020-05-29;0;0;0;23065;22140;49;45205
94;2020-05-29;0;0;0;24549;23421;59;47970
94;2020-05-29;0;0;0;23212;21883;69;45095
94;2020-05-29;0;0;0;19544;17141;79;36685
94;2020-05-29;0;1;1;11227;8178;89;19405
94;2020-05-29;0;0;0;3332;1447;90;4779
94;2020-05-29;0;1;1;177745;166934;0;344679
01;2020-05-30;0;0;0;19979;20155;09;40134
01;2020-05-30;0;0;0;24994;25489;19;50483
01;2020-05-30;0;0;0;17868;16690;29;34558
01;2020-05-30;0;0;0;22328;14821;39;37149
01;2020-05-30;0;0;0;28652;20276;49;48928
01;2020-05-30;0;0;0;33264;27260;59;60524
01;2020-05-30;0;0;0;27135;23978;69;51113
01;2020-05-30;0;0;0;18401;14661;79;33062
01;2020-05-30;0;0;0;9633;6375;89;16008
01;2020-05-30;0;0;0;3410;1510;90;4920
01;2020-05-30;0;0;0;205664;171215;0;376879
02;2020-05-30;0;0;0;16881;17110;09;33991
02;2020-05-30;0;0;0;21410;21604;19;43014
02;2020-05-30;0;0;0;16017;15479;29;31496
02;2020-05-30;0;0;0;19825;14455;39;34280
02;2020-05-30;0;0;0;24719;18248;49;42967
02;2020-05-30;0;0;0;34361;28310;59;62671
02;2020-05-30;0;0;0;28061;24495;69;52556
02;2020-05-30;0;0;0;18231;15278;79;33509
02;2020-05-30;0;0;0;11090;7677;89;18767
02;2020-05-30;0;0;0;3992;1506;90;5498
02;2020-05-30;0;0;0;194587;164162;0;358749
03;2020-05-30;2;0;3;31123;30920;09;62043
03;2020-05-30;1;1;4;29370;29268;19;58638
03;2020-05-30;2;6;9;21458;18963;29;40421
03;2020-05-30;2;4;6;21276;18326;39;39602
03;2020-05-30;2;2;5;18164;16593;49;34757
03;2020-05-30;0;0;1;13469;13557;59;27026
03;2020-05-30;2;2;4;8776;8670;69;17446
03;2020-05-30;0;0;1;3777;3591;79;7368
03;2020-05-30;0;1;1;1649;1072;89;2721
03;2020-05-30;0;0;0;485;184;90;669
03;2020-05-30;11;16;34;149547;141144;0;290691
04;2020-05-30;0;0;0;60314;61377;09;121691
04;2020-05-30;0;0;0;66065;68387;19;134452
04;2020-05-30;0;0;0;51059;47156;29;98215
04;2020-05-30;0;0;0;58788;45780;39;104568
04;2020-05-30;0;1;1;61408;52207;49;113615
04;2020-05-30;0;0;0;64838;60759;59;125597
04;2020-05-30;0;0;0;47008;42843;69;89851
04;2020-05-30;0;0;0;25509;21184;79;46693
04;2020-05-30;0;0;0;13168;7647;89;20815
04;2020-05-30;0;0;0;3209;1253;90;4462
04;2020-05-30;0;1;1;451366;408593;0;859959
05;2020-05-30;0;0;0;362.366008612902;341.338819562748;09;703.704828175651
05;2020-05-30;0;0;0;353.376145114279;370.349735405642;19;723.725880519921
05;2020-05-30;0;0;0;218.593559489256;256.539602589476;29;475.133162078732
05;2020-05-30;0;0;0;404.225408693299;360.321910454353;39;764.547319147651
05;2020-05-30;0;0;0;520.067953604221;497.108383964256;49;1017.17633756848
05;2020-05-30;0;0;0;468.146063921917;510.087601910415;59;978.233665832332
05;2020-05-30;0;0;0;340.368470050554;334.366842191253;69;674.735312241807
05;2020-05-30;0;0;0;212.598666888387;192.597753227106;79;405.196420115493
05;2020-05-30;0;0;0;148.727797095705;61.8681715431829;89;210.595968638888
05;2020-05-30;0;0;0;32.9601271090696;10.9909785719784;90;43.9511056810479
05;2020-05-30;0;0;0;3061.43020057959;2935.56979942041;0;5997
06;2020-05-30;0;0;0;42583;42380;09;84963
06;2020-05-30;0;13;13;33369;31925;19;65294
06;2020-05-30;3;46;49;21571;15080;29;36651
06;2020-05-30;5;16;21;21550;16147;39;37697
06;2020-05-30;1;6;7;14193;13939;49;28132
06;2020-05-30;3;3;6;7171;7597;59;14768
06;2020-05-30;0;0;0;3629;4117;69;7746
06;2020-05-30;0;0;0;1577;1457;79;3034
06;2020-05-30;0;0;0;531;474;89;1005
06;2020-05-30;0;0;0;88;93;90;181
06;2020-05-30;12;84;96;146262;133209;0;279471
07;2020-05-30;0;0;0;485;549;09;1034
07;2020-05-30;0;0;0;403;432;19;835
07;2020-05-30;0;0;0;764;841;29;1605
07;2020-05-30;0;0;0;824;928;39;1752
07;2020-05-30;0;0;0;788;1020;49;1808
07;2020-05-30;0;0;0;678;870;59;1548
07;2020-05-30;0;0;0;360;382;69;742
07;2020-05-30;0;0;0;231;190;79;421
07;2020-05-30;0;0;0;114;67;89;181
07;2020-05-30;0;0;0;24;11;90;35
07;2020-05-30;0;0;0;4671;5290;0;9961
08;2020-05-30;0;0;0;2715.22592983026;2997.75551488675;09;5712.98144471701
08;2020-05-30;0;0;0;2778.51901080978;3160.9156459093;19;5939.43465671908
08;2020-05-30;0;0;0;2080.8882988764;1718.16634315323;29;3799.05464202964
08;2020-05-30;0;0;0;2701.8582062647;1896.52641413317;39;4598.38462039786
08;2020-05-30;0;0;0;3151.45861023308;2460.52498233809;49;5611.98359257117
08;2020-05-30;0;0;0;2620.29868333099;2422.23566154656;59;5042.53434487755
08;2020-05-30;0;0;0;1621.44173420671;1438.58325779464;69;3060.02499200135
08;2020-05-30;0;0;0;626.575909335673;526.358467843651;79;1152.93437717932
08;2020-05-30;0;0;0;205.018522985054;140.993639349697;89;346.012162334751
08;2020-05-30;0;0;0;50.0325684687745;20.62259870351;90;70.6551671722846
08;2020-05-30;0;0;0;18551.3174743414;16782.6825256586;0;35334
11;2020-05-30;1;0;1;783071;811785;09;1594856
11;2020-05-30;0;1;1;761456;784653;19;1546109
11;2020-05-30;5;2;7;850145;801772;29;1651917
11;2020-05-30;4;1;5;914360;843488;39;1757848
11;2020-05-30;5;6;11;845609;826202;49;1671811
11;2020-05-30;6;3;9;793566;745070;59;1538636
11;2020-05-30;4;4;8;628649;549192;69;1177841
11;2020-05-30;3;4;7;434606;358356;79;792962
11;2020-05-30;8;4;12;261425;162933;89;424358
11;2020-05-30;7;0;7;89253;32619;90;121872
11;2020-05-30;43;25;68;6362140;5916070;0;12278210
24;2020-05-30;0;0;0;139720;144686;09;284406
24;2020-05-30;0;0;0;152979;161185;19;314164
24;2020-05-30;0;0;0;122237;126536;29;248773
24;2020-05-30;1;0;1;150359;142009;39;292368
24;2020-05-30;0;1;1;161829;158758;49;320587
24;2020-05-30;0;0;0;172552;168011;59;340563
24;2020-05-30;1;0;1;172509;158177;69;330686
24;2020-05-30;1;0;1;129428;110593;79;240021
24;2020-05-30;1;0;1;87342;56882;89;144224
24;2020-05-30;0;0;0;31210;12071;90;43281
24;2020-05-30;4;1;5;1320165;1238908;0;2559073
27;2020-05-30;1;1;2;143373;149679;09;293052
27;2020-05-30;0;0;0;160962;173003;19;333965
27;2020-05-30;0;0;0;133746;142254;29;276000
27;2020-05-30;0;1;1;160004;155407;39;315411
27;2020-05-30;0;0;0;172333;169564;49;341897
27;2020-05-30;0;1;1;189979;183788;59;373767
27;2020-05-30;1;0;1;192591;178206;69;370797
27;2020-05-30;0;3;3;146876;127546;79;274422
27;2020-05-30;1;0;1;96896;61575;89;158471
27;2020-05-30;3;0;3;33148;12109;90;45257
27;2020-05-30;6;6;12;1429908;1353131;0;2783039
28;2020-05-30;0;0;0;180735;186856;09;367591
28;2020-05-30;0;0;0;200125;213621;19;413746
28;2020-05-30;0;0;0;168922;173007;29;341929
28;2020-05-30;0;0;0;196628;188487;39;385115
28;2020-05-30;1;0;1;205396;201699;49;407095
28;2020-05-30;0;0;0;222002;213866;59;435868
28;2020-05-30;1;0;1;224688;203758;69;428446
28;2020-05-30;0;0;0;163192;135543;79;298735
28;2020-05-30;0;0;0;109691;65377;89;175068
28;2020-05-30;0;0;0;37222;12685;90;49907
28;2020-05-30;2;0;2;1708601;1594899;0;3303500
32;2020-05-30;3;1;4;358062;373689;09;731751
32;2020-05-30;1;1;2;387045;406742;19;793787
32;2020-05-30;6;1;7;342304;348587;29;690891
32;2020-05-30;2;3;5;382485;369972;39;752457
32;2020-05-30;4;2;6;382510;376716;49;759226
32;2020-05-30;3;2;5;386937;376527;59;763464
32;2020-05-30;1;1;2;371211;330938;69;702149
32;2020-05-30;1;1;2;250542;201459;79;452001
32;2020-05-30;2;0;2;163399;89786;89;253185
32;2020-05-30;2;0;2;48384;15367;90;63751
32;2020-05-30;25;12;37;3072879;2889783;0;5962662
44;2020-05-30;0;1;1;291525;306839;09;598364
44;2020-05-30;1;1;2;320255;339504;19;659759
44;2020-05-30;0;1;1;302020;314428;29;616448
44;2020-05-30;4;2;6;342222;333292;39;675514
44;2020-05-30;0;1;1;349727;344491;49;694218
44;2020-05-30;1;0;1;381371;373239;59;754610
44;2020-05-30;0;1;1;367165;335850;69;703015
44;2020-05-30;1;3;4;250387;215436;79;465823
44;2020-05-30;3;1;4;170825;105192;89;276017
44;2020-05-30;1;1;2;51248;16731;90;67979
44;2020-05-30;11;12;23;2826745;2685002;0;5511747
52;2020-05-30;1;0;1;213594;223900;09;437494
52;2020-05-30;1;2;3;240818;255197;19;496015
52;2020-05-30;2;3;5;197010;200630;29;397640
52;2020-05-30;1;2;3;231204;224885;39;456089
52;2020-05-30;3;3;6;243874;243418;49;487292
52;2020-05-30;1;1;2;244100;239116;59;483216
52;2020-05-30;1;0;1;241796;221345;69;463141
52;2020-05-30;0;0;0;177805;149903;79;327708
52;2020-05-30;0;2;2;119561;75822;89;195383
52;2020-05-30;0;1;1;42559;15260;90;57819
52;2020-05-30;10;14;24;1952321;1849476;0;3801797
53;2020-05-30;0;0;0;173813;182358;09;356171
53;2020-05-30;0;0;0;202720;214740;19;417460
53;2020-05-30;0;2;2;163116;173196;29;336312
53;2020-05-30;1;1;2;190526;187674;39;378200
53;2020-05-30;0;0;0;212098;212015;49;424113
53;2020-05-30;0;1;1;223699;219176;59;442875
53;2020-05-30;0;0;0;227435;209274;69;436709
53;2020-05-30;0;0;0;169992;140910;79;310902
53;2020-05-30;0;0;0;118117;69883;89;188000
53;2020-05-30;2;0;2;37370;12267;90;49637
53;2020-05-30;3;4;7;1718886;1621493;0;3340379
75;2020-05-30;1;1;2;293104;305291;09;598395
75;2020-05-30;0;0;0;337141;357785;19;694926
75;2020-05-30;2;0;2;295024;300618;29;595642
75;2020-05-30;0;3;3;347871;331233;39;679104
75;2020-05-30;0;2;2;384742;372771;49;757513
75;2020-05-30;0;2;2;413361;390880;59;804241
75;2020-05-30;0;0;0;425623;384060;69;809683
75;2020-05-30;0;1;1;325086;276298;79;601384
75;2020-05-30;0;0;0;213986;139308;89;353294
75;2020-05-30;2;0;2;77600;28200;90;105800
75;2020-05-30;5;9;14;3113538;2886444;0;5999982
76;2020-05-30;0;0;0;305956;318589;09;624545
76;2020-05-30;1;0;1;338942;356969;19;695911
76;2020-05-30;0;0;0;316210;319570;29;635780
76;2020-05-30;1;2;3;356758;337587;39;694345
76;2020-05-30;1;2;3;376541;363812;49;740353
76;2020-05-30;0;0;0;402608;383750;59;786358
76;2020-05-30;1;1;2;394889;358997;69;753886
76;2020-05-30;1;0;1;308664;263806;79;572470
76;2020-05-30;0;0;0;195838;129272;89;325110
76;2020-05-30;0;1;1;69372;26728;90;96100
76;2020-05-30;5;6;11;3065778;2859080;0;5924858
84;2020-05-30;0;1;1;459549;481088;09;940637
84;2020-05-30;2;1;3;487711;511905;19;999616
84;2020-05-30;2;0;2;443824;451094;29;894918
84;2020-05-30;1;1;2;512522;493262;39;1005784
84;2020-05-30;2;1;3;520248;515106;49;1035354
84;2020-05-30;2;2;4;529611;514848;59;1044459
84;2020-05-30;0;1;1;486720;439940;69;926660
84;2020-05-30;2;0;2;372151;315211;79;687362
84;2020-05-30;3;0;3;237198;150524;89;387722
84;2020-05-30;1;0;1;81185;28680;90;109865
84;2020-05-30;15;7;22;4130719;3901658;0;8032377
93;2020-05-30;0;0;0;268834;283093;09;551927
93;2020-05-30;0;0;0;280751;296087;19;576838
93;2020-05-30;1;0;1;254404;255552;29;509956
93;2020-05-30;0;0;0;310704;288398;39;599102
93;2020-05-30;1;2;4;325559;305827;49;631386
93;2020-05-30;2;0;2;353104;325389;59;678493
93;2020-05-30;2;2;4;336327;296459;69;632786
93;2020-05-30;0;0;0;279820;229699;79;509519
93;2020-05-30;0;0;0;171274;113716;89;284990
93;2020-05-30;0;0;0;58896;21758;90;80654
93;2020-05-30;6;4;11;2639673;2415978;0;5055651
94;2020-05-30;0;0;0;16311;17433;09;33744
94;2020-05-30;0;0;0;16679;18132;19;34811
94;2020-05-30;0;0;0;16782;16579;29;33361
94;2020-05-30;0;0;0;23044;20580;39;43624
94;2020-05-30;0;0;0;23065;22140;49;45205
94;2020-05-30;0;0;0;24549;23421;59;47970
94;2020-05-30;0;0;0;23212;21883;69;45095
94;2020-05-30;0;0;0;19544;17141;79;36685
94;2020-05-30;0;0;0;11227;8178;89;19405
94;2020-05-30;0;0;0;3332;1447;90;4779
94;2020-05-30;0;0;0;177745;166934;0;344679
01;2020-05-31;0;0;0;19979;20155;09;40134
01;2020-05-31;0;0;0;24994;25489;19;50483
01;2020-05-31;0;0;0;17868;16690;29;34558
01;2020-05-31;0;0;0;22328;14821;39;37149
01;2020-05-31;0;0;0;28652;20276;49;48928
01;2020-05-31;0;0;0;33264;27260;59;60524
01;2020-05-31;0;0;0;27135;23978;69;51113
01;2020-05-31;0;0;0;18401;14661;79;33062
01;2020-05-31;0;0;0;9633;6375;89;16008
01;2020-05-31;0;0;0;3410;1510;90;4920
01;2020-05-31;0;0;0;205664;171215;0;376879
02;2020-05-31;0;0;0;16881;17110;09;33991
02;2020-05-31;0;0;0;21410;21604;19;43014
02;2020-05-31;0;0;0;16017;15479;29;31496
02;2020-05-31;0;0;0;19825;14455;39;34280
02;2020-05-31;0;0;0;24719;18248;49;42967
02;2020-05-31;0;0;0;34361;28310;59;62671
02;2020-05-31;0;0;0;28061;24495;69;52556
02;2020-05-31;0;0;0;18231;15278;79;33509
02;2020-05-31;0;0;0;11090;7677;89;18767
02;2020-05-31;0;0;0;3992;1506;90;5498
02;2020-05-31;0;0;0;194587;164162;0;358749
03;2020-05-31;0;0;0;31123;30920;09;62043
03;2020-05-31;3;2;5;29370;29268;19;58638
03;2020-05-31;1;2;3;21458;18963;29;40421
03;2020-05-31;1;3;4;21276;18326;39;39602
03;2020-05-31;1;1;2;18164;16593;49;34757
03;2020-05-31;2;1;4;13469;13557;59;27026
03;2020-05-31;0;0;0;8776;8670;69;17446
03;2020-05-31;0;0;0;3777;3591;79;7368
03;2020-05-31;0;1;1;1649;1072;89;2721
03;2020-05-31;0;1;1;485;184;90;669
03;2020-05-31;8;11;20;149547;141144;0;290691
04;2020-05-31;0;0;0;60314;61377;09;121691
04;2020-05-31;1;0;1;66065;68387;19;134452
04;2020-05-31;1;1;2;51059;47156;29;98215
04;2020-05-31;0;0;0;58788;45780;39;104568
04;2020-05-31;0;0;0;61408;52207;49;113615
04;2020-05-31;0;0;0;64838;60759;59;125597
04;2020-05-31;0;0;0;47008;42843;69;89851
04;2020-05-31;0;0;0;25509;21184;79;46693
04;2020-05-31;0;0;0;13168;7647;89;20815
04;2020-05-31;0;0;0;3209;1253;90;4462
04;2020-05-31;2;1;3;451366;408593;0;859959
05;2020-05-31;0;0;0;362.366008612902;341.338819562748;09;703.704828175651
05;2020-05-31;0;0;0;353.376145114279;370.349735405642;19;723.725880519921
05;2020-05-31;0;0;0;218.593559489256;256.539602589476;29;475.133162078732
05;2020-05-31;0;0;0;404.225408693299;360.321910454353;39;764.547319147651
05;2020-05-31;0;0;0;520.067953604221;497.108383964256;49;1017.17633756848
05;2020-05-31;0;0;0;468.146063921917;510.087601910415;59;978.233665832332
05;2020-05-31;0;0;0;340.368470050554;334.366842191253;69;674.735312241807
05;2020-05-31;0;0;0;212.598666888387;192.597753227106;79;405.196420115493
05;2020-05-31;0;0;0;148.727797095705;61.8681715431829;89;210.595968638888
05;2020-05-31;0;0;0;32.9601271090696;10.9909785719784;90;43.9511056810479
05;2020-05-31;0;0;0;3061.43020057959;2935.56979942041;0;5997
06;2020-05-31;1;0;1;42583;42380;09;84963
06;2020-05-31;1;12;13;33369;31925;19;65294
06;2020-05-31;2;26;28;21571;15080;29;36651
06;2020-05-31;2;7;9;21550;16147;39;37697
06;2020-05-31;1;4;5;14193;13939;49;28132
06;2020-05-31;1;3;4;7171;7597;59;14768
06;2020-05-31;1;0;1;3629;4117;69;7746
06;2020-05-31;0;1;1;1577;1457;79;3034
06;2020-05-31;0;0;0;531;474;89;1005
06;2020-05-31;0;0;0;88;93;90;181
06;2020-05-31;9;53;62;146262;133209;0;279471
07;2020-05-31;0;0;0;485;549;09;1034
07;2020-05-31;0;0;0;403;432;19;835
07;2020-05-31;0;0;0;764;841;29;1605
07;2020-05-31;0;0;0;824;928;39;1752
07;2020-05-31;0;0;0;788;1020;49;1808
07;2020-05-31;0;0;0;678;870;59;1548
07;2020-05-31;0;0;0;360;382;69;742
07;2020-05-31;0;0;0;231;190;79;421
07;2020-05-31;0;0;0;114;67;89;181
07;2020-05-31;0;0;0;24;11;90;35
07;2020-05-31;0;0;0;4671;5290;0;9961
08;2020-05-31;0;0;0;2715.22592983026;2997.75551488675;09;5712.98144471701
08;2020-05-31;0;0;0;2778.51901080978;3160.9156459093;19;5939.43465671908
08;2020-05-31;0;0;0;2080.8882988764;1718.16634315323;29;3799.05464202964
08;2020-05-31;0;0;0;2701.8582062647;1896.52641413317;39;4598.38462039786
08;2020-05-31;0;0;0;3151.45861023308;2460.52498233809;49;5611.98359257117
08;2020-05-31;0;0;0;2620.29868333099;2422.23566154656;59;5042.53434487755
08;2020-05-31;0;0;0;1621.44173420671;1438.58325779464;69;3060.02499200135
08;2020-05-31;0;0;0;626.575909335673;526.358467843651;79;1152.93437717932
08;2020-05-31;0;0;0;205.018522985054;140.993639349697;89;346.012162334751
08;2020-05-31;0;0;0;50.0325684687745;20.62259870351;90;70.6551671722846
08;2020-05-31;0;0;0;18551.3174743414;16782.6825256586;0;35334
11;2020-05-31;1;0;1;783071;811785;09;1594856
11;2020-05-31;1;1;2;761456;784653;19;1546109
11;2020-05-31;3;0;3;850145;801772;29;1651917
11;2020-05-31;2;2;4;914360;843488;39;1757848
11;2020-05-31;2;1;3;845609;826202;49;1671811
11;2020-05-31;1;0;1;793566;745070;59;1538636
11;2020-05-31;4;4;8;628649;549192;69;1177841
11;2020-05-31;1;2;3;434606;358356;79;792962
11;2020-05-31;1;3;4;261425;162933;89;424358
11;2020-05-31;0;0;0;89253;32619;90;121872
11;2020-05-31;16;13;29;6362140;5916070;0;12278210
24;2020-05-31;0;0;0;139720;144686;09;284406
24;2020-05-31;0;1;1;152979;161185;19;314164
24;2020-05-31;0;0;0;122237;126536;29;248773
24;2020-05-31;1;1;2;150359;142009;39;292368
24;2020-05-31;0;0;0;161829;158758;49;320587
24;2020-05-31;0;1;1;172552;168011;59;340563
24;2020-05-31;1;0;1;172509;158177;69;330686
24;2020-05-31;0;0;0;129428;110593;79;240021
24;2020-05-31;0;0;0;87342;56882;89;144224
24;2020-05-31;1;0;1;31210;12071;90;43281
24;2020-05-31;3;3;6;1320165;1238908;0;2559073
27;2020-05-31;0;0;0;143373;149679;09;293052
27;2020-05-31;0;0;0;160962;173003;19;333965
27;2020-05-31;0;1;1;133746;142254;29;276000
27;2020-05-31;0;1;1;160004;155407;39;315411
27;2020-05-31;0;0;0;172333;169564;49;341897
27;2020-05-31;0;0;0;189979;183788;59;373767
27;2020-05-31;0;0;0;192591;178206;69;370797
27;2020-05-31;1;0;1;146876;127546;79;274422
27;2020-05-31;0;1;1;96896;61575;89;158471
27;2020-05-31;0;0;0;33148;12109;90;45257
27;2020-05-31;1;3;4;1429908;1353131;0;2783039
28;2020-05-31;0;0;0;180735;186856;09;367591
28;2020-05-31;0;0;0;200125;213621;19;413746
28;2020-05-31;0;1;1;168922;173007;29;341929
28;2020-05-31;0;0;0;196628;188487;39;385115
28;2020-05-31;0;0;0;205396;201699;49;407095
28;2020-05-31;0;0;0;222002;213866;59;435868
28;2020-05-31;0;0;0;224688;203758;69;428446
28;2020-05-31;0;0;0;163192;135543;79;298735
28;2020-05-31;1;0;1;109691;65377;89;175068
28;2020-05-31;0;0;0;37222;12685;90;49907
28;2020-05-31;1;1;2;1708601;1594899;0;3303500
32;2020-05-31;0;0;0;358062;373689;09;731751
32;2020-05-31;0;0;0;387045;406742;19;793787
32;2020-05-31;0;0;0;342304;348587;29;690891
32;2020-05-31;1;0;1;382485;369972;39;752457
32;2020-05-31;2;0;2;382510;376716;49;759226
32;2020-05-31;1;0;1;386937;376527;59;763464
32;2020-05-31;0;0;0;371211;330938;69;702149
32;2020-05-31;0;0;0;250542;201459;79;452001
32;2020-05-31;1;0;1;163399;89786;89;253185
32;2020-05-31;0;0;0;48384;15367;90;63751
32;2020-05-31;5;0;5;3072879;2889783;0;5962662
44;2020-05-31;0;1;1;291525;306839;09;598364
44;2020-05-31;0;0;0;320255;339504;19;659759
44;2020-05-31;1;1;2;302020;314428;29;616448
44;2020-05-31;1;1;2;342222;333292;39;675514
44;2020-05-31;1;0;1;349727;344491;49;694218
44;2020-05-31;0;0;0;381371;373239;59;754610
44;2020-05-31;0;0;0;367165;335850;69;703015
44;2020-05-31;0;0;0;250387;215436;79;465823
44;2020-05-31;0;0;0;170825;105192;89;276017
44;2020-05-31;0;0;0;51248;16731;90;67979
44;2020-05-31;3;3;6;2826745;2685002;0;5511747
52;2020-05-31;1;2;3;213594;223900;09;437494
52;2020-05-31;1;2;3;240818;255197;19;496015
52;2020-05-31;3;2;5;197010;200630;29;397640
52;2020-05-31;2;1;3;231204;224885;39;456089
52;2020-05-31;0;0;0;243874;243418;49;487292
52;2020-05-31;0;1;1;244100;239116;59;483216
52;2020-05-31;0;1;1;241796;221345;69;463141
52;2020-05-31;2;0;2;177805;149903;79;327708
52;2020-05-31;0;0;0;119561;75822;89;195383
52;2020-05-31;0;0;0;42559;15260;90;57819
52;2020-05-31;9;9;18;1952321;1849476;0;3801797
53;2020-05-31;0;0;0;173813;182358;09;356171
53;2020-05-31;0;0;0;202720;214740;19;417460
53;2020-05-31;1;0;1;163116;173196;29;336312
53;2020-05-31;0;1;1;190526;187674;39;378200
53;2020-05-31;0;0;0;212098;212015;49;424113
53;2020-05-31;0;0;0;223699;219176;59;442875
53;2020-05-31;0;0;0;227435;209274;69;436709
53;2020-05-31;0;0;0;169992;140910;79;310902
53;2020-05-31;0;2;2;118117;69883;89;188000
53;2020-05-31;0;0;0;37370;12267;90;49637
53;2020-05-31;1;3;4;1718886;1621493;0;3340379
75;2020-05-31;0;0;0;293104;305291;09;598395
75;2020-05-31;0;0;0;337141;357785;19;694926
75;2020-05-31;0;0;0;295024;300618;29;595642
75;2020-05-31;1;0;1;347871;331233;39;679104
75;2020-05-31;0;0;0;384742;372771;49;757513
75;2020-05-31;0;0;0;413361;390880;59;804241
75;2020-05-31;0;0;0;425623;384060;69;809683
75;2020-05-31;0;0;0;325086;276298;79;601384
75;2020-05-31;0;0;0;213986;139308;89;353294
75;2020-05-31;0;0;0;77600;28200;90;105800
75;2020-05-31;1;0;1;3113538;2886444;0;5999982
76;2020-05-31;0;0;0;305956;318589;09;624545
76;2020-05-31;0;0;0;338942;356969;19;695911
76;2020-05-31;0;0;0;316210;319570;29;635780
76;2020-05-31;0;0;0;356758;337587;39;694345
76;2020-05-31;1;0;1;376541;363812;49;740353
76;2020-05-31;0;0;0;402608;383750;59;786358
76;2020-05-31;0;0;0;394889;358997;69;753886
76;2020-05-31;0;0;0;308664;263806;79;572470
76;2020-05-31;0;0;0;195838;129272;89;325110
76;2020-05-31;0;0;0;69372;26728;90;96100
76;2020-05-31;1;0;1;3065778;2859080;0;5924858
84;2020-05-31;0;0;0;459549;481088;09;940637
84;2020-05-31;0;0;0;487711;511905;19;999616
84;2020-05-31;0;0;0;443824;451094;29;894918
84;2020-05-31;1;0;1;512522;493262;39;1005784
84;2020-05-31;0;0;0;520248;515106;49;1035354
84;2020-05-31;0;0;0;529611;514848;59;1044459
84;2020-05-31;0;0;0;486720;439940;69;926660
84;2020-05-31;1;0;1;372151;315211;79;687362
84;2020-05-31;0;0;0;237198;150524;89;387722
84;2020-05-31;1;0;1;81185;28680;90;109865
84;2020-05-31;3;0;3;4130719;3901658;0;8032377
93;2020-05-31;0;0;0;268834;283093;09;551927
93;2020-05-31;0;0;0;280751;296087;19;576838
93;2020-05-31;4;0;5;254404;255552;29;509956
93;2020-05-31;0;5;5;310704;288398;39;599102
93;2020-05-31;0;5;5;325559;305827;49;631386
93;2020-05-31;0;2;2;353104;325389;59;678493
93;2020-05-31;0;0;0;336327;296459;69;632786
93;2020-05-31;1;0;3;279820;229699;79;509519
93;2020-05-31;0;0;0;171274;113716;89;284990
93;2020-05-31;0;1;1;58896;21758;90;80654
93;2020-05-31;5;13;21;2639673;2415978;0;5055651
94;2020-05-31;0;0;0;16311;17433;09;33744
94;2020-05-31;0;0;0;16679;18132;19;34811
94;2020-05-31;0;0;0;16782;16579;29;33361
94;2020-05-31;0;0;0;23044;20580;39;43624
94;2020-05-31;0;0;0;23065;22140;49;45205
94;2020-05-31;0;0;0;24549;23421;59;47970
94;2020-05-31;0;0;0;23212;21883;69;45095
94;2020-05-31;0;0;0;19544;17141;79;36685
94;2020-05-31;0;0;0;11227;8178;89;19405
94;2020-05-31;0;0;0;3332;1447;90;4779
94;2020-05-31;0;0;0;177745;166934;0;344679
01;2020-06-01;0;0;0;19979;20155;09;40134
01;2020-06-01;0;0;0;24994;25489;19;50483
01;2020-06-01;0;0;0;17868;16690;29;34558
01;2020-06-01;0;0;0;22328;14821;39;37149
01;2020-06-01;0;0;0;28652;20276;49;48928
01;2020-06-01;0;0;0;33264;27260;59;60524
01;2020-06-01;0;0;0;27135;23978;69;51113
01;2020-06-01;0;0;0;18401;14661;79;33062
01;2020-06-01;0;0;0;9633;6375;89;16008
01;2020-06-01;0;0;0;3410;1510;90;4920
01;2020-06-01;0;0;0;205664;171215;0;376879
02;2020-06-01;0;0;0;16881;17110;09;33991
02;2020-06-01;0;0;0;21410;21604;19;43014
02;2020-06-01;0;0;0;16017;15479;29;31496
02;2020-06-01;0;0;0;19825;14455;39;34280
02;2020-06-01;0;0;0;24719;18248;49;42967
02;2020-06-01;0;0;0;34361;28310;59;62671
02;2020-06-01;0;0;0;28061;24495;69;52556
02;2020-06-01;0;0;0;18231;15278;79;33509
02;2020-06-01;0;0;0;11090;7677;89;18767
02;2020-06-01;0;0;0;3992;1506;90;5498
02;2020-06-01;0;0;0;194587;164162;0;358749
03;2020-06-01;1;1;2;31123;30920;09;62043
03;2020-06-01;2;1;3;29370;29268;19;58638
03;2020-06-01;2;3;5;21458;18963;29;40421
03;2020-06-01;1;2;3;21276;18326;39;39602
03;2020-06-01;0;0;0;18164;16593;49;34757
03;2020-06-01;0;4;4;13469;13557;59;27026
03;2020-06-01;0;1;1;8776;8670;69;17446
03;2020-06-01;0;0;0;3777;3591;79;7368
03;2020-06-01;0;0;0;1649;1072;89;2721
03;2020-06-01;0;0;0;485;184;90;669
03;2020-06-01;6;12;18;149547;141144;0;290691
04;2020-06-01;0;0;0;60314;61377;09;121691
04;2020-06-01;0;0;0;66065;68387;19;134452
04;2020-06-01;0;0;0;51059;47156;29;98215
04;2020-06-01;0;0;0;58788;45780;39;104568
04;2020-06-01;0;0;0;61408;52207;49;113615
04;2020-06-01;0;0;0;64838;60759;59;125597
04;2020-06-01;0;0;0;47008;42843;69;89851
04;2020-06-01;0;0;0;25509;21184;79;46693
04;2020-06-01;0;0;0;13168;7647;89;20815
04;2020-06-01;0;0;0;3209;1253;90;4462
04;2020-06-01;0;0;0;451366;408593;0;859959
05;2020-06-01;0;0;0;362.366008612902;341.338819562748;09;703.704828175651
05;2020-06-01;0;0;0;353.376145114279;370.349735405642;19;723.725880519921
05;2020-06-01;0;0;0;218.593559489256;256.539602589476;29;475.133162078732
05;2020-06-01;0;0;0;404.225408693299;360.321910454353;39;764.547319147651
05;2020-06-01;0;0;0;520.067953604221;497.108383964256;49;1017.17633756848
05;2020-06-01;0;0;0;468.146063921917;510.087601910415;59;978.233665832332
05;2020-06-01;0;0;0;340.368470050554;334.366842191253;69;674.735312241807
05;2020-06-01;0;0;0;212.598666888387;192.597753227106;79;405.196420115493
05;2020-06-01;0;0;0;148.727797095705;61.8681715431829;89;210.595968638888
05;2020-06-01;0;0;0;32.9601271090696;10.9909785719784;90;43.9511056810479
05;2020-06-01;0;0;0;3061.43020057959;2935.56979942041;0;5997
06;2020-06-01;0;0;0;42583;42380;09;84963
06;2020-06-01;1;6;7;33369;31925;19;65294
06;2020-06-01;4;19;23;21571;15080;29;36651
06;2020-06-01;2;5;7;21550;16147;39;37697
06;2020-06-01;3;1;4;14193;13939;49;28132
06;2020-06-01;2;3;5;7171;7597;59;14768
06;2020-06-01;0;0;0;3629;4117;69;7746
06;2020-06-01;0;0;0;1577;1457;79;3034
06;2020-06-01;0;0;0;531;474;89;1005
06;2020-06-01;0;1;1;88;93;90;181
06;2020-06-01;12;35;47;146262;133209;0;279471
07;2020-06-01;0;0;0;485;549;09;1034
07;2020-06-01;0;0;0;403;432;19;835
07;2020-06-01;0;0;0;764;841;29;1605
07;2020-06-01;0;0;0;824;928;39;1752
07;2020-06-01;0;0;0;788;1020;49;1808
07;2020-06-01;0;0;0;678;870;59;1548
07;2020-06-01;0;0;0;360;382;69;742
07;2020-06-01;0;0;0;231;190;79;421
07;2020-06-01;0;0;0;114;67;89;181
07;2020-06-01;0;0;0;24;11;90;35
07;2020-06-01;0;0;0;4671;5290;0;9961
08;2020-06-01;0;0;0;2715.22592983026;2997.75551488675;09;5712.98144471701
08;2020-06-01;0;0;0;2778.51901080978;3160.9156459093;19;5939.43465671908
08;2020-06-01;0;0;0;2080.8882988764;1718.16634315323;29;3799.05464202964
08;2020-06-01;0;0;0;2701.8582062647;1896.52641413317;39;4598.38462039786
08;2020-06-01;0;0;0;3151.45861023308;2460.52498233809;49;5611.98359257117
08;2020-06-01;0;0;0;2620.29868333099;2422.23566154656;59;5042.53434487755
08;2020-06-01;0;0;0;1621.44173420671;1438.58325779464;69;3060.02499200135
08;2020-06-01;0;0;0;626.575909335673;526.358467843651;79;1152.93437717932
08;2020-06-01;0;0;0;205.018522985054;140.993639349697;89;346.012162334751
08;2020-06-01;0;0;0;50.0325684687745;20.62259870351;90;70.6551671722846
08;2020-06-01;0;0;0;18551.3174743414;16782.6825256586;0;35334
11;2020-06-01;1;1;2;783071;811785;09;1594856
11;2020-06-01;0;0;0;761456;784653;19;1546109
11;2020-06-01;0;8;8;850145;801772;29;1651917
11;2020-06-01;3;2;5;914360;843488;39;1757848
11;2020-06-01;2;4;6;845609;826202;49;1671811
11;2020-06-01;4;0;4;793566;745070;59;1538636
11;2020-06-01;0;1;1;628649;549192;69;1177841
11;2020-06-01;2;1;3;434606;358356;79;792962
11;2020-06-01;0;1;1;261425;162933;89;424358
11;2020-06-01;3;0;3;89253;32619;90;121872
11;2020-06-01;15;18;33;6362140;5916070;0;12278210
24;2020-06-01;0;0;0;139720;144686;09;284406
24;2020-06-01;0;0;0;152979;161185;19;314164
24;2020-06-01;0;0;0;122237;126536;29;248773
24;2020-06-01;1;0;1;150359;142009;39;292368
24;2020-06-01;0;0;0;161829;158758;49;320587
24;2020-06-01;0;0;0;172552;168011;59;340563
24;2020-06-01;0;0;0;172509;158177;69;330686
24;2020-06-01;0;0;0;129428;110593;79;240021
24;2020-06-01;1;0;1;87342;56882;89;144224
24;2020-06-01;0;0;0;31210;12071;90;43281
24;2020-06-01;2;0;2;1320165;1238908;0;2559073
27;2020-06-01;0;0;0;143373;149679;09;293052
27;2020-06-01;0;0;0;160962;173003;19;333965
27;2020-06-01;0;0;0;133746;142254;29;276000
27;2020-06-01;0;0;0;160004;155407;39;315411
27;2020-06-01;0;0;0;172333;169564;49;341897
27;2020-06-01;0;0;0;189979;183788;59;373767
27;2020-06-01;0;0;0;192591;178206;69;370797
27;2020-06-01;0;1;1;146876;127546;79;274422
27;2020-06-01;1;0;1;96896;61575;89;158471
27;2020-06-01;1;0;1;33148;12109;90;45257
27;2020-06-01;2;1;3;1429908;1353131;0;2783039
28;2020-06-01;0;0;0;180735;186856;09;367591
28;2020-06-01;0;0;0;200125;213621;19;413746
28;2020-06-01;1;0;1;168922;173007;29;341929
28;2020-06-01;1;0;1;196628;188487;39;385115
28;2020-06-01;0;0;0;205396;201699;49;407095
28;2020-06-01;0;0;0;222002;213866;59;435868
28;2020-06-01;0;0;0;224688;203758;69;428446
28;2020-06-01;0;0;0;163192;135543;79;298735
28;2020-06-01;1;0;1;109691;65377;89;175068
28;2020-06-01;1;1;2;37222;12685;90;49907
28;2020-06-01;4;1;5;1708601;1594899;0;3303500
32;2020-06-01;0;1;1;358062;373689;09;731751
32;2020-06-01;0;0;0;387045;406742;19;793787
32;2020-06-01;1;0;1;342304;348587;29;690891
32;2020-06-01;0;0;0;382485;369972;39;752457
32;2020-06-01;2;1;3;382510;376716;49;759226
32;2020-06-01;0;4;4;386937;376527;59;763464
32;2020-06-01;0;1;1;371211;330938;69;702149
32;2020-06-01;0;2;2;250542;201459;79;452001
32;2020-06-01;4;0;4;163399;89786;89;253185
32;2020-06-01;3;0;3;48384;15367;90;63751
32;2020-06-01;10;9;19;3072879;2889783;0;5962662
44;2020-06-01;0;0;0;291525;306839;09;598364
44;2020-06-01;0;0;0;320255;339504;19;659759
44;2020-06-01;0;0;0;302020;314428;29;616448
44;2020-06-01;0;0;0;342222;333292;39;675514
44;2020-06-01;2;1;3;349727;344491;49;694218
44;2020-06-01;3;0;3;381371;373239;59;754610
44;2020-06-01;0;0;0;367165;335850;69;703015
44;2020-06-01;0;2;2;250387;215436;79;465823
44;2020-06-01;1;0;1;170825;105192;89;276017
44;2020-06-01;0;0;0;51248;16731;90;67979
44;2020-06-01;6;3;9;2826745;2685002;0;5511747
52;2020-06-01;0;0;0;213594;223900;09;437494
52;2020-06-01;0;2;2;240818;255197;19;496015
52;2020-06-01;0;0;0;197010;200630;29;397640
52;2020-06-01;0;0;0;231204;224885;39;456089
52;2020-06-01;0;1;1;243874;243418;49;487292
52;2020-06-01;2;0;2;244100;239116;59;483216
52;2020-06-01;0;0;0;241796;221345;69;463141
52;2020-06-01;0;0;0;177805;149903;79;327708
52;2020-06-01;0;1;1;119561;75822;89;195383
52;2020-06-01;1;0;1;42559;15260;90;57819
52;2020-06-01;3;4;7;1952321;1849476;0;3801797
53;2020-06-01;0;0;0;173813;182358;09;356171
53;2020-06-01;1;0;1;202720;214740;19;417460
53;2020-06-01;0;0;0;163116;173196;29;336312
53;2020-06-01;0;0;0;190526;187674;39;378200
53;2020-06-01;0;0;0;212098;212015;49;424113
53;2020-06-01;0;0;0;223699;219176;59;442875
53;2020-06-01;0;0;0;227435;209274;69;436709
53;2020-06-01;0;0;0;169992;140910;79;310902
53;2020-06-01;0;0;0;118117;69883;89;188000
53;2020-06-01;0;0;0;37370;12267;90;49637
53;2020-06-01;1;0;1;1718886;1621493;0;3340379
75;2020-06-01;0;0;0;293104;305291;09;598395
75;2020-06-01;0;0;0;337141;357785;19;694926
75;2020-06-01;0;0;0;295024;300618;29;595642
75;2020-06-01;2;0;2;347871;331233;39;679104
75;2020-06-01;1;1;2;384742;372771;49;757513
75;2020-06-01;0;0;0;413361;390880;59;804241
75;2020-06-01;0;0;0;425623;384060;69;809683
75;2020-06-01;0;2;2;325086;276298;79;601384
75;2020-06-01;0;0;0;213986;139308;89;353294
75;2020-06-01;0;0;0;77600;28200;90;105800
75;2020-06-01;3;3;6;3113538;2886444;0;5999982
76;2020-06-01;0;0;0;305956;318589;09;624545
76;2020-06-01;0;0;0;338942;356969;19;695911
76;2020-06-01;0;0;0;316210;319570;29;635780
76;2020-06-01;0;1;1;356758;337587;39;694345
76;2020-06-01;0;0;0;376541;363812;49;740353
76;2020-06-01;0;0;0;402608;383750;59;786358
76;2020-06-01;0;0;0;394889;358997;69;753886
76;2020-06-01;0;0;0;308664;263806;79;572470
76;2020-06-01;0;1;1;195838;129272;89;325110
76;2020-06-01;0;0;0;69372;26728;90;96100
76;2020-06-01;0;2;2;3065778;2859080;0;5924858
84;2020-06-01;0;0;0;459549;481088;09;940637
84;2020-06-01;0;0;0;487711;511905;19;999616
84;2020-06-01;2;2;4;443824;451094;29;894918
84;2020-06-01;0;0;0;512522;493262;39;1005784
84;2020-06-01;0;0;0;520248;515106;49;1035354
84;2020-06-01;2;0;2;529611;514848;59;1044459
84;2020-06-01;0;0;0;486720;439940;69;926660
84;2020-06-01;1;0;1;372151;315211;79;687362
84;2020-06-01;2;0;2;237198;150524;89;387722
84;2020-06-01;1;2;3;81185;28680;90;109865
84;2020-06-01;8;4;16;4130719;3901658;0;8032377
93;2020-06-01;0;0;0;268834;283093;09;551927
93;2020-06-01;0;0;0;280751;296087;19;576838
93;2020-06-01;0;0;0;254404;255552;29;509956
93;2020-06-01;1;0;1;310704;288398;39;599102
93;2020-06-01;0;1;1;325559;305827;49;631386
93;2020-06-01;0;1;1;353104;325389;59;678493
93;2020-06-01;1;2;3;336327;296459;69;632786
93;2020-06-01;0;1;1;279820;229699;79;509519
93;2020-06-01;0;0;0;171274;113716;89;284990
93;2020-06-01;1;0;1;58896;21758;90;80654
93;2020-06-01;3;5;8;2639673;2415978;0;5055651
94;2020-06-01;0;0;0;16311;17433;09;33744
94;2020-06-01;0;0;0;16679;18132;19;34811
94;2020-06-01;0;0;0;16782;16579;29;33361
94;2020-06-01;0;0;0;23044;20580;39;43624
94;2020-06-01;0;0;0;23065;22140;49;45205
94;2020-06-01;0;0;0;24549;23421;59;47970
94;2020-06-01;0;0;0;23212;21883;69;45095
94;2020-06-01;0;0;0;19544;17141;79;36685
94;2020-06-01;0;0;0;11227;8178;89;19405
94;2020-06-01;0;0;0;3332;1447;90;4779
94;2020-06-01;0;0;0;177745;166934;0;344679
01;2020-06-02;0;0;0;19979;20155;09;40134
01;2020-06-02;1;0;1;24994;25489;19;50483
01;2020-06-02;0;0;0;17868;16690;29;34558
01;2020-06-02;0;0;0;22328;14821;39;37149
01;2020-06-02;0;0;0;28652;20276;49;48928
01;2020-06-02;0;0;0;33264;27260;59;60524
01;2020-06-02;0;1;1;27135;23978;69;51113
01;2020-06-02;0;0;0;18401;14661;79;33062
01;2020-06-02;0;0;0;9633;6375;89;16008
01;2020-06-02;0;0;0;3410;1510;90;4920
01;2020-06-02;1;1;2;205664;171215;0;376879
02;2020-06-02;0;0;0;16881;17110;09;33991
02;2020-06-02;0;0;0;21410;21604;19;43014
02;2020-06-02;0;0;0;16017;15479;29;31496
02;2020-06-02;1;0;1;19825;14455;39;34280
02;2020-06-02;0;0;0;24719;18248;49;42967
02;2020-06-02;0;0;0;34361;28310;59;62671
02;2020-06-02;0;0;0;28061;24495;69;52556
02;2020-06-02;0;0;0;18231;15278;79;33509
02;2020-06-02;0;0;0;11090;7677;89;18767
02;2020-06-02;0;0;0;3992;1506;90;5498
02;2020-06-02;1;0;1;194587;164162;0;358749
03;2020-06-02;4;0;4;31123;30920;09;62043
03;2020-06-02;0;0;0;29370;29268;19;58638
03;2020-06-02;5;1;6;21458;18963;29;40421
03;2020-06-02;3;2;5;21276;18326;39;39602
03;2020-06-02;3;7;11;18164;16593;49;34757
03;2020-06-02;2;5;7;13469;13557;59;27026
03;2020-06-02;0;2;2;8776;8670;69;17446
03;2020-06-02;0;0;0;3777;3591;79;7368
03;2020-06-02;0;1;1;1649;1072;89;2721
03;2020-06-02;0;0;0;485;184;90;669
03;2020-06-02;17;18;36;149547;141144;0;290691
04;2020-06-02;0;0;0;60314;61377;09;121691
04;2020-06-02;0;0;0;66065;68387;19;134452
04;2020-06-02;0;0;0;51059;47156;29;98215
04;2020-06-02;0;0;0;58788;45780;39;104568
04;2020-06-02;0;2;2;61408;52207;49;113615
04;2020-06-02;0;0;0;64838;60759;59;125597
04;2020-06-02;0;0;0;47008;42843;69;89851
04;2020-06-02;0;0;0;25509;21184;79;46693
04;2020-06-02;0;0;0;13168;7647;89;20815
04;2020-06-02;0;0;0;3209;1253;90;4462
04;2020-06-02;0;2;2;451366;408593;0;859959
05;2020-06-02;0;0;0;362.366008612902;341.338819562748;09;703.704828175651
05;2020-06-02;0;0;0;353.376145114279;370.349735405642;19;723.725880519921
05;2020-06-02;0;0;0;218.593559489256;256.539602589476;29;475.133162078732
05;2020-06-02;0;0;0;404.225408693299;360.321910454353;39;764.547319147651
05;2020-06-02;0;0;0;520.067953604221;497.108383964256;49;1017.17633756848
05;2020-06-02;0;0;0;468.146063921917;510.087601910415;59;978.233665832332
05;2020-06-02;0;0;0;340.368470050554;334.366842191253;69;674.735312241807
05;2020-06-02;0;0;0;212.598666888387;192.597753227106;79;405.196420115493
05;2020-06-02;0;0;0;148.727797095705;61.8681715431829;89;210.595968638888
05;2020-06-02;0;0;0;32.9601271090696;10.9909785719784;90;43.9511056810479
05;2020-06-02;0;0;0;3061.43020057959;2935.56979942041;0;5997
06;2020-06-02;0;0;0;42583;42380;09;84963
06;2020-06-02;2;1;3;33369;31925;19;65294
06;2020-06-02;3;0;3;21571;15080;29;36651
06;2020-06-02;4;2;6;21550;16147;39;37697
06;2020-06-02;4;7;11;14193;13939;49;28132
06;2020-06-02;3;5;8;7171;7597;59;14768
06;2020-06-02;0;1;1;3629;4117;69;7746
06;2020-06-02;1;2;3;1577;1457;79;3034
06;2020-06-02;0;1;1;531;474;89;1005
06;2020-06-02;0;0;0;88;93;90;181
06;2020-06-02;17;19;36;146262;133209;0;279471
07;2020-06-02;0;0;0;485;549;09;1034
07;2020-06-02;0;0;0;403;432;19;835
07;2020-06-02;0;0;0;764;841;29;1605
07;2020-06-02;0;0;0;824;928;39;1752
07;2020-06-02;0;0;0;788;1020;49;1808
07;2020-06-02;0;0;0;678;870;59;1548
07;2020-06-02;0;0;0;360;382;69;742
07;2020-06-02;0;0;0;231;190;79;421
07;2020-06-02;0;0;0;114;67;89;181
07;2020-06-02;0;0;0;24;11;90;35
07;2020-06-02;0;0;0;4671;5290;0;9961
08;2020-06-02;0;0;0;2715.22592983026;2997.75551488675;09;5712.98144471701
08;2020-06-02;0;0;0;2778.51901080978;3160.9156459093;19;5939.43465671908
08;2020-06-02;0;0;0;2080.8882988764;1718.16634315323;29;3799.05464202964
08;2020-06-02;0;0;0;2701.8582062647;1896.52641413317;39;4598.38462039786
08;2020-06-02;0;0;0;3151.45861023308;2460.52498233809;49;5611.98359257117
08;2020-06-02;0;0;0;2620.29868333099;2422.23566154656;59;5042.53434487755
08;2020-06-02;0;0;0;1621.44173420671;1438.58325779464;69;3060.02499200135
08;2020-06-02;0;0;0;626.575909335673;526.358467843651;79;1152.93437717932
08;2020-06-02;0;0;0;205.018522985054;140.993639349697;89;346.012162334751
08;2020-06-02;0;0;0;50.0325684687745;20.62259870351;90;70.6551671722846
08;2020-06-02;0;0;0;18551.3174743414;16782.6825256586;0;35334
11;2020-06-02;3;0;3;783071;811785;09;1594856
11;2020-06-02;2;7;9;761456;784653;19;1546109
11;2020-06-02;15;11;26;850145;801772;29;1651917
11;2020-06-02;14;3;17;914360;843488;39;1757848
11;2020-06-02;17;18;35;845609;826202;49;1671811
11;2020-06-02;13;15;28;793566;745070;59;1538636
11;2020-06-02;19;15;34;628649;549192;69;1177841
11;2020-06-02;15;4;19;434606;358356;79;792962
11;2020-06-02;14;6;20;261425;162933;89;424358
11;2020-06-02;19;2;21;89253;32619;90;121872
11;2020-06-02;131;82;213;6362140;5916070;0;12278210
24;2020-06-02;0;0;0;139720;144686;09;284406
24;2020-06-02;1;0;1;152979;161185;19;314164
24;2020-06-02;2;0;2;122237;126536;29;248773
24;2020-06-02;0;0;0;150359;142009;39;292368
24;2020-06-02;1;1;2;161829;158758;49;320587
24;2020-06-02;1;0;1;172552;168011;59;340563
24;2020-06-02;0;0;0;172509;158177;69;330686
24;2020-06-02;0;1;1;129428;110593;79;240021
24;2020-06-02;2;1;3;87342;56882;89;144224
24;2020-06-02;1;1;2;31210;12071;90;43281
24;2020-06-02;8;4;12;1320165;1238908;0;2559073
27;2020-06-02;0;0;0;143373;149679;09;293052
27;2020-06-02;0;0;0;160962;173003;19;333965
27;2020-06-02;2;2;4;133746;142254;29;276000
27;2020-06-02;1;0;1;160004;155407;39;315411
27;2020-06-02;3;0;3;172333;169564;49;341897
27;2020-06-02;2;0;2;189979;183788;59;373767
27;2020-06-02;0;0;0;192591;178206;69;370797
27;2020-06-02;1;2;3;146876;127546;79;274422
27;2020-06-02;3;2;5;96896;61575;89;158471
27;2020-06-02;8;0;8;33148;12109;90;45257
27;2020-06-02;20;6;26;1429908;1353131;0;2783039
28;2020-06-02;0;3;3;180735;186856;09;367591
28;2020-06-02;0;0;0;200125;213621;19;413746
28;2020-06-02;0;0;0;168922;173007;29;341929
28;2020-06-02;0;0;0;196628;188487;39;385115
28;2020-06-02;3;0;3;205396;201699;49;407095
28;2020-06-02;1;1;2;222002;213866;59;435868
28;2020-06-02;0;0;0;224688;203758;69;428446
28;2020-06-02;1;0;1;163192;135543;79;298735
28;2020-06-02;0;0;0;109691;65377;89;175068
28;2020-06-02;0;0;0;37222;12685;90;49907
28;2020-06-02;5;4;9;1708601;1594899;0;3303500
32;2020-06-02;2;2;4;358062;373689;09;731751
32;2020-06-02;6;0;6;387045;406742;19;793787
32;2020-06-02;6;2;8;342304;348587;29;690891
32;2020-06-02;8;2;10;382485;369972;39;752457
32;2020-06-02;6;3;9;382510;376716;49;759226
32;2020-06-02;7;2;9;386937;376527;59;763464
32;2020-06-02;5;3;8;371211;330938;69;702149
32;2020-06-02;1;1;2;250542;201459;79;452001
32;2020-06-02;8;5;13;163399;89786;89;253185
32;2020-06-02;5;3;8;48384;15367;90;63751
32;2020-06-02;54;23;77;3072879;2889783;0;5962662
44;2020-06-02;6;2;8;291525;306839;09;598364
44;2020-06-02;1;0;1;320255;339504;19;659759
44;2020-06-02;9;15;24;302020;314428;29;616448
44;2020-06-02;10;3;13;342222;333292;39;675514
44;2020-06-02;7;11;18;349727;344491;49;694218
44;2020-06-02;15;1;16;381371;373239;59;754610
44;2020-06-02;7;6;13;367165;335850;69;703015
44;2020-06-02;10;6;16;250387;215436;79;465823
44;2020-06-02;13;6;19;170825;105192;89;276017
44;2020-06-02;10;2;12;51248;16731;90;67979
44;2020-06-02;88;52;140;2826745;2685002;0;5511747
52;2020-06-02;2;2;4;213594;223900;09;437494
52;2020-06-02;5;3;9;240818;255197;19;496015
52;2020-06-02;8;1;9;197010;200630;29;397640
52;2020-06-02;5;5;10;231204;224885;39;456089
52;2020-06-02;1;4;5;243874;243418;49;487292
52;2020-06-02;1;2;3;244100;239116;59;483216
52;2020-06-02;1;0;1;241796;221345;69;463141
52;2020-06-02;3;0;3;177805;149903;79;327708
52;2020-06-02;0;0;0;119561;75822;89;195383
52;2020-06-02;3;1;5;42559;15260;90;57819
52;2020-06-02;29;18;49;1952321;1849476;0;3801797
53;2020-06-02;1;1;2;173813;182358;09;356171
53;2020-06-02;0;0;0;202720;214740;19;417460
53;2020-06-02;0;1;1;163116;173196;29;336312
53;2020-06-02;2;0;2;190526;187674;39;378200
53;2020-06-02;0;2;2;212098;212015;49;424113
53;2020-06-02;0;0;0;223699;219176;59;442875
53;2020-06-02;0;0;0;227435;209274;69;436709
53;2020-06-02;0;1;1;169992;140910;79;310902
53;2020-06-02;0;0;0;118117;69883;89;188000
53;2020-06-02;0;0;0;37370;12267;90;49637
53;2020-06-02;3;5;8;1718886;1621493;0;3340379
75;2020-06-02;0;0;0;293104;305291;09;598395
75;2020-06-02;4;0;4;337141;357785;19;694926
75;2020-06-02;0;0;0;295024;300618;29;595642
75;2020-06-02;0;1;1;347871;331233;39;679104
75;2020-06-02;1;0;1;384742;372771;49;757513
75;2020-06-02;0;2;2;413361;390880;59;804241
75;2020-06-02;0;1;1;425623;384060;69;809683
75;2020-06-02;0;2;2;325086;276298;79;601384
75;2020-06-02;1;0;1;213986;139308;89;353294
75;2020-06-02;0;0;0;77600;28200;90;105800
75;2020-06-02;6;6;12;3113538;2886444;0;5999982
76;2020-06-02;0;2;2;305956;318589;09;624545
76;2020-06-02;2;0;2;338942;356969;19;695911
76;2020-06-02;0;0;0;316210;319570;29;635780
76;2020-06-02;3;0;3;356758;337587;39;694345
76;2020-06-02;0;0;0;376541;363812;49;740353
76;2020-06-02;0;3;3;402608;383750;59;786358
76;2020-06-02;1;2;3;394889;358997;69;753886
76;2020-06-02;0;0;0;308664;263806;79;572470
76;2020-06-02;3;1;4;195838;129272;89;325110
76;2020-06-02;2;0;2;69372;26728;90;96100
76;2020-06-02;11;8;19;3065778;2859080;0;5924858
84;2020-06-02;0;1;1;459549;481088;09;940637
84;2020-06-02;0;0;0;487711;511905;19;999616
84;2020-06-02;8;5;13;443824;451094;29;894918
84;2020-06-02;1;3;4;512522;493262;39;1005784
84;2020-06-02;3;0;3;520248;515106;49;1035354
84;2020-06-02;1;0;1;529611;514848;59;1044459
84;2020-06-02;3;2;5;486720;439940;69;926660
84;2020-06-02;0;1;1;372151;315211;79;687362
84;2020-06-02;7;2;9;237198;150524;89;387722
84;2020-06-02;11;2;13;81185;28680;90;109865
84;2020-06-02;34;16;50;4130719;3901658;0;8032377
93;2020-06-02;1;0;1;268834;283093;09;551927
93;2020-06-02;0;0;0;280751;296087;19;576838
93;2020-06-02;5;6;11;254404;255552;29;509956
93;2020-06-02;4;0;4;310704;288398;39;599102
93;2020-06-02;2;2;4;325559;305827;49;631386
93;2020-06-02;1;2;3;353104;325389;59;678493
93;2020-06-02;2;2;4;336327;296459;69;632786
93;2020-06-02;5;3;9;279820;229699;79;509519
93;2020-06-02;3;3;6;171274;113716;89;284990
93;2020-06-02;5;3;8;58896;21758;90;80654
93;2020-06-02;28;21;50;2639673;2415978;0;5055651
94;2020-06-02;0;0;0;16311;17433;09;33744
94;2020-06-02;0;0;0;16679;18132;19;34811
94;2020-06-02;0;0;0;16782;16579;29;33361
94;2020-06-02;0;0;0;23044;20580;39;43624
94;2020-06-02;0;0;0;23065;22140;49;45205
94;2020-06-02;0;1;1;24549;23421;59;47970
94;2020-06-02;0;0;0;23212;21883;69;45095
94;2020-06-02;0;0;0;19544;17141;79;36685
94;2020-06-02;0;0;0;11227;8178;89;19405
94;2020-06-02;0;0;0;3332;1447;90;4779
94;2020-06-02;0;1;1;177745;166934;0;344679
01;2020-06-03;0;0;0;19979;20155;09;40134
01;2020-06-03;0;0;0;24994;25489;19;50483
01;2020-06-03;0;0;0;17868;16690;29;34558
01;2020-06-03;0;0;0;22328;14821;39;37149
01;2020-06-03;0;0;0;28652;20276;49;48928
01;2020-06-03;0;0;0;33264;27260;59;60524
01;2020-06-03;0;0;0;27135;23978;69;51113
01;2020-06-03;0;0;0;18401;14661;79;33062
01;2020-06-03;0;0;0;9633;6375;89;16008
01;2020-06-03;0;0;0;3410;1510;90;4920
01;2020-06-03;0;0;0;205664;171215;0;376879
02;2020-06-03;0;0;0;16881;17110;09;33991
02;2020-06-03;1;0;1;21410;21604;19;43014
02;2020-06-03;0;0;0;16017;15479;29;31496
02;2020-06-03;0;0;0;19825;14455;39;34280
02;2020-06-03;0;0;0;24719;18248;49;42967
02;2020-06-03;0;0;0;34361;28310;59;62671
02;2020-06-03;0;0;0;28061;24495;69;52556
02;2020-06-03;0;0;0;18231;15278;79;33509
02;2020-06-03;0;0;0;11090;7677;89;18767
02;2020-06-03;0;0;0;3992;1506;90;5498
02;2020-06-03;1;0;1;194587;164162;0;358749
03;2020-06-03;0;0;0;31123;30920;09;62043
03;2020-06-03;2;0;4;29370;29268;19;58638
03;2020-06-03;2;6;8;21458;18963;29;40421
03;2020-06-03;4;1;5;21276;18326;39;39602
03;2020-06-03;3;4;7;18164;16593;49;34757
03;2020-06-03;1;0;1;13469;13557;59;27026
03;2020-06-03;2;0;2;8776;8670;69;17446
03;2020-06-03;1;0;1;3777;3591;79;7368
03;2020-06-03;0;0;0;1649;1072;89;2721
03;2020-06-03;0;0;0;485;184;90;669
03;2020-06-03;15;11;28;149547;141144;0;290691
04;2020-06-03;0;0;0;60314;61377;09;121691
04;2020-06-03;0;0;0;66065;68387;19;134452
04;2020-06-03;1;1;2;51059;47156;29;98215
04;2020-06-03;0;0;0;58788;45780;39;104568
04;2020-06-03;0;0;0;61408;52207;49;113615
04;2020-06-03;1;0;1;64838;60759;59;125597
04;2020-06-03;0;0;0;47008;42843;69;89851
04;2020-06-03;0;0;0;25509;21184;79;46693
04;2020-06-03;0;0;0;13168;7647;89;20815
04;2020-06-03;0;0;0;3209;1253;90;4462
04;2020-06-03;2;1;3;451366;408593;0;859959
05;2020-06-03;0;0;0;362.366008612902;341.338819562748;09;703.704828175651
05;2020-06-03;0;0;0;353.376145114279;370.349735405642;19;723.725880519921
05;2020-06-03;0;0;0;218.593559489256;256.539602589476;29;475.133162078732
05;2020-06-03;0;0;0;404.225408693299;360.321910454353;39;764.547319147651
05;2020-06-03;0;0;0;520.067953604221;497.108383964256;49;1017.17633756848
05;2020-06-03;0;0;0;468.146063921917;510.087601910415;59;978.233665832332
05;2020-06-03;0;0;0;340.368470050554;334.366842191253;69;674.735312241807
05;2020-06-03;0;0;0;212.598666888387;192.597753227106;79;405.196420115493
05;2020-06-03;0;0;0;148.727797095705;61.8681715431829;89;210.595968638888
05;2020-06-03;0;0;0;32.9601271090696;10.9909785719784;90;43.9511056810479
05;2020-06-03;0;0;0;3061.43020057959;2935.56979942041;0;5997
06;2020-06-03;0;0;0;42583;42380;09;84963
06;2020-06-03;5;0;6;33369;31925;19;65294
06;2020-06-03;4;2;6;21571;15080;29;36651
06;2020-06-03;2;2;4;21550;16147;39;37697
06;2020-06-03;2;3;5;14193;13939;49;28132
06;2020-06-03;1;2;3;7171;7597;59;14768
06;2020-06-03;0;3;3;3629;4117;69;7746
06;2020-06-03;0;0;0;1577;1457;79;3034
06;2020-06-03;0;0;0;531;474;89;1005
06;2020-06-03;0;0;0;88;93;90;181
06;2020-06-03;14;12;27;146262;133209;0;279471
07;2020-06-03;0;0;0;485;549;09;1034
07;2020-06-03;0;0;0;403;432;19;835
07;2020-06-03;0;0;0;764;841;29;1605
07;2020-06-03;0;0;0;824;928;39;1752
07;2020-06-03;0;0;0;788;1020;49;1808
07;2020-06-03;0;0;0;678;870;59;1548
07;2020-06-03;0;0;0;360;382;69;742
07;2020-06-03;0;0;0;231;190;79;421
07;2020-06-03;0;0;0;114;67;89;181
07;2020-06-03;0;0;0;24;11;90;35
07;2020-06-03;0;0;0;4671;5290;0;9961
08;2020-06-03;0;0;0;2715.22592983026;2997.75551488675;09;5712.98144471701
08;2020-06-03;0;0;0;2778.51901080978;3160.9156459093;19;5939.43465671908
08;2020-06-03;0;0;0;2080.8882988764;1718.16634315323;29;3799.05464202964
08;2020-06-03;0;0;0;2701.8582062647;1896.52641413317;39;4598.38462039786
08;2020-06-03;0;0;0;3151.45861023308;2460.52498233809;49;5611.98359257117
08;2020-06-03;0;0;0;2620.29868333099;2422.23566154656;59;5042.53434487755
08;2020-06-03;0;0;0;1621.44173420671;1438.58325779464;69;3060.02499200135
08;2020-06-03;0;0;0;626.575909335673;526.358467843651;79;1152.93437717932
08;2020-06-03;0;0;0;205.018522985054;140.993639349697;89;346.012162334751
08;2020-06-03;0;0;0;50.0325684687745;20.62259870351;90;70.6551671722846
08;2020-06-03;0;0;0;18551.3174743414;16782.6825256586;0;35334
11;2020-06-03;0;3;4;783071;811785;09;1594856
11;2020-06-03;5;2;7;761456;784653;19;1546109
11;2020-06-03;17;8;25;850145;801772;29;1651917
11;2020-06-03;14;12;27;914360;843488;39;1757848
11;2020-06-03;19;7;26;845609;826202;49;1671811
11;2020-06-03;11;10;21;793566;745070;59;1538636
11;2020-06-03;10;8;18;628649;549192;69;1177841
11;2020-06-03;2;9;11;434606;358356;79;792962
11;2020-06-03;8;8;16;261425;162933;89;424358
11;2020-06-03;12;2;14;89253;32619;90;121872
11;2020-06-03;98;69;171;6362140;5916070;0;12278210
24;2020-06-03;0;0;0;139720;144686;09;284406
24;2020-06-03;0;1;1;152979;161185;19;314164
24;2020-06-03;2;0;2;122237;126536;29;248773
24;2020-06-03;0;0;0;150359;142009;39;292368
24;2020-06-03;0;0;0;161829;158758;49;320587
24;2020-06-03;4;3;7;172552;168011;59;340563
24;2020-06-03;0;0;0;172509;158177;69;330686
24;2020-06-03;1;0;1;129428;110593;79;240021
24;2020-06-03;3;1;4;87342;56882;89;144224
24;2020-06-03;0;0;0;31210;12071;90;43281
24;2020-06-03;10;5;15;1320165;1238908;0;2559073
27;2020-06-03;0;0;0;143373;149679;09;293052
27;2020-06-03;0;0;0;160962;173003;19;333965
27;2020-06-03;3;0;3;133746;142254;29;276000
27;2020-06-03;2;0;2;160004;155407;39;315411
27;2020-06-03;1;0;1;172333;169564;49;341897
27;2020-06-03;1;0;1;189979;183788;59;373767
27;2020-06-03;0;0;0;192591;178206;69;370797
27;2020-06-03;0;3;3;146876;127546;79;274422
27;2020-06-03;4;0;4;96896;61575;89;158471
27;2020-06-03;1;0;1;33148;12109;90;45257
27;2020-06-03;12;3;15;1429908;1353131;0;2783039
28;2020-06-03;0;0;0;180735;186856;09;367591
28;2020-06-03;0;2;2;200125;213621;19;413746
28;2020-06-03;1;1;2;168922;173007;29;341929
28;2020-06-03;1;1;2;196628;188487;39;385115
28;2020-06-03;0;0;0;205396;201699;49;407095
28;2020-06-03;0;0;0;222002;213866;59;435868
28;2020-06-03;0;0;0;224688;203758;69;428446
28;2020-06-03;0;0;0;163192;135543;79;298735
28;2020-06-03;0;0;0;109691;65377;89;175068
28;2020-06-03;0;0;0;37222;12685;90;49907
28;2020-06-03;2;4;6;1708601;1594899;0;3303500
32;2020-06-03;0;4;4;358062;373689;09;731751
32;2020-06-03;2;2;4;387045;406742;19;793787
32;2020-06-03;8;3;11;342304;348587;29;690891
32;2020-06-03;12;2;14;382485;369972;39;752457
32;2020-06-03;4;4;8;382510;376716;49;759226
32;2020-06-03;1;2;3;386937;376527;59;763464
32;2020-06-03;4;4;8;371211;330938;69;702149
32;2020-06-03;1;7;8;250542;201459;79;452001
32;2020-06-03;7;4;11;163399;89786;89;253185
32;2020-06-03;9;0;9;48384;15367;90;63751
32;2020-06-03;48;32;80;3072879;2889783;0;5962662
44;2020-06-03;1;1;3;291525;306839;09;598364
44;2020-06-03;1;1;2;320255;339504;19;659759
44;2020-06-03;11;3;14;302020;314428;29;616448
44;2020-06-03;11;4;16;342222;333292;39;675514
44;2020-06-03;14;3;17;349727;344491;49;694218
44;2020-06-03;7;5;12;381371;373239;59;754610
44;2020-06-03;8;9;17;367165;335850;69;703015
44;2020-06-03;11;7;18;250387;215436;79;465823
44;2020-06-03;19;9;28;170825;105192;89;276017
44;2020-06-03;10;2;12;51248;16731;90;67979
44;2020-06-03;93;44;154;2826745;2685002;0;5511747
52;2020-06-03;0;0;0;213594;223900;09;437494
52;2020-06-03;0;7;7;240818;255197;19;496015
52;2020-06-03;3;0;3;197010;200630;29;397640
52;2020-06-03;0;3;3;231204;224885;39;456089
52;2020-06-03;3;1;4;243874;243418;49;487292
52;2020-06-03;2;1;3;244100;239116;59;483216
52;2020-06-03;0;1;1;241796;221345;69;463141
52;2020-06-03;0;0;0;177805;149903;79;327708
52;2020-06-03;1;0;1;119561;75822;89;195383
52;2020-06-03;0;0;0;42559;15260;90;57819
52;2020-06-03;9;13;22;1952321;1849476;0;3801797
53;2020-06-03;0;0;0;173813;182358;09;356171
53;2020-06-03;0;0;0;202720;214740;19;417460
53;2020-06-03;0;0;0;163116;173196;29;336312
53;2020-06-03;0;1;1;190526;187674;39;378200
53;2020-06-03;0;0;0;212098;212015;49;424113
53;2020-06-03;2;1;3;223699;219176;59;442875
53;2020-06-03;1;0;1;227435;209274;69;436709
53;2020-06-03;0;0;0;169992;140910;79;310902
53;2020-06-03;0;1;1;118117;69883;89;188000
53;2020-06-03;0;0;0;37370;12267;90;49637
53;2020-06-03;3;3;6;1718886;1621493;0;3340379
75;2020-06-03;1;0;1;293104;305291;09;598395
75;2020-06-03;1;0;1;337141;357785;19;694926
75;2020-06-03;0;1;1;295024;300618;29;595642
75;2020-06-03;3;1;4;347871;331233;39;679104
75;2020-06-03;0;0;0;384742;372771;49;757513
75;2020-06-03;3;2;5;413361;390880;59;804241
75;2020-06-03;1;2;3;425623;384060;69;809683
75;2020-06-03;3;2;5;325086;276298;79;601384
75;2020-06-03;0;2;2;213986;139308;89;353294
75;2020-06-03;1;0;1;77600;28200;90;105800
75;2020-06-03;13;11;24;3113538;2886444;0;5999982
76;2020-06-03;1;0;1;305956;318589;09;624545
76;2020-06-03;0;0;0;338942;356969;19;695911
76;2020-06-03;0;2;2;316210;319570;29;635780
76;2020-06-03;2;1;3;356758;337587;39;694345
76;2020-06-03;1;1;2;376541;363812;49;740353
76;2020-06-03;2;1;3;402608;383750;59;786358
76;2020-06-03;0;0;0;394889;358997;69;753886
76;2020-06-03;0;1;1;308664;263806;79;572470
76;2020-06-03;1;1;2;195838;129272;89;325110
76;2020-06-03;2;0;2;69372;26728;90;96100
76;2020-06-03;9;7;16;3065778;2859080;0;5924858
84;2020-06-03;0;0;0;459549;481088;09;940637
84;2020-06-03;1;2;3;487711;511905;19;999616
84;2020-06-03;3;3;6;443824;451094;29;894918
84;2020-06-03;4;2;6;512522;493262;39;1005784
84;2020-06-03;2;0;2;520248;515106;49;1035354
84;2020-06-03;3;0;3;529611;514848;59;1044459
84;2020-06-03;0;2;2;486720;439940;69;926660
84;2020-06-03;2;0;2;372151;315211;79;687362
84;2020-06-03;3;1;4;237198;150524;89;387722
84;2020-06-03;8;2;10;81185;28680;90;109865
84;2020-06-03;26;12;38;4130719;3901658;0;8032377
93;2020-06-03;2;0;2;268834;283093;09;551927
93;2020-06-03;1;0;1;280751;296087;19;576838
93;2020-06-03;1;4;5;254404;255552;29;509956
93;2020-06-03;7;6;17;310704;288398;39;599102
93;2020-06-03;1;5;9;325559;305827;49;631386
93;2020-06-03;3;3;6;353104;325389;59;678493
93;2020-06-03;1;0;1;336327;296459;69;632786
93;2020-06-03;4;2;6;279820;229699;79;509519
93;2020-06-03;9;3;12;171274;113716;89;284990
93;2020-06-03;2;1;3;58896;21758;90;80654
93;2020-06-03;31;24;62;2639673;2415978;0;5055651
94;2020-06-03;0;0;0;16311;17433;09;33744
94;2020-06-03;0;0;0;16679;18132;19;34811
94;2020-06-03;0;0;0;16782;16579;29;33361
94;2020-06-03;0;0;0;23044;20580;39;43624
94;2020-06-03;1;0;1;23065;22140;49;45205
94;2020-06-03;0;0;0;24549;23421;59;47970
94;2020-06-03;0;0;0;23212;21883;69;45095
94;2020-06-03;0;0;0;19544;17141;79;36685
94;2020-06-03;0;1;1;11227;8178;89;19405
94;2020-06-03;0;0;0;3332;1447;90;4779
94;2020-06-03;1;1;2;177745;166934;0;344679
01;2020-06-04;0;0;0;19979;20155;09;40134
01;2020-06-04;0;0;0;24994;25489;19;50483
01;2020-06-04;0;0;0;17868;16690;29;34558
01;2020-06-04;0;0;0;22328;14821;39;37149
01;2020-06-04;0;0;0;28652;20276;49;48928
01;2020-06-04;0;0;0;33264;27260;59;60524
01;2020-06-04;0;0;0;27135;23978;69;51113
01;2020-06-04;0;0;0;18401;14661;79;33062
01;2020-06-04;0;0;0;9633;6375;89;16008
01;2020-06-04;0;0;0;3410;1510;90;4920
01;2020-06-04;0;0;0;205664;171215;0;376879
02;2020-06-04;0;0;0;16881;17110;09;33991
02;2020-06-04;0;0;0;21410;21604;19;43014
02;2020-06-04;0;1;1;16017;15479;29;31496
02;2020-06-04;0;0;0;19825;14455;39;34280
02;2020-06-04;0;0;0;24719;18248;49;42967
02;2020-06-04;1;0;1;34361;28310;59;62671
02;2020-06-04;0;0;0;28061;24495;69;52556
02;2020-06-04;1;0;1;18231;15278;79;33509
02;2020-06-04;0;0;0;11090;7677;89;18767
02;2020-06-04;0;0;0;3992;1506;90;5498
02;2020-06-04;2;1;3;194587;164162;0;358749
03;2020-06-04;1;1;2;31123;30920;09;62043
03;2020-06-04;3;1;4;29370;29268;19;58638
03;2020-06-04;4;4;8;21458;18963;29;40421
03;2020-06-04;4;5;10;21276;18326;39;39602
03;2020-06-04;4;0;4;18164;16593;49;34757
03;2020-06-04;4;2;6;13469;13557;59;27026
03;2020-06-04;1;1;2;8776;8670;69;17446
03;2020-06-04;0;0;0;3777;3591;79;7368
03;2020-06-04;0;0;0;1649;1072;89;2721
03;2020-06-04;0;0;0;485;184;90;669
03;2020-06-04;21;15;37;149547;141144;0;290691
04;2020-06-04;0;0;5;60314;61377;09;121691
04;2020-06-04;0;0;0;66065;68387;19;134452
04;2020-06-04;0;0;0;51059;47156;29;98215
04;2020-06-04;0;0;0;58788;45780;39;104568
04;2020-06-04;0;0;0;61408;52207;49;113615
04;2020-06-04;0;0;0;64838;60759;59;125597
04;2020-06-04;0;0;0;47008;42843;69;89851
04;2020-06-04;0;0;0;25509;21184;79;46693
04;2020-06-04;0;0;0;13168;7647;89;20815
04;2020-06-04;0;0;0;3209;1253;90;4462
04;2020-06-04;0;0;5;451366;408593;0;859959
05;2020-06-04;0;0;0;362.366008612902;341.338819562748;09;703.704828175651
05;2020-06-04;0;0;0;353.376145114279;370.349735405642;19;723.725880519921
05;2020-06-04;0;0;0;218.593559489256;256.539602589476;29;475.133162078732
05;2020-06-04;0;0;0;404.225408693299;360.321910454353;39;764.547319147651
05;2020-06-04;0;0;0;520.067953604221;497.108383964256;49;1017.17633756848
05;2020-06-04;0;0;0;468.146063921917;510.087601910415;59;978.233665832332
05;2020-06-04;0;0;0;340.368470050554;334.366842191253;69;674.735312241807
05;2020-06-04;0;0;0;212.598666888387;192.597753227106;79;405.196420115493
05;2020-06-04;0;0;0;148.727797095705;61.8681715431829;89;210.595968638888
05;2020-06-04;0;0;0;32.9601271090696;10.9909785719784;90;43.9511056810479
05;2020-06-04;0;0;0;3061.43020057959;2935.56979942041;0;5997
06;2020-06-04;0;2;2;42583;42380;09;84963
06;2020-06-04;2;0;3;33369;31925;19;65294
06;2020-06-04;1;1;2;21571;15080;29;36651
06;2020-06-04;4;2;6;21550;16147;39;37697
06;2020-06-04;3;0;3;14193;13939;49;28132
06;2020-06-04;2;0;2;7171;7597;59;14768
06;2020-06-04;0;2;2;3629;4117;69;7746
06;2020-06-04;0;0;0;1577;1457;79;3034
06;2020-06-04;0;0;0;531;474;89;1005
06;2020-06-04;0;0;0;88;93;90;181
06;2020-06-04;12;7;20;146262;133209;0;279471
07;2020-06-04;0;0;0;485;549;09;1034
07;2020-06-04;0;0;0;403;432;19;835
07;2020-06-04;0;0;0;764;841;29;1605
07;2020-06-04;0;0;0;824;928;39;1752
07;2020-06-04;0;0;0;788;1020;49;1808
07;2020-06-04;0;0;0;678;870;59;1548
07;2020-06-04;0;0;0;360;382;69;742
07;2020-06-04;0;0;0;231;190;79;421
07;2020-06-04;0;0;0;114;67;89;181
07;2020-06-04;0;0;0;24;11;90;35
07;2020-06-04;0;0;0;4671;5290;0;9961
08;2020-06-04;0;0;0;2715.22592983026;2997.75551488675;09;5712.98144471701
08;2020-06-04;0;0;0;2778.51901080978;3160.9156459093;19;5939.43465671908
08;2020-06-04;0;0;0;2080.8882988764;1718.16634315323;29;3799.05464202964
08;2020-06-04;0;0;0;2701.8582062647;1896.52641413317;39;4598.38462039786
08;2020-06-04;0;0;0;3151.45861023308;2460.52498233809;49;5611.98359257117
08;2020-06-04;0;0;0;2620.29868333099;2422.23566154656;59;5042.53434487755
08;2020-06-04;0;0;0;1621.44173420671;1438.58325779464;69;3060.02499200135
08;2020-06-04;0;0;0;626.575909335673;526.358467843651;79;1152.93437717932
08;2020-06-04;0;0;0;205.018522985054;140.993639349697;89;346.012162334751
08;2020-06-04;0;0;0;50.0325684687745;20.62259870351;90;70.6551671722846
08;2020-06-04;0;0;0;18551.3174743414;16782.6825256586;0;35334
11;2020-06-04;1;3;4;783071;811785;09;1594856
11;2020-06-04;4;3;7;761456;784653;19;1546109
11;2020-06-04;12;9;22;850145;801772;29;1651917
11;2020-06-04;11;9;20;914360;843488;39;1757848
11;2020-06-04;12;12;24;845609;826202;49;1671811
11;2020-06-04;15;13;28;793566;745070;59;1538636
11;2020-06-04;10;14;24;628649;549192;69;1177841
11;2020-06-04;4;5;9;434606;358356;79;792962
11;2020-06-04;15;4;19;261425;162933;89;424358
11;2020-06-04;16;2;18;89253;32619;90;121872
11;2020-06-04;100;76;178;6362140;5916070;0;12278210
24;2020-06-04;1;0;1;139720;144686;09;284406
24;2020-06-04;1;0;1;152979;161185;19;314164
24;2020-06-04;0;1;1;122237;126536;29;248773
24;2020-06-04;2;0;2;150359;142009;39;292368
24;2020-06-04;1;3;4;161829;158758;49;320587
24;2020-06-04;0;1;1;172552;168011;59;340563
24;2020-06-04;0;0;0;172509;158177;69;330686
24;2020-06-04;0;1;1;129428;110593;79;240021
24;2020-06-04;1;1;2;87342;56882;89;144224
24;2020-06-04;4;2;6;31210;12071;90;43281
24;2020-06-04;10;9;19;1320165;1238908;0;2559073
27;2020-06-04;0;0;0;143373;149679;09;293052
27;2020-06-04;0;0;0;160962;173003;19;333965
27;2020-06-04;1;0;1;133746;142254;29;276000
27;2020-06-04;2;0;2;160004;155407;39;315411
27;2020-06-04;0;0;0;172333;169564;49;341897
27;2020-06-04;2;0;2;189979;183788;59;373767
27;2020-06-04;1;0;1;192591;178206;69;370797
27;2020-06-04;1;0;1;146876;127546;79;274422
27;2020-06-04;2;2;4;96896;61575;89;158471
27;2020-06-04;0;2;2;33148;12109;90;45257
27;2020-06-04;9;4;13;1429908;1353131;0;2783039
28;2020-06-04;1;1;2;180735;186856;09;367591
28;2020-06-04;0;1;1;200125;213621;19;413746
28;2020-06-04;0;1;1;168922;173007;29;341929
28;2020-06-04;0;1;1;196628;188487;39;385115
28;2020-06-04;0;0;0;205396;201699;49;407095
28;2020-06-04;1;0;1;222002;213866;59;435868
28;2020-06-04;0;0;0;224688;203758;69;428446
28;2020-06-04;0;0;0;163192;135543;79;298735
28;2020-06-04;3;0;3;109691;65377;89;175068
28;2020-06-04;0;0;0;37222;12685;90;49907
28;2020-06-04;5;4;9;1708601;1594899;0;3303500
32;2020-06-04;2;2;4;358062;373689;09;731751
32;2020-06-04;1;1;2;387045;406742;19;793787
32;2020-06-04;5;3;8;342304;348587;29;690891
32;2020-06-04;5;8;13;382485;369972;39;752457
32;2020-06-04;6;3;9;382510;376716;49;759226
32;2020-06-04;5;0;5;386937;376527;59;763464
32;2020-06-04;5;6;11;371211;330938;69;702149
32;2020-06-04;2;4;6;250542;201459;79;452001
32;2020-06-04;7;3;10;163399;89786;89;253185
32;2020-06-04;3;2;5;48384;15367;90;63751
32;2020-06-04;41;32;73;3072879;2889783;0;5962662
44;2020-06-04;1;1;2;291525;306839;09;598364
44;2020-06-04;2;1;3;320255;339504;19;659759
44;2020-06-04;13;1;14;302020;314428;29;616448
44;2020-06-04;9;7;16;342222;333292;39;675514
44;2020-06-04;8;3;11;349727;344491;49;694218
44;2020-06-04;10;4;14;381371;373239;59;754610
44;2020-06-04;3;1;4;367165;335850;69;703015
44;2020-06-04;1;3;4;250387;215436;79;465823
44;2020-06-04;5;3;8;170825;105192;89;276017
44;2020-06-04;4;4;8;51248;16731;90;67979
44;2020-06-04;56;28;84;2826745;2685002;0;5511747
52;2020-06-04;0;0;0;213594;223900;09;437494
52;2020-06-04;0;1;1;240818;255197;19;496015
52;2020-06-04;1;1;2;197010;200630;29;397640
52;2020-06-04;1;2;3;231204;224885;39;456089
52;2020-06-04;1;0;1;243874;243418;49;487292
52;2020-06-04;1;0;1;244100;239116;59;483216
52;2020-06-04;0;2;2;241796;221345;69;463141
52;2020-06-04;2;0;2;177805;149903;79;327708
52;2020-06-04;1;3;4;119561;75822;89;195383
52;2020-06-04;2;1;3;42559;15260;90;57819
52;2020-06-04;9;10;19;1952321;1849476;0;3801797
53;2020-06-04;0;0;0;173813;182358;09;356171
53;2020-06-04;0;0;0;202720;214740;19;417460
53;2020-06-04;0;0;0;163116;173196;29;336312
53;2020-06-04;0;0;0;190526;187674;39;378200
53;2020-06-04;0;0;0;212098;212015;49;424113
53;2020-06-04;0;3;3;223699;219176;59;442875
53;2020-06-04;0;0;0;227435;209274;69;436709
53;2020-06-04;0;0;0;169992;140910;79;310902
53;2020-06-04;1;1;2;118117;69883;89;188000
53;2020-06-04;0;0;0;37370;12267;90;49637
53;2020-06-04;1;4;5;1718886;1621493;0;3340379
75;2020-06-04;0;0;0;293104;305291;09;598395
75;2020-06-04;0;1;1;337141;357785;19;694926
75;2020-06-04;1;0;1;295024;300618;29;595642
75;2020-06-04;0;1;1;347871;331233;39;679104
75;2020-06-04;0;0;0;384742;372771;49;757513
75;2020-06-04;0;2;2;413361;390880;59;804241
75;2020-06-04;1;1;2;425623;384060;69;809683
75;2020-06-04;1;2;3;325086;276298;79;601384
75;2020-06-04;0;0;0;213986;139308;89;353294
75;2020-06-04;0;0;0;77600;28200;90;105800
75;2020-06-04;3;7;10;3113538;2886444;0;5999982
76;2020-06-04;0;0;1;305956;318589;09;624545
76;2020-06-04;0;1;1;338942;356969;19;695911
76;2020-06-04;3;4;7;316210;319570;29;635780
76;2020-06-04;5;1;6;356758;337587;39;694345
76;2020-06-04;4;2;6;376541;363812;49;740353
76;2020-06-04;2;3;6;402608;383750;59;786358
76;2020-06-04;0;1;1;394889;358997;69;753886
76;2020-06-04;0;0;0;308664;263806;79;572470
76;2020-06-04;1;2;3;195838;129272;89;325110
76;2020-06-04;3;0;3;69372;26728;90;96100
76;2020-06-04;18;14;34;3065778;2859080;0;5924858
84;2020-06-04;0;0;0;459549;481088;09;940637
84;2020-06-04;0;0;0;487711;511905;19;999616
84;2020-06-04;0;1;1;443824;451094;29;894918
84;2020-06-04;3;1;4;512522;493262;39;1005784
84;2020-06-04;1;1;2;520248;515106;49;1035354
84;2020-06-04;3;4;7;529611;514848;59;1044459
84;2020-06-04;0;0;0;486720;439940;69;926660
84;2020-06-04;1;0;1;372151;315211;79;687362
84;2020-06-04;4;1;5;237198;150524;89;387722
84;2020-06-04;5;2;7;81185;28680;90;109865
84;2020-06-04;17;10;27;4130719;3901658;0;8032377
93;2020-06-04;1;0;2;268834;283093;09;551927
93;2020-06-04;1;0;1;280751;296087;19;576838
93;2020-06-04;4;5;9;254404;255552;29;509956
93;2020-06-04;5;22;27;310704;288398;39;599102
93;2020-06-04;8;15;24;325559;305827;49;631386
93;2020-06-04;1;10;11;353104;325389;59;678493
93;2020-06-04;1;4;6;336327;296459;69;632786
93;2020-06-04;0;2;2;279820;229699;79;509519
93;2020-06-04;2;0;2;171274;113716;89;284990
93;2020-06-04;5;0;5;58896;21758;90;80654
93;2020-06-04;28;58;90;2639673;2415978;0;5055651
94;2020-06-04;0;0;0;16311;17433;09;33744
94;2020-06-04;0;0;0;16679;18132;19;34811
94;2020-06-04;0;0;0;16782;16579;29;33361
94;2020-06-04;0;0;0;23044;20580;39;43624
94;2020-06-04;0;0;0;23065;22140;49;45205
94;2020-06-04;0;0;0;24549;23421;59;47970
94;2020-06-04;0;0;0;23212;21883;69;45095
94;2020-06-04;0;0;0;19544;17141;79;36685
94;2020-06-04;0;0;0;11227;8178;89;19405
94;2020-06-04;0;1;1;3332;1447;90;4779
94;2020-06-04;0;1;1;177745;166934;0;344679
01;2020-06-05;0;0;0;19979;20155;09;40134
01;2020-06-05;0;0;0;24994;25489;19;50483
01;2020-06-05;1;1;2;17868;16690;29;34558
01;2020-06-05;0;0;0;22328;14821;39;37149
01;2020-06-05;1;0;1;28652;20276;49;48928
01;2020-06-05;0;0;0;33264;27260;59;60524
01;2020-06-05;0;1;1;27135;23978;69;51113
01;2020-06-05;0;0;0;18401;14661;79;33062
01;2020-06-05;0;0;0;9633;6375;89;16008
01;2020-06-05;0;0;0;3410;1510;90;4920
01;2020-06-05;2;2;4;205664;171215;0;376879
02;2020-06-05;0;0;0;16881;17110;09;33991
02;2020-06-05;0;0;0;21410;21604;19;43014
02;2020-06-05;0;0;0;16017;15479;29;31496
02;2020-06-05;1;0;1;19825;14455;39;34280
02;2020-06-05;0;0;0;24719;18248;49;42967
02;2020-06-05;0;0;0;34361;28310;59;62671
02;2020-06-05;1;1;2;28061;24495;69;52556
02;2020-06-05;1;0;1;18231;15278;79;33509
02;2020-06-05;0;0;0;11090;7677;89;18767
02;2020-06-05;0;0;0;3992;1506;90;5498
02;2020-06-05;3;1;4;194587;164162;0;358749
03;2020-06-05;1;0;1;31123;30920;09;62043
03;2020-06-05;6;1;7;29370;29268;19;58638
03;2020-06-05;3;2;5;21458;18963;29;40421
03;2020-06-05;5;2;7;21276;18326;39;39602
03;2020-06-05;7;2;9;18164;16593;49;34757
03;2020-06-05;2;2;4;13469;13557;59;27026
03;2020-06-05;0;2;2;8776;8670;69;17446
03;2020-06-05;0;1;1;3777;3591;79;7368
03;2020-06-05;0;0;0;1649;1072;89;2721
03;2020-06-05;0;0;0;485;184;90;669
03;2020-06-05;24;12;36;149547;141144;0;290691
04;2020-06-05;0;0;0;60314;61377;09;121691
04;2020-06-05;1;0;1;66065;68387;19;134452
04;2020-06-05;0;0;0;51059;47156;29;98215
04;2020-06-05;0;0;0;58788;45780;39;104568
04;2020-06-05;0;0;0;61408;52207;49;113615
04;2020-06-05;0;0;0;64838;60759;59;125597
04;2020-06-05;0;0;0;47008;42843;69;89851
04;2020-06-05;0;0;0;25509;21184;79;46693
04;2020-06-05;0;0;0;13168;7647;89;20815
04;2020-06-05;0;0;0;3209;1253;90;4462
04;2020-06-05;1;0;1;451366;408593;0;859959
05;2020-06-05;0;0;0;362.366008612902;341.338819562748;09;703.704828175651
05;2020-06-05;0;0;0;353.376145114279;370.349735405642;19;723.725880519921
05;2020-06-05;0;0;0;218.593559489256;256.539602589476;29;475.133162078732
05;2020-06-05;1;0;1;404.225408693299;360.321910454353;39;764.547319147651
05;2020-06-05;0;0;0;520.067953604221;497.108383964256;49;1017.17633756848
05;2020-06-05;0;0;0;468.146063921917;510.087601910415;59;978.233665832332
05;2020-06-05;0;0;0;340.368470050554;334.366842191253;69;674.735312241807
05;2020-06-05;0;0;0;212.598666888387;192.597753227106;79;405.196420115493
05;2020-06-05;0;0;0;148.727797095705;61.8681715431829;89;210.595968638888
05;2020-06-05;0;0;0;32.9601271090696;10.9909785719784;90;43.9511056810479
05;2020-06-05;1;0;1;3061.43020057959;2935.56979942041;0;5997
06;2020-06-05;1;0;1;42583;42380;09;84963
06;2020-06-05;1;1;2;33369;31925;19;65294
06;2020-06-05;3;1;4;21571;15080;29;36651
06;2020-06-05;1;3;4;21550;16147;39;37697
06;2020-06-05;1;2;3;14193;13939;49;28132
06;2020-06-05;2;0;2;7171;7597;59;14768
06;2020-06-05;2;0;2;3629;4117;69;7746
06;2020-06-05;0;0;0;1577;1457;79;3034
06;2020-06-05;0;1;1;531;474;89;1005
06;2020-06-05;0;0;0;88;93;90;181
06;2020-06-05;11;8;19;146262;133209;0;279471
07;2020-06-05;0;0;0;485;549;09;1034
07;2020-06-05;0;0;0;403;432;19;835
07;2020-06-05;0;0;0;764;841;29;1605
07;2020-06-05;0;0;0;824;928;39;1752
07;2020-06-05;0;0;0;788;1020;49;1808
07;2020-06-05;0;0;0;678;870;59;1548
07;2020-06-05;0;0;0;360;382;69;742
07;2020-06-05;0;0;0;231;190;79;421
07;2020-06-05;0;0;0;114;67;89;181
07;2020-06-05;0;0;0;24;11;90;35
07;2020-06-05;0;0;0;4671;5290;0;9961
08;2020-06-05;0;0;0;2715.22592983026;2997.75551488675;09;5712.98144471701
08;2020-06-05;0;0;0;2778.51901080978;3160.9156459093;19;5939.43465671908
08;2020-06-05;0;0;0;2080.8882988764;1718.16634315323;29;3799.05464202964
08;2020-06-05;0;0;0;2701.8582062647;1896.52641413317;39;4598.38462039786
08;2020-06-05;0;0;0;3151.45861023308;2460.52498233809;49;5611.98359257117
08;2020-06-05;0;0;0;2620.29868333099;2422.23566154656;59;5042.53434487755
08;2020-06-05;0;0;0;1621.44173420671;1438.58325779464;69;3060.02499200135
08;2020-06-05;0;0;0;626.575909335673;526.358467843651;79;1152.93437717932
08;2020-06-05;0;0;0;205.018522985054;140.993639349697;89;346.012162334751
08;2020-06-05;0;0;0;50.0325684687745;20.62259870351;90;70.6551671722846
08;2020-06-05;0;0;0;18551.3174743414;16782.6825256586;0;35334
11;2020-06-05;1;4;5;783071;811785;09;1594856
11;2020-06-05;2;5;7;761456;784653;19;1546109
11;2020-06-05;7;12;21;850145;801772;29;1651917
11;2020-06-05;14;14;30;914360;843488;39;1757848
11;2020-06-05;10;9;19;845609;826202;49;1671811
11;2020-06-05;12;9;21;793566;745070;59;1538636
11;2020-06-05;9;7;16;628649;549192;69;1177841
11;2020-06-05;9;5;14;434606;358356;79;792962
11;2020-06-05;8;2;10;261425;162933;89;424358
11;2020-06-05;7;5;12;89253;32619;90;121872
11;2020-06-05;79;72;156;6362140;5916070;0;12278210
24;2020-06-05;0;0;0;139720;144686;09;284406
24;2020-06-05;0;0;0;152979;161185;19;314164
24;2020-06-05;0;1;1;122237;126536;29;248773
24;2020-06-05;0;0;0;150359;142009;39;292368
24;2020-06-05;0;0;0;161829;158758;49;320587
24;2020-06-05;1;1;2;172552;168011;59;340563
24;2020-06-05;1;1;2;172509;158177;69;330686
24;2020-06-05;2;0;2;129428;110593;79;240021
24;2020-06-05;2;1;3;87342;56882;89;144224
24;2020-06-05;1;0;1;31210;12071;90;43281
24;2020-06-05;7;4;11;1320165;1238908;0;2559073
27;2020-06-05;0;0;0;143373;149679;09;293052
27;2020-06-05;0;1;1;160962;173003;19;333965
27;2020-06-05;0;2;2;133746;142254;29;276000
27;2020-06-05;0;0;0;160004;155407;39;315411
27;2020-06-05;0;0;0;172333;169564;49;341897
27;2020-06-05;1;2;3;189979;183788;59;373767
27;2020-06-05;0;1;1;192591;178206;69;370797
27;2020-06-05;0;1;1;146876;127546;79;274422
27;2020-06-05;2;2;4;96896;61575;89;158471
27;2020-06-05;0;0;0;33148;12109;90;45257
27;2020-06-05;3;9;12;1429908;1353131;0;2783039
28;2020-06-05;0;0;0;180735;186856;09;367591
28;2020-06-05;0;0;0;200125;213621;19;413746
28;2020-06-05;0;2;2;168922;173007;29;341929
28;2020-06-05;0;1;1;196628;188487;39;385115
28;2020-06-05;0;1;1;205396;201699;49;407095
28;2020-06-05;0;0;0;222002;213866;59;435868
28;2020-06-05;0;0;0;224688;203758;69;428446
28;2020-06-05;0;1;1;163192;135543;79;298735
28;2020-06-05;0;0;0;109691;65377;89;175068
28;2020-06-05;0;0;0;37222;12685;90;49907
28;2020-06-05;0;5;5;1708601;1594899;0;3303500
32;2020-06-05;3;2;5;358062;373689;09;731751
32;2020-06-05;3;4;7;387045;406742;19;793787
32;2020-06-05;4;2;6;342304;348587;29;690891
32;2020-06-05;9;4;13;382485;369972;39;752457
32;2020-06-05;9;3;12;382510;376716;49;759226
32;2020-06-05;1;6;7;386937;376527;59;763464
32;2020-06-05;7;4;12;371211;330938;69;702149
32;2020-06-05;3;2;6;250542;201459;79;452001
32;2020-06-05;5;2;7;163399;89786;89;253185
32;2020-06-05;8;3;11;48384;15367;90;63751
32;2020-06-05;52;32;86;3072879;2889783;0;5962662
44;2020-06-05;0;1;1;291525;306839;09;598364
44;2020-06-05;3;5;8;320255;339504;19;659759
44;2020-06-05;6;3;9;302020;314428;29;616448
44;2020-06-05;4;3;7;342222;333292;39;675514
44;2020-06-05;4;1;5;349727;344491;49;694218
44;2020-06-05;3;1;5;381371;373239;59;754610
44;2020-06-05;4;4;8;367165;335850;69;703015
44;2020-06-05;4;5;9;250387;215436;79;465823
44;2020-06-05;4;6;10;170825;105192;89;276017
44;2020-06-05;7;0;7;51248;16731;90;67979
44;2020-06-05;39;29;69;2826745;2685002;0;5511747
52;2020-06-05;0;3;3;213594;223900;09;437494
52;2020-06-05;1;10;11;240818;255197;19;496015
52;2020-06-05;3;0;3;197010;200630;29;397640
52;2020-06-05;0;6;6;231204;224885;39;456089
52;2020-06-05;4;2;6;243874;243418;49;487292
52;2020-06-05;7;3;11;244100;239116;59;483216
52;2020-06-05;2;0;2;241796;221345;69;463141
52;2020-06-05;0;0;0;177805;149903;79;327708
52;2020-06-05;2;0;2;119561;75822;89;195383
52;2020-06-05;0;0;0;42559;15260;90;57819
52;2020-06-05;19;24;44;1952321;1849476;0;3801797
53;2020-06-05;0;0;0;173813;182358;09;356171
53;2020-06-05;1;0;1;202720;214740;19;417460
53;2020-06-05;0;2;2;163116;173196;29;336312
53;2020-06-05;0;0;0;190526;187674;39;378200
53;2020-06-05;0;1;1;212098;212015;49;424113
53;2020-06-05;0;1;1;223699;219176;59;442875
53;2020-06-05;0;0;0;227435;209274;69;436709
53;2020-06-05;0;0;0;169992;140910;79;310902
53;2020-06-05;1;0;1;118117;69883;89;188000
53;2020-06-05;0;0;0;37370;12267;90;49637
53;2020-06-05;2;4;6;1718886;1621493;0;3340379
75;2020-06-05;0;0;0;293104;305291;09;598395
75;2020-06-05;1;0;1;337141;357785;19;694926
75;2020-06-05;0;1;1;295024;300618;29;595642
75;2020-06-05;0;0;0;347871;331233;39;679104
75;2020-06-05;1;0;1;384742;372771;49;757513
75;2020-06-05;0;0;0;413361;390880;59;804241
75;2020-06-05;2;0;2;425623;384060;69;809683
75;2020-06-05;1;0;1;325086;276298;79;601384
75;2020-06-05;1;0;1;213986;139308;89;353294
75;2020-06-05;1;0;1;77600;28200;90;105800
75;2020-06-05;7;1;8;3113538;2886444;0;5999982
76;2020-06-05;0;0;0;305956;318589;09;624545
76;2020-06-05;0;0;0;338942;356969;19;695911
76;2020-06-05;0;4;4;316210;319570;29;635780
76;2020-06-05;1;4;5;356758;337587;39;694345
76;2020-06-05;1;1;2;376541;363812;49;740353
76;2020-06-05;1;0;1;402608;383750;59;786358
76;2020-06-05;0;0;0;394889;358997;69;753886
76;2020-06-05;1;1;2;308664;263806;79;572470
76;2020-06-05;3;0;3;195838;129272;89;325110
76;2020-06-05;1;0;1;69372;26728;90;96100
76;2020-06-05;8;10;18;3065778;2859080;0;5924858
84;2020-06-05;0;0;0;459549;481088;09;940637
84;2020-06-05;0;3;3;487711;511905;19;999616
84;2020-06-05;2;1;3;443824;451094;29;894918
84;2020-06-05;1;2;3;512522;493262;39;1005784
84;2020-06-05;3;1;4;520248;515106;49;1035354
84;2020-06-05;1;2;3;529611;514848;59;1044459
84;2020-06-05;2;0;2;486720;439940;69;926660
84;2020-06-05;2;1;3;372151;315211;79;687362
84;2020-06-05;2;3;5;237198;150524;89;387722
84;2020-06-05;0;0;0;81185;28680;90;109865
84;2020-06-05;13;13;27;4130719;3901658;0;8032377
93;2020-06-05;0;0;0;268834;283093;09;551927
93;2020-06-05;0;1;1;280751;296087;19;576838
93;2020-06-05;2;3;6;254404;255552;29;509956
93;2020-06-05;4;2;6;310704;288398;39;599102
93;2020-06-05;1;6;7;325559;305827;49;631386
93;2020-06-05;6;2;8;353104;325389;59;678493
93;2020-06-05;1;6;7;336327;296459;69;632786
93;2020-06-05;0;3;3;279820;229699;79;509519
93;2020-06-05;4;4;8;171274;113716;89;284990
93;2020-06-05;1;0;1;58896;21758;90;80654
93;2020-06-05;19;27;47;2639673;2415978;0;5055651
94;2020-06-05;0;0;0;16311;17433;09;33744
94;2020-06-05;0;0;0;16679;18132;19;34811
94;2020-06-05;0;0;0;16782;16579;29;33361
94;2020-06-05;0;1;1;23044;20580;39;43624
94;2020-06-05;0;0;0;23065;22140;49;45205
94;2020-06-05;0;0;0;24549;23421;59;47970
94;2020-06-05;0;0;0;23212;21883;69;45095
94;2020-06-05;0;0;0;19544;17141;79;36685
94;2020-06-05;1;0;1;11227;8178;89;19405
94;2020-06-05;0;0;0;3332;1447;90;4779
94;2020-06-05;1;1;2;177745;166934;0;344679
01;2020-06-06;0;0;0;19979;20155;09;40134
01;2020-06-06;0;0;0;24994;25489;19;50483
01;2020-06-06;0;0;0;17868;16690;29;34558
01;2020-06-06;0;0;0;22328;14821;39;37149
01;2020-06-06;0;0;0;28652;20276;49;48928
01;2020-06-06;1;0;1;33264;27260;59;60524
01;2020-06-06;0;0;0;27135;23978;69;51113
01;2020-06-06;0;0;0;18401;14661;79;33062
01;2020-06-06;0;0;0;9633;6375;89;16008
01;2020-06-06;0;0;0;3410;1510;90;4920
01;2020-06-06;1;0;1;205664;171215;0;376879
02;2020-06-06;0;0;0;16881;17110;09;33991
02;2020-06-06;0;0;0;21410;21604;19;43014
02;2020-06-06;0;0;0;16017;15479;29;31496
02;2020-06-06;0;0;0;19825;14455;39;34280
02;2020-06-06;0;0;0;24719;18248;49;42967
02;2020-06-06;0;0;0;34361;28310;59;62671
02;2020-06-06;0;0;0;28061;24495;69;52556
02;2020-06-06;0;0;0;18231;15278;79;33509
02;2020-06-06;0;0;0;11090;7677;89;18767
02;2020-06-06;0;0;0;3992;1506;90;5498
02;2020-06-06;0;0;0;194587;164162;0;358749
03;2020-06-06;0;2;2;31123;30920;09;62043
03;2020-06-06;0;1;2;29370;29268;19;58638
03;2020-06-06;3;2;5;21458;18963;29;40421
03;2020-06-06;7;6;13;21276;18326;39;39602
03;2020-06-06;3;5;8;18164;16593;49;34757
03;2020-06-06;2;3;5;13469;13557;59;27026
03;2020-06-06;1;5;6;8776;8670;69;17446
03;2020-06-06;0;1;1;3777;3591;79;7368
03;2020-06-06;0;1;1;1649;1072;89;2721
03;2020-06-06;0;0;0;485;184;90;669
03;2020-06-06;16;26;43;149547;141144;0;290691
04;2020-06-06;0;0;0;60314;61377;09;121691
04;2020-06-06;0;0;0;66065;68387;19;134452
04;2020-06-06;0;0;0;51059;47156;29;98215
04;2020-06-06;0;0;0;58788;45780;39;104568
04;2020-06-06;0;0;0;61408;52207;49;113615
04;2020-06-06;0;0;0;64838;60759;59;125597
04;2020-06-06;0;0;0;47008;42843;69;89851
04;2020-06-06;0;0;0;25509;21184;79;46693
04;2020-06-06;0;0;0;13168;7647;89;20815
04;2020-06-06;0;0;0;3209;1253;90;4462
04;2020-06-06;0;0;0;451366;408593;0;859959
05;2020-06-06;0;0;0;362.366008612902;341.338819562748;09;703.704828175651
05;2020-06-06;0;0;0;353.376145114279;370.349735405642;19;723.725880519921
05;2020-06-06;0;0;0;218.593559489256;256.539602589476;29;475.133162078732
05;2020-06-06;0;0;0;404.225408693299;360.321910454353;39;764.547319147651
05;2020-06-06;0;0;0;520.067953604221;497.108383964256;49;1017.17633756848
05;2020-06-06;0;0;0;468.146063921917;510.087601910415;59;978.233665832332
05;2020-06-06;0;0;0;340.368470050554;334.366842191253;69;674.735312241807
05;2020-06-06;0;0;0;212.598666888387;192.597753227106;79;405.196420115493
05;2020-06-06;0;0;0;148.727797095705;61.8681715431829;89;210.595968638888
05;2020-06-06;0;0;0;32.9601271090696;10.9909785719784;90;43.9511056810479
05;2020-06-06;0;0;0;3061.43020057959;2935.56979942041;0;5997
06;2020-06-06;0;0;0;42583;42380;09;84963
06;2020-06-06;1;2;3;33369;31925;19;65294
06;2020-06-06;2;1;3;21571;15080;29;36651
06;2020-06-06;2;1;3;21550;16147;39;37697
06;2020-06-06;1;0;1;14193;13939;49;28132
06;2020-06-06;1;0;1;7171;7597;59;14768
06;2020-06-06;0;0;0;3629;4117;69;7746
06;2020-06-06;1;0;1;1577;1457;79;3034
06;2020-06-06;0;0;0;531;474;89;1005
06;2020-06-06;0;0;0;88;93;90;181
06;2020-06-06;8;4;12;146262;133209;0;279471
07;2020-06-06;0;0;0;485;549;09;1034
07;2020-06-06;0;0;0;403;432;19;835
07;2020-06-06;0;0;0;764;841;29;1605
07;2020-06-06;0;0;0;824;928;39;1752
07;2020-06-06;0;0;0;788;1020;49;1808
07;2020-06-06;0;0;0;678;870;59;1548
07;2020-06-06;0;0;0;360;382;69;742
07;2020-06-06;0;0;0;231;190;79;421
07;2020-06-06;0;0;0;114;67;89;181
07;2020-06-06;0;0;0;24;11;90;35
07;2020-06-06;0;0;0;4671;5290;0;9961
08;2020-06-06;0;0;0;2715.22592983026;2997.75551488675;09;5712.98144471701
08;2020-06-06;0;0;0;2778.51901080978;3160.9156459093;19;5939.43465671908
08;2020-06-06;0;0;0;2080.8882988764;1718.16634315323;29;3799.05464202964
08;2020-06-06;0;0;0;2701.8582062647;1896.52641413317;39;4598.38462039786
08;2020-06-06;0;0;0;3151.45861023308;2460.52498233809;49;5611.98359257117
08;2020-06-06;0;0;0;2620.29868333099;2422.23566154656;59;5042.53434487755
08;2020-06-06;0;0;0;1621.44173420671;1438.58325779464;69;3060.02499200135
08;2020-06-06;0;0;0;626.575909335673;526.358467843651;79;1152.93437717932
08;2020-06-06;0;0;0;205.018522985054;140.993639349697;89;346.012162334751
08;2020-06-06;0;0;0;50.0325684687745;20.62259870351;90;70.6551671722846
08;2020-06-06;0;0;0;18551.3174743414;16782.6825256586;0;35334
11;2020-06-06;1;1;2;783071;811785;09;1594856
11;2020-06-06;1;1;2;761456;784653;19;1546109
11;2020-06-06;2;4;6;850145;801772;29;1651917
11;2020-06-06;7;6;13;914360;843488;39;1757848
11;2020-06-06;3;6;9;845609;826202;49;1671811
11;2020-06-06;6;8;14;793566;745070;59;1538636
11;2020-06-06;4;6;10;628649;549192;69;1177841
11;2020-06-06;2;4;6;434606;358356;79;792962
11;2020-06-06;3;1;4;261425;162933;89;424358
11;2020-06-06;3;0;3;89253;32619;90;121872
11;2020-06-06;32;38;70;6362140;5916070;0;12278210
24;2020-06-06;0;0;0;139720;144686;09;284406
24;2020-06-06;1;0;1;152979;161185;19;314164
24;2020-06-06;1;0;1;122237;126536;29;248773
24;2020-06-06;0;0;0;150359;142009;39;292368
24;2020-06-06;0;0;0;161829;158758;49;320587
24;2020-06-06;0;0;0;172552;168011;59;340563
24;2020-06-06;0;0;0;172509;158177;69;330686
24;2020-06-06;0;0;0;129428;110593;79;240021
24;2020-06-06;0;0;0;87342;56882;89;144224
24;2020-06-06;0;0;0;31210;12071;90;43281
24;2020-06-06;2;0;2;1320165;1238908;0;2559073
27;2020-06-06;0;0;0;143373;149679;09;293052
27;2020-06-06;0;1;1;160962;173003;19;333965
27;2020-06-06;1;0;1;133746;142254;29;276000
27;2020-06-06;1;0;1;160004;155407;39;315411
27;2020-06-06;0;0;0;172333;169564;49;341897
27;2020-06-06;1;0;1;189979;183788;59;373767
27;2020-06-06;0;0;0;192591;178206;69;370797
27;2020-06-06;1;0;1;146876;127546;79;274422
27;2020-06-06;1;2;3;96896;61575;89;158471
27;2020-06-06;0;0;0;33148;12109;90;45257
27;2020-06-06;5;3;8;1429908;1353131;0;2783039
28;2020-06-06;1;1;2;180735;186856;09;367591
28;2020-06-06;0;1;1;200125;213621;19;413746
28;2020-06-06;0;2;2;168922;173007;29;341929
28;2020-06-06;2;0;2;196628;188487;39;385115
28;2020-06-06;0;0;0;205396;201699;49;407095
28;2020-06-06;0;0;0;222002;213866;59;435868
28;2020-06-06;0;0;0;224688;203758;69;428446
28;2020-06-06;0;1;1;163192;135543;79;298735
28;2020-06-06;0;0;0;109691;65377;89;175068
28;2020-06-06;0;0;0;37222;12685;90;49907
28;2020-06-06;3;5;8;1708601;1594899;0;3303500
32;2020-06-06;0;2;2;358062;373689;09;731751
32;2020-06-06;0;0;0;387045;406742;19;793787
32;2020-06-06;4;5;9;342304;348587;29;690891
32;2020-06-06;2;1;3;382485;369972;39;752457
32;2020-06-06;3;3;6;382510;376716;49;759226
32;2020-06-06;2;1;3;386937;376527;59;763464
32;2020-06-06;2;1;3;371211;330938;69;702149
32;2020-06-06;2;1;3;250542;201459;79;452001
32;2020-06-06;7;3;10;163399;89786;89;253185
32;2020-06-06;5;2;7;48384;15367;90;63751
32;2020-06-06;27;19;47;3072879;2889783;0;5962662
44;2020-06-06;0;2;2;291525;306839;09;598364
44;2020-06-06;1;0;1;320255;339504;19;659759
44;2020-06-06;2;2;4;302020;314428;29;616448
44;2020-06-06;5;0;5;342222;333292;39;675514
44;2020-06-06;1;2;3;349727;344491;49;694218
44;2020-06-06;1;1;2;381371;373239;59;754610
44;2020-06-06;1;1;3;367165;335850;69;703015
44;2020-06-06;1;3;4;250387;215436;79;465823
44;2020-06-06;1;0;1;170825;105192;89;276017
44;2020-06-06;1;0;1;51248;16731;90;67979
44;2020-06-06;14;11;26;2826745;2685002;0;5511747
52;2020-06-06;0;2;2;213594;223900;09;437494
52;2020-06-06;0;0;0;240818;255197;19;496015
52;2020-06-06;1;1;2;197010;200630;29;397640
52;2020-06-06;0;1;1;231204;224885;39;456089
52;2020-06-06;1;0;1;243874;243418;49;487292
52;2020-06-06;0;1;1;244100;239116;59;483216
52;2020-06-06;0;1;1;241796;221345;69;463141
52;2020-06-06;3;0;3;177805;149903;79;327708
52;2020-06-06;1;0;1;119561;75822;89;195383
52;2020-06-06;0;0;0;42559;15260;90;57819
52;2020-06-06;6;6;12;1952321;1849476;0;3801797
53;2020-06-06;0;1;1;173813;182358;09;356171
53;2020-06-06;0;0;0;202720;214740;19;417460
53;2020-06-06;1;0;1;163116;173196;29;336312
53;2020-06-06;0;1;1;190526;187674;39;378200
53;2020-06-06;0;0;0;212098;212015;49;424113
53;2020-06-06;1;0;1;223699;219176;59;442875
53;2020-06-06;0;0;0;227435;209274;69;436709
53;2020-06-06;0;0;0;169992;140910;79;310902
53;2020-06-06;0;0;0;118117;69883;89;188000
53;2020-06-06;0;0;0;37370;12267;90;49637
53;2020-06-06;2;2;4;1718886;1621493;0;3340379
75;2020-06-06;1;0;1;293104;305291;09;598395
75;2020-06-06;1;1;2;337141;357785;19;694926
75;2020-06-06;1;0;1;295024;300618;29;595642
75;2020-06-06;0;0;0;347871;331233;39;679104
75;2020-06-06;1;0;1;384742;372771;49;757513
75;2020-06-06;0;1;1;413361;390880;59;804241
75;2020-06-06;0;1;1;425623;384060;69;809683
75;2020-06-06;0;0;0;325086;276298;79;601384
75;2020-06-06;0;0;0;213986;139308;89;353294
75;2020-06-06;0;0;0;77600;28200;90;105800
75;2020-06-06;4;3;7;3113538;2886444;0;5999982
76;2020-06-06;0;0;0;305956;318589;09;624545
76;2020-06-06;1;0;1;338942;356969;19;695911
76;2020-06-06;0;0;0;316210;319570;29;635780
76;2020-06-06;0;0;0;356758;337587;39;694345
76;2020-06-06;2;3;5;376541;363812;49;740353
76;2020-06-06;0;1;1;402608;383750;59;786358
76;2020-06-06;1;0;1;394889;358997;69;753886
76;2020-06-06;0;1;1;308664;263806;79;572470
76;2020-06-06;0;0;0;195838;129272;89;325110
76;2020-06-06;0;0;0;69372;26728;90;96100
76;2020-06-06;4;5;9;3065778;2859080;0;5924858
84;2020-06-06;0;0;0;459549;481088;09;940637
84;2020-06-06;2;0;2;487711;511905;19;999616
84;2020-06-06;2;1;3;443824;451094;29;894918
84;2020-06-06;2;1;3;512522;493262;39;1005784
84;2020-06-06;3;1;4;520248;515106;49;1035354
84;2020-06-06;0;0;0;529611;514848;59;1044459
84;2020-06-06;1;1;2;486720;439940;69;926660
84;2020-06-06;2;1;3;372151;315211;79;687362
84;2020-06-06;1;1;2;237198;150524;89;387722
84;2020-06-06;0;0;0;81185;28680;90;109865
84;2020-06-06;13;7;20;4130719;3901658;0;8032377
93;2020-06-06;0;0;0;268834;283093;09;551927
93;2020-06-06;2;0;2;280751;296087;19;576838
93;2020-06-06;0;1;1;254404;255552;29;509956
93;2020-06-06;1;4;5;310704;288398;39;599102
93;2020-06-06;3;3;6;325559;305827;49;631386
93;2020-06-06;1;1;2;353104;325389;59;678493
93;2020-06-06;2;0;2;336327;296459;69;632786
93;2020-06-06;0;1;1;279820;229699;79;509519
93;2020-06-06;0;1;1;171274;113716;89;284990
93;2020-06-06;1;0;1;58896;21758;90;80654
93;2020-06-06;10;11;21;2639673;2415978;0;5055651
94;2020-06-06;0;0;0;16311;17433;09;33744
94;2020-06-06;0;0;0;16679;18132;19;34811
94;2020-06-06;0;0;0;16782;16579;29;33361
94;2020-06-06;0;0;0;23044;20580;39;43624
94;2020-06-06;0;0;0;23065;22140;49;45205
94;2020-06-06;0;0;0;24549;23421;59;47970
94;2020-06-06;0;0;0;23212;21883;69;45095
94;2020-06-06;0;0;0;19544;17141;79;36685
94;2020-06-06;0;0;0;11227;8178;89;19405
94;2020-06-06;1;0;1;3332;1447;90;4779
94;2020-06-06;1;0;1;177745;166934;0;344679
01;2020-06-07;0;0;0;19979;20155;09;40134
01;2020-06-07;0;0;0;24994;25489;19;50483
01;2020-06-07;0;0;0;17868;16690;29;34558
01;2020-06-07;0;0;0;22328;14821;39;37149
01;2020-06-07;0;0;0;28652;20276;49;48928
01;2020-06-07;0;0;0;33264;27260;59;60524
01;2020-06-07;0;0;0;27135;23978;69;51113
01;2020-06-07;0;0;0;18401;14661;79;33062
01;2020-06-07;0;0;0;9633;6375;89;16008
01;2020-06-07;0;0;0;3410;1510;90;4920
01;2020-06-07;0;0;0;205664;171215;0;376879
02;2020-06-07;0;0;0;16881;17110;09;33991
02;2020-06-07;0;0;0;21410;21604;19;43014
02;2020-06-07;0;0;0;16017;15479;29;31496
02;2020-06-07;0;0;0;19825;14455;39;34280
02;2020-06-07;0;0;0;24719;18248;49;42967
02;2020-06-07;0;0;0;34361;28310;59;62671
02;2020-06-07;0;0;0;28061;24495;69;52556
02;2020-06-07;0;0;0;18231;15278;79;33509
02;2020-06-07;0;0;0;11090;7677;89;18767
02;2020-06-07;0;0;0;3992;1506;90;5498
02;2020-06-07;0;0;0;194587;164162;0;358749
03;2020-06-07;2;2;4;31123;30920;09;62043
03;2020-06-07;4;7;11;29370;29268;19;58638
03;2020-06-07;1;0;2;21458;18963;29;40421
03;2020-06-07;5;3;8;21276;18326;39;39602
03;2020-06-07;3;2;6;18164;16593;49;34757
03;2020-06-07;1;3;4;13469;13557;59;27026
03;2020-06-07;0;2;2;8776;8670;69;17446
03;2020-06-07;1;0;1;3777;3591;79;7368
03;2020-06-07;0;1;1;1649;1072;89;2721
03;2020-06-07;0;0;0;485;184;90;669
03;2020-06-07;17;20;39;149547;141144;0;290691
04;2020-06-07;0;0;0;60314;61377;09;121691
04;2020-06-07;0;0;0;66065;68387;19;134452
04;2020-06-07;0;0;0;51059;47156;29;98215
04;2020-06-07;0;0;0;58788;45780;39;104568
04;2020-06-07;1;0;1;61408;52207;49;113615
04;2020-06-07;0;0;0;64838;60759;59;125597
04;2020-06-07;0;0;0;47008;42843;69;89851
04;2020-06-07;0;0;0;25509;21184;79;46693
04;2020-06-07;0;0;0;13168;7647;89;20815
04;2020-06-07;0;0;0;3209;1253;90;4462
04;2020-06-07;1;0;1;451366;408593;0;859959
05;2020-06-07;0;0;0;362.366008612902;341.338819562748;09;703.704828175651
05;2020-06-07;0;0;0;353.376145114279;370.349735405642;19;723.725880519921
05;2020-06-07;0;0;0;218.593559489256;256.539602589476;29;475.133162078732
05;2020-06-07;0;0;0;404.225408693299;360.321910454353;39;764.547319147651
05;2020-06-07;0;0;0;520.067953604221;497.108383964256;49;1017.17633756848
05;2020-06-07;0;0;0;468.146063921917;510.087601910415;59;978.233665832332
05;2020-06-07;0;0;0;340.368470050554;334.366842191253;69;674.735312241807
05;2020-06-07;0;0;0;212.598666888387;192.597753227106;79;405.196420115493
05;2020-06-07;0;0;0;148.727797095705;61.8681715431829;89;210.595968638888
05;2020-06-07;0;0;0;32.9601271090696;10.9909785719784;90;43.9511056810479
05;2020-06-07;0;0;0;3061.43020057959;2935.56979942041;0;5997
06;2020-06-07;0;0;0;42583;42380;09;84963
06;2020-06-07;0;0;0;33369;31925;19;65294
06;2020-06-07;0;0;0;21571;15080;29;36651
06;2020-06-07;1;0;1;21550;16147;39;37697
06;2020-06-07;0;0;0;14193;13939;49;28132
06;2020-06-07;2;0;2;7171;7597;59;14768
06;2020-06-07;0;0;0;3629;4117;69;7746
06;2020-06-07;0;1;1;1577;1457;79;3034
06;2020-06-07;0;0;0;531;474;89;1005
06;2020-06-07;0;0;0;88;93;90;181
06;2020-06-07;3;1;4;146262;133209;0;279471
07;2020-06-07;0;0;0;485;549;09;1034
07;2020-06-07;0;0;0;403;432;19;835
07;2020-06-07;0;0;0;764;841;29;1605
07;2020-06-07;0;0;0;824;928;39;1752
07;2020-06-07;0;0;0;788;1020;49;1808
07;2020-06-07;0;0;0;678;870;59;1548
07;2020-06-07;0;0;0;360;382;69;742
07;2020-06-07;0;0;0;231;190;79;421
07;2020-06-07;0;0;0;114;67;89;181
07;2020-06-07;0;0;0;24;11;90;35
07;2020-06-07;0;0;0;4671;5290;0;9961
08;2020-06-07;0;0;0;2715.22592983026;2997.75551488675;09;5712.98144471701
08;2020-06-07;0;0;0;2778.51901080978;3160.9156459093;19;5939.43465671908
08;2020-06-07;0;0;0;2080.8882988764;1718.16634315323;29;3799.05464202964
08;2020-06-07;0;0;0;2701.8582062647;1896.52641413317;39;4598.38462039786
08;2020-06-07;0;0;0;3151.45861023308;2460.52498233809;49;5611.98359257117
08;2020-06-07;0;0;0;2620.29868333099;2422.23566154656;59;5042.53434487755
08;2020-06-07;0;0;0;1621.44173420671;1438.58325779464;69;3060.02499200135
08;2020-06-07;0;0;0;626.575909335673;526.358467843651;79;1152.93437717932
08;2020-06-07;0;0;0;205.018522985054;140.993639349697;89;346.012162334751
08;2020-06-07;0;0;0;50.0325684687745;20.62259870351;90;70.6551671722846
08;2020-06-07;0;0;0;18551.3174743414;16782.6825256586;0;35334
11;2020-06-07;1;1;2;783071;811785;09;1594856
11;2020-06-07;1;2;3;761456;784653;19;1546109
11;2020-06-07;2;1;3;850145;801772;29;1651917
11;2020-06-07;0;2;2;914360;843488;39;1757848
11;2020-06-07;3;0;3;845609;826202;49;1671811
11;2020-06-07;0;2;2;793566;745070;59;1538636
11;2020-06-07;3;3;6;628649;549192;69;1177841
11;2020-06-07;0;0;0;434606;358356;79;792962
11;2020-06-07;1;1;2;261425;162933;89;424358
11;2020-06-07;3;1;4;89253;32619;90;121872
11;2020-06-07;14;13;27;6362140;5916070;0;12278210
24;2020-06-07;0;0;0;139720;144686;09;284406
24;2020-06-07;0;0;0;152979;161185;19;314164
24;2020-06-07;0;0;0;122237;126536;29;248773
24;2020-06-07;0;0;0;150359;142009;39;292368
24;2020-06-07;0;0;0;161829;158758;49;320587
24;2020-06-07;0;0;0;172552;168011;59;340563
24;2020-06-07;0;0;0;172509;158177;69;330686
24;2020-06-07;0;0;0;129428;110593;79;240021
24;2020-06-07;0;0;0;87342;56882;89;144224
24;2020-06-07;0;0;0;31210;12071;90;43281
24;2020-06-07;0;0;0;1320165;1238908;0;2559073
27;2020-06-07;0;0;0;143373;149679;09;293052
27;2020-06-07;0;0;0;160962;173003;19;333965
27;2020-06-07;0;0;0;133746;142254;29;276000
27;2020-06-07;0;0;0;160004;155407;39;315411
27;2020-06-07;0;0;0;172333;169564;49;341897
27;2020-06-07;0;0;0;189979;183788;59;373767
27;2020-06-07;0;0;0;192591;178206;69;370797
27;2020-06-07;0;0;0;146876;127546;79;274422
27;2020-06-07;0;0;0;96896;61575;89;158471
27;2020-06-07;0;0;0;33148;12109;90;45257
27;2020-06-07;0;0;0;1429908;1353131;0;2783039
28;2020-06-07;0;0;0;180735;186856;09;367591
28;2020-06-07;0;0;0;200125;213621;19;413746
28;2020-06-07;0;0;0;168922;173007;29;341929
28;2020-06-07;0;0;0;196628;188487;39;385115
28;2020-06-07;0;0;0;205396;201699;49;407095
28;2020-06-07;0;0;0;222002;213866;59;435868
28;2020-06-07;0;0;0;224688;203758;69;428446
28;2020-06-07;0;1;1;163192;135543;79;298735
28;2020-06-07;0;1;1;109691;65377;89;175068
28;2020-06-07;0;0;0;37222;12685;90;49907
28;2020-06-07;0;2;2;1708601;1594899;0;3303500
32;2020-06-07;0;0;0;358062;373689;09;731751
32;2020-06-07;0;1;1;387045;406742;19;793787
32;2020-06-07;1;0;1;342304;348587;29;690891
32;2020-06-07;0;0;0;382485;369972;39;752457
32;2020-06-07;1;1;2;382510;376716;49;759226
32;2020-06-07;1;1;2;386937;376527;59;763464
32;2020-06-07;0;2;2;371211;330938;69;702149
32;2020-06-07;0;1;1;250542;201459;79;452001
32;2020-06-07;2;0;2;163399;89786;89;253185
32;2020-06-07;1;2;3;48384;15367;90;63751
32;2020-06-07;6;8;14;3072879;2889783;0;5962662
44;2020-06-07;0;0;0;291525;306839;09;598364
44;2020-06-07;0;0;0;320255;339504;19;659759
44;2020-06-07;0;2;2;302020;314428;29;616448
44;2020-06-07;1;2;3;342222;333292;39;675514
44;2020-06-07;2;0;2;349727;344491;49;694218
44;2020-06-07;2;1;3;381371;373239;59;754610
44;2020-06-07;0;2;2;367165;335850;69;703015
44;2020-06-07;1;1;2;250387;215436;79;465823
44;2020-06-07;2;4;6;170825;105192;89;276017
44;2020-06-07;1;0;1;51248;16731;90;67979
44;2020-06-07;9;12;21;2826745;2685002;0;5511747
52;2020-06-07;0;1;1;213594;223900;09;437494
52;2020-06-07;0;0;0;240818;255197;19;496015
52;2020-06-07;0;0;0;197010;200630;29;397640
52;2020-06-07;0;0;0;231204;224885;39;456089
52;2020-06-07;1;1;2;243874;243418;49;487292
52;2020-06-07;0;0;0;244100;239116;59;483216
52;2020-06-07;0;1;1;241796;221345;69;463141
52;2020-06-07;1;0;1;177805;149903;79;327708
52;2020-06-07;0;0;0;119561;75822;89;195383
52;2020-06-07;1;0;1;42559;15260;90;57819
52;2020-06-07;3;3;6;1952321;1849476;0;3801797
53;2020-06-07;0;0;0;173813;182358;09;356171
53;2020-06-07;0;0;0;202720;214740;19;417460
53;2020-06-07;0;0;0;163116;173196;29;336312
53;2020-06-07;0;0;0;190526;187674;39;378200
53;2020-06-07;0;0;0;212098;212015;49;424113
53;2020-06-07;0;0;0;223699;219176;59;442875
53;2020-06-07;0;0;0;227435;209274;69;436709
53;2020-06-07;0;0;0;169992;140910;79;310902
53;2020-06-07;0;1;1;118117;69883;89;188000
53;2020-06-07;0;0;0;37370;12267;90;49637
53;2020-06-07;0;1;1;1718886;1621493;0;3340379
75;2020-06-07;0;0;0;293104;305291;09;598395
75;2020-06-07;0;0;0;337141;357785;19;694926
75;2020-06-07;1;0;1;295024;300618;29;595642
75;2020-06-07;0;0;0;347871;331233;39;679104
75;2020-06-07;0;0;0;384742;372771;49;757513
75;2020-06-07;0;0;0;413361;390880;59;804241
75;2020-06-07;0;0;0;425623;384060;69;809683
75;2020-06-07;0;0;0;325086;276298;79;601384
75;2020-06-07;0;0;0;213986;139308;89;353294
75;2020-06-07;0;0;0;77600;28200;90;105800
75;2020-06-07;1;0;1;3113538;2886444;0;5999982
76;2020-06-07;0;0;0;305956;318589;09;624545
76;2020-06-07;0;0;0;338942;356969;19;695911
76;2020-06-07;0;0;0;316210;319570;29;635780
76;2020-06-07;0;0;0;356758;337587;39;694345
76;2020-06-07;1;0;1;376541;363812;49;740353
76;2020-06-07;0;0;0;402608;383750;59;786358
76;2020-06-07;0;0;0;394889;358997;69;753886
76;2020-06-07;0;0;0;308664;263806;79;572470
76;2020-06-07;0;0;0;195838;129272;89;325110
76;2020-06-07;0;0;0;69372;26728;90;96100
76;2020-06-07;1;0;1;3065778;2859080;0;5924858
84;2020-06-07;0;0;1;459549;481088;09;940637
84;2020-06-07;0;0;0;487711;511905;19;999616
84;2020-06-07;0;0;0;443824;451094;29;894918
84;2020-06-07;0;0;0;512522;493262;39;1005784
84;2020-06-07;0;0;0;520248;515106;49;1035354
84;2020-06-07;2;0;2;529611;514848;59;1044459
84;2020-06-07;1;0;1;486720;439940;69;926660
84;2020-06-07;0;0;0;372151;315211;79;687362
84;2020-06-07;1;1;2;237198;150524;89;387722
84;2020-06-07;1;0;1;81185;28680;90;109865
84;2020-06-07;5;1;7;4130719;3901658;0;8032377
93;2020-06-07;0;0;0;268834;283093;09;551927
93;2020-06-07;0;0;0;280751;296087;19;576838
93;2020-06-07;0;0;0;254404;255552;29;509956
93;2020-06-07;0;0;0;310704;288398;39;599102
93;2020-06-07;0;2;3;325559;305827;49;631386
93;2020-06-07;0;1;1;353104;325389;59;678493
93;2020-06-07;0;0;0;336327;296459;69;632786
93;2020-06-07;0;0;0;279820;229699;79;509519
93;2020-06-07;0;0;0;171274;113716;89;284990
93;2020-06-07;2;0;2;58896;21758;90;80654
93;2020-06-07;2;3;6;2639673;2415978;0;5055651
94;2020-06-07;0;0;0;16311;17433;09;33744
94;2020-06-07;0;0;0;16679;18132;19;34811
94;2020-06-07;0;0;0;16782;16579;29;33361
94;2020-06-07;0;0;0;23044;20580;39;43624
94;2020-06-07;0;0;0;23065;22140;49;45205
94;2020-06-07;0;0;0;24549;23421;59;47970
94;2020-06-07;0;0;0;23212;21883;69;45095
94;2020-06-07;0;0;0;19544;17141;79;36685
94;2020-06-07;0;0;0;11227;8178;89;19405
94;2020-06-07;0;0;0;3332;1447;90;4779
94;2020-06-07;0;0;0;177745;166934;0;344679
01;2020-06-08;0;0;0;19979;20155;09;40134
01;2020-06-08;0;0;0;24994;25489;19;50483
01;2020-06-08;0;0;0;17868;16690;29;34558
01;2020-06-08;0;0;0;22328;14821;39;37149
01;2020-06-08;0;0;0;28652;20276;49;48928
01;2020-06-08;0;0;0;33264;27260;59;60524
01;2020-06-08;0;0;0;27135;23978;69;51113
01;2020-06-08;0;0;0;18401;14661;79;33062
01;2020-06-08;0;0;0;9633;6375;89;16008
01;2020-06-08;0;0;0;3410;1510;90;4920
01;2020-06-08;0;0;0;205664;171215;0;376879
02;2020-06-08;1;0;1;16881;17110;09;33991
02;2020-06-08;0;0;0;21410;21604;19;43014
02;2020-06-08;1;0;1;16017;15479;29;31496
02;2020-06-08;0;0;0;19825;14455;39;34280
02;2020-06-08;0;0;0;24719;18248;49;42967
02;2020-06-08;1;0;1;34361;28310;59;62671
02;2020-06-08;0;0;0;28061;24495;69;52556
02;2020-06-08;0;0;0;18231;15278;79;33509
02;2020-06-08;0;0;0;11090;7677;89;18767
02;2020-06-08;0;0;0;3992;1506;90;5498
02;2020-06-08;3;0;3;194587;164162;0;358749
03;2020-06-08;1;4;5;31123;30920;09;62043
03;2020-06-08;2;3;5;29370;29268;19;58638
03;2020-06-08;6;5;11;21458;18963;29;40421
03;2020-06-08;9;8;17;21276;18326;39;39602
03;2020-06-08;5;4;9;18164;16593;49;34757
03;2020-06-08;2;4;6;13469;13557;59;27026
03;2020-06-08;4;1;5;8776;8670;69;17446
03;2020-06-08;2;0;2;3777;3591;79;7368
03;2020-06-08;0;0;0;1649;1072;89;2721
03;2020-06-08;0;0;0;485;184;90;669
03;2020-06-08;31;29;60;149547;141144;0;290691
04;2020-06-08;0;0;0;60314;61377;09;121691
04;2020-06-08;0;0;0;66065;68387;19;134452
04;2020-06-08;0;0;0;51059;47156;29;98215
04;2020-06-08;0;0;0;58788;45780;39;104568
04;2020-06-08;0;0;0;61408;52207;49;113615
04;2020-06-08;0;0;0;64838;60759;59;125597
04;2020-06-08;0;0;0;47008;42843;69;89851
04;2020-06-08;1;0;1;25509;21184;79;46693
04;2020-06-08;0;0;0;13168;7647;89;20815
04;2020-06-08;0;0;0;3209;1253;90;4462
04;2020-06-08;1;0;1;451366;408593;0;859959
05;2020-06-08;0;0;0;362.366008612902;341.338819562748;09;703.704828175651
05;2020-06-08;0;0;0;353.376145114279;370.349735405642;19;723.725880519921
05;2020-06-08;0;0;0;218.593559489256;256.539602589476;29;475.133162078732
05;2020-06-08;0;0;0;404.225408693299;360.321910454353;39;764.547319147651
05;2020-06-08;0;0;0;520.067953604221;497.108383964256;49;1017.17633756848
05;2020-06-08;0;0;0;468.146063921917;510.087601910415;59;978.233665832332
05;2020-06-08;0;0;0;340.368470050554;334.366842191253;69;674.735312241807
05;2020-06-08;0;0;0;212.598666888387;192.597753227106;79;405.196420115493
05;2020-06-08;0;0;0;148.727797095705;61.8681715431829;89;210.595968638888
05;2020-06-08;0;0;0;32.9601271090696;10.9909785719784;90;43.9511056810479
05;2020-06-08;0;0;0;3061.43020057959;2935.56979942041;0;5997
06;2020-06-08;0;0;0;42583;42380;09;84963
06;2020-06-08;0;0;0;33369;31925;19;65294
06;2020-06-08;3;2;5;21571;15080;29;36651
06;2020-06-08;2;1;3;21550;16147;39;37697
06;2020-06-08;2;0;2;14193;13939;49;28132
06;2020-06-08;1;0;1;7171;7597;59;14768
06;2020-06-08;1;1;2;3629;4117;69;7746
06;2020-06-08;0;0;0;1577;1457;79;3034
06;2020-06-08;0;0;0;531;474;89;1005
06;2020-06-08;0;0;0;88;93;90;181
06;2020-06-08;9;4;13;146262;133209;0;279471
07;2020-06-08;0;0;0;485;549;09;1034
07;2020-06-08;0;0;0;403;432;19;835
07;2020-06-08;0;0;0;764;841;29;1605
07;2020-06-08;0;0;0;824;928;39;1752
07;2020-06-08;0;0;0;788;1020;49;1808
07;2020-06-08;0;0;0;678;870;59;1548
07;2020-06-08;0;0;0;360;382;69;742
07;2020-06-08;0;0;0;231;190;79;421
07;2020-06-08;0;0;0;114;67;89;181
07;2020-06-08;0;0;0;24;11;90;35
07;2020-06-08;0;0;0;4671;5290;0;9961
08;2020-06-08;0;0;0;2715.22592983026;2997.75551488675;09;5712.98144471701
08;2020-06-08;0;1;1;2778.51901080978;3160.9156459093;19;5939.43465671908
08;2020-06-08;0;0;0;2080.8882988764;1718.16634315323;29;3799.05464202964
08;2020-06-08;0;0;0;2701.8582062647;1896.52641413317;39;4598.38462039786
08;2020-06-08;0;0;0;3151.45861023308;2460.52498233809;49;5611.98359257117
08;2020-06-08;0;0;0;2620.29868333099;2422.23566154656;59;5042.53434487755
08;2020-06-08;0;0;0;1621.44173420671;1438.58325779464;69;3060.02499200135
08;2020-06-08;0;0;0;626.575909335673;526.358467843651;79;1152.93437717932
08;2020-06-08;0;0;0;205.018522985054;140.993639349697;89;346.012162334751
08;2020-06-08;0;0;0;50.0325684687745;20.62259870351;90;70.6551671722846
08;2020-06-08;0;1;1;18551.3174743414;16782.6825256586;0;35334
11;2020-06-08;4;0;4;783071;811785;09;1594856
11;2020-06-08;9;2;12;761456;784653;19;1546109
11;2020-06-08;5;8;13;850145;801772;29;1651917
11;2020-06-08;10;8;18;914360;843488;39;1757848
11;2020-06-08;19;12;32;845609;826202;49;1671811
11;2020-06-08;11;6;17;793566;745070;59;1538636
11;2020-06-08;6;6;13;628649;549192;69;1177841
11;2020-06-08;6;4;10;434606;358356;79;792962
11;2020-06-08;6;4;10;261425;162933;89;424358
11;2020-06-08;7;2;9;89253;32619;90;121872
11;2020-06-08;83;52;138;6362140;5916070;0;12278210
24;2020-06-08;0;0;0;139720;144686;09;284406
24;2020-06-08;0;0;0;152979;161185;19;314164
24;2020-06-08;0;0;0;122237;126536;29;248773
24;2020-06-08;0;1;1;150359;142009;39;292368
24;2020-06-08;1;1;2;161829;158758;49;320587
24;2020-06-08;1;0;1;172552;168011;59;340563
24;2020-06-08;1;4;5;172509;158177;69;330686
24;2020-06-08;1;1;2;129428;110593;79;240021
24;2020-06-08;1;0;1;87342;56882;89;144224
24;2020-06-08;0;1;1;31210;12071;90;43281
24;2020-06-08;5;8;13;1320165;1238908;0;2559073
27;2020-06-08;0;0;0;143373;149679;09;293052
27;2020-06-08;0;0;0;160962;173003;19;333965
27;2020-06-08;0;0;0;133746;142254;29;276000
27;2020-06-08;1;0;1;160004;155407;39;315411
27;2020-06-08;0;0;0;172333;169564;49;341897
27;2020-06-08;2;0;2;189979;183788;59;373767
27;2020-06-08;0;1;1;192591;178206;69;370797
27;2020-06-08;0;0;0;146876;127546;79;274422
27;2020-06-08;2;1;3;96896;61575;89;158471
27;2020-06-08;1;1;2;33148;12109;90;45257
27;2020-06-08;6;3;9;1429908;1353131;0;2783039
28;2020-06-08;0;0;0;180735;186856;09;367591
28;2020-06-08;0;1;1;200125;213621;19;413746
28;2020-06-08;0;1;1;168922;173007;29;341929
28;2020-06-08;1;0;1;196628;188487;39;385115
28;2020-06-08;0;0;0;205396;201699;49;407095
28;2020-06-08;2;1;3;222002;213866;59;435868
28;2020-06-08;0;0;0;224688;203758;69;428446
28;2020-06-08;0;2;2;163192;135543;79;298735
28;2020-06-08;0;0;0;109691;65377;89;175068
28;2020-06-08;0;0;0;37222;12685;90;49907
28;2020-06-08;3;5;8;1708601;1594899;0;3303500
32;2020-06-08;5;4;9;358062;373689;09;731751
32;2020-06-08;4;7;11;387045;406742;19;793787
32;2020-06-08;10;11;22;342304;348587;29;690891
32;2020-06-08;9;5;14;382485;369972;39;752457
32;2020-06-08;10;6;17;382510;376716;49;759226
32;2020-06-08;2;1;3;386937;376527;59;763464
32;2020-06-08;0;5;5;371211;330938;69;702149
32;2020-06-08;1;2;3;250542;201459;79;452001
32;2020-06-08;5;3;8;163399;89786;89;253185
32;2020-06-08;5;2;7;48384;15367;90;63751
32;2020-06-08;51;46;99;3072879;2889783;0;5962662
44;2020-06-08;1;2;3;291525;306839;09;598364
44;2020-06-08;1;0;1;320255;339504;19;659759
44;2020-06-08;5;3;9;302020;314428;29;616448
44;2020-06-08;6;4;10;342222;333292;39;675514
44;2020-06-08;4;1;5;349727;344491;49;694218
44;2020-06-08;9;4;13;381371;373239;59;754610
44;2020-06-08;6;2;8;367165;335850;69;703015
44;2020-06-08;6;3;9;250387;215436;79;465823
44;2020-06-08;7;1;8;170825;105192;89;276017
44;2020-06-08;9;1;10;51248;16731;90;67979
44;2020-06-08;54;21;76;2826745;2685002;0;5511747
52;2020-06-08;0;0;0;213594;223900;09;437494
52;2020-06-08;0;0;1;240818;255197;19;496015
52;2020-06-08;0;2;2;197010;200630;29;397640
52;2020-06-08;3;5;8;231204;224885;39;456089
52;2020-06-08;1;2;3;243874;243418;49;487292
52;2020-06-08;4;2;6;244100;239116;59;483216
52;2020-06-08;0;1;1;241796;221345;69;463141
52;2020-06-08;2;1;3;177805;149903;79;327708
52;2020-06-08;1;2;3;119561;75822;89;195383
52;2020-06-08;1;0;2;42559;15260;90;57819
52;2020-06-08;12;15;29;1952321;1849476;0;3801797
53;2020-06-08;0;0;0;173813;182358;09;356171
53;2020-06-08;1;0;1;202720;214740;19;417460
53;2020-06-08;0;1;1;163116;173196;29;336312
53;2020-06-08;0;1;1;190526;187674;39;378200
53;2020-06-08;0;0;0;212098;212015;49;424113
53;2020-06-08;0;1;1;223699;219176;59;442875
53;2020-06-08;0;1;1;227435;209274;69;436709
53;2020-06-08;0;1;1;169992;140910;79;310902
53;2020-06-08;0;0;0;118117;69883;89;188000
53;2020-06-08;0;0;0;37370;12267;90;49637
53;2020-06-08;1;5;6;1718886;1621493;0;3340379
75;2020-06-08;0;1;1;293104;305291;09;598395
75;2020-06-08;0;0;0;337141;357785;19;694926
75;2020-06-08;2;1;3;295024;300618;29;595642
75;2020-06-08;0;1;1;347871;331233;39;679104
75;2020-06-08;0;0;0;384742;372771;49;757513
75;2020-06-08;0;1;1;413361;390880;59;804241
75;2020-06-08;0;0;0;425623;384060;69;809683
75;2020-06-08;0;0;0;325086;276298;79;601384
75;2020-06-08;0;0;0;213986;139308;89;353294
75;2020-06-08;0;0;0;77600;28200;90;105800
75;2020-06-08;2;4;6;3113538;2886444;0;5999982
76;2020-06-08;2;0;2;305956;318589;09;624545
76;2020-06-08;0;0;0;338942;356969;19;695911
76;2020-06-08;3;0;3;316210;319570;29;635780
76;2020-06-08;0;1;1;356758;337587;39;694345
76;2020-06-08;2;0;2;376541;363812;49;740353
76;2020-06-08;1;1;2;402608;383750;59;786358
76;2020-06-08;0;1;1;394889;358997;69;753886
76;2020-06-08;0;0;0;308664;263806;79;572470
76;2020-06-08;1;3;4;195838;129272;89;325110
76;2020-06-08;0;1;1;69372;26728;90;96100
76;2020-06-08;9;7;16;3065778;2859080;0;5924858
84;2020-06-08;0;0;0;459549;481088;09;940637
84;2020-06-08;1;1;2;487711;511905;19;999616
84;2020-06-08;3;3;7;443824;451094;29;894918
84;2020-06-08;3;0;3;512522;493262;39;1005784
84;2020-06-08;3;1;4;520248;515106;49;1035354
84;2020-06-08;2;3;5;529611;514848;59;1044459
84;2020-06-08;3;3;6;486720;439940;69;926660
84;2020-06-08;0;0;0;372151;315211;79;687362
84;2020-06-08;2;5;7;237198;150524;89;387722
84;2020-06-08;3;2;5;81185;28680;90;109865
84;2020-06-08;20;18;39;4130719;3901658;0;8032377
93;2020-06-08;0;0;0;268834;283093;09;551927
93;2020-06-08;1;1;2;280751;296087;19;576838
93;2020-06-08;3;2;5;254404;255552;29;509956
93;2020-06-08;2;4;7;310704;288398;39;599102
93;2020-06-08;3;8;12;325559;305827;49;631386
93;2020-06-08;4;1;5;353104;325389;59;678493
93;2020-06-08;2;2;4;336327;296459;69;632786
93;2020-06-08;2;0;2;279820;229699;79;509519
93;2020-06-08;1;0;1;171274;113716;89;284990
93;2020-06-08;1;1;3;58896;21758;90;80654
93;2020-06-08;19;19;41;2639673;2415978;0;5055651
94;2020-06-08;0;0;0;16311;17433;09;33744
94;2020-06-08;0;0;0;16679;18132;19;34811
94;2020-06-08;1;0;1;16782;16579;29;33361
94;2020-06-08;1;0;1;23044;20580;39;43624
94;2020-06-08;0;0;0;23065;22140;49;45205
94;2020-06-08;0;0;0;24549;23421;59;47970
94;2020-06-08;0;0;0;23212;21883;69;45095
94;2020-06-08;0;0;0;19544;17141;79;36685
94;2020-06-08;0;0;0;11227;8178;89;19405
94;2020-06-08;0;0;0;3332;1447;90;4779
94;2020-06-08;2;0;2;177745;166934;0;344679
01;2020-06-09;0;0;0;19979;20155;09;40134
01;2020-06-09;0;0;0;24994;25489;19;50483
01;2020-06-09;0;0;0;17868;16690;29;34558
01;2020-06-09;0;0;0;22328;14821;39;37149
01;2020-06-09;0;0;0;28652;20276;49;48928
01;2020-06-09;0;0;0;33264;27260;59;60524
01;2020-06-09;0;0;0;27135;23978;69;51113
01;2020-06-09;0;0;0;18401;14661;79;33062
01;2020-06-09;0;0;0;9633;6375;89;16008
01;2020-06-09;0;0;0;3410;1510;90;4920
01;2020-06-09;0;0;0;205664;171215;0;376879
02;2020-06-09;0;0;0;16881;17110;09;33991
02;2020-06-09;1;1;2;21410;21604;19;43014
02;2020-06-09;0;1;1;16017;15479;29;31496
02;2020-06-09;0;0;0;19825;14455;39;34280
02;2020-06-09;1;0;1;24719;18248;49;42967
02;2020-06-09;0;0;0;34361;28310;59;62671
02;2020-06-09;0;0;0;28061;24495;69;52556
02;2020-06-09;0;0;0;18231;15278;79;33509
02;2020-06-09;0;0;0;11090;7677;89;18767
02;2020-06-09;0;0;0;3992;1506;90;5498
02;2020-06-09;2;2;4;194587;164162;0;358749
03;2020-06-09;4;3;7;31123;30920;09;62043
03;2020-06-09;6;6;12;29370;29268;19;58638
03;2020-06-09;5;4;9;21458;18963;29;40421
03;2020-06-09;6;5;12;21276;18326;39;39602
03;2020-06-09;5;4;9;18164;16593;49;34757
03;2020-06-09;2;3;5;13469;13557;59;27026
03;2020-06-09;3;2;5;8776;8670;69;17446
03;2020-06-09;1;3;4;3777;3591;79;7368
03;2020-06-09;0;1;1;1649;1072;89;2721
03;2020-06-09;0;0;0;485;184;90;669
03;2020-06-09;32;31;64;149547;141144;0;290691
04;2020-06-09;0;0;0;60314;61377;09;121691
04;2020-06-09;0;0;0;66065;68387;19;134452
04;2020-06-09;0;1;1;51059;47156;29;98215
04;2020-06-09;1;0;1;58788;45780;39;104568
04;2020-06-09;1;0;1;61408;52207;49;113615
04;2020-06-09;0;1;1;64838;60759;59;125597
04;2020-06-09;0;0;0;47008;42843;69;89851
04;2020-06-09;0;0;0;25509;21184;79;46693
04;2020-06-09;0;0;0;13168;7647;89;20815
04;2020-06-09;0;0;0;3209;1253;90;4462
04;2020-06-09;2;2;4;451366;408593;0;859959
05;2020-06-09;0;0;0;362.366008612902;341.338819562748;09;703.704828175651
05;2020-06-09;0;0;0;353.376145114279;370.349735405642;19;723.725880519921
05;2020-06-09;0;0;0;218.593559489256;256.539602589476;29;475.133162078732
05;2020-06-09;0;0;0;404.225408693299;360.321910454353;39;764.547319147651
05;2020-06-09;0;0;0;520.067953604221;497.108383964256;49;1017.17633756848
05;2020-06-09;0;0;0;468.146063921917;510.087601910415;59;978.233665832332
05;2020-06-09;0;0;0;340.368470050554;334.366842191253;69;674.735312241807
05;2020-06-09;0;0;0;212.598666888387;192.597753227106;79;405.196420115493
05;2020-06-09;0;0;0;148.727797095705;61.8681715431829;89;210.595968638888
05;2020-06-09;0;0;0;32.9601271090696;10.9909785719784;90;43.9511056810479
05;2020-06-09;0;0;0;3061.43020057959;2935.56979942041;0;5997
06;2020-06-09;0;2;2;42583;42380;09;84963
06;2020-06-09;1;2;3;33369;31925;19;65294
06;2020-06-09;2;3;5;21571;15080;29;36651
06;2020-06-09;5;4;9;21550;16147;39;37697
06;2020-06-09;3;2;5;14193;13939;49;28132
06;2020-06-09;2;2;4;7171;7597;59;14768
06;2020-06-09;1;0;1;3629;4117;69;7746
06;2020-06-09;1;1;2;1577;1457;79;3034
06;2020-06-09;0;1;1;531;474;89;1005
06;2020-06-09;0;0;0;88;93;90;181
06;2020-06-09;15;17;32;146262;133209;0;279471
07;2020-06-09;0;0;0;485;549;09;1034
07;2020-06-09;0;0;0;403;432;19;835
07;2020-06-09;0;0;0;764;841;29;1605
07;2020-06-09;0;0;0;824;928;39;1752
07;2020-06-09;0;0;0;788;1020;49;1808
07;2020-06-09;0;0;0;678;870;59;1548
07;2020-06-09;0;0;0;360;382;69;742
07;2020-06-09;0;0;0;231;190;79;421
07;2020-06-09;0;0;0;114;67;89;181
07;2020-06-09;0;0;0;24;11;90;35
07;2020-06-09;0;0;0;4671;5290;0;9961
08;2020-06-09;0;0;0;2715.22592983026;2997.75551488675;09;5712.98144471701
08;2020-06-09;0;0;0;2778.51901080978;3160.9156459093;19;5939.43465671908
08;2020-06-09;0;0;0;2080.8882988764;1718.16634315323;29;3799.05464202964
08;2020-06-09;0;0;0;2701.8582062647;1896.52641413317;39;4598.38462039786
08;2020-06-09;0;0;0;3151.45861023308;2460.52498233809;49;5611.98359257117
08;2020-06-09;0;0;0;2620.29868333099;2422.23566154656;59;5042.53434487755
08;2020-06-09;0;0;0;1621.44173420671;1438.58325779464;69;3060.02499200135
08;2020-06-09;0;0;0;626.575909335673;526.358467843651;79;1152.93437717932
08;2020-06-09;0;0;0;205.018522985054;140.993639349697;89;346.012162334751
08;2020-06-09;0;0;0;50.0325684687745;20.62259870351;90;70.6551671722846
08;2020-06-09;0;0;0;18551.3174743414;16782.6825256586;0;35334
11;2020-06-09;6;5;12;783071;811785;09;1594856
11;2020-06-09;4;3;7;761456;784653;19;1546109
11;2020-06-09;9;10;20;850145;801772;29;1651917
11;2020-06-09;12;12;26;914360;843488;39;1757848
11;2020-06-09;10;12;22;845609;826202;49;1671811
11;2020-06-09;11;10;22;793566;745070;59;1538636
11;2020-06-09;1;8;9;628649;549192;69;1177841
11;2020-06-09;2;5;7;434606;358356;79;792962
11;2020-06-09;5;4;9;261425;162933;89;424358
11;2020-06-09;6;2;8;89253;32619;90;121872
11;2020-06-09;66;71;142;6362140;5916070;0;12278210
24;2020-06-09;0;0;0;139720;144686;09;284406
24;2020-06-09;0;0;0;152979;161185;19;314164
24;2020-06-09;0;0;1;122237;126536;29;248773
24;2020-06-09;1;1;2;150359;142009;39;292368
24;2020-06-09;2;0;2;161829;158758;49;320587
24;2020-06-09;0;1;1;172552;168011;59;340563
24;2020-06-09;0;0;0;172509;158177;69;330686
24;2020-06-09;2;0;2;129428;110593;79;240021
24;2020-06-09;4;0;4;87342;56882;89;144224
24;2020-06-09;4;0;4;31210;12071;90;43281
24;2020-06-09;13;2;16;1320165;1238908;0;2559073
27;2020-06-09;0;1;1;143373;149679;09;293052
27;2020-06-09;0;0;0;160962;173003;19;333965
27;2020-06-09;0;0;0;133746;142254;29;276000
27;2020-06-09;0;0;0;160004;155407;39;315411
27;2020-06-09;1;1;3;172333;169564;49;341897
27;2020-06-09;0;0;0;189979;183788;59;373767
27;2020-06-09;0;0;0;192591;178206;69;370797
27;2020-06-09;0;0;0;146876;127546;79;274422
27;2020-06-09;1;1;2;96896;61575;89;158471
27;2020-06-09;3;0;3;33148;12109;90;45257
27;2020-06-09;5;3;9;1429908;1353131;0;2783039
28;2020-06-09;0;0;0;180735;186856;09;367591
28;2020-06-09;0;0;0;200125;213621;19;413746
28;2020-06-09;0;1;1;168922;173007;29;341929
28;2020-06-09;0;0;0;196628;188487;39;385115
28;2020-06-09;1;2;3;205396;201699;49;407095
28;2020-06-09;0;0;0;222002;213866;59;435868
28;2020-06-09;4;1;5;224688;203758;69;428446
28;2020-06-09;0;0;0;163192;135543;79;298735
28;2020-06-09;0;0;0;109691;65377;89;175068
28;2020-06-09;0;0;0;37222;12685;90;49907
28;2020-06-09;5;4;9;1708601;1594899;0;3303500
32;2020-06-09;0;2;2;358062;373689;09;731751
32;2020-06-09;4;1;6;387045;406742;19;793787
32;2020-06-09;6;4;11;342304;348587;29;690891
32;2020-06-09;3;4;7;382485;369972;39;752457
32;2020-06-09;3;3;7;382510;376716;49;759226
32;2020-06-09;3;4;9;386937;376527;59;763464
32;2020-06-09;3;0;5;371211;330938;69;702149
32;2020-06-09;4;3;7;250542;201459;79;452001
32;2020-06-09;7;0;7;163399;89786;89;253185
32;2020-06-09;7;0;7;48384;15367;90;63751
32;2020-06-09;40;21;68;3072879;2889783;0;5962662
44;2020-06-09;0;1;4;291525;306839;09;598364
44;2020-06-09;2;3;7;320255;339504;19;659759
44;2020-06-09;4;3;8;302020;314428;29;616448
44;2020-06-09;6;1;9;342222;333292;39;675514
44;2020-06-09;4;3;10;349727;344491;49;694218
44;2020-06-09;2;5;9;381371;373239;59;754610
44;2020-06-09;7;5;13;367165;335850;69;703015
44;2020-06-09;3;4;8;250387;215436;79;465823
44;2020-06-09;4;1;7;170825;105192;89;276017
44;2020-06-09;2;3;5;51248;16731;90;67979
44;2020-06-09;34;29;80;2826745;2685002;0;5511747
52;2020-06-09;0;2;2;213594;223900;09;437494
52;2020-06-09;0;0;0;240818;255197;19;496015
52;2020-06-09;1;1;2;197010;200630;29;397640
52;2020-06-09;0;2;2;231204;224885;39;456089
52;2020-06-09;4;1;5;243874;243418;49;487292
52;2020-06-09;1;2;3;244100;239116;59;483216
52;2020-06-09;1;0;1;241796;221345;69;463141
52;2020-06-09;1;2;3;177805;149903;79;327708
52;2020-06-09;2;0;2;119561;75822;89;195383
52;2020-06-09;4;1;5;42559;15260;90;57819
52;2020-06-09;14;11;25;1952321;1849476;0;3801797
53;2020-06-09;0;0;0;173813;182358;09;356171
53;2020-06-09;0;0;0;202720;214740;19;417460
53;2020-06-09;0;1;1;163116;173196;29;336312
53;2020-06-09;0;2;2;190526;187674;39;378200
53;2020-06-09;0;0;0;212098;212015;49;424113
53;2020-06-09;0;0;0;223699;219176;59;442875
53;2020-06-09;1;0;1;227435;209274;69;436709
53;2020-06-09;0;0;0;169992;140910;79;310902
53;2020-06-09;0;0;0;118117;69883;89;188000
53;2020-06-09;1;0;1;37370;12267;90;49637
53;2020-06-09;2;3;5;1718886;1621493;0;3340379
75;2020-06-09;0;0;0;293104;305291;09;598395
75;2020-06-09;0;0;0;337141;357785;19;694926
75;2020-06-09;0;3;3;295024;300618;29;595642
75;2020-06-09;0;1;1;347871;331233;39;679104
75;2020-06-09;0;1;1;384742;372771;49;757513
75;2020-06-09;1;0;1;413361;390880;59;804241
75;2020-06-09;1;0;1;425623;384060;69;809683
75;2020-06-09;0;0;0;325086;276298;79;601384
75;2020-06-09;0;0;0;213986;139308;89;353294
75;2020-06-09;1;0;1;77600;28200;90;105800
75;2020-06-09;3;5;8;3113538;2886444;0;5999982
76;2020-06-09;1;0;1;305956;318589;09;624545
76;2020-06-09;4;0;4;338942;356969;19;695911
76;2020-06-09;3;6;10;316210;319570;29;635780
76;2020-06-09;3;0;3;356758;337587;39;694345
76;2020-06-09;7;5;12;376541;363812;49;740353
76;2020-06-09;4;6;10;402608;383750;59;786358
76;2020-06-09;1;2;3;394889;358997;69;753886
76;2020-06-09;0;1;1;308664;263806;79;572470
76;2020-06-09;0;0;0;195838;129272;89;325110
76;2020-06-09;0;0;0;69372;26728;90;96100
76;2020-06-09;23;20;44;3065778;2859080;0;5924858
84;2020-06-09;0;0;0;459549;481088;09;940637
84;2020-06-09;1;1;2;487711;511905;19;999616
84;2020-06-09;1;4;5;443824;451094;29;894918
84;2020-06-09;2;1;3;512522;493262;39;1005784
84;2020-06-09;1;1;2;520248;515106;49;1035354
84;2020-06-09;0;1;1;529611;514848;59;1044459
84;2020-06-09;2;1;3;486720;439940;69;926660
84;2020-06-09;0;2;2;372151;315211;79;687362
84;2020-06-09;3;0;3;237198;150524;89;387722
84;2020-06-09;2;2;4;81185;28680;90;109865
84;2020-06-09;12;13;25;4130719;3901658;0;8032377
93;2020-06-09;0;0;1;268834;283093;09;551927
93;2020-06-09;0;1;2;280751;296087;19;576838
93;2020-06-09;2;5;7;254404;255552;29;509956
93;2020-06-09;5;2;8;310704;288398;39;599102
93;2020-06-09;5;7;12;325559;305827;49;631386
93;2020-06-09;3;5;8;353104;325389;59;678493
93;2020-06-09;0;1;1;336327;296459;69;632786
93;2020-06-09;0;0;0;279820;229699;79;509519
93;2020-06-09;1;1;2;171274;113716;89;284990
93;2020-06-09;0;0;0;58896;21758;90;80654
93;2020-06-09;16;22;41;2639673;2415978;0;5055651
94;2020-06-09;0;0;0;16311;17433;09;33744
94;2020-06-09;0;0;0;16679;18132;19;34811
94;2020-06-09;0;0;0;16782;16579;29;33361
94;2020-06-09;0;0;0;23044;20580;39;43624
94;2020-06-09;0;0;0;23065;22140;49;45205
94;2020-06-09;0;0;0;24549;23421;59;47970
94;2020-06-09;0;0;0;23212;21883;69;45095
94;2020-06-09;0;0;0;19544;17141;79;36685
94;2020-06-09;0;0;0;11227;8178;89;19405
94;2020-06-09;0;0;0;3332;1447;90;4779
94;2020-06-09;0;0;0;177745;166934;0;344679
01;2020-06-10;0;0;0;19979;20155;09;40134
01;2020-06-10;0;0;0;24994;25489;19;50483
01;2020-06-10;0;0;0;17868;16690;29;34558
01;2020-06-10;0;0;0;22328;14821;39;37149
01;2020-06-10;0;0;0;28652;20276;49;48928
01;2020-06-10;1;0;1;33264;27260;59;60524
01;2020-06-10;0;0;0;27135;23978;69;51113
01;2020-06-10;0;0;0;18401;14661;79;33062
01;2020-06-10;0;0;0;9633;6375;89;16008
01;2020-06-10;0;0;0;3410;1510;90;4920
01;2020-06-10;1;0;1;205664;171215;0;376879
02;2020-06-10;0;0;0;16881;17110;09;33991
02;2020-06-10;0;0;0;21410;21604;19;43014
02;2020-06-10;1;0;1;16017;15479;29;31496
02;2020-06-10;0;0;0;19825;14455;39;34280
02;2020-06-10;0;0;0;24719;18248;49;42967
02;2020-06-10;0;0;0;34361;28310;59;62671
02;2020-06-10;0;0;0;28061;24495;69;52556
02;2020-06-10;0;0;0;18231;15278;79;33509
02;2020-06-10;0;0;0;11090;7677;89;18767
02;2020-06-10;0;0;0;3992;1506;90;5498
02;2020-06-10;1;0;1;194587;164162;0;358749
03;2020-06-10;2;1;3;31123;30920;09;62043
03;2020-06-10;3;6;9;29370;29268;19;58638
03;2020-06-10;5;2;7;21458;18963;29;40421
03;2020-06-10;9;6;15;21276;18326;39;39602
03;2020-06-10;3;4;7;18164;16593;49;34757
03;2020-06-10;3;6;9;13469;13557;59;27026
03;2020-06-10;0;1;1;8776;8670;69;17446
03;2020-06-10;1;0;1;3777;3591;79;7368
03;2020-06-10;1;0;1;1649;1072;89;2721
03;2020-06-10;0;0;0;485;184;90;669
03;2020-06-10;27;26;53;149547;141144;0;290691
04;2020-06-10;0;0;0;60314;61377;09;121691
04;2020-06-10;1;0;1;66065;68387;19;134452
04;2020-06-10;0;0;0;51059;47156;29;98215
04;2020-06-10;0;0;0;58788;45780;39;104568
04;2020-06-10;0;0;0;61408;52207;49;113615
04;2020-06-10;0;0;0;64838;60759;59;125597
04;2020-06-10;0;0;0;47008;42843;69;89851
04;2020-06-10;0;0;0;25509;21184;79;46693
04;2020-06-10;0;0;0;13168;7647;89;20815
04;2020-06-10;0;0;0;3209;1253;90;4462
04;2020-06-10;1;0;1;451366;408593;0;859959
05;2020-06-10;0;0;0;362.366008612902;341.338819562748;09;703.704828175651
05;2020-06-10;0;0;0;353.376145114279;370.349735405642;19;723.725880519921
05;2020-06-10;0;0;0;218.593559489256;256.539602589476;29;475.133162078732
05;2020-06-10;0;0;0;404.225408693299;360.321910454353;39;764.547319147651
05;2020-06-10;0;0;0;520.067953604221;497.108383964256;49;1017.17633756848
05;2020-06-10;0;0;0;468.146063921917;510.087601910415;59;978.233665832332
05;2020-06-10;0;0;0;340.368470050554;334.366842191253;69;674.735312241807
05;2020-06-10;0;0;0;212.598666888387;192.597753227106;79;405.196420115493
05;2020-06-10;0;0;0;148.727797095705;61.8681715431829;89;210.595968638888
05;2020-06-10;0;0;0;32.9601271090696;10.9909785719784;90;43.9511056810479
05;2020-06-10;0;0;0;3061.43020057959;2935.56979942041;0;5997
06;2020-06-10;0;0;0;42583;42380;09;84963
06;2020-06-10;1;2;3;33369;31925;19;65294
06;2020-06-10;3;2;5;21571;15080;29;36651
06;2020-06-10;3;3;6;21550;16147;39;37697
06;2020-06-10;4;2;6;14193;13939;49;28132
06;2020-06-10;2;1;3;7171;7597;59;14768
06;2020-06-10;0;0;0;3629;4117;69;7746
06;2020-06-10;1;0;1;1577;1457;79;3034
06;2020-06-10;0;0;0;531;474;89;1005
06;2020-06-10;0;0;0;88;93;90;181
06;2020-06-10;14;10;24;146262;133209;0;279471
07;2020-06-10;0;0;0;485;549;09;1034
07;2020-06-10;0;0;0;403;432;19;835
07;2020-06-10;0;0;0;764;841;29;1605
07;2020-06-10;0;0;0;824;928;39;1752
07;2020-06-10;0;0;0;788;1020;49;1808
07;2020-06-10;0;0;0;678;870;59;1548
07;2020-06-10;0;0;0;360;382;69;742
07;2020-06-10;0;0;0;231;190;79;421
07;2020-06-10;0;0;0;114;67;89;181
07;2020-06-10;0;0;0;24;11;90;35
07;2020-06-10;0;0;0;4671;5290;0;9961
08;2020-06-10;0;0;0;2715.22592983026;2997.75551488675;09;5712.98144471701
08;2020-06-10;0;0;0;2778.51901080978;3160.9156459093;19;5939.43465671908
08;2020-06-10;0;0;0;2080.8882988764;1718.16634315323;29;3799.05464202964
08;2020-06-10;0;0;0;2701.8582062647;1896.52641413317;39;4598.38462039786
08;2020-06-10;0;0;0;3151.45861023308;2460.52498233809;49;5611.98359257117
08;2020-06-10;0;0;0;2620.29868333099;2422.23566154656;59;5042.53434487755
08;2020-06-10;0;0;0;1621.44173420671;1438.58325779464;69;3060.02499200135
08;2020-06-10;0;0;0;626.575909335673;526.358467843651;79;1152.93437717932
08;2020-06-10;0;0;0;205.018522985054;140.993639349697;89;346.012162334751
08;2020-06-10;0;0;0;50.0325684687745;20.62259870351;90;70.6551671722846
08;2020-06-10;0;0;0;18551.3174743414;16782.6825256586;0;35334
11;2020-06-10;1;5;6;783071;811785;09;1594856
11;2020-06-10;2;5;8;761456;784653;19;1546109
11;2020-06-10;7;10;18;850145;801772;29;1651917
11;2020-06-10;11;12;25;914360;843488;39;1757848
11;2020-06-10;6;6;15;845609;826202;49;1671811
11;2020-06-10;8;10;21;793566;745070;59;1538636
11;2020-06-10;8;5;13;628649;549192;69;1177841
11;2020-06-10;8;9;17;434606;358356;79;792962
11;2020-06-10;9;7;17;261425;162933;89;424358
11;2020-06-10;4;2;6;89253;32619;90;121872
11;2020-06-10;64;71;146;6362140;5916070;0;12278210
24;2020-06-10;0;0;0;139720;144686;09;284406
24;2020-06-10;0;1;1;152979;161185;19;314164
24;2020-06-10;0;0;0;122237;126536;29;248773
24;2020-06-10;1;0;1;150359;142009;39;292368
24;2020-06-10;1;0;1;161829;158758;49;320587
24;2020-06-10;2;0;2;172552;168011;59;340563
24;2020-06-10;0;1;2;172509;158177;69;330686
24;2020-06-10;1;0;1;129428;110593;79;240021
24;2020-06-10;0;1;1;87342;56882;89;144224
24;2020-06-10;0;0;0;31210;12071;90;43281
24;2020-06-10;5;3;9;1320165;1238908;0;2559073
27;2020-06-10;0;0;2;143373;149679;09;293052
27;2020-06-10;0;0;1;160962;173003;19;333965
27;2020-06-10;0;2;4;133746;142254;29;276000
27;2020-06-10;0;0;0;160004;155407;39;315411
27;2020-06-10;1;0;3;172333;169564;49;341897
27;2020-06-10;1;0;2;189979;183788;59;373767
27;2020-06-10;0;0;0;192591;178206;69;370797
27;2020-06-10;0;2;2;146876;127546;79;274422
27;2020-06-10;1;2;3;96896;61575;89;158471
27;2020-06-10;1;0;1;33148;12109;90;45257
27;2020-06-10;4;6;18;1429908;1353131;0;2783039
28;2020-06-10;0;0;0;180735;186856;09;367591
28;2020-06-10;1;0;1;200125;213621;19;413746
28;2020-06-10;0;0;0;168922;173007;29;341929
28;2020-06-10;1;1;2;196628;188487;39;385115
28;2020-06-10;0;0;1;205396;201699;49;407095
28;2020-06-10;0;0;0;222002;213866;59;435868
28;2020-06-10;0;0;0;224688;203758;69;428446
28;2020-06-10;2;0;2;163192;135543;79;298735
28;2020-06-10;1;0;1;109691;65377;89;175068
28;2020-06-10;0;0;0;37222;12685;90;49907
28;2020-06-10;5;1;7;1708601;1594899;0;3303500
32;2020-06-10;3;3;6;358062;373689;09;731751
32;2020-06-10;0;3;4;387045;406742;19;793787
32;2020-06-10;3;4;10;342304;348587;29;690891
32;2020-06-10;8;3;14;382485;369972;39;752457
32;2020-06-10;1;3;6;382510;376716;49;759226
32;2020-06-10;2;1;8;386937;376527;59;763464
32;2020-06-10;2;2;5;371211;330938;69;702149
32;2020-06-10;4;1;5;250542;201459;79;452001
32;2020-06-10;3;3;9;163399;89786;89;253185
32;2020-06-10;0;1;2;48384;15367;90;63751
32;2020-06-10;26;24;69;3072879;2889783;0;5962662
44;2020-06-10;0;1;1;291525;306839;09;598364
44;2020-06-10;3;0;3;320255;339504;19;659759
44;2020-06-10;5;6;14;302020;314428;29;616448
44;2020-06-10;2;2;6;342222;333292;39;675514
44;2020-06-10;3;0;4;349727;344491;49;694218
44;2020-06-10;3;1;5;381371;373239;59;754610
44;2020-06-10;5;7;13;367165;335850;69;703015
44;2020-06-10;5;3;11;250387;215436;79;465823
44;2020-06-10;4;2;8;170825;105192;89;276017
44;2020-06-10;3;2;6;51248;16731;90;67979
44;2020-06-10;33;24;71;2826745;2685002;0;5511747
52;2020-06-10;0;0;1;213594;223900;09;437494
52;2020-06-10;2;0;2;240818;255197;19;496015
52;2020-06-10;5;7;13;197010;200630;29;397640
52;2020-06-10;1;0;1;231204;224885;39;456089
52;2020-06-10;0;2;3;243874;243418;49;487292
52;2020-06-10;1;2;3;244100;239116;59;483216
52;2020-06-10;0;0;0;241796;221345;69;463141
52;2020-06-10;0;1;1;177805;149903;79;327708
52;2020-06-10;0;1;1;119561;75822;89;195383
52;2020-06-10;1;0;2;42559;15260;90;57819
52;2020-06-10;10;13;27;1952321;1849476;0;3801797
53;2020-06-10;0;0;0;173813;182358;09;356171
53;2020-06-10;0;0;0;202720;214740;19;417460
53;2020-06-10;0;0;0;163116;173196;29;336312
53;2020-06-10;0;0;0;190526;187674;39;378200
53;2020-06-10;0;1;1;212098;212015;49;424113
53;2020-06-10;1;1;2;223699;219176;59;442875
53;2020-06-10;0;0;0;227435;209274;69;436709
53;2020-06-10;0;1;1;169992;140910;79;310902
53;2020-06-10;0;0;0;118117;69883;89;188000
53;2020-06-10;0;1;1;37370;12267;90;49637
53;2020-06-10;1;4;5;1718886;1621493;0;3340379
75;2020-06-10;0;0;0;293104;305291;09;598395
75;2020-06-10;0;0;0;337141;357785;19;694926
75;2020-06-10;1;2;4;295024;300618;29;595642
75;2020-06-10;1;0;1;347871;331233;39;679104
75;2020-06-10;1;1;2;384742;372771;49;757513
75;2020-06-10;1;1;2;413361;390880;59;804241
75;2020-06-10;2;0;2;425623;384060;69;809683
75;2020-06-10;1;0;1;325086;276298;79;601384
75;2020-06-10;0;2;2;213986;139308;89;353294
75;2020-06-10;0;0;0;77600;28200;90;105800
75;2020-06-10;7;6;14;3113538;2886444;0;5999982
76;2020-06-10;1;1;2;305956;318589;09;624545
76;2020-06-10;3;0;4;338942;356969;19;695911
76;2020-06-10;2;3;6;316210;319570;29;635780
76;2020-06-10;2;2;5;356758;337587;39;694345
76;2020-06-10;4;2;7;376541;363812;49;740353
76;2020-06-10;4;7;11;402608;383750;59;786358
76;2020-06-10;2;3;5;394889;358997;69;753886
76;2020-06-10;1;2;3;308664;263806;79;572470
76;2020-06-10;1;0;1;195838;129272;89;325110
76;2020-06-10;1;0;1;69372;26728;90;96100
76;2020-06-10;21;20;45;3065778;2859080;0;5924858
84;2020-06-10;1;0;1;459549;481088;09;940637
84;2020-06-10;0;1;1;487711;511905;19;999616
84;2020-06-10;3;1;4;443824;451094;29;894918
84;2020-06-10;4;2;7;512522;493262;39;1005784
84;2020-06-10;1;1;2;520248;515106;49;1035354
84;2020-06-10;1;1;4;529611;514848;59;1044459
84;2020-06-10;1;1;2;486720;439940;69;926660
84;2020-06-10;2;1;3;372151;315211;79;687362
84;2020-06-10;4;2;6;237198;150524;89;387722
84;2020-06-10;3;0;3;81185;28680;90;109865
84;2020-06-10;20;10;33;4130719;3901658;0;8032377
93;2020-06-10;0;1;1;268834;283093;09;551927
93;2020-06-10;1;2;3;280751;296087;19;576838
93;2020-06-10;2;2;4;254404;255552;29;509956
93;2020-06-10;1;4;5;310704;288398;39;599102
93;2020-06-10;1;4;6;325559;305827;49;631386
93;2020-06-10;2;3;5;353104;325389;59;678493
93;2020-06-10;1;2;5;336327;296459;69;632786
93;2020-06-10;1;1;2;279820;229699;79;509519
93;2020-06-10;1;1;4;171274;113716;89;284990
93;2020-06-10;2;0;4;58896;21758;90;80654
93;2020-06-10;12;20;39;2639673;2415978;0;5055651
94;2020-06-10;0;0;0;16311;17433;09;33744
94;2020-06-10;0;0;0;16679;18132;19;34811
94;2020-06-10;0;0;0;16782;16579;29;33361
94;2020-06-10;0;0;0;23044;20580;39;43624
94;2020-06-10;0;0;0;23065;22140;49;45205
94;2020-06-10;0;0;1;24549;23421;59;47970
94;2020-06-10;0;0;0;23212;21883;69;45095
94;2020-06-10;0;0;0;19544;17141;79;36685
94;2020-06-10;0;0;0;11227;8178;89;19405
94;2020-06-10;0;0;0;3332;1447;90;4779
94;2020-06-10;0;0;1;177745;166934;0;344679
01;2020-06-11;0;0;0;19979;20155;09;40134
01;2020-06-11;0;0;0;24994;25489;19;50483
01;2020-06-11;0;0;0;17868;16690;29;34558
01;2020-06-11;0;0;0;22328;14821;39;37149
01;2020-06-11;0;0;0;28652;20276;49;48928
01;2020-06-11;0;0;0;33264;27260;59;60524
01;2020-06-11;0;0;0;27135;23978;69;51113
01;2020-06-11;0;0;0;18401;14661;79;33062
01;2020-06-11;0;0;0;9633;6375;89;16008
01;2020-06-11;0;0;0;3410;1510;90;4920
01;2020-06-11;0;0;0;205664;171215;0;376879
02;2020-06-11;0;0;0;16881;17110;09;33991
02;2020-06-11;0;0;0;21410;21604;19;43014
02;2020-06-11;2;0;2;16017;15479;29;31496
02;2020-06-11;0;0;0;19825;14455;39;34280
02;2020-06-11;0;0;0;24719;18248;49;42967
02;2020-06-11;0;0;0;34361;28310;59;62671
02;2020-06-11;0;0;0;28061;24495;69;52556
02;2020-06-11;0;0;0;18231;15278;79;33509
02;2020-06-11;0;0;0;11090;7677;89;18767
02;2020-06-11;0;0;0;3992;1506;90;5498
02;2020-06-11;2;0;2;194587;164162;0;358749
03;2020-06-11;6;8;17;31123;30920;09;62043
03;2020-06-11;4;7;11;29370;29268;19;58638
03;2020-06-11;15;7;24;21458;18963;29;40421
03;2020-06-11;16;13;31;21276;18326;39;39602
03;2020-06-11;5;6;11;18164;16593;49;34757
03;2020-06-11;7;3;10;13469;13557;59;27026
03;2020-06-11;0;3;3;8776;8670;69;17446
03;2020-06-11;5;3;8;3777;3591;79;7368
03;2020-06-11;1;1;2;1649;1072;89;2721
03;2020-06-11;0;0;0;485;184;90;669
03;2020-06-11;59;51;117;149547;141144;0;290691
04;2020-06-11;0;0;0;60314;61377;09;121691
04;2020-06-11;0;0;0;66065;68387;19;134452
04;2020-06-11;0;0;0;51059;47156;29;98215
04;2020-06-11;0;0;0;58788;45780;39;104568
04;2020-06-11;0;0;0;61408;52207;49;113615
04;2020-06-11;0;0;0;64838;60759;59;125597
04;2020-06-11;0;0;0;47008;42843;69;89851
04;2020-06-11;0;0;0;25509;21184;79;46693
04;2020-06-11;0;0;0;13168;7647;89;20815
04;2020-06-11;0;0;0;3209;1253;90;4462
04;2020-06-11;0;0;0;451366;408593;0;859959
05;2020-06-11;0;0;0;362.366008612902;341.338819562748;09;703.704828175651
05;2020-06-11;0;0;0;353.376145114279;370.349735405642;19;723.725880519921
05;2020-06-11;0;0;0;218.593559489256;256.539602589476;29;475.133162078732
05;2020-06-11;0;0;0;404.225408693299;360.321910454353;39;764.547319147651
05;2020-06-11;0;0;0;520.067953604221;497.108383964256;49;1017.17633756848
05;2020-06-11;0;0;0;468.146063921917;510.087601910415;59;978.233665832332
05;2020-06-11;0;0;0;340.368470050554;334.366842191253;69;674.735312241807
05;2020-06-11;0;0;0;212.598666888387;192.597753227106;79;405.196420115493
05;2020-06-11;0;0;0;148.727797095705;61.8681715431829;89;210.595968638888
05;2020-06-11;0;0;0;32.9601271090696;10.9909785719784;90;43.9511056810479
05;2020-06-11;0;0;0;3061.43020057959;2935.56979942041;0;5997
06;2020-06-11;0;2;2;42583;42380;09;84963
06;2020-06-11;0;1;1;33369;31925;19;65294
06;2020-06-11;5;5;10;21571;15080;29;36651
06;2020-06-11;5;3;8;21550;16147;39;37697
06;2020-06-11;0;2;2;14193;13939;49;28132
06;2020-06-11;3;1;4;7171;7597;59;14768
06;2020-06-11;0;0;0;3629;4117;69;7746
06;2020-06-11;0;1;1;1577;1457;79;3034
06;2020-06-11;0;0;0;531;474;89;1005
06;2020-06-11;0;0;0;88;93;90;181
06;2020-06-11;13;15;28;146262;133209;0;279471
07;2020-06-11;0;0;0;485;549;09;1034
07;2020-06-11;0;0;0;403;432;19;835
07;2020-06-11;0;0;0;764;841;29;1605
07;2020-06-11;0;0;0;824;928;39;1752
07;2020-06-11;0;0;0;788;1020;49;1808
07;2020-06-11;0;0;0;678;870;59;1548
07;2020-06-11;0;0;0;360;382;69;742
07;2020-06-11;0;0;0;231;190;79;421
07;2020-06-11;0;0;0;114;67;89;181
07;2020-06-11;0;0;0;24;11;90;35
07;2020-06-11;0;0;0;4671;5290;0;9961
08;2020-06-11;0;0;0;2715.22592983026;2997.75551488675;09;5712.98144471701
08;2020-06-11;0;0;0;2778.51901080978;3160.9156459093;19;5939.43465671908
08;2020-06-11;0;0;0;2080.8882988764;1718.16634315323;29;3799.05464202964
08;2020-06-11;0;0;0;2701.8582062647;1896.52641413317;39;4598.38462039786
08;2020-06-11;0;0;0;3151.45861023308;2460.52498233809;49;5611.98359257117
08;2020-06-11;0;0;0;2620.29868333099;2422.23566154656;59;5042.53434487755
08;2020-06-11;0;0;0;1621.44173420671;1438.58325779464;69;3060.02499200135
08;2020-06-11;0;0;0;626.575909335673;526.358467843651;79;1152.93437717932
08;2020-06-11;0;0;0;205.018522985054;140.993639349697;89;346.012162334751
08;2020-06-11;0;0;0;50.0325684687745;20.62259870351;90;70.6551671722846
08;2020-06-11;0;0;0;18551.3174743414;16782.6825256586;0;35334
11;2020-06-11;1;6;7;783071;811785;09;1594856
11;2020-06-11;7;3;11;761456;784653;19;1546109
11;2020-06-11;7;4;14;850145;801772;29;1651917
11;2020-06-11;11;2;13;914360;843488;39;1757848
11;2020-06-11;5;4;10;845609;826202;49;1671811
11;2020-06-11;8;9;18;793566;745070;59;1538636
11;2020-06-11;5;10;15;628649;549192;69;1177841
11;2020-06-11;2;6;8;434606;358356;79;792962
11;2020-06-11;2;2;4;261425;162933;89;424358
11;2020-06-11;2;1;3;89253;32619;90;121872
11;2020-06-11;50;47;103;6362140;5916070;0;12278210
24;2020-06-11;0;0;0;139720;144686;09;284406
24;2020-06-11;0;0;0;152979;161185;19;314164
24;2020-06-11;2;0;2;122237;126536;29;248773
24;2020-06-11;2;0;2;150359;142009;39;292368
24;2020-06-11;2;1;3;161829;158758;49;320587
24;2020-06-11;1;1;2;172552;168011;59;340563
24;2020-06-11;0;1;1;172509;158177;69;330686
24;2020-06-11;0;0;0;129428;110593;79;240021
24;2020-06-11;0;2;2;87342;56882;89;144224
24;2020-06-11;1;0;1;31210;12071;90;43281
24;2020-06-11;8;5;13;1320165;1238908;0;2559073
27;2020-06-11;0;0;0;143373;149679;09;293052
27;2020-06-11;1;0;1;160962;173003;19;333965
27;2020-06-11;0;1;2;133746;142254;29;276000
27;2020-06-11;0;0;0;160004;155407;39;315411
27;2020-06-11;0;0;1;172333;169564;49;341897
27;2020-06-11;1;0;1;189979;183788;59;373767
27;2020-06-11;0;0;0;192591;178206;69;370797
27;2020-06-11;1;1;2;146876;127546;79;274422
27;2020-06-11;0;1;1;96896;61575;89;158471
27;2020-06-11;0;0;0;33148;12109;90;45257
27;2020-06-11;3;3;8;1429908;1353131;0;2783039
28;2020-06-11;0;1;1;180735;186856;09;367591
28;2020-06-11;0;0;1;200125;213621;19;413746
28;2020-06-11;2;0;4;168922;173007;29;341929
28;2020-06-11;2;1;3;196628;188487;39;385115
28;2020-06-11;1;1;2;205396;201699;49;407095
28;2020-06-11;0;0;0;222002;213866;59;435868
28;2020-06-11;0;0;0;224688;203758;69;428446
28;2020-06-11;0;0;0;163192;135543;79;298735
28;2020-06-11;1;0;1;109691;65377;89;175068
28;2020-06-11;0;0;0;37222;12685;90;49907
28;2020-06-11;6;3;12;1708601;1594899;0;3303500
32;2020-06-11;2;2;6;358062;373689;09;731751
32;2020-06-11;1;2;5;387045;406742;19;793787
32;2020-06-11;3;0;6;342304;348587;29;690891
32;2020-06-11;4;2;11;382485;369972;39;752457
32;2020-06-11;4;5;10;382510;376716;49;759226
32;2020-06-11;1;3;7;386937;376527;59;763464
32;2020-06-11;1;0;4;371211;330938;69;702149
32;2020-06-11;3;1;4;250542;201459;79;452001
32;2020-06-11;2;1;8;163399;89786;89;253185
32;2020-06-11;1;0;3;48384;15367;90;63751
32;2020-06-11;22;16;64;3072879;2889783;0;5962662
44;2020-06-11;0;3;4;291525;306839;09;598364
44;2020-06-11;0;1;1;320255;339504;19;659759
44;2020-06-11;4;4;9;302020;314428;29;616448
44;2020-06-11;6;3;11;342222;333292;39;675514
44;2020-06-11;4;3;7;349727;344491;49;694218
44;2020-06-11;9;2;13;381371;373239;59;754610
44;2020-06-11;1;0;1;367165;335850;69;703015
44;2020-06-11;2;3;5;250387;215436;79;465823
44;2020-06-11;2;2;4;170825;105192;89;276017
44;2020-06-11;3;0;3;51248;16731;90;67979
44;2020-06-11;31;21;58;2826745;2685002;0;5511747
52;2020-06-11;0;0;0;213594;223900;09;437494
52;2020-06-11;1;0;1;240818;255197;19;496015
52;2020-06-11;1;0;2;197010;200630;29;397640
52;2020-06-11;2;0;2;231204;224885;39;456089
52;2020-06-11;0;1;2;243874;243418;49;487292
52;2020-06-11;1;0;1;244100;239116;59;483216
52;2020-06-11;0;2;2;241796;221345;69;463141
52;2020-06-11;0;0;0;177805;149903;79;327708
52;2020-06-11;0;1;1;119561;75822;89;195383
52;2020-06-11;2;0;3;42559;15260;90;57819
52;2020-06-11;7;4;14;1952321;1849476;0;3801797
53;2020-06-11;0;0;0;173813;182358;09;356171
53;2020-06-11;0;0;0;202720;214740;19;417460
53;2020-06-11;0;0;0;163116;173196;29;336312
53;2020-06-11;0;0;0;190526;187674;39;378200
53;2020-06-11;0;0;0;212098;212015;49;424113
53;2020-06-11;0;0;0;223699;219176;59;442875
53;2020-06-11;0;0;0;227435;209274;69;436709
53;2020-06-11;0;0;0;169992;140910;79;310902
53;2020-06-11;0;0;0;118117;69883;89;188000
53;2020-06-11;0;0;0;37370;12267;90;49637
53;2020-06-11;0;0;0;1718886;1621493;0;3340379
75;2020-06-11;0;1;1;293104;305291;09;598395
75;2020-06-11;0;0;0;337141;357785;19;694926
75;2020-06-11;1;0;1;295024;300618;29;595642
75;2020-06-11;0;1;1;347871;331233;39;679104
75;2020-06-11;3;0;4;384742;372771;49;757513
75;2020-06-11;3;0;3;413361;390880;59;804241
75;2020-06-11;0;1;1;425623;384060;69;809683
75;2020-06-11;0;1;1;325086;276298;79;601384
75;2020-06-11;0;0;0;213986;139308;89;353294
75;2020-06-11;0;0;0;77600;28200;90;105800
75;2020-06-11;7;4;12;3113538;2886444;0;5999982
76;2020-06-11;5;0;5;305956;318589;09;624545
76;2020-06-11;3;1;5;338942;356969;19;695911
76;2020-06-11;4;5;9;316210;319570;29;635780
76;2020-06-11;5;2;8;356758;337587;39;694345
76;2020-06-11;4;3;8;376541;363812;49;740353
76;2020-06-11;1;5;6;402608;383750;59;786358
76;2020-06-11;1;3;4;394889;358997;69;753886
76;2020-06-11;1;0;1;308664;263806;79;572470
76;2020-06-11;1;0;1;195838;129272;89;325110
76;2020-06-11;1;0;1;69372;26728;90;96100
76;2020-06-11;26;19;48;3065778;2859080;0;5924858
84;2020-06-11;1;0;1;459549;481088;09;940637
84;2020-06-11;0;2;10;487711;511905;19;999616
84;2020-06-11;3;1;4;443824;451094;29;894918
84;2020-06-11;2;2;4;512522;493262;39;1005784
84;2020-06-11;3;1;7;520248;515106;49;1035354
84;2020-06-11;2;1;4;529611;514848;59;1044459
84;2020-06-11;3;2;5;486720;439940;69;926660
84;2020-06-11;1;3;5;372151;315211;79;687362
84;2020-06-11;4;2;6;237198;150524;89;387722
84;2020-06-11;4;1;5;81185;28680;90;109865
84;2020-06-11;23;15;51;4130719;3901658;0;8032377
93;2020-06-11;1;3;5;268834;283093;09;551927
93;2020-06-11;0;2;2;280751;296087;19;576838
93;2020-06-11;1;4;5;254404;255552;29;509956
93;2020-06-11;6;16;25;310704;288398;39;599102
93;2020-06-11;1;14;18;325559;305827;49;631386
93;2020-06-11;5;7;12;353104;325389;59;678493
93;2020-06-11;2;1;8;336327;296459;69;632786
93;2020-06-11;1;1;3;279820;229699;79;509519
93;2020-06-11;1;0;3;171274;113716;89;284990
93;2020-06-11;2;0;3;58896;21758;90;80654
93;2020-06-11;20;48;84;2639673;2415978;0;5055651
94;2020-06-11;0;0;0;16311;17433;09;33744
94;2020-06-11;0;0;0;16679;18132;19;34811
94;2020-06-11;0;0;0;16782;16579;29;33361
94;2020-06-11;1;1;2;23044;20580;39;43624
94;2020-06-11;0;0;0;23065;22140;49;45205
94;2020-06-11;0;0;0;24549;23421;59;47970
94;2020-06-11;0;0;0;23212;21883;69;45095
94;2020-06-11;0;0;0;19544;17141;79;36685
94;2020-06-11;0;0;0;11227;8178;89;19405
94;2020-06-11;0;0;0;3332;1447;90;4779
94;2020-06-11;1;1;2;177745;166934;0;344679
01;2020-06-12;0;0;0;19979;20155;09;40134
01;2020-06-12;0;0;0;24994;25489;19;50483
01;2020-06-12;0;0;1;17868;16690;29;34558
01;2020-06-12;0;0;0;22328;14821;39;37149
01;2020-06-12;0;0;0;28652;20276;49;48928
01;2020-06-12;0;0;1;33264;27260;59;60524
01;2020-06-12;0;0;0;27135;23978;69;51113
01;2020-06-12;0;0;1;18401;14661;79;33062
01;2020-06-12;0;0;0;9633;6375;89;16008
01;2020-06-12;0;0;0;3410;1510;90;4920
01;2020-06-12;0;0;3;205664;171215;0;376879
02;2020-06-12;0;0;0;16881;17110;09;33991
02;2020-06-12;0;0;0;21410;21604;19;43014
02;2020-06-12;1;0;1;16017;15479;29;31496
02;2020-06-12;0;0;0;19825;14455;39;34280
02;2020-06-12;0;0;0;24719;18248;49;42967
02;2020-06-12;0;0;0;34361;28310;59;62671
02;2020-06-12;0;0;0;28061;24495;69;52556
02;2020-06-12;0;0;0;18231;15278;79;33509
02;2020-06-12;0;0;0;11090;7677;89;18767
02;2020-06-12;0;0;0;3992;1506;90;5498
02;2020-06-12;1;0;1;194587;164162;0;358749
03;2020-06-12;7;9;16;31123;30920;09;62043
03;2020-06-12;14;9;23;29370;29268;19;58638
03;2020-06-12;9;8;17;21458;18963;29;40421
03;2020-06-12;14;13;28;21276;18326;39;39602
03;2020-06-12;14;4;18;18164;16593;49;34757
03;2020-06-12;4;7;11;13469;13557;59;27026
03;2020-06-12;2;7;9;8776;8670;69;17446
03;2020-06-12;1;5;6;3777;3591;79;7368
03;2020-06-12;3;1;4;1649;1072;89;2721
03;2020-06-12;0;0;0;485;184;90;669
03;2020-06-12;68;63;132;149547;141144;0;290691
04;2020-06-12;1;0;1;60314;61377;09;121691
04;2020-06-12;0;1;1;66065;68387;19;134452
04;2020-06-12;1;0;1;51059;47156;29;98215
04;2020-06-12;0;0;0;58788;45780;39;104568
04;2020-06-12;0;0;0;61408;52207;49;113615
04;2020-06-12;0;1;1;64838;60759;59;125597
04;2020-06-12;0;0;0;47008;42843;69;89851
04;2020-06-12;0;0;0;25509;21184;79;46693
04;2020-06-12;0;0;0;13168;7647;89;20815
04;2020-06-12;0;0;0;3209;1253;90;4462
04;2020-06-12;2;2;4;451366;408593;0;859959
05;2020-06-12;0;0;0;362.366008612902;341.338819562748;09;703.704828175651
05;2020-06-12;0;0;0;353.376145114279;370.349735405642;19;723.725880519921
05;2020-06-12;0;0;0;218.593559489256;256.539602589476;29;475.133162078732
05;2020-06-12;0;0;0;404.225408693299;360.321910454353;39;764.547319147651
05;2020-06-12;0;0;0;520.067953604221;497.108383964256;49;1017.17633756848
05;2020-06-12;0;0;0;468.146063921917;510.087601910415;59;978.233665832332
05;2020-06-12;0;0;0;340.368470050554;334.366842191253;69;674.735312241807
05;2020-06-12;0;0;0;212.598666888387;192.597753227106;79;405.196420115493
05;2020-06-12;0;0;0;148.727797095705;61.8681715431829;89;210.595968638888
05;2020-06-12;0;0;0;32.9601271090696;10.9909785719784;90;43.9511056810479
05;2020-06-12;0;0;0;3061.43020057959;2935.56979942041;0;5997
06;2020-06-12;0;1;1;42583;42380;09;84963
06;2020-06-12;3;0;3;33369;31925;19;65294
06;2020-06-12;1;0;2;21571;15080;29;36651
06;2020-06-12;2;5;7;21550;16147;39;37697
06;2020-06-12;0;1;1;14193;13939;49;28132
06;2020-06-12;0;2;2;7171;7597;59;14768
06;2020-06-12;1;2;3;3629;4117;69;7746
06;2020-06-12;0;0;0;1577;1457;79;3034
06;2020-06-12;0;0;0;531;474;89;1005
06;2020-06-12;0;0;0;88;93;90;181
06;2020-06-12;7;11;19;146262;133209;0;279471
07;2020-06-12;0;0;0;485;549;09;1034
07;2020-06-12;0;0;0;403;432;19;835
07;2020-06-12;0;0;0;764;841;29;1605
07;2020-06-12;0;0;0;824;928;39;1752
07;2020-06-12;0;0;0;788;1020;49;1808
07;2020-06-12;0;0;0;678;870;59;1548
07;2020-06-12;0;0;0;360;382;69;742
07;2020-06-12;0;0;0;231;190;79;421
07;2020-06-12;0;0;0;114;67;89;181
07;2020-06-12;0;0;0;24;11;90;35
07;2020-06-12;0;0;0;4671;5290;0;9961
08;2020-06-12;0;0;0;2715.22592983026;2997.75551488675;09;5712.98144471701
08;2020-06-12;0;0;0;2778.51901080978;3160.9156459093;19;5939.43465671908
08;2020-06-12;0;0;0;2080.8882988764;1718.16634315323;29;3799.05464202964
08;2020-06-12;0;0;0;2701.8582062647;1896.52641413317;39;4598.38462039786
08;2020-06-12;0;0;0;3151.45861023308;2460.52498233809;49;5611.98359257117
08;2020-06-12;0;0;0;2620.29868333099;2422.23566154656;59;5042.53434487755
08;2020-06-12;0;0;0;1621.44173420671;1438.58325779464;69;3060.02499200135
08;2020-06-12;0;0;0;626.575909335673;526.358467843651;79;1152.93437717932
08;2020-06-12;0;0;0;205.018522985054;140.993639349697;89;346.012162334751
08;2020-06-12;0;0;0;50.0325684687745;20.62259870351;90;70.6551671722846
08;2020-06-12;0;0;0;18551.3174743414;16782.6825256586;0;35334
11;2020-06-12;0;5;5;783071;811785;09;1594856
11;2020-06-12;6;6;12;761456;784653;19;1546109
11;2020-06-12;14;9;26;850145;801772;29;1651917
11;2020-06-12;9;14;23;914360;843488;39;1757848
11;2020-06-12;7;9;16;845609;826202;49;1671811
11;2020-06-12;7;12;20;793566;745070;59;1538636
11;2020-06-12;6;6;12;628649;549192;69;1177841
11;2020-06-12;4;8;13;434606;358356;79;792962
11;2020-06-12;9;2;11;261425;162933;89;424358
11;2020-06-12;16;2;18;89253;32619;90;121872
11;2020-06-12;78;73;157;6362140;5916070;0;12278210
24;2020-06-12;1;2;3;139720;144686;09;284406
24;2020-06-12;1;0;1;152979;161185;19;314164
24;2020-06-12;0;0;0;122237;126536;29;248773
24;2020-06-12;1;0;1;150359;142009;39;292368
24;2020-06-12;1;0;1;161829;158758;49;320587
24;2020-06-12;0;0;0;172552;168011;59;340563
24;2020-06-12;2;0;2;172509;158177;69;330686
24;2020-06-12;0;0;0;129428;110593;79;240021
24;2020-06-12;1;0;1;87342;56882;89;144224
24;2020-06-12;0;0;0;31210;12071;90;43281
24;2020-06-12;7;2;9;1320165;1238908;0;2559073
27;2020-06-12;0;0;0;143373;149679;09;293052
27;2020-06-12;1;0;2;160962;173003;19;333965
27;2020-06-12;3;0;4;133746;142254;29;276000
27;2020-06-12;0;1;1;160004;155407;39;315411
27;2020-06-12;1;0;2;172333;169564;49;341897
27;2020-06-12;1;2;3;189979;183788;59;373767
27;2020-06-12;0;0;0;192591;178206;69;370797
27;2020-06-12;0;0;0;146876;127546;79;274422
27;2020-06-12;0;0;3;96896;61575;89;158471
27;2020-06-12;0;0;0;33148;12109;90;45257
27;2020-06-12;6;3;15;1429908;1353131;0;2783039
28;2020-06-12;0;0;0;180735;186856;09;367591
28;2020-06-12;1;0;1;200125;213621;19;413746
28;2020-06-12;2;4;6;168922;173007;29;341929
28;2020-06-12;2;0;2;196628;188487;39;385115
28;2020-06-12;0;2;2;205396;201699;49;407095
28;2020-06-12;0;0;0;222002;213866;59;435868
28;2020-06-12;2;0;2;224688;203758;69;428446
28;2020-06-12;0;0;0;163192;135543;79;298735
28;2020-06-12;0;1;1;109691;65377;89;175068
28;2020-06-12;0;0;0;37222;12685;90;49907
28;2020-06-12;7;7;14;1708601;1594899;0;3303500
32;2020-06-12;1;0;1;358062;373689;09;731751
32;2020-06-12;0;0;0;387045;406742;19;793787
32;2020-06-12;1;2;5;342304;348587;29;690891
32;2020-06-12;3;1;4;382485;369972;39;752457
32;2020-06-12;0;1;6;382510;376716;49;759226
32;2020-06-12;1;0;6;386937;376527;59;763464
32;2020-06-12;2;5;8;371211;330938;69;702149
32;2020-06-12;1;1;2;250542;201459;79;452001
32;2020-06-12;1;0;1;163399;89786;89;253185
32;2020-06-12;5;0;5;48384;15367;90;63751
32;2020-06-12;15;10;38;3072879;2889783;0;5962662
44;2020-06-12;0;1;4;291525;306839;09;598364
44;2020-06-12;1;2;6;320255;339504;19;659759
44;2020-06-12;5;2;8;302020;314428;29;616448
44;2020-06-12;4;2;8;342222;333292;39;675514
44;2020-06-12;4;4;8;349727;344491;49;694218
44;2020-06-12;2;3;6;381371;373239;59;754610
44;2020-06-12;0;2;3;367165;335850;69;703015
44;2020-06-12;6;3;10;250387;215436;79;465823
44;2020-06-12;4;0;6;170825;105192;89;276017
44;2020-06-12;1;0;1;51248;16731;90;67979
44;2020-06-12;27;19;60;2826745;2685002;0;5511747
52;2020-06-12;0;0;2;213594;223900;09;437494
52;2020-06-12;0;2;2;240818;255197;19;496015
52;2020-06-12;2;1;4;197010;200630;29;397640
52;2020-06-12;1;0;1;231204;224885;39;456089
52;2020-06-12;4;0;4;243874;243418;49;487292
52;2020-06-12;4;0;6;244100;239116;59;483216
52;2020-06-12;2;1;3;241796;221345;69;463141
52;2020-06-12;0;2;2;177805;149903;79;327708
52;2020-06-12;0;0;0;119561;75822;89;195383
52;2020-06-12;0;0;0;42559;15260;90;57819
52;2020-06-12;13;6;24;1952321;1849476;0;3801797
53;2020-06-12;0;1;1;173813;182358;09;356171
53;2020-06-12;0;0;0;202720;214740;19;417460
53;2020-06-12;0;0;0;163116;173196;29;336312
53;2020-06-12;1;0;1;190526;187674;39;378200
53;2020-06-12;0;0;0;212098;212015;49;424113
53;2020-06-12;0;0;0;223699;219176;59;442875
53;2020-06-12;1;0;1;227435;209274;69;436709
53;2020-06-12;0;0;0;169992;140910;79;310902
53;2020-06-12;0;0;0;118117;69883;89;188000
53;2020-06-12;0;0;0;37370;12267;90;49637
53;2020-06-12;2;1;3;1718886;1621493;0;3340379
75;2020-06-12;0;0;0;293104;305291;09;598395
75;2020-06-12;0;0;0;337141;357785;19;694926
75;2020-06-12;0;0;1;295024;300618;29;595642
75;2020-06-12;0;1;1;347871;331233;39;679104
75;2020-06-12;1;0;2;384742;372771;49;757513
75;2020-06-12;1;1;2;413361;390880;59;804241
75;2020-06-12;1;0;1;425623;384060;69;809683
75;2020-06-12;0;1;1;325086;276298;79;601384
75;2020-06-12;1;0;1;213986;139308;89;353294
75;2020-06-12;0;0;0;77600;28200;90;105800
75;2020-06-12;4;3;9;3113538;2886444;0;5999982
76;2020-06-12;3;1;4;305956;318589;09;624545
76;2020-06-12;2;5;7;338942;356969;19;695911
76;2020-06-12;3;7;10;316210;319570;29;635780
76;2020-06-12;1;1;2;356758;337587;39;694345
76;2020-06-12;10;3;13;376541;363812;49;740353
76;2020-06-12;2;3;5;402608;383750;59;786358
76;2020-06-12;1;1;2;394889;358997;69;753886
76;2020-06-12;0;0;0;308664;263806;79;572470
76;2020-06-12;2;0;2;195838;129272;89;325110
76;2020-06-12;0;0;0;69372;26728;90;96100
76;2020-06-12;24;21;45;3065778;2859080;0;5924858
84;2020-06-12;1;0;3;459549;481088;09;940637
84;2020-06-12;1;4;8;487711;511905;19;999616
84;2020-06-12;2;1;5;443824;451094;29;894918
84;2020-06-12;1;2;3;512522;493262;39;1005784
84;2020-06-12;4;3;7;520248;515106;49;1035354
84;2020-06-12;0;4;5;529611;514848;59;1044459
84;2020-06-12;1;0;1;486720;439940;69;926660
84;2020-06-12;2;4;7;372151;315211;79;687362
84;2020-06-12;2;0;2;237198;150524;89;387722
84;2020-06-12;0;0;0;81185;28680;90;109865
84;2020-06-12;14;18;41;4130719;3901658;0;8032377
93;2020-06-12;0;1;5;268834;283093;09;551927
93;2020-06-12;0;0;2;280751;296087;19;576838
93;2020-06-12;4;2;7;254404;255552;29;509956
93;2020-06-12;1;4;7;310704;288398;39;599102
93;2020-06-12;2;7;9;325559;305827;49;631386
93;2020-06-12;0;4;4;353104;325389;59;678493
93;2020-06-12;1;1;4;336327;296459;69;632786
93;2020-06-12;0;0;0;279820;229699;79;509519
93;2020-06-12;1;0;1;171274;113716;89;284990
93;2020-06-12;0;0;0;58896;21758;90;80654
93;2020-06-12;9;19;39;2639673;2415978;0;5055651
94;2020-06-12;0;0;0;16311;17433;09;33744
94;2020-06-12;0;0;0;16679;18132;19;34811
94;2020-06-12;0;0;0;16782;16579;29;33361
94;2020-06-12;0;0;0;23044;20580;39;43624
94;2020-06-12;0;0;0;23065;22140;49;45205
94;2020-06-12;0;0;0;24549;23421;59;47970
94;2020-06-12;0;0;0;23212;21883;69;45095
94;2020-06-12;0;0;0;19544;17141;79;36685
94;2020-06-12;0;0;0;11227;8178;89;19405
94;2020-06-12;0;0;0;3332;1447;90;4779
94;2020-06-12;0;0;0;177745;166934;0;344679
01;2020-06-13;0;0;0;19979;20155;09;40134
01;2020-06-13;0;0;0;24994;25489;19;50483
01;2020-06-13;0;0;0;17868;16690;29;34558
01;2020-06-13;0;0;0;22328;14821;39;37149
01;2020-06-13;0;0;0;28652;20276;49;48928
01;2020-06-13;0;0;0;33264;27260;59;60524
01;2020-06-13;0;0;0;27135;23978;69;51113
01;2020-06-13;0;0;0;18401;14661;79;33062
01;2020-06-13;0;0;0;9633;6375;89;16008
01;2020-06-13;0;0;0;3410;1510;90;4920
01;2020-06-13;0;0;0;205664;171215;0;376879
02;2020-06-13;0;0;0;16881;17110;09;33991
02;2020-06-13;0;0;0;21410;21604;19;43014
02;2020-06-13;0;0;0;16017;15479;29;31496
02;2020-06-13;0;0;0;19825;14455;39;34280
02;2020-06-13;2;1;3;24719;18248;49;42967
02;2020-06-13;0;0;0;34361;28310;59;62671
02;2020-06-13;0;2;2;28061;24495;69;52556
02;2020-06-13;0;0;0;18231;15278;79;33509
02;2020-06-13;0;0;0;11090;7677;89;18767
02;2020-06-13;0;0;0;3992;1506;90;5498
02;2020-06-13;2;3;5;194587;164162;0;358749
03;2020-06-13;2;1;4;31123;30920;09;62043
03;2020-06-13;2;6;8;29370;29268;19;58638
03;2020-06-13;5;9;14;21458;18963;29;40421
03;2020-06-13;7;7;14;21276;18326;39;39602
03;2020-06-13;8;7;15;18164;16593;49;34757
03;2020-06-13;3;4;7;13469;13557;59;27026
03;2020-06-13;4;2;6;8776;8670;69;17446
03;2020-06-13;3;1;4;3777;3591;79;7368
03;2020-06-13;1;0;1;1649;1072;89;2721
03;2020-06-13;0;0;0;485;184;90;669
03;2020-06-13;35;37;73;149547;141144;0;290691
04;2020-06-13;0;0;0;60314;61377;09;121691
04;2020-06-13;0;0;0;66065;68387;19;134452
04;2020-06-13;0;0;0;51059;47156;29;98215
04;2020-06-13;0;0;0;58788;45780;39;104568
04;2020-06-13;0;0;0;61408;52207;49;113615
04;2020-06-13;0;0;0;64838;60759;59;125597
04;2020-06-13;0;1;1;47008;42843;69;89851
04;2020-06-13;0;0;0;25509;21184;79;46693
04;2020-06-13;0;0;0;13168;7647;89;20815
04;2020-06-13;0;0;0;3209;1253;90;4462
04;2020-06-13;0;1;1;451366;408593;0;859959
05;2020-06-13;0;0;0;362.366008612902;341.338819562748;09;703.704828175651
05;2020-06-13;0;0;0;353.376145114279;370.349735405642;19;723.725880519921
05;2020-06-13;0;0;0;218.593559489256;256.539602589476;29;475.133162078732
05;2020-06-13;0;0;0;404.225408693299;360.321910454353;39;764.547319147651
05;2020-06-13;0;0;0;520.067953604221;497.108383964256;49;1017.17633756848
05;2020-06-13;0;0;0;468.146063921917;510.087601910415;59;978.233665832332
05;2020-06-13;0;0;0;340.368470050554;334.366842191253;69;674.735312241807
05;2020-06-13;0;0;0;212.598666888387;192.597753227106;79;405.196420115493
05;2020-06-13;0;0;0;148.727797095705;61.8681715431829;89;210.595968638888
05;2020-06-13;0;0;0;32.9601271090696;10.9909785719784;90;43.9511056810479
05;2020-06-13;0;0;0;3061.43020057959;2935.56979942041;0;5997
06;2020-06-13;0;0;0;42583;42380;09;84963
06;2020-06-13;1;1;2;33369;31925;19;65294
06;2020-06-13;1;3;4;21571;15080;29;36651
06;2020-06-13;3;1;4;21550;16147;39;37697
06;2020-06-13;0;2;2;14193;13939;49;28132
06;2020-06-13;1;0;1;7171;7597;59;14768
06;2020-06-13;0;1;1;3629;4117;69;7746
06;2020-06-13;0;0;0;1577;1457;79;3034
06;2020-06-13;0;0;0;531;474;89;1005
06;2020-06-13;0;0;0;88;93;90;181
06;2020-06-13;6;8;14;146262;133209;0;279471
07;2020-06-13;0;0;0;485;549;09;1034
07;2020-06-13;0;0;0;403;432;19;835
07;2020-06-13;0;0;0;764;841;29;1605
07;2020-06-13;0;0;0;824;928;39;1752
07;2020-06-13;0;0;0;788;1020;49;1808
07;2020-06-13;0;0;0;678;870;59;1548
07;2020-06-13;0;0;0;360;382;69;742
07;2020-06-13;0;0;0;231;190;79;421
07;2020-06-13;0;0;0;114;67;89;181
07;2020-06-13;0;0;0;24;11;90;35
07;2020-06-13;0;0;0;4671;5290;0;9961
08;2020-06-13;0;0;0;2715.22592983026;2997.75551488675;09;5712.98144471701
08;2020-06-13;0;0;0;2778.51901080978;3160.9156459093;19;5939.43465671908
08;2020-06-13;0;0;0;2080.8882988764;1718.16634315323;29;3799.05464202964
08;2020-06-13;0;0;0;2701.8582062647;1896.52641413317;39;4598.38462039786
08;2020-06-13;0;0;0;3151.45861023308;2460.52498233809;49;5611.98359257117
08;2020-06-13;0;0;0;2620.29868333099;2422.23566154656;59;5042.53434487755
08;2020-06-13;0;0;0;1621.44173420671;1438.58325779464;69;3060.02499200135
08;2020-06-13;0;0;0;626.575909335673;526.358467843651;79;1152.93437717932
08;2020-06-13;0;0;0;205.018522985054;140.993639349697;89;346.012162334751
08;2020-06-13;0;0;0;50.0325684687745;20.62259870351;90;70.6551671722846
08;2020-06-13;0;0;0;18551.3174743414;16782.6825256586;0;35334
11;2020-06-13;1;1;2;783071;811785;09;1594856
11;2020-06-13;2;0;2;761456;784653;19;1546109
11;2020-06-13;5;3;8;850145;801772;29;1651917
11;2020-06-13;1;2;3;914360;843488;39;1757848
11;2020-06-13;3;2;5;845609;826202;49;1671811
11;2020-06-13;2;1;3;793566;745070;59;1538636
11;2020-06-13;2;4;6;628649;549192;69;1177841
11;2020-06-13;0;1;1;434606;358356;79;792962
11;2020-06-13;2;1;3;261425;162933;89;424358
11;2020-06-13;2;0;2;89253;32619;90;121872
11;2020-06-13;20;15;35;6362140;5916070;0;12278210
24;2020-06-13;1;0;1;139720;144686;09;284406
24;2020-06-13;0;0;0;152979;161185;19;314164
24;2020-06-13;1;0;1;122237;126536;29;248773
24;2020-06-13;0;0;0;150359;142009;39;292368
24;2020-06-13;1;0;1;161829;158758;49;320587
24;2020-06-13;0;2;2;172552;168011;59;340563
24;2020-06-13;0;0;1;172509;158177;69;330686
24;2020-06-13;0;0;0;129428;110593;79;240021
24;2020-06-13;0;0;0;87342;56882;89;144224
24;2020-06-13;0;0;0;31210;12071;90;43281
24;2020-06-13;3;2;6;1320165;1238908;0;2559073
27;2020-06-13;0;0;0;143373;149679;09;293052
27;2020-06-13;0;0;0;160962;173003;19;333965
27;2020-06-13;0;0;0;133746;142254;29;276000
27;2020-06-13;0;0;1;160004;155407;39;315411
27;2020-06-13;0;0;0;172333;169564;49;341897
27;2020-06-13;0;0;0;189979;183788;59;373767
27;2020-06-13;0;0;0;192591;178206;69;370797
27;2020-06-13;0;0;0;146876;127546;79;274422
27;2020-06-13;0;0;0;96896;61575;89;158471
27;2020-06-13;0;0;0;33148;12109;90;45257
27;2020-06-13;0;0;1;1429908;1353131;0;2783039
28;2020-06-13;1;3;4;180735;186856;09;367591
28;2020-06-13;0;0;0;200125;213621;19;413746
28;2020-06-13;0;0;0;168922;173007;29;341929
28;2020-06-13;4;0;4;196628;188487;39;385115
28;2020-06-13;0;0;0;205396;201699;49;407095
28;2020-06-13;0;1;1;222002;213866;59;435868
28;2020-06-13;1;0;1;224688;203758;69;428446
28;2020-06-13;2;0;2;163192;135543;79;298735
28;2020-06-13;0;1;1;109691;65377;89;175068
28;2020-06-13;1;0;1;37222;12685;90;49907
28;2020-06-13;9;5;14;1708601;1594899;0;3303500
32;2020-06-13;0;0;0;358062;373689;09;731751
32;2020-06-13;1;1;2;387045;406742;19;793787
32;2020-06-13;0;0;0;342304;348587;29;690891
32;2020-06-13;1;1;2;382485;369972;39;752457
32;2020-06-13;0;0;0;382510;376716;49;759226
32;2020-06-13;1;1;3;386937;376527;59;763464
32;2020-06-13;0;1;1;371211;330938;69;702149
32;2020-06-13;0;1;1;250542;201459;79;452001
32;2020-06-13;3;1;6;163399;89786;89;253185
32;2020-06-13;0;0;1;48384;15367;90;63751
32;2020-06-13;6;6;16;3072879;2889783;0;5962662
44;2020-06-13;0;0;0;291525;306839;09;598364
44;2020-06-13;0;1;2;320255;339504;19;659759
44;2020-06-13;1;0;1;302020;314428;29;616448
44;2020-06-13;0;0;2;342222;333292;39;675514
44;2020-06-13;0;0;1;349727;344491;49;694218
44;2020-06-13;1;0;1;381371;373239;59;754610
44;2020-06-13;0;1;1;367165;335850;69;703015
44;2020-06-13;0;1;2;250387;215436;79;465823
44;2020-06-13;1;1;2;170825;105192;89;276017
44;2020-06-13;1;0;1;51248;16731;90;67979
44;2020-06-13;4;4;13;2826745;2685002;0;5511747
52;2020-06-13;0;0;0;213594;223900;09;437494
52;2020-06-13;1;1;2;240818;255197;19;496015
52;2020-06-13;1;0;1;197010;200630;29;397640
52;2020-06-13;0;0;0;231204;224885;39;456089
52;2020-06-13;0;1;2;243874;243418;49;487292
52;2020-06-13;0;0;0;244100;239116;59;483216
52;2020-06-13;0;0;0;241796;221345;69;463141
52;2020-06-13;1;1;2;177805;149903;79;327708
52;2020-06-13;0;0;1;119561;75822;89;195383
52;2020-06-13;0;1;1;42559;15260;90;57819
52;2020-06-13;3;4;9;1952321;1849476;0;3801797
53;2020-06-13;0;0;0;173813;182358;09;356171
53;2020-06-13;0;0;0;202720;214740;19;417460
53;2020-06-13;0;0;0;163116;173196;29;336312
53;2020-06-13;0;0;0;190526;187674;39;378200
53;2020-06-13;0;0;0;212098;212015;49;424113
53;2020-06-13;0;0;0;223699;219176;59;442875
53;2020-06-13;0;0;0;227435;209274;69;436709
53;2020-06-13;0;0;0;169992;140910;79;310902
53;2020-06-13;0;0;0;118117;69883;89;188000
53;2020-06-13;0;0;0;37370;12267;90;49637
53;2020-06-13;0;0;0;1718886;1621493;0;3340379
75;2020-06-13;1;0;1;293104;305291;09;598395
75;2020-06-13;2;0;2;337141;357785;19;694926
75;2020-06-13;1;0;2;295024;300618;29;595642
75;2020-06-13;0;0;0;347871;331233;39;679104
75;2020-06-13;0;0;0;384742;372771;49;757513
75;2020-06-13;0;0;0;413361;390880;59;804241
75;2020-06-13;0;0;0;425623;384060;69;809683
75;2020-06-13;1;0;1;325086;276298;79;601384
75;2020-06-13;0;1;1;213986;139308;89;353294
75;2020-06-13;0;0;0;77600;28200;90;105800
75;2020-06-13;5;1;7;3113538;2886444;0;5999982
76;2020-06-13;0;0;0;305956;318589;09;624545
76;2020-06-13;0;0;0;338942;356969;19;695911
76;2020-06-13;1;1;2;316210;319570;29;635780
76;2020-06-13;0;0;0;356758;337587;39;694345
76;2020-06-13;0;1;1;376541;363812;49;740353
76;2020-06-13;0;1;1;402608;383750;59;786358
76;2020-06-13;0;0;0;394889;358997;69;753886
76;2020-06-13;1;0;1;308664;263806;79;572470
76;2020-06-13;0;0;0;195838;129272;89;325110
76;2020-06-13;0;0;0;69372;26728;90;96100
76;2020-06-13;2;3;5;3065778;2859080;0;5924858
84;2020-06-13;0;0;0;459549;481088;09;940637
84;2020-06-13;0;0;0;487711;511905;19;999616
84;2020-06-13;1;0;2;443824;451094;29;894918
84;2020-06-13;1;1;2;512522;493262;39;1005784
84;2020-06-13;0;2;2;520248;515106;49;1035354
84;2020-06-13;0;0;0;529611;514848;59;1044459
84;2020-06-13;0;0;0;486720;439940;69;926660
84;2020-06-13;0;1;1;372151;315211;79;687362
84;2020-06-13;0;0;0;237198;150524;89;387722
84;2020-06-13;0;0;0;81185;28680;90;109865
84;2020-06-13;2;4;7;4130719;3901658;0;8032377
93;2020-06-13;0;0;0;268834;283093;09;551927
93;2020-06-13;0;0;0;280751;296087;19;576838
93;2020-06-13;0;1;2;254404;255552;29;509956
93;2020-06-13;2;1;3;310704;288398;39;599102
93;2020-06-13;0;1;1;325559;305827;49;631386
93;2020-06-13;1;1;2;353104;325389;59;678493
93;2020-06-13;0;0;0;336327;296459;69;632786
93;2020-06-13;0;1;1;279820;229699;79;509519
93;2020-06-13;0;0;0;171274;113716;89;284990
93;2020-06-13;0;0;0;58896;21758;90;80654
93;2020-06-13;3;5;9;2639673;2415978;0;5055651
94;2020-06-13;0;0;0;16311;17433;09;33744
94;2020-06-13;0;0;0;16679;18132;19;34811
94;2020-06-13;0;0;0;16782;16579;29;33361
94;2020-06-13;0;0;0;23044;20580;39;43624
94;2020-06-13;0;0;0;23065;22140;49;45205
94;2020-06-13;0;0;0;24549;23421;59;47970
94;2020-06-13;0;0;0;23212;21883;69;45095
94;2020-06-13;0;0;0;19544;17141;79;36685
94;2020-06-13;0;0;0;11227;8178;89;19405
94;2020-06-13;0;0;0;3332;1447;90;4779
94;2020-06-13;0;0;0;177745;166934;0;344679
01;2020-06-14;0;0;0;19979;20155;09;40134
01;2020-06-14;0;0;0;24994;25489;19;50483
01;2020-06-14;0;0;0;17868;16690;29;34558
01;2020-06-14;0;0;0;22328;14821;39;37149
01;2020-06-14;0;0;0;28652;20276;49;48928
01;2020-06-14;0;0;0;33264;27260;59;60524
01;2020-06-14;0;0;0;27135;23978;69;51113
01;2020-06-14;0;0;0;18401;14661;79;33062
01;2020-06-14;0;0;0;9633;6375;89;16008
01;2020-06-14;0;0;0;3410;1510;90;4920
01;2020-06-14;0;0;0;205664;171215;0;376879
02;2020-06-14;0;0;0;16881;17110;09;33991
02;2020-06-14;0;0;0;21410;21604;19;43014
02;2020-06-14;0;0;0;16017;15479;29;31496
02;2020-06-14;0;0;0;19825;14455;39;34280
02;2020-06-14;0;0;0;24719;18248;49;42967
02;2020-06-14;0;0;0;34361;28310;59;62671
02;2020-06-14;0;0;1;28061;24495;69;52556
02;2020-06-14;0;0;0;18231;15278;79;33509
02;2020-06-14;0;0;0;11090;7677;89;18767
02;2020-06-14;0;0;0;3992;1506;90;5498
02;2020-06-14;0;0;1;194587;164162;0;358749
03;2020-06-14;3;1;4;31123;30920;09;62043
03;2020-06-14;1;0;5;29370;29268;19;58638
03;2020-06-14;6;2;13;21458;18963;29;40421
03;2020-06-14;12;6;19;21276;18326;39;39602
03;2020-06-14;4;3;8;18164;16593;49;34757
03;2020-06-14;2;2;5;13469;13557;59;27026
03;2020-06-14;7;2;10;8776;8670;69;17446
03;2020-06-14;0;0;0;3777;3591;79;7368
03;2020-06-14;0;0;0;1649;1072;89;2721
03;2020-06-14;0;0;0;485;184;90;669
03;2020-06-14;35;16;64;149547;141144;0;290691
04;2020-06-14;0;0;0;60314;61377;09;121691
04;2020-06-14;0;0;0;66065;68387;19;134452
04;2020-06-14;0;0;0;51059;47156;29;98215
04;2020-06-14;0;0;0;58788;45780;39;104568
04;2020-06-14;0;0;0;61408;52207;49;113615
04;2020-06-14;0;0;0;64838;60759;59;125597
04;2020-06-14;0;0;0;47008;42843;69;89851
04;2020-06-14;0;0;0;25509;21184;79;46693
04;2020-06-14;0;0;0;13168;7647;89;20815
04;2020-06-14;0;0;0;3209;1253;90;4462
04;2020-06-14;0;0;0;451366;408593;0;859959
05;2020-06-14;0;0;0;362.366008612902;341.338819562748;09;703.704828175651
05;2020-06-14;0;0;0;353.376145114279;370.349735405642;19;723.725880519921
05;2020-06-14;0;0;0;218.593559489256;256.539602589476;29;475.133162078732
05;2020-06-14;0;0;0;404.225408693299;360.321910454353;39;764.547319147651
05;2020-06-14;0;0;0;520.067953604221;497.108383964256;49;1017.17633756848
05;2020-06-14;0;0;0;468.146063921917;510.087601910415;59;978.233665832332
05;2020-06-14;0;0;0;340.368470050554;334.366842191253;69;674.735312241807
05;2020-06-14;0;0;0;212.598666888387;192.597753227106;79;405.196420115493
05;2020-06-14;0;0;0;148.727797095705;61.8681715431829;89;210.595968638888
05;2020-06-14;0;0;0;32.9601271090696;10.9909785719784;90;43.9511056810479
05;2020-06-14;0;0;0;3061.43020057959;2935.56979942041;0;5997
06;2020-06-14;0;0;0;42583;42380;09;84963
06;2020-06-14;0;0;0;33369;31925;19;65294
06;2020-06-14;0;0;0;21571;15080;29;36651
06;2020-06-14;1;0;1;21550;16147;39;37697
06;2020-06-14;0;0;0;14193;13939;49;28132
06;2020-06-14;0;0;0;7171;7597;59;14768
06;2020-06-14;0;0;0;3629;4117;69;7746
06;2020-06-14;0;0;0;1577;1457;79;3034
06;2020-06-14;0;1;1;531;474;89;1005
06;2020-06-14;0;0;0;88;93;90;181
06;2020-06-14;1;1;2;146262;133209;0;279471
07;2020-06-14;0;0;0;485;549;09;1034
07;2020-06-14;0;0;0;403;432;19;835
07;2020-06-14;0;0;0;764;841;29;1605
07;2020-06-14;0;0;0;824;928;39;1752
07;2020-06-14;0;0;0;788;1020;49;1808
07;2020-06-14;0;0;0;678;870;59;1548
07;2020-06-14;0;0;0;360;382;69;742
07;2020-06-14;0;0;0;231;190;79;421
07;2020-06-14;0;0;0;114;67;89;181
07;2020-06-14;0;0;0;24;11;90;35
07;2020-06-14;0;0;0;4671;5290;0;9961
08;2020-06-14;0;0;0;2715.22592983026;2997.75551488675;09;5712.98144471701
08;2020-06-14;0;0;0;2778.51901080978;3160.9156459093;19;5939.43465671908
08;2020-06-14;0;0;0;2080.8882988764;1718.16634315323;29;3799.05464202964
08;2020-06-14;0;0;0;2701.8582062647;1896.52641413317;39;4598.38462039786
08;2020-06-14;0;0;0;3151.45861023308;2460.52498233809;49;5611.98359257117
08;2020-06-14;0;0;0;2620.29868333099;2422.23566154656;59;5042.53434487755
08;2020-06-14;0;0;0;1621.44173420671;1438.58325779464;69;3060.02499200135
08;2020-06-14;0;0;0;626.575909335673;526.358467843651;79;1152.93437717932
08;2020-06-14;0;0;0;205.018522985054;140.993639349697;89;346.012162334751
08;2020-06-14;0;0;0;50.0325684687745;20.62259870351;90;70.6551671722846
08;2020-06-14;0;0;0;18551.3174743414;16782.6825256586;0;35334
11;2020-06-14;0;2;2;783071;811785;09;1594856
11;2020-06-14;0;0;0;761456;784653;19;1546109
11;2020-06-14;1;1;2;850145;801772;29;1651917
11;2020-06-14;0;1;1;914360;843488;39;1757848
11;2020-06-14;1;1;2;845609;826202;49;1671811
11;2020-06-14;1;1;2;793566;745070;59;1538636
11;2020-06-14;0;4;4;628649;549192;69;1177841
11;2020-06-14;1;1;2;434606;358356;79;792962
11;2020-06-14;0;1;1;261425;162933;89;424358
11;2020-06-14;2;0;2;89253;32619;90;121872
11;2020-06-14;6;12;18;6362140;5916070;0;12278210
24;2020-06-14;0;0;0;139720;144686;09;284406
24;2020-06-14;0;0;0;152979;161185;19;314164
24;2020-06-14;0;0;0;122237;126536;29;248773
24;2020-06-14;0;0;0;150359;142009;39;292368
24;2020-06-14;0;0;0;161829;158758;49;320587
24;2020-06-14;0;0;0;172552;168011;59;340563
24;2020-06-14;0;2;2;172509;158177;69;330686
24;2020-06-14;0;0;0;129428;110593;79;240021
24;2020-06-14;0;0;0;87342;56882;89;144224
24;2020-06-14;0;0;0;31210;12071;90;43281
24;2020-06-14;0;2;2;1320165;1238908;0;2559073
27;2020-06-14;0;0;0;143373;149679;09;293052
27;2020-06-14;0;0;0;160962;173003;19;333965
27;2020-06-14;0;0;0;133746;142254;29;276000
27;2020-06-14;0;0;0;160004;155407;39;315411
27;2020-06-14;0;0;0;172333;169564;49;341897
27;2020-06-14;0;0;1;189979;183788;59;373767
27;2020-06-14;0;0;0;192591;178206;69;370797
27;2020-06-14;1;0;1;146876;127546;79;274422
27;2020-06-14;0;1;1;96896;61575;89;158471
27;2020-06-14;0;0;0;33148;12109;90;45257
27;2020-06-14;1;1;3;1429908;1353131;0;2783039
28;2020-06-14;0;0;0;180735;186856;09;367591
28;2020-06-14;1;0;1;200125;213621;19;413746
28;2020-06-14;0;0;0;168922;173007;29;341929
28;2020-06-14;2;0;2;196628;188487;39;385115
28;2020-06-14;0;2;2;205396;201699;49;407095
28;2020-06-14;0;0;0;222002;213866;59;435868
28;2020-06-14;0;2;2;224688;203758;69;428446
28;2020-06-14;0;0;0;163192;135543;79;298735
28;2020-06-14;0;0;0;109691;65377;89;175068
28;2020-06-14;0;0;0;37222;12685;90;49907
28;2020-06-14;3;4;7;1708601;1594899;0;3303500
32;2020-06-14;0;2;2;358062;373689;09;731751
32;2020-06-14;1;0;1;387045;406742;19;793787
32;2020-06-14;1;0;1;342304;348587;29;690891
32;2020-06-14;2;1;4;382485;369972;39;752457
32;2020-06-14;0;0;0;382510;376716;49;759226
32;2020-06-14;0;0;0;386937;376527;59;763464
32;2020-06-14;0;0;0;371211;330938;69;702149
32;2020-06-14;2;0;3;250542;201459;79;452001
32;2020-06-14;0;1;1;163399;89786;89;253185
32;2020-06-14;0;0;0;48384;15367;90;63751
32;2020-06-14;6;4;12;3072879;2889783;0;5962662
44;2020-06-14;0;0;0;291525;306839;09;598364
44;2020-06-14;0;0;0;320255;339504;19;659759
44;2020-06-14;0;0;0;302020;314428;29;616448
44;2020-06-14;0;0;0;342222;333292;39;675514
44;2020-06-14;0;0;0;349727;344491;49;694218
44;2020-06-14;0;1;1;381371;373239;59;754610
44;2020-06-14;0;0;0;367165;335850;69;703015
44;2020-06-14;1;0;1;250387;215436;79;465823
44;2020-06-14;1;0;1;170825;105192;89;276017
44;2020-06-14;1;0;1;51248;16731;90;67979
44;2020-06-14;3;1;4;2826745;2685002;0;5511747
52;2020-06-14;0;0;1;213594;223900;09;437494
52;2020-06-14;0;0;0;240818;255197;19;496015
52;2020-06-14;0;0;0;197010;200630;29;397640
52;2020-06-14;0;0;0;231204;224885;39;456089
52;2020-06-14;0;0;0;243874;243418;49;487292
52;2020-06-14;0;0;0;244100;239116;59;483216
52;2020-06-14;0;0;0;241796;221345;69;463141
52;2020-06-14;0;0;0;177805;149903;79;327708
52;2020-06-14;1;0;1;119561;75822;89;195383
52;2020-06-14;0;0;0;42559;15260;90;57819
52;2020-06-14;1;0;2;1952321;1849476;0;3801797
53;2020-06-14;0;0;0;173813;182358;09;356171
53;2020-06-14;0;0;1;202720;214740;19;417460
53;2020-06-14;0;0;0;163116;173196;29;336312
53;2020-06-14;0;0;0;190526;187674;39;378200
53;2020-06-14;0;0;0;212098;212015;49;424113
53;2020-06-14;0;0;0;223699;219176;59;442875
53;2020-06-14;0;0;0;227435;209274;69;436709
53;2020-06-14;0;0;0;169992;140910;79;310902
53;2020-06-14;0;0;0;118117;69883;89;188000
53;2020-06-14;0;1;1;37370;12267;90;49637
53;2020-06-14;0;1;2;1718886;1621493;0;3340379
75;2020-06-14;0;0;0;293104;305291;09;598395
75;2020-06-14;0;0;0;337141;357785;19;694926
75;2020-06-14;0;0;0;295024;300618;29;595642
75;2020-06-14;0;0;0;347871;331233;39;679104
75;2020-06-14;0;1;1;384742;372771;49;757513
75;2020-06-14;0;0;0;413361;390880;59;804241
75;2020-06-14;0;0;0;425623;384060;69;809683
75;2020-06-14;0;0;0;325086;276298;79;601384
75;2020-06-14;0;0;0;213986;139308;89;353294
75;2020-06-14;0;0;0;77600;28200;90;105800
75;2020-06-14;0;1;1;3113538;2886444;0;5999982
76;2020-06-14;0;0;0;305956;318589;09;624545
76;2020-06-14;0;0;0;338942;356969;19;695911
76;2020-06-14;0;0;0;316210;319570;29;635780
76;2020-06-14;0;0;0;356758;337587;39;694345
76;2020-06-14;0;0;0;376541;363812;49;740353
76;2020-06-14;1;0;1;402608;383750;59;786358
76;2020-06-14;0;0;0;394889;358997;69;753886
76;2020-06-14;0;0;0;308664;263806;79;572470
76;2020-06-14;0;0;0;195838;129272;89;325110
76;2020-06-14;0;0;0;69372;26728;90;96100
76;2020-06-14;1;0;1;3065778;2859080;0;5924858
84;2020-06-14;0;0;0;459549;481088;09;940637
84;2020-06-14;0;0;0;487711;511905;19;999616
84;2020-06-14;1;0;1;443824;451094;29;894918
84;2020-06-14;1;0;1;512522;493262;39;1005784
84;2020-06-14;0;0;0;520248;515106;49;1035354
84;2020-06-14;1;2;3;529611;514848;59;1044459
84;2020-06-14;0;0;0;486720;439940;69;926660
84;2020-06-14;0;0;0;372151;315211;79;687362
84;2020-06-14;4;0;4;237198;150524;89;387722
84;2020-06-14;0;1;1;81185;28680;90;109865
84;2020-06-14;7;3;10;4130719;3901658;0;8032377
93;2020-06-14;0;0;0;268834;283093;09;551927
93;2020-06-14;0;0;0;280751;296087;19;576838
93;2020-06-14;0;0;0;254404;255552;29;509956
93;2020-06-14;0;0;0;310704;288398;39;599102
93;2020-06-14;1;0;1;325559;305827;49;631386
93;2020-06-14;0;0;1;353104;325389;59;678493
93;2020-06-14;0;0;0;336327;296459;69;632786
93;2020-06-14;0;1;1;279820;229699;79;509519
93;2020-06-14;1;0;1;171274;113716;89;284990
93;2020-06-14;0;0;0;58896;21758;90;80654
93;2020-06-14;2;1;4;2639673;2415978;0;5055651
94;2020-06-14;0;0;0;16311;17433;09;33744
94;2020-06-14;0;0;0;16679;18132;19;34811
94;2020-06-14;0;0;0;16782;16579;29;33361
94;2020-06-14;0;0;0;23044;20580;39;43624
94;2020-06-14;0;0;0;23065;22140;49;45205
94;2020-06-14;0;0;0;24549;23421;59;47970
94;2020-06-14;0;0;0;23212;21883;69;45095
94;2020-06-14;0;0;0;19544;17141;79;36685
94;2020-06-14;0;0;0;11227;8178;89;19405
94;2020-06-14;0;0;0;3332;1447;90;4779
94;2020-06-14;0;0;0;177745;166934;0;344679
01;2020-06-15;0;0;0;19979;20155;09;40134
01;2020-06-15;0;0;0;24994;25489;19;50483
01;2020-06-15;0;0;0;17868;16690;29;34558
01;2020-06-15;0;1;1;22328;14821;39;37149
01;2020-06-15;0;0;0;28652;20276;49;48928
01;2020-06-15;0;0;0;33264;27260;59;60524
01;2020-06-15;0;0;0;27135;23978;69;51113
01;2020-06-15;0;0;0;18401;14661;79;33062
01;2020-06-15;0;0;0;9633;6375;89;16008
01;2020-06-15;0;0;0;3410;1510;90;4920
01;2020-06-15;0;1;1;205664;171215;0;376879
02;2020-06-15;0;0;0;16881;17110;09;33991
02;2020-06-15;0;0;0;21410;21604;19;43014
02;2020-06-15;1;1;2;16017;15479;29;31496
02;2020-06-15;0;0;0;19825;14455;39;34280
02;2020-06-15;0;0;0;24719;18248;49;42967
02;2020-06-15;0;0;0;34361;28310;59;62671
02;2020-06-15;0;0;0;28061;24495;69;52556
02;2020-06-15;0;0;0;18231;15278;79;33509
02;2020-06-15;0;0;0;11090;7677;89;18767
02;2020-06-15;0;0;0;3992;1506;90;5498
02;2020-06-15;1;1;2;194587;164162;0;358749
03;2020-06-15;1;2;4;31123;30920;09;62043
03;2020-06-15;8;4;12;29370;29268;19;58638
03;2020-06-15;9;7;16;21458;18963;29;40421
03;2020-06-15;12;6;18;21276;18326;39;39602
03;2020-06-15;4;7;12;18164;16593;49;34757
03;2020-06-15;5;6;11;13469;13557;59;27026
03;2020-06-15;5;4;9;8776;8670;69;17446
03;2020-06-15;0;3;3;3777;3591;79;7368
03;2020-06-15;0;0;0;1649;1072;89;2721
03;2020-06-15;0;0;0;485;184;90;669
03;2020-06-15;44;39;85;149547;141144;0;290691
04;2020-06-15;0;0;0;60314;61377;09;121691
04;2020-06-15;0;0;0;66065;68387;19;134452
04;2020-06-15;0;0;0;51059;47156;29;98215
04;2020-06-15;0;3;3;58788;45780;39;104568
04;2020-06-15;0;0;0;61408;52207;49;113615
04;2020-06-15;0;0;0;64838;60759;59;125597
04;2020-06-15;0;0;0;47008;42843;69;89851
04;2020-06-15;0;0;0;25509;21184;79;46693
04;2020-06-15;0;0;0;13168;7647;89;20815
04;2020-06-15;0;0;0;3209;1253;90;4462
04;2020-06-15;0;3;3;451366;408593;0;859959
05;2020-06-15;0;0;0;362.366008612902;341.338819562748;09;703.704828175651
05;2020-06-15;0;0;0;353.376145114279;370.349735405642;19;723.725880519921
05;2020-06-15;0;0;0;218.593559489256;256.539602589476;29;475.133162078732
05;2020-06-15;0;0;0;404.225408693299;360.321910454353;39;764.547319147651
05;2020-06-15;0;0;0;520.067953604221;497.108383964256;49;1017.17633756848
05;2020-06-15;0;0;0;468.146063921917;510.087601910415;59;978.233665832332
05;2020-06-15;0;0;0;340.368470050554;334.366842191253;69;674.735312241807
05;2020-06-15;0;0;0;212.598666888387;192.597753227106;79;405.196420115493
05;2020-06-15;0;0;0;148.727797095705;61.8681715431829;89;210.595968638888
05;2020-06-15;0;0;0;32.9601271090696;10.9909785719784;90;43.9511056810479
05;2020-06-15;0;0;0;3061.43020057959;2935.56979942041;0;5997
06;2020-06-15;0;0;0;42583;42380;09;84963
06;2020-06-15;1;0;1;33369;31925;19;65294
06;2020-06-15;3;3;7;21571;15080;29;36651
06;2020-06-15;4;3;7;21550;16147;39;37697
06;2020-06-15;1;2;4;14193;13939;49;28132
06;2020-06-15;2;1;4;7171;7597;59;14768
06;2020-06-15;1;0;1;3629;4117;69;7746
06;2020-06-15;0;0;0;1577;1457;79;3034
06;2020-06-15;0;0;0;531;474;89;1005
06;2020-06-15;0;0;0;88;93;90;181
06;2020-06-15;12;9;24;146262;133209;0;279471
07;2020-06-15;0;0;0;485;549;09;1034
07;2020-06-15;0;0;0;403;432;19;835
07;2020-06-15;0;0;0;764;841;29;1605
07;2020-06-15;0;0;0;824;928;39;1752
07;2020-06-15;0;0;0;788;1020;49;1808
07;2020-06-15;0;0;0;678;870;59;1548
07;2020-06-15;0;0;0;360;382;69;742
07;2020-06-15;0;1;1;231;190;79;421
07;2020-06-15;0;0;0;114;67;89;181
07;2020-06-15;0;0;0;24;11;90;35
07;2020-06-15;0;1;1;4671;5290;0;9961
08;2020-06-15;0;0;0;2715.22592983026;2997.75551488675;09;5712.98144471701
08;2020-06-15;0;0;0;2778.51901080978;3160.9156459093;19;5939.43465671908
08;2020-06-15;0;0;0;2080.8882988764;1718.16634315323;29;3799.05464202964
08;2020-06-15;0;0;0;2701.8582062647;1896.52641413317;39;4598.38462039786
08;2020-06-15;0;0;0;3151.45861023308;2460.52498233809;49;5611.98359257117
08;2020-06-15;0;0;0;2620.29868333099;2422.23566154656;59;5042.53434487755
08;2020-06-15;0;0;0;1621.44173420671;1438.58325779464;69;3060.02499200135
08;2020-06-15;0;0;0;626.575909335673;526.358467843651;79;1152.93437717932
08;2020-06-15;0;0;0;205.018522985054;140.993639349697;89;346.012162334751
08;2020-06-15;0;0;0;50.0325684687745;20.62259870351;90;70.6551671722846
08;2020-06-15;0;0;0;18551.3174743414;16782.6825256586;0;35334
11;2020-06-15;5;3;8;783071;811785;09;1594856
11;2020-06-15;5;5;10;761456;784653;19;1546109
11;2020-06-15;7;7;16;850145;801772;29;1651917
11;2020-06-15;9;13;25;914360;843488;39;1757848
11;2020-06-15;9;11;22;845609;826202;49;1671811
11;2020-06-15;6;1;8;793566;745070;59;1538636
11;2020-06-15;6;4;13;628649;549192;69;1177841
11;2020-06-15;4;4;8;434606;358356;79;792962
11;2020-06-15;2;2;4;261425;162933;89;424358
11;2020-06-15;2;1;3;89253;32619;90;121872
11;2020-06-15;55;51;117;6362140;5916070;0;12278210
24;2020-06-15;1;0;1;139720;144686;09;284406
24;2020-06-15;0;1;1;152979;161185;19;314164
24;2020-06-15;0;1;1;122237;126536;29;248773
24;2020-06-15;0;0;0;150359;142009;39;292368
24;2020-06-15;2;1;3;161829;158758;49;320587
24;2020-06-15;2;1;3;172552;168011;59;340563
24;2020-06-15;2;0;2;172509;158177;69;330686
24;2020-06-15;1;1;2;129428;110593;79;240021
24;2020-06-15;0;0;0;87342;56882;89;144224
24;2020-06-15;0;0;0;31210;12071;90;43281
24;2020-06-15;8;5;13;1320165;1238908;0;2559073
27;2020-06-15;0;0;0;143373;149679;09;293052
27;2020-06-15;1;1;2;160962;173003;19;333965
27;2020-06-15;0;0;0;133746;142254;29;276000
27;2020-06-15;1;0;1;160004;155407;39;315411
27;2020-06-15;0;1;2;172333;169564;49;341897
27;2020-06-15;0;0;1;189979;183788;59;373767
27;2020-06-15;0;0;0;192591;178206;69;370797
27;2020-06-15;1;1;2;146876;127546;79;274422
27;2020-06-15;1;0;1;96896;61575;89;158471
27;2020-06-15;0;0;0;33148;12109;90;45257
27;2020-06-15;4;3;9;1429908;1353131;0;2783039
28;2020-06-15;3;2;5;180735;186856;09;367591
28;2020-06-15;0;0;0;200125;213621;19;413746
28;2020-06-15;1;2;3;168922;173007;29;341929
28;2020-06-15;1;1;2;196628;188487;39;385115
28;2020-06-15;0;0;0;205396;201699;49;407095
28;2020-06-15;2;0;2;222002;213866;59;435868
28;2020-06-15;1;1;2;224688;203758;69;428446
28;2020-06-15;0;2;2;163192;135543;79;298735
28;2020-06-15;2;1;3;109691;65377;89;175068
28;2020-06-15;3;0;3;37222;12685;90;49907
28;2020-06-15;13;9;22;1708601;1594899;0;3303500
32;2020-06-15;1;6;7;358062;373689;09;731751
32;2020-06-15;1;1;6;387045;406742;19;793787
32;2020-06-15;4;0;5;342304;348587;29;690891
32;2020-06-15;3;5;13;382485;369972;39;752457
32;2020-06-15;1;1;5;382510;376716;49;759226
32;2020-06-15;3;1;5;386937;376527;59;763464
32;2020-06-15;5;1;9;371211;330938;69;702149
32;2020-06-15;1;2;4;250542;201459;79;452001
32;2020-06-15;5;2;7;163399;89786;89;253185
32;2020-06-15;3;1;4;48384;15367;90;63751
32;2020-06-15;27;20;65;3072879;2889783;0;5962662
44;2020-06-15;0;1;1;291525;306839;09;598364
44;2020-06-15;2;4;8;320255;339504;19;659759
44;2020-06-15;3;0;3;302020;314428;29;616448
44;2020-06-15;4;2;6;342222;333292;39;675514
44;2020-06-15;2;0;3;349727;344491;49;694218
44;2020-06-15;1;2;4;381371;373239;59;754610
44;2020-06-15;1;2;4;367165;335850;69;703015
44;2020-06-15;2;1;3;250387;215436;79;465823
44;2020-06-15;9;4;13;170825;105192;89;276017
44;2020-06-15;2;0;3;51248;16731;90;67979
44;2020-06-15;26;16;48;2826745;2685002;0;5511747
52;2020-06-15;0;0;0;213594;223900;09;437494
52;2020-06-15;0;1;2;240818;255197;19;496015
52;2020-06-15;0;2;4;197010;200630;29;397640
52;2020-06-15;0;0;1;231204;224885;39;456089
52;2020-06-15;1;2;3;243874;243418;49;487292
52;2020-06-15;1;0;1;244100;239116;59;483216
52;2020-06-15;0;0;0;241796;221345;69;463141
52;2020-06-15;1;0;1;177805;149903;79;327708
52;2020-06-15;0;3;3;119561;75822;89;195383
52;2020-06-15;1;2;3;42559;15260;90;57819
52;2020-06-15;4;10;18;1952321;1849476;0;3801797
53;2020-06-15;0;0;0;173813;182358;09;356171
53;2020-06-15;1;0;1;202720;214740;19;417460
53;2020-06-15;0;1;1;163116;173196;29;336312
53;2020-06-15;0;0;0;190526;187674;39;378200
53;2020-06-15;1;0;1;212098;212015;49;424113
53;2020-06-15;0;0;0;223699;219176;59;442875
53;2020-06-15;0;0;0;227435;209274;69;436709
53;2020-06-15;0;0;0;169992;140910;79;310902
53;2020-06-15;0;0;0;118117;69883;89;188000
53;2020-06-15;0;0;0;37370;12267;90;49637
53;2020-06-15;2;1;3;1718886;1621493;0;3340379
75;2020-06-15;0;0;0;293104;305291;09;598395
75;2020-06-15;0;0;0;337141;357785;19;694926
75;2020-06-15;0;0;0;295024;300618;29;595642
75;2020-06-15;0;0;0;347871;331233;39;679104
75;2020-06-15;0;0;0;384742;372771;49;757513
75;2020-06-15;0;1;1;413361;390880;59;804241
75;2020-06-15;0;0;0;425623;384060;69;809683
75;2020-06-15;0;1;1;325086;276298;79;601384
75;2020-06-15;0;0;0;213986;139308;89;353294
75;2020-06-15;0;0;0;77600;28200;90;105800
75;2020-06-15;0;2;2;3113538;2886444;0;5999982
76;2020-06-15;1;1;2;305956;318589;09;624545
76;2020-06-15;1;0;1;338942;356969;19;695911
76;2020-06-15;0;0;0;316210;319570;29;635780
76;2020-06-15;2;1;3;356758;337587;39;694345
76;2020-06-15;0;0;1;376541;363812;49;740353
76;2020-06-15;0;0;0;402608;383750;59;786358
76;2020-06-15;2;0;2;394889;358997;69;753886
76;2020-06-15;0;0;0;308664;263806;79;572470
76;2020-06-15;2;1;4;195838;129272;89;325110
76;2020-06-15;0;0;1;69372;26728;90;96100
76;2020-06-15;8;3;14;3065778;2859080;0;5924858
84;2020-06-15;5;0;5;459549;481088;09;940637
84;2020-06-15;0;3;5;487711;511905;19;999616
84;2020-06-15;0;2;4;443824;451094;29;894918
84;2020-06-15;3;3;6;512522;493262;39;1005784
84;2020-06-15;1;0;2;520248;515106;49;1035354
84;2020-06-15;2;1;3;529611;514848;59;1044459
84;2020-06-15;0;0;2;486720;439940;69;926660
84;2020-06-15;0;0;1;372151;315211;79;687362
84;2020-06-15;3;1;4;237198;150524;89;387722
84;2020-06-15;0;1;1;81185;28680;90;109865
84;2020-06-15;14;11;33;4130719;3901658;0;8032377
93;2020-06-15;0;2;2;268834;283093;09;551927
93;2020-06-15;0;0;0;280751;296087;19;576838
93;2020-06-15;1;3;5;254404;255552;29;509956
93;2020-06-15;3;1;5;310704;288398;39;599102
93;2020-06-15;2;7;11;325559;305827;49;631386
93;2020-06-15;2;2;7;353104;325389;59;678493
93;2020-06-15;0;0;3;336327;296459;69;632786
93;2020-06-15;0;0;3;279820;229699;79;509519
93;2020-06-15;0;0;2;171274;113716;89;284990
93;2020-06-15;0;0;0;58896;21758;90;80654
93;2020-06-15;8;15;38;2639673;2415978;0;5055651
94;2020-06-15;0;0;0;16311;17433;09;33744
94;2020-06-15;0;0;0;16679;18132;19;34811
94;2020-06-15;0;0;0;16782;16579;29;33361
94;2020-06-15;0;0;0;23044;20580;39;43624
94;2020-06-15;0;0;0;23065;22140;49;45205
94;2020-06-15;0;0;0;24549;23421;59;47970
94;2020-06-15;0;0;0;23212;21883;69;45095
94;2020-06-15;1;0;1;19544;17141;79;36685
94;2020-06-15;0;0;0;11227;8178;89;19405
94;2020-06-15;0;0;0;3332;1447;90;4779
94;2020-06-15;1;0;1;177745;166934;0;344679
01;2020-06-16;0;0;0;19979;20155;09;40134
01;2020-06-16;0;0;0;24994;25489;19;50483
01;2020-06-16;0;0;1;17868;16690;29;34558
01;2020-06-16;0;0;0;22328;14821;39;37149
01;2020-06-16;0;0;0;28652;20276;49;48928
01;2020-06-16;0;0;0;33264;27260;59;60524
01;2020-06-16;0;0;0;27135;23978;69;51113
01;2020-06-16;0;0;0;18401;14661;79;33062
01;2020-06-16;0;0;0;9633;6375;89;16008
01;2020-06-16;0;0;0;3410;1510;90;4920
01;2020-06-16;0;0;1;205664;171215;0;376879
02;2020-06-16;0;0;0;16881;17110;09;33991
02;2020-06-16;0;0;0;21410;21604;19;43014
02;2020-06-16;0;0;0;16017;15479;29;31496
02;2020-06-16;0;0;0;19825;14455;39;34280
02;2020-06-16;1;0;1;24719;18248;49;42967
02;2020-06-16;0;0;0;34361;28310;59;62671
02;2020-06-16;0;0;0;28061;24495;69;52556
02;2020-06-16;0;0;0;18231;15278;79;33509
02;2020-06-16;0;0;0;11090;7677;89;18767
02;2020-06-16;0;0;0;3992;1506;90;5498
02;2020-06-16;1;0;1;194587;164162;0;358749
03;2020-06-16;5;4;11;31123;30920;09;62043
03;2020-06-16;10;4;14;29370;29268;19;58638
03;2020-06-16;21;14;35;21458;18963;29;40421
03;2020-06-16;21;16;37;21276;18326;39;39602
03;2020-06-16;9;6;17;18164;16593;49;34757
03;2020-06-16;10;14;25;13469;13557;59;27026
03;2020-06-16;11;5;16;8776;8670;69;17446
03;2020-06-16;2;2;4;3777;3591;79;7368
03;2020-06-16;1;0;1;1649;1072;89;2721
03;2020-06-16;0;0;0;485;184;90;669
03;2020-06-16;90;65;160;149547;141144;0;290691
04;2020-06-16;0;0;0;60314;61377;09;121691
04;2020-06-16;0;0;0;66065;68387;19;134452
04;2020-06-16;0;0;0;51059;47156;29;98215
04;2020-06-16;0;0;0;58788;45780;39;104568
04;2020-06-16;0;0;0;61408;52207;49;113615
04;2020-06-16;0;0;0;64838;60759;59;125597
04;2020-06-16;0;1;1;47008;42843;69;89851
04;2020-06-16;0;0;0;25509;21184;79;46693
04;2020-06-16;0;0;0;13168;7647;89;20815
04;2020-06-16;0;0;0;3209;1253;90;4462
04;2020-06-16;0;1;1;451366;408593;0;859959
05;2020-06-16;0;0;0;362.366008612902;341.338819562748;09;703.704828175651
05;2020-06-16;0;0;0;353.376145114279;370.349735405642;19;723.725880519921
05;2020-06-16;0;0;0;218.593559489256;256.539602589476;29;475.133162078732
05;2020-06-16;0;0;0;404.225408693299;360.321910454353;39;764.547319147651
05;2020-06-16;0;0;0;520.067953604221;497.108383964256;49;1017.17633756848
05;2020-06-16;0;0;0;468.146063921917;510.087601910415;59;978.233665832332
05;2020-06-16;0;0;0;340.368470050554;334.366842191253;69;674.735312241807
05;2020-06-16;0;0;0;212.598666888387;192.597753227106;79;405.196420115493
05;2020-06-16;0;0;0;148.727797095705;61.8681715431829;89;210.595968638888
05;2020-06-16;0;0;0;32.9601271090696;10.9909785719784;90;43.9511056810479
05;2020-06-16;0;0;0;3061.43020057959;2935.56979942041;0;5997
06;2020-06-16;1;0;1;42583;42380;09;84963
06;2020-06-16;2;1;3;33369;31925;19;65294
06;2020-06-16;2;1;3;21571;15080;29;36651
06;2020-06-16;2;2;4;21550;16147;39;37697
06;2020-06-16;3;2;6;14193;13939;49;28132
06;2020-06-16;1;1;2;7171;7597;59;14768
06;2020-06-16;1;1;2;3629;4117;69;7746
06;2020-06-16;1;0;1;1577;1457;79;3034
06;2020-06-16;0;1;1;531;474;89;1005
06;2020-06-16;0;0;0;88;93;90;181
06;2020-06-16;13;9;23;146262;133209;0;279471
07;2020-06-16;0;0;0;485;549;09;1034
07;2020-06-16;0;0;0;403;432;19;835
07;2020-06-16;0;0;0;764;841;29;1605
07;2020-06-16;0;0;0;824;928;39;1752
07;2020-06-16;0;0;0;788;1020;49;1808
07;2020-06-16;0;0;0;678;870;59;1548
07;2020-06-16;0;0;0;360;382;69;742
07;2020-06-16;0;0;0;231;190;79;421
07;2020-06-16;0;0;0;114;67;89;181
07;2020-06-16;0;0;0;24;11;90;35
07;2020-06-16;0;0;0;4671;5290;0;9961
08;2020-06-16;0;0;0;2715.22592983026;2997.75551488675;09;5712.98144471701
08;2020-06-16;0;0;0;2778.51901080978;3160.9156459093;19;5939.43465671908
08;2020-06-16;0;0;0;2080.8882988764;1718.16634315323;29;3799.05464202964
08;2020-06-16;0;0;0;2701.8582062647;1896.52641413317;39;4598.38462039786
08;2020-06-16;0;0;0;3151.45861023308;2460.52498233809;49;5611.98359257117
08;2020-06-16;0;0;0;2620.29868333099;2422.23566154656;59;5042.53434487755
08;2020-06-16;0;0;0;1621.44173420671;1438.58325779464;69;3060.02499200135
08;2020-06-16;0;0;0;626.575909335673;526.358467843651;79;1152.93437717932
08;2020-06-16;0;0;0;205.018522985054;140.993639349697;89;346.012162334751
08;2020-06-16;0;0;0;50.0325684687745;20.62259870351;90;70.6551671722846
08;2020-06-16;0;0;0;18551.3174743414;16782.6825256586;0;35334
11;2020-06-16;3;2;5;783071;811785;09;1594856
11;2020-06-16;1;7;8;761456;784653;19;1546109
11;2020-06-16;10;7;18;850145;801772;29;1651917
11;2020-06-16;13;14;29;914360;843488;39;1757848
11;2020-06-16;9;9;21;845609;826202;49;1671811
11;2020-06-16;8;6;14;793566;745070;59;1538636
11;2020-06-16;3;3;9;628649;549192;69;1177841
11;2020-06-16;3;8;11;434606;358356;79;792962
11;2020-06-16;6;1;7;261425;162933;89;424358
11;2020-06-16;3;1;4;89253;32619;90;121872
11;2020-06-16;59;58;128;6362140;5916070;0;12278210
24;2020-06-16;0;0;0;139720;144686;09;284406
24;2020-06-16;0;0;0;152979;161185;19;314164
24;2020-06-16;0;0;0;122237;126536;29;248773
24;2020-06-16;0;1;1;150359;142009;39;292368
24;2020-06-16;1;0;2;161829;158758;49;320587
24;2020-06-16;0;0;0;172552;168011;59;340563
24;2020-06-16;0;1;1;172509;158177;69;330686
24;2020-06-16;0;0;0;129428;110593;79;240021
24;2020-06-16;0;2;2;87342;56882;89;144224
24;2020-06-16;1;0;1;31210;12071;90;43281
24;2020-06-16;2;4;7;1320165;1238908;0;2559073
27;2020-06-16;0;2;2;143373;149679;09;293052
27;2020-06-16;2;0;2;160962;173003;19;333965
27;2020-06-16;1;0;1;133746;142254;29;276000
27;2020-06-16;0;0;0;160004;155407;39;315411
27;2020-06-16;0;0;0;172333;169564;49;341897
27;2020-06-16;0;0;0;189979;183788;59;373767
27;2020-06-16;1;1;2;192591;178206;69;370797
27;2020-06-16;0;2;2;146876;127546;79;274422
27;2020-06-16;0;0;0;96896;61575;89;158471
27;2020-06-16;0;0;0;33148;12109;90;45257
27;2020-06-16;4;5;9;1429908;1353131;0;2783039
28;2020-06-16;0;1;1;180735;186856;09;367591
28;2020-06-16;4;0;4;200125;213621;19;413746
28;2020-06-16;2;1;3;168922;173007;29;341929
28;2020-06-16;2;0;4;196628;188487;39;385115
28;2020-06-16;2;0;3;205396;201699;49;407095
28;2020-06-16;1;0;1;222002;213866;59;435868
28;2020-06-16;1;0;1;224688;203758;69;428446
28;2020-06-16;0;1;1;163192;135543;79;298735
28;2020-06-16;0;0;1;109691;65377;89;175068
28;2020-06-16;0;0;0;37222;12685;90;49907
28;2020-06-16;12;3;19;1708601;1594899;0;3303500
32;2020-06-16;1;1;3;358062;373689;09;731751
32;2020-06-16;1;0;4;387045;406742;19;793787
32;2020-06-16;4;0;7;342304;348587;29;690891
32;2020-06-16;4;0;7;382485;369972;39;752457
32;2020-06-16;2;2;4;382510;376716;49;759226
32;2020-06-16;0;3;6;386937;376527;59;763464
32;2020-06-16;1;3;4;371211;330938;69;702149
32;2020-06-16;1;1;3;250542;201459;79;452001
32;2020-06-16;6;1;10;163399;89786;89;253185
32;2020-06-16;5;0;5;48384;15367;90;63751
32;2020-06-16;25;11;53;3072879;2889783;0;5962662
44;2020-06-16;1;0;1;291525;306839;09;598364
44;2020-06-16;1;2;3;320255;339504;19;659759
44;2020-06-16;3;4;11;302020;314428;29;616448
44;2020-06-16;3;3;6;342222;333292;39;675514
44;2020-06-16;3;3;9;349727;344491;49;694218
44;2020-06-16;3;5;9;381371;373239;59;754610
44;2020-06-16;2;1;4;367165;335850;69;703015
44;2020-06-16;5;4;9;250387;215436;79;465823
44;2020-06-16;4;4;8;170825;105192;89;276017
44;2020-06-16;1;3;4;51248;16731;90;67979
44;2020-06-16;26;29;64;2826745;2685002;0;5511747
52;2020-06-16;0;0;1;213594;223900;09;437494
52;2020-06-16;0;0;2;240818;255197;19;496015
52;2020-06-16;2;2;4;197010;200630;29;397640
52;2020-06-16;1;1;2;231204;224885;39;456089
52;2020-06-16;0;0;1;243874;243418;49;487292
52;2020-06-16;2;0;2;244100;239116;59;483216
52;2020-06-16;1;0;1;241796;221345;69;463141
52;2020-06-16;3;4;8;177805;149903;79;327708
52;2020-06-16;2;0;2;119561;75822;89;195383
52;2020-06-16;0;0;1;42559;15260;90;57819
52;2020-06-16;11;7;24;1952321;1849476;0;3801797
53;2020-06-16;0;0;0;173813;182358;09;356171
53;2020-06-16;0;0;0;202720;214740;19;417460
53;2020-06-16;1;0;1;163116;173196;29;336312
53;2020-06-16;0;0;0;190526;187674;39;378200
53;2020-06-16;0;0;0;212098;212015;49;424113
53;2020-06-16;0;0;0;223699;219176;59;442875
53;2020-06-16;0;0;0;227435;209274;69;436709
53;2020-06-16;1;0;1;169992;140910;79;310902
53;2020-06-16;2;1;3;118117;69883;89;188000
53;2020-06-16;0;0;0;37370;12267;90;49637
53;2020-06-16;4;1;5;1718886;1621493;0;3340379
75;2020-06-16;0;0;0;293104;305291;09;598395
75;2020-06-16;0;0;0;337141;357785;19;694926
75;2020-06-16;0;0;0;295024;300618;29;595642
75;2020-06-16;0;0;0;347871;331233;39;679104
75;2020-06-16;0;0;1;384742;372771;49;757513
75;2020-06-16;0;0;0;413361;390880;59;804241
75;2020-06-16;0;0;0;425623;384060;69;809683
75;2020-06-16;0;0;0;325086;276298;79;601384
75;2020-06-16;0;0;0;213986;139308;89;353294
75;2020-06-16;1;0;1;77600;28200;90;105800
75;2020-06-16;1;0;2;3113538;2886444;0;5999982
76;2020-06-16;0;0;0;305956;318589;09;624545
76;2020-06-16;0;0;0;338942;356969;19;695911
76;2020-06-16;0;0;0;316210;319570;29;635780
76;2020-06-16;2;1;4;356758;337587;39;694345
76;2020-06-16;0;0;1;376541;363812;49;740353
76;2020-06-16;2;1;5;402608;383750;59;786358
76;2020-06-16;0;0;0;394889;358997;69;753886
76;2020-06-16;1;0;2;308664;263806;79;572470
76;2020-06-16;0;0;0;195838;129272;89;325110
76;2020-06-16;1;0;1;69372;26728;90;96100
76;2020-06-16;6;2;13;3065778;2859080;0;5924858
84;2020-06-16;0;0;3;459549;481088;09;940637
84;2020-06-16;2;1;3;487711;511905;19;999616
84;2020-06-16;2;1;4;443824;451094;29;894918
84;2020-06-16;2;3;7;512522;493262;39;1005784
84;2020-06-16;1;2;4;520248;515106;49;1035354
84;2020-06-16;0;1;2;529611;514848;59;1044459
84;2020-06-16;1;0;1;486720;439940;69;926660
84;2020-06-16;0;1;1;372151;315211;79;687362
84;2020-06-16;0;1;1;237198;150524;89;387722
84;2020-06-16;2;0;3;81185;28680;90;109865
84;2020-06-16;10;10;29;4130719;3901658;0;8032377
93;2020-06-16;1;0;1;268834;283093;09;551927
93;2020-06-16;0;1;1;280751;296087;19;576838
93;2020-06-16;1;1;3;254404;255552;29;509956
93;2020-06-16;1;2;4;310704;288398;39;599102
93;2020-06-16;0;5;5;325559;305827;49;631386
93;2020-06-16;3;1;6;353104;325389;59;678493
93;2020-06-16;0;1;3;336327;296459;69;632786
93;2020-06-16;2;0;3;279820;229699;79;509519
93;2020-06-16;0;0;0;171274;113716;89;284990
93;2020-06-16;0;0;1;58896;21758;90;80654
93;2020-06-16;8;11;31;2639673;2415978;0;5055651
94;2020-06-16;0;0;0;16311;17433;09;33744
94;2020-06-16;0;0;0;16679;18132;19;34811
94;2020-06-16;1;0;1;16782;16579;29;33361
94;2020-06-16;0;0;0;23044;20580;39;43624
94;2020-06-16;0;0;0;23065;22140;49;45205
94;2020-06-16;0;0;0;24549;23421;59;47970
94;2020-06-16;1;0;1;23212;21883;69;45095
94;2020-06-16;0;0;0;19544;17141;79;36685
94;2020-06-16;0;0;0;11227;8178;89;19405
94;2020-06-16;0;0;0;3332;1447;90;4779
94;2020-06-16;2;0;2;177745;166934;0;344679
01;2020-06-17;0;0;0;19979;20155;09;40134
01;2020-06-17;0;0;0;24994;25489;19;50483
01;2020-06-17;0;0;0;17868;16690;29;34558
01;2020-06-17;0;0;0;22328;14821;39;37149
01;2020-06-17;0;0;0;28652;20276;49;48928
01;2020-06-17;0;0;0;33264;27260;59;60524
01;2020-06-17;0;0;0;27135;23978;69;51113
01;2020-06-17;0;0;0;18401;14661;79;33062
01;2020-06-17;0;0;0;9633;6375;89;16008
01;2020-06-17;0;0;0;3410;1510;90;4920
01;2020-06-17;0;0;0;205664;171215;0;376879
02;2020-06-17;0;0;0;16881;17110;09;33991
02;2020-06-17;0;0;0;21410;21604;19;43014
02;2020-06-17;0;0;0;16017;15479;29;31496
02;2020-06-17;0;0;0;19825;14455;39;34280
02;2020-06-17;1;0;1;24719;18248;49;42967
02;2020-06-17;0;0;0;34361;28310;59;62671
02;2020-06-17;0;0;0;28061;24495;69;52556
02;2020-06-17;0;0;0;18231;15278;79;33509
02;2020-06-17;0;0;0;11090;7677;89;18767
02;2020-06-17;0;0;0;3992;1506;90;5498
02;2020-06-17;1;0;1;194587;164162;0;358749
03;2020-06-17;10;4;18;31123;30920;09;62043
03;2020-06-17;24;17;41;29370;29268;19;58638
03;2020-06-17;20;23;49;21458;18963;29;40421
03;2020-06-17;27;29;62;21276;18326;39;39602
03;2020-06-17;25;19;45;18164;16593;49;34757
03;2020-06-17;19;15;35;13469;13557;59;27026
03;2020-06-17;9;17;27;8776;8670;69;17446
03;2020-06-17;6;3;9;3777;3591;79;7368
03;2020-06-17;1;0;1;1649;1072;89;2721
03;2020-06-17;0;1;1;485;184;90;669
03;2020-06-17;141;128;288;149547;141144;0;290691
04;2020-06-17;1;0;1;60314;61377;09;121691
04;2020-06-17;0;0;0;66065;68387;19;134452
04;2020-06-17;1;0;1;51059;47156;29;98215
04;2020-06-17;1;0;1;58788;45780;39;104568
04;2020-06-17;0;0;0;61408;52207;49;113615
04;2020-06-17;1;1;2;64838;60759;59;125597
04;2020-06-17;0;0;0;47008;42843;69;89851
04;2020-06-17;0;0;0;25509;21184;79;46693
04;2020-06-17;0;0;0;13168;7647;89;20815
04;2020-06-17;0;0;0;3209;1253;90;4462
04;2020-06-17;4;1;5;451366;408593;0;859959
05;2020-06-17;0;0;0;362.366008612902;341.338819562748;09;703.704828175651
05;2020-06-17;0;0;0;353.376145114279;370.349735405642;19;723.725880519921
05;2020-06-17;0;0;0;218.593559489256;256.539602589476;29;475.133162078732
05;2020-06-17;0;0;0;404.225408693299;360.321910454353;39;764.547319147651
05;2020-06-17;0;0;0;520.067953604221;497.108383964256;49;1017.17633756848
05;2020-06-17;0;0;0;468.146063921917;510.087601910415;59;978.233665832332
05;2020-06-17;0;0;0;340.368470050554;334.366842191253;69;674.735312241807
05;2020-06-17;0;0;0;212.598666888387;192.597753227106;79;405.196420115493
05;2020-06-17;0;0;0;148.727797095705;61.8681715431829;89;210.595968638888
05;2020-06-17;0;0;0;32.9601271090696;10.9909785719784;90;43.9511056810479
05;2020-06-17;0;0;0;3061.43020057959;2935.56979942041;0;5997
06;2020-06-17;1;1;2;42583;42380;09;84963
06;2020-06-17;1;1;2;33369;31925;19;65294
06;2020-06-17;0;1;2;21571;15080;29;36651
06;2020-06-17;4;1;6;21550;16147;39;37697
06;2020-06-17;3;0;4;14193;13939;49;28132
06;2020-06-17;2;1;5;7171;7597;59;14768
06;2020-06-17;0;2;2;3629;4117;69;7746
06;2020-06-17;1;0;1;1577;1457;79;3034
06;2020-06-17;0;0;0;531;474;89;1005
06;2020-06-17;0;0;0;88;93;90;181
06;2020-06-17;12;7;24;146262;133209;0;279471
07;2020-06-17;0;0;0;485;549;09;1034
07;2020-06-17;0;0;0;403;432;19;835
07;2020-06-17;0;0;0;764;841;29;1605
07;2020-06-17;0;0;0;824;928;39;1752
07;2020-06-17;0;0;0;788;1020;49;1808
07;2020-06-17;0;0;0;678;870;59;1548
07;2020-06-17;0;0;0;360;382;69;742
07;2020-06-17;0;0;0;231;190;79;421
07;2020-06-17;0;0;0;114;67;89;181
07;2020-06-17;0;0;0;24;11;90;35
07;2020-06-17;0;0;0;4671;5290;0;9961
08;2020-06-17;0;0;0;2715.22592983026;2997.75551488675;09;5712.98144471701
08;2020-06-17;0;0;0;2778.51901080978;3160.9156459093;19;5939.43465671908
08;2020-06-17;0;0;0;2080.8882988764;1718.16634315323;29;3799.05464202964
08;2020-06-17;0;0;0;2701.8582062647;1896.52641413317;39;4598.38462039786
08;2020-06-17;0;0;0;3151.45861023308;2460.52498233809;49;5611.98359257117
08;2020-06-17;0;0;0;2620.29868333099;2422.23566154656;59;5042.53434487755
08;2020-06-17;0;0;0;1621.44173420671;1438.58325779464;69;3060.02499200135
08;2020-06-17;0;0;0;626.575909335673;526.358467843651;79;1152.93437717932
08;2020-06-17;0;0;0;205.018522985054;140.993639349697;89;346.012162334751
08;2020-06-17;0;0;0;50.0325684687745;20.62259870351;90;70.6551671722846
08;2020-06-17;0;0;0;18551.3174743414;16782.6825256586;0;35334
11;2020-06-17;4;5;9;783071;811785;09;1594856
11;2020-06-17;4;4;8;761456;784653;19;1546109
11;2020-06-17;5;11;17;850145;801772;29;1651917
11;2020-06-17;16;14;30;914360;843488;39;1757848
11;2020-06-17;14;10;27;845609;826202;49;1671811
11;2020-06-17;13;11;24;793566;745070;59;1538636
11;2020-06-17;11;1;12;628649;549192;69;1177841
11;2020-06-17;6;5;11;434606;358356;79;792962
11;2020-06-17;5;6;11;261425;162933;89;424358
11;2020-06-17;7;0;7;89253;32619;90;121872
11;2020-06-17;85;67;158;6362140;5916070;0;12278210
24;2020-06-17;0;1;1;139720;144686;09;284406
24;2020-06-17;0;0;0;152979;161185;19;314164
24;2020-06-17;1;1;2;122237;126536;29;248773
24;2020-06-17;1;2;3;150359;142009;39;292368
24;2020-06-17;1;2;3;161829;158758;49;320587
24;2020-06-17;0;1;1;172552;168011;59;340563
24;2020-06-17;1;0;1;172509;158177;69;330686
24;2020-06-17;0;0;0;129428;110593;79;240021
24;2020-06-17;0;0;0;87342;56882;89;144224
24;2020-06-17;0;0;0;31210;12071;90;43281
24;2020-06-17;4;7;11;1320165;1238908;0;2559073
27;2020-06-17;0;0;0;143373;149679;09;293052
27;2020-06-17;0;1;1;160962;173003;19;333965
27;2020-06-17;1;1;2;133746;142254;29;276000
27;2020-06-17;0;0;1;160004;155407;39;315411
27;2020-06-17;0;0;1;172333;169564;49;341897
27;2020-06-17;0;0;0;189979;183788;59;373767
27;2020-06-17;0;0;0;192591;178206;69;370797
27;2020-06-17;0;0;0;146876;127546;79;274422
27;2020-06-17;0;1;4;96896;61575;89;158471
27;2020-06-17;0;0;0;33148;12109;90;45257
27;2020-06-17;1;3;9;1429908;1353131;0;2783039
28;2020-06-17;1;1;2;180735;186856;09;367591
28;2020-06-17;1;0;1;200125;213621;19;413746
28;2020-06-17;3;2;5;168922;173007;29;341929
28;2020-06-17;0;0;0;196628;188487;39;385115
28;2020-06-17;3;2;5;205396;201699;49;407095
28;2020-06-17;4;1;5;222002;213866;59;435868
28;2020-06-17;3;1;4;224688;203758;69;428446
28;2020-06-17;1;0;1;163192;135543;79;298735
28;2020-06-17;4;2;6;109691;65377;89;175068
28;2020-06-17;3;1;4;37222;12685;90;49907
28;2020-06-17;23;10;33;1708601;1594899;0;3303500
32;2020-06-17;1;0;4;358062;373689;09;731751
32;2020-06-17;0;0;1;387045;406742;19;793787
32;2020-06-17;0;6;12;342304;348587;29;690891
32;2020-06-17;1;2;3;382485;369972;39;752457
32;2020-06-17;2;5;8;382510;376716;49;759226
32;2020-06-17;1;0;2;386937;376527;59;763464
32;2020-06-17;0;1;2;371211;330938;69;702149
32;2020-06-17;7;3;11;250542;201459;79;452001
32;2020-06-17;4;1;8;163399;89786;89;253185
32;2020-06-17;0;1;1;48384;15367;90;63751
32;2020-06-17;16;19;52;3072879;2889783;0;5962662
44;2020-06-17;0;1;1;291525;306839;09;598364
44;2020-06-17;1;3;4;320255;339504;19;659759
44;2020-06-17;3;2;5;302020;314428;29;616448
44;2020-06-17;5;2;7;342222;333292;39;675514
44;2020-06-17;7;2;9;349727;344491;49;694218
44;2020-06-17;5;0;5;381371;373239;59;754610
44;2020-06-17;2;2;4;367165;335850;69;703015
44;2020-06-17;3;4;11;250387;215436;79;465823
44;2020-06-17;2;7;10;170825;105192;89;276017
44;2020-06-17;2;0;2;51248;16731;90;67979
44;2020-06-17;30;23;58;2826745;2685002;0;5511747
52;2020-06-17;0;0;0;213594;223900;09;437494
52;2020-06-17;0;0;0;240818;255197;19;496015
52;2020-06-17;1;0;1;197010;200630;29;397640
52;2020-06-17;1;2;3;231204;224885;39;456089
52;2020-06-17;0;1;1;243874;243418;49;487292
52;2020-06-17;0;0;0;244100;239116;59;483216
52;2020-06-17;1;1;2;241796;221345;69;463141
52;2020-06-17;2;0;3;177805;149903;79;327708
52;2020-06-17;0;0;0;119561;75822;89;195383
52;2020-06-17;1;2;3;42559;15260;90;57819
52;2020-06-17;6;6;13;1952321;1849476;0;3801797
53;2020-06-17;0;0;0;173813;182358;09;356171
53;2020-06-17;0;0;0;202720;214740;19;417460
53;2020-06-17;0;1;1;163116;173196;29;336312
53;2020-06-17;0;0;0;190526;187674;39;378200
53;2020-06-17;0;0;0;212098;212015;49;424113
53;2020-06-17;0;0;0;223699;219176;59;442875
53;2020-06-17;0;0;0;227435;209274;69;436709
53;2020-06-17;0;0;0;169992;140910;79;310902
53;2020-06-17;1;1;2;118117;69883;89;188000
53;2020-06-17;3;0;3;37370;12267;90;49637
53;2020-06-17;4;2;6;1718886;1621493;0;3340379
75;2020-06-17;0;0;0;293104;305291;09;598395
75;2020-06-17;1;0;1;337141;357785;19;694926
75;2020-06-17;0;1;1;295024;300618;29;595642
75;2020-06-17;1;0;1;347871;331233;39;679104
75;2020-06-17;0;0;0;384742;372771;49;757513
75;2020-06-17;0;0;0;413361;390880;59;804241
75;2020-06-17;1;0;1;425623;384060;69;809683
75;2020-06-17;0;0;0;325086;276298;79;601384
75;2020-06-17;0;0;0;213986;139308;89;353294
75;2020-06-17;0;0;0;77600;28200;90;105800
75;2020-06-17;3;1;4;3113538;2886444;0;5999982
76;2020-06-17;2;0;2;305956;318589;09;624545
76;2020-06-17;0;0;0;338942;356969;19;695911
76;2020-06-17;1;0;2;316210;319570;29;635780
76;2020-06-17;1;2;3;356758;337587;39;694345
76;2020-06-17;2;1;3;376541;363812;49;740353
76;2020-06-17;1;1;2;402608;383750;59;786358
76;2020-06-17;1;0;1;394889;358997;69;753886
76;2020-06-17;0;1;1;308664;263806;79;572470
76;2020-06-17;0;0;0;195838;129272;89;325110
76;2020-06-17;0;1;1;69372;26728;90;96100
76;2020-06-17;8;6;15;3065778;2859080;0;5924858
84;2020-06-17;4;1;7;459549;481088;09;940637
84;2020-06-17;1;2;3;487711;511905;19;999616
84;2020-06-17;4;4;9;443824;451094;29;894918
84;2020-06-17;0;2;6;512522;493262;39;1005784
84;2020-06-17;4;0;8;520248;515106;49;1035354
84;2020-06-17;1;1;3;529611;514848;59;1044459
84;2020-06-17;0;0;0;486720;439940;69;926660
84;2020-06-17;1;0;1;372151;315211;79;687362
84;2020-06-17;2;0;2;237198;150524;89;387722
84;2020-06-17;2;0;2;81185;28680;90;109865
84;2020-06-17;19;10;41;4130719;3901658;0;8032377
93;2020-06-17;1;0;3;268834;283093;09;551927
93;2020-06-17;0;2;2;280751;296087;19;576838
93;2020-06-17;1;1;5;254404;255552;29;509956
93;2020-06-17;0;2;2;310704;288398;39;599102
93;2020-06-17;3;2;7;325559;305827;49;631386
93;2020-06-17;1;0;1;353104;325389;59;678493
93;2020-06-17;0;1;1;336327;296459;69;632786
93;2020-06-17;0;0;1;279820;229699;79;509519
93;2020-06-17;0;0;1;171274;113716;89;284990
93;2020-06-17;1;0;1;58896;21758;90;80654
93;2020-06-17;7;8;24;2639673;2415978;0;5055651
94;2020-06-17;0;0;0;16311;17433;09;33744
94;2020-06-17;0;0;0;16679;18132;19;34811
94;2020-06-17;0;0;0;16782;16579;29;33361
94;2020-06-17;0;0;0;23044;20580;39;43624
94;2020-06-17;0;1;1;23065;22140;49;45205
94;2020-06-17;0;0;0;24549;23421;59;47970
94;2020-06-17;0;0;0;23212;21883;69;45095
94;2020-06-17;0;0;0;19544;17141;79;36685
94;2020-06-17;0;0;0;11227;8178;89;19405
94;2020-06-17;0;0;0;3332;1447;90;4779
94;2020-06-17;0;1;1;177745;166934;0;344679
01;2020-06-18;0;0;0;19979;20155;09;40134
01;2020-06-18;0;0;0;24994;25489;19;50483
01;2020-06-18;0;0;1;17868;16690;29;34558
01;2020-06-18;0;0;0;22328;14821;39;37149
01;2020-06-18;0;0;0;28652;20276;49;48928
01;2020-06-18;0;0;0;33264;27260;59;60524
01;2020-06-18;0;0;0;27135;23978;69;51113
01;2020-06-18;0;0;0;18401;14661;79;33062
01;2020-06-18;0;0;0;9633;6375;89;16008
01;2020-06-18;0;0;0;3410;1510;90;4920
01;2020-06-18;0;0;1;205664;171215;0;376879
02;2020-06-18;0;0;0;16881;17110;09;33991
02;2020-06-18;0;0;0;21410;21604;19;43014
02;2020-06-18;1;0;1;16017;15479;29;31496
02;2020-06-18;0;0;0;19825;14455;39;34280
02;2020-06-18;0;0;0;24719;18248;49;42967
02;2020-06-18;0;0;0;34361;28310;59;62671
02;2020-06-18;0;0;0;28061;24495;69;52556
02;2020-06-18;1;0;1;18231;15278;79;33509
02;2020-06-18;0;0;0;11090;7677;89;18767
02;2020-06-18;0;0;0;3992;1506;90;5498
02;2020-06-18;2;0;2;194587;164162;0;358749
03;2020-06-18;3;4;8;31123;30920;09;62043
03;2020-06-18;12;11;24;29370;29268;19;58638
03;2020-06-18;18;18;37;21458;18963;29;40421
03;2020-06-18;25;9;36;21276;18326;39;39602
03;2020-06-18;19;21;40;18164;16593;49;34757
03;2020-06-18;4;13;17;13469;13557;59;27026
03;2020-06-18;4;9;15;8776;8670;69;17446
03;2020-06-18;2;2;4;3777;3591;79;7368
03;2020-06-18;0;3;3;1649;1072;89;2721
03;2020-06-18;0;0;0;485;184;90;669
03;2020-06-18;87;90;184;149547;141144;0;290691
04;2020-06-18;0;0;0;60314;61377;09;121691
04;2020-06-18;0;0;0;66065;68387;19;134452
04;2020-06-18;0;0;0;51059;47156;29;98215
04;2020-06-18;0;0;0;58788;45780;39;104568
04;2020-06-18;0;0;0;61408;52207;49;113615
04;2020-06-18;0;0;0;64838;60759;59;125597
04;2020-06-18;0;0;0;47008;42843;69;89851
04;2020-06-18;0;0;0;25509;21184;79;46693
04;2020-06-18;0;0;0;13168;7647;89;20815
04;2020-06-18;0;0;0;3209;1253;90;4462
04;2020-06-18;0;0;0;451366;408593;0;859959
05;2020-06-18;0;0;0;362.366008612902;341.338819562748;09;703.704828175651
05;2020-06-18;0;0;0;353.376145114279;370.349735405642;19;723.725880519921
05;2020-06-18;0;0;0;218.593559489256;256.539602589476;29;475.133162078732
05;2020-06-18;0;0;0;404.225408693299;360.321910454353;39;764.547319147651
05;2020-06-18;0;0;0;520.067953604221;497.108383964256;49;1017.17633756848
05;2020-06-18;0;0;0;468.146063921917;510.087601910415;59;978.233665832332
05;2020-06-18;0;0;0;340.368470050554;334.366842191253;69;674.735312241807
05;2020-06-18;0;0;0;212.598666888387;192.597753227106;79;405.196420115493
05;2020-06-18;0;0;0;148.727797095705;61.8681715431829;89;210.595968638888
05;2020-06-18;0;0;0;32.9601271090696;10.9909785719784;90;43.9511056810479
05;2020-06-18;0;0;0;3061.43020057959;2935.56979942041;0;5997
06;2020-06-18;0;0;0;42583;42380;09;84963
06;2020-06-18;0;0;0;33369;31925;19;65294
06;2020-06-18;0;0;0;21571;15080;29;36651
06;2020-06-18;2;2;5;21550;16147;39;37697
06;2020-06-18;0;0;0;14193;13939;49;28132
06;2020-06-18;1;0;1;7171;7597;59;14768
06;2020-06-18;2;0;2;3629;4117;69;7746
06;2020-06-18;0;0;0;1577;1457;79;3034
06;2020-06-18;0;0;0;531;474;89;1005
06;2020-06-18;0;0;0;88;93;90;181
06;2020-06-18;5;2;8;146262;133209;0;279471
07;2020-06-18;0;0;0;485;549;09;1034
07;2020-06-18;0;0;0;403;432;19;835
07;2020-06-18;0;0;0;764;841;29;1605
07;2020-06-18;0;0;0;824;928;39;1752
07;2020-06-18;0;0;0;788;1020;49;1808
07;2020-06-18;0;0;0;678;870;59;1548
07;2020-06-18;0;0;0;360;382;69;742
07;2020-06-18;0;0;0;231;190;79;421
07;2020-06-18;0;0;0;114;67;89;181
07;2020-06-18;0;0;0;24;11;90;35
07;2020-06-18;0;0;0;4671;5290;0;9961
08;2020-06-18;0;0;0;2715.22592983026;2997.75551488675;09;5712.98144471701
08;2020-06-18;0;0;0;2778.51901080978;3160.9156459093;19;5939.43465671908
08;2020-06-18;0;0;0;2080.8882988764;1718.16634315323;29;3799.05464202964
08;2020-06-18;0;0;0;2701.8582062647;1896.52641413317;39;4598.38462039786
08;2020-06-18;0;0;0;3151.45861023308;2460.52498233809;49;5611.98359257117
08;2020-06-18;0;0;0;2620.29868333099;2422.23566154656;59;5042.53434487755
08;2020-06-18;0;0;0;1621.44173420671;1438.58325779464;69;3060.02499200135
08;2020-06-18;0;0;0;626.575909335673;526.358467843651;79;1152.93437717932
08;2020-06-18;0;0;0;205.018522985054;140.993639349697;89;346.012162334751
08;2020-06-18;0;0;0;50.0325684687745;20.62259870351;90;70.6551671722846
08;2020-06-18;0;0;0;18551.3174743414;16782.6825256586;0;35334
11;2020-06-18;2;2;15;783071;811785;09;1594856
11;2020-06-18;7;4;14;761456;784653;19;1546109
11;2020-06-18;10;7;19;850145;801772;29;1651917
11;2020-06-18;12;13;25;914360;843488;39;1757848
11;2020-06-18;12;10;23;845609;826202;49;1671811
11;2020-06-18;7;8;17;793566;745070;59;1538636
11;2020-06-18;8;6;14;628649;549192;69;1177841
11;2020-06-18;5;5;10;434606;358356;79;792962
11;2020-06-18;5;3;9;261425;162933;89;424358
11;2020-06-18;1;0;1;89253;32619;90;121872
11;2020-06-18;69;58;147;6362140;5916070;0;12278210
24;2020-06-18;0;0;0;139720;144686;09;284406
24;2020-06-18;0;0;0;152979;161185;19;314164
24;2020-06-18;0;0;0;122237;126536;29;248773
24;2020-06-18;2;1;3;150359;142009;39;292368
24;2020-06-18;1;1;2;161829;158758;49;320587
24;2020-06-18;1;0;1;172552;168011;59;340563
24;2020-06-18;0;0;0;172509;158177;69;330686
24;2020-06-18;1;1;2;129428;110593;79;240021
24;2020-06-18;0;0;0;87342;56882;89;144224
24;2020-06-18;0;0;0;31210;12071;90;43281
24;2020-06-18;5;3;8;1320165;1238908;0;2559073
27;2020-06-18;0;0;0;143373;149679;09;293052
27;2020-06-18;0;0;0;160962;173003;19;333965
27;2020-06-18;1;1;2;133746;142254;29;276000
27;2020-06-18;1;0;1;160004;155407;39;315411
27;2020-06-18;0;0;0;172333;169564;49;341897
27;2020-06-18;0;1;1;189979;183788;59;373767
27;2020-06-18;1;1;2;192591;178206;69;370797
27;2020-06-18;0;0;0;146876;127546;79;274422
27;2020-06-18;1;0;2;96896;61575;89;158471
27;2020-06-18;0;0;0;33148;12109;90;45257
27;2020-06-18;4;3;8;1429908;1353131;0;2783039
28;2020-06-18;1;0;1;180735;186856;09;367591
28;2020-06-18;3;1;4;200125;213621;19;413746
28;2020-06-18;0;1;1;168922;173007;29;341929
28;2020-06-18;5;2;8;196628;188487;39;385115
28;2020-06-18;0;1;2;205396;201699;49;407095
28;2020-06-18;1;1;2;222002;213866;59;435868
28;2020-06-18;1;1;2;224688;203758;69;428446
28;2020-06-18;0;0;2;163192;135543;79;298735
28;2020-06-18;1;0;1;109691;65377;89;175068
28;2020-06-18;0;0;1;37222;12685;90;49907
28;2020-06-18;12;7;24;1708601;1594899;0;3303500
32;2020-06-18;2;1;3;358062;373689;09;731751
32;2020-06-18;3;3;8;387045;406742;19;793787
32;2020-06-18;1;2;7;342304;348587;29;690891
32;2020-06-18;3;0;4;382485;369972;39;752457
32;2020-06-18;1;1;5;382510;376716;49;759226
32;2020-06-18;0;3;3;386937;376527;59;763464
32;2020-06-18;0;1;1;371211;330938;69;702149
32;2020-06-18;0;2;2;250542;201459;79;452001
32;2020-06-18;1;1;3;163399;89786;89;253185
32;2020-06-18;0;0;0;48384;15367;90;63751
32;2020-06-18;11;14;36;3072879;2889783;0;5962662
44;2020-06-18;0;0;0;291525;306839;09;598364
44;2020-06-18;0;2;3;320255;339504;19;659759
44;2020-06-18;3;1;4;302020;314428;29;616448
44;2020-06-18;6;0;9;342222;333292;39;675514
44;2020-06-18;1;1;4;349727;344491;49;694218
44;2020-06-18;1;0;2;381371;373239;59;754610
44;2020-06-18;1;3;6;367165;335850;69;703015
44;2020-06-18;1;2;4;250387;215436;79;465823
44;2020-06-18;3;1;4;170825;105192;89;276017
44;2020-06-18;0;1;1;51248;16731;90;67979
44;2020-06-18;16;11;37;2826745;2685002;0;5511747
52;2020-06-18;1;1;2;213594;223900;09;437494
52;2020-06-18;2;1;3;240818;255197;19;496015
52;2020-06-18;1;0;1;197010;200630;29;397640
52;2020-06-18;2;3;5;231204;224885;39;456089
52;2020-06-18;0;0;0;243874;243418;49;487292
52;2020-06-18;1;1;2;244100;239116;59;483216
52;2020-06-18;0;0;0;241796;221345;69;463141
52;2020-06-18;1;0;1;177805;149903;79;327708
52;2020-06-18;1;1;2;119561;75822;89;195383
52;2020-06-18;0;0;0;42559;15260;90;57819
52;2020-06-18;9;7;17;1952321;1849476;0;3801797
53;2020-06-18;0;0;0;173813;182358;09;356171
53;2020-06-18;1;0;1;202720;214740;19;417460
53;2020-06-18;0;0;0;163116;173196;29;336312
53;2020-06-18;0;0;0;190526;187674;39;378200
53;2020-06-18;0;0;0;212098;212015;49;424113
53;2020-06-18;1;0;1;223699;219176;59;442875
53;2020-06-18;0;0;0;227435;209274;69;436709
53;2020-06-18;0;0;1;169992;140910;79;310902
53;2020-06-18;0;0;0;118117;69883;89;188000
53;2020-06-18;0;0;0;37370;12267;90;49637
53;2020-06-18;2;0;3;1718886;1621493;0;3340379
75;2020-06-18;1;0;1;293104;305291;09;598395
75;2020-06-18;0;0;2;337141;357785;19;694926
75;2020-06-18;1;0;2;295024;300618;29;595642
75;2020-06-18;3;1;4;347871;331233;39;679104
75;2020-06-18;1;1;3;384742;372771;49;757513
75;2020-06-18;0;0;2;413361;390880;59;804241
75;2020-06-18;0;0;0;425623;384060;69;809683
75;2020-06-18;0;0;0;325086;276298;79;601384
75;2020-06-18;0;0;0;213986;139308;89;353294
75;2020-06-18;0;0;0;77600;28200;90;105800
75;2020-06-18;6;2;14;3113538;2886444;0;5999982
76;2020-06-18;2;1;3;305956;318589;09;624545
76;2020-06-18;0;1;1;338942;356969;19;695911
76;2020-06-18;3;0;3;316210;319570;29;635780
76;2020-06-18;0;1;1;356758;337587;39;694345
76;2020-06-18;1;2;3;376541;363812;49;740353
76;2020-06-18;1;3;6;402608;383750;59;786358
76;2020-06-18;2;1;3;394889;358997;69;753886
76;2020-06-18;0;0;0;308664;263806;79;572470
76;2020-06-18;1;0;1;195838;129272;89;325110
76;2020-06-18;0;0;0;69372;26728;90;96100
76;2020-06-18;10;9;21;3065778;2859080;0;5924858
84;2020-06-18;2;0;3;459549;481088;09;940637
84;2020-06-18;0;0;5;487711;511905;19;999616
84;2020-06-18;2;1;5;443824;451094;29;894918
84;2020-06-18;1;1;6;512522;493262;39;1005784
84;2020-06-18;1;2;6;520248;515106;49;1035354
84;2020-06-18;2;0;3;529611;514848;59;1044459
84;2020-06-18;2;1;3;486720;439940;69;926660
84;2020-06-18;1;1;2;372151;315211;79;687362
84;2020-06-18;2;0;2;237198;150524;89;387722
84;2020-06-18;2;0;2;81185;28680;90;109865
84;2020-06-18;15;6;37;4130719;3901658;0;8032377
93;2020-06-18;0;0;0;268834;283093;09;551927
93;2020-06-18;0;0;2;280751;296087;19;576838
93;2020-06-18;0;1;2;254404;255552;29;509956
93;2020-06-18;2;5;7;310704;288398;39;599102
93;2020-06-18;1;3;4;325559;305827;49;631386
93;2020-06-18;2;1;3;353104;325389;59;678493
93;2020-06-18;0;1;1;336327;296459;69;632786
93;2020-06-18;2;0;2;279820;229699;79;509519
93;2020-06-18;1;1;2;171274;113716;89;284990
93;2020-06-18;0;0;0;58896;21758;90;80654
93;2020-06-18;8;12;23;2639673;2415978;0;5055651
94;2020-06-18;0;0;0;16311;17433;09;33744
94;2020-06-18;0;0;0;16679;18132;19;34811
94;2020-06-18;0;0;0;16782;16579;29;33361
94;2020-06-18;0;0;0;23044;20580;39;43624
94;2020-06-18;0;0;0;23065;22140;49;45205
94;2020-06-18;0;0;0;24549;23421;59;47970
94;2020-06-18;0;0;0;23212;21883;69;45095
94;2020-06-18;0;0;0;19544;17141;79;36685
94;2020-06-18;0;0;0;11227;8178;89;19405
94;2020-06-18;0;0;0;3332;1447;90;4779
94;2020-06-18;0;0;0;177745;166934;0;344679
01;2020-06-19;0;0;0;19979;20155;09;40134
01;2020-06-19;0;0;0;24994;25489;19;50483
01;2020-06-19;0;1;1;17868;16690;29;34558
01;2020-06-19;0;0;0;22328;14821;39;37149
01;2020-06-19;0;0;1;28652;20276;49;48928
01;2020-06-19;0;0;0;33264;27260;59;60524
01;2020-06-19;0;0;0;27135;23978;69;51113
01;2020-06-19;0;1;1;18401;14661;79;33062
01;2020-06-19;0;0;0;9633;6375;89;16008
01;2020-06-19;0;0;0;3410;1510;90;4920
01;2020-06-19;0;2;3;205664;171215;0;376879
02;2020-06-19;0;1;1;16881;17110;09;33991
02;2020-06-19;0;0;0;21410;21604;19;43014
02;2020-06-19;0;0;0;16017;15479;29;31496
02;2020-06-19;0;0;0;19825;14455;39;34280
02;2020-06-19;0;0;0;24719;18248;49;42967
02;2020-06-19;1;0;1;34361;28310;59;62671
02;2020-06-19;0;0;0;28061;24495;69;52556
02;2020-06-19;0;0;0;18231;15278;79;33509
02;2020-06-19;0;0;0;11090;7677;89;18767
02;2020-06-19;0;0;0;3992;1506;90;5498
02;2020-06-19;1;1;2;194587;164162;0;358749
03;2020-06-19;6;6;13;31123;30920;09;62043
03;2020-06-19;13;12;27;29370;29268;19;58638
03;2020-06-19;23;17;45;21458;18963;29;40421
03;2020-06-19;22;29;58;21276;18326;39;39602
03;2020-06-19;15;15;31;18164;16593;49;34757
03;2020-06-19;12;12;25;13469;13557;59;27026
03;2020-06-19;11;12;23;8776;8670;69;17446
03;2020-06-19;5;0;5;3777;3591;79;7368
03;2020-06-19;0;0;0;1649;1072;89;2721
03;2020-06-19;0;0;0;485;184;90;669
03;2020-06-19;107;103;227;149547;141144;0;290691
04;2020-06-19;0;0;0;60314;61377;09;121691
04;2020-06-19;0;0;0;66065;68387;19;134452
04;2020-06-19;0;0;0;51059;47156;29;98215
04;2020-06-19;0;0;0;58788;45780;39;104568
04;2020-06-19;0;0;0;61408;52207;49;113615
04;2020-06-19;0;0;0;64838;60759;59;125597
04;2020-06-19;0;0;0;47008;42843;69;89851
04;2020-06-19;0;0;0;25509;21184;79;46693
04;2020-06-19;0;0;0;13168;7647;89;20815
04;2020-06-19;0;0;0;3209;1253;90;4462
04;2020-06-19;0;0;0;451366;408593;0;859959
05;2020-06-19;0;0;0;362.366008612902;341.338819562748;09;703.704828175651
05;2020-06-19;0;0;0;353.376145114279;370.349735405642;19;723.725880519921
05;2020-06-19;0;0;0;218.593559489256;256.539602589476;29;475.133162078732
05;2020-06-19;0;0;0;404.225408693299;360.321910454353;39;764.547319147651
05;2020-06-19;0;0;0;520.067953604221;497.108383964256;49;1017.17633756848
05;2020-06-19;0;0;0;468.146063921917;510.087601910415;59;978.233665832332
05;2020-06-19;0;0;0;340.368470050554;334.366842191253;69;674.735312241807
05;2020-06-19;0;0;0;212.598666888387;192.597753227106;79;405.196420115493
05;2020-06-19;0;0;0;148.727797095705;61.8681715431829;89;210.595968638888
05;2020-06-19;0;0;0;32.9601271090696;10.9909785719784;90;43.9511056810479
05;2020-06-19;0;0;0;3061.43020057959;2935.56979942041;0;5997
06;2020-06-19;0;0;0;42583;42380;09;84963
06;2020-06-19;4;0;4;33369;31925;19;65294
06;2020-06-19;7;0;7;21571;15080;29;36651
06;2020-06-19;1;2;3;21550;16147;39;37697
06;2020-06-19;2;1;4;14193;13939;49;28132
06;2020-06-19;2;2;5;7171;7597;59;14768
06;2020-06-19;1;1;2;3629;4117;69;7746
06;2020-06-19;0;1;1;1577;1457;79;3034
06;2020-06-19;0;0;0;531;474;89;1005
06;2020-06-19;0;0;0;88;93;90;181
06;2020-06-19;17;7;26;146262;133209;0;279471
07;2020-06-19;0;0;0;485;549;09;1034
07;2020-06-19;0;0;0;403;432;19;835
07;2020-06-19;0;0;0;764;841;29;1605
07;2020-06-19;0;0;0;824;928;39;1752
07;2020-06-19;0;0;0;788;1020;49;1808
07;2020-06-19;0;0;0;678;870;59;1548
07;2020-06-19;0;0;0;360;382;69;742
07;2020-06-19;0;0;0;231;190;79;421
07;2020-06-19;0;0;0;114;67;89;181
07;2020-06-19;0;0;0;24;11;90;35
07;2020-06-19;0;0;0;4671;5290;0;9961
08;2020-06-19;0;0;0;2715.22592983026;2997.75551488675;09;5712.98144471701
08;2020-06-19;0;0;0;2778.51901080978;3160.9156459093;19;5939.43465671908
08;2020-06-19;0;0;0;2080.8882988764;1718.16634315323;29;3799.05464202964
08;2020-06-19;0;0;0;2701.8582062647;1896.52641413317;39;4598.38462039786
08;2020-06-19;0;0;0;3151.45861023308;2460.52498233809;49;5611.98359257117
08;2020-06-19;0;0;0;2620.29868333099;2422.23566154656;59;5042.53434487755
08;2020-06-19;0;0;0;1621.44173420671;1438.58325779464;69;3060.02499200135
08;2020-06-19;0;0;0;626.575909335673;526.358467843651;79;1152.93437717932
08;2020-06-19;0;0;0;205.018522985054;140.993639349697;89;346.012162334751
08;2020-06-19;0;0;0;50.0325684687745;20.62259870351;90;70.6551671722846
08;2020-06-19;0;0;0;18551.3174743414;16782.6825256586;0;35334
11;2020-06-19;4;5;10;783071;811785;09;1594856
11;2020-06-19;2;8;10;761456;784653;19;1546109
11;2020-06-19;10;10;21;850145;801772;29;1651917
11;2020-06-19;12;18;33;914360;843488;39;1757848
11;2020-06-19;9;12;22;845609;826202;49;1671811
11;2020-06-19;13;8;22;793566;745070;59;1538636
11;2020-06-19;5;5;10;628649;549192;69;1177841
11;2020-06-19;3;0;4;434606;358356;79;792962
11;2020-06-19;6;4;10;261425;162933;89;424358
11;2020-06-19;3;2;5;89253;32619;90;121872
11;2020-06-19;67;72;147;6362140;5916070;0;12278210
24;2020-06-19;1;4;5;139720;144686;09;284406
24;2020-06-19;0;0;0;152979;161185;19;314164
24;2020-06-19;1;0;1;122237;126536;29;248773
24;2020-06-19;3;3;6;150359;142009;39;292368
24;2020-06-19;1;0;1;161829;158758;49;320587
24;2020-06-19;2;2;4;172552;168011;59;340563
24;2020-06-19;0;2;2;172509;158177;69;330686
24;2020-06-19;0;1;1;129428;110593;79;240021
24;2020-06-19;0;0;0;87342;56882;89;144224
24;2020-06-19;0;0;0;31210;12071;90;43281
24;2020-06-19;8;12;20;1320165;1238908;0;2559073
27;2020-06-19;0;0;0;143373;149679;09;293052
27;2020-06-19;0;0;0;160962;173003;19;333965
27;2020-06-19;0;0;0;133746;142254;29;276000
27;2020-06-19;1;2;3;160004;155407;39;315411
27;2020-06-19;0;0;1;172333;169564;49;341897
27;2020-06-19;2;1;5;189979;183788;59;373767
27;2020-06-19;1;0;2;192591;178206;69;370797
27;2020-06-19;0;0;1;146876;127546;79;274422
27;2020-06-19;0;0;0;96896;61575;89;158471
27;2020-06-19;1;0;1;33148;12109;90;45257
27;2020-06-19;5;3;13;1429908;1353131;0;2783039
28;2020-06-19;1;1;2;180735;186856;09;367591
28;2020-06-19;0;1;1;200125;213621;19;413746
28;2020-06-19;2;0;2;168922;173007;29;341929
28;2020-06-19;3;1;4;196628;188487;39;385115
28;2020-06-19;4;1;5;205396;201699;49;407095
28;2020-06-19;1;0;1;222002;213866;59;435868
28;2020-06-19;0;1;1;224688;203758;69;428446
28;2020-06-19;0;0;0;163192;135543;79;298735
28;2020-06-19;2;2;4;109691;65377;89;175068
28;2020-06-19;0;0;0;37222;12685;90;49907
28;2020-06-19;13;7;20;1708601;1594899;0;3303500
32;2020-06-19;1;1;2;358062;373689;09;731751
32;2020-06-19;1;0;3;387045;406742;19;793787
32;2020-06-19;4;4;11;342304;348587;29;690891
32;2020-06-19;1;2;4;382485;369972;39;752457
32;2020-06-19;2;2;4;382510;376716;49;759226
32;2020-06-19;3;4;9;386937;376527;59;763464
32;2020-06-19;1;3;4;371211;330938;69;702149
32;2020-06-19;1;1;2;250542;201459;79;452001
32;2020-06-19;4;2;7;163399;89786;89;253185
32;2020-06-19;3;0;3;48384;15367;90;63751
32;2020-06-19;21;19;49;3072879;2889783;0;5962662
44;2020-06-19;0;1;1;291525;306839;09;598364
44;2020-06-19;2;4;8;320255;339504;19;659759
44;2020-06-19;2;0;2;302020;314428;29;616448
44;2020-06-19;1;4;5;342222;333292;39;675514
44;2020-06-19;4;6;10;349727;344491;49;694218
44;2020-06-19;1;0;1;381371;373239;59;754610
44;2020-06-19;2;9;12;367165;335850;69;703015
44;2020-06-19;5;5;10;250387;215436;79;465823
44;2020-06-19;0;1;2;170825;105192;89;276017
44;2020-06-19;0;2;3;51248;16731;90;67979
44;2020-06-19;17;32;54;2826745;2685002;0;5511747
52;2020-06-19;0;0;0;213594;223900;09;437494
52;2020-06-19;1;3;4;240818;255197;19;496015
52;2020-06-19;1;2;4;197010;200630;29;397640
52;2020-06-19;0;3;3;231204;224885;39;456089
52;2020-06-19;2;2;4;243874;243418;49;487292
52;2020-06-19;1;1;2;244100;239116;59;483216
52;2020-06-19;0;0;0;241796;221345;69;463141
52;2020-06-19;0;2;2;177805;149903;79;327708
52;2020-06-19;1;0;1;119561;75822;89;195383
52;2020-06-19;1;0;1;42559;15260;90;57819
52;2020-06-19;7;13;21;1952321;1849476;0;3801797
53;2020-06-19;0;0;0;173813;182358;09;356171
53;2020-06-19;0;0;0;202720;214740;19;417460
53;2020-06-19;0;0;0;163116;173196;29;336312
53;2020-06-19;0;0;0;190526;187674;39;378200
53;2020-06-19;1;0;1;212098;212015;49;424113
53;2020-06-19;1;1;2;223699;219176;59;442875
53;2020-06-19;0;0;0;227435;209274;69;436709
53;2020-06-19;0;0;0;169992;140910;79;310902
53;2020-06-19;0;0;0;118117;69883;89;188000
53;2020-06-19;1;0;1;37370;12267;90;49637
53;2020-06-19;3;1;4;1718886;1621493;0;3340379
75;2020-06-19;0;0;0;293104;305291;09;598395
75;2020-06-19;1;1;2;337141;357785;19;694926
75;2020-06-19;3;0;3;295024;300618;29;595642
75;2020-06-19;2;0;2;347871;331233;39;679104
75;2020-06-19;1;0;2;384742;372771;49;757513
75;2020-06-19;1;1;3;413361;390880;59;804241
75;2020-06-19;0;1;1;425623;384060;69;809683
75;2020-06-19;0;0;1;325086;276298;79;601384
75;2020-06-19;0;0;0;213986;139308;89;353294
75;2020-06-19;2;0;2;77600;28200;90;105800
75;2020-06-19;10;3;16;3113538;2886444;0;5999982
76;2020-06-19;4;6;11;305956;318589;09;624545
76;2020-06-19;1;1;2;338942;356969;19;695911
76;2020-06-19;4;1;6;316210;319570;29;635780
76;2020-06-19;3;2;5;356758;337587;39;694345
76;2020-06-19;3;4;7;376541;363812;49;740353
76;2020-06-19;0;1;1;402608;383750;59;786358
76;2020-06-19;2;1;3;394889;358997;69;753886
76;2020-06-19;0;1;1;308664;263806;79;572470
76;2020-06-19;0;1;1;195838;129272;89;325110
76;2020-06-19;0;0;0;69372;26728;90;96100
76;2020-06-19;17;18;37;3065778;2859080;0;5924858
84;2020-06-19;1;1;2;459549;481088;09;940637
84;2020-06-19;3;3;7;487711;511905;19;999616
84;2020-06-19;2;2;6;443824;451094;29;894918
84;2020-06-19;1;1;6;512522;493262;39;1005784
84;2020-06-19;1;3;6;520248;515106;49;1035354
84;2020-06-19;1;2;3;529611;514848;59;1044459
84;2020-06-19;4;0;4;486720;439940;69;926660
84;2020-06-19;1;1;2;372151;315211;79;687362
84;2020-06-19;1;2;3;237198;150524;89;387722
84;2020-06-19;1;0;1;81185;28680;90;109865
84;2020-06-19;16;15;40;4130719;3901658;0;8032377
93;2020-06-19;0;0;0;268834;283093;09;551927
93;2020-06-19;0;1;2;280751;296087;19;576838
93;2020-06-19;0;3;3;254404;255552;29;509956
93;2020-06-19;1;0;3;310704;288398;39;599102
93;2020-06-19;2;1;6;325559;305827;49;631386
93;2020-06-19;1;0;1;353104;325389;59;678493
93;2020-06-19;0;1;1;336327;296459;69;632786
93;2020-06-19;0;1;2;279820;229699;79;509519
93;2020-06-19;1;0;1;171274;113716;89;284990
93;2020-06-19;0;0;0;58896;21758;90;80654
93;2020-06-19;6;7;20;2639673;2415978;0;5055651
94;2020-06-19;0;0;0;16311;17433;09;33744
94;2020-06-19;0;0;0;16679;18132;19;34811
94;2020-06-19;0;0;0;16782;16579;29;33361
94;2020-06-19;0;0;0;23044;20580;39;43624
94;2020-06-19;0;0;0;23065;22140;49;45205
94;2020-06-19;0;0;0;24549;23421;59;47970
94;2020-06-19;0;0;0;23212;21883;69;45095
94;2020-06-19;0;0;0;19544;17141;79;36685
94;2020-06-19;0;0;0;11227;8178;89;19405
94;2020-06-19;0;0;0;3332;1447;90;4779
94;2020-06-19;0;0;0;177745;166934;0;344679
01;2020-06-20;0;0;0;19979;20155;09;40134
01;2020-06-20;0;0;0;24994;25489;19;50483
01;2020-06-20;0;1;1;17868;16690;29;34558
01;2020-06-20;0;0;0;22328;14821;39;37149
01;2020-06-20;0;0;0;28652;20276;49;48928
01;2020-06-20;1;0;1;33264;27260;59;60524
01;2020-06-20;0;0;0;27135;23978;69;51113
01;2020-06-20;0;0;0;18401;14661;79;33062
01;2020-06-20;0;0;0;9633;6375;89;16008
01;2020-06-20;0;0;0;3410;1510;90;4920
01;2020-06-20;1;1;2;205664;171215;0;376879
02;2020-06-20;0;0;0;16881;17110;09;33991
02;2020-06-20;0;0;0;21410;21604;19;43014
02;2020-06-20;0;0;0;16017;15479;29;31496
02;2020-06-20;0;0;0;19825;14455;39;34280
02;2020-06-20;0;0;0;24719;18248;49;42967
02;2020-06-20;0;0;0;34361;28310;59;62671
02;2020-06-20;0;0;0;28061;24495;69;52556
02;2020-06-20;0;0;0;18231;15278;79;33509
02;2020-06-20;0;0;0;11090;7677;89;18767
02;2020-06-20;0;0;0;3992;1506;90;5498
02;2020-06-20;0;0;0;194587;164162;0;358749
03;2020-06-20;3;3;6;31123;30920;09;62043
03;2020-06-20;12;11;24;29370;29268;19;58638
03;2020-06-20;17;17;37;21458;18963;29;40421
03;2020-06-20;18;15;34;21276;18326;39;39602
03;2020-06-20;14;11;28;18164;16593;49;34757
03;2020-06-20;14;11;28;13469;13557;59;27026
03;2020-06-20;1;5;6;8776;8670;69;17446
03;2020-06-20;1;3;4;3777;3591;79;7368
03;2020-06-20;1;2;3;1649;1072;89;2721
03;2020-06-20;0;0;0;485;184;90;669
03;2020-06-20;81;78;170;149547;141144;0;290691
04;2020-06-20;0;0;0;60314;61377;09;121691
04;2020-06-20;0;0;0;66065;68387;19;134452
04;2020-06-20;0;0;0;51059;47156;29;98215
04;2020-06-20;0;1;1;58788;45780;39;104568
04;2020-06-20;0;0;0;61408;52207;49;113615
04;2020-06-20;0;0;0;64838;60759;59;125597
04;2020-06-20;0;0;0;47008;42843;69;89851
04;2020-06-20;0;0;0;25509;21184;79;46693
04;2020-06-20;0;0;0;13168;7647;89;20815
04;2020-06-20;0;0;0;3209;1253;90;4462
04;2020-06-20;0;1;1;451366;408593;0;859959
05;2020-06-20;0;0;0;362.366008612902;341.338819562748;09;703.704828175651
05;2020-06-20;0;0;0;353.376145114279;370.349735405642;19;723.725880519921
05;2020-06-20;0;0;0;218.593559489256;256.539602589476;29;475.133162078732
05;2020-06-20;0;0;0;404.225408693299;360.321910454353;39;764.547319147651
05;2020-06-20;0;0;0;520.067953604221;497.108383964256;49;1017.17633756848
05;2020-06-20;0;0;0;468.146063921917;510.087601910415;59;978.233665832332
05;2020-06-20;0;0;0;340.368470050554;334.366842191253;69;674.735312241807
05;2020-06-20;0;0;0;212.598666888387;192.597753227106;79;405.196420115493
05;2020-06-20;0;0;0;148.727797095705;61.8681715431829;89;210.595968638888
05;2020-06-20;0;0;0;32.9601271090696;10.9909785719784;90;43.9511056810479
05;2020-06-20;0;0;0;3061.43020057959;2935.56979942041;0;5997
06;2020-06-20;1;1;2;42583;42380;09;84963
06;2020-06-20;0;0;0;33369;31925;19;65294
06;2020-06-20;0;0;0;21571;15080;29;36651
06;2020-06-20;0;0;0;21550;16147;39;37697
06;2020-06-20;0;1;1;14193;13939;49;28132
06;2020-06-20;1;1;2;7171;7597;59;14768
06;2020-06-20;0;1;1;3629;4117;69;7746
06;2020-06-20;0;0;0;1577;1457;79;3034
06;2020-06-20;0;0;0;531;474;89;1005
06;2020-06-20;0;0;0;88;93;90;181
06;2020-06-20;2;4;6;146262;133209;0;279471
07;2020-06-20;0;0;0;485;549;09;1034
07;2020-06-20;0;0;0;403;432;19;835
07;2020-06-20;0;0;0;764;841;29;1605
07;2020-06-20;0;0;0;824;928;39;1752
07;2020-06-20;0;0;0;788;1020;49;1808
07;2020-06-20;0;0;0;678;870;59;1548
07;2020-06-20;0;0;0;360;382;69;742
07;2020-06-20;0;0;0;231;190;79;421
07;2020-06-20;0;0;0;114;67;89;181
07;2020-06-20;0;0;0;24;11;90;35
07;2020-06-20;0;0;0;4671;5290;0;9961
08;2020-06-20;0;0;0;2715.22592983026;2997.75551488675;09;5712.98144471701
08;2020-06-20;0;0;0;2778.51901080978;3160.9156459093;19;5939.43465671908
08;2020-06-20;0;0;0;2080.8882988764;1718.16634315323;29;3799.05464202964
08;2020-06-20;0;0;0;2701.8582062647;1896.52641413317;39;4598.38462039786
08;2020-06-20;0;0;0;3151.45861023308;2460.52498233809;49;5611.98359257117
08;2020-06-20;0;0;0;2620.29868333099;2422.23566154656;59;5042.53434487755
08;2020-06-20;0;0;0;1621.44173420671;1438.58325779464;69;3060.02499200135
08;2020-06-20;0;0;0;626.575909335673;526.358467843651;79;1152.93437717932
08;2020-06-20;0;0;0;205.018522985054;140.993639349697;89;346.012162334751
08;2020-06-20;0;0;0;50.0325684687745;20.62259870351;90;70.6551671722846
08;2020-06-20;0;0;0;18551.3174743414;16782.6825256586;0;35334
11;2020-06-20;2;1;3;783071;811785;09;1594856
11;2020-06-20;0;0;0;761456;784653;19;1546109
11;2020-06-20;1;7;10;850145;801772;29;1651917
11;2020-06-20;2;2;4;914360;843488;39;1757848
11;2020-06-20;4;1;5;845609;826202;49;1671811
11;2020-06-20;4;2;6;793566;745070;59;1538636
11;2020-06-20;1;3;4;628649;549192;69;1177841
11;2020-06-20;1;2;3;434606;358356;79;792962
11;2020-06-20;0;2;2;261425;162933;89;424358
11;2020-06-20;4;0;4;89253;32619;90;121872
11;2020-06-20;19;20;41;6362140;5916070;0;12278210
24;2020-06-20;0;1;1;139720;144686;09;284406
24;2020-06-20;0;1;1;152979;161185;19;314164
24;2020-06-20;1;0;1;122237;126536;29;248773
24;2020-06-20;1;2;3;150359;142009;39;292368
24;2020-06-20;1;1;2;161829;158758;49;320587
24;2020-06-20;0;1;1;172552;168011;59;340563
24;2020-06-20;0;0;0;172509;158177;69;330686
24;2020-06-20;0;0;0;129428;110593;79;240021
24;2020-06-20;1;1;2;87342;56882;89;144224
24;2020-06-20;0;0;0;31210;12071;90;43281
24;2020-06-20;4;7;11;1320165;1238908;0;2559073
27;2020-06-20;0;0;0;143373;149679;09;293052
27;2020-06-20;0;0;0;160962;173003;19;333965
27;2020-06-20;0;0;0;133746;142254;29;276000
27;2020-06-20;0;0;0;160004;155407;39;315411
27;2020-06-20;0;1;1;172333;169564;49;341897
27;2020-06-20;0;0;0;189979;183788;59;373767
27;2020-06-20;0;0;0;192591;178206;69;370797
27;2020-06-20;0;0;0;146876;127546;79;274422
27;2020-06-20;0;0;0;96896;61575;89;158471
27;2020-06-20;0;1;1;33148;12109;90;45257
27;2020-06-20;0;2;2;1429908;1353131;0;2783039
28;2020-06-20;1;1;2;180735;186856;09;367591
28;2020-06-20;1;0;1;200125;213621;19;413746
28;2020-06-20;2;2;4;168922;173007;29;341929
28;2020-06-20;0;3;3;196628;188487;39;385115
28;2020-06-20;1;2;3;205396;201699;49;407095
28;2020-06-20;0;4;4;222002;213866;59;435868
28;2020-06-20;2;1;3;224688;203758;69;428446
28;2020-06-20;0;0;0;163192;135543;79;298735
28;2020-06-20;0;0;0;109691;65377;89;175068
28;2020-06-20;0;0;0;37222;12685;90;49907
28;2020-06-20;7;13;20;1708601;1594899;0;3303500
32;2020-06-20;0;0;0;358062;373689;09;731751
32;2020-06-20;2;0;2;387045;406742;19;793787
32;2020-06-20;2;2;4;342304;348587;29;690891
32;2020-06-20;3;1;4;382485;369972;39;752457
32;2020-06-20;0;0;0;382510;376716;49;759226
32;2020-06-20;1;3;4;386937;376527;59;763464
32;2020-06-20;0;0;1;371211;330938;69;702149
32;2020-06-20;2;2;4;250542;201459;79;452001
32;2020-06-20;3;2;5;163399;89786;89;253185
32;2020-06-20;1;0;1;48384;15367;90;63751
32;2020-06-20;14;10;25;3072879;2889783;0;5962662
44;2020-06-20;0;0;0;291525;306839;09;598364
44;2020-06-20;0;0;0;320255;339504;19;659759
44;2020-06-20;0;0;0;302020;314428;29;616448
44;2020-06-20;0;0;0;342222;333292;39;675514
44;2020-06-20;2;4;6;349727;344491;49;694218
44;2020-06-20;2;1;3;381371;373239;59;754610
44;2020-06-20;1;2;3;367165;335850;69;703015
44;2020-06-20;0;3;4;250387;215436;79;465823
44;2020-06-20;0;1;1;170825;105192;89;276017
44;2020-06-20;1;0;1;51248;16731;90;67979
44;2020-06-20;6;11;18;2826745;2685002;0;5511747
52;2020-06-20;1;3;4;213594;223900;09;437494
52;2020-06-20;2;0;2;240818;255197;19;496015
52;2020-06-20;3;0;3;197010;200630;29;397640
52;2020-06-20;2;2;4;231204;224885;39;456089
52;2020-06-20;0;0;0;243874;243418;49;487292
52;2020-06-20;0;1;1;244100;239116;59;483216
52;2020-06-20;0;0;0;241796;221345;69;463141
52;2020-06-20;1;0;1;177805;149903;79;327708
52;2020-06-20;0;0;0;119561;75822;89;195383
52;2020-06-20;0;0;0;42559;15260;90;57819
52;2020-06-20;9;6;15;1952321;1849476;0;3801797
53;2020-06-20;0;0;0;173813;182358;09;356171
53;2020-06-20;0;0;0;202720;214740;19;417460
53;2020-06-20;0;0;0;163116;173196;29;336312
53;2020-06-20;0;0;0;190526;187674;39;378200
53;2020-06-20;0;0;0;212098;212015;49;424113
53;2020-06-20;0;0;0;223699;219176;59;442875
53;2020-06-20;0;0;0;227435;209274;69;436709
53;2020-06-20;0;0;0;169992;140910;79;310902
53;2020-06-20;0;0;0;118117;69883;89;188000
53;2020-06-20;0;0;0;37370;12267;90;49637
53;2020-06-20;0;0;0;1718886;1621493;0;3340379
75;2020-06-20;0;0;0;293104;305291;09;598395
75;2020-06-20;0;0;0;337141;357785;19;694926
75;2020-06-20;1;0;1;295024;300618;29;595642
75;2020-06-20;0;1;1;347871;331233;39;679104
75;2020-06-20;0;0;0;384742;372771;49;757513
75;2020-06-20;0;1;1;413361;390880;59;804241
75;2020-06-20;0;0;0;425623;384060;69;809683
75;2020-06-20;1;1;2;325086;276298;79;601384
75;2020-06-20;0;0;0;213986;139308;89;353294
75;2020-06-20;1;0;1;77600;28200;90;105800
75;2020-06-20;3;3;6;3113538;2886444;0;5999982
76;2020-06-20;0;0;0;305956;318589;09;624545
76;2020-06-20;0;0;0;338942;356969;19;695911
76;2020-06-20;0;0;0;316210;319570;29;635780
76;2020-06-20;1;0;1;356758;337587;39;694345
76;2020-06-20;0;0;0;376541;363812;49;740353
76;2020-06-20;0;0;0;402608;383750;59;786358
76;2020-06-20;0;0;0;394889;358997;69;753886
76;2020-06-20;0;0;0;308664;263806;79;572470
76;2020-06-20;0;0;0;195838;129272;89;325110
76;2020-06-20;0;0;0;69372;26728;90;96100
76;2020-06-20;1;0;1;3065778;2859080;0;5924858
84;2020-06-20;0;2;5;459549;481088;09;940637
84;2020-06-20;1;2;4;487711;511905;19;999616
84;2020-06-20;0;0;0;443824;451094;29;894918
84;2020-06-20;2;1;3;512522;493262;39;1005784
84;2020-06-20;3;1;5;520248;515106;49;1035354
84;2020-06-20;0;2;2;529611;514848;59;1044459
84;2020-06-20;1;1;2;486720;439940;69;926660
84;2020-06-20;0;3;3;372151;315211;79;687362
84;2020-06-20;0;1;1;237198;150524;89;387722
84;2020-06-20;4;0;4;81185;28680;90;109865
84;2020-06-20;11;13;29;4130719;3901658;0;8032377
93;2020-06-20;0;0;0;268834;283093;09;551927
93;2020-06-20;0;0;0;280751;296087;19;576838
93;2020-06-20;0;0;0;254404;255552;29;509956
93;2020-06-20;1;0;1;310704;288398;39;599102
93;2020-06-20;0;1;1;325559;305827;49;631386
93;2020-06-20;0;0;0;353104;325389;59;678493
93;2020-06-20;0;0;0;336327;296459;69;632786
93;2020-06-20;0;0;0;279820;229699;79;509519
93;2020-06-20;1;0;1;171274;113716;89;284990
93;2020-06-20;0;0;0;58896;21758;90;80654
93;2020-06-20;2;1;3;2639673;2415978;0;5055651
94;2020-06-20;0;0;0;16311;17433;09;33744
94;2020-06-20;0;0;0;16679;18132;19;34811
94;2020-06-20;0;0;0;16782;16579;29;33361
94;2020-06-20;0;0;0;23044;20580;39;43624
94;2020-06-20;0;0;0;23065;22140;49;45205
94;2020-06-20;0;0;0;24549;23421;59;47970
94;2020-06-20;0;0;0;23212;21883;69;45095
94;2020-06-20;0;0;0;19544;17141;79;36685
94;2020-06-20;0;0;0;11227;8178;89;19405
94;2020-06-20;0;0;0;3332;1447;90;4779
94;2020-06-20;0;0;0;177745;166934;0;344679
01;2020-06-21;0;0;0;19979;20155;09;40134
01;2020-06-21;0;0;0;24994;25489;19;50483
01;2020-06-21;0;0;0;17868;16690;29;34558
01;2020-06-21;0;0;0;22328;14821;39;37149
01;2020-06-21;0;0;0;28652;20276;49;48928
01;2020-06-21;0;0;0;33264;27260;59;60524
01;2020-06-21;0;0;0;27135;23978;69;51113
01;2020-06-21;0;0;0;18401;14661;79;33062
01;2020-06-21;0;0;0;9633;6375;89;16008
01;2020-06-21;0;0;0;3410;1510;90;4920
01;2020-06-21;0;0;0;205664;171215;0;376879
02;2020-06-21;0;0;0;16881;17110;09;33991
02;2020-06-21;0;0;0;21410;21604;19;43014
02;2020-06-21;0;0;0;16017;15479;29;31496
02;2020-06-21;0;0;0;19825;14455;39;34280
02;2020-06-21;0;0;0;24719;18248;49;42967
02;2020-06-21;0;0;0;34361;28310;59;62671
02;2020-06-21;0;0;0;28061;24495;69;52556
02;2020-06-21;0;0;0;18231;15278;79;33509
02;2020-06-21;0;0;0;11090;7677;89;18767
02;2020-06-21;0;0;0;3992;1506;90;5498
02;2020-06-21;0;0;0;194587;164162;0;358749
03;2020-06-21;0;0;1;31123;30920;09;62043
03;2020-06-21;4;1;5;29370;29268;19;58638
03;2020-06-21;2;4;9;21458;18963;29;40421
03;2020-06-21;7;7;16;21276;18326;39;39602
03;2020-06-21;2;1;4;18164;16593;49;34757
03;2020-06-21;3;4;7;13469;13557;59;27026
03;2020-06-21;0;2;2;8776;8670;69;17446
03;2020-06-21;1;2;3;3777;3591;79;7368
03;2020-06-21;0;2;2;1649;1072;89;2721
03;2020-06-21;0;1;1;485;184;90;669
03;2020-06-21;19;24;50;149547;141144;0;290691
04;2020-06-21;0;0;0;60314;61377;09;121691
04;2020-06-21;0;0;0;66065;68387;19;134452
04;2020-06-21;0;0;0;51059;47156;29;98215
04;2020-06-21;0;0;0;58788;45780;39;104568
04;2020-06-21;0;0;0;61408;52207;49;113615
04;2020-06-21;0;0;0;64838;60759;59;125597
04;2020-06-21;0;0;0;47008;42843;69;89851
04;2020-06-21;0;0;0;25509;21184;79;46693
04;2020-06-21;0;0;0;13168;7647;89;20815
04;2020-06-21;0;0;0;3209;1253;90;4462
04;2020-06-21;0;0;0;451366;408593;0;859959
05;2020-06-21;0;0;0;362.366008612902;341.338819562748;09;703.704828175651
05;2020-06-21;0;0;0;353.376145114279;370.349735405642;19;723.725880519921
05;2020-06-21;0;0;0;218.593559489256;256.539602589476;29;475.133162078732
05;2020-06-21;0;0;0;404.225408693299;360.321910454353;39;764.547319147651
05;2020-06-21;0;0;0;520.067953604221;497.108383964256;49;1017.17633756848
05;2020-06-21;0;0;0;468.146063921917;510.087601910415;59;978.233665832332
05;2020-06-21;0;0;0;340.368470050554;334.366842191253;69;674.735312241807
05;2020-06-21;0;0;0;212.598666888387;192.597753227106;79;405.196420115493
05;2020-06-21;0;0;0;148.727797095705;61.8681715431829;89;210.595968638888
05;2020-06-21;0;0;0;32.9601271090696;10.9909785719784;90;43.9511056810479
05;2020-06-21;0;0;0;3061.43020057959;2935.56979942041;0;5997
06;2020-06-21;0;0;0;42583;42380;09;84963
06;2020-06-21;0;0;0;33369;31925;19;65294
06;2020-06-21;1;0;1;21571;15080;29;36651
06;2020-06-21;1;1;2;21550;16147;39;37697
06;2020-06-21;0;0;0;14193;13939;49;28132
06;2020-06-21;0;1;1;7171;7597;59;14768
06;2020-06-21;0;1;1;3629;4117;69;7746
06;2020-06-21;0;0;0;1577;1457;79;3034
06;2020-06-21;0;0;0;531;474;89;1005
06;2020-06-21;0;0;0;88;93;90;181
06;2020-06-21;2;3;5;146262;133209;0;279471
07;2020-06-21;0;0;0;485;549;09;1034
07;2020-06-21;0;0;0;403;432;19;835
07;2020-06-21;0;0;0;764;841;29;1605
07;2020-06-21;0;0;0;824;928;39;1752
07;2020-06-21;0;0;0;788;1020;49;1808
07;2020-06-21;0;0;0;678;870;59;1548
07;2020-06-21;0;0;0;360;382;69;742
07;2020-06-21;0;0;0;231;190;79;421
07;2020-06-21;0;0;0;114;67;89;181
07;2020-06-21;0;0;0;24;11;90;35
07;2020-06-21;0;0;0;4671;5290;0;9961
08;2020-06-21;0;0;0;2715.22592983026;2997.75551488675;09;5712.98144471701
08;2020-06-21;0;0;0;2778.51901080978;3160.9156459093;19;5939.43465671908
08;2020-06-21;0;0;0;2080.8882988764;1718.16634315323;29;3799.05464202964
08;2020-06-21;0;0;0;2701.8582062647;1896.52641413317;39;4598.38462039786
08;2020-06-21;0;0;0;3151.45861023308;2460.52498233809;49;5611.98359257117
08;2020-06-21;0;0;0;2620.29868333099;2422.23566154656;59;5042.53434487755
08;2020-06-21;0;0;0;1621.44173420671;1438.58325779464;69;3060.02499200135
08;2020-06-21;0;0;0;626.575909335673;526.358467843651;79;1152.93437717932
08;2020-06-21;0;0;0;205.018522985054;140.993639349697;89;346.012162334751
08;2020-06-21;0;0;0;50.0325684687745;20.62259870351;90;70.6551671722846
08;2020-06-21;0;0;0;18551.3174743414;16782.6825256586;0;35334
11;2020-06-21;0;2;2;783071;811785;09;1594856
11;2020-06-21;0;2;2;761456;784653;19;1546109
11;2020-06-21;1;2;3;850145;801772;29;1651917
11;2020-06-21;2;2;4;914360;843488;39;1757848
11;2020-06-21;1;2;3;845609;826202;49;1671811
11;2020-06-21;2;3;5;793566;745070;59;1538636
11;2020-06-21;2;0;2;628649;549192;69;1177841
11;2020-06-21;1;1;2;434606;358356;79;792962
11;2020-06-21;0;1;1;261425;162933;89;424358
11;2020-06-21;0;0;0;89253;32619;90;121872
11;2020-06-21;9;15;24;6362140;5916070;0;12278210
24;2020-06-21;0;0;0;139720;144686;09;284406
24;2020-06-21;0;0;0;152979;161185;19;314164
24;2020-06-21;1;0;1;122237;126536;29;248773
24;2020-06-21;0;0;0;150359;142009;39;292368
24;2020-06-21;0;0;0;161829;158758;49;320587
24;2020-06-21;0;0;0;172552;168011;59;340563
24;2020-06-21;0;0;0;172509;158177;69;330686
24;2020-06-21;0;0;0;129428;110593;79;240021
24;2020-06-21;0;0;0;87342;56882;89;144224
24;2020-06-21;0;0;0;31210;12071;90;43281
24;2020-06-21;1;0;1;1320165;1238908;0;2559073
27;2020-06-21;0;0;0;143373;149679;09;293052
27;2020-06-21;0;0;0;160962;173003;19;333965
27;2020-06-21;0;0;0;133746;142254;29;276000
27;2020-06-21;0;0;0;160004;155407;39;315411
27;2020-06-21;0;0;0;172333;169564;49;341897
27;2020-06-21;0;0;0;189979;183788;59;373767
27;2020-06-21;1;0;1;192591;178206;69;370797
27;2020-06-21;0;0;0;146876;127546;79;274422
27;2020-06-21;1;0;1;96896;61575;89;158471
27;2020-06-21;0;0;0;33148;12109;90;45257
27;2020-06-21;2;0;2;1429908;1353131;0;2783039
28;2020-06-21;0;0;0;180735;186856;09;367591
28;2020-06-21;0;0;0;200125;213621;19;413746
28;2020-06-21;1;0;1;168922;173007;29;341929
28;2020-06-21;0;0;0;196628;188487;39;385115
28;2020-06-21;1;1;2;205396;201699;49;407095
28;2020-06-21;0;1;1;222002;213866;59;435868
28;2020-06-21;0;0;0;224688;203758;69;428446
28;2020-06-21;0;0;0;163192;135543;79;298735
28;2020-06-21;0;0;0;109691;65377;89;175068
28;2020-06-21;0;0;0;37222;12685;90;49907
28;2020-06-21;2;2;4;1708601;1594899;0;3303500
32;2020-06-21;0;0;0;358062;373689;09;731751
32;2020-06-21;0;0;0;387045;406742;19;793787
32;2020-06-21;1;0;1;342304;348587;29;690891
32;2020-06-21;0;1;1;382485;369972;39;752457
32;2020-06-21;1;0;1;382510;376716;49;759226
32;2020-06-21;0;0;0;386937;376527;59;763464
32;2020-06-21;0;0;0;371211;330938;69;702149
32;2020-06-21;1;0;1;250542;201459;79;452001
32;2020-06-21;0;0;0;163399;89786;89;253185
32;2020-06-21;1;0;1;48384;15367;90;63751
32;2020-06-21;4;1;5;3072879;2889783;0;5962662
44;2020-06-21;0;0;0;291525;306839;09;598364
44;2020-06-21;0;0;0;320255;339504;19;659759
44;2020-06-21;0;0;0;302020;314428;29;616448
44;2020-06-21;0;0;0;342222;333292;39;675514
44;2020-06-21;0;1;1;349727;344491;49;694218
44;2020-06-21;2;0;2;381371;373239;59;754610
44;2020-06-21;0;0;0;367165;335850;69;703015
44;2020-06-21;0;3;3;250387;215436;79;465823
44;2020-06-21;0;1;1;170825;105192;89;276017
44;2020-06-21;0;0;0;51248;16731;90;67979
44;2020-06-21;2;5;7;2826745;2685002;0;5511747
52;2020-06-21;0;0;0;213594;223900;09;437494
52;2020-06-21;0;0;0;240818;255197;19;496015
52;2020-06-21;0;0;0;197010;200630;29;397640
52;2020-06-21;1;0;1;231204;224885;39;456089
52;2020-06-21;0;0;0;243874;243418;49;487292
52;2020-06-21;0;0;0;244100;239116;59;483216
52;2020-06-21;0;0;0;241796;221345;69;463141
52;2020-06-21;0;0;0;177805;149903;79;327708
52;2020-06-21;0;0;0;119561;75822;89;195383
52;2020-06-21;0;0;0;42559;15260;90;57819
52;2020-06-21;1;0;1;1952321;1849476;0;3801797
53;2020-06-21;0;0;0;173813;182358;09;356171
53;2020-06-21;0;0;0;202720;214740;19;417460
53;2020-06-21;0;0;0;163116;173196;29;336312
53;2020-06-21;0;0;0;190526;187674;39;378200
53;2020-06-21;0;0;0;212098;212015;49;424113
53;2020-06-21;0;0;0;223699;219176;59;442875
53;2020-06-21;1;0;1;227435;209274;69;436709
53;2020-06-21;0;0;0;169992;140910;79;310902
53;2020-06-21;0;0;0;118117;69883;89;188000
53;2020-06-21;0;0;0;37370;12267;90;49637
53;2020-06-21;1;0;1;1718886;1621493;0;3340379
75;2020-06-21;0;0;0;293104;305291;09;598395
75;2020-06-21;0;1;1;337141;357785;19;694926
75;2020-06-21;0;0;0;295024;300618;29;595642
75;2020-06-21;0;0;0;347871;331233;39;679104
75;2020-06-21;0;0;0;384742;372771;49;757513
75;2020-06-21;1;0;1;413361;390880;59;804241
75;2020-06-21;0;0;0;425623;384060;69;809683
75;2020-06-21;0;1;1;325086;276298;79;601384
75;2020-06-21;0;0;0;213986;139308;89;353294
75;2020-06-21;0;0;0;77600;28200;90;105800
75;2020-06-21;1;2;3;3113538;2886444;0;5999982
76;2020-06-21;0;0;0;305956;318589;09;624545
76;2020-06-21;0;0;0;338942;356969;19;695911
76;2020-06-21;0;0;0;316210;319570;29;635780
76;2020-06-21;0;0;0;356758;337587;39;694345
76;2020-06-21;0;0;0;376541;363812;49;740353
76;2020-06-21;2;0;2;402608;383750;59;786358
76;2020-06-21;0;1;1;394889;358997;69;753886
76;2020-06-21;0;0;0;308664;263806;79;572470
76;2020-06-21;0;0;0;195838;129272;89;325110
76;2020-06-21;0;0;0;69372;26728;90;96100
76;2020-06-21;2;1;3;3065778;2859080;0;5924858
84;2020-06-21;0;0;0;459549;481088;09;940637
84;2020-06-21;1;0;1;487711;511905;19;999616
84;2020-06-21;1;0;1;443824;451094;29;894918
84;2020-06-21;0;0;0;512522;493262;39;1005784
84;2020-06-21;0;0;0;520248;515106;49;1035354
84;2020-06-21;0;0;0;529611;514848;59;1044459
84;2020-06-21;0;0;0;486720;439940;69;926660
84;2020-06-21;0;0;0;372151;315211;79;687362
84;2020-06-21;0;0;0;237198;150524;89;387722
84;2020-06-21;0;0;0;81185;28680;90;109865
84;2020-06-21;2;0;2;4130719;3901658;0;8032377
93;2020-06-21;0;0;0;268834;283093;09;551927
93;2020-06-21;1;0;1;280751;296087;19;576838
93;2020-06-21;1;0;1;254404;255552;29;509956
93;2020-06-21;0;1;1;310704;288398;39;599102
93;2020-06-21;0;1;1;325559;305827;49;631386
93;2020-06-21;0;0;0;353104;325389;59;678493
93;2020-06-21;1;0;1;336327;296459;69;632786
93;2020-06-21;0;0;0;279820;229699;79;509519
93;2020-06-21;0;0;0;171274;113716;89;284990
93;2020-06-21;0;0;0;58896;21758;90;80654
93;2020-06-21;3;2;5;2639673;2415978;0;5055651
94;2020-06-21;0;0;0;16311;17433;09;33744
94;2020-06-21;0;0;0;16679;18132;19;34811
94;2020-06-21;0;0;0;16782;16579;29;33361
94;2020-06-21;0;0;0;23044;20580;39;43624
94;2020-06-21;0;0;0;23065;22140;49;45205
94;2020-06-21;0;0;0;24549;23421;59;47970
94;2020-06-21;0;0;0;23212;21883;69;45095
94;2020-06-21;0;0;0;19544;17141;79;36685
94;2020-06-21;0;0;0;11227;8178;89;19405
94;2020-06-21;0;0;0;3332;1447;90;4779
94;2020-06-21;0;0;0;177745;166934;0;344679
01;2020-06-22;0;0;0;19979;20155;09;40134
01;2020-06-22;0;0;0;24994;25489;19;50483
01;2020-06-22;0;0;0;17868;16690;29;34558
01;2020-06-22;0;0;0;22328;14821;39;37149
01;2020-06-22;1;0;1;28652;20276;49;48928
01;2020-06-22;0;0;0;33264;27260;59;60524
01;2020-06-22;0;0;0;27135;23978;69;51113
01;2020-06-22;0;0;0;18401;14661;79;33062
01;2020-06-22;0;0;0;9633;6375;89;16008
01;2020-06-22;0;0;0;3410;1510;90;4920
01;2020-06-22;1;0;1;205664;171215;0;376879
02;2020-06-22;0;0;0;16881;17110;09;33991
02;2020-06-22;0;0;0;21410;21604;19;43014
02;2020-06-22;1;0;1;16017;15479;29;31496
02;2020-06-22;0;0;0;19825;14455;39;34280
02;2020-06-22;0;0;0;24719;18248;49;42967
02;2020-06-22;0;0;0;34361;28310;59;62671
02;2020-06-22;1;0;1;28061;24495;69;52556
02;2020-06-22;0;0;0;18231;15278;79;33509
02;2020-06-22;0;0;0;11090;7677;89;18767
02;2020-06-22;0;0;0;3992;1506;90;5498
02;2020-06-22;2;0;2;194587;164162;0;358749
03;2020-06-22;3;3;6;31123;30920;09;62043
03;2020-06-22;10;5;16;29370;29268;19;58638
03;2020-06-22;20;20;41;21458;18963;29;40421
03;2020-06-22;16;18;34;21276;18326;39;39602
03;2020-06-22;10;16;26;18164;16593;49;34757
03;2020-06-22;15;13;29;13469;13557;59;27026
03;2020-06-22;6;9;15;8776;8670;69;17446
03;2020-06-22;2;6;8;3777;3591;79;7368
03;2020-06-22;1;0;1;1649;1072;89;2721
03;2020-06-22;0;0;0;485;184;90;669
03;2020-06-22;83;90;176;149547;141144;0;290691
04;2020-06-22;0;0;0;60314;61377;09;121691
04;2020-06-22;0;0;0;66065;68387;19;134452
04;2020-06-22;0;0;0;51059;47156;29;98215
04;2020-06-22;0;0;0;58788;45780;39;104568
04;2020-06-22;0;0;0;61408;52207;49;113615
04;2020-06-22;0;0;0;64838;60759;59;125597
04;2020-06-22;0;0;0;47008;42843;69;89851
04;2020-06-22;0;0;0;25509;21184;79;46693
04;2020-06-22;0;0;0;13168;7647;89;20815
04;2020-06-22;0;0;0;3209;1253;90;4462
04;2020-06-22;0;0;0;451366;408593;0;859959
05;2020-06-22;0;0;0;362.366008612902;341.338819562748;09;703.704828175651
05;2020-06-22;0;0;0;353.376145114279;370.349735405642;19;723.725880519921
05;2020-06-22;0;0;0;218.593559489256;256.539602589476;29;475.133162078732
05;2020-06-22;0;0;0;404.225408693299;360.321910454353;39;764.547319147651
05;2020-06-22;0;0;0;520.067953604221;497.108383964256;49;1017.17633756848
05;2020-06-22;0;0;0;468.146063921917;510.087601910415;59;978.233665832332
05;2020-06-22;0;0;0;340.368470050554;334.366842191253;69;674.735312241807
05;2020-06-22;0;0;0;212.598666888387;192.597753227106;79;405.196420115493
05;2020-06-22;0;0;0;148.727797095705;61.8681715431829;89;210.595968638888
05;2020-06-22;0;0;0;32.9601271090696;10.9909785719784;90;43.9511056810479
05;2020-06-22;0;0;0;3061.43020057959;2935.56979942041;0;5997
06;2020-06-22;1;0;1;42583;42380;09;84963
06;2020-06-22;2;1;3;33369;31925;19;65294
06;2020-06-22;2;2;4;21571;15080;29;36651
06;2020-06-22;5;5;10;21550;16147;39;37697
06;2020-06-22;3;1;4;14193;13939;49;28132
06;2020-06-22;2;0;2;7171;7597;59;14768
06;2020-06-22;0;1;1;3629;4117;69;7746
06;2020-06-22;0;0;0;1577;1457;79;3034
06;2020-06-22;0;0;0;531;474;89;1005
06;2020-06-22;0;0;0;88;93;90;181
06;2020-06-22;15;10;25;146262;133209;0;279471
07;2020-06-22;0;0;0;485;549;09;1034
07;2020-06-22;0;0;0;403;432;19;835
07;2020-06-22;0;0;0;764;841;29;1605
07;2020-06-22;0;0;0;824;928;39;1752
07;2020-06-22;0;0;0;788;1020;49;1808
07;2020-06-22;0;0;0;678;870;59;1548
07;2020-06-22;0;0;0;360;382;69;742
07;2020-06-22;0;0;0;231;190;79;421
07;2020-06-22;0;0;0;114;67;89;181
07;2020-06-22;0;0;0;24;11;90;35
07;2020-06-22;0;0;0;4671;5290;0;9961
08;2020-06-22;0;0;0;2715.22592983026;2997.75551488675;09;5712.98144471701
08;2020-06-22;0;0;0;2778.51901080978;3160.9156459093;19;5939.43465671908
08;2020-06-22;0;0;0;2080.8882988764;1718.16634315323;29;3799.05464202964
08;2020-06-22;0;0;0;2701.8582062647;1896.52641413317;39;4598.38462039786
08;2020-06-22;0;0;0;3151.45861023308;2460.52498233809;49;5611.98359257117
08;2020-06-22;1;0;1;2620.29868333099;2422.23566154656;59;5042.53434487755
08;2020-06-22;0;0;0;1621.44173420671;1438.58325779464;69;3060.02499200135
08;2020-06-22;0;0;0;626.575909335673;526.358467843651;79;1152.93437717932
08;2020-06-22;0;0;0;205.018522985054;140.993639349697;89;346.012162334751
08;2020-06-22;0;0;0;50.0325684687745;20.62259870351;90;70.6551671722846
08;2020-06-22;1;0;1;18551.3174743414;16782.6825256586;0;35334
11;2020-06-22;3;5;9;783071;811785;09;1594856
11;2020-06-22;12;6;18;761456;784653;19;1546109
11;2020-06-22;8;18;26;850145;801772;29;1651917
11;2020-06-22;11;9;20;914360;843488;39;1757848
11;2020-06-22;11;18;29;845609;826202;49;1671811
11;2020-06-22;10;11;21;793566;745070;59;1538636
11;2020-06-22;4;9;13;628649;549192;69;1177841
11;2020-06-22;4;6;10;434606;358356;79;792962
11;2020-06-22;7;1;8;261425;162933;89;424358
11;2020-06-22;4;0;4;89253;32619;90;121872
11;2020-06-22;74;83;158;6362140;5916070;0;12278210
24;2020-06-22;0;0;0;139720;144686;09;284406
24;2020-06-22;0;0;0;152979;161185;19;314164
24;2020-06-22;0;0;0;122237;126536;29;248773
24;2020-06-22;1;0;1;150359;142009;39;292368
24;2020-06-22;0;0;0;161829;158758;49;320587
24;2020-06-22;0;0;0;172552;168011;59;340563
24;2020-06-22;1;0;1;172509;158177;69;330686
24;2020-06-22;1;1;2;129428;110593;79;240021
24;2020-06-22;2;1;3;87342;56882;89;144224
24;2020-06-22;0;0;0;31210;12071;90;43281
24;2020-06-22;5;2;7;1320165;1238908;0;2559073
27;2020-06-22;0;0;0;143373;149679;09;293052
27;2020-06-22;0;0;0;160962;173003;19;333965
27;2020-06-22;0;1;1;133746;142254;29;276000
27;2020-06-22;0;1;1;160004;155407;39;315411
27;2020-06-22;1;0;1;172333;169564;49;341897
27;2020-06-22;0;0;0;189979;183788;59;373767
27;2020-06-22;0;0;0;192591;178206;69;370797
27;2020-06-22;0;0;0;146876;127546;79;274422
27;2020-06-22;2;1;3;96896;61575;89;158471
27;2020-06-22;1;0;1;33148;12109;90;45257
27;2020-06-22;4;3;7;1429908;1353131;0;2783039
28;2020-06-22;2;1;3;180735;186856;09;367591
28;2020-06-22;2;4;6;200125;213621;19;413746
28;2020-06-22;1;3;4;168922;173007;29;341929
28;2020-06-22;1;2;3;196628;188487;39;385115
28;2020-06-22;2;4;6;205396;201699;49;407095
28;2020-06-22;1;1;2;222002;213866;59;435868
28;2020-06-22;0;0;0;224688;203758;69;428446
28;2020-06-22;3;0;3;163192;135543;79;298735
28;2020-06-22;3;0;3;109691;65377;89;175068
28;2020-06-22;6;0;6;37222;12685;90;49907
28;2020-06-22;21;15;36;1708601;1594899;0;3303500
32;2020-06-22;0;0;0;358062;373689;09;731751
32;2020-06-22;2;2;4;387045;406742;19;793787
32;2020-06-22;1;4;5;342304;348587;29;690891
32;2020-06-22;6;5;11;382485;369972;39;752457
32;2020-06-22;4;2;6;382510;376716;49;759226
32;2020-06-22;0;3;3;386937;376527;59;763464
32;2020-06-22;2;4;6;371211;330938;69;702149
32;2020-06-22;2;1;3;250542;201459;79;452001
32;2020-06-22;4;3;7;163399;89786;89;253185
32;2020-06-22;3;0;3;48384;15367;90;63751
32;2020-06-22;24;24;48;3072879;2889783;0;5962662
44;2020-06-22;3;1;4;291525;306839;09;598364
44;2020-06-22;2;1;3;320255;339504;19;659759
44;2020-06-22;3;2;5;302020;314428;29;616448
44;2020-06-22;4;3;7;342222;333292;39;675514
44;2020-06-22;1;2;3;349727;344491;49;694218
44;2020-06-22;2;2;4;381371;373239;59;754610
44;2020-06-22;3;1;4;367165;335850;69;703015
44;2020-06-22;2;0;2;250387;215436;79;465823
44;2020-06-22;2;1;3;170825;105192;89;276017
44;2020-06-22;1;1;2;51248;16731;90;67979
44;2020-06-22;23;14;37;2826745;2685002;0;5511747
52;2020-06-22;2;1;3;213594;223900;09;437494
52;2020-06-22;0;0;0;240818;255197;19;496015
52;2020-06-22;1;2;3;197010;200630;29;397640
52;2020-06-22;1;2;3;231204;224885;39;456089
52;2020-06-22;0;0;0;243874;243418;49;487292
52;2020-06-22;0;1;1;244100;239116;59;483216
52;2020-06-22;2;0;2;241796;221345;69;463141
52;2020-06-22;1;1;2;177805;149903;79;327708
52;2020-06-22;0;0;0;119561;75822;89;195383
52;2020-06-22;0;1;1;42559;15260;90;57819
52;2020-06-22;7;8;15;1952321;1849476;0;3801797
53;2020-06-22;0;0;0;173813;182358;09;356171
53;2020-06-22;0;1;1;202720;214740;19;417460
53;2020-06-22;0;0;0;163116;173196;29;336312
53;2020-06-22;1;1;2;190526;187674;39;378200
53;2020-06-22;0;0;0;212098;212015;49;424113
53;2020-06-22;1;0;1;223699;219176;59;442875
53;2020-06-22;0;0;0;227435;209274;69;436709
53;2020-06-22;1;0;1;169992;140910;79;310902
53;2020-06-22;0;0;0;118117;69883;89;188000
53;2020-06-22;0;0;0;37370;12267;90;49637
53;2020-06-22;3;2;5;1718886;1621493;0;3340379
75;2020-06-22;0;2;2;293104;305291;09;598395
75;2020-06-22;0;0;0;337141;357785;19;694926
75;2020-06-22;0;0;0;295024;300618;29;595642
75;2020-06-22;1;0;1;347871;331233;39;679104
75;2020-06-22;3;0;3;384742;372771;49;757513
75;2020-06-22;1;0;1;413361;390880;59;804241
75;2020-06-22;1;0;1;425623;384060;69;809683
75;2020-06-22;0;0;0;325086;276298;79;601384
75;2020-06-22;0;0;0;213986;139308;89;353294
75;2020-06-22;0;0;0;77600;28200;90;105800
75;2020-06-22;6;2;8;3113538;2886444;0;5999982
76;2020-06-22;3;0;3;305956;318589;09;624545
76;2020-06-22;1;3;4;338942;356969;19;695911
76;2020-06-22;2;1;3;316210;319570;29;635780
76;2020-06-22;2;4;6;356758;337587;39;694345
76;2020-06-22;2;2;4;376541;363812;49;740353
76;2020-06-22;2;2;4;402608;383750;59;786358
76;2020-06-22;1;1;2;394889;358997;69;753886
76;2020-06-22;0;0;0;308664;263806;79;572470
76;2020-06-22;0;0;0;195838;129272;89;325110
76;2020-06-22;0;0;0;69372;26728;90;96100
76;2020-06-22;13;13;26;3065778;2859080;0;5924858
84;2020-06-22;1;2;3;459549;481088;09;940637
84;2020-06-22;3;2;5;487711;511905;19;999616
84;2020-06-22;0;2;2;443824;451094;29;894918
84;2020-06-22;4;0;4;512522;493262;39;1005784
84;2020-06-22;2;3;5;520248;515106;49;1035354
84;2020-06-22;2;1;3;529611;514848;59;1044459
84;2020-06-22;1;1;2;486720;439940;69;926660
84;2020-06-22;2;3;5;372151;315211;79;687362
84;2020-06-22;2;1;3;237198;150524;89;387722
84;2020-06-22;0;0;0;81185;28680;90;109865
84;2020-06-22;17;15;32;4130719;3901658;0;8032377
93;2020-06-22;0;1;1;268834;283093;09;551927
93;2020-06-22;0;1;1;280751;296087;19;576838
93;2020-06-22;0;2;2;254404;255552;29;509956
93;2020-06-22;0;0;0;310704;288398;39;599102
93;2020-06-22;0;1;1;325559;305827;49;631386
93;2020-06-22;0;1;1;353104;325389;59;678493
93;2020-06-22;1;1;2;336327;296459;69;632786
93;2020-06-22;0;0;0;279820;229699;79;509519
93;2020-06-22;1;0;1;171274;113716;89;284990
93;2020-06-22;0;1;1;58896;21758;90;80654
93;2020-06-22;2;8;10;2639673;2415978;0;5055651
94;2020-06-22;0;0;0;16311;17433;09;33744
94;2020-06-22;0;0;0;16679;18132;19;34811
94;2020-06-22;0;0;0;16782;16579;29;33361
94;2020-06-22;0;0;0;23044;20580;39;43624
94;2020-06-22;0;0;0;23065;22140;49;45205
94;2020-06-22;0;0;0;24549;23421;59;47970
94;2020-06-22;0;0;0;23212;21883;69;45095
94;2020-06-22;0;0;0;19544;17141;79;36685
94;2020-06-22;1;0;1;11227;8178;89;19405
94;2020-06-22;0;0;0;3332;1447;90;4779
94;2020-06-22;1;0;1;177745;166934;0;344679
01;2020-06-23;0;0;0;19979;20155;09;40134
01;2020-06-23;0;0;0;24994;25489;19;50483
01;2020-06-23;0;1;1;17868;16690;29;34558
01;2020-06-23;0;0;0;22328;14821;39;37149
01;2020-06-23;0;0;0;28652;20276;49;48928
01;2020-06-23;0;0;0;33264;27260;59;60524
01;2020-06-23;0;0;0;27135;23978;69;51113
01;2020-06-23;0;0;0;18401;14661;79;33062
01;2020-06-23;0;0;0;9633;6375;89;16008
01;2020-06-23;0;0;0;3410;1510;90;4920
01;2020-06-23;0;1;1;205664;171215;0;376879
02;2020-06-23;0;0;0;16881;17110;09;33991
02;2020-06-23;1;0;1;21410;21604;19;43014
02;2020-06-23;0;0;0;16017;15479;29;31496
02;2020-06-23;0;0;0;19825;14455;39;34280
02;2020-06-23;0;0;0;24719;18248;49;42967
02;2020-06-23;0;1;1;34361;28310;59;62671
02;2020-06-23;0;0;0;28061;24495;69;52556
02;2020-06-23;0;0;0;18231;15278;79;33509
02;2020-06-23;0;0;0;11090;7677;89;18767
02;2020-06-23;0;0;0;3992;1506;90;5498
02;2020-06-23;1;1;2;194587;164162;0;358749
03;2020-06-23;3;7;10;31123;30920;09;62043
03;2020-06-23;12;11;24;29370;29268;19;58638
03;2020-06-23;17;24;44;21458;18963;29;40421
03;2020-06-23;28;22;53;21276;18326;39;39602
03;2020-06-23;25;18;44;18164;16593;49;34757
03;2020-06-23;18;16;34;13469;13557;59;27026
03;2020-06-23;9;7;16;8776;8670;69;17446
03;2020-06-23;1;7;8;3777;3591;79;7368
03;2020-06-23;5;3;8;1649;1072;89;2721
03;2020-06-23;0;0;0;485;184;90;669
03;2020-06-23;118;115;241;149547;141144;0;290691
04;2020-06-23;0;0;0;60314;61377;09;121691
04;2020-06-23;0;0;0;66065;68387;19;134452
04;2020-06-23;0;1;1;51059;47156;29;98215
04;2020-06-23;0;0;0;58788;45780;39;104568
04;2020-06-23;0;0;0;61408;52207;49;113615
04;2020-06-23;0;0;0;64838;60759;59;125597
04;2020-06-23;1;0;1;47008;42843;69;89851
04;2020-06-23;0;0;0;25509;21184;79;46693
04;2020-06-23;0;0;0;13168;7647;89;20815
04;2020-06-23;0;0;0;3209;1253;90;4462
04;2020-06-23;1;1;2;451366;408593;0;859959
05;2020-06-23;0;0;0;362.366008612902;341.338819562748;09;703.704828175651
05;2020-06-23;0;0;0;353.376145114279;370.349735405642;19;723.725880519921
05;2020-06-23;0;0;0;218.593559489256;256.539602589476;29;475.133162078732
05;2020-06-23;0;0;0;404.225408693299;360.321910454353;39;764.547319147651
05;2020-06-23;0;0;0;520.067953604221;497.108383964256;49;1017.17633756848
05;2020-06-23;0;0;0;468.146063921917;510.087601910415;59;978.233665832332
05;2020-06-23;0;0;0;340.368470050554;334.366842191253;69;674.735312241807
05;2020-06-23;0;0;0;212.598666888387;192.597753227106;79;405.196420115493
05;2020-06-23;0;0;0;148.727797095705;61.8681715431829;89;210.595968638888
05;2020-06-23;0;0;0;32.9601271090696;10.9909785719784;90;43.9511056810479
05;2020-06-23;0;0;0;3061.43020057959;2935.56979942041;0;5997
06;2020-06-23;1;0;1;42583;42380;09;84963
06;2020-06-23;6;1;7;33369;31925;19;65294
06;2020-06-23;3;3;6;21571;15080;29;36651
06;2020-06-23;3;2;5;21550;16147;39;37697
06;2020-06-23;2;4;6;14193;13939;49;28132
06;2020-06-23;2;0;2;7171;7597;59;14768
06;2020-06-23;1;1;2;3629;4117;69;7746
06;2020-06-23;0;2;2;1577;1457;79;3034
06;2020-06-23;0;0;0;531;474;89;1005
06;2020-06-23;0;0;0;88;93;90;181
06;2020-06-23;18;13;31;146262;133209;0;279471
07;2020-06-23;0;0;0;485;549;09;1034
07;2020-06-23;0;0;0;403;432;19;835
07;2020-06-23;0;0;0;764;841;29;1605
07;2020-06-23;0;0;0;824;928;39;1752
07;2020-06-23;0;0;0;788;1020;49;1808
07;2020-06-23;0;0;0;678;870;59;1548
07;2020-06-23;0;0;0;360;382;69;742
07;2020-06-23;0;0;0;231;190;79;421
07;2020-06-23;0;0;0;114;67;89;181
07;2020-06-23;0;0;0;24;11;90;35
07;2020-06-23;0;0;0;4671;5290;0;9961
08;2020-06-23;0;0;0;2715.22592983026;2997.75551488675;09;5712.98144471701
08;2020-06-23;0;0;0;2778.51901080978;3160.9156459093;19;5939.43465671908
08;2020-06-23;0;0;0;2080.8882988764;1718.16634315323;29;3799.05464202964
08;2020-06-23;0;0;0;2701.8582062647;1896.52641413317;39;4598.38462039786
08;2020-06-23;0;0;0;3151.45861023308;2460.52498233809;49;5611.98359257117
08;2020-06-23;0;0;0;2620.29868333099;2422.23566154656;59;5042.53434487755
08;2020-06-23;0;0;0;1621.44173420671;1438.58325779464;69;3060.02499200135
08;2020-06-23;0;0;0;626.575909335673;526.358467843651;79;1152.93437717932
08;2020-06-23;0;0;0;205.018522985054;140.993639349697;89;346.012162334751
08;2020-06-23;0;0;0;50.0325684687745;20.62259870351;90;70.6551671722846
08;2020-06-23;0;0;0;18551.3174743414;16782.6825256586;0;35334
11;2020-06-23;2;1;4;783071;811785;09;1594856
11;2020-06-23;13;7;20;761456;784653;19;1546109
11;2020-06-23;12;9;22;850145;801772;29;1651917
11;2020-06-23;9;21;30;914360;843488;39;1757848
11;2020-06-23;8;9;17;845609;826202;49;1671811
11;2020-06-23;5;9;14;793566;745070;59;1538636
11;2020-06-23;4;6;10;628649;549192;69;1177841
11;2020-06-23;4;1;5;434606;358356;79;792962
11;2020-06-23;4;4;8;261425;162933;89;424358
11;2020-06-23;3;1;4;89253;32619;90;121872
11;2020-06-23;65;68;135;6362140;5916070;0;12278210
24;2020-06-23;0;0;0;139720;144686;09;284406
24;2020-06-23;0;0;0;152979;161185;19;314164
24;2020-06-23;0;1;1;122237;126536;29;248773
24;2020-06-23;3;0;3;150359;142009;39;292368
24;2020-06-23;1;1;2;161829;158758;49;320587
24;2020-06-23;1;0;1;172552;168011;59;340563
24;2020-06-23;1;0;1;172509;158177;69;330686
24;2020-06-23;0;0;0;129428;110593;79;240021
24;2020-06-23;1;1;2;87342;56882;89;144224
24;2020-06-23;2;0;2;31210;12071;90;43281
24;2020-06-23;9;3;12;1320165;1238908;0;2559073
27;2020-06-23;0;0;0;143373;149679;09;293052
27;2020-06-23;1;0;1;160962;173003;19;333965
27;2020-06-23;0;1;1;133746;142254;29;276000
27;2020-06-23;1;0;1;160004;155407;39;315411
27;2020-06-23;2;0;2;172333;169564;49;341897
27;2020-06-23;1;2;3;189979;183788;59;373767
27;2020-06-23;0;0;0;192591;178206;69;370797
27;2020-06-23;0;0;0;146876;127546;79;274422
27;2020-06-23;0;0;0;96896;61575;89;158471
27;2020-06-23;1;0;1;33148;12109;90;45257
27;2020-06-23;6;3;9;1429908;1353131;0;2783039
28;2020-06-23;1;1;2;180735;186856;09;367591
28;2020-06-23;1;3;4;200125;213621;19;413746
28;2020-06-23;2;2;4;168922;173007;29;341929
28;2020-06-23;4;1;5;196628;188487;39;385115
28;2020-06-23;2;2;4;205396;201699;49;407095
28;2020-06-23;2;3;5;222002;213866;59;435868
28;2020-06-23;0;0;0;224688;203758;69;428446
28;2020-06-23;0;0;0;163192;135543;79;298735
28;2020-06-23;1;0;1;109691;65377;89;175068
28;2020-06-23;0;0;0;37222;12685;90;49907
28;2020-06-23;13;12;25;1708601;1594899;0;3303500
32;2020-06-23;4;3;7;358062;373689;09;731751
32;2020-06-23;5;7;12;387045;406742;19;793787
32;2020-06-23;5;7;12;342304;348587;29;690891
32;2020-06-23;1;4;5;382485;369972;39;752457
32;2020-06-23;3;3;6;382510;376716;49;759226
32;2020-06-23;1;3;4;386937;376527;59;763464
32;2020-06-23;6;1;7;371211;330938;69;702149
32;2020-06-23;3;2;5;250542;201459;79;452001
32;2020-06-23;4;2;6;163399;89786;89;253185
32;2020-06-23;2;0;2;48384;15367;90;63751
32;2020-06-23;34;32;66;3072879;2889783;0;5962662
44;2020-06-23;3;1;4;291525;306839;09;598364
44;2020-06-23;2;1;3;320255;339504;19;659759
44;2020-06-23;1;2;3;302020;314428;29;616448
44;2020-06-23;1;1;2;342222;333292;39;675514
44;2020-06-23;3;1;4;349727;344491;49;694218
44;2020-06-23;2;1;3;381371;373239;59;754610
44;2020-06-23;0;2;2;367165;335850;69;703015
44;2020-06-23;1;2;3;250387;215436;79;465823
44;2020-06-23;1;2;3;170825;105192;89;276017
44;2020-06-23;0;0;0;51248;16731;90;67979
44;2020-06-23;14;13;27;2826745;2685002;0;5511747
52;2020-06-23;1;1;2;213594;223900;09;437494
52;2020-06-23;0;1;1;240818;255197;19;496015
52;2020-06-23;1;4;5;197010;200630;29;397640
52;2020-06-23;1;0;1;231204;224885;39;456089
52;2020-06-23;0;3;3;243874;243418;49;487292
52;2020-06-23;2;0;2;244100;239116;59;483216
52;2020-06-23;1;0;1;241796;221345;69;463141
52;2020-06-23;0;0;0;177805;149903;79;327708
52;2020-06-23;0;0;0;119561;75822;89;195383
52;2020-06-23;0;0;0;42559;15260;90;57819
52;2020-06-23;6;9;15;1952321;1849476;0;3801797
53;2020-06-23;0;0;0;173813;182358;09;356171
53;2020-06-23;0;0;0;202720;214740;19;417460
53;2020-06-23;1;0;1;163116;173196;29;336312
53;2020-06-23;0;1;1;190526;187674;39;378200
53;2020-06-23;0;1;1;212098;212015;49;424113
53;2020-06-23;0;0;0;223699;219176;59;442875
53;2020-06-23;0;0;0;227435;209274;69;436709
53;2020-06-23;0;0;0;169992;140910;79;310902
53;2020-06-23;0;0;0;118117;69883;89;188000
53;2020-06-23;2;0;2;37370;12267;90;49637
53;2020-06-23;3;2;5;1718886;1621493;0;3340379
75;2020-06-23;0;1;1;293104;305291;09;598395
75;2020-06-23;1;1;2;337141;357785;19;694926
75;2020-06-23;1;0;1;295024;300618;29;595642
75;2020-06-23;1;2;3;347871;331233;39;679104
75;2020-06-23;1;0;1;384742;372771;49;757513
75;2020-06-23;2;2;4;413361;390880;59;804241
75;2020-06-23;0;0;0;425623;384060;69;809683
75;2020-06-23;0;0;0;325086;276298;79;601384
75;2020-06-23;0;0;0;213986;139308;89;353294
75;2020-06-23;0;0;0;77600;28200;90;105800
75;2020-06-23;6;6;12;3113538;2886444;0;5999982
76;2020-06-23;0;0;0;305956;318589;09;624545
76;2020-06-23;1;0;1;338942;356969;19;695911
76;2020-06-23;1;3;4;316210;319570;29;635780
76;2020-06-23;1;2;3;356758;337587;39;694345
76;2020-06-23;3;1;4;376541;363812;49;740353
76;2020-06-23;2;2;4;402608;383750;59;786358
76;2020-06-23;0;2;2;394889;358997;69;753886
76;2020-06-23;0;1;1;308664;263806;79;572470
76;2020-06-23;0;1;1;195838;129272;89;325110
76;2020-06-23;0;1;1;69372;26728;90;96100
76;2020-06-23;8;14;22;3065778;2859080;0;5924858
84;2020-06-23;2;2;4;459549;481088;09;940637
84;2020-06-23;0;2;2;487711;511905;19;999616
84;2020-06-23;4;3;7;443824;451094;29;894918
84;2020-06-23;0;1;1;512522;493262;39;1005784
84;2020-06-23;3;0;3;520248;515106;49;1035354
84;2020-06-23;5;1;6;529611;514848;59;1044459
84;2020-06-23;0;2;2;486720;439940;69;926660
84;2020-06-23;0;2;2;372151;315211;79;687362
84;2020-06-23;2;2;4;237198;150524;89;387722
84;2020-06-23;1;1;2;81185;28680;90;109865
84;2020-06-23;17;16;33;4130719;3901658;0;8032377
93;2020-06-23;0;0;0;268834;283093;09;551927
93;2020-06-23;1;0;1;280751;296087;19;576838
93;2020-06-23;1;2;3;254404;255552;29;509956
93;2020-06-23;2;1;3;310704;288398;39;599102
93;2020-06-23;0;1;1;325559;305827;49;631386
93;2020-06-23;2;2;4;353104;325389;59;678493
93;2020-06-23;0;1;1;336327;296459;69;632786
93;2020-06-23;1;0;1;279820;229699;79;509519
93;2020-06-23;0;2;2;171274;113716;89;284990
93;2020-06-23;1;0;1;58896;21758;90;80654
93;2020-06-23;8;9;17;2639673;2415978;0;5055651
94;2020-06-23;0;0;0;16311;17433;09;33744
94;2020-06-23;0;0;0;16679;18132;19;34811
94;2020-06-23;0;1;1;16782;16579;29;33361
94;2020-06-23;0;0;0;23044;20580;39;43624
94;2020-06-23;0;0;0;23065;22140;49;45205
94;2020-06-23;0;0;0;24549;23421;59;47970
94;2020-06-23;0;0;0;23212;21883;69;45095
94;2020-06-23;0;0;0;19544;17141;79;36685
94;2020-06-23;0;0;0;11227;8178;89;19405
94;2020-06-23;0;0;0;3332;1447;90;4779
94;2020-06-23;0;1;1;177745;166934;0;344679
01;2020-06-24;0;0;0;19979;20155;09;40134
01;2020-06-24;0;0;0;24994;25489;19;50483
01;2020-06-24;0;0;0;17868;16690;29;34558
01;2020-06-24;0;0;0;22328;14821;39;37149
01;2020-06-24;0;0;0;28652;20276;49;48928
01;2020-06-24;0;0;0;33264;27260;59;60524
01;2020-06-24;0;0;0;27135;23978;69;51113
01;2020-06-24;0;0;0;18401;14661;79;33062
01;2020-06-24;0;0;0;9633;6375;89;16008
01;2020-06-24;0;0;0;3410;1510;90;4920
01;2020-06-24;0;0;0;205664;171215;0;376879
02;2020-06-24;0;0;0;16881;17110;09;33991
02;2020-06-24;0;0;0;21410;21604;19;43014
02;2020-06-24;0;0;0;16017;15479;29;31496
02;2020-06-24;0;0;0;19825;14455;39;34280
02;2020-06-24;0;0;0;24719;18248;49;42967
02;2020-06-24;0;1;1;34361;28310;59;62671
02;2020-06-24;0;0;0;28061;24495;69;52556
02;2020-06-24;0;0;0;18231;15278;79;33509
02;2020-06-24;0;0;0;11090;7677;89;18767
02;2020-06-24;0;0;0;3992;1506;90;5498
02;2020-06-24;0;1;1;194587;164162;0;358749
03;2020-06-24;6;5;12;31123;30920;09;62043
03;2020-06-24;15;9;25;29370;29268;19;58638
03;2020-06-24;30;27;57;21458;18963;29;40421
03;2020-06-24;34;22;58;21276;18326;39;39602
03;2020-06-24;26;27;53;18164;16593;49;34757
03;2020-06-24;12;20;32;13469;13557;59;27026
03;2020-06-24;7;12;19;8776;8670;69;17446
03;2020-06-24;2;6;8;3777;3591;79;7368
03;2020-06-24;0;1;1;1649;1072;89;2721
03;2020-06-24;0;0;0;485;184;90;669
03;2020-06-24;132;129;265;149547;141144;0;290691
04;2020-06-24;0;0;0;60314;61377;09;121691
04;2020-06-24;0;1;1;66065;68387;19;134452
04;2020-06-24;2;0;2;51059;47156;29;98215
04;2020-06-24;0;1;1;58788;45780;39;104568
04;2020-06-24;2;0;2;61408;52207;49;113615
04;2020-06-24;1;1;2;64838;60759;59;125597
04;2020-06-24;0;0;0;47008;42843;69;89851
04;2020-06-24;0;0;0;25509;21184;79;46693
04;2020-06-24;0;0;0;13168;7647;89;20815
04;2020-06-24;0;0;0;3209;1253;90;4462
04;2020-06-24;5;3;8;451366;408593;0;859959
05;2020-06-24;0;0;0;362.366008612902;341.338819562748;09;703.704828175651
05;2020-06-24;0;0;0;353.376145114279;370.349735405642;19;723.725880519921
05;2020-06-24;0;0;0;218.593559489256;256.539602589476;29;475.133162078732
05;2020-06-24;0;0;0;404.225408693299;360.321910454353;39;764.547319147651
05;2020-06-24;0;0;0;520.067953604221;497.108383964256;49;1017.17633756848
05;2020-06-24;0;0;0;468.146063921917;510.087601910415;59;978.233665832332
05;2020-06-24;0;0;0;340.368470050554;334.366842191253;69;674.735312241807
05;2020-06-24;0;0;0;212.598666888387;192.597753227106;79;405.196420115493
05;2020-06-24;0;0;0;148.727797095705;61.8681715431829;89;210.595968638888
05;2020-06-24;0;0;0;32.9601271090696;10.9909785719784;90;43.9511056810479
05;2020-06-24;0;0;0;3061.43020057959;2935.56979942041;0;5997
06;2020-06-24;0;0;0;42583;42380;09;84963
06;2020-06-24;2;3;5;33369;31925;19;65294
06;2020-06-24;3;3;6;21571;15080;29;36651
06;2020-06-24;1;2;3;21550;16147;39;37697
06;2020-06-24;3;3;6;14193;13939;49;28132
06;2020-06-24;2;2;4;7171;7597;59;14768
06;2020-06-24;2;0;2;3629;4117;69;7746
06;2020-06-24;1;0;1;1577;1457;79;3034
06;2020-06-24;0;0;0;531;474;89;1005
06;2020-06-24;0;0;0;88;93;90;181
06;2020-06-24;14;13;27;146262;133209;0;279471
07;2020-06-24;0;0;0;485;549;09;1034
07;2020-06-24;0;0;0;403;432;19;835
07;2020-06-24;0;0;0;764;841;29;1605
07;2020-06-24;0;0;0;824;928;39;1752
07;2020-06-24;0;0;0;788;1020;49;1808
07;2020-06-24;0;0;0;678;870;59;1548
07;2020-06-24;0;0;0;360;382;69;742
07;2020-06-24;0;0;0;231;190;79;421
07;2020-06-24;0;0;0;114;67;89;181
07;2020-06-24;0;0;0;24;11;90;35
07;2020-06-24;0;0;0;4671;5290;0;9961
08;2020-06-24;0;0;0;2715.22592983026;2997.75551488675;09;5712.98144471701
08;2020-06-24;0;0;0;2778.51901080978;3160.9156459093;19;5939.43465671908
08;2020-06-24;0;0;0;2080.8882988764;1718.16634315323;29;3799.05464202964
08;2020-06-24;0;0;0;2701.8582062647;1896.52641413317;39;4598.38462039786
08;2020-06-24;0;0;0;3151.45861023308;2460.52498233809;49;5611.98359257117
08;2020-06-24;0;0;0;2620.29868333099;2422.23566154656;59;5042.53434487755
08;2020-06-24;0;1;1;1621.44173420671;1438.58325779464;69;3060.02499200135
08;2020-06-24;0;0;0;626.575909335673;526.358467843651;79;1152.93437717932
08;2020-06-24;0;0;0;205.018522985054;140.993639349697;89;346.012162334751
08;2020-06-24;0;0;0;50.0325684687745;20.62259870351;90;70.6551671722846
08;2020-06-24;0;1;1;18551.3174743414;16782.6825256586;0;35334
11;2020-06-24;3;3;6;783071;811785;09;1594856
11;2020-06-24;9;2;11;761456;784653;19;1546109
11;2020-06-24;11;10;21;850145;801772;29;1651917
11;2020-06-24;15;17;32;914360;843488;39;1757848
11;2020-06-24;6;7;13;845609;826202;49;1671811
11;2020-06-24;6;10;16;793566;745070;59;1538636
11;2020-06-24;8;1;10;628649;549192;69;1177841
11;2020-06-24;3;5;8;434606;358356;79;792962
11;2020-06-24;7;3;10;261425;162933;89;424358
11;2020-06-24;4;2;6;89253;32619;90;121872
11;2020-06-24;72;60;133;6362140;5916070;0;12278210
24;2020-06-24;1;0;1;139720;144686;09;284406
24;2020-06-24;1;0;1;152979;161185;19;314164
24;2020-06-24;1;0;1;122237;126536;29;248773
24;2020-06-24;1;0;1;150359;142009;39;292368
24;2020-06-24;0;1;1;161829;158758;49;320587
24;2020-06-24;0;0;0;172552;168011;59;340563
24;2020-06-24;0;0;0;172509;158177;69;330686
24;2020-06-24;0;0;0;129428;110593;79;240021
24;2020-06-24;0;0;0;87342;56882;89;144224
24;2020-06-24;0;0;0;31210;12071;90;43281
24;2020-06-24;4;1;5;1320165;1238908;0;2559073
27;2020-06-24;0;0;0;143373;149679;09;293052
27;2020-06-24;0;1;1;160962;173003;19;333965
27;2020-06-24;0;0;0;133746;142254;29;276000
27;2020-06-24;1;1;2;160004;155407;39;315411
27;2020-06-24;1;2;3;172333;169564;49;341897
27;2020-06-24;1;0;1;189979;183788;59;373767
27;2020-06-24;0;1;1;192591;178206;69;370797
27;2020-06-24;0;0;0;146876;127546;79;274422
27;2020-06-24;0;1;1;96896;61575;89;158471
27;2020-06-24;2;0;2;33148;12109;90;45257
27;2020-06-24;5;6;11;1429908;1353131;0;2783039
28;2020-06-24;0;3;3;180735;186856;09;367591
28;2020-06-24;1;1;2;200125;213621;19;413746
28;2020-06-24;4;1;5;168922;173007;29;341929
28;2020-06-24;2;0;2;196628;188487;39;385115
28;2020-06-24;1;2;3;205396;201699;49;407095
28;2020-06-24;1;1;2;222002;213866;59;435868
28;2020-06-24;0;1;1;224688;203758;69;428446
28;2020-06-24;0;0;0;163192;135543;79;298735
28;2020-06-24;1;1;2;109691;65377;89;175068
28;2020-06-24;1;0;1;37222;12685;90;49907
28;2020-06-24;11;10;21;1708601;1594899;0;3303500
32;2020-06-24;3;1;4;358062;373689;09;731751
32;2020-06-24;2;2;4;387045;406742;19;793787
32;2020-06-24;2;3;5;342304;348587;29;690891
32;2020-06-24;6;5;11;382485;369972;39;752457
32;2020-06-24;1;4;5;382510;376716;49;759226
32;2020-06-24;1;0;1;386937;376527;59;763464
32;2020-06-24;1;2;3;371211;330938;69;702149
32;2020-06-24;2;0;2;250542;201459;79;452001
32;2020-06-24;1;4;5;163399;89786;89;253185
32;2020-06-24;1;0;1;48384;15367;90;63751
32;2020-06-24;20;21;41;3072879;2889783;0;5962662
44;2020-06-24;3;0;3;291525;306839;09;598364
44;2020-06-24;0;1;1;320255;339504;19;659759
44;2020-06-24;6;1;7;302020;314428;29;616448
44;2020-06-24;1;1;2;342222;333292;39;675514
44;2020-06-24;3;2;5;349727;344491;49;694218
44;2020-06-24;1;2;3;381371;373239;59;754610
44;2020-06-24;2;0;2;367165;335850;69;703015
44;2020-06-24;2;2;4;250387;215436;79;465823
44;2020-06-24;4;1;5;170825;105192;89;276017
44;2020-06-24;1;0;1;51248;16731;90;67979
44;2020-06-24;23;10;33;2826745;2685002;0;5511747
52;2020-06-24;1;1;2;213594;223900;09;437494
52;2020-06-24;2;0;2;240818;255197;19;496015
52;2020-06-24;2;4;6;197010;200630;29;397640
52;2020-06-24;1;2;3;231204;224885;39;456089
52;2020-06-24;1;1;2;243874;243418;49;487292
52;2020-06-24;0;0;0;244100;239116;59;483216
52;2020-06-24;0;0;0;241796;221345;69;463141
52;2020-06-24;0;0;0;177805;149903;79;327708
52;2020-06-24;0;1;1;119561;75822;89;195383
52;2020-06-24;0;0;0;42559;15260;90;57819
52;2020-06-24;7;9;16;1952321;1849476;0;3801797
53;2020-06-24;0;0;0;173813;182358;09;356171
53;2020-06-24;0;0;0;202720;214740;19;417460
53;2020-06-24;2;0;2;163116;173196;29;336312
53;2020-06-24;0;0;0;190526;187674;39;378200
53;2020-06-24;0;1;1;212098;212015;49;424113
53;2020-06-24;0;1;1;223699;219176;59;442875
53;2020-06-24;0;0;0;227435;209274;69;436709
53;2020-06-24;0;0;0;169992;140910;79;310902
53;2020-06-24;0;0;0;118117;69883;89;188000
53;2020-06-24;0;0;0;37370;12267;90;49637
53;2020-06-24;2;2;4;1718886;1621493;0;3340379
75;2020-06-24;0;0;0;293104;305291;09;598395
75;2020-06-24;1;1;2;337141;357785;19;694926
75;2020-06-24;1;1;2;295024;300618;29;595642
75;2020-06-24;1;1;2;347871;331233;39;679104
75;2020-06-24;0;0;0;384742;372771;49;757513
75;2020-06-24;0;1;1;413361;390880;59;804241
75;2020-06-24;1;0;1;425623;384060;69;809683
75;2020-06-24;0;0;0;325086;276298;79;601384
75;2020-06-24;0;0;0;213986;139308;89;353294
75;2020-06-24;0;0;0;77600;28200;90;105800
75;2020-06-24;4;4;8;3113538;2886444;0;5999982
76;2020-06-24;2;2;4;305956;318589;09;624545
76;2020-06-24;1;1;2;338942;356969;19;695911
76;2020-06-24;1;2;3;316210;319570;29;635780
76;2020-06-24;2;3;5;356758;337587;39;694345
76;2020-06-24;1;1;2;376541;363812;49;740353
76;2020-06-24;1;1;2;402608;383750;59;786358
76;2020-06-24;1;1;2;394889;358997;69;753886
76;2020-06-24;0;0;0;308664;263806;79;572470
76;2020-06-24;1;1;2;195838;129272;89;325110
76;2020-06-24;0;1;1;69372;26728;90;96100
76;2020-06-24;10;14;24;3065778;2859080;0;5924858
84;2020-06-24;1;5;6;459549;481088;09;940637
84;2020-06-24;1;3;4;487711;511905;19;999616
84;2020-06-24;4;3;7;443824;451094;29;894918
84;2020-06-24;6;2;8;512522;493262;39;1005784
84;2020-06-24;4;3;7;520248;515106;49;1035354
84;2020-06-24;2;4;6;529611;514848;59;1044459
84;2020-06-24;2;2;4;486720;439940;69;926660
84;2020-06-24;0;2;2;372151;315211;79;687362
84;2020-06-24;2;0;2;237198;150524;89;387722
84;2020-06-24;2;0;2;81185;28680;90;109865
84;2020-06-24;24;24;48;4130719;3901658;0;8032377
93;2020-06-24;0;1;1;268834;283093;09;551927
93;2020-06-24;0;0;0;280751;296087;19;576838
93;2020-06-24;3;3;6;254404;255552;29;509956
93;2020-06-24;2;2;4;310704;288398;39;599102
93;2020-06-24;2;0;2;325559;305827;49;631386
93;2020-06-24;3;0;3;353104;325389;59;678493
93;2020-06-24;0;1;1;336327;296459;69;632786
93;2020-06-24;0;2;2;279820;229699;79;509519
93;2020-06-24;0;0;0;171274;113716;89;284990
93;2020-06-24;0;0;0;58896;21758;90;80654
93;2020-06-24;10;9;19;2639673;2415978;0;5055651
94;2020-06-24;0;0;0;16311;17433;09;33744
94;2020-06-24;0;0;0;16679;18132;19;34811
94;2020-06-24;0;1;1;16782;16579;29;33361
94;2020-06-24;0;0;0;23044;20580;39;43624
94;2020-06-24;0;0;0;23065;22140;49;45205
94;2020-06-24;0;0;0;24549;23421;59;47970
94;2020-06-24;0;0;0;23212;21883;69;45095
94;2020-06-24;0;0;0;19544;17141;79;36685
94;2020-06-24;0;0;0;11227;8178;89;19405
94;2020-06-24;0;0;0;3332;1447;90;4779
94;2020-06-24;0;1;1;177745;166934;0;344679
01;2020-06-25;0;0;0;19979;20155;09;40134
01;2020-06-25;1;0;1;24994;25489;19;50483
01;2020-06-25;0;0;0;17868;16690;29;34558
01;2020-06-25;0;0;0;22328;14821;39;37149
01;2020-06-25;1;0;1;28652;20276;49;48928
01;2020-06-25;0;0;0;33264;27260;59;60524
01;2020-06-25;1;0;1;27135;23978;69;51113
01;2020-06-25;0;0;0;18401;14661;79;33062
01;2020-06-25;0;0;0;9633;6375;89;16008
01;2020-06-25;0;0;0;3410;1510;90;4920
01;2020-06-25;3;0;3;205664;171215;0;376879
02;2020-06-25;1;0;1;16881;17110;09;33991
02;2020-06-25;0;0;0;21410;21604;19;43014
02;2020-06-25;0;0;0;16017;15479;29;31496
02;2020-06-25;1;0;1;19825;14455;39;34280
02;2020-06-25;1;0;1;24719;18248;49;42967
02;2020-06-25;0;0;0;34361;28310;59;62671
02;2020-06-25;0;0;0;28061;24495;69;52556
02;2020-06-25;0;0;0;18231;15278;79;33509
02;2020-06-25;0;0;0;11090;7677;89;18767
02;2020-06-25;0;0;0;3992;1506;90;5498
02;2020-06-25;3;0;3;194587;164162;0;358749
03;2020-06-25;3;6;10;31123;30920;09;62043
03;2020-06-25;9;8;18;29370;29268;19;58638
03;2020-06-25;13;14;27;21458;18963;29;40421
03;2020-06-25;28;19;47;21276;18326;39;39602
03;2020-06-25;10;18;28;18164;16593;49;34757
03;2020-06-25;10;13;24;13469;13557;59;27026
03;2020-06-25;6;3;10;8776;8670;69;17446
03;2020-06-25;5;0;5;3777;3591;79;7368
03;2020-06-25;2;1;3;1649;1072;89;2721
03;2020-06-25;1;0;1;485;184;90;669
03;2020-06-25;87;82;173;149547;141144;0;290691
04;2020-06-25;0;0;0;60314;61377;09;121691
04;2020-06-25;0;0;0;66065;68387;19;134452
04;2020-06-25;0;0;0;51059;47156;29;98215
04;2020-06-25;1;0;1;58788;45780;39;104568
04;2020-06-25;0;0;0;61408;52207;49;113615
04;2020-06-25;0;0;0;64838;60759;59;125597
04;2020-06-25;0;0;0;47008;42843;69;89851
04;2020-06-25;0;1;1;25509;21184;79;46693
04;2020-06-25;0;0;0;13168;7647;89;20815
04;2020-06-25;0;0;0;3209;1253;90;4462
04;2020-06-25;1;1;2;451366;408593;0;859959
05;2020-06-25;0;0;0;362.366008612902;341.338819562748;09;703.704828175651
05;2020-06-25;0;0;0;353.376145114279;370.349735405642;19;723.725880519921
05;2020-06-25;0;0;0;218.593559489256;256.539602589476;29;475.133162078732
05;2020-06-25;0;0;0;404.225408693299;360.321910454353;39;764.547319147651
05;2020-06-25;0;0;0;520.067953604221;497.108383964256;49;1017.17633756848
05;2020-06-25;0;0;0;468.146063921917;510.087601910415;59;978.233665832332
05;2020-06-25;0;0;0;340.368470050554;334.366842191253;69;674.735312241807
05;2020-06-25;0;0;0;212.598666888387;192.597753227106;79;405.196420115493
05;2020-06-25;0;0;0;148.727797095705;61.8681715431829;89;210.595968638888
05;2020-06-25;0;0;0;32.9601271090696;10.9909785719784;90;43.9511056810479
05;2020-06-25;0;0;0;3061.43020057959;2935.56979942041;0;5997
06;2020-06-25;0;0;0;42583;42380;09;84963
06;2020-06-25;1;0;1;33369;31925;19;65294
06;2020-06-25;3;0;3;21571;15080;29;36651
06;2020-06-25;3;0;3;21550;16147;39;37697
06;2020-06-25;1;0;1;14193;13939;49;28132
06;2020-06-25;1;0;1;7171;7597;59;14768
06;2020-06-25;0;2;2;3629;4117;69;7746
06;2020-06-25;0;0;0;1577;1457;79;3034
06;2020-06-25;0;1;1;531;474;89;1005
06;2020-06-25;0;0;0;88;93;90;181
06;2020-06-25;9;3;12;146262;133209;0;279471
07;2020-06-25;0;0;0;485;549;09;1034
07;2020-06-25;0;0;0;403;432;19;835
07;2020-06-25;0;0;0;764;841;29;1605
07;2020-06-25;0;0;0;824;928;39;1752
07;2020-06-25;0;0;0;788;1020;49;1808
07;2020-06-25;0;0;0;678;870;59;1548
07;2020-06-25;0;0;0;360;382;69;742
07;2020-06-25;0;0;0;231;190;79;421
07;2020-06-25;0;0;0;114;67;89;181
07;2020-06-25;0;0;0;24;11;90;35
07;2020-06-25;0;0;0;4671;5290;0;9961
08;2020-06-25;0;0;0;2715.22592983026;2997.75551488675;09;5712.98144471701
08;2020-06-25;0;0;0;2778.51901080978;3160.9156459093;19;5939.43465671908
08;2020-06-25;0;0;0;2080.8882988764;1718.16634315323;29;3799.05464202964
08;2020-06-25;0;0;0;2701.8582062647;1896.52641413317;39;4598.38462039786
08;2020-06-25;0;0;0;3151.45861023308;2460.52498233809;49;5611.98359257117
08;2020-06-25;0;0;0;2620.29868333099;2422.23566154656;59;5042.53434487755
08;2020-06-25;0;0;0;1621.44173420671;1438.58325779464;69;3060.02499200135
08;2020-06-25;0;0;0;626.575909335673;526.358467843651;79;1152.93437717932
08;2020-06-25;0;0;0;205.018522985054;140.993639349697;89;346.012162334751
08;2020-06-25;0;0;0;50.0325684687745;20.62259870351;90;70.6551671722846
08;2020-06-25;0;0;0;18551.3174743414;16782.6825256586;0;35334
11;2020-06-25;6;2;8;783071;811785;09;1594856
11;2020-06-25;7;3;10;761456;784653;19;1546109
11;2020-06-25;14;9;23;850145;801772;29;1651917
11;2020-06-25;9;15;24;914360;843488;39;1757848
11;2020-06-25;10;9;19;845609;826202;49;1671811
11;2020-06-25;9;6;15;793566;745070;59;1538636
11;2020-06-25;4;3;7;628649;549192;69;1177841
11;2020-06-25;7;3;10;434606;358356;79;792962
11;2020-06-25;3;2;5;261425;162933;89;424358
11;2020-06-25;2;2;4;89253;32619;90;121872
11;2020-06-25;71;54;125;6362140;5916070;0;12278210
24;2020-06-25;0;0;0;139720;144686;09;284406
24;2020-06-25;0;0;0;152979;161185;19;314164
24;2020-06-25;1;0;1;122237;126536;29;248773
24;2020-06-25;1;1;2;150359;142009;39;292368
24;2020-06-25;0;1;1;161829;158758;49;320587
24;2020-06-25;0;0;0;172552;168011;59;340563
24;2020-06-25;1;0;1;172509;158177;69;330686
24;2020-06-25;0;0;0;129428;110593;79;240021
24;2020-06-25;0;0;0;87342;56882;89;144224
24;2020-06-25;0;0;0;31210;12071;90;43281
24;2020-06-25;3;2;5;1320165;1238908;0;2559073
27;2020-06-25;0;0;0;143373;149679;09;293052
27;2020-06-25;0;0;0;160962;173003;19;333965
27;2020-06-25;1;0;1;133746;142254;29;276000
27;2020-06-25;1;1;2;160004;155407;39;315411
27;2020-06-25;0;0;0;172333;169564;49;341897
27;2020-06-25;1;1;2;189979;183788;59;373767
27;2020-06-25;0;0;0;192591;178206;69;370797
27;2020-06-25;1;0;1;146876;127546;79;274422
27;2020-06-25;1;1;2;96896;61575;89;158471
27;2020-06-25;0;0;0;33148;12109;90;45257
27;2020-06-25;5;3;8;1429908;1353131;0;2783039
28;2020-06-25;1;1;2;180735;186856;09;367591
28;2020-06-25;3;2;5;200125;213621;19;413746
28;2020-06-25;2;0;2;168922;173007;29;341929
28;2020-06-25;0;3;3;196628;188487;39;385115
28;2020-06-25;2;1;3;205396;201699;49;407095
28;2020-06-25;2;1;3;222002;213866;59;435868
28;2020-06-25;1;0;1;224688;203758;69;428446
28;2020-06-25;1;0;1;163192;135543;79;298735
28;2020-06-25;0;2;2;109691;65377;89;175068
28;2020-06-25;1;0;1;37222;12685;90;49907
28;2020-06-25;13;10;23;1708601;1594899;0;3303500
32;2020-06-25;1;3;4;358062;373689;09;731751
32;2020-06-25;2;1;3;387045;406742;19;793787
32;2020-06-25;2;2;4;342304;348587;29;690891
32;2020-06-25;6;6;12;382485;369972;39;752457
32;2020-06-25;6;4;10;382510;376716;49;759226
32;2020-06-25;2;1;3;386937;376527;59;763464
32;2020-06-25;0;3;3;371211;330938;69;702149
32;2020-06-25;2;4;6;250542;201459;79;452001
32;2020-06-25;2;1;3;163399;89786;89;253185
32;2020-06-25;2;1;3;48384;15367;90;63751
32;2020-06-25;25;26;51;3072879;2889783;0;5962662
44;2020-06-25;1;2;3;291525;306839;09;598364
44;2020-06-25;0;1;1;320255;339504;19;659759
44;2020-06-25;0;2;2;302020;314428;29;616448
44;2020-06-25;1;2;3;342222;333292;39;675514
44;2020-06-25;2;0;2;349727;344491;49;694218
44;2020-06-25;3;2;5;381371;373239;59;754610
44;2020-06-25;3;3;6;367165;335850;69;703015
44;2020-06-25;0;2;2;250387;215436;79;465823
44;2020-06-25;1;1;2;170825;105192;89;276017
44;2020-06-25;0;0;0;51248;16731;90;67979
44;2020-06-25;11;15;26;2826745;2685002;0;5511747
52;2020-06-25;0;0;0;213594;223900;09;437494
52;2020-06-25;1;0;1;240818;255197;19;496015
52;2020-06-25;0;1;1;197010;200630;29;397640
52;2020-06-25;1;1;2;231204;224885;39;456089
52;2020-06-25;2;0;2;243874;243418;49;487292
52;2020-06-25;1;1;2;244100;239116;59;483216
52;2020-06-25;0;0;0;241796;221345;69;463141
52;2020-06-25;0;0;0;177805;149903;79;327708
52;2020-06-25;2;0;2;119561;75822;89;195383
52;2020-06-25;1;0;1;42559;15260;90;57819
52;2020-06-25;8;3;11;1952321;1849476;0;3801797
53;2020-06-25;0;0;0;173813;182358;09;356171
53;2020-06-25;0;0;0;202720;214740;19;417460
53;2020-06-25;1;2;3;163116;173196;29;336312
53;2020-06-25;2;0;2;190526;187674;39;378200
53;2020-06-25;0;1;1;212098;212015;49;424113
53;2020-06-25;0;0;0;223699;219176;59;442875
53;2020-06-25;0;0;0;227435;209274;69;436709
53;2020-06-25;0;0;0;169992;140910;79;310902
53;2020-06-25;1;0;1;118117;69883;89;188000
53;2020-06-25;0;0;0;37370;12267;90;49637
53;2020-06-25;4;3;7;1718886;1621493;0;3340379
75;2020-06-25;0;0;0;293104;305291;09;598395
75;2020-06-25;0;0;0;337141;357785;19;694926
75;2020-06-25;0;0;0;295024;300618;29;595642
75;2020-06-25;0;1;1;347871;331233;39;679104
75;2020-06-25;0;0;0;384742;372771;49;757513
75;2020-06-25;0;0;0;413361;390880;59;804241
75;2020-06-25;0;0;0;425623;384060;69;809683
75;2020-06-25;0;0;0;325086;276298;79;601384
75;2020-06-25;0;0;0;213986;139308;89;353294
75;2020-06-25;0;0;0;77600;28200;90;105800
75;2020-06-25;0;1;1;3113538;2886444;0;5999982
76;2020-06-25;1;0;1;305956;318589;09;624545
76;2020-06-25;2;0;2;338942;356969;19;695911
76;2020-06-25;3;1;4;316210;319570;29;635780
76;2020-06-25;1;2;3;356758;337587;39;694345
76;2020-06-25;1;0;1;376541;363812;49;740353
76;2020-06-25;1;0;1;402608;383750;59;786358
76;2020-06-25;1;0;1;394889;358997;69;753886
76;2020-06-25;0;0;0;308664;263806;79;572470
76;2020-06-25;0;0;0;195838;129272;89;325110
76;2020-06-25;0;0;0;69372;26728;90;96100
76;2020-06-25;10;3;13;3065778;2859080;0;5924858
84;2020-06-25;0;0;0;459549;481088;09;940637
84;2020-06-25;2;4;6;487711;511905;19;999616
84;2020-06-25;1;5;6;443824;451094;29;894918
84;2020-06-25;2;3;5;512522;493262;39;1005784
84;2020-06-25;1;3;4;520248;515106;49;1035354
84;2020-06-25;6;1;7;529611;514848;59;1044459
84;2020-06-25;1;0;1;486720;439940;69;926660
84;2020-06-25;2;1;3;372151;315211;79;687362
84;2020-06-25;1;1;2;237198;150524;89;387722
84;2020-06-25;0;0;0;81185;28680;90;109865
84;2020-06-25;16;18;34;4130719;3901658;0;8032377
93;2020-06-25;1;0;1;268834;283093;09;551927
93;2020-06-25;0;0;0;280751;296087;19;576838
93;2020-06-25;1;2;3;254404;255552;29;509956
93;2020-06-25;0;2;2;310704;288398;39;599102
93;2020-06-25;1;2;3;325559;305827;49;631386
93;2020-06-25;0;2;2;353104;325389;59;678493
93;2020-06-25;0;0;0;336327;296459;69;632786
93;2020-06-25;0;0;0;279820;229699;79;509519
93;2020-06-25;0;0;0;171274;113716;89;284990
93;2020-06-25;0;0;0;58896;21758;90;80654
93;2020-06-25;3;8;11;2639673;2415978;0;5055651
94;2020-06-25;0;0;0;16311;17433;09;33744
94;2020-06-25;0;0;0;16679;18132;19;34811
94;2020-06-25;0;0;0;16782;16579;29;33361
94;2020-06-25;0;0;0;23044;20580;39;43624
94;2020-06-25;0;0;0;23065;22140;49;45205
94;2020-06-25;0;0;0;24549;23421;59;47970
94;2020-06-25;0;0;0;23212;21883;69;45095
94;2020-06-25;0;0;0;19544;17141;79;36685
94;2020-06-25;0;0;0;11227;8178;89;19405
94;2020-06-25;0;0;0;3332;1447;90;4779
94;2020-06-25;0;0;0;177745;166934;0;344679
01;2020-06-26;0;0;0;19979;20155;09;40134
01;2020-06-26;0;0;0;24994;25489;19;50483
01;2020-06-26;0;0;0;17868;16690;29;34558
01;2020-06-26;0;0;0;22328;14821;39;37149
01;2020-06-26;0;0;0;28652;20276;49;48928
01;2020-06-26;0;0;0;33264;27260;59;60524
01;2020-06-26;0;0;0;27135;23978;69;51113
01;2020-06-26;0;0;0;18401;14661;79;33062
01;2020-06-26;0;0;0;9633;6375;89;16008
01;2020-06-26;0;0;0;3410;1510;90;4920
01;2020-06-26;0;0;0;205664;171215;0;376879
02;2020-06-26;0;0;0;16881;17110;09;33991
02;2020-06-26;0;0;0;21410;21604;19;43014
02;2020-06-26;0;0;0;16017;15479;29;31496
02;2020-06-26;1;0;1;19825;14455;39;34280
02;2020-06-26;0;0;0;24719;18248;49;42967
02;2020-06-26;0;0;0;34361;28310;59;62671
02;2020-06-26;1;0;1;28061;24495;69;52556
02;2020-06-26;0;0;0;18231;15278;79;33509
02;2020-06-26;0;0;0;11090;7677;89;18767
02;2020-06-26;0;0;0;3992;1506;90;5498
02;2020-06-26;2;0;2;194587;164162;0;358749
03;2020-06-26;1;2;4;31123;30920;09;62043
03;2020-06-26;5;8;13;29370;29268;19;58638
03;2020-06-26;19;16;36;21458;18963;29;40421
03;2020-06-26;18;10;28;21276;18326;39;39602
03;2020-06-26;12;11;23;18164;16593;49;34757
03;2020-06-26;6;9;15;13469;13557;59;27026
03;2020-06-26;7;8;15;8776;8670;69;17446
03;2020-06-26;0;4;4;3777;3591;79;7368
03;2020-06-26;2;1;3;1649;1072;89;2721
03;2020-06-26;1;1;2;485;184;90;669
03;2020-06-26;71;70;143;149547;141144;0;290691
04;2020-06-26;0;0;0;60314;61377;09;121691
04;2020-06-26;0;0;0;66065;68387;19;134452
04;2020-06-26;0;1;1;51059;47156;29;98215
04;2020-06-26;0;0;0;58788;45780;39;104568
04;2020-06-26;0;1;1;61408;52207;49;113615
04;2020-06-26;0;0;0;64838;60759;59;125597
04;2020-06-26;0;1;1;47008;42843;69;89851
04;2020-06-26;0;0;0;25509;21184;79;46693
04;2020-06-26;0;0;0;13168;7647;89;20815
04;2020-06-26;0;0;0;3209;1253;90;4462
04;2020-06-26;0;3;3;451366;408593;0;859959
05;2020-06-26;0;0;0;362.366008612902;341.338819562748;09;703.704828175651
05;2020-06-26;0;0;0;353.376145114279;370.349735405642;19;723.725880519921
05;2020-06-26;0;0;0;218.593559489256;256.539602589476;29;475.133162078732
05;2020-06-26;0;0;0;404.225408693299;360.321910454353;39;764.547319147651
05;2020-06-26;0;0;0;520.067953604221;497.108383964256;49;1017.17633756848
05;2020-06-26;0;0;0;468.146063921917;510.087601910415;59;978.233665832332
05;2020-06-26;0;0;0;340.368470050554;334.366842191253;69;674.735312241807
05;2020-06-26;0;0;0;212.598666888387;192.597753227106;79;405.196420115493
05;2020-06-26;0;0;0;148.727797095705;61.8681715431829;89;210.595968638888
05;2020-06-26;0;0;0;32.9601271090696;10.9909785719784;90;43.9511056810479
05;2020-06-26;0;0;0;3061.43020057959;2935.56979942041;0;5997
06;2020-06-26;0;0;0;42583;42380;09;84963
06;2020-06-26;2;0;2;33369;31925;19;65294
06;2020-06-26;1;0;1;21571;15080;29;36651
06;2020-06-26;1;2;3;21550;16147;39;37697
06;2020-06-26;0;0;0;14193;13939;49;28132
06;2020-06-26;1;1;2;7171;7597;59;14768
06;2020-06-26;1;0;1;3629;4117;69;7746
06;2020-06-26;0;1;1;1577;1457;79;3034
06;2020-06-26;0;0;0;531;474;89;1005
06;2020-06-26;0;0;0;88;93;90;181
06;2020-06-26;6;4;10;146262;133209;0;279471
07;2020-06-26;0;0;0;485;549;09;1034
07;2020-06-26;0;0;0;403;432;19;835
07;2020-06-26;0;1;1;764;841;29;1605
07;2020-06-26;0;0;0;824;928;39;1752
07;2020-06-26;0;0;0;788;1020;49;1808
07;2020-06-26;0;0;0;678;870;59;1548
07;2020-06-26;0;0;0;360;382;69;742
07;2020-06-26;0;0;0;231;190;79;421
07;2020-06-26;0;0;0;114;67;89;181
07;2020-06-26;0;0;0;24;11;90;35
07;2020-06-26;0;1;1;4671;5290;0;9961
08;2020-06-26;0;0;0;2715.22592983026;2997.75551488675;09;5712.98144471701
08;2020-06-26;0;0;0;2778.51901080978;3160.9156459093;19;5939.43465671908
08;2020-06-26;0;0;0;2080.8882988764;1718.16634315323;29;3799.05464202964
08;2020-06-26;0;0;0;2701.8582062647;1896.52641413317;39;4598.38462039786
08;2020-06-26;0;0;0;3151.45861023308;2460.52498233809;49;5611.98359257117
08;2020-06-26;0;0;0;2620.29868333099;2422.23566154656;59;5042.53434487755
08;2020-06-26;0;0;0;1621.44173420671;1438.58325779464;69;3060.02499200135
08;2020-06-26;0;0;0;626.575909335673;526.358467843651;79;1152.93437717932
08;2020-06-26;0;0;0;205.018522985054;140.993639349697;89;346.012162334751
08;2020-06-26;0;0;0;50.0325684687745;20.62259870351;90;70.6551671722846
08;2020-06-26;0;0;0;18551.3174743414;16782.6825256586;0;35334
11;2020-06-26;1;3;4;783071;811785;09;1594856
11;2020-06-26;12;8;20;761456;784653;19;1546109
11;2020-06-26;16;16;32;850145;801772;29;1651917
11;2020-06-26;8;8;16;914360;843488;39;1757848
11;2020-06-26;10;15;25;845609;826202;49;1671811
11;2020-06-26;9;9;19;793566;745070;59;1538636
11;2020-06-26;7;4;11;628649;549192;69;1177841
11;2020-06-26;6;6;12;434606;358356;79;792962
11;2020-06-26;3;4;7;261425;162933;89;424358
11;2020-06-26;1;2;3;89253;32619;90;121872
11;2020-06-26;73;75;149;6362140;5916070;0;12278210
24;2020-06-26;0;0;0;139720;144686;09;284406
24;2020-06-26;0;1;1;152979;161185;19;314164
24;2020-06-26;2;4;6;122237;126536;29;248773
24;2020-06-26;3;1;4;150359;142009;39;292368
24;2020-06-26;0;4;4;161829;158758;49;320587
24;2020-06-26;1;0;1;172552;168011;59;340563
24;2020-06-26;0;0;0;172509;158177;69;330686
24;2020-06-26;0;0;0;129428;110593;79;240021
24;2020-06-26;1;0;1;87342;56882;89;144224
24;2020-06-26;0;1;1;31210;12071;90;43281
24;2020-06-26;7;11;18;1320165;1238908;0;2559073
27;2020-06-26;0;0;0;143373;149679;09;293052
27;2020-06-26;0;0;0;160962;173003;19;333965
27;2020-06-26;0;0;0;133746;142254;29;276000
27;2020-06-26;1;0;1;160004;155407;39;315411
27;2020-06-26;0;1;1;172333;169564;49;341897
27;2020-06-26;0;1;1;189979;183788;59;373767
27;2020-06-26;0;1;1;192591;178206;69;370797
27;2020-06-26;0;1;1;146876;127546;79;274422
27;2020-06-26;1;0;1;96896;61575;89;158471
27;2020-06-26;1;0;1;33148;12109;90;45257
27;2020-06-26;3;4;7;1429908;1353131;0;2783039
28;2020-06-26;0;1;1;180735;186856;09;367591
28;2020-06-26;0;1;1;200125;213621;19;413746
28;2020-06-26;1;0;1;168922;173007;29;341929
28;2020-06-26;2;2;4;196628;188487;39;385115
28;2020-06-26;0;1;1;205396;201699;49;407095
28;2020-06-26;2;0;2;222002;213866;59;435868
28;2020-06-26;1;0;1;224688;203758;69;428446
28;2020-06-26;2;2;4;163192;135543;79;298735
28;2020-06-26;0;1;1;109691;65377;89;175068
28;2020-06-26;1;0;1;37222;12685;90;49907
28;2020-06-26;9;8;17;1708601;1594899;0;3303500
32;2020-06-26;4;1;5;358062;373689;09;731751
32;2020-06-26;4;4;8;387045;406742;19;793787
32;2020-06-26;4;3;7;342304;348587;29;690891
32;2020-06-26;10;5;15;382485;369972;39;752457
32;2020-06-26;2;4;6;382510;376716;49;759226
32;2020-06-26;2;3;5;386937;376527;59;763464
32;2020-06-26;2;2;4;371211;330938;69;702149
32;2020-06-26;6;2;8;250542;201459;79;452001
32;2020-06-26;0;0;0;163399;89786;89;253185
32;2020-06-26;1;0;1;48384;15367;90;63751
32;2020-06-26;35;24;59;3072879;2889783;0;5962662
44;2020-06-26;2;0;2;291525;306839;09;598364
44;2020-06-26;0;1;1;320255;339504;19;659759
44;2020-06-26;1;3;4;302020;314428;29;616448
44;2020-06-26;4;1;5;342222;333292;39;675514
44;2020-06-26;2;3;5;349727;344491;49;694218
44;2020-06-26;2;2;4;381371;373239;59;754610
44;2020-06-26;1;1;2;367165;335850;69;703015
44;2020-06-26;1;1;2;250387;215436;79;465823
44;2020-06-26;1;1;2;170825;105192;89;276017
44;2020-06-26;1;0;1;51248;16731;90;67979
44;2020-06-26;15;13;28;2826745;2685002;0;5511747
52;2020-06-26;2;1;3;213594;223900;09;437494
52;2020-06-26;1;1;2;240818;255197;19;496015
52;2020-06-26;2;2;4;197010;200630;29;397640
52;2020-06-26;1;2;3;231204;224885;39;456089
52;2020-06-26;0;3;3;243874;243418;49;487292
52;2020-06-26;1;1;2;244100;239116;59;483216
52;2020-06-26;0;0;0;241796;221345;69;463141
52;2020-06-26;0;0;0;177805;149903;79;327708
52;2020-06-26;0;0;0;119561;75822;89;195383
52;2020-06-26;0;0;0;42559;15260;90;57819
52;2020-06-26;7;10;17;1952321;1849476;0;3801797
53;2020-06-26;0;1;1;173813;182358;09;356171
53;2020-06-26;0;0;0;202720;214740;19;417460
53;2020-06-26;0;0;0;163116;173196;29;336312
53;2020-06-26;0;1;1;190526;187674;39;378200
53;2020-06-26;1;1;2;212098;212015;49;424113
53;2020-06-26;0;1;1;223699;219176;59;442875
53;2020-06-26;0;0;0;227435;209274;69;436709
53;2020-06-26;0;1;1;169992;140910;79;310902
53;2020-06-26;0;0;0;118117;69883;89;188000
53;2020-06-26;0;0;0;37370;12267;90;49637
53;2020-06-26;1;5;6;1718886;1621493;0;3340379
75;2020-06-26;0;2;2;293104;305291;09;598395
75;2020-06-26;0;0;0;337141;357785;19;694926
75;2020-06-26;2;1;3;295024;300618;29;595642
75;2020-06-26;1;0;1;347871;331233;39;679104
75;2020-06-26;1;1;2;384742;372771;49;757513
75;2020-06-26;1;2;3;413361;390880;59;804241
75;2020-06-26;2;1;3;425623;384060;69;809683
75;2020-06-26;0;0;0;325086;276298;79;601384
75;2020-06-26;1;0;1;213986;139308;89;353294
75;2020-06-26;0;0;0;77600;28200;90;105800
75;2020-06-26;8;7;15;3113538;2886444;0;5999982
76;2020-06-26;1;2;3;305956;318589;09;624545
76;2020-06-26;2;1;3;338942;356969;19;695911
76;2020-06-26;6;1;7;316210;319570;29;635780
76;2020-06-26;4;2;6;356758;337587;39;694345
76;2020-06-26;2;5;7;376541;363812;49;740353
76;2020-06-26;2;2;4;402608;383750;59;786358
76;2020-06-26;2;1;3;394889;358997;69;753886
76;2020-06-26;0;1;1;308664;263806;79;572470
76;2020-06-26;0;0;0;195838;129272;89;325110
76;2020-06-26;0;0;0;69372;26728;90;96100
76;2020-06-26;20;15;35;3065778;2859080;0;5924858
84;2020-06-26;0;2;2;459549;481088;09;940637
84;2020-06-26;4;3;7;487711;511905;19;999616
84;2020-06-26;7;2;10;443824;451094;29;894918
84;2020-06-26;3;1;4;512522;493262;39;1005784
84;2020-06-26;4;3;7;520248;515106;49;1035354
84;2020-06-26;5;2;7;529611;514848;59;1044459
84;2020-06-26;1;1;2;486720;439940;69;926660
84;2020-06-26;3;3;6;372151;315211;79;687362
84;2020-06-26;1;0;1;237198;150524;89;387722
84;2020-06-26;2;0;2;81185;28680;90;109865
84;2020-06-26;30;17;48;4130719;3901658;0;8032377
93;2020-06-26;1;0;1;268834;283093;09;551927
93;2020-06-26;2;1;3;280751;296087;19;576838
93;2020-06-26;2;1;3;254404;255552;29;509956
93;2020-06-26;1;1;2;310704;288398;39;599102
93;2020-06-26;3;0;3;325559;305827;49;631386
93;2020-06-26;0;1;1;353104;325389;59;678493
93;2020-06-26;0;2;2;336327;296459;69;632786
93;2020-06-26;0;3;3;279820;229699;79;509519
93;2020-06-26;1;0;1;171274;113716;89;284990
93;2020-06-26;0;0;0;58896;21758;90;80654
93;2020-06-26;10;9;19;2639673;2415978;0;5055651
94;2020-06-26;0;0;0;16311;17433;09;33744
94;2020-06-26;0;0;0;16679;18132;19;34811
94;2020-06-26;0;0;0;16782;16579;29;33361
94;2020-06-26;0;0;0;23044;20580;39;43624
94;2020-06-26;0;0;0;23065;22140;49;45205
94;2020-06-26;0;0;0;24549;23421;59;47970
94;2020-06-26;0;0;0;23212;21883;69;45095
94;2020-06-26;0;1;1;19544;17141;79;36685
94;2020-06-26;0;0;0;11227;8178;89;19405
94;2020-06-26;0;0;0;3332;1447;90;4779
94;2020-06-26;0;1;1;177745;166934;0;344679
01;2020-06-27;0;0;0;19979;20155;09;40134
01;2020-06-27;0;0;0;24994;25489;19;50483
01;2020-06-27;0;0;0;17868;16690;29;34558
01;2020-06-27;0;0;0;22328;14821;39;37149
01;2020-06-27;0;0;0;28652;20276;49;48928
01;2020-06-27;0;0;0;33264;27260;59;60524
01;2020-06-27;0;0;0;27135;23978;69;51113
01;2020-06-27;0;0;0;18401;14661;79;33062
01;2020-06-27;0;0;0;9633;6375;89;16008
01;2020-06-27;0;0;0;3410;1510;90;4920
01;2020-06-27;0;0;0;205664;171215;0;376879
02;2020-06-27;0;0;0;16881;17110;09;33991
02;2020-06-27;0;0;0;21410;21604;19;43014
02;2020-06-27;0;0;0;16017;15479;29;31496
02;2020-06-27;0;0;0;19825;14455;39;34280
02;2020-06-27;0;0;0;24719;18248;49;42967
02;2020-06-27;0;0;0;34361;28310;59;62671
02;2020-06-27;0;0;0;28061;24495;69;52556
02;2020-06-27;0;0;0;18231;15278;79;33509
02;2020-06-27;0;0;0;11090;7677;89;18767
02;2020-06-27;0;0;0;3992;1506;90;5498
02;2020-06-27;0;0;0;194587;164162;0;358749
03;2020-06-27;4;4;8;31123;30920;09;62043
03;2020-06-27;13;8;23;29370;29268;19;58638
03;2020-06-27;20;12;33;21458;18963;29;40421
03;2020-06-27;19;10;29;21276;18326;39;39602
03;2020-06-27;18;9;28;18164;16593;49;34757
03;2020-06-27;6;10;16;13469;13557;59;27026
03;2020-06-27;6;8;14;8776;8670;69;17446
03;2020-06-27;1;6;7;3777;3591;79;7368
03;2020-06-27;0;1;1;1649;1072;89;2721
03;2020-06-27;0;0;0;485;184;90;669
03;2020-06-27;87;68;159;149547;141144;0;290691
04;2020-06-27;0;0;0;60314;61377;09;121691
04;2020-06-27;0;0;0;66065;68387;19;134452
04;2020-06-27;0;0;0;51059;47156;29;98215
04;2020-06-27;0;0;0;58788;45780;39;104568
04;2020-06-27;0;0;0;61408;52207;49;113615
04;2020-06-27;0;0;0;64838;60759;59;125597
04;2020-06-27;0;0;0;47008;42843;69;89851
04;2020-06-27;0;0;0;25509;21184;79;46693
04;2020-06-27;0;0;0;13168;7647;89;20815
04;2020-06-27;0;0;0;3209;1253;90;4462
04;2020-06-27;0;0;0;451366;408593;0;859959
05;2020-06-27;0;0;0;362.366008612902;341.338819562748;09;703.704828175651
05;2020-06-27;0;0;0;353.376145114279;370.349735405642;19;723.725880519921
05;2020-06-27;0;0;0;218.593559489256;256.539602589476;29;475.133162078732
05;2020-06-27;0;0;0;404.225408693299;360.321910454353;39;764.547319147651
05;2020-06-27;0;0;0;520.067953604221;497.108383964256;49;1017.17633756848
05;2020-06-27;0;0;0;468.146063921917;510.087601910415;59;978.233665832332
05;2020-06-27;0;0;0;340.368470050554;334.366842191253;69;674.735312241807
05;2020-06-27;0;0;0;212.598666888387;192.597753227106;79;405.196420115493
05;2020-06-27;0;0;0;148.727797095705;61.8681715431829;89;210.595968638888
05;2020-06-27;0;0;0;32.9601271090696;10.9909785719784;90;43.9511056810479
05;2020-06-27;0;0;0;3061.43020057959;2935.56979942041;0;5997
06;2020-06-27;1;1;2;42583;42380;09;84963
06;2020-06-27;0;2;2;33369;31925;19;65294
06;2020-06-27;3;2;5;21571;15080;29;36651
06;2020-06-27;1;1;2;21550;16147;39;37697
06;2020-06-27;2;1;3;14193;13939;49;28132
06;2020-06-27;1;0;1;7171;7597;59;14768
06;2020-06-27;1;0;1;3629;4117;69;7746
06;2020-06-27;0;0;0;1577;1457;79;3034
06;2020-06-27;0;0;0;531;474;89;1005
06;2020-06-27;0;0;0;88;93;90;181
06;2020-06-27;9;7;16;146262;133209;0;279471
07;2020-06-27;0;0;0;485;549;09;1034
07;2020-06-27;0;0;0;403;432;19;835
07;2020-06-27;0;0;0;764;841;29;1605
07;2020-06-27;0;0;0;824;928;39;1752
07;2020-06-27;0;0;0;788;1020;49;1808
07;2020-06-27;0;0;0;678;870;59;1548
07;2020-06-27;0;0;0;360;382;69;742
07;2020-06-27;0;0;0;231;190;79;421
07;2020-06-27;0;0;0;114;67;89;181
07;2020-06-27;0;0;0;24;11;90;35
07;2020-06-27;0;0;0;4671;5290;0;9961
08;2020-06-27;0;0;0;2715.22592983026;2997.75551488675;09;5712.98144471701
08;2020-06-27;0;0;0;2778.51901080978;3160.9156459093;19;5939.43465671908
08;2020-06-27;0;0;0;2080.8882988764;1718.16634315323;29;3799.05464202964
08;2020-06-27;0;0;0;2701.8582062647;1896.52641413317;39;4598.38462039786
08;2020-06-27;0;0;0;3151.45861023308;2460.52498233809;49;5611.98359257117
08;2020-06-27;0;0;0;2620.29868333099;2422.23566154656;59;5042.53434487755
08;2020-06-27;0;0;0;1621.44173420671;1438.58325779464;69;3060.02499200135
08;2020-06-27;0;0;0;626.575909335673;526.358467843651;79;1152.93437717932
08;2020-06-27;0;0;0;205.018522985054;140.993639349697;89;346.012162334751
08;2020-06-27;0;0;0;50.0325684687745;20.62259870351;90;70.6551671722846
08;2020-06-27;0;0;0;18551.3174743414;16782.6825256586;0;35334
11;2020-06-27;3;6;12;783071;811785;09;1594856
11;2020-06-27;0;1;1;761456;784653;19;1546109
11;2020-06-27;2;1;3;850145;801772;29;1651917
11;2020-06-27;4;5;9;914360;843488;39;1757848
11;2020-06-27;1;4;5;845609;826202;49;1671811
11;2020-06-27;4;4;8;793566;745070;59;1538636
11;2020-06-27;1;3;4;628649;549192;69;1177841
11;2020-06-27;0;1;1;434606;358356;79;792962
11;2020-06-27;1;0;1;261425;162933;89;424358
11;2020-06-27;2;0;2;89253;32619;90;121872
11;2020-06-27;18;25;46;6362140;5916070;0;12278210
24;2020-06-27;0;0;0;139720;144686;09;284406
24;2020-06-27;0;0;0;152979;161185;19;314164
24;2020-06-27;0;0;0;122237;126536;29;248773
24;2020-06-27;1;2;3;150359;142009;39;292368
24;2020-06-27;0;1;1;161829;158758;49;320587
24;2020-06-27;1;0;1;172552;168011;59;340563
24;2020-06-27;0;0;0;172509;158177;69;330686
24;2020-06-27;0;0;0;129428;110593;79;240021
24;2020-06-27;0;0;0;87342;56882;89;144224
24;2020-06-27;1;0;1;31210;12071;90;43281
24;2020-06-27;3;3;6;1320165;1238908;0;2559073
27;2020-06-27;2;0;2;143373;149679;09;293052
27;2020-06-27;0;0;0;160962;173003;19;333965
27;2020-06-27;0;0;0;133746;142254;29;276000
27;2020-06-27;1;1;2;160004;155407;39;315411
27;2020-06-27;0;1;1;172333;169564;49;341897
27;2020-06-27;0;0;0;189979;183788;59;373767
27;2020-06-27;0;2;2;192591;178206;69;370797
27;2020-06-27;0;0;0;146876;127546;79;274422
27;2020-06-27;1;0;1;96896;61575;89;158471
27;2020-06-27;0;0;0;33148;12109;90;45257
27;2020-06-27;4;4;8;1429908;1353131;0;2783039
28;2020-06-27;1;0;1;180735;186856;09;367591
28;2020-06-27;1;0;1;200125;213621;19;413746
28;2020-06-27;0;0;0;168922;173007;29;341929
28;2020-06-27;2;1;3;196628;188487;39;385115
28;2020-06-27;0;1;1;205396;201699;49;407095
28;2020-06-27;2;1;3;222002;213866;59;435868
28;2020-06-27;0;0;0;224688;203758;69;428446
28;2020-06-27;1;0;1;163192;135543;79;298735
28;2020-06-27;0;0;0;109691;65377;89;175068
28;2020-06-27;0;0;0;37222;12685;90;49907
28;2020-06-27;7;3;10;1708601;1594899;0;3303500
32;2020-06-27;0;0;0;358062;373689;09;731751
32;2020-06-27;1;1;2;387045;406742;19;793787
32;2020-06-27;2;1;3;342304;348587;29;690891
32;2020-06-27;2;1;3;382485;369972;39;752457
32;2020-06-27;0;1;1;382510;376716;49;759226
32;2020-06-27;0;2;2;386937;376527;59;763464
32;2020-06-27;2;1;3;371211;330938;69;702149
32;2020-06-27;0;4;4;250542;201459;79;452001
32;2020-06-27;1;1;2;163399;89786;89;253185
32;2020-06-27;0;0;0;48384;15367;90;63751
32;2020-06-27;8;12;20;3072879;2889783;0;5962662
44;2020-06-27;0;0;0;291525;306839;09;598364
44;2020-06-27;0;1;1;320255;339504;19;659759
44;2020-06-27;0;1;1;302020;314428;29;616448
44;2020-06-27;0;0;0;342222;333292;39;675514
44;2020-06-27;0;1;1;349727;344491;49;694218
44;2020-06-27;1;1;2;381371;373239;59;754610
44;2020-06-27;0;1;1;367165;335850;69;703015
44;2020-06-27;2;0;2;250387;215436;79;465823
44;2020-06-27;0;1;1;170825;105192;89;276017
44;2020-06-27;2;1;3;51248;16731;90;67979
44;2020-06-27;5;7;12;2826745;2685002;0;5511747
52;2020-06-27;0;0;0;213594;223900;09;437494
52;2020-06-27;0;0;0;240818;255197;19;496015
52;2020-06-27;1;5;6;197010;200630;29;397640
52;2020-06-27;1;2;3;231204;224885;39;456089
52;2020-06-27;0;0;0;243874;243418;49;487292
52;2020-06-27;0;1;1;244100;239116;59;483216
52;2020-06-27;0;0;0;241796;221345;69;463141
52;2020-06-27;1;1;2;177805;149903;79;327708
52;2020-06-27;0;1;1;119561;75822;89;195383
52;2020-06-27;0;0;0;42559;15260;90;57819
52;2020-06-27;3;10;13;1952321;1849476;0;3801797
53;2020-06-27;0;0;0;173813;182358;09;356171
53;2020-06-27;0;0;0;202720;214740;19;417460
53;2020-06-27;0;0;0;163116;173196;29;336312
53;2020-06-27;0;0;0;190526;187674;39;378200
53;2020-06-27;0;1;1;212098;212015;49;424113
53;2020-06-27;0;0;0;223699;219176;59;442875
53;2020-06-27;0;1;1;227435;209274;69;436709
53;2020-06-27;0;0;0;169992;140910;79;310902
53;2020-06-27;0;0;0;118117;69883;89;188000
53;2020-06-27;0;0;0;37370;12267;90;49637
53;2020-06-27;0;2;2;1718886;1621493;0;3340379
75;2020-06-27;0;0;0;293104;305291;09;598395
75;2020-06-27;0;1;1;337141;357785;19;694926
75;2020-06-27;0;0;0;295024;300618;29;595642
75;2020-06-27;2;0;2;347871;331233;39;679104
75;2020-06-27;0;0;0;384742;372771;49;757513
75;2020-06-27;0;0;0;413361;390880;59;804241
75;2020-06-27;0;0;0;425623;384060;69;809683
75;2020-06-27;0;0;0;325086;276298;79;601384
75;2020-06-27;0;0;0;213986;139308;89;353294
75;2020-06-27;0;0;0;77600;28200;90;105800
75;2020-06-27;2;1;3;3113538;2886444;0;5999982
76;2020-06-27;0;0;0;305956;318589;09;624545
76;2020-06-27;0;0;0;338942;356969;19;695911
76;2020-06-27;1;2;3;316210;319570;29;635780
76;2020-06-27;0;0;0;356758;337587;39;694345
76;2020-06-27;0;0;0;376541;363812;49;740353
76;2020-06-27;0;0;0;402608;383750;59;786358
76;2020-06-27;1;0;1;394889;358997;69;753886
76;2020-06-27;0;0;0;308664;263806;79;572470
76;2020-06-27;0;0;0;195838;129272;89;325110
76;2020-06-27;1;0;1;69372;26728;90;96100
76;2020-06-27;3;2;5;3065778;2859080;0;5924858
84;2020-06-27;2;2;4;459549;481088;09;940637
84;2020-06-27;0;0;0;487711;511905;19;999616
84;2020-06-27;3;3;6;443824;451094;29;894918
84;2020-06-27;1;0;1;512522;493262;39;1005784
84;2020-06-27;4;2;6;520248;515106;49;1035354
84;2020-06-27;3;1;4;529611;514848;59;1044459
84;2020-06-27;3;1;4;486720;439940;69;926660
84;2020-06-27;0;0;0;372151;315211;79;687362
84;2020-06-27;1;1;2;237198;150524;89;387722
84;2020-06-27;1;0;1;81185;28680;90;109865
84;2020-06-27;18;10;28;4130719;3901658;0;8032377
93;2020-06-27;0;0;0;268834;283093;09;551927
93;2020-06-27;0;0;0;280751;296087;19;576838
93;2020-06-27;0;0;0;254404;255552;29;509956
93;2020-06-27;0;1;1;310704;288398;39;599102
93;2020-06-27;0;0;0;325559;305827;49;631386
93;2020-06-27;1;1;2;353104;325389;59;678493
93;2020-06-27;2;0;2;336327;296459;69;632786
93;2020-06-27;0;2;2;279820;229699;79;509519
93;2020-06-27;0;1;1;171274;113716;89;284990
93;2020-06-27;0;0;0;58896;21758;90;80654
93;2020-06-27;3;5;8;2639673;2415978;0;5055651
94;2020-06-27;0;0;0;16311;17433;09;33744
94;2020-06-27;0;0;0;16679;18132;19;34811
94;2020-06-27;0;0;0;16782;16579;29;33361
94;2020-06-27;0;0;0;23044;20580;39;43624
94;2020-06-27;0;0;0;23065;22140;49;45205
94;2020-06-27;0;0;0;24549;23421;59;47970
94;2020-06-27;0;0;0;23212;21883;69;45095
94;2020-06-27;0;0;0;19544;17141;79;36685
94;2020-06-27;0;0;0;11227;8178;89;19405
94;2020-06-27;0;0;0;3332;1447;90;4779
94;2020-06-27;0;0;0;177745;166934;0;344679
01;2020-06-28;0;0;0;19979;20155;09;40134
01;2020-06-28;0;0;0;24994;25489;19;50483
01;2020-06-28;0;0;0;17868;16690;29;34558
01;2020-06-28;0;0;0;22328;14821;39;37149
01;2020-06-28;0;0;0;28652;20276;49;48928
01;2020-06-28;0;0;0;33264;27260;59;60524
01;2020-06-28;0;0;0;27135;23978;69;51113
01;2020-06-28;0;0;0;18401;14661;79;33062
01;2020-06-28;0;0;0;9633;6375;89;16008
01;2020-06-28;0;0;0;3410;1510;90;4920
01;2020-06-28;0;0;0;205664;171215;0;376879
02;2020-06-28;0;0;0;16881;17110;09;33991
02;2020-06-28;0;0;0;21410;21604;19;43014
02;2020-06-28;0;0;0;16017;15479;29;31496
02;2020-06-28;0;0;0;19825;14455;39;34280
02;2020-06-28;0;0;0;24719;18248;49;42967
02;2020-06-28;0;0;0;34361;28310;59;62671
02;2020-06-28;0;0;0;28061;24495;69;52556
02;2020-06-28;0;0;0;18231;15278;79;33509
02;2020-06-28;0;0;0;11090;7677;89;18767
02;2020-06-28;0;0;0;3992;1506;90;5498
02;2020-06-28;0;0;0;194587;164162;0;358749
03;2020-06-28;2;4;7;31123;30920;09;62043
03;2020-06-28;12;6;21;29370;29268;19;58638
03;2020-06-28;15;14;32;21458;18963;29;40421
03;2020-06-28;10;5;17;21276;18326;39;39602
03;2020-06-28;10;8;20;18164;16593;49;34757
03;2020-06-28;5;11;17;13469;13557;59;27026
03;2020-06-28;4;2;7;8776;8670;69;17446
03;2020-06-28;0;4;4;3777;3591;79;7368
03;2020-06-28;1;0;1;1649;1072;89;2721
03;2020-06-28;1;0;1;485;184;90;669
03;2020-06-28;60;54;127;149547;141144;0;290691
04;2020-06-28;0;0;0;60314;61377;09;121691
04;2020-06-28;0;0;0;66065;68387;19;134452
04;2020-06-28;0;1;1;51059;47156;29;98215
04;2020-06-28;0;0;0;58788;45780;39;104568
04;2020-06-28;0;0;0;61408;52207;49;113615
04;2020-06-28;0;0;0;64838;60759;59;125597
04;2020-06-28;0;0;0;47008;42843;69;89851
04;2020-06-28;0;0;0;25509;21184;79;46693
04;2020-06-28;0;0;0;13168;7647;89;20815
04;2020-06-28;0;0;0;3209;1253;90;4462
04;2020-06-28;0;1;1;451366;408593;0;859959
05;2020-06-28;0;0;0;362.366008612902;341.338819562748;09;703.704828175651
05;2020-06-28;0;0;0;353.376145114279;370.349735405642;19;723.725880519921
05;2020-06-28;0;0;0;218.593559489256;256.539602589476;29;475.133162078732
05;2020-06-28;0;0;0;404.225408693299;360.321910454353;39;764.547319147651
05;2020-06-28;0;0;0;520.067953604221;497.108383964256;49;1017.17633756848
05;2020-06-28;0;0;0;468.146063921917;510.087601910415;59;978.233665832332
05;2020-06-28;0;0;0;340.368470050554;334.366842191253;69;674.735312241807
05;2020-06-28;0;0;0;212.598666888387;192.597753227106;79;405.196420115493
05;2020-06-28;0;0;0;148.727797095705;61.8681715431829;89;210.595968638888
05;2020-06-28;0;0;0;32.9601271090696;10.9909785719784;90;43.9511056810479
05;2020-06-28;0;0;0;3061.43020057959;2935.56979942041;0;5997
06;2020-06-28;0;0;0;42583;42380;09;84963
06;2020-06-28;0;0;0;33369;31925;19;65294
06;2020-06-28;1;0;1;21571;15080;29;36651
06;2020-06-28;1;0;1;21550;16147;39;37697
06;2020-06-28;2;0;2;14193;13939;49;28132
06;2020-06-28;0;2;2;7171;7597;59;14768
06;2020-06-28;0;1;1;3629;4117;69;7746
06;2020-06-28;0;0;0;1577;1457;79;3034
06;2020-06-28;0;0;0;531;474;89;1005
06;2020-06-28;0;0;0;88;93;90;181
06;2020-06-28;4;3;7;146262;133209;0;279471
07;2020-06-28;0;0;0;485;549;09;1034
07;2020-06-28;0;0;0;403;432;19;835
07;2020-06-28;0;0;0;764;841;29;1605
07;2020-06-28;0;0;0;824;928;39;1752
07;2020-06-28;0;0;0;788;1020;49;1808
07;2020-06-28;0;0;0;678;870;59;1548
07;2020-06-28;0;0;0;360;382;69;742
07;2020-06-28;0;0;0;231;190;79;421
07;2020-06-28;0;0;0;114;67;89;181
07;2020-06-28;0;0;0;24;11;90;35
07;2020-06-28;0;0;0;4671;5290;0;9961
08;2020-06-28;0;0;0;2715.22592983026;2997.75551488675;09;5712.98144471701
08;2020-06-28;0;0;0;2778.51901080978;3160.9156459093;19;5939.43465671908
08;2020-06-28;0;0;0;2080.8882988764;1718.16634315323;29;3799.05464202964
08;2020-06-28;0;0;0;2701.8582062647;1896.52641413317;39;4598.38462039786
08;2020-06-28;0;0;0;3151.45861023308;2460.52498233809;49;5611.98359257117
08;2020-06-28;0;0;0;2620.29868333099;2422.23566154656;59;5042.53434487755
08;2020-06-28;0;0;0;1621.44173420671;1438.58325779464;69;3060.02499200135
08;2020-06-28;0;0;0;626.575909335673;526.358467843651;79;1152.93437717932
08;2020-06-28;0;0;0;205.018522985054;140.993639349697;89;346.012162334751
08;2020-06-28;0;0;0;50.0325684687745;20.62259870351;90;70.6551671722846
08;2020-06-28;0;0;0;18551.3174743414;16782.6825256586;0;35334
11;2020-06-28;0;0;0;783071;811785;09;1594856
11;2020-06-28;0;2;2;761456;784653;19;1546109
11;2020-06-28;0;1;1;850145;801772;29;1651917
11;2020-06-28;1;4;5;914360;843488;39;1757848
11;2020-06-28;1;0;1;845609;826202;49;1671811
11;2020-06-28;1;1;2;793566;745070;59;1538636
11;2020-06-28;2;0;2;628649;549192;69;1177841
11;2020-06-28;2;2;4;434606;358356;79;792962
11;2020-06-28;4;0;4;261425;162933;89;424358
11;2020-06-28;1;0;1;89253;32619;90;121872
11;2020-06-28;12;10;22;6362140;5916070;0;12278210
24;2020-06-28;0;1;1;139720;144686;09;284406
24;2020-06-28;0;1;1;152979;161185;19;314164
24;2020-06-28;1;0;1;122237;126536;29;248773
24;2020-06-28;0;0;0;150359;142009;39;292368
24;2020-06-28;0;0;0;161829;158758;49;320587
24;2020-06-28;1;0;1;172552;168011;59;340563
24;2020-06-28;0;0;0;172509;158177;69;330686
24;2020-06-28;0;0;0;129428;110593;79;240021
24;2020-06-28;0;0;0;87342;56882;89;144224
24;2020-06-28;0;0;0;31210;12071;90;43281
24;2020-06-28;2;2;4;1320165;1238908;0;2559073
27;2020-06-28;0;1;1;143373;149679;09;293052
27;2020-06-28;0;2;2;160962;173003;19;333965
27;2020-06-28;0;0;0;133746;142254;29;276000
27;2020-06-28;2;0;2;160004;155407;39;315411
27;2020-06-28;0;0;0;172333;169564;49;341897
27;2020-06-28;0;0;0;189979;183788;59;373767
27;2020-06-28;0;0;0;192591;178206;69;370797
27;2020-06-28;0;1;1;146876;127546;79;274422
27;2020-06-28;0;0;0;96896;61575;89;158471
27;2020-06-28;1;0;1;33148;12109;90;45257
27;2020-06-28;3;4;7;1429908;1353131;0;2783039
28;2020-06-28;0;0;0;180735;186856;09;367591
28;2020-06-28;0;0;0;200125;213621;19;413746
28;2020-06-28;0;0;0;168922;173007;29;341929
28;2020-06-28;0;2;2;196628;188487;39;385115
28;2020-06-28;1;2;3;205396;201699;49;407095
28;2020-06-28;1;2;3;222002;213866;59;435868
28;2020-06-28;1;0;1;224688;203758;69;428446
28;2020-06-28;1;0;1;163192;135543;79;298735
28;2020-06-28;0;0;0;109691;65377;89;175068
28;2020-06-28;1;0;1;37222;12685;90;49907
28;2020-06-28;5;6;11;1708601;1594899;0;3303500
32;2020-06-28;1;0;1;358062;373689;09;731751
32;2020-06-28;0;0;0;387045;406742;19;793787
32;2020-06-28;1;0;1;342304;348587;29;690891
32;2020-06-28;0;0;0;382485;369972;39;752457
32;2020-06-28;0;1;1;382510;376716;49;759226
32;2020-06-28;1;0;1;386937;376527;59;763464
32;2020-06-28;0;0;0;371211;330938;69;702149
32;2020-06-28;0;1;1;250542;201459;79;452001
32;2020-06-28;1;0;1;163399;89786;89;253185
32;2020-06-28;1;0;1;48384;15367;90;63751
32;2020-06-28;5;2;7;3072879;2889783;0;5962662
44;2020-06-28;0;0;0;291525;306839;09;598364
44;2020-06-28;0;0;0;320255;339504;19;659759
44;2020-06-28;1;0;1;302020;314428;29;616448
44;2020-06-28;1;0;1;342222;333292;39;675514
44;2020-06-28;0;0;0;349727;344491;49;694218
44;2020-06-28;0;0;0;381371;373239;59;754610
44;2020-06-28;0;1;1;367165;335850;69;703015
44;2020-06-28;0;1;1;250387;215436;79;465823
44;2020-06-28;0;1;1;170825;105192;89;276017
44;2020-06-28;0;1;1;51248;16731;90;67979
44;2020-06-28;2;4;6;2826745;2685002;0;5511747
52;2020-06-28;1;0;1;213594;223900;09;437494
52;2020-06-28;0;0;0;240818;255197;19;496015
52;2020-06-28;0;1;1;197010;200630;29;397640
52;2020-06-28;0;0;0;231204;224885;39;456089
52;2020-06-28;0;0;0;243874;243418;49;487292
52;2020-06-28;1;0;1;244100;239116;59;483216
52;2020-06-28;0;0;0;241796;221345;69;463141
52;2020-06-28;0;0;0;177805;149903;79;327708
52;2020-06-28;0;0;0;119561;75822;89;195383
52;2020-06-28;0;0;0;42559;15260;90;57819
52;2020-06-28;2;1;3;1952321;1849476;0;3801797
53;2020-06-28;0;0;0;173813;182358;09;356171
53;2020-06-28;0;0;0;202720;214740;19;417460
53;2020-06-28;0;0;0;163116;173196;29;336312
53;2020-06-28;0;0;0;190526;187674;39;378200
53;2020-06-28;0;0;0;212098;212015;49;424113
53;2020-06-28;0;0;0;223699;219176;59;442875
53;2020-06-28;0;0;0;227435;209274;69;436709
53;2020-06-28;0;0;0;169992;140910;79;310902
53;2020-06-28;0;0;0;118117;69883;89;188000
53;2020-06-28;0;0;0;37370;12267;90;49637
53;2020-06-28;0;0;0;1718886;1621493;0;3340379
75;2020-06-28;0;2;2;293104;305291;09;598395
75;2020-06-28;1;0;1;337141;357785;19;694926
75;2020-06-28;0;0;0;295024;300618;29;595642
75;2020-06-28;0;0;0;347871;331233;39;679104
75;2020-06-28;0;0;0;384742;372771;49;757513
75;2020-06-28;0;0;0;413361;390880;59;804241
75;2020-06-28;0;0;0;425623;384060;69;809683
75;2020-06-28;0;0;0;325086;276298;79;601384
75;2020-06-28;0;0;0;213986;139308;89;353294
75;2020-06-28;0;1;1;77600;28200;90;105800
75;2020-06-28;1;3;4;3113538;2886444;0;5999982
76;2020-06-28;0;0;0;305956;318589;09;624545
76;2020-06-28;0;1;1;338942;356969;19;695911
76;2020-06-28;0;1;1;316210;319570;29;635780
76;2020-06-28;1;0;1;356758;337587;39;694345
76;2020-06-28;0;0;0;376541;363812;49;740353
76;2020-06-28;0;0;0;402608;383750;59;786358
76;2020-06-28;0;1;1;394889;358997;69;753886
76;2020-06-28;0;0;0;308664;263806;79;572470
76;2020-06-28;0;0;0;195838;129272;89;325110
76;2020-06-28;0;1;1;69372;26728;90;96100
76;2020-06-28;1;4;5;3065778;2859080;0;5924858
84;2020-06-28;0;0;0;459549;481088;09;940637
84;2020-06-28;0;1;1;487711;511905;19;999616
84;2020-06-28;0;0;0;443824;451094;29;894918
84;2020-06-28;0;1;1;512522;493262;39;1005784
84;2020-06-28;1;0;1;520248;515106;49;1035354
84;2020-06-28;0;2;2;529611;514848;59;1044459
84;2020-06-28;0;1;1;486720;439940;69;926660
84;2020-06-28;0;0;0;372151;315211;79;687362
84;2020-06-28;1;1;2;237198;150524;89;387722
84;2020-06-28;0;1;1;81185;28680;90;109865
84;2020-06-28;2;7;9;4130719;3901658;0;8032377
93;2020-06-28;0;0;0;268834;283093;09;551927
93;2020-06-28;0;0;0;280751;296087;19;576838
93;2020-06-28;0;0;0;254404;255552;29;509956
93;2020-06-28;0;0;0;310704;288398;39;599102
93;2020-06-28;0;0;0;325559;305827;49;631386
93;2020-06-28;0;0;0;353104;325389;59;678493
93;2020-06-28;0;0;0;336327;296459;69;632786
93;2020-06-28;0;0;0;279820;229699;79;509519
93;2020-06-28;1;0;1;171274;113716;89;284990
93;2020-06-28;0;0;0;58896;21758;90;80654
93;2020-06-28;1;0;1;2639673;2415978;0;5055651
94;2020-06-28;0;0;0;16311;17433;09;33744
94;2020-06-28;0;0;0;16679;18132;19;34811
94;2020-06-28;0;0;0;16782;16579;29;33361
94;2020-06-28;0;0;0;23044;20580;39;43624
94;2020-06-28;0;0;0;23065;22140;49;45205
94;2020-06-28;0;0;0;24549;23421;59;47970
94;2020-06-28;0;0;0;23212;21883;69;45095
94;2020-06-28;0;0;0;19544;17141;79;36685
94;2020-06-28;0;0;0;11227;8178;89;19405
94;2020-06-28;0;0;0;3332;1447;90;4779
94;2020-06-28;0;0;0;177745;166934;0;344679
01;2020-06-29;0;0;0;19979;20155;09;40134
01;2020-06-29;0;0;0;24994;25489;19;50483
01;2020-06-29;0;0;0;17868;16690;29;34558
01;2020-06-29;0;0;0;22328;14821;39;37149
01;2020-06-29;0;0;0;28652;20276;49;48928
01;2020-06-29;0;0;0;33264;27260;59;60524
01;2020-06-29;0;0;0;27135;23978;69;51113
01;2020-06-29;0;0;0;18401;14661;79;33062
01;2020-06-29;0;0;0;9633;6375;89;16008
01;2020-06-29;0;0;0;3410;1510;90;4920
01;2020-06-29;0;0;0;205664;171215;0;376879
02;2020-06-29;0;0;0;16881;17110;09;33991
02;2020-06-29;0;0;0;21410;21604;19;43014
02;2020-06-29;0;1;1;16017;15479;29;31496
02;2020-06-29;0;0;0;19825;14455;39;34280
02;2020-06-29;0;0;0;24719;18248;49;42967
02;2020-06-29;0;0;0;34361;28310;59;62671
02;2020-06-29;0;0;0;28061;24495;69;52556
02;2020-06-29;0;0;0;18231;15278;79;33509
02;2020-06-29;0;0;0;11090;7677;89;18767
02;2020-06-29;0;0;0;3992;1506;90;5498
02;2020-06-29;0;1;1;194587;164162;0;358749
03;2020-06-29;6;6;12;31123;30920;09;62043
03;2020-06-29;14;4;18;29370;29268;19;58638
03;2020-06-29;19;18;39;21458;18963;29;40421
03;2020-06-29;27;13;40;21276;18326;39;39602
03;2020-06-29;16;15;31;18164;16593;49;34757
03;2020-06-29;8;24;33;13469;13557;59;27026
03;2020-06-29;10;15;25;8776;8670;69;17446
03;2020-06-29;4;4;8;3777;3591;79;7368
03;2020-06-29;1;0;1;1649;1072;89;2721
03;2020-06-29;0;1;1;485;184;90;669
03;2020-06-29;105;100;208;149547;141144;0;290691
04;2020-06-29;0;0;0;60314;61377;09;121691
04;2020-06-29;0;1;1;66065;68387;19;134452
04;2020-06-29;0;0;0;51059;47156;29;98215
04;2020-06-29;0;0;0;58788;45780;39;104568
04;2020-06-29;0;0;0;61408;52207;49;113615
04;2020-06-29;0;1;1;64838;60759;59;125597
04;2020-06-29;0;1;1;47008;42843;69;89851
04;2020-06-29;0;0;0;25509;21184;79;46693
04;2020-06-29;0;0;0;13168;7647;89;20815
04;2020-06-29;0;0;0;3209;1253;90;4462
04;2020-06-29;0;3;3;451366;408593;0;859959
05;2020-06-29;0;0;0;362.366008612902;341.338819562748;09;703.704828175651
05;2020-06-29;0;0;0;353.376145114279;370.349735405642;19;723.725880519921
05;2020-06-29;0;0;0;218.593559489256;256.539602589476;29;475.133162078732
05;2020-06-29;0;0;0;404.225408693299;360.321910454353;39;764.547319147651
05;2020-06-29;0;0;0;520.067953604221;497.108383964256;49;1017.17633756848
05;2020-06-29;0;0;0;468.146063921917;510.087601910415;59;978.233665832332
05;2020-06-29;0;0;0;340.368470050554;334.366842191253;69;674.735312241807
05;2020-06-29;0;0;0;212.598666888387;192.597753227106;79;405.196420115493
05;2020-06-29;0;0;0;148.727797095705;61.8681715431829;89;210.595968638888
05;2020-06-29;0;0;0;32.9601271090696;10.9909785719784;90;43.9511056810479
05;2020-06-29;0;0;0;3061.43020057959;2935.56979942041;0;5997
06;2020-06-29;0;0;0;42583;42380;09;84963
06;2020-06-29;1;3;4;33369;31925;19;65294
06;2020-06-29;5;2;7;21571;15080;29;36651
06;2020-06-29;1;3;4;21550;16147;39;37697
06;2020-06-29;5;3;8;14193;13939;49;28132
06;2020-06-29;2;1;3;7171;7597;59;14768
06;2020-06-29;1;1;2;3629;4117;69;7746
06;2020-06-29;0;0;0;1577;1457;79;3034
06;2020-06-29;0;0;0;531;474;89;1005
06;2020-06-29;0;0;0;88;93;90;181
06;2020-06-29;15;13;28;146262;133209;0;279471
07;2020-06-29;0;0;0;485;549;09;1034
07;2020-06-29;0;0;0;403;432;19;835
07;2020-06-29;0;0;0;764;841;29;1605
07;2020-06-29;0;0;0;824;928;39;1752
07;2020-06-29;0;0;0;788;1020;49;1808
07;2020-06-29;0;0;0;678;870;59;1548
07;2020-06-29;0;0;0;360;382;69;742
07;2020-06-29;0;0;0;231;190;79;421
07;2020-06-29;0;0;0;114;67;89;181
07;2020-06-29;0;0;0;24;11;90;35
07;2020-06-29;0;0;0;4671;5290;0;9961
08;2020-06-29;0;0;0;2715.22592983026;2997.75551488675;09;5712.98144471701
08;2020-06-29;0;0;0;2778.51901080978;3160.9156459093;19;5939.43465671908
08;2020-06-29;0;0;0;2080.8882988764;1718.16634315323;29;3799.05464202964
08;2020-06-29;0;0;0;2701.8582062647;1896.52641413317;39;4598.38462039786
08;2020-06-29;0;0;0;3151.45861023308;2460.52498233809;49;5611.98359257117
08;2020-06-29;0;0;0;2620.29868333099;2422.23566154656;59;5042.53434487755
08;2020-06-29;0;0;0;1621.44173420671;1438.58325779464;69;3060.02499200135
08;2020-06-29;0;0;0;626.575909335673;526.358467843651;79;1152.93437717932
08;2020-06-29;0;0;0;205.018522985054;140.993639349697;89;346.012162334751
08;2020-06-29;0;0;0;50.0325684687745;20.62259870351;90;70.6551671722846
08;2020-06-29;0;0;0;18551.3174743414;16782.6825256586;0;35334
11;2020-06-29;4;4;8;783071;811785;09;1594856
11;2020-06-29;8;7;15;761456;784653;19;1546109
11;2020-06-29;17;15;32;850145;801772;29;1651917
11;2020-06-29;11;12;23;914360;843488;39;1757848
11;2020-06-29;13;14;27;845609;826202;49;1671811
11;2020-06-29;7;8;15;793566;745070;59;1538636
11;2020-06-29;4;7;11;628649;549192;69;1177841
11;2020-06-29;2;2;4;434606;358356;79;792962
11;2020-06-29;6;0;6;261425;162933;89;424358
11;2020-06-29;2;1;3;89253;32619;90;121872
11;2020-06-29;74;70;144;6362140;5916070;0;12278210
24;2020-06-29;2;3;5;139720;144686;09;284406
24;2020-06-29;1;0;1;152979;161185;19;314164
24;2020-06-29;2;0;2;122237;126536;29;248773
24;2020-06-29;3;1;4;150359;142009;39;292368
24;2020-06-29;0;0;0;161829;158758;49;320587
24;2020-06-29;2;2;4;172552;168011;59;340563
24;2020-06-29;1;0;1;172509;158177;69;330686
24;2020-06-29;0;0;0;129428;110593;79;240021
24;2020-06-29;0;0;0;87342;56882;89;144224
24;2020-06-29;0;0;0;31210;12071;90;43281
24;2020-06-29;11;6;17;1320165;1238908;0;2559073
27;2020-06-29;1;0;1;143373;149679;09;293052
27;2020-06-29;0;0;0;160962;173003;19;333965
27;2020-06-29;1;1;2;133746;142254;29;276000
27;2020-06-29;1;0;1;160004;155407;39;315411
27;2020-06-29;0;1;1;172333;169564;49;341897
27;2020-06-29;0;0;0;189979;183788;59;373767
27;2020-06-29;1;2;3;192591;178206;69;370797
27;2020-06-29;1;2;3;146876;127546;79;274422
27;2020-06-29;1;0;1;96896;61575;89;158471
27;2020-06-29;1;0;1;33148;12109;90;45257
27;2020-06-29;7;6;13;1429908;1353131;0;2783039
28;2020-06-29;2;3;5;180735;186856;09;367591
28;2020-06-29;3;1;4;200125;213621;19;413746
28;2020-06-29;0;1;1;168922;173007;29;341929
28;2020-06-29;0;2;2;196628;188487;39;385115
28;2020-06-29;0;1;1;205396;201699;49;407095
28;2020-06-29;1;2;4;222002;213866;59;435868
28;2020-06-29;3;2;5;224688;203758;69;428446
28;2020-06-29;1;0;1;163192;135543;79;298735
28;2020-06-29;1;0;1;109691;65377;89;175068
28;2020-06-29;0;0;0;37222;12685;90;49907
28;2020-06-29;11;12;24;1708601;1594899;0;3303500
32;2020-06-29;3;7;10;358062;373689;09;731751
32;2020-06-29;2;4;6;387045;406742;19;793787
32;2020-06-29;2;2;4;342304;348587;29;690891
32;2020-06-29;3;5;8;382485;369972;39;752457
32;2020-06-29;3;3;6;382510;376716;49;759226
32;2020-06-29;3;3;6;386937;376527;59;763464
32;2020-06-29;3;0;3;371211;330938;69;702149
32;2020-06-29;0;2;2;250542;201459;79;452001
32;2020-06-29;2;0;2;163399;89786;89;253185
32;2020-06-29;2;0;2;48384;15367;90;63751
32;2020-06-29;23;26;49;3072879;2889783;0;5962662
44;2020-06-29;1;1;2;291525;306839;09;598364
44;2020-06-29;1;0;1;320255;339504;19;659759
44;2020-06-29;1;1;2;302020;314428;29;616448
44;2020-06-29;2;0;2;342222;333292;39;675514
44;2020-06-29;2;0;2;349727;344491;49;694218
44;2020-06-29;1;0;1;381371;373239;59;754610
44;2020-06-29;2;2;4;367165;335850;69;703015
44;2020-06-29;2;3;5;250387;215436;79;465823
44;2020-06-29;0;2;2;170825;105192;89;276017
44;2020-06-29;0;0;0;51248;16731;90;67979
44;2020-06-29;12;9;21;2826745;2685002;0;5511747
52;2020-06-29;1;1;2;213594;223900;09;437494
52;2020-06-29;0;0;0;240818;255197;19;496015
52;2020-06-29;4;7;11;197010;200630;29;397640
52;2020-06-29;0;15;15;231204;224885;39;456089
52;2020-06-29;3;6;9;243874;243418;49;487292
52;2020-06-29;0;6;6;244100;239116;59;483216
52;2020-06-29;0;2;2;241796;221345;69;463141
52;2020-06-29;0;1;1;177805;149903;79;327708
52;2020-06-29;1;0;1;119561;75822;89;195383
52;2020-06-29;1;0;1;42559;15260;90;57819
52;2020-06-29;10;38;48;1952321;1849476;0;3801797
53;2020-06-29;1;1;2;173813;182358;09;356171
53;2020-06-29;0;0;0;202720;214740;19;417460
53;2020-06-29;0;0;0;163116;173196;29;336312
53;2020-06-29;0;0;0;190526;187674;39;378200
53;2020-06-29;0;0;0;212098;212015;49;424113
53;2020-06-29;0;0;0;223699;219176;59;442875
53;2020-06-29;1;0;1;227435;209274;69;436709
53;2020-06-29;0;0;0;169992;140910;79;310902
53;2020-06-29;0;0;0;118117;69883;89;188000
53;2020-06-29;1;0;1;37370;12267;90;49637
53;2020-06-29;3;1;4;1718886;1621493;0;3340379
75;2020-06-29;0;1;1;293104;305291;09;598395
75;2020-06-29;0;0;0;337141;357785;19;694926
75;2020-06-29;0;1;1;295024;300618;29;595642
75;2020-06-29;0;2;2;347871;331233;39;679104
75;2020-06-29;1;0;1;384742;372771;49;757513
75;2020-06-29;0;0;0;413361;390880;59;804241
75;2020-06-29;1;0;1;425623;384060;69;809683
75;2020-06-29;0;0;0;325086;276298;79;601384
75;2020-06-29;0;0;0;213986;139308;89;353294
75;2020-06-29;0;0;0;77600;28200;90;105800
75;2020-06-29;2;4;6;3113538;2886444;0;5999982
76;2020-06-29;0;0;0;305956;318589;09;624545
76;2020-06-29;0;1;1;338942;356969;19;695911
76;2020-06-29;4;0;4;316210;319570;29;635780
76;2020-06-29;5;6;11;356758;337587;39;694345
76;2020-06-29;1;3;4;376541;363812;49;740353
76;2020-06-29;1;2;3;402608;383750;59;786358
76;2020-06-29;0;0;0;394889;358997;69;753886
76;2020-06-29;0;0;0;308664;263806;79;572470
76;2020-06-29;2;1;3;195838;129272;89;325110
76;2020-06-29;1;0;1;69372;26728;90;96100
76;2020-06-29;14;13;27;3065778;2859080;0;5924858
84;2020-06-29;2;0;2;459549;481088;09;940637
84;2020-06-29;2;4;6;487711;511905;19;999616
84;2020-06-29;3;3;6;443824;451094;29;894918
84;2020-06-29;3;4;7;512522;493262;39;1005784
84;2020-06-29;5;2;7;520248;515106;49;1035354
84;2020-06-29;3;1;4;529611;514848;59;1044459
84;2020-06-29;3;1;4;486720;439940;69;926660
84;2020-06-29;2;2;4;372151;315211;79;687362
84;2020-06-29;0;0;0;237198;150524;89;387722
84;2020-06-29;0;0;0;81185;28680;90;109865
84;2020-06-29;23;17;41;4130719;3901658;0;8032377
93;2020-06-29;0;1;1;268834;283093;09;551927
93;2020-06-29;3;1;4;280751;296087;19;576838
93;2020-06-29;3;1;4;254404;255552;29;509956
93;2020-06-29;2;2;4;310704;288398;39;599102
93;2020-06-29;3;3;6;325559;305827;49;631386
93;2020-06-29;4;3;7;353104;325389;59;678493
93;2020-06-29;4;0;4;336327;296459;69;632786
93;2020-06-29;1;5;6;279820;229699;79;509519
93;2020-06-29;0;1;1;171274;113716;89;284990
93;2020-06-29;2;0;2;58896;21758;90;80654
93;2020-06-29;22;17;39;2639673;2415978;0;5055651
94;2020-06-29;0;0;0;16311;17433;09;33744
94;2020-06-29;0;0;0;16679;18132;19;34811
94;2020-06-29;0;0;0;16782;16579;29;33361
94;2020-06-29;0;0;0;23044;20580;39;43624
94;2020-06-29;0;0;0;23065;22140;49;45205
94;2020-06-29;1;0;1;24549;23421;59;47970
94;2020-06-29;0;0;0;23212;21883;69;45095
94;2020-06-29;0;0;0;19544;17141;79;36685
94;2020-06-29;0;0;0;11227;8178;89;19405
94;2020-06-29;0;0;0;3332;1447;90;4779
94;2020-06-29;1;0;1;177745;166934;0;344679
01;2020-06-30;0;0;0;19979;20155;09;40134
01;2020-06-30;0;0;0;24994;25489;19;50483
01;2020-06-30;1;0;1;17868;16690;29;34558
01;2020-06-30;0;0;0;22328;14821;39;37149
01;2020-06-30;0;0;0;28652;20276;49;48928
01;2020-06-30;0;0;0;33264;27260;59;60524
01;2020-06-30;1;0;1;27135;23978;69;51113
01;2020-06-30;0;0;0;18401;14661;79;33062
01;2020-06-30;0;0;0;9633;6375;89;16008
01;2020-06-30;0;0;0;3410;1510;90;4920
01;2020-06-30;2;0;2;205664;171215;0;376879
02;2020-06-30;0;0;0;16881;17110;09;33991
02;2020-06-30;2;0;2;21410;21604;19;43014
02;2020-06-30;0;0;0;16017;15479;29;31496
02;2020-06-30;0;0;0;19825;14455;39;34280
02;2020-06-30;0;0;0;24719;18248;49;42967
02;2020-06-30;0;0;0;34361;28310;59;62671
02;2020-06-30;0;0;0;28061;24495;69;52556
02;2020-06-30;0;0;0;18231;15278;79;33509
02;2020-06-30;0;0;0;11090;7677;89;18767
02;2020-06-30;0;0;0;3992;1506;90;5498
02;2020-06-30;2;0;2;194587;164162;0;358749
03;2020-06-30;2;8;11;31123;30920;09;62043
03;2020-06-30;8;10;20;29370;29268;19;58638
03;2020-06-30;20;16;37;21458;18963;29;40421
03;2020-06-30;39;26;68;21276;18326;39;39602
03;2020-06-30;21;24;49;18164;16593;49;34757
03;2020-06-30;23;10;34;13469;13557;59;27026
03;2020-06-30;8;10;18;8776;8670;69;17446
03;2020-06-30;4;4;8;3777;3591;79;7368
03;2020-06-30;0;2;2;1649;1072;89;2721
03;2020-06-30;0;1;2;485;184;90;669
03;2020-06-30;125;111;249;149547;141144;0;290691
04;2020-06-30;0;0;0;60314;61377;09;121691
04;2020-06-30;0;0;0;66065;68387;19;134452
04;2020-06-30;0;0;0;51059;47156;29;98215
04;2020-06-30;2;1;3;58788;45780;39;104568
04;2020-06-30;0;0;0;61408;52207;49;113615
04;2020-06-30;0;0;0;64838;60759;59;125597
04;2020-06-30;0;0;0;47008;42843;69;89851
04;2020-06-30;0;0;0;25509;21184;79;46693
04;2020-06-30;0;0;0;13168;7647;89;20815
04;2020-06-30;0;0;0;3209;1253;90;4462
04;2020-06-30;2;1;3;451366;408593;0;859959
05;2020-06-30;0;0;0;362.366008612902;341.338819562748;09;703.704828175651
05;2020-06-30;0;0;0;353.376145114279;370.349735405642;19;723.725880519921
05;2020-06-30;0;0;0;218.593559489256;256.539602589476;29;475.133162078732
05;2020-06-30;0;0;0;404.225408693299;360.321910454353;39;764.547319147651
05;2020-06-30;0;0;0;520.067953604221;497.108383964256;49;1017.17633756848
05;2020-06-30;0;0;0;468.146063921917;510.087601910415;59;978.233665832332
05;2020-06-30;0;0;0;340.368470050554;334.366842191253;69;674.735312241807
05;2020-06-30;0;0;0;212.598666888387;192.597753227106;79;405.196420115493
05;2020-06-30;0;0;0;148.727797095705;61.8681715431829;89;210.595968638888
05;2020-06-30;0;0;0;32.9601271090696;10.9909785719784;90;43.9511056810479
05;2020-06-30;0;0;0;3061.43020057959;2935.56979942041;0;5997
06;2020-06-30;0;2;2;42583;42380;09;84963
06;2020-06-30;3;1;4;33369;31925;19;65294
06;2020-06-30;1;2;3;21571;15080;29;36651
06;2020-06-30;3;4;7;21550;16147;39;37697
06;2020-06-30;1;1;2;14193;13939;49;28132
06;2020-06-30;1;1;2;7171;7597;59;14768
06;2020-06-30;0;0;0;3629;4117;69;7746
06;2020-06-30;0;2;2;1577;1457;79;3034
06;2020-06-30;0;0;0;531;474;89;1005
06;2020-06-30;0;0;0;88;93;90;181
06;2020-06-30;9;13;22;146262;133209;0;279471
07;2020-06-30;0;0;0;485;549;09;1034
07;2020-06-30;0;0;0;403;432;19;835
07;2020-06-30;0;0;0;764;841;29;1605
07;2020-06-30;0;0;0;824;928;39;1752
07;2020-06-30;0;0;0;788;1020;49;1808
07;2020-06-30;0;0;0;678;870;59;1548
07;2020-06-30;0;0;0;360;382;69;742
07;2020-06-30;0;0;0;231;190;79;421
07;2020-06-30;0;0;0;114;67;89;181
07;2020-06-30;0;0;0;24;11;90;35
07;2020-06-30;0;0;0;4671;5290;0;9961
08;2020-06-30;0;0;0;2715.22592983026;2997.75551488675;09;5712.98144471701
08;2020-06-30;0;0;0;2778.51901080978;3160.9156459093;19;5939.43465671908
08;2020-06-30;0;0;0;2080.8882988764;1718.16634315323;29;3799.05464202964
08;2020-06-30;0;0;0;2701.8582062647;1896.52641413317;39;4598.38462039786
08;2020-06-30;0;0;0;3151.45861023308;2460.52498233809;49;5611.98359257117
08;2020-06-30;0;0;0;2620.29868333099;2422.23566154656;59;5042.53434487755
08;2020-06-30;0;0;0;1621.44173420671;1438.58325779464;69;3060.02499200135
08;2020-06-30;0;0;0;626.575909335673;526.358467843651;79;1152.93437717932
08;2020-06-30;0;0;0;205.018522985054;140.993639349697;89;346.012162334751
08;2020-06-30;0;0;0;50.0325684687745;20.62259870351;90;70.6551671722846
08;2020-06-30;0;0;0;18551.3174743414;16782.6825256586;0;35334
11;2020-06-30;5;4;9;783071;811785;09;1594856
11;2020-06-30;7;7;14;761456;784653;19;1546109
11;2020-06-30;11;11;22;850145;801772;29;1651917
11;2020-06-30;15;17;33;914360;843488;39;1757848
11;2020-06-30;10;9;19;845609;826202;49;1671811
11;2020-06-30;10;11;21;793566;745070;59;1538636
11;2020-06-30;4;6;10;628649;549192;69;1177841
11;2020-06-30;3;8;11;434606;358356;79;792962
11;2020-06-30;7;0;7;261425;162933;89;424358
11;2020-06-30;3;0;3;89253;32619;90;121872
11;2020-06-30;75;73;152;6362140;5916070;0;12278210
24;2020-06-30;1;1;2;139720;144686;09;284406
24;2020-06-30;0;0;0;152979;161185;19;314164
24;2020-06-30;2;1;3;122237;126536;29;248773
24;2020-06-30;0;0;0;150359;142009;39;292368
24;2020-06-30;1;2;3;161829;158758;49;320587
24;2020-06-30;2;1;3;172552;168011;59;340563
24;2020-06-30;0;0;0;172509;158177;69;330686
24;2020-06-30;0;0;0;129428;110593;79;240021
24;2020-06-30;0;0;0;87342;56882;89;144224
24;2020-06-30;1;0;1;31210;12071;90;43281
24;2020-06-30;7;5;13;1320165;1238908;0;2559073
27;2020-06-30;1;0;1;143373;149679;09;293052
27;2020-06-30;1;3;4;160962;173003;19;333965
27;2020-06-30;1;0;1;133746;142254;29;276000
27;2020-06-30;1;0;1;160004;155407;39;315411
27;2020-06-30;3;0;3;172333;169564;49;341897
27;2020-06-30;1;0;1;189979;183788;59;373767
27;2020-06-30;0;0;0;192591;178206;69;370797
27;2020-06-30;0;1;1;146876;127546;79;274422
27;2020-06-30;2;1;3;96896;61575;89;158471
27;2020-06-30;0;0;0;33148;12109;90;45257
27;2020-06-30;10;5;15;1429908;1353131;0;2783039
28;2020-06-30;1;2;3;180735;186856;09;367591
28;2020-06-30;1;2;3;200125;213621;19;413746
28;2020-06-30;2;4;6;168922;173007;29;341929
28;2020-06-30;4;1;5;196628;188487;39;385115
28;2020-06-30;1;3;4;205396;201699;49;407095
28;2020-06-30;2;0;2;222002;213866;59;435868
28;2020-06-30;1;1;2;224688;203758;69;428446
28;2020-06-30;0;2;2;163192;135543;79;298735
28;2020-06-30;2;2;4;109691;65377;89;175068
28;2020-06-30;0;0;0;37222;12685;90;49907
28;2020-06-30;14;17;32;1708601;1594899;0;3303500
32;2020-06-30;1;5;7;358062;373689;09;731751
32;2020-06-30;2;1;3;387045;406742;19;793787
32;2020-06-30;5;4;9;342304;348587;29;690891
32;2020-06-30;2;4;6;382485;369972;39;752457
32;2020-06-30;0;2;2;382510;376716;49;759226
32;2020-06-30;1;0;1;386937;376527;59;763464
32;2020-06-30;5;2;7;371211;330938;69;702149
32;2020-06-30;2;0;2;250542;201459;79;452001
32;2020-06-30;3;1;4;163399;89786;89;253185
32;2020-06-30;2;0;2;48384;15367;90;63751
32;2020-06-30;23;19;46;3072879;2889783;0;5962662
44;2020-06-30;0;1;2;291525;306839;09;598364
44;2020-06-30;0;0;0;320255;339504;19;659759
44;2020-06-30;1;1;2;302020;314428;29;616448
44;2020-06-30;0;2;2;342222;333292;39;675514
44;2020-06-30;1;1;2;349727;344491;49;694218
44;2020-06-30;1;1;2;381371;373239;59;754610
44;2020-06-30;3;0;3;367165;335850;69;703015
44;2020-06-30;4;2;6;250387;215436;79;465823
44;2020-06-30;3;1;4;170825;105192;89;276017
44;2020-06-30;1;1;2;51248;16731;90;67979
44;2020-06-30;14;10;29;2826745;2685002;0;5511747
52;2020-06-30;2;0;2;213594;223900;09;437494
52;2020-06-30;0;2;2;240818;255197;19;496015
52;2020-06-30;7;6;13;197010;200630;29;397640
52;2020-06-30;6;4;10;231204;224885;39;456089
52;2020-06-30;4;3;7;243874;243418;49;487292
52;2020-06-30;1;2;3;244100;239116;59;483216
52;2020-06-30;0;0;0;241796;221345;69;463141
52;2020-06-30;0;0;0;177805;149903;79;327708
52;2020-06-30;4;4;8;119561;75822;89;195383
52;2020-06-30;2;1;3;42559;15260;90;57819
52;2020-06-30;26;22;48;1952321;1849476;0;3801797
53;2020-06-30;0;1;1;173813;182358;09;356171
53;2020-06-30;0;0;0;202720;214740;19;417460
53;2020-06-30;0;0;0;163116;173196;29;336312
53;2020-06-30;1;2;3;190526;187674;39;378200
53;2020-06-30;1;2;3;212098;212015;49;424113
53;2020-06-30;0;0;0;223699;219176;59;442875
53;2020-06-30;1;1;2;227435;209274;69;436709
53;2020-06-30;0;0;0;169992;140910;79;310902
53;2020-06-30;0;0;0;118117;69883;89;188000
53;2020-06-30;0;0;0;37370;12267;90;49637
53;2020-06-30;3;6;9;1718886;1621493;0;3340379
75;2020-06-30;0;0;0;293104;305291;09;598395
75;2020-06-30;0;0;0;337141;357785;19;694926
75;2020-06-30;0;1;1;295024;300618;29;595642
75;2020-06-30;2;1;3;347871;331233;39;679104
75;2020-06-30;1;0;1;384742;372771;49;757513
75;2020-06-30;3;0;3;413361;390880;59;804241
75;2020-06-30;0;0;0;425623;384060;69;809683
75;2020-06-30;0;2;2;325086;276298;79;601384
75;2020-06-30;0;0;0;213986;139308;89;353294
75;2020-06-30;0;0;0;77600;28200;90;105800
75;2020-06-30;6;4;13;3113538;2886444;0;5999982
76;2020-06-30;0;0;0;305956;318589;09;624545
76;2020-06-30;4;3;7;338942;356969;19;695911
76;2020-06-30;4;1;5;316210;319570;29;635780
76;2020-06-30;0;1;1;356758;337587;39;694345
76;2020-06-30;4;2;6;376541;363812;49;740353
76;2020-06-30;0;4;4;402608;383750;59;786358
76;2020-06-30;0;0;0;394889;358997;69;753886
76;2020-06-30;2;0;2;308664;263806;79;572470
76;2020-06-30;1;0;1;195838;129272;89;325110
76;2020-06-30;0;0;0;69372;26728;90;96100
76;2020-06-30;15;11;27;3065778;2859080;0;5924858
84;2020-06-30;1;0;1;459549;481088;09;940637
84;2020-06-30;2;3;5;487711;511905;19;999616
84;2020-06-30;2;4;6;443824;451094;29;894918
84;2020-06-30;3;1;4;512522;493262;39;1005784
84;2020-06-30;2;4;6;520248;515106;49;1035354
84;2020-06-30;2;2;4;529611;514848;59;1044459
84;2020-06-30;5;2;7;486720;439940;69;926660
84;2020-06-30;2;0;2;372151;315211;79;687362
84;2020-06-30;0;0;0;237198;150524;89;387722
84;2020-06-30;1;0;2;81185;28680;90;109865
84;2020-06-30;21;16;42;4130719;3901658;0;8032377
93;2020-06-30;0;0;0;268834;283093;09;551927
93;2020-06-30;0;1;1;280751;296087;19;576838
93;2020-06-30;3;1;4;254404;255552;29;509956
93;2020-06-30;0;4;4;310704;288398;39;599102
93;2020-06-30;2;1;3;325559;305827;49;631386
93;2020-06-30;0;2;2;353104;325389;59;678493
93;2020-06-30;0;1;1;336327;296459;69;632786
93;2020-06-30;0;2;2;279820;229699;79;509519
93;2020-06-30;1;0;1;171274;113716;89;284990
93;2020-06-30;0;0;0;58896;21758;90;80654
93;2020-06-30;6;12;19;2639673;2415978;0;5055651
94;2020-06-30;0;0;0;16311;17433;09;33744
94;2020-06-30;0;0;0;16679;18132;19;34811
94;2020-06-30;0;0;0;16782;16579;29;33361
94;2020-06-30;0;0;0;23044;20580;39;43624
94;2020-06-30;0;0;0;23065;22140;49;45205
94;2020-06-30;0;0;0;24549;23421;59;47970
94;2020-06-30;0;0;0;23212;21883;69;45095
94;2020-06-30;0;0;0;19544;17141;79;36685
94;2020-06-30;0;0;0;11227;8178;89;19405
94;2020-06-30;0;0;0;3332;1447;90;4779
94;2020-06-30;0;0;0;177745;166934;0;344679
01;2020-07-01;0;0;0;19979;20155;09;40134
01;2020-07-01;0;0;0;24994;25489;19;50483
01;2020-07-01;1;0;1;17868;16690;29;34558
01;2020-07-01;0;0;0;22328;14821;39;37149
01;2020-07-01;0;0;0;28652;20276;49;48928
01;2020-07-01;1;0;1;33264;27260;59;60524
01;2020-07-01;1;0;1;27135;23978;69;51113
01;2020-07-01;0;0;0;18401;14661;79;33062
01;2020-07-01;0;0;0;9633;6375;89;16008
01;2020-07-01;0;0;0;3410;1510;90;4920
01;2020-07-01;3;0;3;205664;171215;0;376879
02;2020-07-01;0;0;0;16881;17110;09;33991
02;2020-07-01;0;0;0;21410;21604;19;43014
02;2020-07-01;0;0;0;16017;15479;29;31496
02;2020-07-01;0;0;0;19825;14455;39;34280
02;2020-07-01;0;0;0;24719;18248;49;42967
02;2020-07-01;0;0;0;34361;28310;59;62671
02;2020-07-01;1;0;1;28061;24495;69;52556
02;2020-07-01;0;0;0;18231;15278;79;33509
02;2020-07-01;0;0;0;11090;7677;89;18767
02;2020-07-01;0;0;0;3992;1506;90;5498
02;2020-07-01;1;0;1;194587;164162;0;358749
03;2020-07-01;8;2;10;31123;30920;09;62043
03;2020-07-01;11;8;19;29370;29268;19;58638
03;2020-07-01;20;18;41;21458;18963;29;40421
03;2020-07-01;21;21;44;21276;18326;39;39602
03;2020-07-01;14;22;36;18164;16593;49;34757
03;2020-07-01;12;11;23;13469;13557;59;27026
03;2020-07-01;8;17;25;8776;8670;69;17446
03;2020-07-01;3;1;4;3777;3591;79;7368
03;2020-07-01;1;2;3;1649;1072;89;2721
03;2020-07-01;0;0;0;485;184;90;669
03;2020-07-01;98;102;205;149547;141144;0;290691
04;2020-07-01;0;0;0;60314;61377;09;121691
04;2020-07-01;0;0;0;66065;68387;19;134452
04;2020-07-01;0;0;0;51059;47156;29;98215
04;2020-07-01;0;0;0;58788;45780;39;104568
04;2020-07-01;0;0;0;61408;52207;49;113615
04;2020-07-01;0;0;0;64838;60759;59;125597
04;2020-07-01;2;0;2;47008;42843;69;89851
04;2020-07-01;0;0;0;25509;21184;79;46693
04;2020-07-01;0;0;0;13168;7647;89;20815
04;2020-07-01;0;0;0;3209;1253;90;4462
04;2020-07-01;2;0;2;451366;408593;0;859959
05;2020-07-01;0;0;0;362.366008612902;341.338819562748;09;703.704828175651
05;2020-07-01;0;0;0;353.376145114279;370.349735405642;19;723.725880519921
05;2020-07-01;0;0;0;218.593559489256;256.539602589476;29;475.133162078732
05;2020-07-01;0;0;0;404.225408693299;360.321910454353;39;764.547319147651
05;2020-07-01;0;0;0;520.067953604221;497.108383964256;49;1017.17633756848
05;2020-07-01;0;0;0;468.146063921917;510.087601910415;59;978.233665832332
05;2020-07-01;0;0;0;340.368470050554;334.366842191253;69;674.735312241807
05;2020-07-01;0;0;0;212.598666888387;192.597753227106;79;405.196420115493
05;2020-07-01;0;0;0;148.727797095705;61.8681715431829;89;210.595968638888
05;2020-07-01;0;0;0;32.9601271090696;10.9909785719784;90;43.9511056810479
05;2020-07-01;0;0;0;3061.43020057959;2935.56979942041;0;5997
06;2020-07-01;1;1;2;42583;42380;09;84963
06;2020-07-01;0;0;0;33369;31925;19;65294
06;2020-07-01;5;0;5;21571;15080;29;36651
06;2020-07-01;2;2;4;21550;16147;39;37697
06;2020-07-01;1;2;3;14193;13939;49;28132
06;2020-07-01;3;0;3;7171;7597;59;14768
06;2020-07-01;0;0;0;3629;4117;69;7746
06;2020-07-01;0;0;0;1577;1457;79;3034
06;2020-07-01;0;0;0;531;474;89;1005
06;2020-07-01;0;0;0;88;93;90;181
06;2020-07-01;12;5;17;146262;133209;0;279471
07;2020-07-01;0;0;0;485;549;09;1034
07;2020-07-01;0;0;0;403;432;19;835
07;2020-07-01;0;0;0;764;841;29;1605
07;2020-07-01;0;0;0;824;928;39;1752
07;2020-07-01;0;0;0;788;1020;49;1808
07;2020-07-01;0;0;0;678;870;59;1548
07;2020-07-01;0;0;0;360;382;69;742
07;2020-07-01;0;0;0;231;190;79;421
07;2020-07-01;0;0;0;114;67;89;181
07;2020-07-01;0;0;0;24;11;90;35
07;2020-07-01;0;0;0;4671;5290;0;9961
08;2020-07-01;0;0;0;2715.22592983026;2997.75551488675;09;5712.98144471701
08;2020-07-01;0;0;0;2778.51901080978;3160.9156459093;19;5939.43465671908
08;2020-07-01;0;0;0;2080.8882988764;1718.16634315323;29;3799.05464202964
08;2020-07-01;0;0;0;2701.8582062647;1896.52641413317;39;4598.38462039786
08;2020-07-01;0;0;0;3151.45861023308;2460.52498233809;49;5611.98359257117
08;2020-07-01;0;0;0;2620.29868333099;2422.23566154656;59;5042.53434487755
08;2020-07-01;0;0;0;1621.44173420671;1438.58325779464;69;3060.02499200135
08;2020-07-01;0;0;0;626.575909335673;526.358467843651;79;1152.93437717932
08;2020-07-01;0;0;0;205.018522985054;140.993639349697;89;346.012162334751
08;2020-07-01;0;0;0;50.0325684687745;20.62259870351;90;70.6551671722846
08;2020-07-01;0;0;0;18551.3174743414;16782.6825256586;0;35334
11;2020-07-01;6;5;12;783071;811785;09;1594856
11;2020-07-01;4;7;11;761456;784653;19;1546109
11;2020-07-01;9;14;23;850145;801772;29;1651917
11;2020-07-01;16;10;26;914360;843488;39;1757848
11;2020-07-01;5;9;14;845609;826202;49;1671811
11;2020-07-01;9;15;24;793566;745070;59;1538636
11;2020-07-01;4;8;12;628649;549192;69;1177841
11;2020-07-01;0;2;2;434606;358356;79;792962
11;2020-07-01;1;1;2;261425;162933;89;424358
11;2020-07-01;2;1;3;89253;32619;90;121872
11;2020-07-01;56;73;132;6362140;5916070;0;12278210
24;2020-07-01;0;1;1;139720;144686;09;284406
24;2020-07-01;1;1;2;152979;161185;19;314164
24;2020-07-01;5;0;5;122237;126536;29;248773
24;2020-07-01;0;0;0;150359;142009;39;292368
24;2020-07-01;0;0;0;161829;158758;49;320587
24;2020-07-01;2;0;2;172552;168011;59;340563
24;2020-07-01;0;0;0;172509;158177;69;330686
24;2020-07-01;0;0;0;129428;110593;79;240021
24;2020-07-01;1;1;2;87342;56882;89;144224
24;2020-07-01;1;0;1;31210;12071;90;43281
24;2020-07-01;10;3;13;1320165;1238908;0;2559073
27;2020-07-01;0;0;0;143373;149679;09;293052
27;2020-07-01;2;1;3;160962;173003;19;333965
27;2020-07-01;0;0;0;133746;142254;29;276000
27;2020-07-01;0;1;1;160004;155407;39;315411
27;2020-07-01;1;3;4;172333;169564;49;341897
27;2020-07-01;0;5;5;189979;183788;59;373767
27;2020-07-01;1;0;1;192591;178206;69;370797
27;2020-07-01;1;1;2;146876;127546;79;274422
27;2020-07-01;1;1;2;96896;61575;89;158471
27;2020-07-01;0;2;2;33148;12109;90;45257
27;2020-07-01;6;14;20;1429908;1353131;0;2783039
28;2020-07-01;2;1;3;180735;186856;09;367591
28;2020-07-01;2;1;3;200125;213621;19;413746
28;2020-07-01;1;2;3;168922;173007;29;341929
28;2020-07-01;0;2;2;196628;188487;39;385115
28;2020-07-01;2;0;2;205396;201699;49;407095
28;2020-07-01;1;1;2;222002;213866;59;435868
28;2020-07-01;1;0;1;224688;203758;69;428446
28;2020-07-01;1;1;2;163192;135543;79;298735
28;2020-07-01;1;1;2;109691;65377;89;175068
28;2020-07-01;1;0;1;37222;12685;90;49907
28;2020-07-01;12;9;21;1708601;1594899;0;3303500
32;2020-07-01;4;4;8;358062;373689;09;731751
32;2020-07-01;2;3;5;387045;406742;19;793787
32;2020-07-01;2;4;6;342304;348587;29;690891
32;2020-07-01;4;0;4;382485;369972;39;752457
32;2020-07-01;8;7;15;382510;376716;49;759226
32;2020-07-01;5;0;5;386937;376527;59;763464
32;2020-07-01;0;2;2;371211;330938;69;702149
32;2020-07-01;1;0;1;250542;201459;79;452001
32;2020-07-01;4;2;6;163399;89786;89;253185
32;2020-07-01;0;0;0;48384;15367;90;63751
32;2020-07-01;30;22;54;3072879;2889783;0;5962662
44;2020-07-01;1;0;3;291525;306839;09;598364
44;2020-07-01;0;0;0;320255;339504;19;659759
44;2020-07-01;6;0;6;302020;314428;29;616448
44;2020-07-01;1;1;2;342222;333292;39;675514
44;2020-07-01;2;2;4;349727;344491;49;694218
44;2020-07-01;1;3;4;381371;373239;59;754610
44;2020-07-01;1;3;4;367165;335850;69;703015
44;2020-07-01;0;0;0;250387;215436;79;465823
44;2020-07-01;0;2;2;170825;105192;89;276017
44;2020-07-01;1;0;1;51248;16731;90;67979
44;2020-07-01;13;11;27;2826745;2685002;0;5511747
52;2020-07-01;0;3;3;213594;223900;09;437494
52;2020-07-01;1;1;2;240818;255197;19;496015
52;2020-07-01;4;11;15;197010;200630;29;397640
52;2020-07-01;3;4;7;231204;224885;39;456089
52;2020-07-01;2;3;5;243874;243418;49;487292
52;2020-07-01;2;0;2;244100;239116;59;483216
52;2020-07-01;0;0;0;241796;221345;69;463141
52;2020-07-01;0;0;0;177805;149903;79;327708
52;2020-07-01;0;0;0;119561;75822;89;195383
52;2020-07-01;0;0;0;42559;15260;90;57819
52;2020-07-01;12;22;34;1952321;1849476;0;3801797
53;2020-07-01;0;0;1;173813;182358;09;356171
53;2020-07-01;0;0;0;202720;214740;19;417460
53;2020-07-01;1;0;1;163116;173196;29;336312
53;2020-07-01;0;0;0;190526;187674;39;378200
53;2020-07-01;0;0;0;212098;212015;49;424113
53;2020-07-01;0;0;0;223699;219176;59;442875
53;2020-07-01;0;0;0;227435;209274;69;436709
53;2020-07-01;1;0;1;169992;140910;79;310902
53;2020-07-01;0;0;0;118117;69883;89;188000
53;2020-07-01;0;1;1;37370;12267;90;49637
53;2020-07-01;3;1;5;1718886;1621493;0;3340379
75;2020-07-01;0;0;0;293104;305291;09;598395
75;2020-07-01;0;0;1;337141;357785;19;694926
75;2020-07-01;2;2;4;295024;300618;29;595642
75;2020-07-01;5;2;7;347871;331233;39;679104
75;2020-07-01;4;3;7;384742;372771;49;757513
75;2020-07-01;1;1;2;413361;390880;59;804241
75;2020-07-01;0;0;0;425623;384060;69;809683
75;2020-07-01;0;1;1;325086;276298;79;601384
75;2020-07-01;0;0;0;213986;139308;89;353294
75;2020-07-01;0;0;0;77600;28200;90;105800
75;2020-07-01;12;10;23;3113538;2886444;0;5999982
76;2020-07-01;1;0;4;305956;318589;09;624545
76;2020-07-01;2;1;3;338942;356969;19;695911
76;2020-07-01;2;2;4;316210;319570;29;635780
76;2020-07-01;2;2;4;356758;337587;39;694345
76;2020-07-01;0;2;2;376541;363812;49;740353
76;2020-07-01;2;2;4;402608;383750;59;786358
76;2020-07-01;1;0;1;394889;358997;69;753886
76;2020-07-01;0;1;1;308664;263806;79;572470
76;2020-07-01;0;0;0;195838;129272;89;325110
76;2020-07-01;0;1;1;69372;26728;90;96100
76;2020-07-01;10;11;25;3065778;2859080;0;5924858
84;2020-07-01;1;3;4;459549;481088;09;940637
84;2020-07-01;3;2;5;487711;511905;19;999616
84;2020-07-01;4;1;5;443824;451094;29;894918
84;2020-07-01;4;0;4;512522;493262;39;1005784
84;2020-07-01;1;3;4;520248;515106;49;1035354
84;2020-07-01;2;1;3;529611;514848;59;1044459
84;2020-07-01;0;0;0;486720;439940;69;926660
84;2020-07-01;1;0;1;372151;315211;79;687362
84;2020-07-01;3;2;5;237198;150524;89;387722
84;2020-07-01;0;0;0;81185;28680;90;109865
84;2020-07-01;19;12;31;4130719;3901658;0;8032377
93;2020-07-01;0;1;1;268834;283093;09;551927
93;2020-07-01;1;1;2;280751;296087;19;576838
93;2020-07-01;0;2;2;254404;255552;29;509956
93;2020-07-01;0;1;1;310704;288398;39;599102
93;2020-07-01;0;1;1;325559;305827;49;631386
93;2020-07-01;5;1;6;353104;325389;59;678493
93;2020-07-01;0;2;2;336327;296459;69;632786
93;2020-07-01;0;0;0;279820;229699;79;509519
93;2020-07-01;0;1;1;171274;113716;89;284990
93;2020-07-01;0;0;0;58896;21758;90;80654
93;2020-07-01;6;10;16;2639673;2415978;0;5055651
94;2020-07-01;0;0;0;16311;17433;09;33744
94;2020-07-01;0;0;0;16679;18132;19;34811
94;2020-07-01;0;0;0;16782;16579;29;33361
94;2020-07-01;0;0;0;23044;20580;39;43624
94;2020-07-01;0;0;0;23065;22140;49;45205
94;2020-07-01;0;0;0;24549;23421;59;47970
94;2020-07-01;0;1;1;23212;21883;69;45095
94;2020-07-01;0;1;1;19544;17141;79;36685
94;2020-07-01;0;0;0;11227;8178;89;19405
94;2020-07-01;0;0;0;3332;1447;90;4779
94;2020-07-01;0;2;2;177745;166934;0;344679
01;2020-07-02;0;0;0;19979;20155;09;40134
01;2020-07-02;0;0;0;24994;25489;19;50483
01;2020-07-02;0;0;0;17868;16690;29;34558
01;2020-07-02;0;0;0;22328;14821;39;37149
01;2020-07-02;0;0;0;28652;20276;49;48928
01;2020-07-02;0;0;0;33264;27260;59;60524
01;2020-07-02;0;0;0;27135;23978;69;51113
01;2020-07-02;0;1;1;18401;14661;79;33062
01;2020-07-02;0;0;0;9633;6375;89;16008
01;2020-07-02;0;0;0;3410;1510;90;4920
01;2020-07-02;0;1;1;205664;171215;0;376879
02;2020-07-02;0;0;0;16881;17110;09;33991
02;2020-07-02;0;0;0;21410;21604;19;43014
02;2020-07-02;0;1;1;16017;15479;29;31496
02;2020-07-02;0;0;0;19825;14455;39;34280
02;2020-07-02;0;0;0;24719;18248;49;42967
02;2020-07-02;0;0;0;34361;28310;59;62671
02;2020-07-02;0;0;0;28061;24495;69;52556
02;2020-07-02;0;0;0;18231;15278;79;33509
02;2020-07-02;0;0;0;11090;7677;89;18767
02;2020-07-02;0;0;0;3992;1506;90;5498
02;2020-07-02;0;1;1;194587;164162;0;358749
03;2020-07-02;5;3;8;31123;30920;09;62043
03;2020-07-02;9;9;18;29370;29268;19;58638
03;2020-07-02;24;15;39;21458;18963;29;40421
03;2020-07-02;21;20;42;21276;18326;39;39602
03;2020-07-02;15;10;25;18164;16593;49;34757
03;2020-07-02;10;12;22;13469;13557;59;27026
03;2020-07-02;7;11;18;8776;8670;69;17446
03;2020-07-02;5;5;10;3777;3591;79;7368
03;2020-07-02;1;1;2;1649;1072;89;2721
03;2020-07-02;0;0;0;485;184;90;669
03;2020-07-02;97;86;184;149547;141144;0;290691
04;2020-07-02;0;0;0;60314;61377;09;121691
04;2020-07-02;0;0;0;66065;68387;19;134452
04;2020-07-02;1;0;1;51059;47156;29;98215
04;2020-07-02;1;0;1;58788;45780;39;104568
04;2020-07-02;0;0;0;61408;52207;49;113615
04;2020-07-02;0;0;0;64838;60759;59;125597
04;2020-07-02;0;0;0;47008;42843;69;89851
04;2020-07-02;0;0;0;25509;21184;79;46693
04;2020-07-02;0;0;0;13168;7647;89;20815
04;2020-07-02;0;0;0;3209;1253;90;4462
04;2020-07-02;2;0;2;451366;408593;0;859959
05;2020-07-02;0;0;0;362.366008612902;341.338819562748;09;703.704828175651
05;2020-07-02;0;0;0;353.376145114279;370.349735405642;19;723.725880519921
05;2020-07-02;0;0;0;218.593559489256;256.539602589476;29;475.133162078732
05;2020-07-02;0;0;0;404.225408693299;360.321910454353;39;764.547319147651
05;2020-07-02;0;0;0;520.067953604221;497.108383964256;49;1017.17633756848
05;2020-07-02;0;0;0;468.146063921917;510.087601910415;59;978.233665832332
05;2020-07-02;0;0;0;340.368470050554;334.366842191253;69;674.735312241807
05;2020-07-02;0;0;0;212.598666888387;192.597753227106;79;405.196420115493
05;2020-07-02;0;0;0;148.727797095705;61.8681715431829;89;210.595968638888
05;2020-07-02;0;0;0;32.9601271090696;10.9909785719784;90;43.9511056810479
05;2020-07-02;0;0;0;3061.43020057959;2935.56979942041;0;5997
06;2020-07-02;0;0;0;42583;42380;09;84963
06;2020-07-02;2;0;2;33369;31925;19;65294
06;2020-07-02;1;0;1;21571;15080;29;36651
06;2020-07-02;1;1;2;21550;16147;39;37697
06;2020-07-02;2;0;2;14193;13939;49;28132
06;2020-07-02;1;0;1;7171;7597;59;14768
06;2020-07-02;0;0;0;3629;4117;69;7746
06;2020-07-02;0;0;0;1577;1457;79;3034
06;2020-07-02;0;0;0;531;474;89;1005
06;2020-07-02;0;0;0;88;93;90;181
06;2020-07-02;7;1;8;146262;133209;0;279471
07;2020-07-02;0;0;0;485;549;09;1034
07;2020-07-02;0;0;0;403;432;19;835
07;2020-07-02;0;0;0;764;841;29;1605
07;2020-07-02;0;0;0;824;928;39;1752
07;2020-07-02;0;0;0;788;1020;49;1808
07;2020-07-02;0;0;0;678;870;59;1548
07;2020-07-02;0;0;0;360;382;69;742
07;2020-07-02;0;0;0;231;190;79;421
07;2020-07-02;0;0;0;114;67;89;181
07;2020-07-02;0;0;0;24;11;90;35
07;2020-07-02;0;0;0;4671;5290;0;9961
08;2020-07-02;0;0;0;2715.22592983026;2997.75551488675;09;5712.98144471701
08;2020-07-02;0;0;0;2778.51901080978;3160.9156459093;19;5939.43465671908
08;2020-07-02;0;0;0;2080.8882988764;1718.16634315323;29;3799.05464202964
08;2020-07-02;0;0;0;2701.8582062647;1896.52641413317;39;4598.38462039786
08;2020-07-02;0;0;0;3151.45861023308;2460.52498233809;49;5611.98359257117
08;2020-07-02;0;0;0;2620.29868333099;2422.23566154656;59;5042.53434487755
08;2020-07-02;0;0;0;1621.44173420671;1438.58325779464;69;3060.02499200135
08;2020-07-02;0;0;0;626.575909335673;526.358467843651;79;1152.93437717932
08;2020-07-02;0;0;0;205.018522985054;140.993639349697;89;346.012162334751
08;2020-07-02;0;0;0;50.0325684687745;20.62259870351;90;70.6551671722846
08;2020-07-02;0;0;0;18551.3174743414;16782.6825256586;0;35334
11;2020-07-02;1;2;4;783071;811785;09;1594856
11;2020-07-02;5;13;19;761456;784653;19;1546109
11;2020-07-02;13;16;29;850145;801772;29;1651917
11;2020-07-02;8;10;18;914360;843488;39;1757848
11;2020-07-02;12;13;25;845609;826202;49;1671811
11;2020-07-02;11;10;21;793566;745070;59;1538636
11;2020-07-02;4;3;7;628649;549192;69;1177841
11;2020-07-02;3;2;5;434606;358356;79;792962
11;2020-07-02;2;1;3;261425;162933;89;424358
11;2020-07-02;2;0;2;89253;32619;90;121872
11;2020-07-02;61;70;133;6362140;5916070;0;12278210
24;2020-07-02;0;0;0;139720;144686;09;284406
24;2020-07-02;0;1;1;152979;161185;19;314164
24;2020-07-02;0;0;0;122237;126536;29;248773
24;2020-07-02;3;2;5;150359;142009;39;292368
24;2020-07-02;1;1;2;161829;158758;49;320587
24;2020-07-02;2;1;3;172552;168011;59;340563
24;2020-07-02;2;1;3;172509;158177;69;330686
24;2020-07-02;1;1;2;129428;110593;79;240021
24;2020-07-02;1;0;1;87342;56882;89;144224
24;2020-07-02;0;0;0;31210;12071;90;43281
24;2020-07-02;10;7;17;1320165;1238908;0;2559073
27;2020-07-02;0;0;0;143373;149679;09;293052
27;2020-07-02;1;1;2;160962;173003;19;333965
27;2020-07-02;0;0;0;133746;142254;29;276000
27;2020-07-02;1;0;1;160004;155407;39;315411
27;2020-07-02;0;0;0;172333;169564;49;341897
27;2020-07-02;2;0;2;189979;183788;59;373767
27;2020-07-02;0;0;0;192591;178206;69;370797
27;2020-07-02;1;0;1;146876;127546;79;274422
27;2020-07-02;1;0;1;96896;61575;89;158471
27;2020-07-02;1;0;1;33148;12109;90;45257
27;2020-07-02;7;1;8;1429908;1353131;0;2783039
28;2020-07-02;2;0;2;180735;186856;09;367591
28;2020-07-02;0;0;0;200125;213621;19;413746
28;2020-07-02;2;0;2;168922;173007;29;341929
28;2020-07-02;3;3;6;196628;188487;39;385115
28;2020-07-02;1;1;2;205396;201699;49;407095
28;2020-07-02;3;0;3;222002;213866;59;435868
28;2020-07-02;1;0;1;224688;203758;69;428446
28;2020-07-02;0;1;1;163192;135543;79;298735
28;2020-07-02;1;1;2;109691;65377;89;175068
28;2020-07-02;1;0;1;37222;12685;90;49907
28;2020-07-02;14;6;20;1708601;1594899;0;3303500
32;2020-07-02;3;2;5;358062;373689;09;731751
32;2020-07-02;7;3;10;387045;406742;19;793787
32;2020-07-02;3;3;6;342304;348587;29;690891
32;2020-07-02;6;4;10;382485;369972;39;752457
32;2020-07-02;2;9;11;382510;376716;49;759226
32;2020-07-02;3;1;4;386937;376527;59;763464
32;2020-07-02;4;4;8;371211;330938;69;702149
32;2020-07-02;1;1;2;250542;201459;79;452001
32;2020-07-02;6;2;8;163399;89786;89;253185
32;2020-07-02;0;0;0;48384;15367;90;63751
32;2020-07-02;35;29;67;3072879;2889783;0;5962662
44;2020-07-02;1;1;2;291525;306839;09;598364
44;2020-07-02;0;1;1;320255;339504;19;659759
44;2020-07-02;2;2;4;302020;314428;29;616448
44;2020-07-02;2;0;2;342222;333292;39;675514
44;2020-07-02;0;2;2;349727;344491;49;694218
44;2020-07-02;1;2;3;381371;373239;59;754610
44;2020-07-02;5;3;8;367165;335850;69;703015
44;2020-07-02;0;0;0;250387;215436;79;465823
44;2020-07-02;2;0;2;170825;105192;89;276017
44;2020-07-02;0;0;0;51248;16731;90;67979
44;2020-07-02;13;11;25;2826745;2685002;0;5511747
52;2020-07-02;0;1;1;213594;223900;09;437494
52;2020-07-02;3;0;3;240818;255197;19;496015
52;2020-07-02;5;4;9;197010;200630;29;397640
52;2020-07-02;2;1;3;231204;224885;39;456089
52;2020-07-02;3;2;5;243874;243418;49;487292
52;2020-07-02;0;3;3;244100;239116;59;483216
52;2020-07-02;1;2;3;241796;221345;69;463141
52;2020-07-02;0;0;0;177805;149903;79;327708
52;2020-07-02;0;0;0;119561;75822;89;195383
52;2020-07-02;1;0;1;42559;15260;90;57819
52;2020-07-02;15;13;28;1952321;1849476;0;3801797
53;2020-07-02;0;0;0;173813;182358;09;356171
53;2020-07-02;0;0;0;202720;214740;19;417460
53;2020-07-02;0;1;1;163116;173196;29;336312
53;2020-07-02;0;1;1;190526;187674;39;378200
53;2020-07-02;0;0;0;212098;212015;49;424113
53;2020-07-02;0;0;0;223699;219176;59;442875
53;2020-07-02;0;0;0;227435;209274;69;436709
53;2020-07-02;0;0;0;169992;140910;79;310902
53;2020-07-02;0;0;0;118117;69883;89;188000
53;2020-07-02;0;0;0;37370;12267;90;49637
53;2020-07-02;0;2;2;1718886;1621493;0;3340379
75;2020-07-02;0;1;1;293104;305291;09;598395
75;2020-07-02;0;1;1;337141;357785;19;694926
75;2020-07-02;1;3;4;295024;300618;29;595642
75;2020-07-02;1;1;2;347871;331233;39;679104
75;2020-07-02;3;0;3;384742;372771;49;757513
75;2020-07-02;1;0;1;413361;390880;59;804241
75;2020-07-02;0;0;0;425623;384060;69;809683
75;2020-07-02;0;0;0;325086;276298;79;601384
75;2020-07-02;0;0;0;213986;139308;89;353294
75;2020-07-02;0;0;0;77600;28200;90;105800
75;2020-07-02;6;6;12;3113538;2886444;0;5999982
76;2020-07-02;2;1;3;305956;318589;09;624545
76;2020-07-02;2;1;3;338942;356969;19;695911
76;2020-07-02;1;1;2;316210;319570;29;635780
76;2020-07-02;1;2;3;356758;337587;39;694345
76;2020-07-02;5;1;6;376541;363812;49;740353
76;2020-07-02;0;0;0;402608;383750;59;786358
76;2020-07-02;0;1;1;394889;358997;69;753886
76;2020-07-02;1;0;1;308664;263806;79;572470
76;2020-07-02;0;0;0;195838;129272;89;325110
76;2020-07-02;0;0;0;69372;26728;90;96100
76;2020-07-02;12;7;20;3065778;2859080;0;5924858
84;2020-07-02;4;1;5;459549;481088;09;940637
84;2020-07-02;4;1;5;487711;511905;19;999616
84;2020-07-02;2;3;5;443824;451094;29;894918
84;2020-07-02;1;3;4;512522;493262;39;1005784
84;2020-07-02;1;4;5;520248;515106;49;1035354
84;2020-07-02;3;2;6;529611;514848;59;1044459
84;2020-07-02;1;2;4;486720;439940;69;926660
84;2020-07-02;1;0;2;372151;315211;79;687362
84;2020-07-02;2;1;3;237198;150524;89;387722
84;2020-07-02;0;0;0;81185;28680;90;109865
84;2020-07-02;19;17;39;4130719;3901658;0;8032377
93;2020-07-02;0;1;3;268834;283093;09;551927
93;2020-07-02;3;2;5;280751;296087;19;576838
93;2020-07-02;3;0;3;254404;255552;29;509956
93;2020-07-02;2;3;5;310704;288398;39;599102
93;2020-07-02;0;1;1;325559;305827;49;631386
93;2020-07-02;1;2;3;353104;325389;59;678493
93;2020-07-02;1;1;2;336327;296459;69;632786
93;2020-07-02;0;0;0;279820;229699;79;509519
93;2020-07-02;0;0;0;171274;113716;89;284990
93;2020-07-02;0;0;0;58896;21758;90;80654
93;2020-07-02;10;10;22;2639673;2415978;0;5055651
94;2020-07-02;0;0;0;16311;17433;09;33744
94;2020-07-02;0;0;0;16679;18132;19;34811
94;2020-07-02;0;0;0;16782;16579;29;33361
94;2020-07-02;0;0;0;23044;20580;39;43624
94;2020-07-02;0;0;0;23065;22140;49;45205
94;2020-07-02;0;0;0;24549;23421;59;47970
94;2020-07-02;0;0;0;23212;21883;69;45095
94;2020-07-02;0;0;0;19544;17141;79;36685
94;2020-07-02;1;0;1;11227;8178;89;19405
94;2020-07-02;0;0;0;3332;1447;90;4779
94;2020-07-02;1;0;1;177745;166934;0;344679
01;2020-07-03;0;0;0;19979;20155;09;40134
01;2020-07-03;0;0;0;24994;25489;19;50483
01;2020-07-03;0;0;0;17868;16690;29;34558
01;2020-07-03;0;0;0;22328;14821;39;37149
01;2020-07-03;0;1;1;28652;20276;49;48928
01;2020-07-03;0;0;0;33264;27260;59;60524
01;2020-07-03;0;0;0;27135;23978;69;51113
01;2020-07-03;0;0;0;18401;14661;79;33062
01;2020-07-03;0;0;0;9633;6375;89;16008
01;2020-07-03;0;0;0;3410;1510;90;4920
01;2020-07-03;0;1;1;205664;171215;0;376879
02;2020-07-03;0;0;0;16881;17110;09;33991
02;2020-07-03;0;0;0;21410;21604;19;43014
02;2020-07-03;0;0;0;16017;15479;29;31496
02;2020-07-03;0;0;0;19825;14455;39;34280
02;2020-07-03;0;0;0;24719;18248;49;42967
02;2020-07-03;0;1;1;34361;28310;59;62671
02;2020-07-03;0;0;0;28061;24495;69;52556
02;2020-07-03;0;0;0;18231;15278;79;33509
02;2020-07-03;0;0;0;11090;7677;89;18767
02;2020-07-03;0;0;0;3992;1506;90;5498
02;2020-07-03;0;1;1;194587;164162;0;358749
03;2020-07-03;6;2;9;31123;30920;09;62043
03;2020-07-03;17;20;38;29370;29268;19;58638
03;2020-07-03;31;15;54;21458;18963;29;40421
03;2020-07-03;31;22;55;21276;18326;39;39602
03;2020-07-03;22;14;37;18164;16593;49;34757
03;2020-07-03;13;12;27;13469;13557;59;27026
03;2020-07-03;5;8;14;8776;8670;69;17446
03;2020-07-03;3;2;5;3777;3591;79;7368
03;2020-07-03;1;2;3;1649;1072;89;2721
03;2020-07-03;1;0;1;485;184;90;669
03;2020-07-03;130;97;243;149547;141144;0;290691
04;2020-07-03;1;2;4;60314;61377;09;121691
04;2020-07-03;2;1;3;66065;68387;19;134452
04;2020-07-03;1;1;2;51059;47156;29;98215
04;2020-07-03;0;0;0;58788;45780;39;104568
04;2020-07-03;0;0;0;61408;52207;49;113615
04;2020-07-03;0;0;0;64838;60759;59;125597
04;2020-07-03;0;0;0;47008;42843;69;89851
04;2020-07-03;0;0;0;25509;21184;79;46693
04;2020-07-03;0;0;0;13168;7647;89;20815
04;2020-07-03;0;0;0;3209;1253;90;4462
04;2020-07-03;4;4;9;451366;408593;0;859959
05;2020-07-03;0;0;0;362.366008612902;341.338819562748;09;703.704828175651
05;2020-07-03;0;0;0;353.376145114279;370.349735405642;19;723.725880519921
05;2020-07-03;0;0;0;218.593559489256;256.539602589476;29;475.133162078732
05;2020-07-03;0;0;0;404.225408693299;360.321910454353;39;764.547319147651
05;2020-07-03;0;0;0;520.067953604221;497.108383964256;49;1017.17633756848
05;2020-07-03;0;0;0;468.146063921917;510.087601910415;59;978.233665832332
05;2020-07-03;0;0;0;340.368470050554;334.366842191253;69;674.735312241807
05;2020-07-03;0;0;0;212.598666888387;192.597753227106;79;405.196420115493
05;2020-07-03;0;0;0;148.727797095705;61.8681715431829;89;210.595968638888
05;2020-07-03;0;0;0;32.9601271090696;10.9909785719784;90;43.9511056810479
05;2020-07-03;0;0;0;3061.43020057959;2935.56979942041;0;5997
06;2020-07-03;0;0;0;42583;42380;09;84963
06;2020-07-03;1;1;2;33369;31925;19;65294
06;2020-07-03;1;3;4;21571;15080;29;36651
06;2020-07-03;1;2;3;21550;16147;39;37697
06;2020-07-03;1;2;3;14193;13939;49;28132
06;2020-07-03;0;2;2;7171;7597;59;14768
06;2020-07-03;0;0;0;3629;4117;69;7746
06;2020-07-03;0;0;0;1577;1457;79;3034
06;2020-07-03;0;0;0;531;474;89;1005
06;2020-07-03;0;0;0;88;93;90;181
06;2020-07-03;4;10;14;146262;133209;0;279471
07;2020-07-03;0;0;0;485;549;09;1034
07;2020-07-03;0;0;0;403;432;19;835
07;2020-07-03;0;0;0;764;841;29;1605
07;2020-07-03;0;0;0;824;928;39;1752
07;2020-07-03;0;0;0;788;1020;49;1808
07;2020-07-03;0;0;0;678;870;59;1548
07;2020-07-03;0;0;0;360;382;69;742
07;2020-07-03;0;0;0;231;190;79;421
07;2020-07-03;0;0;0;114;67;89;181
07;2020-07-03;0;0;0;24;11;90;35
07;2020-07-03;0;0;0;4671;5290;0;9961
08;2020-07-03;0;0;0;2715.22592983026;2997.75551488675;09;5712.98144471701
08;2020-07-03;0;0;0;2778.51901080978;3160.9156459093;19;5939.43465671908
08;2020-07-03;0;0;0;2080.8882988764;1718.16634315323;29;3799.05464202964
08;2020-07-03;0;0;0;2701.8582062647;1896.52641413317;39;4598.38462039786
08;2020-07-03;0;0;0;3151.45861023308;2460.52498233809;49;5611.98359257117
08;2020-07-03;0;0;0;2620.29868333099;2422.23566154656;59;5042.53434487755
08;2020-07-03;0;0;0;1621.44173420671;1438.58325779464;69;3060.02499200135
08;2020-07-03;0;0;0;626.575909335673;526.358467843651;79;1152.93437717932
08;2020-07-03;0;0;0;205.018522985054;140.993639349697;89;346.012162334751
08;2020-07-03;0;0;0;50.0325684687745;20.62259870351;90;70.6551671722846
08;2020-07-03;0;0;0;18551.3174743414;16782.6825256586;0;35334
11;2020-07-03;4;4;8;783071;811785;09;1594856
11;2020-07-03;10;10;20;761456;784653;19;1546109
11;2020-07-03;11;19;30;850145;801772;29;1651917
11;2020-07-03;18;9;27;914360;843488;39;1757848
11;2020-07-03;12;11;23;845609;826202;49;1671811
11;2020-07-03;6;6;12;793566;745070;59;1538636
11;2020-07-03;8;10;18;628649;549192;69;1177841
11;2020-07-03;7;2;9;434606;358356;79;792962
11;2020-07-03;14;5;19;261425;162933;89;424358
11;2020-07-03;26;4;30;89253;32619;90;121872
11;2020-07-03;116;80;196;6362140;5916070;0;12278210
24;2020-07-03;1;0;1;139720;144686;09;284406
24;2020-07-03;1;0;1;152979;161185;19;314164
24;2020-07-03;1;0;1;122237;126536;29;248773
24;2020-07-03;1;0;1;150359;142009;39;292368
24;2020-07-03;0;0;0;161829;158758;49;320587
24;2020-07-03;0;0;0;172552;168011;59;340563
24;2020-07-03;1;0;1;172509;158177;69;330686
24;2020-07-03;0;1;1;129428;110593;79;240021
24;2020-07-03;0;1;1;87342;56882;89;144224
24;2020-07-03;0;0;0;31210;12071;90;43281
24;2020-07-03;5;2;7;1320165;1238908;0;2559073
27;2020-07-03;0;0;0;143373;149679;09;293052
27;2020-07-03;0;0;0;160962;173003;19;333965
27;2020-07-03;1;0;1;133746;142254;29;276000
27;2020-07-03;0;1;1;160004;155407;39;315411
27;2020-07-03;0;0;0;172333;169564;49;341897
27;2020-07-03;0;1;1;189979;183788;59;373767
27;2020-07-03;0;0;0;192591;178206;69;370797
27;2020-07-03;1;0;1;146876;127546;79;274422
27;2020-07-03;1;1;2;96896;61575;89;158471
27;2020-07-03;0;0;0;33148;12109;90;45257
27;2020-07-03;3;3;6;1429908;1353131;0;2783039
28;2020-07-03;1;2;3;180735;186856;09;367591
28;2020-07-03;2;1;3;200125;213621;19;413746
28;2020-07-03;0;1;1;168922;173007;29;341929
28;2020-07-03;4;0;4;196628;188487;39;385115
28;2020-07-03;2;1;3;205396;201699;49;407095
28;2020-07-03;0;1;1;222002;213866;59;435868
28;2020-07-03;2;2;4;224688;203758;69;428446
28;2020-07-03;1;0;1;163192;135543;79;298735
28;2020-07-03;2;2;4;109691;65377;89;175068
28;2020-07-03;0;0;0;37222;12685;90;49907
28;2020-07-03;14;10;24;1708601;1594899;0;3303500
32;2020-07-03;2;3;5;358062;373689;09;731751
32;2020-07-03;2;5;7;387045;406742;19;793787
32;2020-07-03;3;4;7;342304;348587;29;690891
32;2020-07-03;6;1;7;382485;369972;39;752457
32;2020-07-03;5;7;12;382510;376716;49;759226
32;2020-07-03;2;2;4;386937;376527;59;763464
32;2020-07-03;3;2;5;371211;330938;69;702149
32;2020-07-03;2;4;6;250542;201459;79;452001
32;2020-07-03;0;4;4;163399;89786;89;253185
32;2020-07-03;2;1;3;48384;15367;90;63751
32;2020-07-03;27;34;61;3072879;2889783;0;5962662
44;2020-07-03;0;1;1;291525;306839;09;598364
44;2020-07-03;1;0;1;320255;339504;19;659759
44;2020-07-03;5;0;5;302020;314428;29;616448
44;2020-07-03;2;3;5;342222;333292;39;675514
44;2020-07-03;3;3;6;349727;344491;49;694218
44;2020-07-03;1;0;1;381371;373239;59;754610
44;2020-07-03;1;3;4;367165;335850;69;703015
44;2020-07-03;2;0;2;250387;215436;79;465823
44;2020-07-03;1;0;1;170825;105192;89;276017
44;2020-07-03;2;0;2;51248;16731;90;67979
44;2020-07-03;18;10;28;2826745;2685002;0;5511747
52;2020-07-03;1;2;3;213594;223900;09;437494
52;2020-07-03;1;1;3;240818;255197;19;496015
52;2020-07-03;5;5;10;197010;200630;29;397640
52;2020-07-03;1;1;2;231204;224885;39;456089
52;2020-07-03;3;3;6;243874;243418;49;487292
52;2020-07-03;0;0;0;244100;239116;59;483216
52;2020-07-03;2;2;4;241796;221345;69;463141
52;2020-07-03;0;1;1;177805;149903;79;327708
52;2020-07-03;1;0;1;119561;75822;89;195383
52;2020-07-03;0;0;0;42559;15260;90;57819
52;2020-07-03;14;15;30;1952321;1849476;0;3801797
53;2020-07-03;1;1;2;173813;182358;09;356171
53;2020-07-03;0;2;2;202720;214740;19;417460
53;2020-07-03;0;0;0;163116;173196;29;336312
53;2020-07-03;0;1;1;190526;187674;39;378200
53;2020-07-03;0;0;0;212098;212015;49;424113
53;2020-07-03;0;1;1;223699;219176;59;442875
53;2020-07-03;0;1;1;227435;209274;69;436709
53;2020-07-03;0;0;0;169992;140910;79;310902
53;2020-07-03;0;0;0;118117;69883;89;188000
53;2020-07-03;0;0;1;37370;12267;90;49637
53;2020-07-03;1;6;9;1718886;1621493;0;3340379
75;2020-07-03;0;0;0;293104;305291;09;598395
75;2020-07-03;0;3;3;337141;357785;19;694926
75;2020-07-03;0;1;1;295024;300618;29;595642
75;2020-07-03;0;1;1;347871;331233;39;679104
75;2020-07-03;2;0;2;384742;372771;49;757513
75;2020-07-03;2;0;2;413361;390880;59;804241
75;2020-07-03;0;0;0;425623;384060;69;809683
75;2020-07-03;1;0;1;325086;276298;79;601384
75;2020-07-03;1;0;1;213986;139308;89;353294
75;2020-07-03;0;0;0;77600;28200;90;105800
75;2020-07-03;6;5;11;3113538;2886444;0;5999982
76;2020-07-03;1;1;2;305956;318589;09;624545
76;2020-07-03;1;2;3;338942;356969;19;695911
76;2020-07-03;2;4;6;316210;319570;29;635780
76;2020-07-03;2;1;3;356758;337587;39;694345
76;2020-07-03;1;1;2;376541;363812;49;740353
76;2020-07-03;0;0;0;402608;383750;59;786358
76;2020-07-03;3;1;4;394889;358997;69;753886
76;2020-07-03;1;0;1;308664;263806;79;572470
76;2020-07-03;0;0;0;195838;129272;89;325110
76;2020-07-03;0;0;0;69372;26728;90;96100
76;2020-07-03;11;10;21;3065778;2859080;0;5924858
84;2020-07-03;3;2;5;459549;481088;09;940637
84;2020-07-03;1;1;2;487711;511905;19;999616
84;2020-07-03;2;1;3;443824;451094;29;894918
84;2020-07-03;4;2;6;512522;493262;39;1005784
84;2020-07-03;1;2;3;520248;515106;49;1035354
84;2020-07-03;3;2;5;529611;514848;59;1044459
84;2020-07-03;6;2;8;486720;439940;69;926660
84;2020-07-03;0;2;2;372151;315211;79;687362
84;2020-07-03;2;0;2;237198;150524;89;387722
84;2020-07-03;2;0;2;81185;28680;90;109865
84;2020-07-03;24;14;39;4130719;3901658;0;8032377
93;2020-07-03;1;2;3;268834;283093;09;551927
93;2020-07-03;1;1;2;280751;296087;19;576838
93;2020-07-03;0;2;2;254404;255552;29;509956
93;2020-07-03;1;3;4;310704;288398;39;599102
93;2020-07-03;5;0;5;325559;305827;49;631386
93;2020-07-03;4;6;10;353104;325389;59;678493
93;2020-07-03;2;0;2;336327;296459;69;632786
93;2020-07-03;0;2;2;279820;229699;79;509519
93;2020-07-03;0;1;1;171274;113716;89;284990
93;2020-07-03;1;0;1;58896;21758;90;80654
93;2020-07-03;15;17;37;2639673;2415978;0;5055651
94;2020-07-03;0;0;0;16311;17433;09;33744
94;2020-07-03;0;0;0;16679;18132;19;34811
94;2020-07-03;0;0;0;16782;16579;29;33361
94;2020-07-03;0;0;0;23044;20580;39;43624
94;2020-07-03;0;0;0;23065;22140;49;45205
94;2020-07-03;0;0;0;24549;23421;59;47970
94;2020-07-03;0;0;0;23212;21883;69;45095
94;2020-07-03;0;0;0;19544;17141;79;36685
94;2020-07-03;0;0;0;11227;8178;89;19405
94;2020-07-03;0;0;0;3332;1447;90;4779
94;2020-07-03;0;0;0;177745;166934;0;344679
01;2020-07-04;0;0;0;19979;20155;09;40134
01;2020-07-04;0;0;0;24994;25489;19;50483
01;2020-07-04;0;0;0;17868;16690;29;34558
01;2020-07-04;0;0;0;22328;14821;39;37149
01;2020-07-04;0;0;0;28652;20276;49;48928
01;2020-07-04;0;0;0;33264;27260;59;60524
01;2020-07-04;0;0;0;27135;23978;69;51113
01;2020-07-04;0;0;0;18401;14661;79;33062
01;2020-07-04;0;0;0;9633;6375;89;16008
01;2020-07-04;0;0;0;3410;1510;90;4920
01;2020-07-04;0;0;0;205664;171215;0;376879
02;2020-07-04;1;0;1;16881;17110;09;33991
02;2020-07-04;0;0;0;21410;21604;19;43014
02;2020-07-04;0;0;0;16017;15479;29;31496
02;2020-07-04;0;0;0;19825;14455;39;34280
02;2020-07-04;0;0;0;24719;18248;49;42967
02;2020-07-04;0;0;0;34361;28310;59;62671
02;2020-07-04;0;0;0;28061;24495;69;52556
02;2020-07-04;0;0;0;18231;15278;79;33509
02;2020-07-04;0;0;0;11090;7677;89;18767
02;2020-07-04;0;0;0;3992;1506;90;5498
02;2020-07-04;1;0;1;194587;164162;0;358749
03;2020-07-04;3;3;7;31123;30920;09;62043
03;2020-07-04;6;12;20;29370;29268;19;58638
03;2020-07-04;9;17;26;21458;18963;29;40421
03;2020-07-04;11;15;27;21276;18326;39;39602
03;2020-07-04;11;12;25;18164;16593;49;34757
03;2020-07-04;8;16;24;13469;13557;59;27026
03;2020-07-04;9;6;16;8776;8670;69;17446
03;2020-07-04;4;4;8;3777;3591;79;7368
03;2020-07-04;2;1;3;1649;1072;89;2721
03;2020-07-04;1;0;1;485;184;90;669
03;2020-07-04;64;86;157;149547;141144;0;290691
04;2020-07-04;0;0;0;60314;61377;09;121691
04;2020-07-04;0;0;0;66065;68387;19;134452
04;2020-07-04;0;1;1;51059;47156;29;98215
04;2020-07-04;0;0;0;58788;45780;39;104568
04;2020-07-04;0;0;0;61408;52207;49;113615
04;2020-07-04;0;0;0;64838;60759;59;125597
04;2020-07-04;1;0;1;47008;42843;69;89851
04;2020-07-04;0;0;0;25509;21184;79;46693
04;2020-07-04;0;0;0;13168;7647;89;20815
04;2020-07-04;0;0;0;3209;1253;90;4462
04;2020-07-04;1;1;2;451366;408593;0;859959
05;2020-07-04;0;0;0;362.366008612902;341.338819562748;09;703.704828175651
05;2020-07-04;0;0;0;353.376145114279;370.349735405642;19;723.725880519921
05;2020-07-04;0;0;0;218.593559489256;256.539602589476;29;475.133162078732
05;2020-07-04;0;0;0;404.225408693299;360.321910454353;39;764.547319147651
05;2020-07-04;0;0;0;520.067953604221;497.108383964256;49;1017.17633756848
05;2020-07-04;0;0;0;468.146063921917;510.087601910415;59;978.233665832332
05;2020-07-04;0;0;0;340.368470050554;334.366842191253;69;674.735312241807
05;2020-07-04;0;0;0;212.598666888387;192.597753227106;79;405.196420115493
05;2020-07-04;0;0;0;148.727797095705;61.8681715431829;89;210.595968638888
05;2020-07-04;0;0;0;32.9601271090696;10.9909785719784;90;43.9511056810479
05;2020-07-04;0;0;0;3061.43020057959;2935.56979942041;0;5997
06;2020-07-04;0;0;0;42583;42380;09;84963
06;2020-07-04;0;0;0;33369;31925;19;65294
06;2020-07-04;1;1;2;21571;15080;29;36651
06;2020-07-04;0;0;0;21550;16147;39;37697
06;2020-07-04;1;0;1;14193;13939;49;28132
06;2020-07-04;0;1;1;7171;7597;59;14768
06;2020-07-04;0;0;0;3629;4117;69;7746
06;2020-07-04;0;0;0;1577;1457;79;3034
06;2020-07-04;0;0;0;531;474;89;1005
06;2020-07-04;0;0;0;88;93;90;181
06;2020-07-04;2;2;4;146262;133209;0;279471
07;2020-07-04;0;0;0;485;549;09;1034
07;2020-07-04;0;0;0;403;432;19;835
07;2020-07-04;0;0;0;764;841;29;1605
07;2020-07-04;0;0;0;824;928;39;1752
07;2020-07-04;0;0;0;788;1020;49;1808
07;2020-07-04;0;0;0;678;870;59;1548
07;2020-07-04;0;0;0;360;382;69;742
07;2020-07-04;0;0;0;231;190;79;421
07;2020-07-04;0;0;0;114;67;89;181
07;2020-07-04;0;0;0;24;11;90;35
07;2020-07-04;0;0;0;4671;5290;0;9961
08;2020-07-04;0;0;0;2715.22592983026;2997.75551488675;09;5712.98144471701
08;2020-07-04;0;0;0;2778.51901080978;3160.9156459093;19;5939.43465671908
08;2020-07-04;0;0;0;2080.8882988764;1718.16634315323;29;3799.05464202964
08;2020-07-04;0;0;0;2701.8582062647;1896.52641413317;39;4598.38462039786
08;2020-07-04;0;0;0;3151.45861023308;2460.52498233809;49;5611.98359257117
08;2020-07-04;0;0;0;2620.29868333099;2422.23566154656;59;5042.53434487755
08;2020-07-04;0;0;0;1621.44173420671;1438.58325779464;69;3060.02499200135
08;2020-07-04;0;0;0;626.575909335673;526.358467843651;79;1152.93437717932
08;2020-07-04;0;0;0;205.018522985054;140.993639349697;89;346.012162334751
08;2020-07-04;0;0;0;50.0325684687745;20.62259870351;90;70.6551671722846
08;2020-07-04;0;0;0;18551.3174743414;16782.6825256586;0;35334
11;2020-07-04;2;0;2;783071;811785;09;1594856
11;2020-07-04;5;5;10;761456;784653;19;1546109
11;2020-07-04;4;7;11;850145;801772;29;1651917
11;2020-07-04;4;8;12;914360;843488;39;1757848
11;2020-07-04;6;2;8;845609;826202;49;1671811
11;2020-07-04;3;4;7;793566;745070;59;1538636
11;2020-07-04;2;2;4;628649;549192;69;1177841
11;2020-07-04;2;1;3;434606;358356;79;792962
11;2020-07-04;1;2;3;261425;162933;89;424358
11;2020-07-04;1;0;1;89253;32619;90;121872
11;2020-07-04;30;31;62;6362140;5916070;0;12278210
24;2020-07-04;0;0;0;139720;144686;09;284406
24;2020-07-04;0;0;0;152979;161185;19;314164
24;2020-07-04;0;1;1;122237;126536;29;248773
24;2020-07-04;0;0;0;150359;142009;39;292368
24;2020-07-04;0;0;0;161829;158758;49;320587
24;2020-07-04;0;0;0;172552;168011;59;340563
24;2020-07-04;0;0;0;172509;158177;69;330686
24;2020-07-04;0;0;0;129428;110593;79;240021
24;2020-07-04;0;0;0;87342;56882;89;144224
24;2020-07-04;0;1;1;31210;12071;90;43281
24;2020-07-04;0;2;2;1320165;1238908;0;2559073
27;2020-07-04;0;0;0;143373;149679;09;293052
27;2020-07-04;0;0;0;160962;173003;19;333965
27;2020-07-04;1;0;1;133746;142254;29;276000
27;2020-07-04;0;2;2;160004;155407;39;315411
27;2020-07-04;1;2;3;172333;169564;49;341897
27;2020-07-04;0;2;2;189979;183788;59;373767
27;2020-07-04;0;0;0;192591;178206;69;370797
27;2020-07-04;1;0;1;146876;127546;79;274422
27;2020-07-04;0;0;0;96896;61575;89;158471
27;2020-07-04;0;0;0;33148;12109;90;45257
27;2020-07-04;3;6;9;1429908;1353131;0;2783039
28;2020-07-04;1;1;2;180735;186856;09;367591
28;2020-07-04;0;2;2;200125;213621;19;413746
28;2020-07-04;1;1;2;168922;173007;29;341929
28;2020-07-04;0;0;0;196628;188487;39;385115
28;2020-07-04;1;1;2;205396;201699;49;407095
28;2020-07-04;0;3;3;222002;213866;59;435868
28;2020-07-04;0;0;0;224688;203758;69;428446
28;2020-07-04;1;0;1;163192;135543;79;298735
28;2020-07-04;0;1;1;109691;65377;89;175068
28;2020-07-04;0;0;0;37222;12685;90;49907
28;2020-07-04;4;9;13;1708601;1594899;0;3303500
32;2020-07-04;1;0;1;358062;373689;09;731751
32;2020-07-04;2;1;3;387045;406742;19;793787
32;2020-07-04;2;0;2;342304;348587;29;690891
32;2020-07-04;4;2;6;382485;369972;39;752457
32;2020-07-04;0;2;2;382510;376716;49;759226
32;2020-07-04;1;1;2;386937;376527;59;763464
32;2020-07-04;0;1;1;371211;330938;69;702149
32;2020-07-04;1;1;2;250542;201459;79;452001
32;2020-07-04;0;2;2;163399;89786;89;253185
32;2020-07-04;0;0;0;48384;15367;90;63751
32;2020-07-04;11;10;21;3072879;2889783;0;5962662
44;2020-07-04;0;0;0;291525;306839;09;598364
44;2020-07-04;0;0;0;320255;339504;19;659759
44;2020-07-04;3;3;6;302020;314428;29;616448
44;2020-07-04;1;1;2;342222;333292;39;675514
44;2020-07-04;0;1;1;349727;344491;49;694218
44;2020-07-04;1;0;1;381371;373239;59;754610
44;2020-07-04;1;1;2;367165;335850;69;703015
44;2020-07-04;3;3;6;250387;215436;79;465823
44;2020-07-04;0;0;0;170825;105192;89;276017
44;2020-07-04;1;0;1;51248;16731;90;67979
44;2020-07-04;10;9;19;2826745;2685002;0;5511747
52;2020-07-04;1;0;1;213594;223900;09;437494
52;2020-07-04;0;0;0;240818;255197;19;496015
52;2020-07-04;2;1;3;197010;200630;29;397640
52;2020-07-04;1;3;4;231204;224885;39;456089
52;2020-07-04;1;1;2;243874;243418;49;487292
52;2020-07-04;1;3;4;244100;239116;59;483216
52;2020-07-04;1;1;2;241796;221345;69;463141
52;2020-07-04;0;0;0;177805;149903;79;327708
52;2020-07-04;1;1;2;119561;75822;89;195383
52;2020-07-04;1;1;2;42559;15260;90;57819
52;2020-07-04;9;11;20;1952321;1849476;0;3801797
53;2020-07-04;0;0;0;173813;182358;09;356171
53;2020-07-04;0;0;0;202720;214740;19;417460
53;2020-07-04;0;0;0;163116;173196;29;336312
53;2020-07-04;1;0;1;190526;187674;39;378200
53;2020-07-04;0;0;0;212098;212015;49;424113
53;2020-07-04;0;1;1;223699;219176;59;442875
53;2020-07-04;0;0;0;227435;209274;69;436709
53;2020-07-04;0;0;0;169992;140910;79;310902
53;2020-07-04;0;0;0;118117;69883;89;188000
53;2020-07-04;0;0;0;37370;12267;90;49637
53;2020-07-04;1;1;2;1718886;1621493;0;3340379
75;2020-07-04;0;0;0;293104;305291;09;598395
75;2020-07-04;2;0;2;337141;357785;19;694926
75;2020-07-04;0;0;0;295024;300618;29;595642
75;2020-07-04;1;1;2;347871;331233;39;679104
75;2020-07-04;0;0;0;384742;372771;49;757513
75;2020-07-04;0;0;0;413361;390880;59;804241
75;2020-07-04;0;1;1;425623;384060;69;809683
75;2020-07-04;0;2;2;325086;276298;79;601384
75;2020-07-04;0;0;0;213986;139308;89;353294
75;2020-07-04;0;0;0;77600;28200;90;105800
75;2020-07-04;3;4;7;3113538;2886444;0;5999982
76;2020-07-04;0;1;1;305956;318589;09;624545
76;2020-07-04;0;0;0;338942;356969;19;695911
76;2020-07-04;0;0;0;316210;319570;29;635780
76;2020-07-04;2;1;3;356758;337587;39;694345
76;2020-07-04;0;0;0;376541;363812;49;740353
76;2020-07-04;0;0;0;402608;383750;59;786358
76;2020-07-04;0;0;0;394889;358997;69;753886
76;2020-07-04;0;1;1;308664;263806;79;572470
76;2020-07-04;0;0;0;195838;129272;89;325110
76;2020-07-04;0;0;0;69372;26728;90;96100
76;2020-07-04;2;3;5;3065778;2859080;0;5924858
84;2020-07-04;2;1;3;459549;481088;09;940637
84;2020-07-04;0;1;2;487711;511905;19;999616
84;2020-07-04;0;0;0;443824;451094;29;894918
84;2020-07-04;0;1;1;512522;493262;39;1005784
84;2020-07-04;2;1;3;520248;515106;49;1035354
84;2020-07-04;2;0;2;529611;514848;59;1044459
84;2020-07-04;0;0;0;486720;439940;69;926660
84;2020-07-04;0;1;1;372151;315211;79;687362
84;2020-07-04;0;1;1;237198;150524;89;387722
84;2020-07-04;0;0;0;81185;28680;90;109865
84;2020-07-04;6;6;13;4130719;3901658;0;8032377
93;2020-07-04;1;0;1;268834;283093;09;551927
93;2020-07-04;0;1;1;280751;296087;19;576838
93;2020-07-04;6;1;7;254404;255552;29;509956
93;2020-07-04;0;0;0;310704;288398;39;599102
93;2020-07-04;0;1;1;325559;305827;49;631386
93;2020-07-04;0;0;0;353104;325389;59;678493
93;2020-07-04;0;0;0;336327;296459;69;632786
93;2020-07-04;0;1;1;279820;229699;79;509519
93;2020-07-04;0;1;1;171274;113716;89;284990
93;2020-07-04;0;0;0;58896;21758;90;80654
93;2020-07-04;7;5;12;2639673;2415978;0;5055651
94;2020-07-04;0;0;0;16311;17433;09;33744
94;2020-07-04;0;0;0;16679;18132;19;34811
94;2020-07-04;0;0;0;16782;16579;29;33361
94;2020-07-04;0;0;0;23044;20580;39;43624
94;2020-07-04;0;0;0;23065;22140;49;45205
94;2020-07-04;0;0;0;24549;23421;59;47970
94;2020-07-04;0;0;0;23212;21883;69;45095
94;2020-07-04;0;0;0;19544;17141;79;36685
94;2020-07-04;0;0;0;11227;8178;89;19405
94;2020-07-04;0;0;0;3332;1447;90;4779
94;2020-07-04;0;0;0;177745;166934;0;344679
01;2020-07-05;0;0;0;19979;20155;09;40134
01;2020-07-05;0;0;0;24994;25489;19;50483
01;2020-07-05;0;0;0;17868;16690;29;34558
01;2020-07-05;0;0;0;22328;14821;39;37149
01;2020-07-05;0;0;0;28652;20276;49;48928
01;2020-07-05;0;0;0;33264;27260;59;60524
01;2020-07-05;0;0;0;27135;23978;69;51113
01;2020-07-05;0;0;0;18401;14661;79;33062
01;2020-07-05;0;0;0;9633;6375;89;16008
01;2020-07-05;0;0;0;3410;1510;90;4920
01;2020-07-05;0;0;0;205664;171215;0;376879
02;2020-07-05;0;0;0;16881;17110;09;33991
02;2020-07-05;0;0;0;21410;21604;19;43014
02;2020-07-05;0;0;0;16017;15479;29;31496
02;2020-07-05;0;0;0;19825;14455;39;34280
02;2020-07-05;0;0;0;24719;18248;49;42967
02;2020-07-05;0;0;0;34361;28310;59;62671
02;2020-07-05;0;0;0;28061;24495;69;52556
02;2020-07-05;0;0;0;18231;15278;79;33509
02;2020-07-05;0;0;0;11090;7677;89;18767
02;2020-07-05;0;0;0;3992;1506;90;5498
02;2020-07-05;0;0;0;194587;164162;0;358749
03;2020-07-05;1;0;1;31123;30920;09;62043
03;2020-07-05;1;1;3;29370;29268;19;58638
03;2020-07-05;7;5;12;21458;18963;29;40421
03;2020-07-05;8;3;11;21276;18326;39;39602
03;2020-07-05;7;5;12;18164;16593;49;34757
03;2020-07-05;4;3;7;13469;13557;59;27026
03;2020-07-05;1;3;4;8776;8670;69;17446
03;2020-07-05;0;0;0;3777;3591;79;7368
03;2020-07-05;0;1;1;1649;1072;89;2721
03;2020-07-05;0;0;0;485;184;90;669
03;2020-07-05;29;21;51;149547;141144;0;290691
04;2020-07-05;0;0;0;60314;61377;09;121691
04;2020-07-05;0;0;0;66065;68387;19;134452
04;2020-07-05;0;0;0;51059;47156;29;98215
04;2020-07-05;1;0;1;58788;45780;39;104568
04;2020-07-05;0;1;1;61408;52207;49;113615
04;2020-07-05;0;0;0;64838;60759;59;125597
04;2020-07-05;0;0;0;47008;42843;69;89851
04;2020-07-05;0;0;0;25509;21184;79;46693
04;2020-07-05;0;0;0;13168;7647;89;20815
04;2020-07-05;0;0;0;3209;1253;90;4462
04;2020-07-05;1;1;2;451366;408593;0;859959
05;2020-07-05;0;0;0;362.366008612902;341.338819562748;09;703.704828175651
05;2020-07-05;0;0;0;353.376145114279;370.349735405642;19;723.725880519921
05;2020-07-05;0;0;0;218.593559489256;256.539602589476;29;475.133162078732
05;2020-07-05;0;0;0;404.225408693299;360.321910454353;39;764.547319147651
05;2020-07-05;0;0;0;520.067953604221;497.108383964256;49;1017.17633756848
05;2020-07-05;0;0;0;468.146063921917;510.087601910415;59;978.233665832332
05;2020-07-05;0;0;0;340.368470050554;334.366842191253;69;674.735312241807
05;2020-07-05;0;0;0;212.598666888387;192.597753227106;79;405.196420115493
05;2020-07-05;0;0;0;148.727797095705;61.8681715431829;89;210.595968638888
05;2020-07-05;0;0;0;32.9601271090696;10.9909785719784;90;43.9511056810479
05;2020-07-05;0;0;0;3061.43020057959;2935.56979942041;0;5997
06;2020-07-05;0;0;0;42583;42380;09;84963
06;2020-07-05;0;0;0;33369;31925;19;65294
06;2020-07-05;0;0;0;21571;15080;29;36651
06;2020-07-05;0;0;0;21550;16147;39;37697
06;2020-07-05;0;0;0;14193;13939;49;28132
06;2020-07-05;0;0;0;7171;7597;59;14768
06;2020-07-05;0;0;0;3629;4117;69;7746
06;2020-07-05;0;0;0;1577;1457;79;3034
06;2020-07-05;0;0;0;531;474;89;1005
06;2020-07-05;0;0;0;88;93;90;181
06;2020-07-05;0;0;0;146262;133209;0;279471
07;2020-07-05;0;0;0;485;549;09;1034
07;2020-07-05;0;0;0;403;432;19;835
07;2020-07-05;0;0;0;764;841;29;1605
07;2020-07-05;0;0;0;824;928;39;1752
07;2020-07-05;0;0;0;788;1020;49;1808
07;2020-07-05;0;0;0;678;870;59;1548
07;2020-07-05;0;0;0;360;382;69;742
07;2020-07-05;0;0;0;231;190;79;421
07;2020-07-05;0;0;0;114;67;89;181
07;2020-07-05;0;0;0;24;11;90;35
07;2020-07-05;0;0;0;4671;5290;0;9961
08;2020-07-05;0;0;0;2715.22592983026;2997.75551488675;09;5712.98144471701
08;2020-07-05;0;0;0;2778.51901080978;3160.9156459093;19;5939.43465671908
08;2020-07-05;0;0;0;2080.8882988764;1718.16634315323;29;3799.05464202964
08;2020-07-05;0;0;0;2701.8582062647;1896.52641413317;39;4598.38462039786
08;2020-07-05;0;0;0;3151.45861023308;2460.52498233809;49;5611.98359257117
08;2020-07-05;0;0;0;2620.29868333099;2422.23566154656;59;5042.53434487755
08;2020-07-05;0;0;0;1621.44173420671;1438.58325779464;69;3060.02499200135
08;2020-07-05;0;0;0;626.575909335673;526.358467843651;79;1152.93437717932
08;2020-07-05;0;0;0;205.018522985054;140.993639349697;89;346.012162334751
08;2020-07-05;0;0;0;50.0325684687745;20.62259870351;90;70.6551671722846
08;2020-07-05;0;0;0;18551.3174743414;16782.6825256586;0;35334
11;2020-07-05;1;0;2;783071;811785;09;1594856
11;2020-07-05;0;0;0;761456;784653;19;1546109
11;2020-07-05;0;2;2;850145;801772;29;1651917
11;2020-07-05;2;4;6;914360;843488;39;1757848
11;2020-07-05;0;1;1;845609;826202;49;1671811
11;2020-07-05;1;1;2;793566;745070;59;1538636
11;2020-07-05;0;3;3;628649;549192;69;1177841
11;2020-07-05;1;1;2;434606;358356;79;792962
11;2020-07-05;2;1;3;261425;162933;89;424358
11;2020-07-05;1;0;1;89253;32619;90;121872
11;2020-07-05;8;13;22;6362140;5916070;0;12278210
24;2020-07-05;1;0;1;139720;144686;09;284406
24;2020-07-05;0;0;0;152979;161185;19;314164
24;2020-07-05;0;0;0;122237;126536;29;248773
24;2020-07-05;1;0;1;150359;142009;39;292368
24;2020-07-05;0;0;0;161829;158758;49;320587
24;2020-07-05;0;0;0;172552;168011;59;340563
24;2020-07-05;0;0;0;172509;158177;69;330686
24;2020-07-05;0;0;0;129428;110593;79;240021
24;2020-07-05;0;0;0;87342;56882;89;144224
24;2020-07-05;0;0;0;31210;12071;90;43281
24;2020-07-05;2;0;2;1320165;1238908;0;2559073
27;2020-07-05;0;0;0;143373;149679;09;293052
27;2020-07-05;0;0;0;160962;173003;19;333965
27;2020-07-05;0;0;0;133746;142254;29;276000
27;2020-07-05;0;0;0;160004;155407;39;315411
27;2020-07-05;1;0;1;172333;169564;49;341897
27;2020-07-05;0;0;0;189979;183788;59;373767
27;2020-07-05;2;0;2;192591;178206;69;370797
27;2020-07-05;0;0;0;146876;127546;79;274422
27;2020-07-05;0;0;0;96896;61575;89;158471
27;2020-07-05;0;0;0;33148;12109;90;45257
27;2020-07-05;3;0;3;1429908;1353131;0;2783039
28;2020-07-05;0;0;0;180735;186856;09;367591
28;2020-07-05;0;1;1;200125;213621;19;413746
28;2020-07-05;0;0;0;168922;173007;29;341929
28;2020-07-05;0;1;1;196628;188487;39;385115
28;2020-07-05;1;0;1;205396;201699;49;407095
28;2020-07-05;1;0;1;222002;213866;59;435868
28;2020-07-05;1;0;1;224688;203758;69;428446
28;2020-07-05;0;0;0;163192;135543;79;298735
28;2020-07-05;0;0;0;109691;65377;89;175068
28;2020-07-05;0;0;0;37222;12685;90;49907
28;2020-07-05;3;2;5;1708601;1594899;0;3303500
32;2020-07-05;0;0;0;358062;373689;09;731751
32;2020-07-05;0;0;0;387045;406742;19;793787
32;2020-07-05;0;0;0;342304;348587;29;690891
32;2020-07-05;0;0;0;382485;369972;39;752457
32;2020-07-05;0;0;0;382510;376716;49;759226
32;2020-07-05;0;0;0;386937;376527;59;763464
32;2020-07-05;1;0;1;371211;330938;69;702149
32;2020-07-05;0;0;0;250542;201459;79;452001
32;2020-07-05;0;0;0;163399;89786;89;253185
32;2020-07-05;0;0;0;48384;15367;90;63751
32;2020-07-05;1;0;1;3072879;2889783;0;5962662
44;2020-07-05;0;0;0;291525;306839;09;598364
44;2020-07-05;0;0;0;320255;339504;19;659759
44;2020-07-05;0;0;0;302020;314428;29;616448
44;2020-07-05;0;0;0;342222;333292;39;675514
44;2020-07-05;0;0;0;349727;344491;49;694218
44;2020-07-05;0;0;0;381371;373239;59;754610
44;2020-07-05;0;0;0;367165;335850;69;703015
44;2020-07-05;1;1;2;250387;215436;79;465823
44;2020-07-05;1;0;1;170825;105192;89;276017
44;2020-07-05;0;0;0;51248;16731;90;67979
44;2020-07-05;2;1;3;2826745;2685002;0;5511747
52;2020-07-05;0;0;0;213594;223900;09;437494
52;2020-07-05;0;0;0;240818;255197;19;496015
52;2020-07-05;0;1;1;197010;200630;29;397640
52;2020-07-05;1;0;1;231204;224885;39;456089
52;2020-07-05;0;0;0;243874;243418;49;487292
52;2020-07-05;1;0;1;244100;239116;59;483216
52;2020-07-05;0;0;0;241796;221345;69;463141
52;2020-07-05;0;0;0;177805;149903;79;327708
52;2020-07-05;2;0;2;119561;75822;89;195383
52;2020-07-05;0;0;0;42559;15260;90;57819
52;2020-07-05;4;1;5;1952321;1849476;0;3801797
53;2020-07-05;0;0;0;173813;182358;09;356171
53;2020-07-05;0;0;0;202720;214740;19;417460
53;2020-07-05;0;0;0;163116;173196;29;336312
53;2020-07-05;0;0;0;190526;187674;39;378200
53;2020-07-05;0;0;0;212098;212015;49;424113
53;2020-07-05;0;0;0;223699;219176;59;442875
53;2020-07-05;0;0;0;227435;209274;69;436709
53;2020-07-05;0;0;0;169992;140910;79;310902
53;2020-07-05;0;0;0;118117;69883;89;188000
53;2020-07-05;0;0;0;37370;12267;90;49637
53;2020-07-05;0;0;0;1718886;1621493;0;3340379
75;2020-07-05;0;0;0;293104;305291;09;598395
75;2020-07-05;0;0;0;337141;357785;19;694926
75;2020-07-05;0;0;0;295024;300618;29;595642
75;2020-07-05;0;0;0;347871;331233;39;679104
75;2020-07-05;0;0;0;384742;372771;49;757513
75;2020-07-05;0;1;1;413361;390880;59;804241
75;2020-07-05;0;1;1;425623;384060;69;809683
75;2020-07-05;0;0;0;325086;276298;79;601384
75;2020-07-05;0;0;0;213986;139308;89;353294
75;2020-07-05;0;0;0;77600;28200;90;105800
75;2020-07-05;0;2;2;3113538;2886444;0;5999982
76;2020-07-05;0;0;0;305956;318589;09;624545
76;2020-07-05;0;0;0;338942;356969;19;695911
76;2020-07-05;1;0;1;316210;319570;29;635780
76;2020-07-05;0;0;0;356758;337587;39;694345
76;2020-07-05;1;0;1;376541;363812;49;740353
76;2020-07-05;0;0;0;402608;383750;59;786358
76;2020-07-05;0;1;1;394889;358997;69;753886
76;2020-07-05;0;0;0;308664;263806;79;572470
76;2020-07-05;0;0;0;195838;129272;89;325110
76;2020-07-05;0;0;0;69372;26728;90;96100
76;2020-07-05;2;1;3;3065778;2859080;0;5924858
84;2020-07-05;0;0;0;459549;481088;09;940637
84;2020-07-05;0;0;0;487711;511905;19;999616
84;2020-07-05;0;0;0;443824;451094;29;894918
84;2020-07-05;0;0;0;512522;493262;39;1005784
84;2020-07-05;0;0;0;520248;515106;49;1035354
84;2020-07-05;1;1;2;529611;514848;59;1044459
84;2020-07-05;1;0;1;486720;439940;69;926660
84;2020-07-05;0;0;0;372151;315211;79;687362
84;2020-07-05;0;0;0;237198;150524;89;387722
84;2020-07-05;0;0;0;81185;28680;90;109865
84;2020-07-05;2;1;3;4130719;3901658;0;8032377
93;2020-07-05;0;0;0;268834;283093;09;551927
93;2020-07-05;0;0;0;280751;296087;19;576838
93;2020-07-05;0;0;0;254404;255552;29;509956
93;2020-07-05;1;0;1;310704;288398;39;599102
93;2020-07-05;0;0;0;325559;305827;49;631386
93;2020-07-05;0;0;0;353104;325389;59;678493
93;2020-07-05;0;0;0;336327;296459;69;632786
93;2020-07-05;0;0;0;279820;229699;79;509519
93;2020-07-05;0;0;0;171274;113716;89;284990
93;2020-07-05;0;0;0;58896;21758;90;80654
93;2020-07-05;1;0;1;2639673;2415978;0;5055651
94;2020-07-05;0;0;0;16311;17433;09;33744
94;2020-07-05;0;0;0;16679;18132;19;34811
94;2020-07-05;0;0;0;16782;16579;29;33361
94;2020-07-05;0;0;0;23044;20580;39;43624
94;2020-07-05;0;0;0;23065;22140;49;45205
94;2020-07-05;0;0;0;24549;23421;59;47970
94;2020-07-05;0;0;0;23212;21883;69;45095
94;2020-07-05;0;0;0;19544;17141;79;36685
94;2020-07-05;0;0;0;11227;8178;89;19405
94;2020-07-05;0;0;0;3332;1447;90;4779
94;2020-07-05;0;0;0;177745;166934;0;344679
01;2020-07-06;0;0;0;19979;20155;09;40134
01;2020-07-06;0;0;0;24994;25489;19;50483
01;2020-07-06;0;0;0;17868;16690;29;34558
01;2020-07-06;0;0;0;22328;14821;39;37149
01;2020-07-06;1;0;1;28652;20276;49;48928
01;2020-07-06;0;0;0;33264;27260;59;60524
01;2020-07-06;0;0;0;27135;23978;69;51113
01;2020-07-06;0;0;0;18401;14661;79;33062
01;2020-07-06;0;0;0;9633;6375;89;16008
01;2020-07-06;0;0;0;3410;1510;90;4920
01;2020-07-06;1;0;1;205664;171215;0;376879
02;2020-07-06;0;1;1;16881;17110;09;33991
02;2020-07-06;0;0;0;21410;21604;19;43014
02;2020-07-06;0;0;0;16017;15479;29;31496
02;2020-07-06;0;0;0;19825;14455;39;34280
02;2020-07-06;0;1;1;24719;18248;49;42967
02;2020-07-06;0;0;0;34361;28310;59;62671
02;2020-07-06;0;0;0;28061;24495;69;52556
02;2020-07-06;1;0;1;18231;15278;79;33509
02;2020-07-06;0;0;0;11090;7677;89;18767
02;2020-07-06;0;0;0;3992;1506;90;5498
02;2020-07-06;1;2;3;194587;164162;0;358749
03;2020-07-06;7;8;16;31123;30920;09;62043
03;2020-07-06;11;16;28;29370;29268;19;58638
03;2020-07-06;17;11;30;21458;18963;29;40421
03;2020-07-06;21;21;43;21276;18326;39;39602
03;2020-07-06;19;16;36;18164;16593;49;34757
03;2020-07-06;9;9;19;13469;13557;59;27026
03;2020-07-06;4;10;14;8776;8670;69;17446
03;2020-07-06;1;8;9;3777;3591;79;7368
03;2020-07-06;1;0;1;1649;1072;89;2721
03;2020-07-06;0;1;1;485;184;90;669
03;2020-07-06;90;100;197;149547;141144;0;290691
04;2020-07-06;0;0;0;60314;61377;09;121691
04;2020-07-06;0;0;0;66065;68387;19;134452
04;2020-07-06;0;0;0;51059;47156;29;98215
04;2020-07-06;0;0;0;58788;45780;39;104568
04;2020-07-06;0;0;0;61408;52207;49;113615
04;2020-07-06;0;0;0;64838;60759;59;125597
04;2020-07-06;0;0;0;47008;42843;69;89851
04;2020-07-06;0;0;0;25509;21184;79;46693
04;2020-07-06;0;0;0;13168;7647;89;20815
04;2020-07-06;0;0;0;3209;1253;90;4462
04;2020-07-06;0;0;0;451366;408593;0;859959
05;2020-07-06;0;0;0;362.366008612902;341.338819562748;09;703.704828175651
05;2020-07-06;0;0;0;353.376145114279;370.349735405642;19;723.725880519921
05;2020-07-06;0;0;0;218.593559489256;256.539602589476;29;475.133162078732
05;2020-07-06;0;0;0;404.225408693299;360.321910454353;39;764.547319147651
05;2020-07-06;0;0;0;520.067953604221;497.108383964256;49;1017.17633756848
05;2020-07-06;0;0;0;468.146063921917;510.087601910415;59;978.233665832332
05;2020-07-06;0;0;0;340.368470050554;334.366842191253;69;674.735312241807
05;2020-07-06;0;0;0;212.598666888387;192.597753227106;79;405.196420115493
05;2020-07-06;0;0;0;148.727797095705;61.8681715431829;89;210.595968638888
05;2020-07-06;0;0;0;32.9601271090696;10.9909785719784;90;43.9511056810479
05;2020-07-06;0;0;0;3061.43020057959;2935.56979942041;0;5997
06;2020-07-06;1;0;1;42583;42380;09;84963
06;2020-07-06;0;0;0;33369;31925;19;65294
06;2020-07-06;0;0;0;21571;15080;29;36651
06;2020-07-06;0;1;1;21550;16147;39;37697
06;2020-07-06;1;1;2;14193;13939;49;28132
06;2020-07-06;1;1;2;7171;7597;59;14768
06;2020-07-06;1;0;1;3629;4117;69;7746
06;2020-07-06;0;1;1;1577;1457;79;3034
06;2020-07-06;0;0;0;531;474;89;1005
06;2020-07-06;0;0;0;88;93;90;181
06;2020-07-06;4;4;8;146262;133209;0;279471
07;2020-07-06;0;0;0;485;549;09;1034
07;2020-07-06;0;0;0;403;432;19;835
07;2020-07-06;0;0;0;764;841;29;1605
07;2020-07-06;0;0;0;824;928;39;1752
07;2020-07-06;0;0;0;788;1020;49;1808
07;2020-07-06;0;0;0;678;870;59;1548
07;2020-07-06;0;0;0;360;382;69;742
07;2020-07-06;0;0;0;231;190;79;421
07;2020-07-06;0;0;0;114;67;89;181
07;2020-07-06;0;0;0;24;11;90;35
07;2020-07-06;0;0;0;4671;5290;0;9961
08;2020-07-06;0;0;0;2715.22592983026;2997.75551488675;09;5712.98144471701
08;2020-07-06;0;0;0;2778.51901080978;3160.9156459093;19;5939.43465671908
08;2020-07-06;0;0;0;2080.8882988764;1718.16634315323;29;3799.05464202964
08;2020-07-06;0;0;0;2701.8582062647;1896.52641413317;39;4598.38462039786
08;2020-07-06;0;0;0;3151.45861023308;2460.52498233809;49;5611.98359257117
08;2020-07-06;0;0;0;2620.29868333099;2422.23566154656;59;5042.53434487755
08;2020-07-06;0;0;0;1621.44173420671;1438.58325779464;69;3060.02499200135
08;2020-07-06;0;0;0;626.575909335673;526.358467843651;79;1152.93437717932
08;2020-07-06;0;0;0;205.018522985054;140.993639349697;89;346.012162334751
08;2020-07-06;0;0;0;50.0325684687745;20.62259870351;90;70.6551671722846
08;2020-07-06;0;0;0;18551.3174743414;16782.6825256586;0;35334
11;2020-07-06;6;3;10;783071;811785;09;1594856
11;2020-07-06;11;8;19;761456;784653;19;1546109
11;2020-07-06;17;10;27;850145;801772;29;1651917
11;2020-07-06;24;12;36;914360;843488;39;1757848
11;2020-07-06;14;21;35;845609;826202;49;1671811
11;2020-07-06;11;13;24;793566;745070;59;1538636
11;2020-07-06;4;9;13;628649;549192;69;1177841
11;2020-07-06;4;5;9;434606;358356;79;792962
11;2020-07-06;6;3;9;261425;162933;89;424358
11;2020-07-06;4;0;4;89253;32619;90;121872
11;2020-07-06;101;84;186;6362140;5916070;0;12278210
24;2020-07-06;2;1;3;139720;144686;09;284406
24;2020-07-06;1;3;4;152979;161185;19;314164
24;2020-07-06;3;1;4;122237;126536;29;248773
24;2020-07-06;0;3;3;150359;142009;39;292368
24;2020-07-06;3;1;4;161829;158758;49;320587
24;2020-07-06;4;1;5;172552;168011;59;340563
24;2020-07-06;1;2;3;172509;158177;69;330686
24;2020-07-06;1;2;3;129428;110593;79;240021
24;2020-07-06;1;0;1;87342;56882;89;144224
24;2020-07-06;0;0;0;31210;12071;90;43281
24;2020-07-06;16;14;30;1320165;1238908;0;2559073
27;2020-07-06;0;0;0;143373;149679;09;293052
27;2020-07-06;0;1;1;160962;173003;19;333965
27;2020-07-06;1;0;1;133746;142254;29;276000
27;2020-07-06;0;0;0;160004;155407;39;315411
27;2020-07-06;1;0;1;172333;169564;49;341897
27;2020-07-06;1;1;2;189979;183788;59;373767
27;2020-07-06;0;0;0;192591;178206;69;370797
27;2020-07-06;2;0;2;146876;127546;79;274422
27;2020-07-06;0;0;0;96896;61575;89;158471
27;2020-07-06;2;0;2;33148;12109;90;45257
27;2020-07-06;7;2;9;1429908;1353131;0;2783039
28;2020-07-06;1;0;2;180735;186856;09;367591
28;2020-07-06;2;0;2;200125;213621;19;413746
28;2020-07-06;3;1;4;168922;173007;29;341929
28;2020-07-06;0;0;0;196628;188487;39;385115
28;2020-07-06;1;1;2;205396;201699;49;407095
28;2020-07-06;0;1;1;222002;213866;59;435868
28;2020-07-06;1;1;2;224688;203758;69;428446
28;2020-07-06;2;0;2;163192;135543;79;298735
28;2020-07-06;0;0;0;109691;65377;89;175068
28;2020-07-06;0;0;0;37222;12685;90;49907
28;2020-07-06;10;4;15;1708601;1594899;0;3303500
32;2020-07-06;4;2;6;358062;373689;09;731751
32;2020-07-06;3;9;12;387045;406742;19;793787
32;2020-07-06;2;7;10;342304;348587;29;690891
32;2020-07-06;2;6;8;382485;369972;39;752457
32;2020-07-06;3;1;4;382510;376716;49;759226
32;2020-07-06;5;8;13;386937;376527;59;763464
32;2020-07-06;3;6;9;371211;330938;69;702149
32;2020-07-06;2;6;8;250542;201459;79;452001
32;2020-07-06;3;0;3;163399;89786;89;253185
32;2020-07-06;2;1;3;48384;15367;90;63751
32;2020-07-06;29;46;76;3072879;2889783;0;5962662
44;2020-07-06;0;0;0;291525;306839;09;598364
44;2020-07-06;0;0;0;320255;339504;19;659759
44;2020-07-06;1;4;5;302020;314428;29;616448
44;2020-07-06;1;2;3;342222;333292;39;675514
44;2020-07-06;1;2;3;349727;344491;49;694218
44;2020-07-06;0;0;0;381371;373239;59;754610
44;2020-07-06;4;5;9;367165;335850;69;703015
44;2020-07-06;1;2;3;250387;215436;79;465823
44;2020-07-06;0;2;2;170825;105192;89;276017
44;2020-07-06;0;1;1;51248;16731;90;67979
44;2020-07-06;8;18;26;2826745;2685002;0;5511747
52;2020-07-06;2;0;2;213594;223900;09;437494
52;2020-07-06;2;2;4;240818;255197;19;496015
52;2020-07-06;3;1;4;197010;200630;29;397640
52;2020-07-06;3;0;3;231204;224885;39;456089
52;2020-07-06;1;3;4;243874;243418;49;487292
52;2020-07-06;2;2;4;244100;239116;59;483216
52;2020-07-06;0;1;1;241796;221345;69;463141
52;2020-07-06;2;1;3;177805;149903;79;327708
52;2020-07-06;0;0;0;119561;75822;89;195383
52;2020-07-06;0;0;0;42559;15260;90;57819
52;2020-07-06;15;10;25;1952321;1849476;0;3801797
53;2020-07-06;0;0;0;173813;182358;09;356171
53;2020-07-06;0;1;1;202720;214740;19;417460
53;2020-07-06;1;0;1;163116;173196;29;336312
53;2020-07-06;2;0;2;190526;187674;39;378200
53;2020-07-06;0;0;0;212098;212015;49;424113
53;2020-07-06;0;1;1;223699;219176;59;442875
53;2020-07-06;0;0;0;227435;209274;69;436709
53;2020-07-06;0;0;0;169992;140910;79;310902
53;2020-07-06;0;0;0;118117;69883;89;188000
53;2020-07-06;0;0;0;37370;12267;90;49637
53;2020-07-06;3;2;5;1718886;1621493;0;3340379
75;2020-07-06;2;2;4;293104;305291;09;598395
75;2020-07-06;2;0;2;337141;357785;19;694926
75;2020-07-06;1;1;2;295024;300618;29;595642
75;2020-07-06;0;0;0;347871;331233;39;679104
75;2020-07-06;0;0;0;384742;372771;49;757513
75;2020-07-06;0;2;2;413361;390880;59;804241
75;2020-07-06;1;1;2;425623;384060;69;809683
75;2020-07-06;0;0;0;325086;276298;79;601384
75;2020-07-06;1;0;1;213986;139308;89;353294
75;2020-07-06;0;1;1;77600;28200;90;105800
75;2020-07-06;7;7;14;3113538;2886444;0;5999982
76;2020-07-06;0;0;0;305956;318589;09;624545
76;2020-07-06;2;2;4;338942;356969;19;695911
76;2020-07-06;1;1;2;316210;319570;29;635780
76;2020-07-06;3;2;5;356758;337587;39;694345
76;2020-07-06;0;1;1;376541;363812;49;740353
76;2020-07-06;0;0;0;402608;383750;59;786358
76;2020-07-06;0;0;0;394889;358997;69;753886
76;2020-07-06;0;0;0;308664;263806;79;572470
76;2020-07-06;0;0;0;195838;129272;89;325110
76;2020-07-06;1;0;1;69372;26728;90;96100
76;2020-07-06;7;6;13;3065778;2859080;0;5924858
84;2020-07-06;1;2;3;459549;481088;09;940637
84;2020-07-06;2;4;6;487711;511905;19;999616
84;2020-07-06;2;3;5;443824;451094;29;894918
84;2020-07-06;2;3;5;512522;493262;39;1005784
84;2020-07-06;0;0;0;520248;515106;49;1035354
84;2020-07-06;1;3;4;529611;514848;59;1044459
84;2020-07-06;2;1;3;486720;439940;69;926660
84;2020-07-06;1;1;2;372151;315211;79;687362
84;2020-07-06;1;3;4;237198;150524;89;387722
84;2020-07-06;0;0;0;81185;28680;90;109865
84;2020-07-06;12;20;32;4130719;3901658;0;8032377
93;2020-07-06;0;0;1;268834;283093;09;551927
93;2020-07-06;4;0;4;280751;296087;19;576838
93;2020-07-06;3;3;6;254404;255552;29;509956
93;2020-07-06;3;1;4;310704;288398;39;599102
93;2020-07-06;3;3;6;325559;305827;49;631386
93;2020-07-06;2;5;7;353104;325389;59;678493
93;2020-07-06;2;3;5;336327;296459;69;632786
93;2020-07-06;1;0;1;279820;229699;79;509519
93;2020-07-06;1;0;1;171274;113716;89;284990
93;2020-07-06;0;0;0;58896;21758;90;80654
93;2020-07-06;19;15;35;2639673;2415978;0;5055651
94;2020-07-06;0;0;0;16311;17433;09;33744
94;2020-07-06;0;0;0;16679;18132;19;34811
94;2020-07-06;0;1;1;16782;16579;29;33361
94;2020-07-06;0;0;0;23044;20580;39;43624
94;2020-07-06;0;0;0;23065;22140;49;45205
94;2020-07-06;0;0;0;24549;23421;59;47970
94;2020-07-06;0;0;0;23212;21883;69;45095
94;2020-07-06;0;0;0;19544;17141;79;36685
94;2020-07-06;0;0;0;11227;8178;89;19405
94;2020-07-06;0;0;0;3332;1447;90;4779
94;2020-07-06;0;1;1;177745;166934;0;344679
01;2020-07-07;0;0;0;19979;20155;09;40134
01;2020-07-07;0;0;0;24994;25489;19;50483
01;2020-07-07;0;0;0;17868;16690;29;34558
01;2020-07-07;1;0;1;22328;14821;39;37149
01;2020-07-07;0;0;0;28652;20276;49;48928
01;2020-07-07;0;0;0;33264;27260;59;60524
01;2020-07-07;0;0;0;27135;23978;69;51113
01;2020-07-07;0;0;0;18401;14661;79;33062
01;2020-07-07;0;0;0;9633;6375;89;16008
01;2020-07-07;0;0;0;3410;1510;90;4920
01;2020-07-07;1;0;1;205664;171215;0;376879
02;2020-07-07;0;0;0;16881;17110;09;33991
02;2020-07-07;0;0;0;21410;21604;19;43014
02;2020-07-07;0;0;0;16017;15479;29;31496
02;2020-07-07;0;0;0;19825;14455;39;34280
02;2020-07-07;0;0;0;24719;18248;49;42967
02;2020-07-07;0;0;0;34361;28310;59;62671
02;2020-07-07;0;0;0;28061;24495;69;52556
02;2020-07-07;0;0;0;18231;15278;79;33509
02;2020-07-07;0;0;0;11090;7677;89;18767
02;2020-07-07;0;0;0;3992;1506;90;5498
02;2020-07-07;0;0;0;194587;164162;0;358749
03;2020-07-07;6;3;9;31123;30920;09;62043
03;2020-07-07;8;9;17;29370;29268;19;58638
03;2020-07-07;24;20;44;21458;18963;29;40421
03;2020-07-07;23;14;37;21276;18326;39;39602
03;2020-07-07;14;6;20;18164;16593;49;34757
03;2020-07-07;10;9;19;13469;13557;59;27026
03;2020-07-07;8;8;16;8776;8670;69;17446
03;2020-07-07;5;3;8;3777;3591;79;7368
03;2020-07-07;0;1;1;1649;1072;89;2721
03;2020-07-07;0;0;0;485;184;90;669
03;2020-07-07;98;73;171;149547;141144;0;290691
04;2020-07-07;0;0;0;60314;61377;09;121691
04;2020-07-07;1;0;1;66065;68387;19;134452
04;2020-07-07;0;0;0;51059;47156;29;98215
04;2020-07-07;0;0;0;58788;45780;39;104568
04;2020-07-07;0;0;0;61408;52207;49;113615
04;2020-07-07;1;0;1;64838;60759;59;125597
04;2020-07-07;1;0;1;47008;42843;69;89851
04;2020-07-07;0;0;0;25509;21184;79;46693
04;2020-07-07;0;0;0;13168;7647;89;20815
04;2020-07-07;0;0;0;3209;1253;90;4462
04;2020-07-07;3;0;3;451366;408593;0;859959
05;2020-07-07;0;0;0;362.366008612902;341.338819562748;09;703.704828175651
05;2020-07-07;0;0;0;353.376145114279;370.349735405642;19;723.725880519921
05;2020-07-07;0;0;0;218.593559489256;256.539602589476;29;475.133162078732
05;2020-07-07;0;0;0;404.225408693299;360.321910454353;39;764.547319147651
05;2020-07-07;0;0;0;520.067953604221;497.108383964256;49;1017.17633756848
05;2020-07-07;0;0;0;468.146063921917;510.087601910415;59;978.233665832332
05;2020-07-07;0;0;0;340.368470050554;334.366842191253;69;674.735312241807
05;2020-07-07;0;0;0;212.598666888387;192.597753227106;79;405.196420115493
05;2020-07-07;0;0;0;148.727797095705;61.8681715431829;89;210.595968638888
05;2020-07-07;0;0;0;32.9601271090696;10.9909785719784;90;43.9511056810479
05;2020-07-07;0;0;0;3061.43020057959;2935.56979942041;0;5997
06;2020-07-07;0;0;0;42583;42380;09;84963
06;2020-07-07;0;0;0;33369;31925;19;65294
06;2020-07-07;1;0;1;21571;15080;29;36651
06;2020-07-07;1;2;3;21550;16147;39;37697
06;2020-07-07;0;0;0;14193;13939;49;28132
06;2020-07-07;0;1;1;7171;7597;59;14768
06;2020-07-07;0;0;0;3629;4117;69;7746
06;2020-07-07;0;0;0;1577;1457;79;3034
06;2020-07-07;0;0;0;531;474;89;1005
06;2020-07-07;0;0;0;88;93;90;181
06;2020-07-07;2;3;5;146262;133209;0;279471
07;2020-07-07;0;0;0;485;549;09;1034
07;2020-07-07;0;0;0;403;432;19;835
07;2020-07-07;0;0;0;764;841;29;1605
07;2020-07-07;0;0;0;824;928;39;1752
07;2020-07-07;0;0;0;788;1020;49;1808
07;2020-07-07;0;0;0;678;870;59;1548
07;2020-07-07;0;0;0;360;382;69;742
07;2020-07-07;0;0;0;231;190;79;421
07;2020-07-07;0;0;0;114;67;89;181
07;2020-07-07;0;0;0;24;11;90;35
07;2020-07-07;0;0;0;4671;5290;0;9961
08;2020-07-07;0;0;0;2715.22592983026;2997.75551488675;09;5712.98144471701
08;2020-07-07;0;0;0;2778.51901080978;3160.9156459093;19;5939.43465671908
08;2020-07-07;0;0;0;2080.8882988764;1718.16634315323;29;3799.05464202964
08;2020-07-07;0;0;0;2701.8582062647;1896.52641413317;39;4598.38462039786
08;2020-07-07;0;0;0;3151.45861023308;2460.52498233809;49;5611.98359257117
08;2020-07-07;0;0;0;2620.29868333099;2422.23566154656;59;5042.53434487755
08;2020-07-07;0;0;0;1621.44173420671;1438.58325779464;69;3060.02499200135
08;2020-07-07;0;0;0;626.575909335673;526.358467843651;79;1152.93437717932
08;2020-07-07;0;0;0;205.018522985054;140.993639349697;89;346.012162334751
08;2020-07-07;0;0;0;50.0325684687745;20.62259870351;90;70.6551671722846
08;2020-07-07;0;0;0;18551.3174743414;16782.6825256586;0;35334
11;2020-07-07;4;1;5;783071;811785;09;1594856
11;2020-07-07;11;5;16;761456;784653;19;1546109
11;2020-07-07;22;6;28;850145;801772;29;1651917
11;2020-07-07;15;8;23;914360;843488;39;1757848
11;2020-07-07;7;12;19;845609;826202;49;1671811
11;2020-07-07;10;8;18;793566;745070;59;1538636
11;2020-07-07;12;8;20;628649;549192;69;1177841
11;2020-07-07;5;2;7;434606;358356;79;792962
11;2020-07-07;1;2;3;261425;162933;89;424358
11;2020-07-07;2;1;3;89253;32619;90;121872
11;2020-07-07;89;53;143;6362140;5916070;0;12278210
24;2020-07-07;0;0;0;139720;144686;09;284406
24;2020-07-07;0;0;0;152979;161185;19;314164
24;2020-07-07;0;0;0;122237;126536;29;248773
24;2020-07-07;3;1;4;150359;142009;39;292368
24;2020-07-07;1;0;1;161829;158758;49;320587
24;2020-07-07;0;1;1;172552;168011;59;340563
24;2020-07-07;0;0;0;172509;158177;69;330686
24;2020-07-07;1;0;1;129428;110593;79;240021
24;2020-07-07;0;0;0;87342;56882;89;144224
24;2020-07-07;0;0;0;31210;12071;90;43281
24;2020-07-07;5;2;8;1320165;1238908;0;2559073
27;2020-07-07;0;0;0;143373;149679;09;293052
27;2020-07-07;0;0;0;160962;173003;19;333965
27;2020-07-07;1;0;1;133746;142254;29;276000
27;2020-07-07;0;1;1;160004;155407;39;315411
27;2020-07-07;3;1;4;172333;169564;49;341897
27;2020-07-07;1;1;2;189979;183788;59;373767
27;2020-07-07;2;0;2;192591;178206;69;370797
27;2020-07-07;1;1;2;146876;127546;79;274422
27;2020-07-07;1;0;1;96896;61575;89;158471
27;2020-07-07;1;0;1;33148;12109;90;45257
27;2020-07-07;10;4;14;1429908;1353131;0;2783039
28;2020-07-07;4;0;4;180735;186856;09;367591
28;2020-07-07;2;1;3;200125;213621;19;413746
28;2020-07-07;2;3;5;168922;173007;29;341929
28;2020-07-07;4;2;6;196628;188487;39;385115
28;2020-07-07;2;2;4;205396;201699;49;407095
28;2020-07-07;0;3;3;222002;213866;59;435868
28;2020-07-07;0;2;2;224688;203758;69;428446
28;2020-07-07;1;1;2;163192;135543;79;298735
28;2020-07-07;1;0;1;109691;65377;89;175068
28;2020-07-07;0;0;0;37222;12685;90;49907
28;2020-07-07;16;14;30;1708601;1594899;0;3303500
32;2020-07-07;2;0;2;358062;373689;09;731751
32;2020-07-07;2;5;7;387045;406742;19;793787
32;2020-07-07;4;2;6;342304;348587;29;690891
32;2020-07-07;4;4;8;382485;369972;39;752457
32;2020-07-07;3;3;6;382510;376716;49;759226
32;2020-07-07;4;1;5;386937;376527;59;763464
32;2020-07-07;2;3;5;371211;330938;69;702149
32;2020-07-07;3;2;5;250542;201459;79;452001
32;2020-07-07;3;0;3;163399;89786;89;253185
32;2020-07-07;2;0;2;48384;15367;90;63751
32;2020-07-07;29;20;49;3072879;2889783;0;5962662
44;2020-07-07;0;0;0;291525;306839;09;598364
44;2020-07-07;0;0;0;320255;339504;19;659759
44;2020-07-07;7;3;10;302020;314428;29;616448
44;2020-07-07;1;1;2;342222;333292;39;675514
44;2020-07-07;2;1;3;349727;344491;49;694218
44;2020-07-07;0;1;1;381371;373239;59;754610
44;2020-07-07;0;1;1;367165;335850;69;703015
44;2020-07-07;1;1;2;250387;215436;79;465823
44;2020-07-07;1;1;2;170825;105192;89;276017
44;2020-07-07;0;0;0;51248;16731;90;67979
44;2020-07-07;12;9;22;2826745;2685002;0;5511747
52;2020-07-07;0;0;0;213594;223900;09;437494
52;2020-07-07;1;3;4;240818;255197;19;496015
52;2020-07-07;0;7;7;197010;200630;29;397640
52;2020-07-07;1;1;2;231204;224885;39;456089
52;2020-07-07;1;1;2;243874;243418;49;487292
52;2020-07-07;4;3;7;244100;239116;59;483216
52;2020-07-07;0;2;2;241796;221345;69;463141
52;2020-07-07;0;0;0;177805;149903;79;327708
52;2020-07-07;1;0;1;119561;75822;89;195383
52;2020-07-07;0;0;0;42559;15260;90;57819
52;2020-07-07;8;17;25;1952321;1849476;0;3801797
53;2020-07-07;0;0;0;173813;182358;09;356171
53;2020-07-07;0;0;0;202720;214740;19;417460
53;2020-07-07;1;0;1;163116;173196;29;336312
53;2020-07-07;0;0;0;190526;187674;39;378200
53;2020-07-07;0;0;0;212098;212015;49;424113
53;2020-07-07;0;1;1;223699;219176;59;442875
53;2020-07-07;0;0;0;227435;209274;69;436709
53;2020-07-07;1;1;2;169992;140910;79;310902
53;2020-07-07;0;0;0;118117;69883;89;188000
53;2020-07-07;0;0;0;37370;12267;90;49637
53;2020-07-07;2;2;4;1718886;1621493;0;3340379
75;2020-07-07;2;0;2;293104;305291;09;598395
75;2020-07-07;0;0;0;337141;357785;19;694926
75;2020-07-07;1;0;1;295024;300618;29;595642
75;2020-07-07;1;0;1;347871;331233;39;679104
75;2020-07-07;3;0;3;384742;372771;49;757513
75;2020-07-07;0;1;1;413361;390880;59;804241
75;2020-07-07;2;1;3;425623;384060;69;809683
75;2020-07-07;0;1;1;325086;276298;79;601384
75;2020-07-07;1;0;1;213986;139308;89;353294
75;2020-07-07;0;0;0;77600;28200;90;105800
75;2020-07-07;10;3;14;3113538;2886444;0;5999982
76;2020-07-07;0;0;0;305956;318589;09;624545
76;2020-07-07;2;1;3;338942;356969;19;695911
76;2020-07-07;0;3;3;316210;319570;29;635780
76;2020-07-07;4;1;5;356758;337587;39;694345
76;2020-07-07;1;2;3;376541;363812;49;740353
76;2020-07-07;0;1;1;402608;383750;59;786358
76;2020-07-07;0;0;0;394889;358997;69;753886
76;2020-07-07;1;0;1;308664;263806;79;572470
76;2020-07-07;0;0;0;195838;129272;89;325110
76;2020-07-07;0;0;0;69372;26728;90;96100
76;2020-07-07;8;8;16;3065778;2859080;0;5924858
84;2020-07-07;0;1;1;459549;481088;09;940637
84;2020-07-07;2;1;3;487711;511905;19;999616
84;2020-07-07;9;2;11;443824;451094;29;894918
84;2020-07-07;4;1;5;512522;493262;39;1005784
84;2020-07-07;3;1;4;520248;515106;49;1035354
84;2020-07-07;2;1;3;529611;514848;59;1044459
84;2020-07-07;2;1;3;486720;439940;69;926660
84;2020-07-07;3;0;3;372151;315211;79;687362
84;2020-07-07;0;1;1;237198;150524;89;387722
84;2020-07-07;2;0;2;81185;28680;90;109865
84;2020-07-07;27;9;36;4130719;3901658;0;8032377
93;2020-07-07;3;0;3;268834;283093;09;551927
93;2020-07-07;4;1;5;280751;296087;19;576838
93;2020-07-07;1;0;1;254404;255552;29;509956
93;2020-07-07;5;3;8;310704;288398;39;599102
93;2020-07-07;2;4;6;325559;305827;49;631386
93;2020-07-07;1;0;1;353104;325389;59;678493
93;2020-07-07;2;1;3;336327;296459;69;632786
93;2020-07-07;0;1;1;279820;229699;79;509519
93;2020-07-07;1;0;1;171274;113716;89;284990
93;2020-07-07;1;0;1;58896;21758;90;80654
93;2020-07-07;20;10;30;2639673;2415978;0;5055651
94;2020-07-07;0;0;0;16311;17433;09;33744
94;2020-07-07;0;0;0;16679;18132;19;34811
94;2020-07-07;0;0;0;16782;16579;29;33361
94;2020-07-07;0;0;0;23044;20580;39;43624
94;2020-07-07;0;0;0;23065;22140;49;45205
94;2020-07-07;0;0;0;24549;23421;59;47970
94;2020-07-07;0;0;0;23212;21883;69;45095
94;2020-07-07;0;0;0;19544;17141;79;36685
94;2020-07-07;0;0;0;11227;8178;89;19405
94;2020-07-07;0;0;0;3332;1447;90;4779
94;2020-07-07;0;0;0;177745;166934;0;344679
01;2020-07-08;0;0;0;19979;20155;09;40134
01;2020-07-08;0;0;0;24994;25489;19;50483
01;2020-07-08;0;0;0;17868;16690;29;34558
01;2020-07-08;0;0;0;22328;14821;39;37149
01;2020-07-08;0;0;0;28652;20276;49;48928
01;2020-07-08;0;0;0;33264;27260;59;60524
01;2020-07-08;0;0;0;27135;23978;69;51113
01;2020-07-08;0;0;0;18401;14661;79;33062
01;2020-07-08;0;0;0;9633;6375;89;16008
01;2020-07-08;0;0;0;3410;1510;90;4920
01;2020-07-08;0;0;0;205664;171215;0;376879
02;2020-07-08;0;0;0;16881;17110;09;33991
02;2020-07-08;0;0;0;21410;21604;19;43014
02;2020-07-08;0;0;0;16017;15479;29;31496
02;2020-07-08;0;0;0;19825;14455;39;34280
02;2020-07-08;0;0;0;24719;18248;49;42967
02;2020-07-08;0;0;0;34361;28310;59;62671
02;2020-07-08;0;0;0;28061;24495;69;52556
02;2020-07-08;0;0;0;18231;15278;79;33509
02;2020-07-08;0;0;0;11090;7677;89;18767
02;2020-07-08;0;0;0;3992;1506;90;5498
02;2020-07-08;0;0;0;194587;164162;0;358749
03;2020-07-08;4;7;11;31123;30920;09;62043
03;2020-07-08;11;5;16;29370;29268;19;58638
03;2020-07-08;24;27;51;21458;18963;29;40421
03;2020-07-08;14;13;28;21276;18326;39;39602
03;2020-07-08;18;13;31;18164;16593;49;34757
03;2020-07-08;10;7;17;13469;13557;59;27026
03;2020-07-08;5;7;12;8776;8670;69;17446
03;2020-07-08;1;4;5;3777;3591;79;7368
03;2020-07-08;2;0;2;1649;1072;89;2721
03;2020-07-08;0;0;0;485;184;90;669
03;2020-07-08;89;83;173;149547;141144;0;290691
04;2020-07-08;0;1;1;60314;61377;09;121691
04;2020-07-08;2;2;4;66065;68387;19;134452
04;2020-07-08;1;0;1;51059;47156;29;98215
04;2020-07-08;0;1;1;58788;45780;39;104568
04;2020-07-08;1;0;1;61408;52207;49;113615
04;2020-07-08;1;1;2;64838;60759;59;125597
04;2020-07-08;0;1;1;47008;42843;69;89851
04;2020-07-08;0;0;0;25509;21184;79;46693
04;2020-07-08;0;1;1;13168;7647;89;20815
04;2020-07-08;0;0;0;3209;1253;90;4462
04;2020-07-08;5;7;12;451366;408593;0;859959
05;2020-07-08;0;0;0;362.366008612902;341.338819562748;09;703.704828175651
05;2020-07-08;0;0;0;353.376145114279;370.349735405642;19;723.725880519921
05;2020-07-08;0;0;0;218.593559489256;256.539602589476;29;475.133162078732
05;2020-07-08;0;0;0;404.225408693299;360.321910454353;39;764.547319147651
05;2020-07-08;0;0;0;520.067953604221;497.108383964256;49;1017.17633756848
05;2020-07-08;0;0;0;468.146063921917;510.087601910415;59;978.233665832332
05;2020-07-08;0;0;0;340.368470050554;334.366842191253;69;674.735312241807
05;2020-07-08;0;0;0;212.598666888387;192.597753227106;79;405.196420115493
05;2020-07-08;0;0;0;148.727797095705;61.8681715431829;89;210.595968638888
05;2020-07-08;0;0;0;32.9601271090696;10.9909785719784;90;43.9511056810479
05;2020-07-08;0;0;0;3061.43020057959;2935.56979942041;0;5997
06;2020-07-08;1;2;3;42583;42380;09;84963
06;2020-07-08;0;1;1;33369;31925;19;65294
06;2020-07-08;3;1;4;21571;15080;29;36651
06;2020-07-08;1;2;3;21550;16147;39;37697
06;2020-07-08;0;2;2;14193;13939;49;28132
06;2020-07-08;0;0;0;7171;7597;59;14768
06;2020-07-08;1;0;1;3629;4117;69;7746
06;2020-07-08;0;0;0;1577;1457;79;3034
06;2020-07-08;1;0;1;531;474;89;1005
06;2020-07-08;0;0;0;88;93;90;181
06;2020-07-08;7;8;15;146262;133209;0;279471
07;2020-07-08;0;0;0;485;549;09;1034
07;2020-07-08;0;0;0;403;432;19;835
07;2020-07-08;0;0;0;764;841;29;1605
07;2020-07-08;0;0;0;824;928;39;1752
07;2020-07-08;0;0;0;788;1020;49;1808
07;2020-07-08;0;0;0;678;870;59;1548
07;2020-07-08;0;0;0;360;382;69;742
07;2020-07-08;0;0;0;231;190;79;421
07;2020-07-08;0;0;0;114;67;89;181
07;2020-07-08;0;0;0;24;11;90;35
07;2020-07-08;0;0;0;4671;5290;0;9961
08;2020-07-08;0;0;0;2715.22592983026;2997.75551488675;09;5712.98144471701
08;2020-07-08;0;0;0;2778.51901080978;3160.9156459093;19;5939.43465671908
08;2020-07-08;0;0;0;2080.8882988764;1718.16634315323;29;3799.05464202964
08;2020-07-08;0;0;0;2701.8582062647;1896.52641413317;39;4598.38462039786
08;2020-07-08;0;0;0;3151.45861023308;2460.52498233809;49;5611.98359257117
08;2020-07-08;0;0;0;2620.29868333099;2422.23566154656;59;5042.53434487755
08;2020-07-08;0;0;0;1621.44173420671;1438.58325779464;69;3060.02499200135
08;2020-07-08;0;0;0;626.575909335673;526.358467843651;79;1152.93437717932
08;2020-07-08;0;0;0;205.018522985054;140.993639349697;89;346.012162334751
08;2020-07-08;0;0;0;50.0325684687745;20.62259870351;90;70.6551671722846
08;2020-07-08;0;0;0;18551.3174743414;16782.6825256586;0;35334
11;2020-07-08;1;4;5;783071;811785;09;1594856
11;2020-07-08;11;6;17;761456;784653;19;1546109
11;2020-07-08;19;12;31;850145;801772;29;1651917
11;2020-07-08;26;13;39;914360;843488;39;1757848
11;2020-07-08;9;10;19;845609;826202;49;1671811
11;2020-07-08;12;15;27;793566;745070;59;1538636
11;2020-07-08;3;5;8;628649;549192;69;1177841
11;2020-07-08;2;3;5;434606;358356;79;792962
11;2020-07-08;3;2;5;261425;162933;89;424358
11;2020-07-08;4;0;4;89253;32619;90;121872
11;2020-07-08;90;70;160;6362140;5916070;0;12278210
24;2020-07-08;0;0;0;139720;144686;09;284406
24;2020-07-08;0;0;0;152979;161185;19;314164
24;2020-07-08;0;0;0;122237;126536;29;248773
24;2020-07-08;0;1;1;150359;142009;39;292368
24;2020-07-08;2;0;2;161829;158758;49;320587
24;2020-07-08;0;1;1;172552;168011;59;340563
24;2020-07-08;1;0;1;172509;158177;69;330686
24;2020-07-08;0;1;1;129428;110593;79;240021
24;2020-07-08;1;0;1;87342;56882;89;144224
24;2020-07-08;0;0;0;31210;12071;90;43281
24;2020-07-08;4;3;7;1320165;1238908;0;2559073
27;2020-07-08;0;0;0;143373;149679;09;293052
27;2020-07-08;0;1;1;160962;173003;19;333965
27;2020-07-08;2;2;4;133746;142254;29;276000
27;2020-07-08;3;1;4;160004;155407;39;315411
27;2020-07-08;1;0;1;172333;169564;49;341897
27;2020-07-08;1;2;3;189979;183788;59;373767
27;2020-07-08;3;0;3;192591;178206;69;370797
27;2020-07-08;0;0;0;146876;127546;79;274422
27;2020-07-08;1;0;1;96896;61575;89;158471
27;2020-07-08;0;1;1;33148;12109;90;45257
27;2020-07-08;11;7;18;1429908;1353131;0;2783039
28;2020-07-08;5;1;6;180735;186856;09;367591
28;2020-07-08;1;1;2;200125;213621;19;413746
28;2020-07-08;4;0;4;168922;173007;29;341929
28;2020-07-08;0;0;0;196628;188487;39;385115
28;2020-07-08;2;0;2;205396;201699;49;407095
28;2020-07-08;0;0;0;222002;213866;59;435868
28;2020-07-08;0;0;0;224688;203758;69;428446
28;2020-07-08;0;1;1;163192;135543;79;298735
28;2020-07-08;0;0;0;109691;65377;89;175068
28;2020-07-08;0;0;0;37222;12685;90;49907
28;2020-07-08;12;3;15;1708601;1594899;0;3303500
32;2020-07-08;0;1;1;358062;373689;09;731751
32;2020-07-08;4;3;7;387045;406742;19;793787
32;2020-07-08;2;2;4;342304;348587;29;690891
32;2020-07-08;2;3;5;382485;369972;39;752457
32;2020-07-08;7;3;10;382510;376716;49;759226
32;2020-07-08;0;2;2;386937;376527;59;763464
32;2020-07-08;1;1;2;371211;330938;69;702149
32;2020-07-08;1;3;4;250542;201459;79;452001
32;2020-07-08;3;1;4;163399;89786;89;253185
32;2020-07-08;2;0;2;48384;15367;90;63751
32;2020-07-08;22;19;41;3072879;2889783;0;5962662
44;2020-07-08;1;0;1;291525;306839;09;598364
44;2020-07-08;1;2;3;320255;339504;19;659759
44;2020-07-08;0;5;5;302020;314428;29;616448
44;2020-07-08;0;0;0;342222;333292;39;675514
44;2020-07-08;3;2;5;349727;344491;49;694218
44;2020-07-08;0;2;2;381371;373239;59;754610
44;2020-07-08;3;1;4;367165;335850;69;703015
44;2020-07-08;2;1;3;250387;215436;79;465823
44;2020-07-08;0;1;1;170825;105192;89;276017
44;2020-07-08;2;1;3;51248;16731;90;67979
44;2020-07-08;12;15;27;2826745;2685002;0;5511747
52;2020-07-08;0;1;1;213594;223900;09;437494
52;2020-07-08;1;3;4;240818;255197;19;496015
52;2020-07-08;3;5;8;197010;200630;29;397640
52;2020-07-08;7;3;10;231204;224885;39;456089
52;2020-07-08;3;2;5;243874;243418;49;487292
52;2020-07-08;5;8;13;244100;239116;59;483216
52;2020-07-08;1;1;2;241796;221345;69;463141
52;2020-07-08;1;0;1;177805;149903;79;327708
52;2020-07-08;0;0;0;119561;75822;89;195383
52;2020-07-08;0;0;0;42559;15260;90;57819
52;2020-07-08;21;23;44;1952321;1849476;0;3801797
53;2020-07-08;0;0;0;173813;182358;09;356171
53;2020-07-08;0;1;1;202720;214740;19;417460
53;2020-07-08;1;1;2;163116;173196;29;336312
53;2020-07-08;1;1;2;190526;187674;39;378200
53;2020-07-08;1;3;4;212098;212015;49;424113
53;2020-07-08;0;1;1;223699;219176;59;442875
53;2020-07-08;0;2;2;227435;209274;69;436709
53;2020-07-08;0;1;1;169992;140910;79;310902
53;2020-07-08;0;1;1;118117;69883;89;188000
53;2020-07-08;0;0;0;37370;12267;90;49637
53;2020-07-08;3;11;14;1718886;1621493;0;3340379
75;2020-07-08;1;0;1;293104;305291;09;598395
75;2020-07-08;0;6;6;337141;357785;19;694926
75;2020-07-08;1;0;1;295024;300618;29;595642
75;2020-07-08;0;1;1;347871;331233;39;679104
75;2020-07-08;6;7;13;384742;372771;49;757513
75;2020-07-08;1;6;7;413361;390880;59;804241
75;2020-07-08;1;4;5;425623;384060;69;809683
75;2020-07-08;1;0;1;325086;276298;79;601384
75;2020-07-08;0;0;0;213986;139308;89;353294
75;2020-07-08;0;0;0;77600;28200;90;105800
75;2020-07-08;11;24;35;3113538;2886444;0;5999982
76;2020-07-08;0;0;0;305956;318589;09;624545
76;2020-07-08;3;4;7;338942;356969;19;695911
76;2020-07-08;0;2;2;316210;319570;29;635780
76;2020-07-08;2;2;4;356758;337587;39;694345
76;2020-07-08;1;3;4;376541;363812;49;740353
76;2020-07-08;1;3;4;402608;383750;59;786358
76;2020-07-08;1;2;3;394889;358997;69;753886
76;2020-07-08;0;0;0;308664;263806;79;572470
76;2020-07-08;0;0;0;195838;129272;89;325110
76;2020-07-08;0;0;0;69372;26728;90;96100
76;2020-07-08;8;16;24;3065778;2859080;0;5924858
84;2020-07-08;3;1;4;459549;481088;09;940637
84;2020-07-08;5;3;8;487711;511905;19;999616
84;2020-07-08;7;8;15;443824;451094;29;894918
84;2020-07-08;2;3;5;512522;493262;39;1005784
84;2020-07-08;3;6;9;520248;515106;49;1035354
84;2020-07-08;2;3;5;529611;514848;59;1044459
84;2020-07-08;5;5;10;486720;439940;69;926660
84;2020-07-08;0;3;3;372151;315211;79;687362
84;2020-07-08;1;0;1;237198;150524;89;387722
84;2020-07-08;1;0;1;81185;28680;90;109865
84;2020-07-08;29;32;61;4130719;3901658;0;8032377
93;2020-07-08;2;5;7;268834;283093;09;551927
93;2020-07-08;3;2;5;280751;296087;19;576838
93;2020-07-08;3;4;7;254404;255552;29;509956
93;2020-07-08;5;4;9;310704;288398;39;599102
93;2020-07-08;2;4;6;325559;305827;49;631386
93;2020-07-08;4;8;12;353104;325389;59;678493
93;2020-07-08;1;1;2;336327;296459;69;632786
93;2020-07-08;3;0;3;279820;229699;79;509519
93;2020-07-08;1;0;1;171274;113716;89;284990
93;2020-07-08;0;0;0;58896;21758;90;80654
93;2020-07-08;24;28;52;2639673;2415978;0;5055651
94;2020-07-08;0;0;0;16311;17433;09;33744
94;2020-07-08;0;0;0;16679;18132;19;34811
94;2020-07-08;0;2;2;16782;16579;29;33361
94;2020-07-08;0;0;0;23044;20580;39;43624
94;2020-07-08;0;0;0;23065;22140;49;45205
94;2020-07-08;0;0;0;24549;23421;59;47970
94;2020-07-08;0;0;0;23212;21883;69;45095
94;2020-07-08;0;0;0;19544;17141;79;36685
94;2020-07-08;0;0;0;11227;8178;89;19405
94;2020-07-08;0;0;0;3332;1447;90;4779
94;2020-07-08;0;2;2;177745;166934;0;344679
01;2020-07-09;0;0;0;19979;20155;09;40134
01;2020-07-09;0;0;0;24994;25489;19;50483
01;2020-07-09;0;1;1;17868;16690;29;34558
01;2020-07-09;0;0;0;22328;14821;39;37149
01;2020-07-09;0;0;0;28652;20276;49;48928
01;2020-07-09;0;0;0;33264;27260;59;60524
01;2020-07-09;0;0;0;27135;23978;69;51113
01;2020-07-09;0;0;0;18401;14661;79;33062
01;2020-07-09;0;0;0;9633;6375;89;16008
01;2020-07-09;0;0;0;3410;1510;90;4920
01;2020-07-09;0;1;1;205664;171215;0;376879
02;2020-07-09;0;0;0;16881;17110;09;33991
02;2020-07-09;0;0;0;21410;21604;19;43014
02;2020-07-09;0;0;0;16017;15479;29;31496
02;2020-07-09;0;0;0;19825;14455;39;34280
02;2020-07-09;0;0;0;24719;18248;49;42967
02;2020-07-09;0;0;0;34361;28310;59;62671
02;2020-07-09;0;1;1;28061;24495;69;52556
02;2020-07-09;0;0;0;18231;15278;79;33509
02;2020-07-09;0;0;0;11090;7677;89;18767
02;2020-07-09;0;0;0;3992;1506;90;5498
02;2020-07-09;0;1;1;194587;164162;0;358749
03;2020-07-09;4;4;8;31123;30920;09;62043
03;2020-07-09;5;8;13;29370;29268;19;58638
03;2020-07-09;17;5;23;21458;18963;29;40421
03;2020-07-09;10;13;23;21276;18326;39;39602
03;2020-07-09;7;10;17;18164;16593;49;34757
03;2020-07-09;7;12;19;13469;13557;59;27026
03;2020-07-09;1;8;9;8776;8670;69;17446
03;2020-07-09;1;5;6;3777;3591;79;7368
03;2020-07-09;0;0;0;1649;1072;89;2721
03;2020-07-09;0;0;0;485;184;90;669
03;2020-07-09;52;65;118;149547;141144;0;290691
04;2020-07-09;0;0;0;60314;61377;09;121691
04;2020-07-09;0;2;2;66065;68387;19;134452
04;2020-07-09;0;0;0;51059;47156;29;98215
04;2020-07-09;2;0;2;58788;45780;39;104568
04;2020-07-09;1;0;1;61408;52207;49;113615
04;2020-07-09;0;0;0;64838;60759;59;125597
04;2020-07-09;1;0;1;47008;42843;69;89851
04;2020-07-09;1;0;1;25509;21184;79;46693
04;2020-07-09;0;0;0;13168;7647;89;20815
04;2020-07-09;0;0;0;3209;1253;90;4462
04;2020-07-09;5;2;7;451366;408593;0;859959
05;2020-07-09;0;0;0;362.366008612902;341.338819562748;09;703.704828175651
05;2020-07-09;0;0;0;353.376145114279;370.349735405642;19;723.725880519921
05;2020-07-09;0;0;0;218.593559489256;256.539602589476;29;475.133162078732
05;2020-07-09;0;0;0;404.225408693299;360.321910454353;39;764.547319147651
05;2020-07-09;0;0;0;520.067953604221;497.108383964256;49;1017.17633756848
05;2020-07-09;0;0;0;468.146063921917;510.087601910415;59;978.233665832332
05;2020-07-09;0;0;0;340.368470050554;334.366842191253;69;674.735312241807
05;2020-07-09;0;0;0;212.598666888387;192.597753227106;79;405.196420115493
05;2020-07-09;0;0;0;148.727797095705;61.8681715431829;89;210.595968638888
05;2020-07-09;0;0;0;32.9601271090696;10.9909785719784;90;43.9511056810479
05;2020-07-09;0;0;0;3061.43020057959;2935.56979942041;0;5997
06;2020-07-09;0;0;0;42583;42380;09;84963
06;2020-07-09;0;0;0;33369;31925;19;65294
06;2020-07-09;0;2;2;21571;15080;29;36651
06;2020-07-09;1;2;3;21550;16147;39;37697
06;2020-07-09;0;0;0;14193;13939;49;28132
06;2020-07-09;2;0;2;7171;7597;59;14768
06;2020-07-09;0;0;0;3629;4117;69;7746
06;2020-07-09;0;0;0;1577;1457;79;3034
06;2020-07-09;0;0;0;531;474;89;1005
06;2020-07-09;0;0;0;88;93;90;181
06;2020-07-09;3;4;7;146262;133209;0;279471
07;2020-07-09;0;0;0;485;549;09;1034
07;2020-07-09;0;0;0;403;432;19;835
07;2020-07-09;0;0;0;764;841;29;1605
07;2020-07-09;0;0;0;824;928;39;1752
07;2020-07-09;0;0;0;788;1020;49;1808
07;2020-07-09;0;0;0;678;870;59;1548
07;2020-07-09;0;0;0;360;382;69;742
07;2020-07-09;0;0;0;231;190;79;421
07;2020-07-09;0;0;0;114;67;89;181
07;2020-07-09;0;0;0;24;11;90;35
07;2020-07-09;0;0;0;4671;5290;0;9961
08;2020-07-09;0;0;0;2715.22592983026;2997.75551488675;09;5712.98144471701
08;2020-07-09;0;0;0;2778.51901080978;3160.9156459093;19;5939.43465671908
08;2020-07-09;0;0;0;2080.8882988764;1718.16634315323;29;3799.05464202964
08;2020-07-09;0;0;0;2701.8582062647;1896.52641413317;39;4598.38462039786
08;2020-07-09;0;0;0;3151.45861023308;2460.52498233809;49;5611.98359257117
08;2020-07-09;0;0;0;2620.29868333099;2422.23566154656;59;5042.53434487755
08;2020-07-09;0;0;0;1621.44173420671;1438.58325779464;69;3060.02499200135
08;2020-07-09;0;0;0;626.575909335673;526.358467843651;79;1152.93437717932
08;2020-07-09;0;0;0;205.018522985054;140.993639349697;89;346.012162334751
08;2020-07-09;0;0;0;50.0325684687745;20.62259870351;90;70.6551671722846
08;2020-07-09;0;0;0;18551.3174743414;16782.6825256586;0;35334
11;2020-07-09;6;5;11;783071;811785;09;1594856
11;2020-07-09;6;12;18;761456;784653;19;1546109
11;2020-07-09;25;17;42;850145;801772;29;1651917
11;2020-07-09;17;20;37;914360;843488;39;1757848
11;2020-07-09;13;11;24;845609;826202;49;1671811
11;2020-07-09;12;14;26;793566;745070;59;1538636
11;2020-07-09;10;9;20;628649;549192;69;1177841
11;2020-07-09;5;5;10;434606;358356;79;792962
11;2020-07-09;1;5;6;261425;162933;89;424358
11;2020-07-09;5;1;6;89253;32619;90;121872
11;2020-07-09;100;99;201;6362140;5916070;0;12278210
24;2020-07-09;0;1;1;139720;144686;09;284406
24;2020-07-09;0;0;0;152979;161185;19;314164
24;2020-07-09;2;1;3;122237;126536;29;248773
24;2020-07-09;1;0;1;150359;142009;39;292368
24;2020-07-09;0;0;0;161829;158758;49;320587
24;2020-07-09;0;0;0;172552;168011;59;340563
24;2020-07-09;1;0;1;172509;158177;69;330686
24;2020-07-09;1;0;1;129428;110593;79;240021
24;2020-07-09;0;0;0;87342;56882;89;144224
24;2020-07-09;0;0;0;31210;12071;90;43281
24;2020-07-09;5;2;7;1320165;1238908;0;2559073
27;2020-07-09;1;0;1;143373;149679;09;293052
27;2020-07-09;1;0;1;160962;173003;19;333965
27;2020-07-09;1;4;5;133746;142254;29;276000
27;2020-07-09;0;1;1;160004;155407;39;315411
27;2020-07-09;3;1;4;172333;169564;49;341897
27;2020-07-09;2;2;4;189979;183788;59;373767
27;2020-07-09;0;1;1;192591;178206;69;370797
27;2020-07-09;1;0;1;146876;127546;79;274422
27;2020-07-09;0;0;0;96896;61575;89;158471
27;2020-07-09;0;0;0;33148;12109;90;45257
27;2020-07-09;9;9;18;1429908;1353131;0;2783039
28;2020-07-09;1;2;3;180735;186856;09;367591
28;2020-07-09;4;2;6;200125;213621;19;413746
28;2020-07-09;0;1;1;168922;173007;29;341929
28;2020-07-09;3;3;7;196628;188487;39;385115
28;2020-07-09;0;2;2;205396;201699;49;407095
28;2020-07-09;0;0;0;222002;213866;59;435868
28;2020-07-09;2;1;3;224688;203758;69;428446
28;2020-07-09;0;0;0;163192;135543;79;298735
28;2020-07-09;0;0;0;109691;65377;89;175068
28;2020-07-09;0;0;0;37222;12685;90;49907
28;2020-07-09;10;11;22;1708601;1594899;0;3303500
32;2020-07-09;4;3;7;358062;373689;09;731751
32;2020-07-09;7;6;13;387045;406742;19;793787
32;2020-07-09;4;3;7;342304;348587;29;690891
32;2020-07-09;5;2;7;382485;369972;39;752457
32;2020-07-09;4;6;10;382510;376716;49;759226
32;2020-07-09;5;4;9;386937;376527;59;763464
32;2020-07-09;4;0;4;371211;330938;69;702149
32;2020-07-09;0;2;2;250542;201459;79;452001
32;2020-07-09;4;2;6;163399;89786;89;253185
32;2020-07-09;0;0;0;48384;15367;90;63751
32;2020-07-09;37;28;65;3072879;2889783;0;5962662
44;2020-07-09;0;2;2;291525;306839;09;598364
44;2020-07-09;0;2;2;320255;339504;19;659759
44;2020-07-09;4;3;7;302020;314428;29;616448
44;2020-07-09;2;1;3;342222;333292;39;675514
44;2020-07-09;5;5;10;349727;344491;49;694218
44;2020-07-09;2;3;5;381371;373239;59;754610
44;2020-07-09;2;1;3;367165;335850;69;703015
44;2020-07-09;1;2;3;250387;215436;79;465823
44;2020-07-09;0;1;1;170825;105192;89;276017
44;2020-07-09;1;1;2;51248;16731;90;67979
44;2020-07-09;17;21;38;2826745;2685002;0;5511747
52;2020-07-09;1;3;4;213594;223900;09;437494
52;2020-07-09;1;1;2;240818;255197;19;496015
52;2020-07-09;4;8;12;197010;200630;29;397640
52;2020-07-09;3;4;7;231204;224885;39;456089
52;2020-07-09;7;0;7;243874;243418;49;487292
52;2020-07-09;0;0;0;244100;239116;59;483216
52;2020-07-09;1;1;2;241796;221345;69;463141
52;2020-07-09;1;0;1;177805;149903;79;327708
52;2020-07-09;0;0;0;119561;75822;89;195383
52;2020-07-09;0;0;0;42559;15260;90;57819
52;2020-07-09;18;17;35;1952321;1849476;0;3801797
53;2020-07-09;0;0;0;173813;182358;09;356171
53;2020-07-09;0;0;0;202720;214740;19;417460
53;2020-07-09;3;1;4;163116;173196;29;336312
53;2020-07-09;0;1;1;190526;187674;39;378200
53;2020-07-09;2;2;4;212098;212015;49;424113
53;2020-07-09;2;0;2;223699;219176;59;442875
53;2020-07-09;0;0;0;227435;209274;69;436709
53;2020-07-09;0;1;1;169992;140910;79;310902
53;2020-07-09;0;0;0;118117;69883;89;188000
53;2020-07-09;0;0;0;37370;12267;90;49637
53;2020-07-09;7;5;12;1718886;1621493;0;3340379
75;2020-07-09;0;0;0;293104;305291;09;598395
75;2020-07-09;0;1;1;337141;357785;19;694926
75;2020-07-09;0;1;1;295024;300618;29;595642
75;2020-07-09;0;2;2;347871;331233;39;679104
75;2020-07-09;4;1;5;384742;372771;49;757513
75;2020-07-09;0;0;0;413361;390880;59;804241
75;2020-07-09;0;1;1;425623;384060;69;809683
75;2020-07-09;0;1;1;325086;276298;79;601384
75;2020-07-09;0;0;0;213986;139308;89;353294
75;2020-07-09;0;0;0;77600;28200;90;105800
75;2020-07-09;4;7;11;3113538;2886444;0;5999982
76;2020-07-09;1;2;3;305956;318589;09;624545
76;2020-07-09;2;3;5;338942;356969;19;695911
76;2020-07-09;3;2;5;316210;319570;29;635780
76;2020-07-09;1;2;3;356758;337587;39;694345
76;2020-07-09;3;3;6;376541;363812;49;740353
76;2020-07-09;2;2;4;402608;383750;59;786358
76;2020-07-09;2;2;4;394889;358997;69;753886
76;2020-07-09;1;1;2;308664;263806;79;572470
76;2020-07-09;0;0;0;195838;129272;89;325110
76;2020-07-09;0;0;0;69372;26728;90;96100
76;2020-07-09;15;17;32;3065778;2859080;0;5924858
84;2020-07-09;5;1;6;459549;481088;09;940637
84;2020-07-09;2;2;4;487711;511905;19;999616
84;2020-07-09;9;3;12;443824;451094;29;894918
84;2020-07-09;4;6;10;512522;493262;39;1005784
84;2020-07-09;2;2;4;520248;515106;49;1035354
84;2020-07-09;3;2;5;529611;514848;59;1044459
84;2020-07-09;4;0;4;486720;439940;69;926660
84;2020-07-09;1;1;2;372151;315211;79;687362
84;2020-07-09;3;1;4;237198;150524;89;387722
84;2020-07-09;0;0;0;81185;28680;90;109865
84;2020-07-09;33;18;51;4130719;3901658;0;8032377
93;2020-07-09;2;3;5;268834;283093;09;551927
93;2020-07-09;2;5;7;280751;296087;19;576838
93;2020-07-09;6;9;15;254404;255552;29;509956
93;2020-07-09;7;6;13;310704;288398;39;599102
93;2020-07-09;0;9;9;325559;305827;49;631386
93;2020-07-09;3;8;11;353104;325389;59;678493
93;2020-07-09;3;3;6;336327;296459;69;632786
93;2020-07-09;1;3;4;279820;229699;79;509519
93;2020-07-09;2;1;3;171274;113716;89;284990
93;2020-07-09;0;0;0;58896;21758;90;80654
93;2020-07-09;26;47;74;2639673;2415978;0;5055651
94;2020-07-09;0;0;0;16311;17433;09;33744
94;2020-07-09;0;0;0;16679;18132;19;34811
94;2020-07-09;0;0;0;16782;16579;29;33361
94;2020-07-09;0;0;0;23044;20580;39;43624
94;2020-07-09;0;0;0;23065;22140;49;45205
94;2020-07-09;1;0;1;24549;23421;59;47970
94;2020-07-09;0;0;0;23212;21883;69;45095
94;2020-07-09;0;0;0;19544;17141;79;36685
94;2020-07-09;0;0;0;11227;8178;89;19405
94;2020-07-09;0;0;0;3332;1447;90;4779
94;2020-07-09;1;0;1;177745;166934;0;344679
01;2020-07-10;0;0;0;19979;20155;09;40134
01;2020-07-10;0;0;0;24994;25489;19;50483
01;2020-07-10;0;1;1;17868;16690;29;34558
01;2020-07-10;0;0;0;22328;14821;39;37149
01;2020-07-10;0;0;0;28652;20276;49;48928
01;2020-07-10;0;0;0;33264;27260;59;60524
01;2020-07-10;0;0;0;27135;23978;69;51113
01;2020-07-10;0;0;0;18401;14661;79;33062
01;2020-07-10;0;0;0;9633;6375;89;16008
01;2020-07-10;0;0;0;3410;1510;90;4920
01;2020-07-10;0;1;1;205664;171215;0;376879
02;2020-07-10;0;0;0;16881;17110;09;33991
02;2020-07-10;0;0;0;21410;21604;19;43014
02;2020-07-10;0;0;0;16017;15479;29;31496
02;2020-07-10;0;0;0;19825;14455;39;34280
02;2020-07-10;0;0;0;24719;18248;49;42967
02;2020-07-10;1;0;1;34361;28310;59;62671
02;2020-07-10;0;0;0;28061;24495;69;52556
02;2020-07-10;0;0;0;18231;15278;79;33509
02;2020-07-10;0;0;0;11090;7677;89;18767
02;2020-07-10;0;0;0;3992;1506;90;5498
02;2020-07-10;1;0;1;194587;164162;0;358749
03;2020-07-10;5;6;11;31123;30920;09;62043
03;2020-07-10;14;13;27;29370;29268;19;58638
03;2020-07-10;25;18;45;21458;18963;29;40421
03;2020-07-10;22;18;45;21276;18326;39;39602
03;2020-07-10;18;14;34;18164;16593;49;34757
03;2020-07-10;16;13;30;13469;13557;59;27026
03;2020-07-10;10;8;19;8776;8670;69;17446
03;2020-07-10;3;0;3;3777;3591;79;7368
03;2020-07-10;1;0;1;1649;1072;89;2721
03;2020-07-10;2;1;3;485;184;90;669
03;2020-07-10;116;91;218;149547;141144;0;290691
04;2020-07-10;1;0;1;60314;61377;09;121691
04;2020-07-10;0;0;0;66065;68387;19;134452
04;2020-07-10;1;1;2;51059;47156;29;98215
04;2020-07-10;0;0;0;58788;45780;39;104568
04;2020-07-10;0;0;0;61408;52207;49;113615
04;2020-07-10;0;0;0;64838;60759;59;125597
04;2020-07-10;1;0;1;47008;42843;69;89851
04;2020-07-10;0;0;0;25509;21184;79;46693
04;2020-07-10;0;0;0;13168;7647;89;20815
04;2020-07-10;0;0;0;3209;1253;90;4462
04;2020-07-10;3;1;4;451366;408593;0;859959
05;2020-07-10;0;0;0;362.366008612902;341.338819562748;09;703.704828175651
05;2020-07-10;0;0;0;353.376145114279;370.349735405642;19;723.725880519921
05;2020-07-10;0;0;0;218.593559489256;256.539602589476;29;475.133162078732
05;2020-07-10;0;0;0;404.225408693299;360.321910454353;39;764.547319147651
05;2020-07-10;0;0;0;520.067953604221;497.108383964256;49;1017.17633756848
05;2020-07-10;0;0;0;468.146063921917;510.087601910415;59;978.233665832332
05;2020-07-10;0;0;0;340.368470050554;334.366842191253;69;674.735312241807
05;2020-07-10;0;0;0;212.598666888387;192.597753227106;79;405.196420115493
05;2020-07-10;0;0;0;148.727797095705;61.8681715431829;89;210.595968638888
05;2020-07-10;0;0;0;32.9601271090696;10.9909785719784;90;43.9511056810479
05;2020-07-10;0;0;0;3061.43020057959;2935.56979942041;0;5997
06;2020-07-10;1;0;1;42583;42380;09;84963
06;2020-07-10;0;0;0;33369;31925;19;65294
06;2020-07-10;0;0;0;21571;15080;29;36651
06;2020-07-10;1;0;1;21550;16147;39;37697
06;2020-07-10;2;0;2;14193;13939;49;28132
06;2020-07-10;2;2;4;7171;7597;59;14768
06;2020-07-10;1;0;1;3629;4117;69;7746
06;2020-07-10;0;0;0;1577;1457;79;3034
06;2020-07-10;1;0;1;531;474;89;1005
06;2020-07-10;0;0;0;88;93;90;181
06;2020-07-10;8;2;10;146262;133209;0;279471
07;2020-07-10;0;0;0;485;549;09;1034
07;2020-07-10;0;0;0;403;432;19;835
07;2020-07-10;0;0;0;764;841;29;1605
07;2020-07-10;0;0;0;824;928;39;1752
07;2020-07-10;0;0;0;788;1020;49;1808
07;2020-07-10;0;0;0;678;870;59;1548
07;2020-07-10;0;0;0;360;382;69;742
07;2020-07-10;0;0;0;231;190;79;421
07;2020-07-10;0;0;0;114;67;89;181
07;2020-07-10;0;0;0;24;11;90;35
07;2020-07-10;0;0;0;4671;5290;0;9961
08;2020-07-10;0;0;0;2715.22592983026;2997.75551488675;09;5712.98144471701
08;2020-07-10;0;0;0;2778.51901080978;3160.9156459093;19;5939.43465671908
08;2020-07-10;0;0;0;2080.8882988764;1718.16634315323;29;3799.05464202964
08;2020-07-10;0;0;0;2701.8582062647;1896.52641413317;39;4598.38462039786
08;2020-07-10;0;0;0;3151.45861023308;2460.52498233809;49;5611.98359257117
08;2020-07-10;0;0;0;2620.29868333099;2422.23566154656;59;5042.53434487755
08;2020-07-10;0;0;0;1621.44173420671;1438.58325779464;69;3060.02499200135
08;2020-07-10;0;0;0;626.575909335673;526.358467843651;79;1152.93437717932
08;2020-07-10;0;0;0;205.018522985054;140.993639349697;89;346.012162334751
08;2020-07-10;0;0;0;50.0325684687745;20.62259870351;90;70.6551671722846
08;2020-07-10;0;0;0;18551.3174743414;16782.6825256586;0;35334
11;2020-07-10;15;12;27;783071;811785;09;1594856
11;2020-07-10;7;6;13;761456;784653;19;1546109
11;2020-07-10;18;20;38;850145;801772;29;1651917
11;2020-07-10;24;11;35;914360;843488;39;1757848
11;2020-07-10;15;12;27;845609;826202;49;1671811
11;2020-07-10;15;7;22;793566;745070;59;1538636
11;2020-07-10;6;15;21;628649;549192;69;1177841
11;2020-07-10;2;5;7;434606;358356;79;792962
11;2020-07-10;4;1;5;261425;162933;89;424358
11;2020-07-10;1;1;2;89253;32619;90;121872
11;2020-07-10;107;90;197;6362140;5916070;0;12278210
24;2020-07-10;0;0;0;139720;144686;09;284406
24;2020-07-10;0;0;0;152979;161185;19;314164
24;2020-07-10;1;0;1;122237;126536;29;248773
24;2020-07-10;1;2;3;150359;142009;39;292368
24;2020-07-10;2;1;3;161829;158758;49;320587
24;2020-07-10;0;1;1;172552;168011;59;340563
24;2020-07-10;0;0;0;172509;158177;69;330686
24;2020-07-10;1;0;1;129428;110593;79;240021
24;2020-07-10;0;0;0;87342;56882;89;144224
24;2020-07-10;0;0;0;31210;12071;90;43281
24;2020-07-10;5;4;9;1320165;1238908;0;2559073
27;2020-07-10;0;0;0;143373;149679;09;293052
27;2020-07-10;1;0;1;160962;173003;19;333965
27;2020-07-10;0;1;1;133746;142254;29;276000
27;2020-07-10;0;0;0;160004;155407;39;315411
27;2020-07-10;1;0;1;172333;169564;49;341897
27;2020-07-10;3;1;4;189979;183788;59;373767
27;2020-07-10;1;2;3;192591;178206;69;370797
27;2020-07-10;1;2;3;146876;127546;79;274422
27;2020-07-10;0;0;0;96896;61575;89;158471
27;2020-07-10;0;1;1;33148;12109;90;45257
27;2020-07-10;7;7;14;1429908;1353131;0;2783039
28;2020-07-10;1;1;2;180735;186856;09;367591
28;2020-07-10;1;1;2;200125;213621;19;413746
28;2020-07-10;2;0;2;168922;173007;29;341929
28;2020-07-10;3;0;3;196628;188487;39;385115
28;2020-07-10;1;1;2;205396;201699;49;407095
28;2020-07-10;0;1;1;222002;213866;59;435868
28;2020-07-10;0;0;0;224688;203758;69;428446
28;2020-07-10;0;1;1;163192;135543;79;298735
28;2020-07-10;0;0;0;109691;65377;89;175068
28;2020-07-10;0;0;0;37222;12685;90;49907
28;2020-07-10;8;5;13;1708601;1594899;0;3303500
32;2020-07-10;0;2;2;358062;373689;09;731751
32;2020-07-10;4;8;12;387045;406742;19;793787
32;2020-07-10;6;3;9;342304;348587;29;690891
32;2020-07-10;6;4;10;382485;369972;39;752457
32;2020-07-10;5;3;8;382510;376716;49;759226
32;2020-07-10;2;2;4;386937;376527;59;763464
32;2020-07-10;2;0;2;371211;330938;69;702149
32;2020-07-10;2;1;3;250542;201459;79;452001
32;2020-07-10;2;1;3;163399;89786;89;253185
32;2020-07-10;2;0;2;48384;15367;90;63751
32;2020-07-10;31;24;55;3072879;2889783;0;5962662
44;2020-07-10;3;1;4;291525;306839;09;598364
44;2020-07-10;1;0;1;320255;339504;19;659759
44;2020-07-10;3;4;7;302020;314428;29;616448
44;2020-07-10;2;1;3;342222;333292;39;675514
44;2020-07-10;3;3;6;349727;344491;49;694218
44;2020-07-10;0;0;0;381371;373239;59;754610
44;2020-07-10;2;3;5;367165;335850;69;703015
44;2020-07-10;1;2;3;250387;215436;79;465823
44;2020-07-10;1;1;2;170825;105192;89;276017
44;2020-07-10;0;0;0;51248;16731;90;67979
44;2020-07-10;16;15;31;2826745;2685002;0;5511747
52;2020-07-10;6;3;9;213594;223900;09;437494
52;2020-07-10;9;6;15;240818;255197;19;496015
52;2020-07-10;3;7;10;197010;200630;29;397640
52;2020-07-10;10;7;17;231204;224885;39;456089
52;2020-07-10;6;5;11;243874;243418;49;487292
52;2020-07-10;5;0;5;244100;239116;59;483216
52;2020-07-10;1;0;1;241796;221345;69;463141
52;2020-07-10;1;3;4;177805;149903;79;327708
52;2020-07-10;3;1;4;119561;75822;89;195383
52;2020-07-10;0;0;0;42559;15260;90;57819
52;2020-07-10;44;32;76;1952321;1849476;0;3801797
53;2020-07-10;5;2;7;173813;182358;09;356171
53;2020-07-10;2;3;5;202720;214740;19;417460
53;2020-07-10;2;1;3;163116;173196;29;336312
53;2020-07-10;8;3;11;190526;187674;39;378200
53;2020-07-10;7;1;8;212098;212015;49;424113
53;2020-07-10;5;2;7;223699;219176;59;442875
53;2020-07-10;3;2;5;227435;209274;69;436709
53;2020-07-10;2;1;3;169992;140910;79;310902
53;2020-07-10;1;1;2;118117;69883;89;188000
53;2020-07-10;0;0;0;37370;12267;90;49637
53;2020-07-10;35;16;51;1718886;1621493;0;3340379
75;2020-07-10;1;3;5;293104;305291;09;598395
75;2020-07-10;2;1;3;337141;357785;19;694926
75;2020-07-10;2;0;2;295024;300618;29;595642
75;2020-07-10;4;1;5;347871;331233;39;679104
75;2020-07-10;0;2;2;384742;372771;49;757513
75;2020-07-10;0;2;2;413361;390880;59;804241
75;2020-07-10;1;0;1;425623;384060;69;809683
75;2020-07-10;0;0;0;325086;276298;79;601384
75;2020-07-10;2;0;2;213986;139308;89;353294
75;2020-07-10;1;0;1;77600;28200;90;105800
75;2020-07-10;13;9;27;3113538;2886444;0;5999982
76;2020-07-10;0;1;1;305956;318589;09;624545
76;2020-07-10;0;0;0;338942;356969;19;695911
76;2020-07-10;4;2;6;316210;319570;29;635780
76;2020-07-10;2;2;4;356758;337587;39;694345
76;2020-07-10;2;5;7;376541;363812;49;740353
76;2020-07-10;2;2;4;402608;383750;59;786358
76;2020-07-10;1;1;2;394889;358997;69;753886
76;2020-07-10;0;0;0;308664;263806;79;572470
76;2020-07-10;0;0;0;195838;129272;89;325110
76;2020-07-10;0;0;0;69372;26728;90;96100
76;2020-07-10;11;13;24;3065778;2859080;0;5924858
84;2020-07-10;2;3;5;459549;481088;09;940637
84;2020-07-10;3;2;5;487711;511905;19;999616
84;2020-07-10;7;4;11;443824;451094;29;894918
84;2020-07-10;8;3;11;512522;493262;39;1005784
84;2020-07-10;9;3;12;520248;515106;49;1035354
84;2020-07-10;10;6;16;529611;514848;59;1044459
84;2020-07-10;5;2;7;486720;439940;69;926660
84;2020-07-10;1;4;5;372151;315211;79;687362
84;2020-07-10;1;3;4;237198;150524;89;387722
84;2020-07-10;1;1;2;81185;28680;90;109865
84;2020-07-10;47;31;78;4130719;3901658;0;8032377
93;2020-07-10;0;0;0;268834;283093;09;551927
93;2020-07-10;2;4;6;280751;296087;19;576838
93;2020-07-10;6;2;8;254404;255552;29;509956
93;2020-07-10;3;2;5;310704;288398;39;599102
93;2020-07-10;4;1;5;325559;305827;49;631386
93;2020-07-10;0;6;6;353104;325389;59;678493
93;2020-07-10;1;2;3;336327;296459;69;632786
93;2020-07-10;2;0;2;279820;229699;79;509519
93;2020-07-10;1;0;1;171274;113716;89;284990
93;2020-07-10;1;0;1;58896;21758;90;80654
93;2020-07-10;20;17;37;2639673;2415978;0;5055651
94;2020-07-10;0;0;0;16311;17433;09;33744
94;2020-07-10;0;0;0;16679;18132;19;34811
94;2020-07-10;0;1;1;16782;16579;29;33361
94;2020-07-10;0;0;0;23044;20580;39;43624
94;2020-07-10;0;0;0;23065;22140;49;45205
94;2020-07-10;0;0;0;24549;23421;59;47970
94;2020-07-10;0;0;0;23212;21883;69;45095
94;2020-07-10;0;0;0;19544;17141;79;36685
94;2020-07-10;0;0;0;11227;8178;89;19405
94;2020-07-10;0;0;0;3332;1447;90;4779
94;2020-07-10;0;1;1;177745;166934;0;344679
01;2020-07-11;1;0;1;19979;20155;09;40134
01;2020-07-11;0;0;0;24994;25489;19;50483
01;2020-07-11;0;0;0;17868;16690;29;34558
01;2020-07-11;0;0;0;22328;14821;39;37149
01;2020-07-11;0;1;1;28652;20276;49;48928
01;2020-07-11;0;0;0;33264;27260;59;60524
01;2020-07-11;0;0;0;27135;23978;69;51113
01;2020-07-11;0;0;0;18401;14661;79;33062
01;2020-07-11;0;0;0;9633;6375;89;16008
01;2020-07-11;0;0;0;3410;1510;90;4920
01;2020-07-11;1;1;2;205664;171215;0;376879
02;2020-07-11;0;0;0;16881;17110;09;33991
02;2020-07-11;0;0;0;21410;21604;19;43014
02;2020-07-11;0;0;0;16017;15479;29;31496
02;2020-07-11;0;0;0;19825;14455;39;34280
02;2020-07-11;0;0;0;24719;18248;49;42967
02;2020-07-11;0;0;0;34361;28310;59;62671
02;2020-07-11;0;0;0;28061;24495;69;52556
02;2020-07-11;0;0;0;18231;15278;79;33509
02;2020-07-11;0;0;0;11090;7677;89;18767
02;2020-07-11;0;0;0;3992;1506;90;5498
02;2020-07-11;0;0;0;194587;164162;0;358749
03;2020-07-11;2;0;2;31123;30920;09;62043
03;2020-07-11;1;3;4;29370;29268;19;58638
03;2020-07-11;9;4;13;21458;18963;29;40421
03;2020-07-11;8;4;13;21276;18326;39;39602
03;2020-07-11;6;7;14;18164;16593;49;34757
03;2020-07-11;3;4;9;13469;13557;59;27026
03;2020-07-11;2;4;6;8776;8670;69;17446
03;2020-07-11;2;3;5;3777;3591;79;7368
03;2020-07-11;0;1;1;1649;1072;89;2721
03;2020-07-11;0;0;0;485;184;90;669
03;2020-07-11;33;30;67;149547;141144;0;290691
04;2020-07-11;0;0;0;60314;61377;09;121691
04;2020-07-11;1;1;2;66065;68387;19;134452
04;2020-07-11;2;1;3;51059;47156;29;98215
04;2020-07-11;1;1;2;58788;45780;39;104568
04;2020-07-11;3;4;7;61408;52207;49;113615
04;2020-07-11;1;3;4;64838;60759;59;125597
04;2020-07-11;0;1;1;47008;42843;69;89851
04;2020-07-11;0;0;0;25509;21184;79;46693
04;2020-07-11;0;0;0;13168;7647;89;20815
04;2020-07-11;0;0;0;3209;1253;90;4462
04;2020-07-11;8;11;19;451366;408593;0;859959
05;2020-07-11;0;0;0;362.366008612902;341.338819562748;09;703.704828175651
05;2020-07-11;0;0;0;353.376145114279;370.349735405642;19;723.725880519921
05;2020-07-11;0;0;0;218.593559489256;256.539602589476;29;475.133162078732
05;2020-07-11;0;0;0;404.225408693299;360.321910454353;39;764.547319147651
05;2020-07-11;0;0;0;520.067953604221;497.108383964256;49;1017.17633756848
05;2020-07-11;0;0;0;468.146063921917;510.087601910415;59;978.233665832332
05;2020-07-11;0;0;0;340.368470050554;334.366842191253;69;674.735312241807
05;2020-07-11;0;0;0;212.598666888387;192.597753227106;79;405.196420115493
05;2020-07-11;0;0;0;148.727797095705;61.8681715431829;89;210.595968638888
05;2020-07-11;0;0;0;32.9601271090696;10.9909785719784;90;43.9511056810479
05;2020-07-11;0;0;0;3061.43020057959;2935.56979942041;0;5997
06;2020-07-11;0;0;0;42583;42380;09;84963
06;2020-07-11;0;0;0;33369;31925;19;65294
06;2020-07-11;0;0;0;21571;15080;29;36651
06;2020-07-11;1;0;1;21550;16147;39;37697
06;2020-07-11;0;0;0;14193;13939;49;28132
06;2020-07-11;0;0;0;7171;7597;59;14768
06;2020-07-11;1;0;1;3629;4117;69;7746
06;2020-07-11;0;0;0;1577;1457;79;3034
06;2020-07-11;0;0;0;531;474;89;1005
06;2020-07-11;0;0;0;88;93;90;181
06;2020-07-11;2;0;2;146262;133209;0;279471
07;2020-07-11;0;0;0;485;549;09;1034
07;2020-07-11;0;0;0;403;432;19;835
07;2020-07-11;0;0;0;764;841;29;1605
07;2020-07-11;0;0;0;824;928;39;1752
07;2020-07-11;0;0;0;788;1020;49;1808
07;2020-07-11;0;0;0;678;870;59;1548
07;2020-07-11;0;0;0;360;382;69;742
07;2020-07-11;0;0;0;231;190;79;421
07;2020-07-11;0;0;0;114;67;89;181
07;2020-07-11;0;0;0;24;11;90;35
07;2020-07-11;0;0;0;4671;5290;0;9961
08;2020-07-11;0;0;0;2715.22592983026;2997.75551488675;09;5712.98144471701
08;2020-07-11;0;0;0;2778.51901080978;3160.9156459093;19;5939.43465671908
08;2020-07-11;0;0;0;2080.8882988764;1718.16634315323;29;3799.05464202964
08;2020-07-11;0;0;0;2701.8582062647;1896.52641413317;39;4598.38462039786
08;2020-07-11;0;0;0;3151.45861023308;2460.52498233809;49;5611.98359257117
08;2020-07-11;0;0;0;2620.29868333099;2422.23566154656;59;5042.53434487755
08;2020-07-11;0;0;0;1621.44173420671;1438.58325779464;69;3060.02499200135
08;2020-07-11;0;0;0;626.575909335673;526.358467843651;79;1152.93437717932
08;2020-07-11;0;0;0;205.018522985054;140.993639349697;89;346.012162334751
08;2020-07-11;0;0;0;50.0325684687745;20.62259870351;90;70.6551671722846
08;2020-07-11;0;0;0;18551.3174743414;16782.6825256586;0;35334
11;2020-07-11;3;5;8;783071;811785;09;1594856
11;2020-07-11;2;5;7;761456;784653;19;1546109
11;2020-07-11;8;6;14;850145;801772;29;1651917
11;2020-07-11;5;6;11;914360;843488;39;1757848
11;2020-07-11;4;4;8;845609;826202;49;1671811
11;2020-07-11;4;6;10;793566;745070;59;1538636
11;2020-07-11;5;1;6;628649;549192;69;1177841
11;2020-07-11;3;0;3;434606;358356;79;792962
11;2020-07-11;2;2;4;261425;162933;89;424358
11;2020-07-11;1;1;2;89253;32619;90;121872
11;2020-07-11;37;36;73;6362140;5916070;0;12278210
24;2020-07-11;0;0;0;139720;144686;09;284406
24;2020-07-11;0;0;0;152979;161185;19;314164
24;2020-07-11;0;0;0;122237;126536;29;248773
24;2020-07-11;0;1;1;150359;142009;39;292368
24;2020-07-11;0;0;0;161829;158758;49;320587
24;2020-07-11;0;0;0;172552;168011;59;340563
24;2020-07-11;0;0;0;172509;158177;69;330686
24;2020-07-11;0;0;0;129428;110593;79;240021
24;2020-07-11;0;0;0;87342;56882;89;144224
24;2020-07-11;0;0;0;31210;12071;90;43281
24;2020-07-11;0;1;1;1320165;1238908;0;2559073
27;2020-07-11;0;0;0;143373;149679;09;293052
27;2020-07-11;0;0;0;160962;173003;19;333965
27;2020-07-11;1;2;3;133746;142254;29;276000
27;2020-07-11;0;1;1;160004;155407;39;315411
27;2020-07-11;0;1;1;172333;169564;49;341897
27;2020-07-11;1;1;2;189979;183788;59;373767
27;2020-07-11;2;0;2;192591;178206;69;370797
27;2020-07-11;1;1;2;146876;127546;79;274422
27;2020-07-11;0;0;0;96896;61575;89;158471
27;2020-07-11;0;0;0;33148;12109;90;45257
27;2020-07-11;5;6;11;1429908;1353131;0;2783039
28;2020-07-11;0;0;0;180735;186856;09;367591
28;2020-07-11;1;0;1;200125;213621;19;413746
28;2020-07-11;2;1;3;168922;173007;29;341929
28;2020-07-11;1;0;1;196628;188487;39;385115
28;2020-07-11;1;0;1;205396;201699;49;407095
28;2020-07-11;0;1;1;222002;213866;59;435868
28;2020-07-11;1;0;1;224688;203758;69;428446
28;2020-07-11;0;0;0;163192;135543;79;298735
28;2020-07-11;0;0;0;109691;65377;89;175068
28;2020-07-11;0;0;0;37222;12685;90;49907
28;2020-07-11;6;2;8;1708601;1594899;0;3303500
32;2020-07-11;1;0;1;358062;373689;09;731751
32;2020-07-11;2;4;6;387045;406742;19;793787
32;2020-07-11;1;1;2;342304;348587;29;690891
32;2020-07-11;5;6;11;382485;369972;39;752457
32;2020-07-11;2;2;4;382510;376716;49;759226
32;2020-07-11;3;2;5;386937;376527;59;763464
32;2020-07-11;3;3;6;371211;330938;69;702149
32;2020-07-11;3;3;6;250542;201459;79;452001
32;2020-07-11;1;0;1;163399;89786;89;253185
32;2020-07-11;0;0;0;48384;15367;90;63751
32;2020-07-11;21;21;42;3072879;2889783;0;5962662
44;2020-07-11;0;0;0;291525;306839;09;598364
44;2020-07-11;0;1;1;320255;339504;19;659759
44;2020-07-11;0;1;1;302020;314428;29;616448
44;2020-07-11;0;2;2;342222;333292;39;675514
44;2020-07-11;0;2;2;349727;344491;49;694218
44;2020-07-11;0;0;0;381371;373239;59;754610
44;2020-07-11;0;0;0;367165;335850;69;703015
44;2020-07-11;0;1;1;250387;215436;79;465823
44;2020-07-11;0;0;0;170825;105192;89;276017
44;2020-07-11;0;0;0;51248;16731;90;67979
44;2020-07-11;0;7;7;2826745;2685002;0;5511747
52;2020-07-11;4;1;5;213594;223900;09;437494
52;2020-07-11;2;2;6;240818;255197;19;496015
52;2020-07-11;4;1;5;197010;200630;29;397640
52;2020-07-11;8;8;16;231204;224885;39;456089
52;2020-07-11;4;3;7;243874;243418;49;487292
52;2020-07-11;3;2;5;244100;239116;59;483216
52;2020-07-11;2;2;4;241796;221345;69;463141
52;2020-07-11;0;3;3;177805;149903;79;327708
52;2020-07-11;1;0;1;119561;75822;89;195383
52;2020-07-11;0;0;0;42559;15260;90;57819
52;2020-07-11;28;22;52;1952321;1849476;0;3801797
53;2020-07-11;1;1;2;173813;182358;09;356171
53;2020-07-11;1;0;1;202720;214740;19;417460
53;2020-07-11;0;2;2;163116;173196;29;336312
53;2020-07-11;0;1;1;190526;187674;39;378200
53;2020-07-11;3;2;5;212098;212015;49;424113
53;2020-07-11;0;0;0;223699;219176;59;442875
53;2020-07-11;1;0;1;227435;209274;69;436709
53;2020-07-11;0;0;0;169992;140910;79;310902
53;2020-07-11;0;0;0;118117;69883;89;188000
53;2020-07-11;0;0;0;37370;12267;90;49637
53;2020-07-11;6;6;12;1718886;1621493;0;3340379
75;2020-07-11;0;0;0;293104;305291;09;598395
75;2020-07-11;0;0;0;337141;357785;19;694926
75;2020-07-11;0;1;1;295024;300618;29;595642
75;2020-07-11;0;0;0;347871;331233;39;679104
75;2020-07-11;1;1;2;384742;372771;49;757513
75;2020-07-11;1;0;1;413361;390880;59;804241
75;2020-07-11;0;0;0;425623;384060;69;809683
75;2020-07-11;0;0;0;325086;276298;79;601384
75;2020-07-11;0;0;0;213986;139308;89;353294
75;2020-07-11;0;0;0;77600;28200;90;105800
75;2020-07-11;2;2;4;3113538;2886444;0;5999982
76;2020-07-11;0;0;0;305956;318589;09;624545
76;2020-07-11;0;0;0;338942;356969;19;695911
76;2020-07-11;2;2;4;316210;319570;29;635780
76;2020-07-11;1;1;2;356758;337587;39;694345
76;2020-07-11;0;0;0;376541;363812;49;740353
76;2020-07-11;0;0;0;402608;383750;59;786358
76;2020-07-11;1;0;1;394889;358997;69;753886
76;2020-07-11;0;0;0;308664;263806;79;572470
76;2020-07-11;0;0;0;195838;129272;89;325110
76;2020-07-11;0;0;0;69372;26728;90;96100
76;2020-07-11;4;3;7;3065778;2859080;0;5924858
84;2020-07-11;0;1;1;459549;481088;09;940637
84;2020-07-11;1;2;3;487711;511905;19;999616
84;2020-07-11;3;1;4;443824;451094;29;894918
84;2020-07-11;2;2;4;512522;493262;39;1005784
84;2020-07-11;2;1;3;520248;515106;49;1035354
84;2020-07-11;2;3;5;529611;514848;59;1044459
84;2020-07-11;3;1;4;486720;439940;69;926660
84;2020-07-11;0;1;1;372151;315211;79;687362
84;2020-07-11;0;0;0;237198;150524;89;387722
84;2020-07-11;1;0;1;81185;28680;90;109865
84;2020-07-11;14;12;26;4130719;3901658;0;8032377
93;2020-07-11;2;1;3;268834;283093;09;551927
93;2020-07-11;3;1;4;280751;296087;19;576838
93;2020-07-11;1;1;2;254404;255552;29;509956
93;2020-07-11;0;1;1;310704;288398;39;599102
93;2020-07-11;0;1;1;325559;305827;49;631386
93;2020-07-11;2;1;3;353104;325389;59;678493
93;2020-07-11;0;1;1;336327;296459;69;632786
93;2020-07-11;0;3;3;279820;229699;79;509519
93;2020-07-11;0;0;0;171274;113716;89;284990
93;2020-07-11;0;0;0;58896;21758;90;80654
93;2020-07-11;8;10;18;2639673;2415978;0;5055651
94;2020-07-11;0;0;0;16311;17433;09;33744
94;2020-07-11;0;0;0;16679;18132;19;34811
94;2020-07-11;0;0;0;16782;16579;29;33361
94;2020-07-11;0;1;1;23044;20580;39;43624
94;2020-07-11;0;0;0;23065;22140;49;45205
94;2020-07-11;0;0;0;24549;23421;59;47970
94;2020-07-11;0;0;0;23212;21883;69;45095
94;2020-07-11;0;0;0;19544;17141;79;36685
94;2020-07-11;0;0;0;11227;8178;89;19405
94;2020-07-11;0;0;0;3332;1447;90;4779
94;2020-07-11;0;1;1;177745;166934;0;344679
01;2020-07-12;0;0;0;19979;20155;09;40134
01;2020-07-12;1;0;1;24994;25489;19;50483
01;2020-07-12;0;0;0;17868;16690;29;34558
01;2020-07-12;0;0;0;22328;14821;39;37149
01;2020-07-12;1;0;1;28652;20276;49;48928
01;2020-07-12;0;0;0;33264;27260;59;60524
01;2020-07-12;0;0;0;27135;23978;69;51113
01;2020-07-12;0;0;0;18401;14661;79;33062
01;2020-07-12;0;0;0;9633;6375;89;16008
01;2020-07-12;0;0;0;3410;1510;90;4920
01;2020-07-12;2;0;2;205664;171215;0;376879
02;2020-07-12;0;0;0;16881;17110;09;33991
02;2020-07-12;0;0;0;21410;21604;19;43014
02;2020-07-12;0;0;0;16017;15479;29;31496
02;2020-07-12;0;0;0;19825;14455;39;34280
02;2020-07-12;0;0;0;24719;18248;49;42967
02;2020-07-12;0;0;0;34361;28310;59;62671
02;2020-07-12;0;0;0;28061;24495;69;52556
02;2020-07-12;0;0;0;18231;15278;79;33509
02;2020-07-12;0;0;0;11090;7677;89;18767
02;2020-07-12;0;0;0;3992;1506;90;5498
02;2020-07-12;0;0;0;194587;164162;0;358749
03;2020-07-12;0;0;0;31123;30920;09;62043
03;2020-07-12;2;2;4;29370;29268;19;58638
03;2020-07-12;2;7;9;21458;18963;29;40421
03;2020-07-12;0;0;0;21276;18326;39;39602
03;2020-07-12;3;6;9;18164;16593;49;34757
03;2020-07-12;3;0;3;13469;13557;59;27026
03;2020-07-12;2;1;3;8776;8670;69;17446
03;2020-07-12;1;1;2;3777;3591;79;7368
03;2020-07-12;1;2;3;1649;1072;89;2721
03;2020-07-12;0;0;0;485;184;90;669
03;2020-07-12;14;19;33;149547;141144;0;290691
04;2020-07-12;0;0;0;60314;61377;09;121691
04;2020-07-12;0;0;0;66065;68387;19;134452
04;2020-07-12;0;0;0;51059;47156;29;98215
04;2020-07-12;0;0;0;58788;45780;39;104568
04;2020-07-12;0;0;0;61408;52207;49;113615
04;2020-07-12;0;0;0;64838;60759;59;125597
04;2020-07-12;0;0;0;47008;42843;69;89851
04;2020-07-12;0;0;0;25509;21184;79;46693
04;2020-07-12;0;0;0;13168;7647;89;20815
04;2020-07-12;0;0;0;3209;1253;90;4462
04;2020-07-12;0;0;0;451366;408593;0;859959
05;2020-07-12;0;0;0;362.366008612902;341.338819562748;09;703.704828175651
05;2020-07-12;0;0;0;353.376145114279;370.349735405642;19;723.725880519921
05;2020-07-12;0;0;0;218.593559489256;256.539602589476;29;475.133162078732
05;2020-07-12;0;0;0;404.225408693299;360.321910454353;39;764.547319147651
05;2020-07-12;0;0;0;520.067953604221;497.108383964256;49;1017.17633756848
05;2020-07-12;0;0;0;468.146063921917;510.087601910415;59;978.233665832332
05;2020-07-12;0;0;0;340.368470050554;334.366842191253;69;674.735312241807
05;2020-07-12;0;0;0;212.598666888387;192.597753227106;79;405.196420115493
05;2020-07-12;0;0;0;148.727797095705;61.8681715431829;89;210.595968638888
05;2020-07-12;0;0;0;32.9601271090696;10.9909785719784;90;43.9511056810479
05;2020-07-12;0;0;0;3061.43020057959;2935.56979942041;0;5997
06;2020-07-12;0;0;0;42583;42380;09;84963
06;2020-07-12;1;1;2;33369;31925;19;65294
06;2020-07-12;1;2;3;21571;15080;29;36651
06;2020-07-12;0;0;0;21550;16147;39;37697
06;2020-07-12;0;1;1;14193;13939;49;28132
06;2020-07-12;0;0;0;7171;7597;59;14768
06;2020-07-12;1;0;1;3629;4117;69;7746
06;2020-07-12;0;0;0;1577;1457;79;3034
06;2020-07-12;0;0;0;531;474;89;1005
06;2020-07-12;0;0;0;88;93;90;181
06;2020-07-12;3;4;7;146262;133209;0;279471
07;2020-07-12;0;0;0;485;549;09;1034
07;2020-07-12;0;0;0;403;432;19;835
07;2020-07-12;0;0;0;764;841;29;1605
07;2020-07-12;0;0;0;824;928;39;1752
07;2020-07-12;0;0;0;788;1020;49;1808
07;2020-07-12;0;0;0;678;870;59;1548
07;2020-07-12;0;0;0;360;382;69;742
07;2020-07-12;0;0;0;231;190;79;421
07;2020-07-12;0;0;0;114;67;89;181
07;2020-07-12;0;0;0;24;11;90;35
07;2020-07-12;0;0;0;4671;5290;0;9961
08;2020-07-12;0;0;0;2715.22592983026;2997.75551488675;09;5712.98144471701
08;2020-07-12;0;0;0;2778.51901080978;3160.9156459093;19;5939.43465671908
08;2020-07-12;0;0;0;2080.8882988764;1718.16634315323;29;3799.05464202964
08;2020-07-12;0;0;0;2701.8582062647;1896.52641413317;39;4598.38462039786
08;2020-07-12;0;0;0;3151.45861023308;2460.52498233809;49;5611.98359257117
08;2020-07-12;0;0;0;2620.29868333099;2422.23566154656;59;5042.53434487755
08;2020-07-12;0;0;0;1621.44173420671;1438.58325779464;69;3060.02499200135
08;2020-07-12;0;0;0;626.575909335673;526.358467843651;79;1152.93437717932
08;2020-07-12;0;0;0;205.018522985054;140.993639349697;89;346.012162334751
08;2020-07-12;0;0;0;50.0325684687745;20.62259870351;90;70.6551671722846
08;2020-07-12;0;0;0;18551.3174743414;16782.6825256586;0;35334
11;2020-07-12;0;0;0;783071;811785;09;1594856
11;2020-07-12;0;0;0;761456;784653;19;1546109
11;2020-07-12;2;2;4;850145;801772;29;1651917
11;2020-07-12;1;1;2;914360;843488;39;1757848
11;2020-07-12;2;0;2;845609;826202;49;1671811
11;2020-07-12;1;1;2;793566;745070;59;1538636
11;2020-07-12;1;2;3;628649;549192;69;1177841
11;2020-07-12;0;0;0;434606;358356;79;792962
11;2020-07-12;0;1;1;261425;162933;89;424358
11;2020-07-12;1;0;1;89253;32619;90;121872
11;2020-07-12;8;7;15;6362140;5916070;0;12278210
24;2020-07-12;1;0;1;139720;144686;09;284406
24;2020-07-12;0;0;0;152979;161185;19;314164
24;2020-07-12;0;0;0;122237;126536;29;248773
24;2020-07-12;0;0;0;150359;142009;39;292368
24;2020-07-12;0;1;1;161829;158758;49;320587
24;2020-07-12;0;0;0;172552;168011;59;340563
24;2020-07-12;0;0;0;172509;158177;69;330686
24;2020-07-12;0;0;0;129428;110593;79;240021
24;2020-07-12;0;0;0;87342;56882;89;144224
24;2020-07-12;0;0;0;31210;12071;90;43281
24;2020-07-12;1;1;2;1320165;1238908;0;2559073
27;2020-07-12;0;0;0;143373;149679;09;293052
27;2020-07-12;0;0;0;160962;173003;19;333965
27;2020-07-12;0;0;0;133746;142254;29;276000
27;2020-07-12;0;0;0;160004;155407;39;315411
27;2020-07-12;1;0;1;172333;169564;49;341897
27;2020-07-12;1;1;2;189979;183788;59;373767
27;2020-07-12;0;2;2;192591;178206;69;370797
27;2020-07-12;0;0;0;146876;127546;79;274422
27;2020-07-12;0;0;0;96896;61575;89;158471
27;2020-07-12;1;0;1;33148;12109;90;45257
27;2020-07-12;3;3;6;1429908;1353131;0;2783039
28;2020-07-12;0;0;0;180735;186856;09;367591
28;2020-07-12;1;0;1;200125;213621;19;413746
28;2020-07-12;0;0;0;168922;173007;29;341929
28;2020-07-12;0;1;1;196628;188487;39;385115
28;2020-07-12;1;0;1;205396;201699;49;407095
28;2020-07-12;0;0;0;222002;213866;59;435868
28;2020-07-12;0;1;1;224688;203758;69;428446
28;2020-07-12;0;0;0;163192;135543;79;298735
28;2020-07-12;0;0;0;109691;65377;89;175068
28;2020-07-12;1;0;1;37222;12685;90;49907
28;2020-07-12;3;2;5;1708601;1594899;0;3303500
32;2020-07-12;0;0;0;358062;373689;09;731751
32;2020-07-12;2;0;2;387045;406742;19;793787
32;2020-07-12;1;0;1;342304;348587;29;690891
32;2020-07-12;0;0;0;382485;369972;39;752457
32;2020-07-12;2;0;2;382510;376716;49;759226
32;2020-07-12;1;1;2;386937;376527;59;763464
32;2020-07-12;0;0;0;371211;330938;69;702149
32;2020-07-12;0;0;0;250542;201459;79;452001
32;2020-07-12;1;0;1;163399;89786;89;253185
32;2020-07-12;0;0;0;48384;15367;90;63751
32;2020-07-12;7;1;8;3072879;2889783;0;5962662
44;2020-07-12;0;0;0;291525;306839;09;598364
44;2020-07-12;0;0;0;320255;339504;19;659759
44;2020-07-12;1;0;1;302020;314428;29;616448
44;2020-07-12;0;0;0;342222;333292;39;675514
44;2020-07-12;1;1;2;349727;344491;49;694218
44;2020-07-12;0;1;1;381371;373239;59;754610
44;2020-07-12;0;0;0;367165;335850;69;703015
44;2020-07-12;0;1;1;250387;215436;79;465823
44;2020-07-12;0;0;0;170825;105192;89;276017
44;2020-07-12;0;0;0;51248;16731;90;67979
44;2020-07-12;2;3;5;2826745;2685002;0;5511747
52;2020-07-12;1;0;2;213594;223900;09;437494
52;2020-07-12;4;1;6;240818;255197;19;496015
52;2020-07-12;2;1;3;197010;200630;29;397640
52;2020-07-12;2;0;2;231204;224885;39;456089
52;2020-07-12;0;0;0;243874;243418;49;487292
52;2020-07-12;0;1;1;244100;239116;59;483216
52;2020-07-12;0;0;0;241796;221345;69;463141
52;2020-07-12;0;0;0;177805;149903;79;327708
52;2020-07-12;1;1;2;119561;75822;89;195383
52;2020-07-12;0;0;0;42559;15260;90;57819
52;2020-07-12;10;4;16;1952321;1849476;0;3801797
53;2020-07-12;0;0;0;173813;182358;09;356171
53;2020-07-12;0;0;0;202720;214740;19;417460
53;2020-07-12;1;0;1;163116;173196;29;336312
53;2020-07-12;1;0;1;190526;187674;39;378200
53;2020-07-12;0;0;0;212098;212015;49;424113
53;2020-07-12;0;0;0;223699;219176;59;442875
53;2020-07-12;0;0;0;227435;209274;69;436709
53;2020-07-12;0;1;1;169992;140910;79;310902
53;2020-07-12;0;0;0;118117;69883;89;188000
53;2020-07-12;0;0;0;37370;12267;90;49637
53;2020-07-12;2;1;3;1718886;1621493;0;3340379
75;2020-07-12;0;0;0;293104;305291;09;598395
75;2020-07-12;0;0;0;337141;357785;19;694926
75;2020-07-12;0;0;0;295024;300618;29;595642
75;2020-07-12;0;0;0;347871;331233;39;679104
75;2020-07-12;0;0;0;384742;372771;49;757513
75;2020-07-12;0;0;0;413361;390880;59;804241
75;2020-07-12;0;0;0;425623;384060;69;809683
75;2020-07-12;0;0;0;325086;276298;79;601384
75;2020-07-12;0;1;1;213986;139308;89;353294
75;2020-07-12;0;0;0;77600;28200;90;105800
75;2020-07-12;0;1;1;3113538;2886444;0;5999982
76;2020-07-12;0;0;0;305956;318589;09;624545
76;2020-07-12;0;0;0;338942;356969;19;695911
76;2020-07-12;1;0;1;316210;319570;29;635780
76;2020-07-12;0;1;1;356758;337587;39;694345
76;2020-07-12;0;0;0;376541;363812;49;740353
76;2020-07-12;0;0;0;402608;383750;59;786358
76;2020-07-12;0;0;0;394889;358997;69;753886
76;2020-07-12;0;0;0;308664;263806;79;572470
76;2020-07-12;0;1;1;195838;129272;89;325110
76;2020-07-12;0;0;0;69372;26728;90;96100
76;2020-07-12;1;2;3;3065778;2859080;0;5924858
84;2020-07-12;0;1;1;459549;481088;09;940637
84;2020-07-12;0;0;0;487711;511905;19;999616
84;2020-07-12;0;0;0;443824;451094;29;894918
84;2020-07-12;0;0;0;512522;493262;39;1005784
84;2020-07-12;0;0;0;520248;515106;49;1035354
84;2020-07-12;0;1;1;529611;514848;59;1044459
84;2020-07-12;0;0;0;486720;439940;69;926660
84;2020-07-12;1;0;1;372151;315211;79;687362
84;2020-07-12;1;1;2;237198;150524;89;387722
84;2020-07-12;0;1;1;81185;28680;90;109865
84;2020-07-12;2;4;6;4130719;3901658;0;8032377
93;2020-07-12;0;0;0;268834;283093;09;551927
93;2020-07-12;0;0;0;280751;296087;19;576838
93;2020-07-12;0;0;0;254404;255552;29;509956
93;2020-07-12;0;0;0;310704;288398;39;599102
93;2020-07-12;1;0;1;325559;305827;49;631386
93;2020-07-12;0;0;0;353104;325389;59;678493
93;2020-07-12;0;0;0;336327;296459;69;632786
93;2020-07-12;1;1;2;279820;229699;79;509519
93;2020-07-12;0;1;1;171274;113716;89;284990
93;2020-07-12;0;0;0;58896;21758;90;80654
93;2020-07-12;2;2;4;2639673;2415978;0;5055651
94;2020-07-12;0;0;0;16311;17433;09;33744
94;2020-07-12;0;0;0;16679;18132;19;34811
94;2020-07-12;0;0;0;16782;16579;29;33361
94;2020-07-12;0;0;0;23044;20580;39;43624
94;2020-07-12;0;0;0;23065;22140;49;45205
94;2020-07-12;0;0;0;24549;23421;59;47970
94;2020-07-12;0;0;0;23212;21883;69;45095
94;2020-07-12;0;0;0;19544;17141;79;36685
94;2020-07-12;0;0;0;11227;8178;89;19405
94;2020-07-12;0;0;0;3332;1447;90;4779
94;2020-07-12;0;0;0;177745;166934;0;344679
01;2020-07-13;0;0;0;19979;20155;09;40134
01;2020-07-13;0;0;0;24994;25489;19;50483
01;2020-07-13;1;0;1;17868;16690;29;34558
01;2020-07-13;0;0;0;22328;14821;39;37149
01;2020-07-13;0;0;0;28652;20276;49;48928
01;2020-07-13;0;0;0;33264;27260;59;60524
01;2020-07-13;0;1;1;27135;23978;69;51113
01;2020-07-13;0;0;0;18401;14661;79;33062
01;2020-07-13;0;0;0;9633;6375;89;16008
01;2020-07-13;0;0;0;3410;1510;90;4920
01;2020-07-13;1;1;2;205664;171215;0;376879
02;2020-07-13;0;0;0;16881;17110;09;33991
02;2020-07-13;0;0;0;21410;21604;19;43014
02;2020-07-13;1;0;1;16017;15479;29;31496
02;2020-07-13;0;1;1;19825;14455;39;34280
02;2020-07-13;0;0;0;24719;18248;49;42967
02;2020-07-13;1;0;1;34361;28310;59;62671
02;2020-07-13;0;0;0;28061;24495;69;52556
02;2020-07-13;0;0;0;18231;15278;79;33509
02;2020-07-13;0;0;0;11090;7677;89;18767
02;2020-07-13;0;0;0;3992;1506;90;5498
02;2020-07-13;2;1;3;194587;164162;0;358749
03;2020-07-13;1;6;7;31123;30920;09;62043
03;2020-07-13;11;12;23;29370;29268;19;58638
03;2020-07-13;20;13;33;21458;18963;29;40421
03;2020-07-13;15;5;20;21276;18326;39;39602
03;2020-07-13;14;15;29;18164;16593;49;34757
03;2020-07-13;6;9;15;13469;13557;59;27026
03;2020-07-13;4;2;6;8776;8670;69;17446
03;2020-07-13;0;2;2;3777;3591;79;7368
03;2020-07-13;0;0;0;1649;1072;89;2721
03;2020-07-13;0;0;0;485;184;90;669
03;2020-07-13;71;64;135;149547;141144;0;290691
04;2020-07-13;1;1;2;60314;61377;09;121691
04;2020-07-13;0;0;0;66065;68387;19;134452
04;2020-07-13;0;0;0;51059;47156;29;98215
04;2020-07-13;0;1;1;58788;45780;39;104568
04;2020-07-13;3;1;4;61408;52207;49;113615
04;2020-07-13;0;0;0;64838;60759;59;125597
04;2020-07-13;0;0;0;47008;42843;69;89851
04;2020-07-13;0;0;0;25509;21184;79;46693
04;2020-07-13;0;0;0;13168;7647;89;20815
04;2020-07-13;0;0;0;3209;1253;90;4462
04;2020-07-13;4;3;7;451366;408593;0;859959
05;2020-07-13;0;0;0;362.366008612902;341.338819562748;09;703.704828175651
05;2020-07-13;0;0;0;353.376145114279;370.349735405642;19;723.725880519921
05;2020-07-13;0;0;0;218.593559489256;256.539602589476;29;475.133162078732
05;2020-07-13;0;0;0;404.225408693299;360.321910454353;39;764.547319147651
05;2020-07-13;0;0;0;520.067953604221;497.108383964256;49;1017.17633756848
05;2020-07-13;0;0;0;468.146063921917;510.087601910415;59;978.233665832332
05;2020-07-13;0;0;0;340.368470050554;334.366842191253;69;674.735312241807
05;2020-07-13;0;0;0;212.598666888387;192.597753227106;79;405.196420115493
05;2020-07-13;0;0;0;148.727797095705;61.8681715431829;89;210.595968638888
05;2020-07-13;0;0;0;32.9601271090696;10.9909785719784;90;43.9511056810479
05;2020-07-13;0;0;0;3061.43020057959;2935.56979942041;0;5997
06;2020-07-13;0;1;1;42583;42380;09;84963
06;2020-07-13;1;2;3;33369;31925;19;65294
06;2020-07-13;1;3;4;21571;15080;29;36651
06;2020-07-13;4;0;4;21550;16147;39;37697
06;2020-07-13;1;3;4;14193;13939;49;28132
06;2020-07-13;0;0;0;7171;7597;59;14768
06;2020-07-13;0;0;0;3629;4117;69;7746
06;2020-07-13;0;0;0;1577;1457;79;3034
06;2020-07-13;0;0;0;531;474;89;1005
06;2020-07-13;0;0;0;88;93;90;181
06;2020-07-13;7;9;16;146262;133209;0;279471
07;2020-07-13;0;0;0;485;549;09;1034
07;2020-07-13;0;0;0;403;432;19;835
07;2020-07-13;0;0;0;764;841;29;1605
07;2020-07-13;0;0;0;824;928;39;1752
07;2020-07-13;0;0;0;788;1020;49;1808
07;2020-07-13;0;0;0;678;870;59;1548
07;2020-07-13;0;0;0;360;382;69;742
07;2020-07-13;0;0;0;231;190;79;421
07;2020-07-13;0;0;0;114;67;89;181
07;2020-07-13;0;0;0;24;11;90;35
07;2020-07-13;0;0;0;4671;5290;0;9961
08;2020-07-13;0;0;0;2715.22592983026;2997.75551488675;09;5712.98144471701
08;2020-07-13;0;0;0;2778.51901080978;3160.9156459093;19;5939.43465671908
08;2020-07-13;0;0;0;2080.8882988764;1718.16634315323;29;3799.05464202964
08;2020-07-13;0;0;0;2701.8582062647;1896.52641413317;39;4598.38462039786
08;2020-07-13;0;0;0;3151.45861023308;2460.52498233809;49;5611.98359257117
08;2020-07-13;0;0;0;2620.29868333099;2422.23566154656;59;5042.53434487755
08;2020-07-13;0;0;0;1621.44173420671;1438.58325779464;69;3060.02499200135
08;2020-07-13;0;0;0;626.575909335673;526.358467843651;79;1152.93437717932
08;2020-07-13;0;0;0;205.018522985054;140.993639349697;89;346.012162334751
08;2020-07-13;0;0;0;50.0325684687745;20.62259870351;90;70.6551671722846
08;2020-07-13;0;0;0;18551.3174743414;16782.6825256586;0;35334
11;2020-07-13;5;5;10;783071;811785;09;1594856
11;2020-07-13;17;11;28;761456;784653;19;1546109
11;2020-07-13;29;19;48;850145;801772;29;1651917
11;2020-07-13;25;22;47;914360;843488;39;1757848
11;2020-07-13;11;12;23;845609;826202;49;1671811
11;2020-07-13;21;19;40;793566;745070;59;1538636
11;2020-07-13;11;9;20;628649;549192;69;1177841
11;2020-07-13;4;9;13;434606;358356;79;792962
11;2020-07-13;2;3;5;261425;162933;89;424358
11;2020-07-13;3;1;4;89253;32619;90;121872
11;2020-07-13;128;110;238;6362140;5916070;0;12278210
24;2020-07-13;0;0;0;139720;144686;09;284406
24;2020-07-13;0;0;0;152979;161185;19;314164
24;2020-07-13;0;0;0;122237;126536;29;248773
24;2020-07-13;0;0;0;150359;142009;39;292368
24;2020-07-13;1;0;1;161829;158758;49;320587
24;2020-07-13;1;1;2;172552;168011;59;340563
24;2020-07-13;1;0;1;172509;158177;69;330686
24;2020-07-13;1;1;2;129428;110593;79;240021
24;2020-07-13;0;0;0;87342;56882;89;144224
24;2020-07-13;0;0;0;31210;12071;90;43281
24;2020-07-13;4;2;6;1320165;1238908;0;2559073
27;2020-07-13;0;1;1;143373;149679;09;293052
27;2020-07-13;0;0;0;160962;173003;19;333965
27;2020-07-13;4;1;5;133746;142254;29;276000
27;2020-07-13;1;1;2;160004;155407;39;315411
27;2020-07-13;0;1;1;172333;169564;49;341897
27;2020-07-13;0;1;1;189979;183788;59;373767
27;2020-07-13;1;1;2;192591;178206;69;370797
27;2020-07-13;0;2;2;146876;127546;79;274422
27;2020-07-13;0;0;0;96896;61575;89;158471
27;2020-07-13;0;0;0;33148;12109;90;45257
27;2020-07-13;6;8;14;1429908;1353131;0;2783039
28;2020-07-13;3;1;4;180735;186856;09;367591
28;2020-07-13;3;1;4;200125;213621;19;413746
28;2020-07-13;3;1;4;168922;173007;29;341929
28;2020-07-13;2;0;2;196628;188487;39;385115
28;2020-07-13;1;0;1;205396;201699;49;407095
28;2020-07-13;1;0;1;222002;213866;59;435868
28;2020-07-13;1;0;1;224688;203758;69;428446
28;2020-07-13;0;0;0;163192;135543;79;298735
28;2020-07-13;2;0;2;109691;65377;89;175068
28;2020-07-13;0;0;0;37222;12685;90;49907
28;2020-07-13;16;3;19;1708601;1594899;0;3303500
32;2020-07-13;3;5;8;358062;373689;09;731751
32;2020-07-13;1;5;6;387045;406742;19;793787
32;2020-07-13;3;10;13;342304;348587;29;690891
32;2020-07-13;3;4;7;382485;369972;39;752457
32;2020-07-13;2;2;4;382510;376716;49;759226
32;2020-07-13;3;4;7;386937;376527;59;763464
32;2020-07-13;5;3;8;371211;330938;69;702149
32;2020-07-13;5;1;6;250542;201459;79;452001
32;2020-07-13;0;1;1;163399;89786;89;253185
32;2020-07-13;1;0;1;48384;15367;90;63751
32;2020-07-13;26;35;61;3072879;2889783;0;5962662
44;2020-07-13;0;0;0;291525;306839;09;598364
44;2020-07-13;1;2;4;320255;339504;19;659759
44;2020-07-13;4;2;6;302020;314428;29;616448
44;2020-07-13;5;6;11;342222;333292;39;675514
44;2020-07-13;3;4;7;349727;344491;49;694218
44;2020-07-13;5;2;7;381371;373239;59;754610
44;2020-07-13;3;4;7;367165;335850;69;703015
44;2020-07-13;4;3;7;250387;215436;79;465823
44;2020-07-13;3;1;4;170825;105192;89;276017
44;2020-07-13;1;0;1;51248;16731;90;67979
44;2020-07-13;29;24;54;2826745;2685002;0;5511747
52;2020-07-13;3;8;12;213594;223900;09;437494
52;2020-07-13;2;5;8;240818;255197;19;496015
52;2020-07-13;9;6;15;197010;200630;29;397640
52;2020-07-13;8;9;17;231204;224885;39;456089
52;2020-07-13;7;2;9;243874;243418;49;487292
52;2020-07-13;5;5;10;244100;239116;59;483216
52;2020-07-13;3;3;6;241796;221345;69;463141
52;2020-07-13;2;3;5;177805;149903;79;327708
52;2020-07-13;1;0;1;119561;75822;89;195383
52;2020-07-13;1;0;1;42559;15260;90;57819
52;2020-07-13;41;41;84;1952321;1849476;0;3801797
53;2020-07-13;1;2;3;173813;182358;09;356171
53;2020-07-13;4;4;8;202720;214740;19;417460
53;2020-07-13;5;3;8;163116;173196;29;336312
53;2020-07-13;8;4;12;190526;187674;39;378200
53;2020-07-13;2;4;6;212098;212015;49;424113
53;2020-07-13;1;6;7;223699;219176;59;442875
53;2020-07-13;3;2;5;227435;209274;69;436709
53;2020-07-13;1;2;3;169992;140910;79;310902
53;2020-07-13;0;2;2;118117;69883;89;188000
53;2020-07-13;1;0;1;37370;12267;90;49637
53;2020-07-13;26;29;55;1718886;1621493;0;3340379
75;2020-07-13;0;1;1;293104;305291;09;598395
75;2020-07-13;0;2;2;337141;357785;19;694926
75;2020-07-13;4;1;5;295024;300618;29;595642
75;2020-07-13;2;3;5;347871;331233;39;679104
75;2020-07-13;3;0;3;384742;372771;49;757513
75;2020-07-13;0;0;0;413361;390880;59;804241
75;2020-07-13;1;0;1;425623;384060;69;809683
75;2020-07-13;0;0;0;325086;276298;79;601384
75;2020-07-13;0;0;0;213986;139308;89;353294
75;2020-07-13;0;0;0;77600;28200;90;105800
75;2020-07-13;10;7;17;3113538;2886444;0;5999982
76;2020-07-13;1;0;1;305956;318589;09;624545
76;2020-07-13;1;1;2;338942;356969;19;695911
76;2020-07-13;3;2;5;316210;319570;29;635780
76;2020-07-13;2;2;4;356758;337587;39;694345
76;2020-07-13;2;2;4;376541;363812;49;740353
76;2020-07-13;1;2;3;402608;383750;59;786358
76;2020-07-13;2;0;2;394889;358997;69;753886
76;2020-07-13;0;1;1;308664;263806;79;572470
76;2020-07-13;0;0;0;195838;129272;89;325110
76;2020-07-13;0;0;0;69372;26728;90;96100
76;2020-07-13;12;10;22;3065778;2859080;0;5924858
84;2020-07-13;5;0;5;459549;481088;09;940637
84;2020-07-13;5;5;10;487711;511905;19;999616
84;2020-07-13;6;9;15;443824;451094;29;894918
84;2020-07-13;4;7;11;512522;493262;39;1005784
84;2020-07-13;2;4;6;520248;515106;49;1035354
84;2020-07-13;0;7;7;529611;514848;59;1044459
84;2020-07-13;2;4;6;486720;439940;69;926660
84;2020-07-13;5;3;8;372151;315211;79;687362
84;2020-07-13;1;1;2;237198;150524;89;387722
84;2020-07-13;2;2;4;81185;28680;90;109865
84;2020-07-13;32;42;74;4130719;3901658;0;8032377
93;2020-07-13;2;0;2;268834;283093;09;551927
93;2020-07-13;6;4;10;280751;296087;19;576838
93;2020-07-13;4;7;11;254404;255552;29;509956
93;2020-07-13;6;4;10;310704;288398;39;599102
93;2020-07-13;7;8;15;325559;305827;49;631386
93;2020-07-13;4;4;8;353104;325389;59;678493
93;2020-07-13;1;2;3;336327;296459;69;632786
93;2020-07-13;1;0;1;279820;229699;79;509519
93;2020-07-13;0;2;2;171274;113716;89;284990
93;2020-07-13;0;0;0;58896;21758;90;80654
93;2020-07-13;31;31;62;2639673;2415978;0;5055651
94;2020-07-13;0;1;1;16311;17433;09;33744
94;2020-07-13;0;0;0;16679;18132;19;34811
94;2020-07-13;2;0;2;16782;16579;29;33361
94;2020-07-13;1;0;1;23044;20580;39;43624
94;2020-07-13;0;1;1;23065;22140;49;45205
94;2020-07-13;0;0;0;24549;23421;59;47970
94;2020-07-13;0;0;0;23212;21883;69;45095
94;2020-07-13;0;1;1;19544;17141;79;36685
94;2020-07-13;0;0;0;11227;8178;89;19405
94;2020-07-13;0;0;0;3332;1447;90;4779
94;2020-07-13;3;3;6;177745;166934;0;344679
01;2020-07-14;0;0;0;19979;20155;09;40134
01;2020-07-14;0;0;0;24994;25489;19;50483
01;2020-07-14;0;0;0;17868;16690;29;34558
01;2020-07-14;0;0;0;22328;14821;39;37149
01;2020-07-14;0;0;0;28652;20276;49;48928
01;2020-07-14;0;0;0;33264;27260;59;60524
01;2020-07-14;0;0;0;27135;23978;69;51113
01;2020-07-14;0;0;0;18401;14661;79;33062
01;2020-07-14;0;0;0;9633;6375;89;16008
01;2020-07-14;0;0;0;3410;1510;90;4920
01;2020-07-14;0;0;0;205664;171215;0;376879
02;2020-07-14;0;0;0;16881;17110;09;33991
02;2020-07-14;0;0;0;21410;21604;19;43014
02;2020-07-14;0;0;0;16017;15479;29;31496
02;2020-07-14;0;0;0;19825;14455;39;34280
02;2020-07-14;0;0;0;24719;18248;49;42967
02;2020-07-14;0;0;0;34361;28310;59;62671
02;2020-07-14;0;0;0;28061;24495;69;52556
02;2020-07-14;0;0;0;18231;15278;79;33509
02;2020-07-14;0;0;0;11090;7677;89;18767
02;2020-07-14;0;0;0;3992;1506;90;5498
02;2020-07-14;0;0;0;194587;164162;0;358749
03;2020-07-14;1;1;2;31123;30920;09;62043
03;2020-07-14;8;1;9;29370;29268;19;58638
03;2020-07-14;11;5;16;21458;18963;29;40421
03;2020-07-14;6;4;10;21276;18326;39;39602
03;2020-07-14;5;6;11;18164;16593;49;34757
03;2020-07-14;8;9;17;13469;13557;59;27026
03;2020-07-14;1;4;5;8776;8670;69;17446
03;2020-07-14;0;1;1;3777;3591;79;7368
03;2020-07-14;0;0;0;1649;1072;89;2721
03;2020-07-14;0;0;0;485;184;90;669
03;2020-07-14;40;31;71;149547;141144;0;290691
04;2020-07-14;0;0;0;60314;61377;09;121691
04;2020-07-14;0;0;0;66065;68387;19;134452
04;2020-07-14;0;0;0;51059;47156;29;98215
04;2020-07-14;0;0;0;58788;45780;39;104568
04;2020-07-14;0;0;0;61408;52207;49;113615
04;2020-07-14;0;0;0;64838;60759;59;125597
04;2020-07-14;0;1;1;47008;42843;69;89851
04;2020-07-14;0;0;0;25509;21184;79;46693
04;2020-07-14;0;0;0;13168;7647;89;20815
04;2020-07-14;0;0;0;3209;1253;90;4462
04;2020-07-14;0;1;1;451366;408593;0;859959
05;2020-07-14;0;0;0;362.366008612902;341.338819562748;09;703.704828175651
05;2020-07-14;0;0;0;353.376145114279;370.349735405642;19;723.725880519921
05;2020-07-14;0;0;0;218.593559489256;256.539602589476;29;475.133162078732
05;2020-07-14;0;0;0;404.225408693299;360.321910454353;39;764.547319147651
05;2020-07-14;0;0;0;520.067953604221;497.108383964256;49;1017.17633756848
05;2020-07-14;0;0;0;468.146063921917;510.087601910415;59;978.233665832332
05;2020-07-14;0;0;0;340.368470050554;334.366842191253;69;674.735312241807
05;2020-07-14;0;0;0;212.598666888387;192.597753227106;79;405.196420115493
05;2020-07-14;0;0;0;148.727797095705;61.8681715431829;89;210.595968638888
05;2020-07-14;0;0;0;32.9601271090696;10.9909785719784;90;43.9511056810479
05;2020-07-14;0;0;0;3061.43020057959;2935.56979942041;0;5997
06;2020-07-14;0;0;0;42583;42380;09;84963
06;2020-07-14;0;2;2;33369;31925;19;65294
06;2020-07-14;0;3;3;21571;15080;29;36651
06;2020-07-14;0;1;1;21550;16147;39;37697
06;2020-07-14;0;0;0;14193;13939;49;28132
06;2020-07-14;0;0;0;7171;7597;59;14768
06;2020-07-14;0;1;1;3629;4117;69;7746
06;2020-07-14;0;0;0;1577;1457;79;3034
06;2020-07-14;0;0;0;531;474;89;1005
06;2020-07-14;0;0;0;88;93;90;181
06;2020-07-14;0;7;7;146262;133209;0;279471
07;2020-07-14;0;0;0;485;549;09;1034
07;2020-07-14;0;0;0;403;432;19;835
07;2020-07-14;0;0;0;764;841;29;1605
07;2020-07-14;0;0;0;824;928;39;1752
07;2020-07-14;0;0;0;788;1020;49;1808
07;2020-07-14;0;0;0;678;870;59;1548
07;2020-07-14;0;0;0;360;382;69;742
07;2020-07-14;0;0;0;231;190;79;421
07;2020-07-14;0;0;0;114;67;89;181
07;2020-07-14;0;0;0;24;11;90;35
07;2020-07-14;0;0;0;4671;5290;0;9961
08;2020-07-14;0;0;0;2715.22592983026;2997.75551488675;09;5712.98144471701
08;2020-07-14;0;0;0;2778.51901080978;3160.9156459093;19;5939.43465671908
08;2020-07-14;0;0;0;2080.8882988764;1718.16634315323;29;3799.05464202964
08;2020-07-14;0;0;0;2701.8582062647;1896.52641413317;39;4598.38462039786
08;2020-07-14;0;0;0;3151.45861023308;2460.52498233809;49;5611.98359257117
08;2020-07-14;0;0;0;2620.29868333099;2422.23566154656;59;5042.53434487755
08;2020-07-14;0;0;0;1621.44173420671;1438.58325779464;69;3060.02499200135
08;2020-07-14;0;0;0;626.575909335673;526.358467843651;79;1152.93437717932
08;2020-07-14;0;0;0;205.018522985054;140.993639349697;89;346.012162334751
08;2020-07-14;0;0;0;50.0325684687745;20.62259870351;90;70.6551671722846
08;2020-07-14;0;0;0;18551.3174743414;16782.6825256586;0;35334
11;2020-07-14;1;0;1;783071;811785;09;1594856
11;2020-07-14;0;0;0;761456;784653;19;1546109
11;2020-07-14;3;4;7;850145;801772;29;1651917
11;2020-07-14;2;3;5;914360;843488;39;1757848
11;2020-07-14;1;5;6;845609;826202;49;1671811
11;2020-07-14;0;3;3;793566;745070;59;1538636
11;2020-07-14;2;4;6;628649;549192;69;1177841
11;2020-07-14;1;2;3;434606;358356;79;792962
11;2020-07-14;1;3;4;261425;162933;89;424358
11;2020-07-14;0;0;0;89253;32619;90;121872
11;2020-07-14;11;24;35;6362140;5916070;0;12278210
24;2020-07-14;0;0;0;139720;144686;09;284406
24;2020-07-14;0;0;0;152979;161185;19;314164
24;2020-07-14;0;0;0;122237;126536;29;248773
24;2020-07-14;0;0;0;150359;142009;39;292368
24;2020-07-14;0;0;0;161829;158758;49;320587
24;2020-07-14;0;0;0;172552;168011;59;340563
24;2020-07-14;0;0;0;172509;158177;69;330686
24;2020-07-14;0;0;0;129428;110593;79;240021
24;2020-07-14;0;1;1;87342;56882;89;144224
24;2020-07-14;0;0;0;31210;12071;90;43281
24;2020-07-14;0;1;1;1320165;1238908;0;2559073
27;2020-07-14;0;0;0;143373;149679;09;293052
27;2020-07-14;0;0;0;160962;173003;19;333965
27;2020-07-14;0;0;0;133746;142254;29;276000
27;2020-07-14;0;0;0;160004;155407;39;315411
27;2020-07-14;0;1;1;172333;169564;49;341897
27;2020-07-14;0;0;0;189979;183788;59;373767
27;2020-07-14;0;2;2;192591;178206;69;370797
27;2020-07-14;0;0;0;146876;127546;79;274422
27;2020-07-14;1;0;1;96896;61575;89;158471
27;2020-07-14;0;0;0;33148;12109;90;45257
27;2020-07-14;1;3;4;1429908;1353131;0;2783039
28;2020-07-14;0;1;1;180735;186856;09;367591
28;2020-07-14;0;1;1;200125;213621;19;413746
28;2020-07-14;1;0;1;168922;173007;29;341929
28;2020-07-14;0;1;1;196628;188487;39;385115
28;2020-07-14;1;1;2;205396;201699;49;407095
28;2020-07-14;1;0;1;222002;213866;59;435868
28;2020-07-14;0;0;0;224688;203758;69;428446
28;2020-07-14;0;0;0;163192;135543;79;298735
28;2020-07-14;0;0;0;109691;65377;89;175068
28;2020-07-14;0;0;0;37222;12685;90;49907
28;2020-07-14;3;4;7;1708601;1594899;0;3303500
32;2020-07-14;0;0;0;358062;373689;09;731751
32;2020-07-14;2;1;3;387045;406742;19;793787
32;2020-07-14;0;2;2;342304;348587;29;690891
32;2020-07-14;0;1;1;382485;369972;39;752457
32;2020-07-14;2;0;2;382510;376716;49;759226
32;2020-07-14;0;0;0;386937;376527;59;763464
32;2020-07-14;0;0;0;371211;330938;69;702149
32;2020-07-14;0;1;1;250542;201459;79;452001
32;2020-07-14;2;0;2;163399;89786;89;253185
32;2020-07-14;0;0;0;48384;15367;90;63751
32;2020-07-14;6;5;11;3072879;2889783;0;5962662
44;2020-07-14;0;0;0;291525;306839;09;598364
44;2020-07-14;0;0;0;320255;339504;19;659759
44;2020-07-14;1;1;2;302020;314428;29;616448
44;2020-07-14;1;1;2;342222;333292;39;675514
44;2020-07-14;2;0;2;349727;344491;49;694218
44;2020-07-14;1;1;2;381371;373239;59;754610
44;2020-07-14;0;0;0;367165;335850;69;703015
44;2020-07-14;0;0;0;250387;215436;79;465823
44;2020-07-14;0;0;0;170825;105192;89;276017
44;2020-07-14;0;0;0;51248;16731;90;67979
44;2020-07-14;5;3;8;2826745;2685002;0;5511747
52;2020-07-14;2;3;5;213594;223900;09;437494
52;2020-07-14;2;1;3;240818;255197;19;496015
52;2020-07-14;1;0;1;197010;200630;29;397640
52;2020-07-14;2;0;2;231204;224885;39;456089
52;2020-07-14;1;0;1;243874;243418;49;487292
52;2020-07-14;0;1;1;244100;239116;59;483216
52;2020-07-14;0;0;0;241796;221345;69;463141
52;2020-07-14;0;1;1;177805;149903;79;327708
52;2020-07-14;0;0;0;119561;75822;89;195383
52;2020-07-14;0;0;0;42559;15260;90;57819
52;2020-07-14;8;6;14;1952321;1849476;0;3801797
53;2020-07-14;0;0;0;173813;182358;09;356171
53;2020-07-14;0;0;0;202720;214740;19;417460
53;2020-07-14;0;0;0;163116;173196;29;336312
53;2020-07-14;0;0;0;190526;187674;39;378200
53;2020-07-14;0;0;0;212098;212015;49;424113
53;2020-07-14;0;0;0;223699;219176;59;442875
53;2020-07-14;0;0;0;227435;209274;69;436709
53;2020-07-14;0;0;0;169992;140910;79;310902
53;2020-07-14;0;0;0;118117;69883;89;188000
53;2020-07-14;0;0;0;37370;12267;90;49637
53;2020-07-14;0;0;0;1718886;1621493;0;3340379
75;2020-07-14;0;0;0;293104;305291;09;598395
75;2020-07-14;1;0;1;337141;357785;19;694926
75;2020-07-14;0;0;0;295024;300618;29;595642
75;2020-07-14;0;0;0;347871;331233;39;679104
75;2020-07-14;0;0;0;384742;372771;49;757513
75;2020-07-14;0;2;2;413361;390880;59;804241
75;2020-07-14;0;0;0;425623;384060;69;809683
75;2020-07-14;0;0;0;325086;276298;79;601384
75;2020-07-14;0;0;0;213986;139308;89;353294
75;2020-07-14;1;0;1;77600;28200;90;105800
75;2020-07-14;2;2;4;3113538;2886444;0;5999982
76;2020-07-14;0;0;0;305956;318589;09;624545
76;2020-07-14;0;0;0;338942;356969;19;695911
76;2020-07-14;1;0;1;316210;319570;29;635780
76;2020-07-14;0;1;1;356758;337587;39;694345
76;2020-07-14;0;0;0;376541;363812;49;740353
76;2020-07-14;0;0;0;402608;383750;59;786358
76;2020-07-14;0;0;0;394889;358997;69;753886
76;2020-07-14;0;0;0;308664;263806;79;572470
76;2020-07-14;1;0;1;195838;129272;89;325110
76;2020-07-14;0;0;0;69372;26728;90;96100
76;2020-07-14;2;1;3;3065778;2859080;0;5924858
84;2020-07-14;0;0;0;459549;481088;09;940637
84;2020-07-14;0;0;0;487711;511905;19;999616
84;2020-07-14;0;0;0;443824;451094;29;894918
84;2020-07-14;0;1;1;512522;493262;39;1005784
84;2020-07-14;0;0;0;520248;515106;49;1035354
84;2020-07-14;0;0;0;529611;514848;59;1044459
84;2020-07-14;0;1;1;486720;439940;69;926660
84;2020-07-14;0;2;2;372151;315211;79;687362
84;2020-07-14;0;1;1;237198;150524;89;387722
84;2020-07-14;0;0;0;81185;28680;90;109865
84;2020-07-14;0;5;5;4130719;3901658;0;8032377
93;2020-07-14;0;0;0;268834;283093;09;551927
93;2020-07-14;1;0;1;280751;296087;19;576838
93;2020-07-14;1;1;2;254404;255552;29;509956
93;2020-07-14;0;1;1;310704;288398;39;599102
93;2020-07-14;0;0;0;325559;305827;49;631386
93;2020-07-14;0;0;0;353104;325389;59;678493
93;2020-07-14;0;1;1;336327;296459;69;632786
93;2020-07-14;1;0;1;279820;229699;79;509519
93;2020-07-14;0;0;0;171274;113716;89;284990
93;2020-07-14;1;0;1;58896;21758;90;80654
93;2020-07-14;4;3;7;2639673;2415978;0;5055651
94;2020-07-14;0;0;0;16311;17433;09;33744
94;2020-07-14;0;0;0;16679;18132;19;34811
94;2020-07-14;1;2;3;16782;16579;29;33361
94;2020-07-14;0;1;1;23044;20580;39;43624
94;2020-07-14;1;0;1;23065;22140;49;45205
94;2020-07-14;0;0;0;24549;23421;59;47970
94;2020-07-14;0;0;0;23212;21883;69;45095
94;2020-07-14;0;0;0;19544;17141;79;36685
94;2020-07-14;0;0;0;11227;8178;89;19405
94;2020-07-14;0;0;0;3332;1447;90;4779
94;2020-07-14;2;3;5;177745;166934;0;344679
01;2020-07-15;0;0;0;19979;20155;09;40134
01;2020-07-15;1;1;2;24994;25489;19;50483
01;2020-07-15;0;0;0;17868;16690;29;34558
01;2020-07-15;0;0;0;22328;14821;39;37149
01;2020-07-15;0;0;0;28652;20276;49;48928
01;2020-07-15;0;0;0;33264;27260;59;60524
01;2020-07-15;0;0;0;27135;23978;69;51113
01;2020-07-15;0;0;0;18401;14661;79;33062
01;2020-07-15;0;0;0;9633;6375;89;16008
01;2020-07-15;0;0;0;3410;1510;90;4920
01;2020-07-15;1;1;2;205664;171215;0;376879
02;2020-07-15;0;0;0;16881;17110;09;33991
02;2020-07-15;0;0;0;21410;21604;19;43014
02;2020-07-15;0;0;0;16017;15479;29;31496
02;2020-07-15;0;0;0;19825;14455;39;34280
02;2020-07-15;0;1;1;24719;18248;49;42967
02;2020-07-15;1;0;1;34361;28310;59;62671
02;2020-07-15;1;0;1;28061;24495;69;52556
02;2020-07-15;0;0;0;18231;15278;79;33509
02;2020-07-15;0;0;0;11090;7677;89;18767
02;2020-07-15;0;0;0;3992;1506;90;5498
02;2020-07-15;2;1;3;194587;164162;0;358749
03;2020-07-15;1;6;7;31123;30920;09;62043
03;2020-07-15;5;4;9;29370;29268;19;58638
03;2020-07-15;8;5;13;21458;18963;29;40421
03;2020-07-15;9;5;14;21276;18326;39;39602
03;2020-07-15;9;6;15;18164;16593;49;34757
03;2020-07-15;7;8;15;13469;13557;59;27026
03;2020-07-15;0;3;3;8776;8670;69;17446
03;2020-07-15;2;1;3;3777;3591;79;7368
03;2020-07-15;0;0;0;1649;1072;89;2721
03;2020-07-15;0;1;1;485;184;90;669
03;2020-07-15;41;39;80;149547;141144;0;290691
04;2020-07-15;1;1;2;60314;61377;09;121691
04;2020-07-15;1;0;1;66065;68387;19;134452
04;2020-07-15;1;1;2;51059;47156;29;98215
04;2020-07-15;1;1;2;58788;45780;39;104568
04;2020-07-15;2;2;4;61408;52207;49;113615
04;2020-07-15;0;0;0;64838;60759;59;125597
04;2020-07-15;0;0;0;47008;42843;69;89851
04;2020-07-15;0;0;0;25509;21184;79;46693
04;2020-07-15;0;0;0;13168;7647;89;20815
04;2020-07-15;0;0;0;3209;1253;90;4462
04;2020-07-15;6;5;11;451366;408593;0;859959
05;2020-07-15;0;0;0;362.366008612902;341.338819562748;09;703.704828175651
05;2020-07-15;0;0;0;353.376145114279;370.349735405642;19;723.725880519921
05;2020-07-15;0;0;0;218.593559489256;256.539602589476;29;475.133162078732
05;2020-07-15;0;0;0;404.225408693299;360.321910454353;39;764.547319147651
05;2020-07-15;0;0;0;520.067953604221;497.108383964256;49;1017.17633756848
05;2020-07-15;0;0;0;468.146063921917;510.087601910415;59;978.233665832332
05;2020-07-15;0;0;0;340.368470050554;334.366842191253;69;674.735312241807
05;2020-07-15;0;0;0;212.598666888387;192.597753227106;79;405.196420115493
05;2020-07-15;0;0;0;148.727797095705;61.8681715431829;89;210.595968638888
05;2020-07-15;0;0;0;32.9601271090696;10.9909785719784;90;43.9511056810479
05;2020-07-15;0;0;0;3061.43020057959;2935.56979942041;0;5997
06;2020-07-15;0;0;0;42583;42380;09;84963
06;2020-07-15;2;7;9;33369;31925;19;65294
06;2020-07-15;4;3;7;21571;15080;29;36651
06;2020-07-15;3;1;4;21550;16147;39;37697
06;2020-07-15;1;3;4;14193;13939;49;28132
06;2020-07-15;1;0;1;7171;7597;59;14768
06;2020-07-15;0;0;0;3629;4117;69;7746
06;2020-07-15;0;1;1;1577;1457;79;3034
06;2020-07-15;0;0;0;531;474;89;1005
06;2020-07-15;0;0;0;88;93;90;181
06;2020-07-15;11;15;26;146262;133209;0;279471
07;2020-07-15;0;0;0;485;549;09;1034
07;2020-07-15;0;0;0;403;432;19;835
07;2020-07-15;0;0;0;764;841;29;1605
07;2020-07-15;0;0;0;824;928;39;1752
07;2020-07-15;0;0;0;788;1020;49;1808
07;2020-07-15;0;0;0;678;870;59;1548
07;2020-07-15;0;0;0;360;382;69;742
07;2020-07-15;0;0;0;231;190;79;421
07;2020-07-15;0;1;1;114;67;89;181
07;2020-07-15;0;0;0;24;11;90;35
07;2020-07-15;0;1;1;4671;5290;0;9961
08;2020-07-15;0;0;0;2715.22592983026;2997.75551488675;09;5712.98144471701
08;2020-07-15;0;0;0;2778.51901080978;3160.9156459093;19;5939.43465671908
08;2020-07-15;0;0;0;2080.8882988764;1718.16634315323;29;3799.05464202964
08;2020-07-15;0;0;0;2701.8582062647;1896.52641413317;39;4598.38462039786
08;2020-07-15;0;0;0;3151.45861023308;2460.52498233809;49;5611.98359257117
08;2020-07-15;0;0;0;2620.29868333099;2422.23566154656;59;5042.53434487755
08;2020-07-15;0;1;1;1621.44173420671;1438.58325779464;69;3060.02499200135
08;2020-07-15;0;1;1;626.575909335673;526.358467843651;79;1152.93437717932
08;2020-07-15;0;0;0;205.018522985054;140.993639349697;89;346.012162334751
08;2020-07-15;0;0;0;50.0325684687745;20.62259870351;90;70.6551671722846
08;2020-07-15;0;2;2;18551.3174743414;16782.6825256586;0;35334
11;2020-07-15;6;9;15;783071;811785;09;1594856
11;2020-07-15;14;7;21;761456;784653;19;1546109
11;2020-07-15;23;20;43;850145;801772;29;1651917
11;2020-07-15;27;23;50;914360;843488;39;1757848
11;2020-07-15;20;9;29;845609;826202;49;1671811
11;2020-07-15;10;19;29;793566;745070;59;1538636
11;2020-07-15;11;14;25;628649;549192;69;1177841
11;2020-07-15;7;11;18;434606;358356;79;792962
11;2020-07-15;2;3;5;261425;162933;89;424358
11;2020-07-15;3;1;4;89253;32619;90;121872
11;2020-07-15;124;116;244;6362140;5916070;0;12278210
24;2020-07-15;0;0;0;139720;144686;09;284406
24;2020-07-15;0;1;1;152979;161185;19;314164
24;2020-07-15;0;0;0;122237;126536;29;248773
24;2020-07-15;0;0;0;150359;142009;39;292368
24;2020-07-15;0;0;0;161829;158758;49;320587
24;2020-07-15;0;1;1;172552;168011;59;340563
24;2020-07-15;0;0;0;172509;158177;69;330686
24;2020-07-15;2;0;2;129428;110593;79;240021
24;2020-07-15;0;0;0;87342;56882;89;144224
24;2020-07-15;0;0;0;31210;12071;90;43281
24;2020-07-15;2;2;4;1320165;1238908;0;2559073
27;2020-07-15;0;0;0;143373;149679;09;293052
27;2020-07-15;0;0;0;160962;173003;19;333965
27;2020-07-15;1;0;1;133746;142254;29;276000
27;2020-07-15;0;1;1;160004;155407;39;315411
27;2020-07-15;3;1;4;172333;169564;49;341897
27;2020-07-15;2;0;2;189979;183788;59;373767
27;2020-07-15;0;2;2;192591;178206;69;370797
27;2020-07-15;1;1;2;146876;127546;79;274422
27;2020-07-15;0;0;0;96896;61575;89;158471
27;2020-07-15;1;0;1;33148;12109;90;45257
27;2020-07-15;8;5;13;1429908;1353131;0;2783039
28;2020-07-15;0;0;0;180735;186856;09;367591
28;2020-07-15;0;2;2;200125;213621;19;413746
28;2020-07-15;1;1;2;168922;173007;29;341929
28;2020-07-15;0;1;1;196628;188487;39;385115
28;2020-07-15;1;1;2;205396;201699;49;407095
28;2020-07-15;1;0;1;222002;213866;59;435868
28;2020-07-15;0;0;0;224688;203758;69;428446
28;2020-07-15;0;0;0;163192;135543;79;298735
28;2020-07-15;0;1;1;109691;65377;89;175068
28;2020-07-15;0;1;1;37222;12685;90;49907
28;2020-07-15;3;7;10;1708601;1594899;0;3303500
32;2020-07-15;5;3;8;358062;373689;09;731751
32;2020-07-15;1;2;3;387045;406742;19;793787
32;2020-07-15;1;8;9;342304;348587;29;690891
32;2020-07-15;6;4;10;382485;369972;39;752457
32;2020-07-15;4;6;10;382510;376716;49;759226
32;2020-07-15;6;5;11;386937;376527;59;763464
32;2020-07-15;3;2;5;371211;330938;69;702149
32;2020-07-15;0;4;4;250542;201459;79;452001
32;2020-07-15;3;3;6;163399;89786;89;253185
32;2020-07-15;1;0;1;48384;15367;90;63751
32;2020-07-15;30;37;67;3072879;2889783;0;5962662
44;2020-07-15;4;1;5;291525;306839;09;598364
44;2020-07-15;2;3;5;320255;339504;19;659759
44;2020-07-15;3;0;3;302020;314428;29;616448
44;2020-07-15;9;6;15;342222;333292;39;675514
44;2020-07-15;5;4;9;349727;344491;49;694218
44;2020-07-15;4;8;12;381371;373239;59;754610
44;2020-07-15;3;6;9;367165;335850;69;703015
44;2020-07-15;2;4;6;250387;215436;79;465823
44;2020-07-15;2;0;2;170825;105192;89;276017
44;2020-07-15;0;0;0;51248;16731;90;67979
44;2020-07-15;34;32;66;2826745;2685002;0;5511747
52;2020-07-15;3;2;5;213594;223900;09;437494
52;2020-07-15;3;5;8;240818;255197;19;496015
52;2020-07-15;2;6;8;197010;200630;29;397640
52;2020-07-15;7;7;14;231204;224885;39;456089
52;2020-07-15;4;3;7;243874;243418;49;487292
52;2020-07-15;6;7;13;244100;239116;59;483216
52;2020-07-15;2;0;2;241796;221345;69;463141
52;2020-07-15;2;0;2;177805;149903;79;327708
52;2020-07-15;2;1;3;119561;75822;89;195383
52;2020-07-15;1;0;1;42559;15260;90;57819
52;2020-07-15;32;31;63;1952321;1849476;0;3801797
53;2020-07-15;1;8;9;173813;182358;09;356171
53;2020-07-15;4;3;7;202720;214740;19;417460
53;2020-07-15;7;5;12;163116;173196;29;336312
53;2020-07-15;13;13;26;190526;187674;39;378200
53;2020-07-15;4;7;11;212098;212015;49;424113
53;2020-07-15;9;4;13;223699;219176;59;442875
53;2020-07-15;4;3;7;227435;209274;69;436709
53;2020-07-15;2;2;4;169992;140910;79;310902
53;2020-07-15;3;1;4;118117;69883;89;188000
53;2020-07-15;1;0;1;37370;12267;90;49637
53;2020-07-15;48;46;94;1718886;1621493;0;3340379
75;2020-07-15;1;0;1;293104;305291;09;598395
75;2020-07-15;2;0;2;337141;357785;19;694926
75;2020-07-15;4;7;11;295024;300618;29;595642
75;2020-07-15;1;2;3;347871;331233;39;679104
75;2020-07-15;1;1;2;384742;372771;49;757513
75;2020-07-15;1;3;4;413361;390880;59;804241
75;2020-07-15;1;2;3;425623;384060;69;809683
75;2020-07-15;0;2;2;325086;276298;79;601384
75;2020-07-15;1;0;1;213986;139308;89;353294
75;2020-07-15;0;0;0;77600;28200;90;105800
75;2020-07-15;12;17;29;3113538;2886444;0;5999982
76;2020-07-15;0;1;1;305956;318589;09;624545
76;2020-07-15;1;1;2;338942;356969;19;695911
76;2020-07-15;4;2;6;316210;319570;29;635780
76;2020-07-15;1;2;3;356758;337587;39;694345
76;2020-07-15;3;1;4;376541;363812;49;740353
76;2020-07-15;5;1;6;402608;383750;59;786358
76;2020-07-15;0;0;0;394889;358997;69;753886
76;2020-07-15;0;1;1;308664;263806;79;572470
76;2020-07-15;0;0;0;195838;129272;89;325110
76;2020-07-15;0;0;0;69372;26728;90;96100
76;2020-07-15;14;9;23;3065778;2859080;0;5924858
84;2020-07-15;1;3;4;459549;481088;09;940637
84;2020-07-15;3;2;5;487711;511905;19;999616
84;2020-07-15;3;1;4;443824;451094;29;894918
84;2020-07-15;3;8;11;512522;493262;39;1005784
84;2020-07-15;6;4;10;520248;515106;49;1035354
84;2020-07-15;5;2;7;529611;514848;59;1044459
84;2020-07-15;0;2;2;486720;439940;69;926660
84;2020-07-15;5;4;9;372151;315211;79;687362
84;2020-07-15;0;3;3;237198;150524;89;387722
84;2020-07-15;1;0;1;81185;28680;90;109865
84;2020-07-15;27;29;56;4130719;3901658;0;8032377
93;2020-07-15;2;1;3;268834;283093;09;551927
93;2020-07-15;2;3;5;280751;296087;19;576838
93;2020-07-15;5;3;8;254404;255552;29;509956
93;2020-07-15;4;3;7;310704;288398;39;599102
93;2020-07-15;7;3;10;325559;305827;49;631386
93;2020-07-15;8;4;12;353104;325389;59;678493
93;2020-07-15;2;4;6;336327;296459;69;632786
93;2020-07-15;0;0;0;279820;229699;79;509519
93;2020-07-15;2;1;3;171274;113716;89;284990
93;2020-07-15;1;1;2;58896;21758;90;80654
93;2020-07-15;33;23;56;2639673;2415978;0;5055651
94;2020-07-15;0;0;0;16311;17433;09;33744
94;2020-07-15;0;1;1;16679;18132;19;34811
94;2020-07-15;0;0;0;16782;16579;29;33361
94;2020-07-15;0;1;1;23044;20580;39;43624
94;2020-07-15;0;0;0;23065;22140;49;45205
94;2020-07-15;0;1;1;24549;23421;59;47970
94;2020-07-15;0;0;0;23212;21883;69;45095
94;2020-07-15;0;0;0;19544;17141;79;36685
94;2020-07-15;0;0;0;11227;8178;89;19405
94;2020-07-15;0;0;0;3332;1447;90;4779
94;2020-07-15;0;3;3;177745;166934;0;344679
01;2020-07-16;0;0;0;19979;20155;09;40134
01;2020-07-16;0;0;0;24994;25489;19;50483
01;2020-07-16;0;0;0;17868;16690;29;34558
01;2020-07-16;0;0;0;22328;14821;39;37149
01;2020-07-16;0;0;0;28652;20276;49;48928
01;2020-07-16;1;0;1;33264;27260;59;60524
01;2020-07-16;0;0;0;27135;23978;69;51113
01;2020-07-16;0;0;0;18401;14661;79;33062
01;2020-07-16;0;0;0;9633;6375;89;16008
01;2020-07-16;0;0;0;3410;1510;90;4920
01;2020-07-16;1;0;1;205664;171215;0;376879
02;2020-07-16;0;0;0;16881;17110;09;33991
02;2020-07-16;0;0;0;21410;21604;19;43014
02;2020-07-16;1;0;1;16017;15479;29;31496
02;2020-07-16;1;0;1;19825;14455;39;34280
02;2020-07-16;0;0;0;24719;18248;49;42967
02;2020-07-16;0;0;0;34361;28310;59;62671
02;2020-07-16;0;0;0;28061;24495;69;52556
02;2020-07-16;0;0;0;18231;15278;79;33509
02;2020-07-16;0;0;0;11090;7677;89;18767
02;2020-07-16;0;0;0;3992;1506;90;5498
02;2020-07-16;2;0;2;194587;164162;0;358749
03;2020-07-16;4;3;7;31123;30920;09;62043
03;2020-07-16;5;5;12;29370;29268;19;58638
03;2020-07-16;14;26;40;21458;18963;29;40421
03;2020-07-16;18;15;34;21276;18326;39;39602
03;2020-07-16;11;12;25;18164;16593;49;34757
03;2020-07-16;6;16;22;13469;13557;59;27026
03;2020-07-16;7;3;10;8776;8670;69;17446
03;2020-07-16;1;3;4;3777;3591;79;7368
03;2020-07-16;0;1;1;1649;1072;89;2721
03;2020-07-16;0;0;0;485;184;90;669
03;2020-07-16;66;84;155;149547;141144;0;290691
04;2020-07-16;0;0;0;60314;61377;09;121691
04;2020-07-16;0;0;0;66065;68387;19;134452
04;2020-07-16;0;0;0;51059;47156;29;98215
04;2020-07-16;0;0;0;58788;45780;39;104568
04;2020-07-16;0;2;2;61408;52207;49;113615
04;2020-07-16;0;0;0;64838;60759;59;125597
04;2020-07-16;0;0;0;47008;42843;69;89851
04;2020-07-16;0;0;0;25509;21184;79;46693
04;2020-07-16;0;0;0;13168;7647;89;20815
04;2020-07-16;0;0;0;3209;1253;90;4462
04;2020-07-16;0;2;2;451366;408593;0;859959
05;2020-07-16;0;0;0;362.366008612902;341.338819562748;09;703.704828175651
05;2020-07-16;0;0;0;353.376145114279;370.349735405642;19;723.725880519921
05;2020-07-16;0;0;0;218.593559489256;256.539602589476;29;475.133162078732
05;2020-07-16;0;0;0;404.225408693299;360.321910454353;39;764.547319147651
05;2020-07-16;0;0;0;520.067953604221;497.108383964256;49;1017.17633756848
05;2020-07-16;0;0;0;468.146063921917;510.087601910415;59;978.233665832332
05;2020-07-16;0;0;0;340.368470050554;334.366842191253;69;674.735312241807
05;2020-07-16;0;0;0;212.598666888387;192.597753227106;79;405.196420115493
05;2020-07-16;0;0;0;148.727797095705;61.8681715431829;89;210.595968638888
05;2020-07-16;0;0;0;32.9601271090696;10.9909785719784;90;43.9511056810479
05;2020-07-16;0;0;0;3061.43020057959;2935.56979942041;0;5997
06;2020-07-16;0;0;0;42583;42380;09;84963
06;2020-07-16;2;0;2;33369;31925;19;65294
06;2020-07-16;3;2;5;21571;15080;29;36651
06;2020-07-16;1;2;3;21550;16147;39;37697
06;2020-07-16;3;1;4;14193;13939;49;28132
06;2020-07-16;0;0;0;7171;7597;59;14768
06;2020-07-16;0;0;0;3629;4117;69;7746
06;2020-07-16;0;0;0;1577;1457;79;3034
06;2020-07-16;0;0;0;531;474;89;1005
06;2020-07-16;0;0;0;88;93;90;181
06;2020-07-16;9;5;14;146262;133209;0;279471
07;2020-07-16;0;0;0;485;549;09;1034
07;2020-07-16;0;0;0;403;432;19;835
07;2020-07-16;0;0;0;764;841;29;1605
07;2020-07-16;0;0;0;824;928;39;1752
07;2020-07-16;0;0;0;788;1020;49;1808
07;2020-07-16;0;0;0;678;870;59;1548
07;2020-07-16;0;0;0;360;382;69;742
07;2020-07-16;0;0;0;231;190;79;421
07;2020-07-16;0;0;0;114;67;89;181
07;2020-07-16;0;0;0;24;11;90;35
07;2020-07-16;0;0;0;4671;5290;0;9961
08;2020-07-16;0;0;0;2715.22592983026;2997.75551488675;09;5712.98144471701
08;2020-07-16;0;0;0;2778.51901080978;3160.9156459093;19;5939.43465671908
08;2020-07-16;0;0;0;2080.8882988764;1718.16634315323;29;3799.05464202964
08;2020-07-16;0;0;0;2701.8582062647;1896.52641413317;39;4598.38462039786
08;2020-07-16;0;0;0;3151.45861023308;2460.52498233809;49;5611.98359257117
08;2020-07-16;0;0;0;2620.29868333099;2422.23566154656;59;5042.53434487755
08;2020-07-16;0;0;0;1621.44173420671;1438.58325779464;69;3060.02499200135
08;2020-07-16;0;0;0;626.575909335673;526.358467843651;79;1152.93437717932
08;2020-07-16;0;0;0;205.018522985054;140.993639349697;89;346.012162334751
08;2020-07-16;0;0;0;50.0325684687745;20.62259870351;90;70.6551671722846
08;2020-07-16;0;0;0;18551.3174743414;16782.6825256586;0;35334
11;2020-07-16;4;8;12;783071;811785;09;1594856
11;2020-07-16;13;10;23;761456;784653;19;1546109
11;2020-07-16;36;27;63;850145;801772;29;1651917
11;2020-07-16;33;29;62;914360;843488;39;1757848
11;2020-07-16;26;20;46;845609;826202;49;1671811
11;2020-07-16;22;12;34;793566;745070;59;1538636
11;2020-07-16;12;12;24;628649;549192;69;1177841
11;2020-07-16;7;6;13;434606;358356;79;792962
11;2020-07-16;5;3;8;261425;162933;89;424358
11;2020-07-16;1;0;1;89253;32619;90;121872
11;2020-07-16;159;128;290;6362140;5916070;0;12278210
24;2020-07-16;0;0;0;139720;144686;09;284406
24;2020-07-16;0;0;0;152979;161185;19;314164
24;2020-07-16;3;0;3;122237;126536;29;248773
24;2020-07-16;0;0;0;150359;142009;39;292368
24;2020-07-16;0;0;0;161829;158758;49;320587
24;2020-07-16;0;2;2;172552;168011;59;340563
24;2020-07-16;0;0;0;172509;158177;69;330686
24;2020-07-16;0;1;1;129428;110593;79;240021
24;2020-07-16;1;1;2;87342;56882;89;144224
24;2020-07-16;0;0;0;31210;12071;90;43281
24;2020-07-16;4;4;8;1320165;1238908;0;2559073
27;2020-07-16;1;0;1;143373;149679;09;293052
27;2020-07-16;0;0;0;160962;173003;19;333965
27;2020-07-16;0;1;1;133746;142254;29;276000
27;2020-07-16;0;3;3;160004;155407;39;315411
27;2020-07-16;2;0;2;172333;169564;49;341897
27;2020-07-16;0;1;1;189979;183788;59;373767
27;2020-07-16;2;1;3;192591;178206;69;370797
27;2020-07-16;0;0;0;146876;127546;79;274422
27;2020-07-16;0;0;0;96896;61575;89;158471
27;2020-07-16;0;0;0;33148;12109;90;45257
27;2020-07-16;5;6;11;1429908;1353131;0;2783039
28;2020-07-16;0;0;1;180735;186856;09;367591
28;2020-07-16;1;3;4;200125;213621;19;413746
28;2020-07-16;2;0;2;168922;173007;29;341929
28;2020-07-16;4;5;9;196628;188487;39;385115
28;2020-07-16;1;2;3;205396;201699;49;407095
28;2020-07-16;0;0;0;222002;213866;59;435868
28;2020-07-16;3;1;4;224688;203758;69;428446
28;2020-07-16;1;3;4;163192;135543;79;298735
28;2020-07-16;0;0;0;109691;65377;89;175068
28;2020-07-16;0;0;0;37222;12685;90;49907
28;2020-07-16;12;14;27;1708601;1594899;0;3303500
32;2020-07-16;2;10;12;358062;373689;09;731751
32;2020-07-16;4;8;12;387045;406742;19;793787
32;2020-07-16;6;7;14;342304;348587;29;690891
32;2020-07-16;10;7;17;382485;369972;39;752457
32;2020-07-16;2;12;14;382510;376716;49;759226
32;2020-07-16;1;8;9;386937;376527;59;763464
32;2020-07-16;2;2;4;371211;330938;69;702149
32;2020-07-16;5;2;7;250542;201459;79;452001
32;2020-07-16;2;0;2;163399;89786;89;253185
32;2020-07-16;0;0;0;48384;15367;90;63751
32;2020-07-16;34;56;91;3072879;2889783;0;5962662
44;2020-07-16;0;3;3;291525;306839;09;598364
44;2020-07-16;4;6;10;320255;339504;19;659759
44;2020-07-16;6;3;9;302020;314428;29;616448
44;2020-07-16;12;7;19;342222;333292;39;675514
44;2020-07-16;3;6;9;349727;344491;49;694218
44;2020-07-16;8;6;14;381371;373239;59;754610
44;2020-07-16;3;9;12;367165;335850;69;703015
44;2020-07-16;3;4;7;250387;215436;79;465823
44;2020-07-16;2;1;3;170825;105192;89;276017
44;2020-07-16;2;0;2;51248;16731;90;67979
44;2020-07-16;43;45;88;2826745;2685002;0;5511747
52;2020-07-16;4;3;7;213594;223900;09;437494
52;2020-07-16;1;8;9;240818;255197;19;496015
52;2020-07-16;5;10;15;197010;200630;29;397640
52;2020-07-16;3;7;10;231204;224885;39;456089
52;2020-07-16;4;6;10;243874;243418;49;487292
52;2020-07-16;2;4;6;244100;239116;59;483216
52;2020-07-16;1;0;1;241796;221345;69;463141
52;2020-07-16;3;0;3;177805;149903;79;327708
52;2020-07-16;0;1;1;119561;75822;89;195383
52;2020-07-16;0;0;0;42559;15260;90;57819
52;2020-07-16;23;39;62;1952321;1849476;0;3801797
53;2020-07-16;5;1;6;173813;182358;09;356171
53;2020-07-16;4;4;8;202720;214740;19;417460
53;2020-07-16;3;3;6;163116;173196;29;336312
53;2020-07-16;3;4;7;190526;187674;39;378200
53;2020-07-16;5;3;8;212098;212015;49;424113
53;2020-07-16;7;3;10;223699;219176;59;442875
53;2020-07-16;3;2;5;227435;209274;69;436709
53;2020-07-16;3;0;3;169992;140910;79;310902
53;2020-07-16;0;1;1;118117;69883;89;188000
53;2020-07-16;1;0;1;37370;12267;90;49637
53;2020-07-16;34;21;55;1718886;1621493;0;3340379
75;2020-07-16;0;0;1;293104;305291;09;598395
75;2020-07-16;1;4;5;337141;357785;19;694926
75;2020-07-16;2;3;5;295024;300618;29;595642
75;2020-07-16;4;3;7;347871;331233;39;679104
75;2020-07-16;2;3;5;384742;372771;49;757513
75;2020-07-16;0;0;0;413361;390880;59;804241
75;2020-07-16;0;3;3;425623;384060;69;809683
75;2020-07-16;0;1;1;325086;276298;79;601384
75;2020-07-16;2;0;2;213986;139308;89;353294
75;2020-07-16;0;1;1;77600;28200;90;105800
75;2020-07-16;11;18;30;3113538;2886444;0;5999982
76;2020-07-16;1;2;3;305956;318589;09;624545
76;2020-07-16;0;1;1;338942;356969;19;695911
76;2020-07-16;7;5;12;316210;319570;29;635780
76;2020-07-16;6;3;9;356758;337587;39;694345
76;2020-07-16;3;4;7;376541;363812;49;740353
76;2020-07-16;1;4;5;402608;383750;59;786358
76;2020-07-16;2;0;2;394889;358997;69;753886
76;2020-07-16;1;0;1;308664;263806;79;572470
76;2020-07-16;0;0;0;195838;129272;89;325110
76;2020-07-16;0;0;0;69372;26728;90;96100
76;2020-07-16;21;19;40;3065778;2859080;0;5924858
84;2020-07-16;1;1;2;459549;481088;09;940637
84;2020-07-16;3;1;4;487711;511905;19;999616
84;2020-07-16;7;6;13;443824;451094;29;894918
84;2020-07-16;6;3;9;512522;493262;39;1005784
84;2020-07-16;6;6;12;520248;515106;49;1035354
84;2020-07-16;6;1;7;529611;514848;59;1044459
84;2020-07-16;5;4;9;486720;439940;69;926660
84;2020-07-16;2;1;3;372151;315211;79;687362
84;2020-07-16;2;0;2;237198;150524;89;387722
84;2020-07-16;0;0;0;81185;28680;90;109865
84;2020-07-16;38;23;61;4130719;3901658;0;8032377
93;2020-07-16;1;2;3;268834;283093;09;551927
93;2020-07-16;1;1;2;280751;296087;19;576838
93;2020-07-16;2;1;3;254404;255552;29;509956
93;2020-07-16;4;2;6;310704;288398;39;599102
93;2020-07-16;3;5;8;325559;305827;49;631386
93;2020-07-16;1;2;3;353104;325389;59;678493
93;2020-07-16;4;1;5;336327;296459;69;632786
93;2020-07-16;2;2;4;279820;229699;79;509519
93;2020-07-16;0;0;0;171274;113716;89;284990
93;2020-07-16;1;0;1;58896;21758;90;80654
93;2020-07-16;19;16;35;2639673;2415978;0;5055651
94;2020-07-16;0;0;0;16311;17433;09;33744
94;2020-07-16;0;0;0;16679;18132;19;34811
94;2020-07-16;0;0;0;16782;16579;29;33361
94;2020-07-16;0;1;1;23044;20580;39;43624
94;2020-07-16;0;0;0;23065;22140;49;45205
94;2020-07-16;0;1;1;24549;23421;59;47970
94;2020-07-16;0;0;0;23212;21883;69;45095
94;2020-07-16;0;0;0;19544;17141;79;36685
94;2020-07-16;0;0;0;11227;8178;89;19405
94;2020-07-16;0;0;0;3332;1447;90;4779
94;2020-07-16;0;2;2;177745;166934;0;344679
01;2020-07-17;0;0;0;19979;20155;09;40134
01;2020-07-17;0;0;0;24994;25489;19;50483
01;2020-07-17;1;0;1;17868;16690;29;34558
01;2020-07-17;0;1;1;22328;14821;39;37149
01;2020-07-17;1;0;1;28652;20276;49;48928
01;2020-07-17;0;1;1;33264;27260;59;60524
01;2020-07-17;0;0;0;27135;23978;69;51113
01;2020-07-17;0;0;0;18401;14661;79;33062
01;2020-07-17;0;0;0;9633;6375;89;16008
01;2020-07-17;0;0;0;3410;1510;90;4920
01;2020-07-17;2;2;4;205664;171215;0;376879
02;2020-07-17;0;0;0;16881;17110;09;33991
02;2020-07-17;0;0;0;21410;21604;19;43014
02;2020-07-17;0;0;0;16017;15479;29;31496
02;2020-07-17;0;0;0;19825;14455;39;34280
02;2020-07-17;0;0;0;24719;18248;49;42967
02;2020-07-17;0;0;0;34361;28310;59;62671
02;2020-07-17;0;0;0;28061;24495;69;52556
02;2020-07-17;0;0;0;18231;15278;79;33509
02;2020-07-17;0;0;0;11090;7677;89;18767
02;2020-07-17;0;0;0;3992;1506;90;5498
02;2020-07-17;0;0;0;194587;164162;0;358749
03;2020-07-17;2;2;4;31123;30920;09;62043
03;2020-07-17;3;7;10;29370;29268;19;58638
03;2020-07-17;12;7;21;21458;18963;29;40421
03;2020-07-17;12;6;20;21276;18326;39;39602
03;2020-07-17;8;5;13;18164;16593;49;34757
03;2020-07-17;5;6;11;13469;13557;59;27026
03;2020-07-17;3;9;12;8776;8670;69;17446
03;2020-07-17;0;2;2;3777;3591;79;7368
03;2020-07-17;1;0;1;1649;1072;89;2721
03;2020-07-17;0;0;0;485;184;90;669
03;2020-07-17;46;44;94;149547;141144;0;290691
04;2020-07-17;0;0;0;60314;61377;09;121691
04;2020-07-17;0;0;0;66065;68387;19;134452
04;2020-07-17;0;1;1;51059;47156;29;98215
04;2020-07-17;0;3;3;58788;45780;39;104568
04;2020-07-17;0;0;0;61408;52207;49;113615
04;2020-07-17;1;1;2;64838;60759;59;125597
04;2020-07-17;0;1;1;47008;42843;69;89851
04;2020-07-17;0;0;0;25509;21184;79;46693
04;2020-07-17;0;0;0;13168;7647;89;20815
04;2020-07-17;0;0;0;3209;1253;90;4462
04;2020-07-17;1;6;7;451366;408593;0;859959
05;2020-07-17;0;0;0;362.366008612902;341.338819562748;09;703.704828175651
05;2020-07-17;0;0;0;353.376145114279;370.349735405642;19;723.725880519921
05;2020-07-17;0;0;0;218.593559489256;256.539602589476;29;475.133162078732
05;2020-07-17;0;0;0;404.225408693299;360.321910454353;39;764.547319147651
05;2020-07-17;0;0;0;520.067953604221;497.108383964256;49;1017.17633756848
05;2020-07-17;0;0;0;468.146063921917;510.087601910415;59;978.233665832332
05;2020-07-17;0;0;0;340.368470050554;334.366842191253;69;674.735312241807
05;2020-07-17;0;0;0;212.598666888387;192.597753227106;79;405.196420115493
05;2020-07-17;0;0;0;148.727797095705;61.8681715431829;89;210.595968638888
05;2020-07-17;0;0;0;32.9601271090696;10.9909785719784;90;43.9511056810479
05;2020-07-17;0;0;0;3061.43020057959;2935.56979942041;0;5997
06;2020-07-17;0;0;0;42583;42380;09;84963
06;2020-07-17;1;0;1;33369;31925;19;65294
06;2020-07-17;1;1;2;21571;15080;29;36651
06;2020-07-17;2;3;5;21550;16147;39;37697
06;2020-07-17;2;3;5;14193;13939;49;28132
06;2020-07-17;2;0;2;7171;7597;59;14768
06;2020-07-17;0;1;1;3629;4117;69;7746
06;2020-07-17;0;0;0;1577;1457;79;3034
06;2020-07-17;0;0;0;531;474;89;1005
06;2020-07-17;0;0;0;88;93;90;181
06;2020-07-17;8;8;16;146262;133209;0;279471
07;2020-07-17;0;0;0;485;549;09;1034
07;2020-07-17;0;0;0;403;432;19;835
07;2020-07-17;0;0;0;764;841;29;1605
07;2020-07-17;0;0;0;824;928;39;1752
07;2020-07-17;0;0;0;788;1020;49;1808
07;2020-07-17;0;1;1;678;870;59;1548
07;2020-07-17;0;0;0;360;382;69;742
07;2020-07-17;0;0;0;231;190;79;421
07;2020-07-17;0;0;0;114;67;89;181
07;2020-07-17;0;0;0;24;11;90;35
07;2020-07-17;0;1;1;4671;5290;0;9961
08;2020-07-17;0;0;0;2715.22592983026;2997.75551488675;09;5712.98144471701
08;2020-07-17;0;0;0;2778.51901080978;3160.9156459093;19;5939.43465671908
08;2020-07-17;0;0;0;2080.8882988764;1718.16634315323;29;3799.05464202964
08;2020-07-17;0;0;0;2701.8582062647;1896.52641413317;39;4598.38462039786
08;2020-07-17;0;0;0;3151.45861023308;2460.52498233809;49;5611.98359257117
08;2020-07-17;0;0;0;2620.29868333099;2422.23566154656;59;5042.53434487755
08;2020-07-17;0;0;0;1621.44173420671;1438.58325779464;69;3060.02499200135
08;2020-07-17;0;0;0;626.575909335673;526.358467843651;79;1152.93437717932
08;2020-07-17;0;0;0;205.018522985054;140.993639349697;89;346.012162334751
08;2020-07-17;0;0;0;50.0325684687745;20.62259870351;90;70.6551671722846
08;2020-07-17;0;0;0;18551.3174743414;16782.6825256586;0;35334
11;2020-07-17;5;8;13;783071;811785;09;1594856
11;2020-07-17;9;21;31;761456;784653;19;1546109
11;2020-07-17;26;21;47;850145;801772;29;1651917
11;2020-07-17;27;26;53;914360;843488;39;1757848
11;2020-07-17;24;24;48;845609;826202;49;1671811
11;2020-07-17;25;13;38;793566;745070;59;1538636
11;2020-07-17;13;11;24;628649;549192;69;1177841
11;2020-07-17;7;12;19;434606;358356;79;792962
11;2020-07-17;3;4;7;261425;162933;89;424358
11;2020-07-17;2;1;3;89253;32619;90;121872
11;2020-07-17;141;142;284;6362140;5916070;0;12278210
24;2020-07-17;0;2;2;139720;144686;09;284406
24;2020-07-17;0;0;0;152979;161185;19;314164
24;2020-07-17;0;2;2;122237;126536;29;248773
24;2020-07-17;1;2;3;150359;142009;39;292368
24;2020-07-17;2;0;2;161829;158758;49;320587
24;2020-07-17;0;3;3;172552;168011;59;340563
24;2020-07-17;0;0;0;172509;158177;69;330686
24;2020-07-17;0;0;0;129428;110593;79;240021
24;2020-07-17;0;1;1;87342;56882;89;144224
24;2020-07-17;0;0;0;31210;12071;90;43281
24;2020-07-17;3;10;13;1320165;1238908;0;2559073
27;2020-07-17;0;0;0;143373;149679;09;293052
27;2020-07-17;1;0;1;160962;173003;19;333965
27;2020-07-17;0;1;1;133746;142254;29;276000
27;2020-07-17;1;0;1;160004;155407;39;315411
27;2020-07-17;4;3;7;172333;169564;49;341897
27;2020-07-17;2;1;3;189979;183788;59;373767
27;2020-07-17;1;0;1;192591;178206;69;370797
27;2020-07-17;4;2;6;146876;127546;79;274422
27;2020-07-17;0;0;0;96896;61575;89;158471
27;2020-07-17;1;0;1;33148;12109;90;45257
27;2020-07-17;14;7;21;1429908;1353131;0;2783039
28;2020-07-17;1;0;1;180735;186856;09;367591
28;2020-07-17;1;0;1;200125;213621;19;413746
28;2020-07-17;6;1;7;168922;173007;29;341929
28;2020-07-17;2;0;2;196628;188487;39;385115
28;2020-07-17;2;1;3;205396;201699;49;407095
28;2020-07-17;0;0;0;222002;213866;59;435868
28;2020-07-17;1;1;2;224688;203758;69;428446
28;2020-07-17;2;2;4;163192;135543;79;298735
28;2020-07-17;2;0;2;109691;65377;89;175068
28;2020-07-17;0;0;0;37222;12685;90;49907
28;2020-07-17;17;5;22;1708601;1594899;0;3303500
32;2020-07-17;3;4;7;358062;373689;09;731751
32;2020-07-17;4;16;20;387045;406742;19;793787
32;2020-07-17;5;6;11;342304;348587;29;690891
32;2020-07-17;3;4;7;382485;369972;39;752457
32;2020-07-17;6;4;10;382510;376716;49;759226
32;2020-07-17;2;4;6;386937;376527;59;763464
32;2020-07-17;7;5;12;371211;330938;69;702149
32;2020-07-17;0;3;3;250542;201459;79;452001
32;2020-07-17;0;0;0;163399;89786;89;253185
32;2020-07-17;2;1;3;48384;15367;90;63751
32;2020-07-17;32;47;85;3072879;2889783;0;5962662
44;2020-07-17;2;1;3;291525;306839;09;598364
44;2020-07-17;1;4;5;320255;339504;19;659759
44;2020-07-17;6;5;11;302020;314428;29;616448
44;2020-07-17;10;12;22;342222;333292;39;675514
44;2020-07-17;2;5;7;349727;344491;49;694218
44;2020-07-17;7;4;11;381371;373239;59;754610
44;2020-07-17;5;6;11;367165;335850;69;703015
44;2020-07-17;6;6;12;250387;215436;79;465823
44;2020-07-17;2;1;3;170825;105192;89;276017
44;2020-07-17;1;0;1;51248;16731;90;67979
44;2020-07-17;42;44;86;2826745;2685002;0;5511747
52;2020-07-17;3;2;7;213594;223900;09;437494
52;2020-07-17;3;9;13;240818;255197;19;496015
52;2020-07-17;8;14;22;197010;200630;29;397640
52;2020-07-17;7;16;23;231204;224885;39;456089
52;2020-07-17;2;7;9;243874;243418;49;487292
52;2020-07-17;7;9;16;244100;239116;59;483216
52;2020-07-17;5;5;10;241796;221345;69;463141
52;2020-07-17;3;1;4;177805;149903;79;327708
52;2020-07-17;0;1;1;119561;75822;89;195383
52;2020-07-17;3;0;3;42559;15260;90;57819
52;2020-07-17;41;64;108;1952321;1849476;0;3801797
53;2020-07-17;3;0;3;173813;182358;09;356171
53;2020-07-17;1;2;3;202720;214740;19;417460
53;2020-07-17;2;1;3;163116;173196;29;336312
53;2020-07-17;3;2;5;190526;187674;39;378200
53;2020-07-17;3;2;5;212098;212015;49;424113
53;2020-07-17;3;1;4;223699;219176;59;442875
53;2020-07-17;0;1;1;227435;209274;69;436709
53;2020-07-17;1;0;1;169992;140910;79;310902
53;2020-07-17;1;1;2;118117;69883;89;188000
53;2020-07-17;1;0;1;37370;12267;90;49637
53;2020-07-17;18;10;28;1718886;1621493;0;3340379
75;2020-07-17;0;1;1;293104;305291;09;598395
75;2020-07-17;2;4;6;337141;357785;19;694926
75;2020-07-17;4;7;11;295024;300618;29;595642
75;2020-07-17;1;4;5;347871;331233;39;679104
75;2020-07-17;1;1;2;384742;372771;49;757513
75;2020-07-17;3;2;5;413361;390880;59;804241
75;2020-07-17;2;1;3;425623;384060;69;809683
75;2020-07-17;3;0;3;325086;276298;79;601384
75;2020-07-17;4;3;7;213986;139308;89;353294
75;2020-07-17;1;1;2;77600;28200;90;105800
75;2020-07-17;21;24;45;3113538;2886444;0;5999982
76;2020-07-17;0;0;0;305956;318589;09;624545
76;2020-07-17;3;1;4;338942;356969;19;695911
76;2020-07-17;3;3;6;316210;319570;29;635780
76;2020-07-17;2;6;8;356758;337587;39;694345
76;2020-07-17;4;1;5;376541;363812;49;740353
76;2020-07-17;2;3;5;402608;383750;59;786358
76;2020-07-17;5;0;5;394889;358997;69;753886
76;2020-07-17;1;1;2;308664;263806;79;572470
76;2020-07-17;2;1;3;195838;129272;89;325110
76;2020-07-17;0;0;0;69372;26728;90;96100
76;2020-07-17;22;16;38;3065778;2859080;0;5924858
84;2020-07-17;1;1;2;459549;481088;09;940637
84;2020-07-17;5;3;8;487711;511905;19;999616
84;2020-07-17;6;7;13;443824;451094;29;894918
84;2020-07-17;6;4;10;512522;493262;39;1005784
84;2020-07-17;3;5;8;520248;515106;49;1035354
84;2020-07-17;3;1;4;529611;514848;59;1044459
84;2020-07-17;5;5;10;486720;439940;69;926660
84;2020-07-17;4;2;6;372151;315211;79;687362
84;2020-07-17;3;1;4;237198;150524;89;387722
84;2020-07-17;0;0;0;81185;28680;90;109865
84;2020-07-17;36;29;65;4130719;3901658;0;8032377
93;2020-07-17;0;0;0;268834;283093;09;551927
93;2020-07-17;3;2;5;280751;296087;19;576838
93;2020-07-17;1;2;3;254404;255552;29;509956
93;2020-07-17;4;4;8;310704;288398;39;599102
93;2020-07-17;2;7;9;325559;305827;49;631386
93;2020-07-17;4;3;7;353104;325389;59;678493
93;2020-07-17;1;4;5;336327;296459;69;632786
93;2020-07-17;4;2;6;279820;229699;79;509519
93;2020-07-17;0;0;0;171274;113716;89;284990
93;2020-07-17;0;0;0;58896;21758;90;80654
93;2020-07-17;19;24;43;2639673;2415978;0;5055651
94;2020-07-17;0;0;0;16311;17433;09;33744
94;2020-07-17;0;0;0;16679;18132;19;34811
94;2020-07-17;0;1;1;16782;16579;29;33361
94;2020-07-17;0;0;0;23044;20580;39;43624
94;2020-07-17;0;1;1;23065;22140;49;45205
94;2020-07-17;0;0;0;24549;23421;59;47970
94;2020-07-17;0;0;0;23212;21883;69;45095
94;2020-07-17;0;0;0;19544;17141;79;36685
94;2020-07-17;0;0;0;11227;8178;89;19405
94;2020-07-17;0;0;0;3332;1447;90;4779
94;2020-07-17;0;2;2;177745;166934;0;344679
01;2020-07-18;0;0;0;19979;20155;09;40134
01;2020-07-18;0;0;0;24994;25489;19;50483
01;2020-07-18;0;0;0;17868;16690;29;34558
01;2020-07-18;1;0;1;22328;14821;39;37149
01;2020-07-18;0;0;0;28652;20276;49;48928
01;2020-07-18;0;0;0;33264;27260;59;60524
01;2020-07-18;0;0;0;27135;23978;69;51113
01;2020-07-18;0;0;0;18401;14661;79;33062
01;2020-07-18;0;0;0;9633;6375;89;16008
01;2020-07-18;0;0;0;3410;1510;90;4920
01;2020-07-18;1;0;1;205664;171215;0;376879
02;2020-07-18;0;0;0;16881;17110;09;33991
02;2020-07-18;0;0;0;21410;21604;19;43014
02;2020-07-18;0;0;0;16017;15479;29;31496
02;2020-07-18;0;0;0;19825;14455;39;34280
02;2020-07-18;0;0;0;24719;18248;49;42967
02;2020-07-18;0;0;0;34361;28310;59;62671
02;2020-07-18;0;0;0;28061;24495;69;52556
02;2020-07-18;0;0;0;18231;15278;79;33509
02;2020-07-18;0;0;0;11090;7677;89;18767
02;2020-07-18;0;0;0;3992;1506;90;5498
02;2020-07-18;0;0;0;194587;164162;0;358749
03;2020-07-18;2;5;7;31123;30920;09;62043
03;2020-07-18;4;2;7;29370;29268;19;58638
03;2020-07-18;5;4;9;21458;18963;29;40421
03;2020-07-18;2;4;6;21276;18326;39;39602
03;2020-07-18;7;3;10;18164;16593;49;34757
03;2020-07-18;3;5;8;13469;13557;59;27026
03;2020-07-18;1;0;1;8776;8670;69;17446
03;2020-07-18;1;0;1;3777;3591;79;7368
03;2020-07-18;0;1;1;1649;1072;89;2721
03;2020-07-18;0;0;0;485;184;90;669
03;2020-07-18;25;24;50;149547;141144;0;290691
04;2020-07-18;0;0;0;60314;61377;09;121691
04;2020-07-18;0;0;0;66065;68387;19;134452
04;2020-07-18;1;2;3;51059;47156;29;98215
04;2020-07-18;1;0;1;58788;45780;39;104568
04;2020-07-18;0;0;0;61408;52207;49;113615
04;2020-07-18;0;1;1;64838;60759;59;125597
04;2020-07-18;0;0;0;47008;42843;69;89851
04;2020-07-18;1;0;1;25509;21184;79;46693
04;2020-07-18;0;0;0;13168;7647;89;20815
04;2020-07-18;0;0;0;3209;1253;90;4462
04;2020-07-18;3;3;6;451366;408593;0;859959
05;2020-07-18;0;0;0;362.366008612902;341.338819562748;09;703.704828175651
05;2020-07-18;0;0;0;353.376145114279;370.349735405642;19;723.725880519921
05;2020-07-18;0;0;0;218.593559489256;256.539602589476;29;475.133162078732
05;2020-07-18;0;0;0;404.225408693299;360.321910454353;39;764.547319147651
05;2020-07-18;0;0;0;520.067953604221;497.108383964256;49;1017.17633756848
05;2020-07-18;0;0;0;468.146063921917;510.087601910415;59;978.233665832332
05;2020-07-18;0;0;0;340.368470050554;334.366842191253;69;674.735312241807
05;2020-07-18;0;0;0;212.598666888387;192.597753227106;79;405.196420115493
05;2020-07-18;0;0;0;148.727797095705;61.8681715431829;89;210.595968638888
05;2020-07-18;0;0;0;32.9601271090696;10.9909785719784;90;43.9511056810479
05;2020-07-18;0;0;0;3061.43020057959;2935.56979942041;0;5997
06;2020-07-18;0;0;0;42583;42380;09;84963
06;2020-07-18;0;0;0;33369;31925;19;65294
06;2020-07-18;0;0;0;21571;15080;29;36651
06;2020-07-18;2;0;2;21550;16147;39;37697
06;2020-07-18;0;0;0;14193;13939;49;28132
06;2020-07-18;0;0;0;7171;7597;59;14768
06;2020-07-18;0;0;0;3629;4117;69;7746
06;2020-07-18;0;0;0;1577;1457;79;3034
06;2020-07-18;0;0;0;531;474;89;1005
06;2020-07-18;0;0;0;88;93;90;181
06;2020-07-18;2;0;2;146262;133209;0;279471
07;2020-07-18;0;0;0;485;549;09;1034
07;2020-07-18;0;0;0;403;432;19;835
07;2020-07-18;0;0;0;764;841;29;1605
07;2020-07-18;0;0;0;824;928;39;1752
07;2020-07-18;0;0;0;788;1020;49;1808
07;2020-07-18;0;0;0;678;870;59;1548
07;2020-07-18;0;0;0;360;382;69;742
07;2020-07-18;0;0;0;231;190;79;421
07;2020-07-18;0;0;0;114;67;89;181
07;2020-07-18;0;0;0;24;11;90;35
07;2020-07-18;0;0;0;4671;5290;0;9961
08;2020-07-18;0;0;0;2715.22592983026;2997.75551488675;09;5712.98144471701
08;2020-07-18;0;0;0;2778.51901080978;3160.9156459093;19;5939.43465671908
08;2020-07-18;0;0;0;2080.8882988764;1718.16634315323;29;3799.05464202964
08;2020-07-18;0;0;0;2701.8582062647;1896.52641413317;39;4598.38462039786
08;2020-07-18;0;0;0;3151.45861023308;2460.52498233809;49;5611.98359257117
08;2020-07-18;0;0;0;2620.29868333099;2422.23566154656;59;5042.53434487755
08;2020-07-18;0;0;0;1621.44173420671;1438.58325779464;69;3060.02499200135
08;2020-07-18;0;0;0;626.575909335673;526.358467843651;79;1152.93437717932
08;2020-07-18;0;0;0;205.018522985054;140.993639349697;89;346.012162334751
08;2020-07-18;0;0;0;50.0325684687745;20.62259870351;90;70.6551671722846
08;2020-07-18;0;0;0;18551.3174743414;16782.6825256586;0;35334
11;2020-07-18;1;2;3;783071;811785;09;1594856
11;2020-07-18;4;5;9;761456;784653;19;1546109
11;2020-07-18;16;9;25;850145;801772;29;1651917
11;2020-07-18;11;14;25;914360;843488;39;1757848
11;2020-07-18;9;6;15;845609;826202;49;1671811
11;2020-07-18;7;6;13;793566;745070;59;1538636
11;2020-07-18;8;3;11;628649;549192;69;1177841
11;2020-07-18;7;5;12;434606;358356;79;792962
11;2020-07-18;1;2;3;261425;162933;89;424358
11;2020-07-18;2;2;4;89253;32619;90;121872
11;2020-07-18;66;54;120;6362140;5916070;0;12278210
24;2020-07-18;0;0;0;139720;144686;09;284406
24;2020-07-18;0;0;0;152979;161185;19;314164
24;2020-07-18;2;1;3;122237;126536;29;248773
24;2020-07-18;0;0;0;150359;142009;39;292368
24;2020-07-18;0;0;0;161829;158758;49;320587
24;2020-07-18;0;1;1;172552;168011;59;340563
24;2020-07-18;0;0;0;172509;158177;69;330686
24;2020-07-18;0;0;0;129428;110593;79;240021
24;2020-07-18;0;0;0;87342;56882;89;144224
24;2020-07-18;0;0;0;31210;12071;90;43281
24;2020-07-18;2;2;4;1320165;1238908;0;2559073
27;2020-07-18;0;0;0;143373;149679;09;293052
27;2020-07-18;0;0;0;160962;173003;19;333965
27;2020-07-18;0;0;0;133746;142254;29;276000
27;2020-07-18;1;1;2;160004;155407;39;315411
27;2020-07-18;1;0;1;172333;169564;49;341897
27;2020-07-18;1;0;1;189979;183788;59;373767
27;2020-07-18;0;0;0;192591;178206;69;370797
27;2020-07-18;0;0;0;146876;127546;79;274422
27;2020-07-18;0;0;0;96896;61575;89;158471
27;2020-07-18;1;0;1;33148;12109;90;45257
27;2020-07-18;4;1;5;1429908;1353131;0;2783039
28;2020-07-18;0;0;0;180735;186856;09;367591
28;2020-07-18;0;0;0;200125;213621;19;413746
28;2020-07-18;2;0;2;168922;173007;29;341929
28;2020-07-18;0;0;0;196628;188487;39;385115
28;2020-07-18;0;0;0;205396;201699;49;407095
28;2020-07-18;0;1;1;222002;213866;59;435868
28;2020-07-18;0;0;0;224688;203758;69;428446
28;2020-07-18;1;0;1;163192;135543;79;298735
28;2020-07-18;0;0;0;109691;65377;89;175068
28;2020-07-18;0;0;0;37222;12685;90;49907
28;2020-07-18;3;1;4;1708601;1594899;0;3303500
32;2020-07-18;0;1;2;358062;373689;09;731751
32;2020-07-18;5;6;11;387045;406742;19;793787
32;2020-07-18;10;0;10;342304;348587;29;690891
32;2020-07-18;2;6;8;382485;369972;39;752457
32;2020-07-18;5;2;7;382510;376716;49;759226
32;2020-07-18;3;1;4;386937;376527;59;763464
32;2020-07-18;1;2;3;371211;330938;69;702149
32;2020-07-18;1;1;2;250542;201459;79;452001
32;2020-07-18;0;0;0;163399;89786;89;253185
32;2020-07-18;0;0;0;48384;15367;90;63751
32;2020-07-18;27;19;47;3072879;2889783;0;5962662
44;2020-07-18;0;4;4;291525;306839;09;598364
44;2020-07-18;1;4;5;320255;339504;19;659759
44;2020-07-18;0;2;2;302020;314428;29;616448
44;2020-07-18;3;5;8;342222;333292;39;675514
44;2020-07-18;2;0;2;349727;344491;49;694218
44;2020-07-18;3;3;6;381371;373239;59;754610
44;2020-07-18;2;0;2;367165;335850;69;703015
44;2020-07-18;0;1;1;250387;215436;79;465823
44;2020-07-18;2;1;3;170825;105192;89;276017
44;2020-07-18;1;0;1;51248;16731;90;67979
44;2020-07-18;14;20;34;2826745;2685002;0;5511747
52;2020-07-18;2;1;3;213594;223900;09;437494
52;2020-07-18;8;7;15;240818;255197;19;496015
52;2020-07-18;5;5;10;197010;200630;29;397640
52;2020-07-18;8;5;13;231204;224885;39;456089
52;2020-07-18;5;1;6;243874;243418;49;487292
52;2020-07-18;3;4;7;244100;239116;59;483216
52;2020-07-18;6;1;7;241796;221345;69;463141
52;2020-07-18;1;0;1;177805;149903;79;327708
52;2020-07-18;0;1;1;119561;75822;89;195383
52;2020-07-18;0;0;0;42559;15260;90;57819
52;2020-07-18;38;25;63;1952321;1849476;0;3801797
53;2020-07-18;0;0;0;173813;182358;09;356171
53;2020-07-18;0;0;0;202720;214740;19;417460
53;2020-07-18;3;1;4;163116;173196;29;336312
53;2020-07-18;0;1;1;190526;187674;39;378200
53;2020-07-18;0;1;1;212098;212015;49;424113
53;2020-07-18;0;0;0;223699;219176;59;442875
53;2020-07-18;2;0;2;227435;209274;69;436709
53;2020-07-18;0;1;1;169992;140910;79;310902
53;2020-07-18;0;0;0;118117;69883;89;188000
53;2020-07-18;0;0;0;37370;12267;90;49637
53;2020-07-18;5;4;9;1718886;1621493;0;3340379
75;2020-07-18;0;3;3;293104;305291;09;598395
75;2020-07-18;0;0;0;337141;357785;19;694926
75;2020-07-18;6;3;9;295024;300618;29;595642
75;2020-07-18;0;2;2;347871;331233;39;679104
75;2020-07-18;0;0;0;384742;372771;49;757513
75;2020-07-18;0;1;1;413361;390880;59;804241
75;2020-07-18;0;0;0;425623;384060;69;809683
75;2020-07-18;1;0;1;325086;276298;79;601384
75;2020-07-18;1;0;1;213986;139308;89;353294
75;2020-07-18;0;0;0;77600;28200;90;105800
75;2020-07-18;8;9;17;3113538;2886444;0;5999982
76;2020-07-18;2;0;2;305956;318589;09;624545
76;2020-07-18;3;1;4;338942;356969;19;695911
76;2020-07-18;1;2;3;316210;319570;29;635780
76;2020-07-18;1;1;2;356758;337587;39;694345
76;2020-07-18;2;2;4;376541;363812;49;740353
76;2020-07-18;3;0;3;402608;383750;59;786358
76;2020-07-18;0;0;0;394889;358997;69;753886
76;2020-07-18;0;1;1;308664;263806;79;572470
76;2020-07-18;0;0;0;195838;129272;89;325110
76;2020-07-18;0;0;0;69372;26728;90;96100
76;2020-07-18;12;7;19;3065778;2859080;0;5924858
84;2020-07-18;0;0;0;459549;481088;09;940637
84;2020-07-18;1;1;2;487711;511905;19;999616
84;2020-07-18;2;3;5;443824;451094;29;894918
84;2020-07-18;6;1;7;512522;493262;39;1005784
84;2020-07-18;1;3;4;520248;515106;49;1035354
84;2020-07-18;2;4;6;529611;514848;59;1044459
84;2020-07-18;3;3;6;486720;439940;69;926660
84;2020-07-18;0;0;0;372151;315211;79;687362
84;2020-07-18;1;0;1;237198;150524;89;387722
84;2020-07-18;1;0;1;81185;28680;90;109865
84;2020-07-18;17;15;32;4130719;3901658;0;8032377
93;2020-07-18;0;3;3;268834;283093;09;551927
93;2020-07-18;3;0;3;280751;296087;19;576838
93;2020-07-18;1;0;1;254404;255552;29;509956
93;2020-07-18;1;2;3;310704;288398;39;599102
93;2020-07-18;2;4;6;325559;305827;49;631386
93;2020-07-18;1;2;3;353104;325389;59;678493
93;2020-07-18;1;3;4;336327;296459;69;632786
93;2020-07-18;2;1;3;279820;229699;79;509519
93;2020-07-18;0;0;0;171274;113716;89;284990
93;2020-07-18;0;0;0;58896;21758;90;80654
93;2020-07-18;11;15;27;2639673;2415978;0;5055651
94;2020-07-18;0;0;0;16311;17433;09;33744
94;2020-07-18;0;0;0;16679;18132;19;34811
94;2020-07-18;0;0;0;16782;16579;29;33361
94;2020-07-18;0;0;0;23044;20580;39;43624
94;2020-07-18;0;0;0;23065;22140;49;45205
94;2020-07-18;0;0;0;24549;23421;59;47970
94;2020-07-18;1;0;1;23212;21883;69;45095
94;2020-07-18;0;0;0;19544;17141;79;36685
94;2020-07-18;0;0;0;11227;8178;89;19405
94;2020-07-18;0;0;0;3332;1447;90;4779
94;2020-07-18;1;0;1;177745;166934;0;344679
01;2020-07-19;0;0;0;19979;20155;09;40134
01;2020-07-19;0;0;0;24994;25489;19;50483
01;2020-07-19;0;0;0;17868;16690;29;34558
01;2020-07-19;0;0;0;22328;14821;39;37149
01;2020-07-19;0;0;0;28652;20276;49;48928
01;2020-07-19;0;0;0;33264;27260;59;60524
01;2020-07-19;0;0;0;27135;23978;69;51113
01;2020-07-19;0;0;0;18401;14661;79;33062
01;2020-07-19;0;0;0;9633;6375;89;16008
01;2020-07-19;0;0;0;3410;1510;90;4920
01;2020-07-19;0;0;0;205664;171215;0;376879
02;2020-07-19;0;0;0;16881;17110;09;33991
02;2020-07-19;0;0;0;21410;21604;19;43014
02;2020-07-19;0;0;0;16017;15479;29;31496
02;2020-07-19;0;0;0;19825;14455;39;34280
02;2020-07-19;0;0;0;24719;18248;49;42967
02;2020-07-19;0;0;0;34361;28310;59;62671
02;2020-07-19;0;0;0;28061;24495;69;52556
02;2020-07-19;0;0;0;18231;15278;79;33509
02;2020-07-19;0;0;0;11090;7677;89;18767
02;2020-07-19;0;0;0;3992;1506;90;5498
02;2020-07-19;0;0;0;194587;164162;0;358749
03;2020-07-19;0;1;1;31123;30920;09;62043
03;2020-07-19;1;4;5;29370;29268;19;58638
03;2020-07-19;7;9;19;21458;18963;29;40421
03;2020-07-19;7;8;16;21276;18326;39;39602
03;2020-07-19;7;14;25;18164;16593;49;34757
03;2020-07-19;3;6;10;13469;13557;59;27026
03;2020-07-19;1;5;6;8776;8670;69;17446
03;2020-07-19;0;0;0;3777;3591;79;7368
03;2020-07-19;0;0;0;1649;1072;89;2721
03;2020-07-19;0;0;0;485;184;90;669
03;2020-07-19;26;47;82;149547;141144;0;290691
04;2020-07-19;0;0;0;60314;61377;09;121691
04;2020-07-19;0;1;1;66065;68387;19;134452
04;2020-07-19;0;0;0;51059;47156;29;98215
04;2020-07-19;0;0;0;58788;45780;39;104568
04;2020-07-19;0;0;0;61408;52207;49;113615
04;2020-07-19;0;1;1;64838;60759;59;125597
04;2020-07-19;0;0;0;47008;42843;69;89851
04;2020-07-19;0;0;0;25509;21184;79;46693
04;2020-07-19;0;0;0;13168;7647;89;20815
04;2020-07-19;0;0;0;3209;1253;90;4462
04;2020-07-19;0;2;2;451366;408593;0;859959
05;2020-07-19;0;0;0;362.366008612902;341.338819562748;09;703.704828175651
05;2020-07-19;0;0;0;353.376145114279;370.349735405642;19;723.725880519921
05;2020-07-19;0;0;0;218.593559489256;256.539602589476;29;475.133162078732
05;2020-07-19;0;0;0;404.225408693299;360.321910454353;39;764.547319147651
05;2020-07-19;0;0;0;520.067953604221;497.108383964256;49;1017.17633756848
05;2020-07-19;0;0;0;468.146063921917;510.087601910415;59;978.233665832332
05;2020-07-19;0;0;0;340.368470050554;334.366842191253;69;674.735312241807
05;2020-07-19;0;0;0;212.598666888387;192.597753227106;79;405.196420115493
05;2020-07-19;0;0;0;148.727797095705;61.8681715431829;89;210.595968638888
05;2020-07-19;0;0;0;32.9601271090696;10.9909785719784;90;43.9511056810479
05;2020-07-19;0;0;0;3061.43020057959;2935.56979942041;0;5997
06;2020-07-19;0;0;0;42583;42380;09;84963
06;2020-07-19;0;1;1;33369;31925;19;65294
06;2020-07-19;0;0;0;21571;15080;29;36651
06;2020-07-19;0;1;1;21550;16147;39;37697
06;2020-07-19;2;0;2;14193;13939;49;28132
06;2020-07-19;0;0;0;7171;7597;59;14768
06;2020-07-19;0;0;0;3629;4117;69;7746
06;2020-07-19;1;0;1;1577;1457;79;3034
06;2020-07-19;0;0;0;531;474;89;1005
06;2020-07-19;0;0;0;88;93;90;181
06;2020-07-19;3;2;5;146262;133209;0;279471
07;2020-07-19;0;0;0;485;549;09;1034
07;2020-07-19;0;0;0;403;432;19;835
07;2020-07-19;0;0;0;764;841;29;1605
07;2020-07-19;0;0;0;824;928;39;1752
07;2020-07-19;0;0;0;788;1020;49;1808
07;2020-07-19;0;0;0;678;870;59;1548
07;2020-07-19;0;0;0;360;382;69;742
07;2020-07-19;0;0;0;231;190;79;421
07;2020-07-19;0;0;0;114;67;89;181
07;2020-07-19;0;0;0;24;11;90;35
07;2020-07-19;0;0;0;4671;5290;0;9961
08;2020-07-19;0;0;0;2715.22592983026;2997.75551488675;09;5712.98144471701
08;2020-07-19;0;0;0;2778.51901080978;3160.9156459093;19;5939.43465671908
08;2020-07-19;0;0;0;2080.8882988764;1718.16634315323;29;3799.05464202964
08;2020-07-19;0;0;0;2701.8582062647;1896.52641413317;39;4598.38462039786
08;2020-07-19;0;0;0;3151.45861023308;2460.52498233809;49;5611.98359257117
08;2020-07-19;0;0;0;2620.29868333099;2422.23566154656;59;5042.53434487755
08;2020-07-19;0;0;0;1621.44173420671;1438.58325779464;69;3060.02499200135
08;2020-07-19;0;0;0;626.575909335673;526.358467843651;79;1152.93437717932
08;2020-07-19;0;0;0;205.018522985054;140.993639349697;89;346.012162334751
08;2020-07-19;0;0;0;50.0325684687745;20.62259870351;90;70.6551671722846
08;2020-07-19;0;0;0;18551.3174743414;16782.6825256586;0;35334
11;2020-07-19;0;1;1;783071;811785;09;1594856
11;2020-07-19;3;0;3;761456;784653;19;1546109
11;2020-07-19;3;3;6;850145;801772;29;1651917
11;2020-07-19;2;4;6;914360;843488;39;1757848
11;2020-07-19;4;1;6;845609;826202;49;1671811
11;2020-07-19;1;3;4;793566;745070;59;1538636
11;2020-07-19;1;1;2;628649;549192;69;1177841
11;2020-07-19;0;3;3;434606;358356;79;792962
11;2020-07-19;0;0;0;261425;162933;89;424358
11;2020-07-19;0;0;0;89253;32619;90;121872
11;2020-07-19;14;16;31;6362140;5916070;0;12278210
24;2020-07-19;0;0;0;139720;144686;09;284406
24;2020-07-19;0;0;0;152979;161185;19;314164
24;2020-07-19;2;0;2;122237;126536;29;248773
24;2020-07-19;0;0;0;150359;142009;39;292368
24;2020-07-19;0;0;0;161829;158758;49;320587
24;2020-07-19;0;0;0;172552;168011;59;340563
24;2020-07-19;0;0;0;172509;158177;69;330686
24;2020-07-19;0;0;0;129428;110593;79;240021
24;2020-07-19;0;0;0;87342;56882;89;144224
24;2020-07-19;0;0;0;31210;12071;90;43281
24;2020-07-19;2;0;2;1320165;1238908;0;2559073
27;2020-07-19;0;0;0;143373;149679;09;293052
27;2020-07-19;0;0;0;160962;173003;19;333965
27;2020-07-19;0;1;1;133746;142254;29;276000
27;2020-07-19;0;1;1;160004;155407;39;315411
27;2020-07-19;0;0;0;172333;169564;49;341897
27;2020-07-19;0;0;0;189979;183788;59;373767
27;2020-07-19;2;1;3;192591;178206;69;370797
27;2020-07-19;0;1;1;146876;127546;79;274422
27;2020-07-19;0;0;0;96896;61575;89;158471
27;2020-07-19;0;0;0;33148;12109;90;45257
27;2020-07-19;2;4;6;1429908;1353131;0;2783039
28;2020-07-19;0;0;0;180735;186856;09;367591
28;2020-07-19;0;0;0;200125;213621;19;413746
28;2020-07-19;0;0;0;168922;173007;29;341929
28;2020-07-19;0;0;0;196628;188487;39;385115
28;2020-07-19;0;0;0;205396;201699;49;407095
28;2020-07-19;1;1;2;222002;213866;59;435868
28;2020-07-19;0;1;1;224688;203758;69;428446
28;2020-07-19;0;0;0;163192;135543;79;298735
28;2020-07-19;0;0;0;109691;65377;89;175068
28;2020-07-19;0;0;0;37222;12685;90;49907
28;2020-07-19;1;2;3;1708601;1594899;0;3303500
32;2020-07-19;0;1;1;358062;373689;09;731751
32;2020-07-19;0;0;0;387045;406742;19;793787
32;2020-07-19;1;0;1;342304;348587;29;690891
32;2020-07-19;1;0;1;382485;369972;39;752457
32;2020-07-19;0;0;0;382510;376716;49;759226
32;2020-07-19;0;0;0;386937;376527;59;763464
32;2020-07-19;0;0;0;371211;330938;69;702149
32;2020-07-19;2;0;2;250542;201459;79;452001
32;2020-07-19;1;0;1;163399;89786;89;253185
32;2020-07-19;0;0;0;48384;15367;90;63751
32;2020-07-19;5;1;6;3072879;2889783;0;5962662
44;2020-07-19;0;0;0;291525;306839;09;598364
44;2020-07-19;0;0;0;320255;339504;19;659759
44;2020-07-19;0;0;0;302020;314428;29;616448
44;2020-07-19;0;0;0;342222;333292;39;675514
44;2020-07-19;0;0;0;349727;344491;49;694218
44;2020-07-19;0;0;0;381371;373239;59;754610
44;2020-07-19;1;0;1;367165;335850;69;703015
44;2020-07-19;0;1;1;250387;215436;79;465823
44;2020-07-19;0;0;0;170825;105192;89;276017
44;2020-07-19;1;0;1;51248;16731;90;67979
44;2020-07-19;2;1;3;2826745;2685002;0;5511747
52;2020-07-19;1;0;2;213594;223900;09;437494
52;2020-07-19;1;6;7;240818;255197;19;496015
52;2020-07-19;2;5;7;197010;200630;29;397640
52;2020-07-19;2;2;4;231204;224885;39;456089
52;2020-07-19;0;2;2;243874;243418;49;487292
52;2020-07-19;1;0;1;244100;239116;59;483216
52;2020-07-19;0;1;1;241796;221345;69;463141
52;2020-07-19;0;0;0;177805;149903;79;327708
52;2020-07-19;0;0;0;119561;75822;89;195383
52;2020-07-19;0;0;0;42559;15260;90;57819
52;2020-07-19;7;16;24;1952321;1849476;0;3801797
53;2020-07-19;0;0;0;173813;182358;09;356171
53;2020-07-19;0;0;0;202720;214740;19;417460
53;2020-07-19;0;1;1;163116;173196;29;336312
53;2020-07-19;0;0;0;190526;187674;39;378200
53;2020-07-19;0;0;0;212098;212015;49;424113
53;2020-07-19;0;0;0;223699;219176;59;442875
53;2020-07-19;0;0;0;227435;209274;69;436709
53;2020-07-19;0;0;0;169992;140910;79;310902
53;2020-07-19;0;0;0;118117;69883;89;188000
53;2020-07-19;0;0;0;37370;12267;90;49637
53;2020-07-19;0;1;1;1718886;1621493;0;3340379
75;2020-07-19;0;0;0;293104;305291;09;598395
75;2020-07-19;0;0;0;337141;357785;19;694926
75;2020-07-19;2;2;4;295024;300618;29;595642
75;2020-07-19;0;0;0;347871;331233;39;679104
75;2020-07-19;0;0;0;384742;372771;49;757513
75;2020-07-19;0;1;1;413361;390880;59;804241
75;2020-07-19;0;1;1;425623;384060;69;809683
75;2020-07-19;0;0;0;325086;276298;79;601384
75;2020-07-19;0;0;0;213986;139308;89;353294
75;2020-07-19;0;0;0;77600;28200;90;105800
75;2020-07-19;2;4;6;3113538;2886444;0;5999982
76;2020-07-19;0;0;0;305956;318589;09;624545
76;2020-07-19;0;0;0;338942;356969;19;695911
76;2020-07-19;0;0;0;316210;319570;29;635780
76;2020-07-19;0;0;0;356758;337587;39;694345
76;2020-07-19;0;0;0;376541;363812;49;740353
76;2020-07-19;0;0;0;402608;383750;59;786358
76;2020-07-19;0;2;2;394889;358997;69;753886
76;2020-07-19;0;0;0;308664;263806;79;572470
76;2020-07-19;0;0;0;195838;129272;89;325110
76;2020-07-19;0;0;0;69372;26728;90;96100
76;2020-07-19;0;2;2;3065778;2859080;0;5924858
84;2020-07-19;0;0;0;459549;481088;09;940637
84;2020-07-19;0;0;0;487711;511905;19;999616
84;2020-07-19;0;0;0;443824;451094;29;894918
84;2020-07-19;1;0;1;512522;493262;39;1005784
84;2020-07-19;0;1;1;520248;515106;49;1035354
84;2020-07-19;1;0;1;529611;514848;59;1044459
84;2020-07-19;1;1;2;486720;439940;69;926660
84;2020-07-19;2;0;2;372151;315211;79;687362
84;2020-07-19;0;1;1;237198;150524;89;387722
84;2020-07-19;1;0;1;81185;28680;90;109865
84;2020-07-19;6;3;9;4130719;3901658;0;8032377
93;2020-07-19;0;0;0;268834;283093;09;551927
93;2020-07-19;1;0;1;280751;296087;19;576838
93;2020-07-19;0;1;1;254404;255552;29;509956
93;2020-07-19;0;3;3;310704;288398;39;599102
93;2020-07-19;0;2;2;325559;305827;49;631386
93;2020-07-19;0;0;0;353104;325389;59;678493
93;2020-07-19;0;0;0;336327;296459;69;632786
93;2020-07-19;0;1;1;279820;229699;79;509519
93;2020-07-19;1;1;2;171274;113716;89;284990
93;2020-07-19;0;0;0;58896;21758;90;80654
93;2020-07-19;2;8;10;2639673;2415978;0;5055651
94;2020-07-19;0;0;0;16311;17433;09;33744
94;2020-07-19;0;0;0;16679;18132;19;34811
94;2020-07-19;0;0;0;16782;16579;29;33361
94;2020-07-19;0;0;0;23044;20580;39;43624
94;2020-07-19;0;0;0;23065;22140;49;45205
94;2020-07-19;0;0;0;24549;23421;59;47970
94;2020-07-19;0;0;0;23212;21883;69;45095
94;2020-07-19;0;0;0;19544;17141;79;36685
94;2020-07-19;0;0;0;11227;8178;89;19405
94;2020-07-19;0;0;0;3332;1447;90;4779
94;2020-07-19;0;0;0;177745;166934;0;344679
01;2020-07-20;0;0;0;19979;20155;09;40134
01;2020-07-20;0;0;0;24994;25489;19;50483
01;2020-07-20;0;0;0;17868;16690;29;34558
01;2020-07-20;0;0;0;22328;14821;39;37149
01;2020-07-20;0;0;0;28652;20276;49;48928
01;2020-07-20;0;0;0;33264;27260;59;60524
01;2020-07-20;0;0;0;27135;23978;69;51113
01;2020-07-20;0;0;0;18401;14661;79;33062
01;2020-07-20;0;0;0;9633;6375;89;16008
01;2020-07-20;0;0;0;3410;1510;90;4920
01;2020-07-20;0;0;0;205664;171215;0;376879
02;2020-07-20;0;0;0;16881;17110;09;33991
02;2020-07-20;0;0;0;21410;21604;19;43014
02;2020-07-20;1;0;1;16017;15479;29;31496
02;2020-07-20;0;0;0;19825;14455;39;34280
02;2020-07-20;0;0;0;24719;18248;49;42967
02;2020-07-20;0;1;1;34361;28310;59;62671
02;2020-07-20;0;0;0;28061;24495;69;52556
02;2020-07-20;0;0;0;18231;15278;79;33509
02;2020-07-20;0;0;0;11090;7677;89;18767
02;2020-07-20;0;0;0;3992;1506;90;5498
02;2020-07-20;1;1;2;194587;164162;0;358749
03;2020-07-20;7;9;16;31123;30920;09;62043
03;2020-07-20;7;7;15;29370;29268;19;58638
03;2020-07-20;10;9;19;21458;18963;29;40421
03;2020-07-20;11;6;17;21276;18326;39;39602
03;2020-07-20;5;9;14;18164;16593;49;34757
03;2020-07-20;6;6;12;13469;13557;59;27026
03;2020-07-20;1;3;4;8776;8670;69;17446
03;2020-07-20;1;2;3;3777;3591;79;7368
03;2020-07-20;1;1;2;1649;1072;89;2721
03;2020-07-20;0;0;0;485;184;90;669
03;2020-07-20;49;52;102;149547;141144;0;290691
04;2020-07-20;0;0;0;60314;61377;09;121691
04;2020-07-20;1;0;1;66065;68387;19;134452
04;2020-07-20;1;1;2;51059;47156;29;98215
04;2020-07-20;0;1;1;58788;45780;39;104568
04;2020-07-20;0;0;0;61408;52207;49;113615
04;2020-07-20;0;0;0;64838;60759;59;125597
04;2020-07-20;2;0;2;47008;42843;69;89851
04;2020-07-20;0;0;0;25509;21184;79;46693
04;2020-07-20;0;0;0;13168;7647;89;20815
04;2020-07-20;0;0;0;3209;1253;90;4462
04;2020-07-20;4;2;6;451366;408593;0;859959
05;2020-07-20;0;0;0;362.366008612902;341.338819562748;09;703.704828175651
05;2020-07-20;0;0;0;353.376145114279;370.349735405642;19;723.725880519921
05;2020-07-20;0;0;0;218.593559489256;256.539602589476;29;475.133162078732
05;2020-07-20;0;0;0;404.225408693299;360.321910454353;39;764.547319147651
05;2020-07-20;0;0;0;520.067953604221;497.108383964256;49;1017.17633756848
05;2020-07-20;0;0;0;468.146063921917;510.087601910415;59;978.233665832332
05;2020-07-20;0;0;0;340.368470050554;334.366842191253;69;674.735312241807
05;2020-07-20;0;0;0;212.598666888387;192.597753227106;79;405.196420115493
05;2020-07-20;0;0;0;148.727797095705;61.8681715431829;89;210.595968638888
05;2020-07-20;0;0;0;32.9601271090696;10.9909785719784;90;43.9511056810479
05;2020-07-20;0;0;0;3061.43020057959;2935.56979942041;0;5997
06;2020-07-20;0;0;0;42583;42380;09;84963
06;2020-07-20;2;2;4;33369;31925;19;65294
06;2020-07-20;2;3;5;21571;15080;29;36651
06;2020-07-20;3;1;4;21550;16147;39;37697
06;2020-07-20;0;1;1;14193;13939;49;28132
06;2020-07-20;0;0;0;7171;7597;59;14768
06;2020-07-20;0;0;0;3629;4117;69;7746
06;2020-07-20;0;1;1;1577;1457;79;3034
06;2020-07-20;0;0;0;531;474;89;1005
06;2020-07-20;0;0;0;88;93;90;181
06;2020-07-20;7;8;15;146262;133209;0;279471
07;2020-07-20;0;0;0;485;549;09;1034
07;2020-07-20;0;0;0;403;432;19;835
07;2020-07-20;0;0;0;764;841;29;1605
07;2020-07-20;0;0;0;824;928;39;1752
07;2020-07-20;0;0;0;788;1020;49;1808
07;2020-07-20;0;0;0;678;870;59;1548
07;2020-07-20;0;0;0;360;382;69;742
07;2020-07-20;0;0;0;231;190;79;421
07;2020-07-20;0;0;0;114;67;89;181
07;2020-07-20;0;0;0;24;11;90;35
07;2020-07-20;0;0;0;4671;5290;0;9961
08;2020-07-20;0;0;0;2715.22592983026;2997.75551488675;09;5712.98144471701
08;2020-07-20;0;0;0;2778.51901080978;3160.9156459093;19;5939.43465671908
08;2020-07-20;1;0;1;2080.8882988764;1718.16634315323;29;3799.05464202964
08;2020-07-20;0;0;0;2701.8582062647;1896.52641413317;39;4598.38462039786
08;2020-07-20;0;0;0;3151.45861023308;2460.52498233809;49;5611.98359257117
08;2020-07-20;0;0;0;2620.29868333099;2422.23566154656;59;5042.53434487755
08;2020-07-20;0;0;0;1621.44173420671;1438.58325779464;69;3060.02499200135
08;2020-07-20;1;0;1;626.575909335673;526.358467843651;79;1152.93437717932
08;2020-07-20;0;0;0;205.018522985054;140.993639349697;89;346.012162334751
08;2020-07-20;0;0;0;50.0325684687745;20.62259870351;90;70.6551671722846
08;2020-07-20;2;0;2;18551.3174743414;16782.6825256586;0;35334
11;2020-07-20;7;6;13;783071;811785;09;1594856
11;2020-07-20;14;18;32;761456;784653;19;1546109
11;2020-07-20;27;28;55;850145;801772;29;1651917
11;2020-07-20;31;30;61;914360;843488;39;1757848
11;2020-07-20;18;28;46;845609;826202;49;1671811
11;2020-07-20;26;24;50;793566;745070;59;1538636
11;2020-07-20;8;21;29;628649;549192;69;1177841
11;2020-07-20;13;10;23;434606;358356;79;792962
11;2020-07-20;4;5;9;261425;162933;89;424358
11;2020-07-20;5;3;8;89253;32619;90;121872
11;2020-07-20;153;173;328;6362140;5916070;0;12278210
24;2020-07-20;0;0;0;139720;144686;09;284406
24;2020-07-20;0;0;0;152979;161185;19;314164
24;2020-07-20;4;2;6;122237;126536;29;248773
24;2020-07-20;0;0;0;150359;142009;39;292368
24;2020-07-20;1;1;2;161829;158758;49;320587
24;2020-07-20;0;0;0;172552;168011;59;340563
24;2020-07-20;2;2;4;172509;158177;69;330686
24;2020-07-20;1;2;3;129428;110593;79;240021
24;2020-07-20;2;0;2;87342;56882;89;144224
24;2020-07-20;0;0;0;31210;12071;90;43281
24;2020-07-20;10;7;17;1320165;1238908;0;2559073
27;2020-07-20;0;0;0;143373;149679;09;293052
27;2020-07-20;3;2;5;160962;173003;19;333965
27;2020-07-20;1;1;2;133746;142254;29;276000
27;2020-07-20;1;0;1;160004;155407;39;315411
27;2020-07-20;3;0;3;172333;169564;49;341897
27;2020-07-20;1;0;1;189979;183788;59;373767
27;2020-07-20;1;1;2;192591;178206;69;370797
27;2020-07-20;2;2;4;146876;127546;79;274422
27;2020-07-20;1;0;1;96896;61575;89;158471
27;2020-07-20;1;0;1;33148;12109;90;45257
27;2020-07-20;14;6;20;1429908;1353131;0;2783039
28;2020-07-20;1;2;3;180735;186856;09;367591
28;2020-07-20;0;1;1;200125;213621;19;413746
28;2020-07-20;0;2;3;168922;173007;29;341929
28;2020-07-20;1;0;1;196628;188487;39;385115
28;2020-07-20;1;0;1;205396;201699;49;407095
28;2020-07-20;0;0;0;222002;213866;59;435868
28;2020-07-20;1;0;1;224688;203758;69;428446
28;2020-07-20;2;1;3;163192;135543;79;298735
28;2020-07-20;4;0;4;109691;65377;89;175068
28;2020-07-20;1;0;1;37222;12685;90;49907
28;2020-07-20;11;6;18;1708601;1594899;0;3303500
32;2020-07-20;2;1;3;358062;373689;09;731751
32;2020-07-20;3;4;7;387045;406742;19;793787
32;2020-07-20;10;11;21;342304;348587;29;690891
32;2020-07-20;12;7;19;382485;369972;39;752457
32;2020-07-20;4;2;6;382510;376716;49;759226
32;2020-07-20;4;6;10;386937;376527;59;763464
32;2020-07-20;2;6;8;371211;330938;69;702149
32;2020-07-20;2;1;3;250542;201459;79;452001
32;2020-07-20;4;0;4;163399;89786;89;253185
32;2020-07-20;1;0;1;48384;15367;90;63751
32;2020-07-20;44;38;82;3072879;2889783;0;5962662
44;2020-07-20;2;1;3;291525;306839;09;598364
44;2020-07-20;4;3;7;320255;339504;19;659759
44;2020-07-20;4;3;7;302020;314428;29;616448
44;2020-07-20;4;5;9;342222;333292;39;675514
44;2020-07-20;8;6;14;349727;344491;49;694218
44;2020-07-20;5;6;11;381371;373239;59;754610
44;2020-07-20;5;2;7;367165;335850;69;703015
44;2020-07-20;2;3;5;250387;215436;79;465823
44;2020-07-20;2;2;4;170825;105192;89;276017
44;2020-07-20;1;0;1;51248;16731;90;67979
44;2020-07-20;37;31;68;2826745;2685002;0;5511747
52;2020-07-20;1;0;1;213594;223900;09;437494
52;2020-07-20;9;4;13;240818;255197;19;496015
52;2020-07-20;21;21;42;197010;200630;29;397640
52;2020-07-20;13;13;26;231204;224885;39;456089
52;2020-07-20;5;8;13;243874;243418;49;487292
52;2020-07-20;9;4;13;244100;239116;59;483216
52;2020-07-20;4;5;9;241796;221345;69;463141
52;2020-07-20;0;2;2;177805;149903;79;327708
52;2020-07-20;2;0;2;119561;75822;89;195383
52;2020-07-20;2;2;4;42559;15260;90;57819
52;2020-07-20;66;59;125;1952321;1849476;0;3801797
53;2020-07-20;0;0;0;173813;182358;09;356171
53;2020-07-20;4;3;7;202720;214740;19;417460
53;2020-07-20;2;2;4;163116;173196;29;336312
53;2020-07-20;0;5;5;190526;187674;39;378200
53;2020-07-20;1;2;3;212098;212015;49;424113
53;2020-07-20;2;1;3;223699;219176;59;442875
53;2020-07-20;1;0;1;227435;209274;69;436709
53;2020-07-20;0;1;1;169992;140910;79;310902
53;2020-07-20;2;0;2;118117;69883;89;188000
53;2020-07-20;0;0;0;37370;12267;90;49637
53;2020-07-20;12;14;26;1718886;1621493;0;3340379
75;2020-07-20;0;0;0;293104;305291;09;598395
75;2020-07-20;1;0;1;337141;357785;19;694926
75;2020-07-20;1;1;2;295024;300618;29;595642
75;2020-07-20;3;2;5;347871;331233;39;679104
75;2020-07-20;0;1;1;384742;372771;49;757513
75;2020-07-20;0;2;2;413361;390880;59;804241
75;2020-07-20;3;1;4;425623;384060;69;809683
75;2020-07-20;2;0;2;325086;276298;79;601384
75;2020-07-20;1;1;2;213986;139308;89;353294
75;2020-07-20;0;0;0;77600;28200;90;105800
75;2020-07-20;11;8;19;3113538;2886444;0;5999982
76;2020-07-20;3;3;6;305956;318589;09;624545
76;2020-07-20;3;1;4;338942;356969;19;695911
76;2020-07-20;10;6;16;316210;319570;29;635780
76;2020-07-20;3;8;11;356758;337587;39;694345
76;2020-07-20;2;1;3;376541;363812;49;740353
76;2020-07-20;4;1;5;402608;383750;59;786358
76;2020-07-20;3;3;6;394889;358997;69;753886
76;2020-07-20;0;4;4;308664;263806;79;572470
76;2020-07-20;1;0;1;195838;129272;89;325110
76;2020-07-20;1;1;2;69372;26728;90;96100
76;2020-07-20;30;28;58;3065778;2859080;0;5924858
84;2020-07-20;5;3;8;459549;481088;09;940637
84;2020-07-20;5;2;7;487711;511905;19;999616
84;2020-07-20;10;3;13;443824;451094;29;894918
84;2020-07-20;8;5;13;512522;493262;39;1005784
84;2020-07-20;7;5;12;520248;515106;49;1035354
84;2020-07-20;5;4;9;529611;514848;59;1044459
84;2020-07-20;5;2;7;486720;439940;69;926660
84;2020-07-20;2;3;5;372151;315211;79;687362
84;2020-07-20;0;1;1;237198;150524;89;387722
84;2020-07-20;0;1;1;81185;28680;90;109865
84;2020-07-20;47;29;76;4130719;3901658;0;8032377
93;2020-07-20;0;0;0;268834;283093;09;551927
93;2020-07-20;1;0;1;280751;296087;19;576838
93;2020-07-20;4;2;6;254404;255552;29;509956
93;2020-07-20;8;11;19;310704;288398;39;599102
93;2020-07-20;3;6;9;325559;305827;49;631386
93;2020-07-20;5;9;14;353104;325389;59;678493
93;2020-07-20;2;6;9;336327;296459;69;632786
93;2020-07-20;3;2;5;279820;229699;79;509519
93;2020-07-20;0;1;1;171274;113716;89;284990
93;2020-07-20;0;0;0;58896;21758;90;80654
93;2020-07-20;26;37;64;2639673;2415978;0;5055651
94;2020-07-20;0;0;0;16311;17433;09;33744
94;2020-07-20;0;0;0;16679;18132;19;34811
94;2020-07-20;0;0;0;16782;16579;29;33361
94;2020-07-20;0;0;0;23044;20580;39;43624
94;2020-07-20;0;0;0;23065;22140;49;45205
94;2020-07-20;0;0;0;24549;23421;59;47970
94;2020-07-20;0;0;0;23212;21883;69;45095
94;2020-07-20;0;0;0;19544;17141;79;36685
94;2020-07-20;0;0;0;11227;8178;89;19405
94;2020-07-20;0;0;0;3332;1447;90;4779
94;2020-07-20;0;0;0;177745;166934;0;344679
01;2020-07-21;0;0;0;19979;20155;09;40134
01;2020-07-21;0;0;0;24994;25489;19;50483
01;2020-07-21;0;1;1;17868;16690;29;34558
01;2020-07-21;0;0;0;22328;14821;39;37149
01;2020-07-21;0;0;0;28652;20276;49;48928
01;2020-07-21;0;0;0;33264;27260;59;60524
01;2020-07-21;0;0;0;27135;23978;69;51113
01;2020-07-21;0;0;0;18401;14661;79;33062
01;2020-07-21;0;0;0;9633;6375;89;16008
01;2020-07-21;0;0;0;3410;1510;90;4920
01;2020-07-21;0;1;1;205664;171215;0;376879
02;2020-07-21;0;0;0;16881;17110;09;33991
02;2020-07-21;0;0;0;21410;21604;19;43014
02;2020-07-21;0;0;0;16017;15479;29;31496
02;2020-07-21;1;0;1;19825;14455;39;34280
02;2020-07-21;0;0;0;24719;18248;49;42967
02;2020-07-21;0;0;0;34361;28310;59;62671
02;2020-07-21;0;0;0;28061;24495;69;52556
02;2020-07-21;0;0;0;18231;15278;79;33509
02;2020-07-21;0;0;0;11090;7677;89;18767
02;2020-07-21;0;0;0;3992;1506;90;5498
02;2020-07-21;1;0;1;194587;164162;0;358749
03;2020-07-21;4;3;7;31123;30920;09;62043
03;2020-07-21;11;4;15;29370;29268;19;58638
03;2020-07-21;17;4;21;21458;18963;29;40421
03;2020-07-21;14;10;24;21276;18326;39;39602
03;2020-07-21;6;7;13;18164;16593;49;34757
03;2020-07-21;7;3;10;13469;13557;59;27026
03;2020-07-21;5;4;9;8776;8670;69;17446
03;2020-07-21;4;0;4;3777;3591;79;7368
03;2020-07-21;2;2;4;1649;1072;89;2721
03;2020-07-21;0;0;0;485;184;90;669
03;2020-07-21;70;37;107;149547;141144;0;290691
04;2020-07-21;0;0;0;60314;61377;09;121691
04;2020-07-21;0;0;0;66065;68387;19;134452
04;2020-07-21;0;0;0;51059;47156;29;98215
04;2020-07-21;1;0;1;58788;45780;39;104568
04;2020-07-21;1;0;1;61408;52207;49;113615
04;2020-07-21;0;0;0;64838;60759;59;125597
04;2020-07-21;0;0;0;47008;42843;69;89851
04;2020-07-21;0;0;0;25509;21184;79;46693
04;2020-07-21;0;0;0;13168;7647;89;20815
04;2020-07-21;0;0;0;3209;1253;90;4462
04;2020-07-21;2;0;2;451366;408593;0;859959
05;2020-07-21;0;0;0;362.366008612902;341.338819562748;09;703.704828175651
05;2020-07-21;0;0;0;353.376145114279;370.349735405642;19;723.725880519921
05;2020-07-21;0;0;0;218.593559489256;256.539602589476;29;475.133162078732
05;2020-07-21;0;0;0;404.225408693299;360.321910454353;39;764.547319147651
05;2020-07-21;0;0;0;520.067953604221;497.108383964256;49;1017.17633756848
05;2020-07-21;0;0;0;468.146063921917;510.087601910415;59;978.233665832332
05;2020-07-21;0;0;0;340.368470050554;334.366842191253;69;674.735312241807
05;2020-07-21;0;0;0;212.598666888387;192.597753227106;79;405.196420115493
05;2020-07-21;0;0;0;148.727797095705;61.8681715431829;89;210.595968638888
05;2020-07-21;0;0;0;32.9601271090696;10.9909785719784;90;43.9511056810479
05;2020-07-21;0;0;0;3061.43020057959;2935.56979942041;0;5997
06;2020-07-21;1;0;1;42583;42380;09;84963
06;2020-07-21;2;5;7;33369;31925;19;65294
06;2020-07-21;2;2;4;21571;15080;29;36651
06;2020-07-21;1;1;2;21550;16147;39;37697
06;2020-07-21;1;1;2;14193;13939;49;28132
06;2020-07-21;0;3;3;7171;7597;59;14768
06;2020-07-21;0;1;1;3629;4117;69;7746
06;2020-07-21;2;0;2;1577;1457;79;3034
06;2020-07-21;0;0;0;531;474;89;1005
06;2020-07-21;0;0;0;88;93;90;181
06;2020-07-21;9;13;22;146262;133209;0;279471
07;2020-07-21;0;0;0;485;549;09;1034
07;2020-07-21;0;0;0;403;432;19;835
07;2020-07-21;0;0;0;764;841;29;1605
07;2020-07-21;0;0;0;824;928;39;1752
07;2020-07-21;0;0;0;788;1020;49;1808
07;2020-07-21;0;0;0;678;870;59;1548
07;2020-07-21;0;0;0;360;382;69;742
07;2020-07-21;0;0;0;231;190;79;421
07;2020-07-21;0;0;0;114;67;89;181
07;2020-07-21;0;0;0;24;11;90;35
07;2020-07-21;0;0;0;4671;5290;0;9961
08;2020-07-21;0;0;0;2715.22592983026;2997.75551488675;09;5712.98144471701
08;2020-07-21;0;0;0;2778.51901080978;3160.9156459093;19;5939.43465671908
08;2020-07-21;0;0;0;2080.8882988764;1718.16634315323;29;3799.05464202964
08;2020-07-21;0;0;0;2701.8582062647;1896.52641413317;39;4598.38462039786
08;2020-07-21;0;0;0;3151.45861023308;2460.52498233809;49;5611.98359257117
08;2020-07-21;0;0;0;2620.29868333099;2422.23566154656;59;5042.53434487755
08;2020-07-21;0;0;0;1621.44173420671;1438.58325779464;69;3060.02499200135
08;2020-07-21;0;0;0;626.575909335673;526.358467843651;79;1152.93437717932
08;2020-07-21;0;0;0;205.018522985054;140.993639349697;89;346.012162334751
08;2020-07-21;0;0;0;50.0325684687745;20.62259870351;90;70.6551671722846
08;2020-07-21;0;0;0;18551.3174743414;16782.6825256586;0;35334
11;2020-07-21;6;11;17;783071;811785;09;1594856
11;2020-07-21;22;9;31;761456;784653;19;1546109
11;2020-07-21;38;32;71;850145;801772;29;1651917
11;2020-07-21;31;40;71;914360;843488;39;1757848
11;2020-07-21;22;26;48;845609;826202;49;1671811
11;2020-07-21;19;24;43;793566;745070;59;1538636
11;2020-07-21;9;13;22;628649;549192;69;1177841
11;2020-07-21;6;11;17;434606;358356;79;792962
11;2020-07-21;5;7;12;261425;162933;89;424358
11;2020-07-21;3;0;3;89253;32619;90;121872
11;2020-07-21;161;174;337;6362140;5916070;0;12278210
24;2020-07-21;0;0;0;139720;144686;09;284406
24;2020-07-21;4;0;4;152979;161185;19;314164
24;2020-07-21;2;3;5;122237;126536;29;248773
24;2020-07-21;1;1;2;150359;142009;39;292368
24;2020-07-21;2;0;2;161829;158758;49;320587
24;2020-07-21;0;0;0;172552;168011;59;340563
24;2020-07-21;0;1;1;172509;158177;69;330686
24;2020-07-21;1;0;1;129428;110593;79;240021
24;2020-07-21;0;0;0;87342;56882;89;144224
24;2020-07-21;0;0;0;31210;12071;90;43281
24;2020-07-21;10;5;15;1320165;1238908;0;2559073
27;2020-07-21;1;0;1;143373;149679;09;293052
27;2020-07-21;0;1;1;160962;173003;19;333965
27;2020-07-21;4;0;4;133746;142254;29;276000
27;2020-07-21;0;0;0;160004;155407;39;315411
27;2020-07-21;1;0;1;172333;169564;49;341897
27;2020-07-21;0;2;2;189979;183788;59;373767
27;2020-07-21;0;0;0;192591;178206;69;370797
27;2020-07-21;1;0;1;146876;127546;79;274422
27;2020-07-21;0;0;0;96896;61575;89;158471
27;2020-07-21;1;0;1;33148;12109;90;45257
27;2020-07-21;8;3;11;1429908;1353131;0;2783039
28;2020-07-21;0;1;1;180735;186856;09;367591
28;2020-07-21;0;0;0;200125;213621;19;413746
28;2020-07-21;1;1;2;168922;173007;29;341929
28;2020-07-21;8;1;9;196628;188487;39;385115
28;2020-07-21;2;0;2;205396;201699;49;407095
28;2020-07-21;1;2;3;222002;213866;59;435868
28;2020-07-21;1;1;2;224688;203758;69;428446
28;2020-07-21;0;0;0;163192;135543;79;298735
28;2020-07-21;0;0;0;109691;65377;89;175068
28;2020-07-21;1;0;1;37222;12685;90;49907
28;2020-07-21;14;6;20;1708601;1594899;0;3303500
32;2020-07-21;3;2;5;358062;373689;09;731751
32;2020-07-21;9;4;13;387045;406742;19;793787
32;2020-07-21;8;13;21;342304;348587;29;690891
32;2020-07-21;12;10;22;382485;369972;39;752457
32;2020-07-21;11;6;17;382510;376716;49;759226
32;2020-07-21;9;7;16;386937;376527;59;763464
32;2020-07-21;3;4;7;371211;330938;69;702149
32;2020-07-21;6;1;7;250542;201459;79;452001
32;2020-07-21;2;1;3;163399;89786;89;253185
32;2020-07-21;3;0;3;48384;15367;90;63751
32;2020-07-21;66;48;114;3072879;2889783;0;5962662
44;2020-07-21;0;1;1;291525;306839;09;598364
44;2020-07-21;1;1;2;320255;339504;19;659759
44;2020-07-21;6;4;10;302020;314428;29;616448
44;2020-07-21;9;3;12;342222;333292;39;675514
44;2020-07-21;7;4;11;349727;344491;49;694218
44;2020-07-21;3;4;7;381371;373239;59;754610
44;2020-07-21;7;6;13;367165;335850;69;703015
44;2020-07-21;2;3;5;250387;215436;79;465823
44;2020-07-21;2;1;3;170825;105192;89;276017
44;2020-07-21;1;0;1;51248;16731;90;67979
44;2020-07-21;38;27;65;2826745;2685002;0;5511747
52;2020-07-21;7;2;9;213594;223900;09;437494
52;2020-07-21;9;18;27;240818;255197;19;496015
52;2020-07-21;9;12;21;197010;200630;29;397640
52;2020-07-21;9;6;15;231204;224885;39;456089
52;2020-07-21;11;5;16;243874;243418;49;487292
52;2020-07-21;8;3;11;244100;239116;59;483216
52;2020-07-21;3;2;5;241796;221345;69;463141
52;2020-07-21;9;4;13;177805;149903;79;327708
52;2020-07-21;4;4;8;119561;75822;89;195383
52;2020-07-21;2;0;2;42559;15260;90;57819
52;2020-07-21;71;56;127;1952321;1849476;0;3801797
53;2020-07-21;0;0;0;173813;182358;09;356171
53;2020-07-21;0;2;2;202720;214740;19;417460
53;2020-07-21;3;2;5;163116;173196;29;336312
53;2020-07-21;3;1;4;190526;187674;39;378200
53;2020-07-21;0;0;0;212098;212015;49;424113
53;2020-07-21;0;0;0;223699;219176;59;442875
53;2020-07-21;2;1;3;227435;209274;69;436709
53;2020-07-21;2;0;2;169992;140910;79;310902
53;2020-07-21;0;0;0;118117;69883;89;188000
53;2020-07-21;0;0;0;37370;12267;90;49637
53;2020-07-21;10;6;16;1718886;1621493;0;3340379
75;2020-07-21;1;0;1;293104;305291;09;598395
75;2020-07-21;0;3;3;337141;357785;19;694926
75;2020-07-21;4;3;7;295024;300618;29;595642
75;2020-07-21;0;2;2;347871;331233;39;679104
75;2020-07-21;2;2;4;384742;372771;49;757513
75;2020-07-21;2;2;4;413361;390880;59;804241
75;2020-07-21;5;0;5;425623;384060;69;809683
75;2020-07-21;0;0;0;325086;276298;79;601384
75;2020-07-21;0;0;0;213986;139308;89;353294
75;2020-07-21;0;0;0;77600;28200;90;105800
75;2020-07-21;14;12;26;3113538;2886444;0;5999982
76;2020-07-21;0;1;1;305956;318589;09;624545
76;2020-07-21;5;3;8;338942;356969;19;695911
76;2020-07-21;9;10;19;316210;319570;29;635780
76;2020-07-21;4;3;7;356758;337587;39;694345
76;2020-07-21;7;2;9;376541;363812;49;740353
76;2020-07-21;5;5;10;402608;383750;59;786358
76;2020-07-21;3;2;6;394889;358997;69;753886
76;2020-07-21;0;2;2;308664;263806;79;572470
76;2020-07-21;1;0;1;195838;129272;89;325110
76;2020-07-21;0;0;0;69372;26728;90;96100
76;2020-07-21;34;28;63;3065778;2859080;0;5924858
84;2020-07-21;1;1;2;459549;481088;09;940637
84;2020-07-21;4;2;6;487711;511905;19;999616
84;2020-07-21;10;7;17;443824;451094;29;894918
84;2020-07-21;11;5;16;512522;493262;39;1005784
84;2020-07-21;5;8;13;520248;515106;49;1035354
84;2020-07-21;12;2;14;529611;514848;59;1044459
84;2020-07-21;6;5;11;486720;439940;69;926660
84;2020-07-21;2;0;2;372151;315211;79;687362
84;2020-07-21;1;3;4;237198;150524;89;387722
84;2020-07-21;0;0;0;81185;28680;90;109865
84;2020-07-21;52;33;86;4130719;3901658;0;8032377
93;2020-07-21;2;2;4;268834;283093;09;551927
93;2020-07-21;5;2;7;280751;296087;19;576838
93;2020-07-21;11;6;17;254404;255552;29;509956
93;2020-07-21;9;5;14;310704;288398;39;599102
93;2020-07-21;4;3;7;325559;305827;49;631386
93;2020-07-21;4;5;9;353104;325389;59;678493
93;2020-07-21;8;4;12;336327;296459;69;632786
93;2020-07-21;5;2;7;279820;229699;79;509519
93;2020-07-21;1;2;3;171274;113716;89;284990
93;2020-07-21;0;0;0;58896;21758;90;80654
93;2020-07-21;49;31;80;2639673;2415978;0;5055651
94;2020-07-21;0;0;0;16311;17433;09;33744
94;2020-07-21;0;0;0;16679;18132;19;34811
94;2020-07-21;0;0;0;16782;16579;29;33361
94;2020-07-21;0;0;0;23044;20580;39;43624
94;2020-07-21;0;0;0;23065;22140;49;45205
94;2020-07-21;0;0;0;24549;23421;59;47970
94;2020-07-21;1;0;1;23212;21883;69;45095
94;2020-07-21;0;0;0;19544;17141;79;36685
94;2020-07-21;0;0;0;11227;8178;89;19405
94;2020-07-21;0;0;0;3332;1447;90;4779
94;2020-07-21;1;0;1;177745;166934;0;344679
01;2020-07-22;0;0;0;19979;20155;09;40134
01;2020-07-22;0;0;0;24994;25489;19;50483
01;2020-07-22;1;0;1;17868;16690;29;34558
01;2020-07-22;0;0;0;22328;14821;39;37149
01;2020-07-22;0;0;0;28652;20276;49;48928
01;2020-07-22;0;0;0;33264;27260;59;60524
01;2020-07-22;0;0;0;27135;23978;69;51113
01;2020-07-22;0;0;0;18401;14661;79;33062
01;2020-07-22;0;0;0;9633;6375;89;16008
01;2020-07-22;0;0;0;3410;1510;90;4920
01;2020-07-22;1;0;1;205664;171215;0;376879
02;2020-07-22;0;0;0;16881;17110;09;33991
02;2020-07-22;0;0;0;21410;21604;19;43014
02;2020-07-22;0;1;1;16017;15479;29;31496
02;2020-07-22;0;1;1;19825;14455;39;34280
02;2020-07-22;0;0;0;24719;18248;49;42967
02;2020-07-22;0;0;0;34361;28310;59;62671
02;2020-07-22;0;0;0;28061;24495;69;52556
02;2020-07-22;0;0;0;18231;15278;79;33509
02;2020-07-22;0;0;0;11090;7677;89;18767
02;2020-07-22;0;0;0;3992;1506;90;5498
02;2020-07-22;0;2;2;194587;164162;0;358749
03;2020-07-22;2;2;4;31123;30920;09;62043
03;2020-07-22;13;8;21;29370;29268;19;58638
03;2020-07-22;6;13;21;21458;18963;29;40421
03;2020-07-22;10;9;20;21276;18326;39;39602
03;2020-07-22;8;12;21;18164;16593;49;34757
03;2020-07-22;9;8;18;13469;13557;59;27026
03;2020-07-22;6;2;8;8776;8670;69;17446
03;2020-07-22;0;1;1;3777;3591;79;7368
03;2020-07-22;4;0;4;1649;1072;89;2721
03;2020-07-22;0;0;0;485;184;90;669
03;2020-07-22;58;55;118;149547;141144;0;290691
04;2020-07-22;0;0;0;60314;61377;09;121691
04;2020-07-22;2;0;2;66065;68387;19;134452
04;2020-07-22;0;0;0;51059;47156;29;98215
04;2020-07-22;0;1;1;58788;45780;39;104568
04;2020-07-22;0;0;0;61408;52207;49;113615
04;2020-07-22;1;0;1;64838;60759;59;125597
04;2020-07-22;1;0;1;47008;42843;69;89851
04;2020-07-22;0;1;1;25509;21184;79;46693
04;2020-07-22;0;0;0;13168;7647;89;20815
04;2020-07-22;0;0;0;3209;1253;90;4462
04;2020-07-22;4;2;6;451366;408593;0;859959
05;2020-07-22;0;0;0;362.366008612902;341.338819562748;09;703.704828175651
05;2020-07-22;0;0;0;353.376145114279;370.349735405642;19;723.725880519921
05;2020-07-22;0;0;0;218.593559489256;256.539602589476;29;475.133162078732
05;2020-07-22;0;0;0;404.225408693299;360.321910454353;39;764.547319147651
05;2020-07-22;0;0;0;520.067953604221;497.108383964256;49;1017.17633756848
05;2020-07-22;0;0;0;468.146063921917;510.087601910415;59;978.233665832332
05;2020-07-22;0;0;0;340.368470050554;334.366842191253;69;674.735312241807
05;2020-07-22;0;0;0;212.598666888387;192.597753227106;79;405.196420115493
05;2020-07-22;0;0;0;148.727797095705;61.8681715431829;89;210.595968638888
05;2020-07-22;0;0;0;32.9601271090696;10.9909785719784;90;43.9511056810479
05;2020-07-22;0;0;0;3061.43020057959;2935.56979942041;0;5997
06;2020-07-22;2;0;2;42583;42380;09;84963
06;2020-07-22;0;0;0;33369;31925;19;65294
06;2020-07-22;2;1;3;21571;15080;29;36651
06;2020-07-22;3;0;3;21550;16147;39;37697
06;2020-07-22;2;1;3;14193;13939;49;28132
06;2020-07-22;0;3;3;7171;7597;59;14768
06;2020-07-22;0;0;0;3629;4117;69;7746
06;2020-07-22;0;0;0;1577;1457;79;3034
06;2020-07-22;0;0;0;531;474;89;1005
06;2020-07-22;0;0;0;88;93;90;181
06;2020-07-22;9;5;14;146262;133209;0;279471
07;2020-07-22;0;0;0;485;549;09;1034
07;2020-07-22;0;0;0;403;432;19;835
07;2020-07-22;0;0;0;764;841;29;1605
07;2020-07-22;0;0;0;824;928;39;1752
07;2020-07-22;0;0;0;788;1020;49;1808
07;2020-07-22;0;0;0;678;870;59;1548
07;2020-07-22;0;0;0;360;382;69;742
07;2020-07-22;0;0;0;231;190;79;421
07;2020-07-22;0;0;0;114;67;89;181
07;2020-07-22;0;0;0;24;11;90;35
07;2020-07-22;0;0;0;4671;5290;0;9961
08;2020-07-22;0;0;0;2715.22592983026;2997.75551488675;09;5712.98144471701
08;2020-07-22;0;0;0;2778.51901080978;3160.9156459093;19;5939.43465671908
08;2020-07-22;0;0;0;2080.8882988764;1718.16634315323;29;3799.05464202964
08;2020-07-22;0;0;0;2701.8582062647;1896.52641413317;39;4598.38462039786
08;2020-07-22;0;0;0;3151.45861023308;2460.52498233809;49;5611.98359257117
08;2020-07-22;0;0;0;2620.29868333099;2422.23566154656;59;5042.53434487755
08;2020-07-22;0;0;0;1621.44173420671;1438.58325779464;69;3060.02499200135
08;2020-07-22;0;0;0;626.575909335673;526.358467843651;79;1152.93437717932
08;2020-07-22;0;0;0;205.018522985054;140.993639349697;89;346.012162334751
08;2020-07-22;0;0;0;50.0325684687745;20.62259870351;90;70.6551671722846
08;2020-07-22;0;0;0;18551.3174743414;16782.6825256586;0;35334
11;2020-07-22;4;11;16;783071;811785;09;1594856
11;2020-07-22;19;14;33;761456;784653;19;1546109
11;2020-07-22;43;39;82;850145;801772;29;1651917
11;2020-07-22;32;46;78;914360;843488;39;1757848
11;2020-07-22;25;27;52;845609;826202;49;1671811
11;2020-07-22;18;18;36;793566;745070;59;1538636
11;2020-07-22;11;17;28;628649;549192;69;1177841
11;2020-07-22;12;8;20;434606;358356;79;792962
11;2020-07-22;3;5;8;261425;162933;89;424358
11;2020-07-22;7;3;10;89253;32619;90;121872
11;2020-07-22;174;188;363;6362140;5916070;0;12278210
24;2020-07-22;1;0;1;139720;144686;09;284406
24;2020-07-22;1;2;3;152979;161185;19;314164
24;2020-07-22;2;2;4;122237;126536;29;248773
24;2020-07-22;3;2;5;150359;142009;39;292368
24;2020-07-22;2;9;11;161829;158758;49;320587
24;2020-07-22;2;0;2;172552;168011;59;340563
24;2020-07-22;3;1;4;172509;158177;69;330686
24;2020-07-22;1;0;1;129428;110593;79;240021
24;2020-07-22;1;0;1;87342;56882;89;144224
24;2020-07-22;0;0;0;31210;12071;90;43281
24;2020-07-22;16;16;32;1320165;1238908;0;2559073
27;2020-07-22;0;1;1;143373;149679;09;293052
27;2020-07-22;0;0;0;160962;173003;19;333965
27;2020-07-22;2;0;2;133746;142254;29;276000
27;2020-07-22;0;1;1;160004;155407;39;315411
27;2020-07-22;0;1;1;172333;169564;49;341897
27;2020-07-22;0;0;0;189979;183788;59;373767
27;2020-07-22;0;0;0;192591;178206;69;370797
27;2020-07-22;0;0;0;146876;127546;79;274422
27;2020-07-22;0;1;1;96896;61575;89;158471
27;2020-07-22;1;1;2;33148;12109;90;45257
27;2020-07-22;3;5;8;1429908;1353131;0;2783039
28;2020-07-22;0;0;0;180735;186856;09;367591
28;2020-07-22;0;0;0;200125;213621;19;413746
28;2020-07-22;6;3;9;168922;173007;29;341929
28;2020-07-22;1;1;2;196628;188487;39;385115
28;2020-07-22;1;0;1;205396;201699;49;407095
28;2020-07-22;0;2;2;222002;213866;59;435868
28;2020-07-22;0;0;0;224688;203758;69;428446
28;2020-07-22;0;1;1;163192;135543;79;298735
28;2020-07-22;0;0;0;109691;65377;89;175068
28;2020-07-22;0;0;0;37222;12685;90;49907
28;2020-07-22;8;7;15;1708601;1594899;0;3303500
32;2020-07-22;2;2;4;358062;373689;09;731751
32;2020-07-22;6;6;13;387045;406742;19;793787
32;2020-07-22;21;5;26;342304;348587;29;690891
32;2020-07-22;8;12;20;382485;369972;39;752457
32;2020-07-22;11;9;20;382510;376716;49;759226
32;2020-07-22;4;6;10;386937;376527;59;763464
32;2020-07-22;6;3;9;371211;330938;69;702149
32;2020-07-22;1;8;9;250542;201459;79;452001
32;2020-07-22;3;1;4;163399;89786;89;253185
32;2020-07-22;3;1;4;48384;15367;90;63751
32;2020-07-22;65;53;119;3072879;2889783;0;5962662
44;2020-07-22;3;0;3;291525;306839;09;598364
44;2020-07-22;4;2;6;320255;339504;19;659759
44;2020-07-22;6;4;10;302020;314428;29;616448
44;2020-07-22;6;4;10;342222;333292;39;675514
44;2020-07-22;2;5;7;349727;344491;49;694218
44;2020-07-22;6;3;9;381371;373239;59;754610
44;2020-07-22;4;3;7;367165;335850;69;703015
44;2020-07-22;0;2;2;250387;215436;79;465823
44;2020-07-22;1;0;1;170825;105192;89;276017
44;2020-07-22;0;1;1;51248;16731;90;67979
44;2020-07-22;32;24;56;2826745;2685002;0;5511747
52;2020-07-22;1;1;2;213594;223900;09;437494
52;2020-07-22;9;15;24;240818;255197;19;496015
52;2020-07-22;13;5;18;197010;200630;29;397640
52;2020-07-22;8;10;18;231204;224885;39;456089
52;2020-07-22;7;10;17;243874;243418;49;487292
52;2020-07-22;8;4;12;244100;239116;59;483216
52;2020-07-22;9;6;15;241796;221345;69;463141
52;2020-07-22;1;3;4;177805;149903;79;327708
52;2020-07-22;3;0;3;119561;75822;89;195383
52;2020-07-22;0;0;0;42559;15260;90;57819
52;2020-07-22;59;54;113;1952321;1849476;0;3801797
53;2020-07-22;0;0;0;173813;182358;09;356171
53;2020-07-22;3;5;8;202720;214740;19;417460
53;2020-07-22;6;4;10;163116;173196;29;336312
53;2020-07-22;2;3;5;190526;187674;39;378200
53;2020-07-22;4;6;10;212098;212015;49;424113
53;2020-07-22;2;1;3;223699;219176;59;442875
53;2020-07-22;0;1;1;227435;209274;69;436709
53;2020-07-22;2;1;3;169992;140910;79;310902
53;2020-07-22;0;1;1;118117;69883;89;188000
53;2020-07-22;0;1;1;37370;12267;90;49637
53;2020-07-22;19;23;42;1718886;1621493;0;3340379
75;2020-07-22;4;1;5;293104;305291;09;598395
75;2020-07-22;1;2;3;337141;357785;19;694926
75;2020-07-22;10;7;17;295024;300618;29;595642
75;2020-07-22;0;1;1;347871;331233;39;679104
75;2020-07-22;3;3;6;384742;372771;49;757513
75;2020-07-22;4;2;6;413361;390880;59;804241
75;2020-07-22;1;1;2;425623;384060;69;809683
75;2020-07-22;3;0;3;325086;276298;79;601384
75;2020-07-22;0;0;0;213986;139308;89;353294
75;2020-07-22;0;0;0;77600;28200;90;105800
75;2020-07-22;26;17;43;3113538;2886444;0;5999982
76;2020-07-22;2;1;3;305956;318589;09;624545
76;2020-07-22;6;4;10;338942;356969;19;695911
76;2020-07-22;6;8;14;316210;319570;29;635780
76;2020-07-22;5;10;15;356758;337587;39;694345
76;2020-07-22;2;2;4;376541;363812;49;740353
76;2020-07-22;3;6;9;402608;383750;59;786358
76;2020-07-22;1;1;2;394889;358997;69;753886
76;2020-07-22;3;3;6;308664;263806;79;572470
76;2020-07-22;0;0;0;195838;129272;89;325110
76;2020-07-22;0;0;0;69372;26728;90;96100
76;2020-07-22;28;35;63;3065778;2859080;0;5924858
84;2020-07-22;6;2;8;459549;481088;09;940637
84;2020-07-22;3;4;7;487711;511905;19;999616
84;2020-07-22;10;6;16;443824;451094;29;894918
84;2020-07-22;8;13;21;512522;493262;39;1005784
84;2020-07-22;10;6;16;520248;515106;49;1035354
84;2020-07-22;6;4;10;529611;514848;59;1044459
84;2020-07-22;4;0;4;486720;439940;69;926660
84;2020-07-22;1;3;4;372151;315211;79;687362
84;2020-07-22;1;0;1;237198;150524;89;387722
84;2020-07-22;0;1;1;81185;28680;90;109865
84;2020-07-22;49;39;88;4130719;3901658;0;8032377
93;2020-07-22;4;4;8;268834;283093;09;551927
93;2020-07-22;0;2;2;280751;296087;19;576838
93;2020-07-22;8;5;13;254404;255552;29;509956
93;2020-07-22;5;11;16;310704;288398;39;599102
93;2020-07-22;4;6;10;325559;305827;49;631386
93;2020-07-22;2;4;6;353104;325389;59;678493
93;2020-07-22;4;3;7;336327;296459;69;632786
93;2020-07-22;6;2;8;279820;229699;79;509519
93;2020-07-22;2;1;3;171274;113716;89;284990
93;2020-07-22;0;0;0;58896;21758;90;80654
93;2020-07-22;35;38;73;2639673;2415978;0;5055651
94;2020-07-22;0;0;0;16311;17433;09;33744
94;2020-07-22;0;0;0;16679;18132;19;34811
94;2020-07-22;0;0;0;16782;16579;29;33361
94;2020-07-22;0;0;0;23044;20580;39;43624
94;2020-07-22;0;1;1;23065;22140;49;45205
94;2020-07-22;0;0;0;24549;23421;59;47970
94;2020-07-22;0;0;0;23212;21883;69;45095
94;2020-07-22;0;0;0;19544;17141;79;36685
94;2020-07-22;0;0;0;11227;8178;89;19405
94;2020-07-22;0;0;0;3332;1447;90;4779
94;2020-07-22;0;1;1;177745;166934;0;344679
01;2020-07-23;0;0;0;19979;20155;09;40134
01;2020-07-23;1;0;1;24994;25489;19;50483
01;2020-07-23;1;1;2;17868;16690;29;34558
01;2020-07-23;1;0;1;22328;14821;39;37149
01;2020-07-23;0;0;0;28652;20276;49;48928
01;2020-07-23;0;0;0;33264;27260;59;60524
01;2020-07-23;1;0;1;27135;23978;69;51113
01;2020-07-23;0;0;0;18401;14661;79;33062
01;2020-07-23;0;0;0;9633;6375;89;16008
01;2020-07-23;0;0;0;3410;1510;90;4920
01;2020-07-23;4;1;5;205664;171215;0;376879
02;2020-07-23;0;0;0;16881;17110;09;33991
02;2020-07-23;0;0;0;21410;21604;19;43014
02;2020-07-23;0;0;0;16017;15479;29;31496
02;2020-07-23;0;0;0;19825;14455;39;34280
02;2020-07-23;0;0;0;24719;18248;49;42967
02;2020-07-23;0;0;0;34361;28310;59;62671
02;2020-07-23;0;0;0;28061;24495;69;52556
02;2020-07-23;0;0;0;18231;15278;79;33509
02;2020-07-23;0;0;0;11090;7677;89;18767
02;2020-07-23;0;0;0;3992;1506;90;5498
02;2020-07-23;0;0;0;194587;164162;0;358749
03;2020-07-23;2;7;9;31123;30920;09;62043
03;2020-07-23;4;8;13;29370;29268;19;58638
03;2020-07-23;16;5;21;21458;18963;29;40421
03;2020-07-23;9;8;18;21276;18326;39;39602
03;2020-07-23;8;8;16;18164;16593;49;34757
03;2020-07-23;4;3;8;13469;13557;59;27026
03;2020-07-23;3;4;7;8776;8670;69;17446
03;2020-07-23;2;4;6;3777;3591;79;7368
03;2020-07-23;1;0;1;1649;1072;89;2721
03;2020-07-23;0;0;0;485;184;90;669
03;2020-07-23;49;47;99;149547;141144;0;290691
04;2020-07-23;0;0;0;60314;61377;09;121691
04;2020-07-23;2;2;4;66065;68387;19;134452
04;2020-07-23;1;4;5;51059;47156;29;98215
04;2020-07-23;1;0;1;58788;45780;39;104568
04;2020-07-23;0;0;0;61408;52207;49;113615
04;2020-07-23;0;0;0;64838;60759;59;125597
04;2020-07-23;0;0;0;47008;42843;69;89851
04;2020-07-23;0;0;0;25509;21184;79;46693
04;2020-07-23;0;1;1;13168;7647;89;20815
04;2020-07-23;0;0;0;3209;1253;90;4462
04;2020-07-23;4;7;11;451366;408593;0;859959
05;2020-07-23;0;0;0;362.366008612902;341.338819562748;09;703.704828175651
05;2020-07-23;0;0;0;353.376145114279;370.349735405642;19;723.725880519921
05;2020-07-23;0;0;0;218.593559489256;256.539602589476;29;475.133162078732
05;2020-07-23;0;0;0;404.225408693299;360.321910454353;39;764.547319147651
05;2020-07-23;0;0;0;520.067953604221;497.108383964256;49;1017.17633756848
05;2020-07-23;0;0;0;468.146063921917;510.087601910415;59;978.233665832332
05;2020-07-23;0;0;0;340.368470050554;334.366842191253;69;674.735312241807
05;2020-07-23;0;0;0;212.598666888387;192.597753227106;79;405.196420115493
05;2020-07-23;0;0;0;148.727797095705;61.8681715431829;89;210.595968638888
05;2020-07-23;0;0;0;32.9601271090696;10.9909785719784;90;43.9511056810479
05;2020-07-23;0;0;0;3061.43020057959;2935.56979942041;0;5997
06;2020-07-23;0;0;0;42583;42380;09;84963
06;2020-07-23;1;1;2;33369;31925;19;65294
06;2020-07-23;1;2;3;21571;15080;29;36651
06;2020-07-23;2;0;2;21550;16147;39;37697
06;2020-07-23;0;4;4;14193;13939;49;28132
06;2020-07-23;1;1;2;7171;7597;59;14768
06;2020-07-23;2;0;2;3629;4117;69;7746
06;2020-07-23;1;1;2;1577;1457;79;3034
06;2020-07-23;0;0;0;531;474;89;1005
06;2020-07-23;0;0;0;88;93;90;181
06;2020-07-23;8;9;17;146262;133209;0;279471
07;2020-07-23;0;0;0;485;549;09;1034
07;2020-07-23;0;0;0;403;432;19;835
07;2020-07-23;0;0;0;764;841;29;1605
07;2020-07-23;0;0;0;824;928;39;1752
07;2020-07-23;0;0;0;788;1020;49;1808
07;2020-07-23;0;0;0;678;870;59;1548
07;2020-07-23;0;0;0;360;382;69;742
07;2020-07-23;0;0;0;231;190;79;421
07;2020-07-23;0;0;0;114;67;89;181
07;2020-07-23;0;0;0;24;11;90;35
07;2020-07-23;0;0;0;4671;5290;0;9961
08;2020-07-23;0;0;0;2715.22592983026;2997.75551488675;09;5712.98144471701
08;2020-07-23;0;0;0;2778.51901080978;3160.9156459093;19;5939.43465671908
08;2020-07-23;0;0;0;2080.8882988764;1718.16634315323;29;3799.05464202964
08;2020-07-23;0;0;0;2701.8582062647;1896.52641413317;39;4598.38462039786
08;2020-07-23;1;0;1;3151.45861023308;2460.52498233809;49;5611.98359257117
08;2020-07-23;0;0;0;2620.29868333099;2422.23566154656;59;5042.53434487755
08;2020-07-23;0;0;0;1621.44173420671;1438.58325779464;69;3060.02499200135
08;2020-07-23;0;0;0;626.575909335673;526.358467843651;79;1152.93437717932
08;2020-07-23;0;0;0;205.018522985054;140.993639349697;89;346.012162334751
08;2020-07-23;0;0;0;50.0325684687745;20.62259870351;90;70.6551671722846
08;2020-07-23;1;0;1;18551.3174743414;16782.6825256586;0;35334
11;2020-07-23;3;10;13;783071;811785;09;1594856
11;2020-07-23;18;8;26;761456;784653;19;1546109
11;2020-07-23;53;42;95;850145;801772;29;1651917
11;2020-07-23;35;32;67;914360;843488;39;1757848
11;2020-07-23;27;27;54;845609;826202;49;1671811
11;2020-07-23;21;9;30;793566;745070;59;1538636
11;2020-07-23;15;13;28;628649;549192;69;1177841
11;2020-07-23;3;6;9;434606;358356;79;792962
11;2020-07-23;5;5;10;261425;162933;89;424358
11;2020-07-23;2;0;2;89253;32619;90;121872
11;2020-07-23;182;152;339;6362140;5916070;0;12278210
24;2020-07-23;3;1;4;139720;144686;09;284406
24;2020-07-23;3;1;4;152979;161185;19;314164
24;2020-07-23;5;3;8;122237;126536;29;248773
24;2020-07-23;2;3;5;150359;142009;39;292368
24;2020-07-23;3;1;4;161829;158758;49;320587
24;2020-07-23;2;0;2;172552;168011;59;340563
24;2020-07-23;2;1;3;172509;158177;69;330686
24;2020-07-23;0;1;1;129428;110593;79;240021
24;2020-07-23;0;0;0;87342;56882;89;144224
24;2020-07-23;0;0;0;31210;12071;90;43281
24;2020-07-23;20;11;31;1320165;1238908;0;2559073
27;2020-07-23;0;0;0;143373;149679;09;293052
27;2020-07-23;0;1;1;160962;173003;19;333965
27;2020-07-23;1;6;7;133746;142254;29;276000
27;2020-07-23;1;1;2;160004;155407;39;315411
27;2020-07-23;1;0;1;172333;169564;49;341897
27;2020-07-23;3;1;4;189979;183788;59;373767
27;2020-07-23;1;0;1;192591;178206;69;370797
27;2020-07-23;3;3;6;146876;127546;79;274422
27;2020-07-23;0;0;0;96896;61575;89;158471
27;2020-07-23;1;0;1;33148;12109;90;45257
27;2020-07-23;11;12;23;1429908;1353131;0;2783039
28;2020-07-23;0;3;3;180735;186856;09;367591
28;2020-07-23;2;2;4;200125;213621;19;413746
28;2020-07-23;2;0;2;168922;173007;29;341929
28;2020-07-23;4;4;8;196628;188487;39;385115
28;2020-07-23;2;2;4;205396;201699;49;407095
28;2020-07-23;1;1;2;222002;213866;59;435868
28;2020-07-23;2;0;2;224688;203758;69;428446
28;2020-07-23;0;0;0;163192;135543;79;298735
28;2020-07-23;0;0;0;109691;65377;89;175068
28;2020-07-23;0;0;0;37222;12685;90;49907
28;2020-07-23;13;12;25;1708601;1594899;0;3303500
32;2020-07-23;2;2;4;358062;373689;09;731751
32;2020-07-23;4;3;7;387045;406742;19;793787
32;2020-07-23;12;8;20;342304;348587;29;690891
32;2020-07-23;9;2;11;382485;369972;39;752457
32;2020-07-23;7;6;13;382510;376716;49;759226
32;2020-07-23;9;4;13;386937;376527;59;763464
32;2020-07-23;3;4;7;371211;330938;69;702149
32;2020-07-23;1;2;3;250542;201459;79;452001
32;2020-07-23;1;2;3;163399;89786;89;253185
32;2020-07-23;1;0;1;48384;15367;90;63751
32;2020-07-23;49;33;82;3072879;2889783;0;5962662
44;2020-07-23;0;1;1;291525;306839;09;598364
44;2020-07-23;5;1;6;320255;339504;19;659759
44;2020-07-23;3;3;6;302020;314428;29;616448
44;2020-07-23;3;8;11;342222;333292;39;675514
44;2020-07-23;8;6;14;349727;344491;49;694218
44;2020-07-23;2;5;7;381371;373239;59;754610
44;2020-07-23;2;1;3;367165;335850;69;703015
44;2020-07-23;5;1;6;250387;215436;79;465823
44;2020-07-23;1;0;1;170825;105192;89;276017
44;2020-07-23;1;0;1;51248;16731;90;67979
44;2020-07-23;30;26;56;2826745;2685002;0;5511747
52;2020-07-23;3;1;4;213594;223900;09;437494
52;2020-07-23;13;9;22;240818;255197;19;496015
52;2020-07-23;16;17;33;197010;200630;29;397640
52;2020-07-23;9;8;17;231204;224885;39;456089
52;2020-07-23;8;4;12;243874;243418;49;487292
52;2020-07-23;10;12;22;244100;239116;59;483216
52;2020-07-23;7;8;15;241796;221345;69;463141
52;2020-07-23;10;5;15;177805;149903;79;327708
52;2020-07-23;4;0;4;119561;75822;89;195383
52;2020-07-23;2;1;3;42559;15260;90;57819
52;2020-07-23;82;65;147;1952321;1849476;0;3801797
53;2020-07-23;1;1;2;173813;182358;09;356171
53;2020-07-23;1;7;8;202720;214740;19;417460
53;2020-07-23;4;4;8;163116;173196;29;336312
53;2020-07-23;2;1;3;190526;187674;39;378200
53;2020-07-23;2;3;5;212098;212015;49;424113
53;2020-07-23;0;1;1;223699;219176;59;442875
53;2020-07-23;2;1;3;227435;209274;69;436709
53;2020-07-23;0;0;0;169992;140910;79;310902
53;2020-07-23;0;1;1;118117;69883;89;188000
53;2020-07-23;1;0;1;37370;12267;90;49637
53;2020-07-23;13;19;32;1718886;1621493;0;3340379
75;2020-07-23;1;1;2;293104;305291;09;598395
75;2020-07-23;2;1;3;337141;357785;19;694926
75;2020-07-23;6;4;10;295024;300618;29;595642
75;2020-07-23;2;5;7;347871;331233;39;679104
75;2020-07-23;2;2;4;384742;372771;49;757513
75;2020-07-23;3;0;3;413361;390880;59;804241
75;2020-07-23;1;1;2;425623;384060;69;809683
75;2020-07-23;1;0;1;325086;276298;79;601384
75;2020-07-23;0;0;0;213986;139308;89;353294
75;2020-07-23;0;0;0;77600;28200;90;105800
75;2020-07-23;18;14;32;3113538;2886444;0;5999982
76;2020-07-23;1;6;7;305956;318589;09;624545
76;2020-07-23;5;2;7;338942;356969;19;695911
76;2020-07-23;8;11;19;316210;319570;29;635780
76;2020-07-23;10;5;15;356758;337587;39;694345
76;2020-07-23;3;9;12;376541;363812;49;740353
76;2020-07-23;6;2;8;402608;383750;59;786358
76;2020-07-23;6;1;7;394889;358997;69;753886
76;2020-07-23;3;4;7;308664;263806;79;572470
76;2020-07-23;2;1;3;195838;129272;89;325110
76;2020-07-23;0;0;0;69372;26728;90;96100
76;2020-07-23;44;41;85;3065778;2859080;0;5924858
84;2020-07-23;5;1;6;459549;481088;09;940637
84;2020-07-23;4;6;10;487711;511905;19;999616
84;2020-07-23;11;11;22;443824;451094;29;894918
84;2020-07-23;6;10;16;512522;493262;39;1005784
84;2020-07-23;6;5;11;520248;515106;49;1035354
84;2020-07-23;8;2;10;529611;514848;59;1044459
84;2020-07-23;6;4;10;486720;439940;69;926660
84;2020-07-23;3;3;6;372151;315211;79;687362
84;2020-07-23;1;0;1;237198;150524;89;387722
84;2020-07-23;0;0;0;81185;28680;90;109865
84;2020-07-23;50;42;92;4130719;3901658;0;8032377
93;2020-07-23;1;2;3;268834;283093;09;551927
93;2020-07-23;4;3;7;280751;296087;19;576838
93;2020-07-23;9;5;14;254404;255552;29;509956
93;2020-07-23;8;6;14;310704;288398;39;599102
93;2020-07-23;3;2;5;325559;305827;49;631386
93;2020-07-23;4;2;6;353104;325389;59;678493
93;2020-07-23;1;4;5;336327;296459;69;632786
93;2020-07-23;1;3;4;279820;229699;79;509519
93;2020-07-23;2;2;4;171274;113716;89;284990
93;2020-07-23;1;1;2;58896;21758;90;80654
93;2020-07-23;34;30;64;2639673;2415978;0;5055651
94;2020-07-23;0;0;0;16311;17433;09;33744
94;2020-07-23;0;0;0;16679;18132;19;34811
94;2020-07-23;0;0;0;16782;16579;29;33361
94;2020-07-23;0;0;0;23044;20580;39;43624
94;2020-07-23;0;0;0;23065;22140;49;45205
94;2020-07-23;0;0;0;24549;23421;59;47970
94;2020-07-23;0;0;0;23212;21883;69;45095
94;2020-07-23;0;0;0;19544;17141;79;36685
94;2020-07-23;0;0;0;11227;8178;89;19405
94;2020-07-23;0;0;0;3332;1447;90;4779
94;2020-07-23;0;0;0;177745;166934;0;344679
01;2020-07-24;0;0;0;19979;20155;09;40134
01;2020-07-24;1;0;1;24994;25489;19;50483
01;2020-07-24;2;2;4;17868;16690;29;34558
01;2020-07-24;0;1;1;22328;14821;39;37149
01;2020-07-24;0;0;0;28652;20276;49;48928
01;2020-07-24;0;0;0;33264;27260;59;60524
01;2020-07-24;0;0;0;27135;23978;69;51113
01;2020-07-24;0;0;0;18401;14661;79;33062
01;2020-07-24;0;0;0;9633;6375;89;16008
01;2020-07-24;0;0;0;3410;1510;90;4920
01;2020-07-24;3;3;6;205664;171215;0;376879
02;2020-07-24;0;0;0;16881;17110;09;33991
02;2020-07-24;0;0;0;21410;21604;19;43014
02;2020-07-24;1;0;1;16017;15479;29;31496
02;2020-07-24;0;0;0;19825;14455;39;34280
02;2020-07-24;0;0;0;24719;18248;49;42967
02;2020-07-24;0;1;1;34361;28310;59;62671
02;2020-07-24;0;0;0;28061;24495;69;52556
02;2020-07-24;0;0;0;18231;15278;79;33509
02;2020-07-24;0;0;0;11090;7677;89;18767
02;2020-07-24;0;0;0;3992;1506;90;5498
02;2020-07-24;1;1;2;194587;164162;0;358749
03;2020-07-24;9;4;14;31123;30920;09;62043
03;2020-07-24;6;2;9;29370;29268;19;58638
03;2020-07-24;11;7;18;21458;18963;29;40421
03;2020-07-24;11;14;25;21276;18326;39;39602
03;2020-07-24;7;8;17;18164;16593;49;34757
03;2020-07-24;8;5;13;13469;13557;59;27026
03;2020-07-24;4;3;7;8776;8670;69;17446
03;2020-07-24;0;2;2;3777;3591;79;7368
03;2020-07-24;0;2;2;1649;1072;89;2721
03;2020-07-24;0;0;0;485;184;90;669
03;2020-07-24;56;47;107;149547;141144;0;290691
04;2020-07-24;0;0;0;60314;61377;09;121691
04;2020-07-24;0;0;0;66065;68387;19;134452
04;2020-07-24;0;0;0;51059;47156;29;98215
04;2020-07-24;0;0;0;58788;45780;39;104568
04;2020-07-24;0;1;1;61408;52207;49;113615
04;2020-07-24;0;0;0;64838;60759;59;125597
04;2020-07-24;0;0;0;47008;42843;69;89851
04;2020-07-24;0;0;0;25509;21184;79;46693
04;2020-07-24;0;0;0;13168;7647;89;20815
04;2020-07-24;0;0;0;3209;1253;90;4462
04;2020-07-24;0;1;1;451366;408593;0;859959
05;2020-07-24;0;0;0;362.366008612902;341.338819562748;09;703.704828175651
05;2020-07-24;0;0;0;353.376145114279;370.349735405642;19;723.725880519921
05;2020-07-24;0;0;0;218.593559489256;256.539602589476;29;475.133162078732
05;2020-07-24;0;0;0;404.225408693299;360.321910454353;39;764.547319147651
05;2020-07-24;0;0;0;520.067953604221;497.108383964256;49;1017.17633756848
05;2020-07-24;0;0;0;468.146063921917;510.087601910415;59;978.233665832332
05;2020-07-24;0;0;0;340.368470050554;334.366842191253;69;674.735312241807
05;2020-07-24;0;0;0;212.598666888387;192.597753227106;79;405.196420115493
05;2020-07-24;0;0;0;148.727797095705;61.8681715431829;89;210.595968638888
05;2020-07-24;0;0;0;32.9601271090696;10.9909785719784;90;43.9511056810479
05;2020-07-24;0;0;0;3061.43020057959;2935.56979942041;0;5997
06;2020-07-24;0;2;2;42583;42380;09;84963
06;2020-07-24;0;0;0;33369;31925;19;65294
06;2020-07-24;2;1;3;21571;15080;29;36651
06;2020-07-24;3;2;5;21550;16147;39;37697
06;2020-07-24;2;0;2;14193;13939;49;28132
06;2020-07-24;1;1;2;7171;7597;59;14768
06;2020-07-24;0;0;0;3629;4117;69;7746
06;2020-07-24;0;0;0;1577;1457;79;3034
06;2020-07-24;0;0;0;531;474;89;1005
06;2020-07-24;0;0;0;88;93;90;181
06;2020-07-24;8;6;14;146262;133209;0;279471
07;2020-07-24;0;0;0;485;549;09;1034
07;2020-07-24;0;0;0;403;432;19;835
07;2020-07-24;0;0;0;764;841;29;1605
07;2020-07-24;0;0;0;824;928;39;1752
07;2020-07-24;0;0;0;788;1020;49;1808
07;2020-07-24;0;0;0;678;870;59;1548
07;2020-07-24;0;0;0;360;382;69;742
07;2020-07-24;0;0;0;231;190;79;421
07;2020-07-24;0;0;0;114;67;89;181
07;2020-07-24;0;0;0;24;11;90;35
07;2020-07-24;0;0;0;4671;5290;0;9961
08;2020-07-24;0;0;0;2715.22592983026;2997.75551488675;09;5712.98144471701
08;2020-07-24;0;0;0;2778.51901080978;3160.9156459093;19;5939.43465671908
08;2020-07-24;0;0;0;2080.8882988764;1718.16634315323;29;3799.05464202964
08;2020-07-24;0;0;0;2701.8582062647;1896.52641413317;39;4598.38462039786
08;2020-07-24;0;0;0;3151.45861023308;2460.52498233809;49;5611.98359257117
08;2020-07-24;0;0;0;2620.29868333099;2422.23566154656;59;5042.53434487755
08;2020-07-24;0;0;0;1621.44173420671;1438.58325779464;69;3060.02499200135
08;2020-07-24;0;0;0;626.575909335673;526.358467843651;79;1152.93437717932
08;2020-07-24;0;0;0;205.018522985054;140.993639349697;89;346.012162334751
08;2020-07-24;0;0;0;50.0325684687745;20.62259870351;90;70.6551671722846
08;2020-07-24;0;0;0;18551.3174743414;16782.6825256586;0;35334
11;2020-07-24;5;5;10;783071;811785;09;1594856
11;2020-07-24;10;19;30;761456;784653;19;1546109
11;2020-07-24;44;46;90;850145;801772;29;1651917
11;2020-07-24;29;39;68;914360;843488;39;1757848
11;2020-07-24;19;21;40;845609;826202;49;1671811
11;2020-07-24;24;21;45;793566;745070;59;1538636
11;2020-07-24;12;15;27;628649;549192;69;1177841
11;2020-07-24;5;9;14;434606;358356;79;792962
11;2020-07-24;1;2;3;261425;162933;89;424358
11;2020-07-24;2;2;4;89253;32619;90;121872
11;2020-07-24;151;180;333;6362140;5916070;0;12278210
24;2020-07-24;0;0;0;139720;144686;09;284406
24;2020-07-24;3;1;4;152979;161185;19;314164
24;2020-07-24;6;5;11;122237;126536;29;248773
24;2020-07-24;3;4;7;150359;142009;39;292368
24;2020-07-24;0;5;5;161829;158758;49;320587
24;2020-07-24;3;2;5;172552;168011;59;340563
24;2020-07-24;2;2;4;172509;158177;69;330686
24;2020-07-24;1;0;1;129428;110593;79;240021
24;2020-07-24;0;0;0;87342;56882;89;144224
24;2020-07-24;0;0;0;31210;12071;90;43281
24;2020-07-24;18;19;37;1320165;1238908;0;2559073
27;2020-07-24;1;3;4;143373;149679;09;293052
27;2020-07-24;2;1;3;160962;173003;19;333965
27;2020-07-24;0;4;4;133746;142254;29;276000
27;2020-07-24;2;0;2;160004;155407;39;315411
27;2020-07-24;0;3;3;172333;169564;49;341897
27;2020-07-24;0;0;0;189979;183788;59;373767
27;2020-07-24;2;1;3;192591;178206;69;370797
27;2020-07-24;2;0;2;146876;127546;79;274422
27;2020-07-24;0;0;0;96896;61575;89;158471
27;2020-07-24;1;0;1;33148;12109;90;45257
27;2020-07-24;10;12;22;1429908;1353131;0;2783039
28;2020-07-24;0;1;1;180735;186856;09;367591
28;2020-07-24;1;0;1;200125;213621;19;413746
28;2020-07-24;0;1;1;168922;173007;29;341929
28;2020-07-24;2;1;3;196628;188487;39;385115
28;2020-07-24;2;3;5;205396;201699;49;407095
28;2020-07-24;2;0;2;222002;213866;59;435868
28;2020-07-24;1;0;1;224688;203758;69;428446
28;2020-07-24;0;1;1;163192;135543;79;298735
28;2020-07-24;0;0;0;109691;65377;89;175068
28;2020-07-24;0;0;0;37222;12685;90;49907
28;2020-07-24;8;7;15;1708601;1594899;0;3303500
32;2020-07-24;6;4;10;358062;373689;09;731751
32;2020-07-24;9;7;16;387045;406742;19;793787
32;2020-07-24;8;4;12;342304;348587;29;690891
32;2020-07-24;9;10;19;382485;369972;39;752457
32;2020-07-24;10;8;18;382510;376716;49;759226
32;2020-07-24;9;8;17;386937;376527;59;763464
32;2020-07-24;5;6;11;371211;330938;69;702149
32;2020-07-24;4;1;5;250542;201459;79;452001
32;2020-07-24;3;2;5;163399;89786;89;253185
32;2020-07-24;0;0;0;48384;15367;90;63751
32;2020-07-24;63;50;113;3072879;2889783;0;5962662
44;2020-07-24;3;3;6;291525;306839;09;598364
44;2020-07-24;2;4;6;320255;339504;19;659759
44;2020-07-24;5;4;9;302020;314428;29;616448
44;2020-07-24;3;7;10;342222;333292;39;675514
44;2020-07-24;4;9;13;349727;344491;49;694218
44;2020-07-24;4;7;11;381371;373239;59;754610
44;2020-07-24;5;6;11;367165;335850;69;703015
44;2020-07-24;4;3;7;250387;215436;79;465823
44;2020-07-24;0;0;0;170825;105192;89;276017
44;2020-07-24;0;0;0;51248;16731;90;67979
44;2020-07-24;30;43;73;2826745;2685002;0;5511747
52;2020-07-24;0;1;1;213594;223900;09;437494
52;2020-07-24;12;10;22;240818;255197;19;496015
52;2020-07-24;13;11;24;197010;200630;29;397640
52;2020-07-24;6;7;13;231204;224885;39;456089
52;2020-07-24;7;9;16;243874;243418;49;487292
52;2020-07-24;11;7;18;244100;239116;59;483216
52;2020-07-24;9;3;12;241796;221345;69;463141
52;2020-07-24;3;6;9;177805;149903;79;327708
52;2020-07-24;6;2;8;119561;75822;89;195383
52;2020-07-24;1;1;2;42559;15260;90;57819
52;2020-07-24;68;57;125;1952321;1849476;0;3801797
53;2020-07-24;1;0;1;173813;182358;09;356171
53;2020-07-24;8;12;20;202720;214740;19;417460
53;2020-07-24;10;11;21;163116;173196;29;336312
53;2020-07-24;1;4;5;190526;187674;39;378200
53;2020-07-24;3;2;5;212098;212015;49;424113
53;2020-07-24;1;2;3;223699;219176;59;442875
53;2020-07-24;1;1;2;227435;209274;69;436709
53;2020-07-24;0;0;0;169992;140910;79;310902
53;2020-07-24;0;0;0;118117;69883;89;188000
53;2020-07-24;0;0;0;37370;12267;90;49637
53;2020-07-24;25;32;57;1718886;1621493;0;3340379
75;2020-07-24;2;1;3;293104;305291;09;598395
75;2020-07-24;3;5;8;337141;357785;19;694926
75;2020-07-24;6;7;13;295024;300618;29;595642
75;2020-07-24;3;4;7;347871;331233;39;679104
75;2020-07-24;2;4;6;384742;372771;49;757513
75;2020-07-24;3;3;6;413361;390880;59;804241
75;2020-07-24;0;3;3;425623;384060;69;809683
75;2020-07-24;2;0;2;325086;276298;79;601384
75;2020-07-24;0;0;0;213986;139308;89;353294
75;2020-07-24;1;0;1;77600;28200;90;105800
75;2020-07-24;22;27;49;3113538;2886444;0;5999982
76;2020-07-24;0;2;2;305956;318589;09;624545
76;2020-07-24;2;4;7;338942;356969;19;695911
76;2020-07-24;11;6;17;316210;319570;29;635780
76;2020-07-24;4;5;9;356758;337587;39;694345
76;2020-07-24;4;8;12;376541;363812;49;740353
76;2020-07-24;5;9;14;402608;383750;59;786358
76;2020-07-24;3;4;7;394889;358997;69;753886
76;2020-07-24;1;3;4;308664;263806;79;572470
76;2020-07-24;0;2;2;195838;129272;89;325110
76;2020-07-24;1;1;2;69372;26728;90;96100
76;2020-07-24;31;45;77;3065778;2859080;0;5924858
84;2020-07-24;3;3;6;459549;481088;09;940637
84;2020-07-24;8;5;13;487711;511905;19;999616
84;2020-07-24;20;16;36;443824;451094;29;894918
84;2020-07-24;13;12;25;512522;493262;39;1005784
84;2020-07-24;9;5;14;520248;515106;49;1035354
84;2020-07-24;11;8;19;529611;514848;59;1044459
84;2020-07-24;5;3;8;486720;439940;69;926660
84;2020-07-24;5;3;8;372151;315211;79;687362
84;2020-07-24;3;3;6;237198;150524;89;387722
84;2020-07-24;1;0;1;81185;28680;90;109865
84;2020-07-24;78;58;136;4130719;3901658;0;8032377
93;2020-07-24;1;3;4;268834;283093;09;551927
93;2020-07-24;3;2;5;280751;296087;19;576838
93;2020-07-24;12;9;21;254404;255552;29;509956
93;2020-07-24;5;9;14;310704;288398;39;599102
93;2020-07-24;7;4;11;325559;305827;49;631386
93;2020-07-24;8;8;16;353104;325389;59;678493
93;2020-07-24;12;7;19;336327;296459;69;632786
93;2020-07-24;6;6;12;279820;229699;79;509519
93;2020-07-24;1;2;3;171274;113716;89;284990
93;2020-07-24;1;0;1;58896;21758;90;80654
93;2020-07-24;56;50;106;2639673;2415978;0;5055651
94;2020-07-24;0;0;0;16311;17433;09;33744
94;2020-07-24;0;0;0;16679;18132;19;34811
94;2020-07-24;0;0;0;16782;16579;29;33361
94;2020-07-24;0;0;0;23044;20580;39;43624
94;2020-07-24;0;0;0;23065;22140;49;45205
94;2020-07-24;0;0;0;24549;23421;59;47970
94;2020-07-24;0;0;0;23212;21883;69;45095
94;2020-07-24;0;0;0;19544;17141;79;36685
94;2020-07-24;0;0;0;11227;8178;89;19405
94;2020-07-24;0;0;0;3332;1447;90;4779
94;2020-07-24;0;0;0;177745;166934;0;344679
01;2020-07-25;0;0;0;19979;20155;09;40134
01;2020-07-25;0;0;0;24994;25489;19;50483
01;2020-07-25;0;0;0;17868;16690;29;34558
01;2020-07-25;1;0;1;22328;14821;39;37149
01;2020-07-25;0;0;0;28652;20276;49;48928
01;2020-07-25;0;0;0;33264;27260;59;60524
01;2020-07-25;0;0;0;27135;23978;69;51113
01;2020-07-25;0;0;0;18401;14661;79;33062
01;2020-07-25;0;0;0;9633;6375;89;16008
01;2020-07-25;0;0;0;3410;1510;90;4920
01;2020-07-25;1;0;1;205664;171215;0;376879
02;2020-07-25;0;0;0;16881;17110;09;33991
02;2020-07-25;0;0;0;21410;21604;19;43014
02;2020-07-25;0;0;0;16017;15479;29;31496
02;2020-07-25;0;0;0;19825;14455;39;34280
02;2020-07-25;0;0;0;24719;18248;49;42967
02;2020-07-25;0;0;0;34361;28310;59;62671
02;2020-07-25;0;0;0;28061;24495;69;52556
02;2020-07-25;0;0;0;18231;15278;79;33509
02;2020-07-25;0;0;0;11090;7677;89;18767
02;2020-07-25;0;0;0;3992;1506;90;5498
02;2020-07-25;0;0;0;194587;164162;0;358749
03;2020-07-25;0;3;4;31123;30920;09;62043
03;2020-07-25;3;2;5;29370;29268;19;58638
03;2020-07-25;6;8;14;21458;18963;29;40421
03;2020-07-25;10;12;22;21276;18326;39;39602
03;2020-07-25;5;2;7;18164;16593;49;34757
03;2020-07-25;4;1;5;13469;13557;59;27026
03;2020-07-25;4;1;5;8776;8670;69;17446
03;2020-07-25;0;4;4;3777;3591;79;7368
03;2020-07-25;0;0;0;1649;1072;89;2721
03;2020-07-25;0;0;0;485;184;90;669
03;2020-07-25;32;33;66;149547;141144;0;290691
04;2020-07-25;0;0;0;60314;61377;09;121691
04;2020-07-25;0;0;0;66065;68387;19;134452
04;2020-07-25;0;0;0;51059;47156;29;98215
04;2020-07-25;0;0;0;58788;45780;39;104568
04;2020-07-25;0;0;0;61408;52207;49;113615
04;2020-07-25;1;0;1;64838;60759;59;125597
04;2020-07-25;0;0;0;47008;42843;69;89851
04;2020-07-25;0;0;0;25509;21184;79;46693
04;2020-07-25;0;0;0;13168;7647;89;20815
04;2020-07-25;0;0;0;3209;1253;90;4462
04;2020-07-25;1;0;1;451366;408593;0;859959
05;2020-07-25;0;0;0;362.366008612902;341.338819562748;09;703.704828175651
05;2020-07-25;0;0;0;353.376145114279;370.349735405642;19;723.725880519921
05;2020-07-25;0;0;0;218.593559489256;256.539602589476;29;475.133162078732
05;2020-07-25;0;0;0;404.225408693299;360.321910454353;39;764.547319147651
05;2020-07-25;0;0;0;520.067953604221;497.108383964256;49;1017.17633756848
05;2020-07-25;0;0;0;468.146063921917;510.087601910415;59;978.233665832332
05;2020-07-25;0;0;0;340.368470050554;334.366842191253;69;674.735312241807
05;2020-07-25;0;0;0;212.598666888387;192.597753227106;79;405.196420115493
05;2020-07-25;0;0;0;148.727797095705;61.8681715431829;89;210.595968638888
05;2020-07-25;0;0;0;32.9601271090696;10.9909785719784;90;43.9511056810479
05;2020-07-25;0;0;0;3061.43020057959;2935.56979942041;0;5997
06;2020-07-25;0;0;0;42583;42380;09;84963
06;2020-07-25;0;0;0;33369;31925;19;65294
06;2020-07-25;0;0;0;21571;15080;29;36651
06;2020-07-25;1;0;1;21550;16147;39;37697
06;2020-07-25;0;0;0;14193;13939;49;28132
06;2020-07-25;0;0;0;7171;7597;59;14768
06;2020-07-25;0;0;0;3629;4117;69;7746
06;2020-07-25;0;0;0;1577;1457;79;3034
06;2020-07-25;0;0;0;531;474;89;1005
06;2020-07-25;0;0;0;88;93;90;181
06;2020-07-25;1;0;1;146262;133209;0;279471
07;2020-07-25;0;0;0;485;549;09;1034
07;2020-07-25;0;0;0;403;432;19;835
07;2020-07-25;0;0;0;764;841;29;1605
07;2020-07-25;0;0;0;824;928;39;1752
07;2020-07-25;0;0;0;788;1020;49;1808
07;2020-07-25;0;0;0;678;870;59;1548
07;2020-07-25;0;0;0;360;382;69;742
07;2020-07-25;0;0;0;231;190;79;421
07;2020-07-25;0;0;0;114;67;89;181
07;2020-07-25;0;0;0;24;11;90;35
07;2020-07-25;0;0;0;4671;5290;0;9961
08;2020-07-25;0;0;0;2715.22592983026;2997.75551488675;09;5712.98144471701
08;2020-07-25;0;0;0;2778.51901080978;3160.9156459093;19;5939.43465671908
08;2020-07-25;0;0;0;2080.8882988764;1718.16634315323;29;3799.05464202964
08;2020-07-25;0;0;0;2701.8582062647;1896.52641413317;39;4598.38462039786
08;2020-07-25;0;0;0;3151.45861023308;2460.52498233809;49;5611.98359257117
08;2020-07-25;0;0;0;2620.29868333099;2422.23566154656;59;5042.53434487755
08;2020-07-25;0;0;0;1621.44173420671;1438.58325779464;69;3060.02499200135
08;2020-07-25;0;0;0;626.575909335673;526.358467843651;79;1152.93437717932
08;2020-07-25;0;0;0;205.018522985054;140.993639349697;89;346.012162334751
08;2020-07-25;0;0;0;50.0325684687745;20.62259870351;90;70.6551671722846
08;2020-07-25;0;0;0;18551.3174743414;16782.6825256586;0;35334
11;2020-07-25;1;2;4;783071;811785;09;1594856
11;2020-07-25;4;6;10;761456;784653;19;1546109
11;2020-07-25;28;17;45;850145;801772;29;1651917
11;2020-07-25;14;12;26;914360;843488;39;1757848
11;2020-07-25;10;16;26;845609;826202;49;1671811
11;2020-07-25;9;7;16;793566;745070;59;1538636
11;2020-07-25;8;8;16;628649;549192;69;1177841
11;2020-07-25;8;3;11;434606;358356;79;792962
11;2020-07-25;3;2;5;261425;162933;89;424358
11;2020-07-25;2;0;2;89253;32619;90;121872
11;2020-07-25;87;73;161;6362140;5916070;0;12278210
24;2020-07-25;0;0;0;139720;144686;09;284406
24;2020-07-25;1;0;1;152979;161185;19;314164
24;2020-07-25;3;2;5;122237;126536;29;248773
24;2020-07-25;2;2;4;150359;142009;39;292368
24;2020-07-25;1;1;2;161829;158758;49;320587
24;2020-07-25;1;0;1;172552;168011;59;340563
24;2020-07-25;3;0;3;172509;158177;69;330686
24;2020-07-25;0;0;0;129428;110593;79;240021
24;2020-07-25;0;0;0;87342;56882;89;144224
24;2020-07-25;0;0;0;31210;12071;90;43281
24;2020-07-25;11;5;16;1320165;1238908;0;2559073
27;2020-07-25;2;0;2;143373;149679;09;293052
27;2020-07-25;0;0;0;160962;173003;19;333965
27;2020-07-25;1;1;2;133746;142254;29;276000
27;2020-07-25;1;1;2;160004;155407;39;315411
27;2020-07-25;1;0;1;172333;169564;49;341897
27;2020-07-25;1;0;1;189979;183788;59;373767
27;2020-07-25;0;1;1;192591;178206;69;370797
27;2020-07-25;0;1;1;146876;127546;79;274422
27;2020-07-25;0;0;0;96896;61575;89;158471
27;2020-07-25;0;0;0;33148;12109;90;45257
27;2020-07-25;6;4;10;1429908;1353131;0;2783039
28;2020-07-25;0;0;0;180735;186856;09;367591
28;2020-07-25;0;0;0;200125;213621;19;413746
28;2020-07-25;0;1;1;168922;173007;29;341929
28;2020-07-25;2;1;3;196628;188487;39;385115
28;2020-07-25;1;2;3;205396;201699;49;407095
28;2020-07-25;1;0;1;222002;213866;59;435868
28;2020-07-25;0;0;0;224688;203758;69;428446
28;2020-07-25;0;0;0;163192;135543;79;298735
28;2020-07-25;0;0;0;109691;65377;89;175068
28;2020-07-25;0;0;0;37222;12685;90;49907
28;2020-07-25;4;4;8;1708601;1594899;0;3303500
32;2020-07-25;4;3;7;358062;373689;09;731751
32;2020-07-25;2;4;6;387045;406742;19;793787
32;2020-07-25;4;3;7;342304;348587;29;690891
32;2020-07-25;7;6;13;382485;369972;39;752457
32;2020-07-25;6;5;12;382510;376716;49;759226
32;2020-07-25;5;4;9;386937;376527;59;763464
32;2020-07-25;3;1;5;371211;330938;69;702149
32;2020-07-25;3;5;8;250542;201459;79;452001
32;2020-07-25;3;2;5;163399;89786;89;253185
32;2020-07-25;0;0;0;48384;15367;90;63751
32;2020-07-25;37;33;72;3072879;2889783;0;5962662
44;2020-07-25;0;1;1;291525;306839;09;598364
44;2020-07-25;3;1;4;320255;339504;19;659759
44;2020-07-25;8;7;15;302020;314428;29;616448
44;2020-07-25;1;2;3;342222;333292;39;675514
44;2020-07-25;2;1;3;349727;344491;49;694218
44;2020-07-25;0;2;2;381371;373239;59;754610
44;2020-07-25;0;1;1;367165;335850;69;703015
44;2020-07-25;4;1;5;250387;215436;79;465823
44;2020-07-25;0;0;0;170825;105192;89;276017
44;2020-07-25;0;0;0;51248;16731;90;67979
44;2020-07-25;18;16;34;2826745;2685002;0;5511747
52;2020-07-25;1;1;2;213594;223900;09;437494
52;2020-07-25;3;6;9;240818;255197;19;496015
52;2020-07-25;5;4;9;197010;200630;29;397640
52;2020-07-25;3;1;4;231204;224885;39;456089
52;2020-07-25;3;3;6;243874;243418;49;487292
52;2020-07-25;2;9;11;244100;239116;59;483216
52;2020-07-25;3;0;3;241796;221345;69;463141
52;2020-07-25;0;4;4;177805;149903;79;327708
52;2020-07-25;0;1;1;119561;75822;89;195383
52;2020-07-25;0;0;0;42559;15260;90;57819
52;2020-07-25;20;29;49;1952321;1849476;0;3801797
53;2020-07-25;1;0;1;173813;182358;09;356171
53;2020-07-25;7;7;14;202720;214740;19;417460
53;2020-07-25;11;7;18;163116;173196;29;336312
53;2020-07-25;1;6;7;190526;187674;39;378200
53;2020-07-25;1;1;2;212098;212015;49;424113
53;2020-07-25;1;1;2;223699;219176;59;442875
53;2020-07-25;0;1;1;227435;209274;69;436709
53;2020-07-25;1;2;3;169992;140910;79;310902
53;2020-07-25;0;0;0;118117;69883;89;188000
53;2020-07-25;0;0;0;37370;12267;90;49637
53;2020-07-25;23;25;48;1718886;1621493;0;3340379
75;2020-07-25;0;1;1;293104;305291;09;598395
75;2020-07-25;1;0;1;337141;357785;19;694926
75;2020-07-25;4;1;5;295024;300618;29;595642
75;2020-07-25;1;3;4;347871;331233;39;679104
75;2020-07-25;0;1;1;384742;372771;49;757513
75;2020-07-25;0;0;0;413361;390880;59;804241
75;2020-07-25;1;0;1;425623;384060;69;809683
75;2020-07-25;0;0;0;325086;276298;79;601384
75;2020-07-25;0;0;0;213986;139308;89;353294
75;2020-07-25;0;0;0;77600;28200;90;105800
75;2020-07-25;7;6;13;3113538;2886444;0;5999982
76;2020-07-25;1;2;3;305956;318589;09;624545
76;2020-07-25;0;4;4;338942;356969;19;695911
76;2020-07-25;1;3;4;316210;319570;29;635780
76;2020-07-25;5;5;10;356758;337587;39;694345
76;2020-07-25;3;4;7;376541;363812;49;740353
76;2020-07-25;5;2;7;402608;383750;59;786358
76;2020-07-25;1;0;1;394889;358997;69;753886
76;2020-07-25;1;0;1;308664;263806;79;572470
76;2020-07-25;0;1;1;195838;129272;89;325110
76;2020-07-25;0;0;0;69372;26728;90;96100
76;2020-07-25;17;21;38;3065778;2859080;0;5924858
84;2020-07-25;2;3;5;459549;481088;09;940637
84;2020-07-25;3;1;4;487711;511905;19;999616
84;2020-07-25;11;8;19;443824;451094;29;894918
84;2020-07-25;3;6;9;512522;493262;39;1005784
84;2020-07-25;4;6;10;520248;515106;49;1035354
84;2020-07-25;6;6;12;529611;514848;59;1044459
84;2020-07-25;5;0;5;486720;439940;69;926660
84;2020-07-25;1;3;4;372151;315211;79;687362
84;2020-07-25;0;0;0;237198;150524;89;387722
84;2020-07-25;1;0;1;81185;28680;90;109865
84;2020-07-25;36;33;69;4130719;3901658;0;8032377
93;2020-07-25;0;1;1;268834;283093;09;551927
93;2020-07-25;3;1;4;280751;296087;19;576838
93;2020-07-25;6;4;10;254404;255552;29;509956
93;2020-07-25;2;7;9;310704;288398;39;599102
93;2020-07-25;0;1;1;325559;305827;49;631386
93;2020-07-25;4;3;7;353104;325389;59;678493
93;2020-07-25;0;1;1;336327;296459;69;632786
93;2020-07-25;0;0;0;279820;229699;79;509519
93;2020-07-25;1;0;1;171274;113716;89;284990
93;2020-07-25;0;0;0;58896;21758;90;80654
93;2020-07-25;16;18;34;2639673;2415978;0;5055651
94;2020-07-25;0;0;0;16311;17433;09;33744
94;2020-07-25;0;0;0;16679;18132;19;34811
94;2020-07-25;0;0;0;16782;16579;29;33361
94;2020-07-25;0;0;0;23044;20580;39;43624
94;2020-07-25;0;0;0;23065;22140;49;45205
94;2020-07-25;0;0;0;24549;23421;59;47970
94;2020-07-25;0;1;1;23212;21883;69;45095
94;2020-07-25;0;0;0;19544;17141;79;36685
94;2020-07-25;0;0;0;11227;8178;89;19405
94;2020-07-25;0;0;0;3332;1447;90;4779
94;2020-07-25;0;1;1;177745;166934;0;344679
01;2020-07-26;0;0;0;19979;20155;09;40134
01;2020-07-26;0;0;0;24994;25489;19;50483
01;2020-07-26;0;0;0;17868;16690;29;34558
01;2020-07-26;0;0;0;22328;14821;39;37149
01;2020-07-26;0;0;0;28652;20276;49;48928
01;2020-07-26;0;0;0;33264;27260;59;60524
01;2020-07-26;0;0;0;27135;23978;69;51113
01;2020-07-26;0;0;0;18401;14661;79;33062
01;2020-07-26;0;0;0;9633;6375;89;16008
01;2020-07-26;0;0;0;3410;1510;90;4920
01;2020-07-26;0;0;0;205664;171215;0;376879
02;2020-07-26;0;0;0;16881;17110;09;33991
02;2020-07-26;0;0;0;21410;21604;19;43014
02;2020-07-26;0;0;0;16017;15479;29;31496
02;2020-07-26;0;0;0;19825;14455;39;34280
02;2020-07-26;1;0;1;24719;18248;49;42967
02;2020-07-26;0;0;0;34361;28310;59;62671
02;2020-07-26;0;0;0;28061;24495;69;52556
02;2020-07-26;0;0;0;18231;15278;79;33509
02;2020-07-26;0;0;0;11090;7677;89;18767
02;2020-07-26;0;0;0;3992;1506;90;5498
02;2020-07-26;1;0;1;194587;164162;0;358749
03;2020-07-26;2;2;4;31123;30920;09;62043
03;2020-07-26;5;3;9;29370;29268;19;58638
03;2020-07-26;11;14;26;21458;18963;29;40421
03;2020-07-26;8;2;11;21276;18326;39;39602
03;2020-07-26;6;4;10;18164;16593;49;34757
03;2020-07-26;2;4;10;13469;13557;59;27026
03;2020-07-26;1;2;3;8776;8670;69;17446
03;2020-07-26;0;0;0;3777;3591;79;7368
03;2020-07-26;2;0;2;1649;1072;89;2721
03;2020-07-26;0;0;0;485;184;90;669
03;2020-07-26;37;31;75;149547;141144;0;290691
04;2020-07-26;0;0;0;60314;61377;09;121691
04;2020-07-26;0;0;0;66065;68387;19;134452
04;2020-07-26;0;0;0;51059;47156;29;98215
04;2020-07-26;0;0;0;58788;45780;39;104568
04;2020-07-26;0;0;0;61408;52207;49;113615
04;2020-07-26;0;0;0;64838;60759;59;125597
04;2020-07-26;0;0;0;47008;42843;69;89851
04;2020-07-26;0;0;0;25509;21184;79;46693
04;2020-07-26;0;0;0;13168;7647;89;20815
04;2020-07-26;0;0;0;3209;1253;90;4462
04;2020-07-26;0;0;0;451366;408593;0;859959
05;2020-07-26;0;0;0;362.366008612902;341.338819562748;09;703.704828175651
05;2020-07-26;0;0;0;353.376145114279;370.349735405642;19;723.725880519921
05;2020-07-26;0;0;0;218.593559489256;256.539602589476;29;475.133162078732
05;2020-07-26;0;0;0;404.225408693299;360.321910454353;39;764.547319147651
05;2020-07-26;0;0;0;520.067953604221;497.108383964256;49;1017.17633756848
05;2020-07-26;0;0;0;468.146063921917;510.087601910415;59;978.233665832332
05;2020-07-26;0;0;0;340.368470050554;334.366842191253;69;674.735312241807
05;2020-07-26;0;0;0;212.598666888387;192.597753227106;79;405.196420115493
05;2020-07-26;0;0;0;148.727797095705;61.8681715431829;89;210.595968638888
05;2020-07-26;0;0;0;32.9601271090696;10.9909785719784;90;43.9511056810479
05;2020-07-26;0;0;0;3061.43020057959;2935.56979942041;0;5997
06;2020-07-26;0;1;1;42583;42380;09;84963
06;2020-07-26;0;0;0;33369;31925;19;65294
06;2020-07-26;1;0;1;21571;15080;29;36651
06;2020-07-26;0;0;0;21550;16147;39;37697
06;2020-07-26;0;0;0;14193;13939;49;28132
06;2020-07-26;0;0;0;7171;7597;59;14768
06;2020-07-26;0;1;1;3629;4117;69;7746
06;2020-07-26;0;0;0;1577;1457;79;3034
06;2020-07-26;0;0;0;531;474;89;1005
06;2020-07-26;0;0;0;88;93;90;181
06;2020-07-26;1;2;3;146262;133209;0;279471
07;2020-07-26;0;0;0;485;549;09;1034
07;2020-07-26;0;0;0;403;432;19;835
07;2020-07-26;0;0;0;764;841;29;1605
07;2020-07-26;0;0;0;824;928;39;1752
07;2020-07-26;0;0;0;788;1020;49;1808
07;2020-07-26;0;0;0;678;870;59;1548
07;2020-07-26;0;0;0;360;382;69;742
07;2020-07-26;0;0;0;231;190;79;421
07;2020-07-26;0;0;0;114;67;89;181
07;2020-07-26;0;0;0;24;11;90;35
07;2020-07-26;0;0;0;4671;5290;0;9961
08;2020-07-26;0;0;0;2715.22592983026;2997.75551488675;09;5712.98144471701
08;2020-07-26;0;0;0;2778.51901080978;3160.9156459093;19;5939.43465671908
08;2020-07-26;0;0;0;2080.8882988764;1718.16634315323;29;3799.05464202964
08;2020-07-26;0;0;0;2701.8582062647;1896.52641413317;39;4598.38462039786
08;2020-07-26;0;0;0;3151.45861023308;2460.52498233809;49;5611.98359257117
08;2020-07-26;0;0;0;2620.29868333099;2422.23566154656;59;5042.53434487755
08;2020-07-26;0;0;0;1621.44173420671;1438.58325779464;69;3060.02499200135
08;2020-07-26;0;0;0;626.575909335673;526.358467843651;79;1152.93437717932
08;2020-07-26;0;0;0;205.018522985054;140.993639349697;89;346.012162334751
08;2020-07-26;0;0;0;50.0325684687745;20.62259870351;90;70.6551671722846
08;2020-07-26;0;0;0;18551.3174743414;16782.6825256586;0;35334
11;2020-07-26;1;0;1;783071;811785;09;1594856
11;2020-07-26;2;2;4;761456;784653;19;1546109
11;2020-07-26;9;8;17;850145;801772;29;1651917
11;2020-07-26;5;3;8;914360;843488;39;1757848
11;2020-07-26;5;5;10;845609;826202;49;1671811
11;2020-07-26;0;4;4;793566;745070;59;1538636
11;2020-07-26;5;6;11;628649;549192;69;1177841
11;2020-07-26;1;3;4;434606;358356;79;792962
11;2020-07-26;0;1;1;261425;162933;89;424358
11;2020-07-26;1;1;2;89253;32619;90;121872
11;2020-07-26;29;33;62;6362140;5916070;0;12278210
24;2020-07-26;0;0;0;139720;144686;09;284406
24;2020-07-26;0;0;0;152979;161185;19;314164
24;2020-07-26;0;1;1;122237;126536;29;248773
24;2020-07-26;1;0;1;150359;142009;39;292368
24;2020-07-26;0;0;0;161829;158758;49;320587
24;2020-07-26;0;1;1;172552;168011;59;340563
24;2020-07-26;0;0;0;172509;158177;69;330686
24;2020-07-26;1;0;1;129428;110593;79;240021
24;2020-07-26;0;0;0;87342;56882;89;144224
24;2020-07-26;0;0;0;31210;12071;90;43281
24;2020-07-26;2;2;4;1320165;1238908;0;2559073
27;2020-07-26;1;0;1;143373;149679;09;293052
27;2020-07-26;0;0;0;160962;173003;19;333965
27;2020-07-26;2;0;2;133746;142254;29;276000
27;2020-07-26;1;0;1;160004;155407;39;315411
27;2020-07-26;0;2;2;172333;169564;49;341897
27;2020-07-26;0;0;0;189979;183788;59;373767
27;2020-07-26;0;0;0;192591;178206;69;370797
27;2020-07-26;0;0;0;146876;127546;79;274422
27;2020-07-26;1;0;1;96896;61575;89;158471
27;2020-07-26;0;0;0;33148;12109;90;45257
27;2020-07-26;5;2;7;1429908;1353131;0;2783039
28;2020-07-26;1;1;2;180735;186856;09;367591
28;2020-07-26;0;0;0;200125;213621;19;413746
28;2020-07-26;2;2;4;168922;173007;29;341929
28;2020-07-26;0;0;0;196628;188487;39;385115
28;2020-07-26;0;0;0;205396;201699;49;407095
28;2020-07-26;0;0;0;222002;213866;59;435868
28;2020-07-26;0;1;1;224688;203758;69;428446
28;2020-07-26;1;0;1;163192;135543;79;298735
28;2020-07-26;0;0;0;109691;65377;89;175068
28;2020-07-26;0;0;0;37222;12685;90;49907
28;2020-07-26;4;4;8;1708601;1594899;0;3303500
32;2020-07-26;1;0;1;358062;373689;09;731751
32;2020-07-26;0;0;0;387045;406742;19;793787
32;2020-07-26;0;0;0;342304;348587;29;690891
32;2020-07-26;0;0;0;382485;369972;39;752457
32;2020-07-26;1;1;2;382510;376716;49;759226
32;2020-07-26;0;0;0;386937;376527;59;763464
32;2020-07-26;0;0;0;371211;330938;69;702149
32;2020-07-26;1;0;1;250542;201459;79;452001
32;2020-07-26;1;0;1;163399;89786;89;253185
32;2020-07-26;1;1;2;48384;15367;90;63751
32;2020-07-26;5;2;7;3072879;2889783;0;5962662
44;2020-07-26;0;1;1;291525;306839;09;598364
44;2020-07-26;0;0;0;320255;339504;19;659759
44;2020-07-26;0;0;0;302020;314428;29;616448
44;2020-07-26;0;2;2;342222;333292;39;675514
44;2020-07-26;0;0;0;349727;344491;49;694218
44;2020-07-26;0;0;0;381371;373239;59;754610
44;2020-07-26;0;1;1;367165;335850;69;703015
44;2020-07-26;0;1;1;250387;215436;79;465823
44;2020-07-26;0;0;0;170825;105192;89;276017
44;2020-07-26;0;0;0;51248;16731;90;67979
44;2020-07-26;0;5;5;2826745;2685002;0;5511747
52;2020-07-26;0;0;0;213594;223900;09;437494
52;2020-07-26;1;1;2;240818;255197;19;496015
52;2020-07-26;0;3;3;197010;200630;29;397640
52;2020-07-26;1;1;2;231204;224885;39;456089
52;2020-07-26;2;1;3;243874;243418;49;487292
52;2020-07-26;0;0;0;244100;239116;59;483216
52;2020-07-26;1;0;1;241796;221345;69;463141
52;2020-07-26;0;0;0;177805;149903;79;327708
52;2020-07-26;0;0;0;119561;75822;89;195383
52;2020-07-26;0;0;0;42559;15260;90;57819
52;2020-07-26;5;6;11;1952321;1849476;0;3801797
53;2020-07-26;0;0;0;173813;182358;09;356171
53;2020-07-26;1;1;2;202720;214740;19;417460
53;2020-07-26;2;4;6;163116;173196;29;336312
53;2020-07-26;1;0;1;190526;187674;39;378200
53;2020-07-26;0;0;0;212098;212015;49;424113
53;2020-07-26;0;0;0;223699;219176;59;442875
53;2020-07-26;0;0;0;227435;209274;69;436709
53;2020-07-26;0;0;0;169992;140910;79;310902
53;2020-07-26;0;0;0;118117;69883;89;188000
53;2020-07-26;1;0;1;37370;12267;90;49637
53;2020-07-26;5;5;10;1718886;1621493;0;3340379
75;2020-07-26;0;0;0;293104;305291;09;598395
75;2020-07-26;0;0;0;337141;357785;19;694926
75;2020-07-26;2;1;3;295024;300618;29;595642
75;2020-07-26;1;0;1;347871;331233;39;679104
75;2020-07-26;1;0;1;384742;372771;49;757513
75;2020-07-26;0;0;0;413361;390880;59;804241
75;2020-07-26;0;1;1;425623;384060;69;809683
75;2020-07-26;0;0;0;325086;276298;79;601384
75;2020-07-26;0;0;0;213986;139308;89;353294
75;2020-07-26;0;0;0;77600;28200;90;105800
75;2020-07-26;4;2;6;3113538;2886444;0;5999982
76;2020-07-26;0;1;1;305956;318589;09;624545
76;2020-07-26;0;0;0;338942;356969;19;695911
76;2020-07-26;1;0;1;316210;319570;29;635780
76;2020-07-26;0;1;1;356758;337587;39;694345
76;2020-07-26;0;0;0;376541;363812;49;740353
76;2020-07-26;1;1;2;402608;383750;59;786358
76;2020-07-26;0;0;0;394889;358997;69;753886
76;2020-07-26;0;0;0;308664;263806;79;572470
76;2020-07-26;1;0;1;195838;129272;89;325110
76;2020-07-26;0;0;0;69372;26728;90;96100
76;2020-07-26;3;3;6;3065778;2859080;0;5924858
84;2020-07-26;1;4;5;459549;481088;09;940637
84;2020-07-26;3;2;5;487711;511905;19;999616
84;2020-07-26;4;4;8;443824;451094;29;894918
84;2020-07-26;3;4;7;512522;493262;39;1005784
84;2020-07-26;4;4;8;520248;515106;49;1035354
84;2020-07-26;1;1;2;529611;514848;59;1044459
84;2020-07-26;0;0;0;486720;439940;69;926660
84;2020-07-26;2;2;4;372151;315211;79;687362
84;2020-07-26;1;0;1;237198;150524;89;387722
84;2020-07-26;3;0;3;81185;28680;90;109865
84;2020-07-26;22;21;43;4130719;3901658;0;8032377
93;2020-07-26;0;0;0;268834;283093;09;551927
93;2020-07-26;0;0;0;280751;296087;19;576838
93;2020-07-26;5;0;5;254404;255552;29;509956
93;2020-07-26;3;2;5;310704;288398;39;599102
93;2020-07-26;1;0;1;325559;305827;49;631386
93;2020-07-26;1;0;1;353104;325389;59;678493
93;2020-07-26;0;1;1;336327;296459;69;632786
93;2020-07-26;0;1;1;279820;229699;79;509519
93;2020-07-26;0;0;0;171274;113716;89;284990
93;2020-07-26;1;0;1;58896;21758;90;80654
93;2020-07-26;11;4;15;2639673;2415978;0;5055651
94;2020-07-26;0;0;0;16311;17433;09;33744
94;2020-07-26;0;0;0;16679;18132;19;34811
94;2020-07-26;0;0;0;16782;16579;29;33361
94;2020-07-26;0;0;0;23044;20580;39;43624
94;2020-07-26;0;0;0;23065;22140;49;45205
94;2020-07-26;0;0;0;24549;23421;59;47970
94;2020-07-26;0;0;0;23212;21883;69;45095
94;2020-07-26;0;0;0;19544;17141;79;36685
94;2020-07-26;0;0;0;11227;8178;89;19405
94;2020-07-26;0;0;0;3332;1447;90;4779
94;2020-07-26;0;0;0;177745;166934;0;344679
01;2020-07-27;0;0;0;19979;20155;09;40134
01;2020-07-27;0;1;1;24994;25489;19;50483
01;2020-07-27;4;8;12;17868;16690;29;34558
01;2020-07-27;1;0;1;22328;14821;39;37149
01;2020-07-27;2;2;4;28652;20276;49;48928
01;2020-07-27;1;4;5;33264;27260;59;60524
01;2020-07-27;1;1;2;27135;23978;69;51113
01;2020-07-27;0;0;0;18401;14661;79;33062
01;2020-07-27;0;0;0;9633;6375;89;16008
01;2020-07-27;0;0;0;3410;1510;90;4920
01;2020-07-27;10;16;26;205664;171215;0;376879
02;2020-07-27;0;0;0;16881;17110;09;33991
02;2020-07-27;1;0;1;21410;21604;19;43014
02;2020-07-27;0;0;0;16017;15479;29;31496
02;2020-07-27;0;0;0;19825;14455;39;34280
02;2020-07-27;0;0;0;24719;18248;49;42967
02;2020-07-27;0;0;0;34361;28310;59;62671
02;2020-07-27;0;0;0;28061;24495;69;52556
02;2020-07-27;0;0;0;18231;15278;79;33509
02;2020-07-27;0;0;0;11090;7677;89;18767
02;2020-07-27;0;0;0;3992;1506;90;5498
02;2020-07-27;1;0;1;194587;164162;0;358749
03;2020-07-27;3;2;5;31123;30920;09;62043
03;2020-07-27;12;4;16;29370;29268;19;58638
03;2020-07-27;8;4;15;21458;18963;29;40421
03;2020-07-27;8;2;11;21276;18326;39;39602
03;2020-07-27;4;6;10;18164;16593;49;34757
03;2020-07-27;0;6;6;13469;13557;59;27026
03;2020-07-27;0;8;8;8776;8670;69;17446
03;2020-07-27;3;1;4;3777;3591;79;7368
03;2020-07-27;0;0;0;1649;1072;89;2721
03;2020-07-27;0;0;0;485;184;90;669
03;2020-07-27;38;33;75;149547;141144;0;290691
04;2020-07-27;0;0;0;60314;61377;09;121691
04;2020-07-27;0;0;0;66065;68387;19;134452
04;2020-07-27;1;0;1;51059;47156;29;98215
04;2020-07-27;1;0;1;58788;45780;39;104568
04;2020-07-27;1;0;1;61408;52207;49;113615
04;2020-07-27;0;0;0;64838;60759;59;125597
04;2020-07-27;1;0;1;47008;42843;69;89851
04;2020-07-27;0;0;0;25509;21184;79;46693
04;2020-07-27;0;0;0;13168;7647;89;20815
04;2020-07-27;0;0;0;3209;1253;90;4462
04;2020-07-27;4;0;4;451366;408593;0;859959
05;2020-07-27;0;0;0;362.366008612902;341.338819562748;09;703.704828175651
05;2020-07-27;0;0;0;353.376145114279;370.349735405642;19;723.725880519921
05;2020-07-27;0;0;0;218.593559489256;256.539602589476;29;475.133162078732
05;2020-07-27;0;0;0;404.225408693299;360.321910454353;39;764.547319147651
05;2020-07-27;0;0;0;520.067953604221;497.108383964256;49;1017.17633756848
05;2020-07-27;0;0;0;468.146063921917;510.087601910415;59;978.233665832332
05;2020-07-27;0;0;0;340.368470050554;334.366842191253;69;674.735312241807
05;2020-07-27;0;0;0;212.598666888387;192.597753227106;79;405.196420115493
05;2020-07-27;0;0;0;148.727797095705;61.8681715431829;89;210.595968638888
05;2020-07-27;0;0;0;32.9601271090696;10.9909785719784;90;43.9511056810479
05;2020-07-27;0;0;0;3061.43020057959;2935.56979942041;0;5997
06;2020-07-27;0;0;0;42583;42380;09;84963
06;2020-07-27;0;0;0;33369;31925;19;65294
06;2020-07-27;2;1;3;21571;15080;29;36651
06;2020-07-27;1;0;1;21550;16147;39;37697
06;2020-07-27;1;2;3;14193;13939;49;28132
06;2020-07-27;1;3;4;7171;7597;59;14768
06;2020-07-27;1;0;1;3629;4117;69;7746
06;2020-07-27;1;0;1;1577;1457;79;3034
06;2020-07-27;0;0;0;531;474;89;1005
06;2020-07-27;0;0;0;88;93;90;181
06;2020-07-27;7;6;13;146262;133209;0;279471
07;2020-07-27;0;0;0;485;549;09;1034
07;2020-07-27;0;0;0;403;432;19;835
07;2020-07-27;0;0;0;764;841;29;1605
07;2020-07-27;0;0;0;824;928;39;1752
07;2020-07-27;0;0;0;788;1020;49;1808
07;2020-07-27;0;0;0;678;870;59;1548
07;2020-07-27;0;0;0;360;382;69;742
07;2020-07-27;0;0;0;231;190;79;421
07;2020-07-27;0;0;0;114;67;89;181
07;2020-07-27;0;0;0;24;11;90;35
07;2020-07-27;0;0;0;4671;5290;0;9961
08;2020-07-27;0;0;0;2715.22592983026;2997.75551488675;09;5712.98144471701
08;2020-07-27;0;0;0;2778.51901080978;3160.9156459093;19;5939.43465671908
08;2020-07-27;0;0;0;2080.8882988764;1718.16634315323;29;3799.05464202964
08;2020-07-27;0;0;0;2701.8582062647;1896.52641413317;39;4598.38462039786
08;2020-07-27;1;0;1;3151.45861023308;2460.52498233809;49;5611.98359257117
08;2020-07-27;0;0;0;2620.29868333099;2422.23566154656;59;5042.53434487755
08;2020-07-27;0;0;0;1621.44173420671;1438.58325779464;69;3060.02499200135
08;2020-07-27;0;0;0;626.575909335673;526.358467843651;79;1152.93437717932
08;2020-07-27;0;0;0;205.018522985054;140.993639349697;89;346.012162334751
08;2020-07-27;0;0;0;50.0325684687745;20.62259870351;90;70.6551671722846
08;2020-07-27;1;0;1;18551.3174743414;16782.6825256586;0;35334
11;2020-07-27;1;6;7;783071;811785;09;1594856
11;2020-07-27;25;14;39;761456;784653;19;1546109
11;2020-07-27;72;72;144;850145;801772;29;1651917
11;2020-07-27;49;55;104;914360;843488;39;1757848
11;2020-07-27;29;49;78;845609;826202;49;1671811
11;2020-07-27;41;22;63;793566;745070;59;1538636
11;2020-07-27;26;13;39;628649;549192;69;1177841
11;2020-07-27;9;6;15;434606;358356;79;792962
11;2020-07-27;3;5;8;261425;162933;89;424358
11;2020-07-27;2;2;4;89253;32619;90;121872
11;2020-07-27;257;244;502;6362140;5916070;0;12278210
24;2020-07-27;3;2;5;139720;144686;09;284406
24;2020-07-27;3;2;5;152979;161185;19;314164
24;2020-07-27;4;10;14;122237;126536;29;248773
24;2020-07-27;1;2;3;150359;142009;39;292368
24;2020-07-27;1;1;2;161829;158758;49;320587
24;2020-07-27;1;1;2;172552;168011;59;340563
24;2020-07-27;1;1;2;172509;158177;69;330686
24;2020-07-27;0;0;0;129428;110593;79;240021
24;2020-07-27;1;0;1;87342;56882;89;144224
24;2020-07-27;0;0;0;31210;12071;90;43281
24;2020-07-27;15;19;34;1320165;1238908;0;2559073
27;2020-07-27;1;1;2;143373;149679;09;293052
27;2020-07-27;1;3;4;160962;173003;19;333965
27;2020-07-27;2;0;2;133746;142254;29;276000
27;2020-07-27;2;1;3;160004;155407;39;315411
27;2020-07-27;3;3;6;172333;169564;49;341897
27;2020-07-27;1;2;3;189979;183788;59;373767
27;2020-07-27;1;1;2;192591;178206;69;370797
27;2020-07-27;3;0;3;146876;127546;79;274422
27;2020-07-27;2;1;3;96896;61575;89;158471
27;2020-07-27;0;0;0;33148;12109;90;45257
27;2020-07-27;16;12;28;1429908;1353131;0;2783039
28;2020-07-27;0;0;0;180735;186856;09;367591
28;2020-07-27;1;2;3;200125;213621;19;413746
28;2020-07-27;1;3;4;168922;173007;29;341929
28;2020-07-27;1;3;4;196628;188487;39;385115
28;2020-07-27;1;0;1;205396;201699;49;407095
28;2020-07-27;1;1;2;222002;213866;59;435868
28;2020-07-27;1;1;2;224688;203758;69;428446
28;2020-07-27;0;0;0;163192;135543;79;298735
28;2020-07-27;0;0;0;109691;65377;89;175068
28;2020-07-27;0;0;0;37222;12685;90;49907
28;2020-07-27;6;10;16;1708601;1594899;0;3303500
32;2020-07-27;8;6;14;358062;373689;09;731751
32;2020-07-27;9;9;18;387045;406742;19;793787
32;2020-07-27;7;10;17;342304;348587;29;690891
32;2020-07-27;15;13;28;382485;369972;39;752457
32;2020-07-27;11;4;15;382510;376716;49;759226
32;2020-07-27;4;7;11;386937;376527;59;763464
32;2020-07-27;11;6;17;371211;330938;69;702149
32;2020-07-27;8;3;11;250542;201459;79;452001
32;2020-07-27;6;4;10;163399;89786;89;253185
32;2020-07-27;3;0;3;48384;15367;90;63751
32;2020-07-27;82;62;144;3072879;2889783;0;5962662
44;2020-07-27;1;2;3;291525;306839;09;598364
44;2020-07-27;4;4;8;320255;339504;19;659759
44;2020-07-27;13;11;24;302020;314428;29;616448
44;2020-07-27;4;4;8;342222;333292;39;675514
44;2020-07-27;9;3;12;349727;344491;49;694218
44;2020-07-27;1;3;4;381371;373239;59;754610
44;2020-07-27;4;3;7;367165;335850;69;703015
44;2020-07-27;3;5;8;250387;215436;79;465823
44;2020-07-27;3;0;3;170825;105192;89;276017
44;2020-07-27;3;0;3;51248;16731;90;67979
44;2020-07-27;45;35;80;2826745;2685002;0;5511747
52;2020-07-27;3;2;6;213594;223900;09;437494
52;2020-07-27;8;7;15;240818;255197;19;496015
52;2020-07-27;9;13;22;197010;200630;29;397640
52;2020-07-27;5;4;9;231204;224885;39;456089
52;2020-07-27;5;3;8;243874;243418;49;487292
52;2020-07-27;4;2;6;244100;239116;59;483216
52;2020-07-27;2;1;3;241796;221345;69;463141
52;2020-07-27;3;2;5;177805;149903;79;327708
52;2020-07-27;1;3;4;119561;75822;89;195383
52;2020-07-27;0;1;1;42559;15260;90;57819
52;2020-07-27;40;38;79;1952321;1849476;0;3801797
53;2020-07-27;0;0;0;173813;182358;09;356171
53;2020-07-27;7;6;13;202720;214740;19;417460
53;2020-07-27;7;15;22;163116;173196;29;336312
53;2020-07-27;1;4;5;190526;187674;39;378200
53;2020-07-27;3;2;5;212098;212015;49;424113
53;2020-07-27;2;3;5;223699;219176;59;442875
53;2020-07-27;2;2;4;227435;209274;69;436709
53;2020-07-27;0;0;0;169992;140910;79;310902
53;2020-07-27;0;1;1;118117;69883;89;188000
53;2020-07-27;0;0;0;37370;12267;90;49637
53;2020-07-27;22;33;55;1718886;1621493;0;3340379
75;2020-07-27;2;0;2;293104;305291;09;598395
75;2020-07-27;4;0;4;337141;357785;19;694926
75;2020-07-27;5;5;10;295024;300618;29;595642
75;2020-07-27;2;4;6;347871;331233;39;679104
75;2020-07-27;2;1;3;384742;372771;49;757513
75;2020-07-27;1;1;2;413361;390880;59;804241
75;2020-07-27;3;1;4;425623;384060;69;809683
75;2020-07-27;0;0;0;325086;276298;79;601384
75;2020-07-27;0;1;1;213986;139308;89;353294
75;2020-07-27;0;0;0;77600;28200;90;105800
75;2020-07-27;19;13;32;3113538;2886444;0;5999982
76;2020-07-27;1;1;3;305956;318589;09;624545
76;2020-07-27;4;3;7;338942;356969;19;695911
76;2020-07-27;5;7;12;316210;319570;29;635780
76;2020-07-27;7;5;12;356758;337587;39;694345
76;2020-07-27;3;4;7;376541;363812;49;740353
76;2020-07-27;8;5;13;402608;383750;59;786358
76;2020-07-27;5;2;7;394889;358997;69;753886
76;2020-07-27;4;0;4;308664;263806;79;572470
76;2020-07-27;2;0;2;195838;129272;89;325110
76;2020-07-27;1;0;1;69372;26728;90;96100
76;2020-07-27;40;28;69;3065778;2859080;0;5924858
84;2020-07-27;2;5;7;459549;481088;09;940637
84;2020-07-27;4;12;16;487711;511905;19;999616
84;2020-07-27;12;16;28;443824;451094;29;894918
84;2020-07-27;14;13;27;512522;493262;39;1005784
84;2020-07-27;10;10;20;520248;515106;49;1035354
84;2020-07-27;7;8;15;529611;514848;59;1044459
84;2020-07-27;4;5;9;486720;439940;69;926660
84;2020-07-27;3;1;4;372151;315211;79;687362
84;2020-07-27;3;1;4;237198;150524;89;387722
84;2020-07-27;1;0;1;81185;28680;90;109865
84;2020-07-27;60;71;131;4130719;3901658;0;8032377
93;2020-07-27;4;3;7;268834;283093;09;551927
93;2020-07-27;8;4;12;280751;296087;19;576838
93;2020-07-27;12;14;26;254404;255552;29;509956
93;2020-07-27;9;10;19;310704;288398;39;599102
93;2020-07-27;16;10;26;325559;305827;49;631386
93;2020-07-27;11;6;17;353104;325389;59;678493
93;2020-07-27;4;5;9;336327;296459;69;632786
93;2020-07-27;3;3;6;279820;229699;79;509519
93;2020-07-27;2;1;3;171274;113716;89;284990
93;2020-07-27;1;0;1;58896;21758;90;80654
93;2020-07-27;70;56;126;2639673;2415978;0;5055651
94;2020-07-27;0;0;0;16311;17433;09;33744
94;2020-07-27;0;0;0;16679;18132;19;34811
94;2020-07-27;0;0;0;16782;16579;29;33361
94;2020-07-27;0;0;0;23044;20580;39;43624
94;2020-07-27;0;0;0;23065;22140;49;45205
94;2020-07-27;0;0;0;24549;23421;59;47970
94;2020-07-27;0;0;0;23212;21883;69;45095
94;2020-07-27;0;1;1;19544;17141;79;36685
94;2020-07-27;0;0;0;11227;8178;89;19405
94;2020-07-27;0;0;0;3332;1447;90;4779
94;2020-07-27;0;1;1;177745;166934;0;344679
01;2020-07-28;0;0;0;19979;20155;09;40134
01;2020-07-28;2;2;4;24994;25489;19;50483
01;2020-07-28;5;6;11;17868;16690;29;34558
01;2020-07-28;1;1;2;22328;14821;39;37149
01;2020-07-28;0;1;1;28652;20276;49;48928
01;2020-07-28;2;0;2;33264;27260;59;60524
01;2020-07-28;1;0;1;27135;23978;69;51113
01;2020-07-28;0;0;0;18401;14661;79;33062
01;2020-07-28;0;0;0;9633;6375;89;16008
01;2020-07-28;0;0;0;3410;1510;90;4920
01;2020-07-28;11;10;21;205664;171215;0;376879
02;2020-07-28;0;0;0;16881;17110;09;33991
02;2020-07-28;0;1;1;21410;21604;19;43014
02;2020-07-28;0;0;0;16017;15479;29;31496
02;2020-07-28;1;0;1;19825;14455;39;34280
02;2020-07-28;0;0;0;24719;18248;49;42967
02;2020-07-28;0;0;0;34361;28310;59;62671
02;2020-07-28;0;0;0;28061;24495;69;52556
02;2020-07-28;0;0;0;18231;15278;79;33509
02;2020-07-28;0;0;0;11090;7677;89;18767
02;2020-07-28;0;0;0;3992;1506;90;5498
02;2020-07-28;1;1;2;194587;164162;0;358749
03;2020-07-28;3;7;11;31123;30920;09;62043
03;2020-07-28;6;3;9;29370;29268;19;58638
03;2020-07-28;7;8;15;21458;18963;29;40421
03;2020-07-28;9;8;18;21276;18326;39;39602
03;2020-07-28;6;6;12;18164;16593;49;34757
03;2020-07-28;3;7;10;13469;13557;59;27026
03;2020-07-28;0;1;1;8776;8670;69;17446
03;2020-07-28;1;0;1;3777;3591;79;7368
03;2020-07-28;0;0;0;1649;1072;89;2721
03;2020-07-28;0;0;0;485;184;90;669
03;2020-07-28;35;41;78;149547;141144;0;290691
04;2020-07-28;0;0;0;60314;61377;09;121691
04;2020-07-28;0;0;0;66065;68387;19;134452
04;2020-07-28;1;0;1;51059;47156;29;98215
04;2020-07-28;1;0;1;58788;45780;39;104568
04;2020-07-28;0;0;0;61408;52207;49;113615
04;2020-07-28;1;0;1;64838;60759;59;125597
04;2020-07-28;0;0;0;47008;42843;69;89851
04;2020-07-28;0;0;0;25509;21184;79;46693
04;2020-07-28;0;0;0;13168;7647;89;20815
04;2020-07-28;0;0;0;3209;1253;90;4462
04;2020-07-28;3;0;3;451366;408593;0;859959
05;2020-07-28;0;0;0;362.366008612902;341.338819562748;09;703.704828175651
05;2020-07-28;0;0;0;353.376145114279;370.349735405642;19;723.725880519921
05;2020-07-28;0;0;0;218.593559489256;256.539602589476;29;475.133162078732
05;2020-07-28;0;0;0;404.225408693299;360.321910454353;39;764.547319147651
05;2020-07-28;0;0;0;520.067953604221;497.108383964256;49;1017.17633756848
05;2020-07-28;0;0;0;468.146063921917;510.087601910415;59;978.233665832332
05;2020-07-28;0;0;0;340.368470050554;334.366842191253;69;674.735312241807
05;2020-07-28;0;0;0;212.598666888387;192.597753227106;79;405.196420115493
05;2020-07-28;0;0;0;148.727797095705;61.8681715431829;89;210.595968638888
05;2020-07-28;0;0;0;32.9601271090696;10.9909785719784;90;43.9511056810479
05;2020-07-28;0;0;0;3061.43020057959;2935.56979942041;0;5997
06;2020-07-28;0;0;0;42583;42380;09;84963
06;2020-07-28;3;1;4;33369;31925;19;65294
06;2020-07-28;5;2;7;21571;15080;29;36651
06;2020-07-28;3;1;4;21550;16147;39;37697
06;2020-07-28;1;3;4;14193;13939;49;28132
06;2020-07-28;2;3;5;7171;7597;59;14768
06;2020-07-28;0;0;0;3629;4117;69;7746
06;2020-07-28;0;1;1;1577;1457;79;3034
06;2020-07-28;0;0;0;531;474;89;1005
06;2020-07-28;0;0;0;88;93;90;181
06;2020-07-28;14;11;25;146262;133209;0;279471
07;2020-07-28;0;0;0;485;549;09;1034
07;2020-07-28;0;0;0;403;432;19;835
07;2020-07-28;0;0;0;764;841;29;1605
07;2020-07-28;0;0;0;824;928;39;1752
07;2020-07-28;0;0;0;788;1020;49;1808
07;2020-07-28;0;0;0;678;870;59;1548
07;2020-07-28;0;0;0;360;382;69;742
07;2020-07-28;0;0;0;231;190;79;421
07;2020-07-28;0;0;0;114;67;89;181
07;2020-07-28;0;0;0;24;11;90;35
07;2020-07-28;0;0;0;4671;5290;0;9961
08;2020-07-28;0;0;0;2715.22592983026;2997.75551488675;09;5712.98144471701
08;2020-07-28;0;0;0;2778.51901080978;3160.9156459093;19;5939.43465671908
08;2020-07-28;0;0;0;2080.8882988764;1718.16634315323;29;3799.05464202964
08;2020-07-28;0;1;1;2701.8582062647;1896.52641413317;39;4598.38462039786
08;2020-07-28;0;0;0;3151.45861023308;2460.52498233809;49;5611.98359257117
08;2020-07-28;1;0;1;2620.29868333099;2422.23566154656;59;5042.53434487755
08;2020-07-28;0;0;0;1621.44173420671;1438.58325779464;69;3060.02499200135
08;2020-07-28;0;0;0;626.575909335673;526.358467843651;79;1152.93437717932
08;2020-07-28;0;0;0;205.018522985054;140.993639349697;89;346.012162334751
08;2020-07-28;0;0;0;50.0325684687745;20.62259870351;90;70.6551671722846
08;2020-07-28;1;1;2;18551.3174743414;16782.6825256586;0;35334
11;2020-07-28;9;11;20;783071;811785;09;1594856
11;2020-07-28;14;20;36;761456;784653;19;1546109
11;2020-07-28;78;60;138;850145;801772;29;1651917
11;2020-07-28;54;48;102;914360;843488;39;1757848
11;2020-07-28;33;32;65;845609;826202;49;1671811
11;2020-07-28;29;26;55;793566;745070;59;1538636
11;2020-07-28;28;20;48;628649;549192;69;1177841
11;2020-07-28;7;12;19;434606;358356;79;792962
11;2020-07-28;4;4;8;261425;162933;89;424358
11;2020-07-28;4;1;5;89253;32619;90;121872
11;2020-07-28;260;235;503;6362140;5916070;0;12278210
24;2020-07-28;1;0;1;139720;144686;09;284406
24;2020-07-28;2;1;3;152979;161185;19;314164
24;2020-07-28;3;5;8;122237;126536;29;248773
24;2020-07-28;5;4;9;150359;142009;39;292368
24;2020-07-28;1;0;1;161829;158758;49;320587
24;2020-07-28;4;1;5;172552;168011;59;340563
24;2020-07-28;2;3;5;172509;158177;69;330686
24;2020-07-28;0;2;2;129428;110593;79;240021
24;2020-07-28;0;1;1;87342;56882;89;144224
24;2020-07-28;1;0;1;31210;12071;90;43281
24;2020-07-28;19;17;36;1320165;1238908;0;2559073
27;2020-07-28;0;0;0;143373;149679;09;293052
27;2020-07-28;1;0;1;160962;173003;19;333965
27;2020-07-28;1;2;3;133746;142254;29;276000
27;2020-07-28;0;0;0;160004;155407;39;315411
27;2020-07-28;1;0;1;172333;169564;49;341897
27;2020-07-28;2;1;3;189979;183788;59;373767
27;2020-07-28;1;1;2;192591;178206;69;370797
27;2020-07-28;0;1;1;146876;127546;79;274422
27;2020-07-28;1;0;1;96896;61575;89;158471
27;2020-07-28;0;0;0;33148;12109;90;45257
27;2020-07-28;7;5;12;1429908;1353131;0;2783039
28;2020-07-28;0;0;1;180735;186856;09;367591
28;2020-07-28;1;0;1;200125;213621;19;413746
28;2020-07-28;2;5;7;168922;173007;29;341929
28;2020-07-28;3;1;4;196628;188487;39;385115
28;2020-07-28;0;1;1;205396;201699;49;407095
28;2020-07-28;1;1;2;222002;213866;59;435868
28;2020-07-28;2;0;2;224688;203758;69;428446
28;2020-07-28;0;1;1;163192;135543;79;298735
28;2020-07-28;0;0;0;109691;65377;89;175068
28;2020-07-28;0;0;0;37222;12685;90;49907
28;2020-07-28;9;9;19;1708601;1594899;0;3303500
32;2020-07-28;3;4;7;358062;373689;09;731751
32;2020-07-28;7;4;11;387045;406742;19;793787
32;2020-07-28;10;18;28;342304;348587;29;690891
32;2020-07-28;8;9;17;382485;369972;39;752457
32;2020-07-28;8;7;15;382510;376716;49;759226
32;2020-07-28;5;5;10;386937;376527;59;763464
32;2020-07-28;5;4;9;371211;330938;69;702149
32;2020-07-28;2;3;5;250542;201459;79;452001
32;2020-07-28;3;4;7;163399;89786;89;253185
32;2020-07-28;1;0;1;48384;15367;90;63751
32;2020-07-28;52;58;110;3072879;2889783;0;5962662
44;2020-07-28;3;0;3;291525;306839;09;598364
44;2020-07-28;3;2;5;320255;339504;19;659759
44;2020-07-28;8;8;16;302020;314428;29;616448
44;2020-07-28;4;9;13;342222;333292;39;675514
44;2020-07-28;5;6;11;349727;344491;49;694218
44;2020-07-28;2;3;5;381371;373239;59;754610
44;2020-07-28;3;5;8;367165;335850;69;703015
44;2020-07-28;3;1;4;250387;215436;79;465823
44;2020-07-28;3;1;4;170825;105192;89;276017
44;2020-07-28;1;1;2;51248;16731;90;67979
44;2020-07-28;35;36;71;2826745;2685002;0;5511747
52;2020-07-28;2;0;2;213594;223900;09;437494
52;2020-07-28;5;7;12;240818;255197;19;496015
52;2020-07-28;9;16;25;197010;200630;29;397640
52;2020-07-28;7;4;11;231204;224885;39;456089
52;2020-07-28;11;3;14;243874;243418;49;487292
52;2020-07-28;5;4;9;244100;239116;59;483216
52;2020-07-28;4;0;4;241796;221345;69;463141
52;2020-07-28;5;2;7;177805;149903;79;327708
52;2020-07-28;2;3;5;119561;75822;89;195383
52;2020-07-28;1;0;1;42559;15260;90;57819
52;2020-07-28;51;39;90;1952321;1849476;0;3801797
53;2020-07-28;1;1;2;173813;182358;09;356171
53;2020-07-28;9;5;14;202720;214740;19;417460
53;2020-07-28;8;15;23;163116;173196;29;336312
53;2020-07-28;9;5;14;190526;187674;39;378200
53;2020-07-28;4;5;9;212098;212015;49;424113
53;2020-07-28;3;2;5;223699;219176;59;442875
53;2020-07-28;3;3;6;227435;209274;69;436709
53;2020-07-28;0;0;0;169992;140910;79;310902
53;2020-07-28;0;0;0;118117;69883;89;188000
53;2020-07-28;0;0;0;37370;12267;90;49637
53;2020-07-28;37;36;73;1718886;1621493;0;3340379
75;2020-07-28;0;0;0;293104;305291;09;598395
75;2020-07-28;3;1;4;337141;357785;19;694926
75;2020-07-28;3;3;6;295024;300618;29;595642
75;2020-07-28;1;3;4;347871;331233;39;679104
75;2020-07-28;1;0;1;384742;372771;49;757513
75;2020-07-28;0;1;1;413361;390880;59;804241
75;2020-07-28;0;4;4;425623;384060;69;809683
75;2020-07-28;0;0;0;325086;276298;79;601384
75;2020-07-28;0;1;1;213986;139308;89;353294
75;2020-07-28;2;0;2;77600;28200;90;105800
75;2020-07-28;10;13;23;3113538;2886444;0;5999982
76;2020-07-28;0;3;3;305956;318589;09;624545
76;2020-07-28;0;1;1;338942;356969;19;695911
76;2020-07-28;18;14;32;316210;319570;29;635780
76;2020-07-28;8;11;19;356758;337587;39;694345
76;2020-07-28;6;2;8;376541;363812;49;740353
76;2020-07-28;3;3;6;402608;383750;59;786358
76;2020-07-28;1;4;5;394889;358997;69;753886
76;2020-07-28;2;4;6;308664;263806;79;572470
76;2020-07-28;0;2;2;195838;129272;89;325110
76;2020-07-28;0;1;1;69372;26728;90;96100
76;2020-07-28;38;45;83;3065778;2859080;0;5924858
84;2020-07-28;2;5;7;459549;481088;09;940637
84;2020-07-28;6;3;9;487711;511905;19;999616
84;2020-07-28;15;14;29;443824;451094;29;894918
84;2020-07-28;10;9;19;512522;493262;39;1005784
84;2020-07-28;5;6;11;520248;515106;49;1035354
84;2020-07-28;8;3;11;529611;514848;59;1044459
84;2020-07-28;4;4;8;486720;439940;69;926660
84;2020-07-28;4;4;8;372151;315211;79;687362
84;2020-07-28;1;0;1;237198;150524;89;387722
84;2020-07-28;0;0;0;81185;28680;90;109865
84;2020-07-28;55;48;103;4130719;3901658;0;8032377
93;2020-07-28;1;1;2;268834;283093;09;551927
93;2020-07-28;7;10;17;280751;296087;19;576838
93;2020-07-28;15;15;30;254404;255552;29;509956
93;2020-07-28;6;4;10;310704;288398;39;599102
93;2020-07-28;4;10;14;325559;305827;49;631386
93;2020-07-28;10;7;17;353104;325389;59;678493
93;2020-07-28;4;2;6;336327;296459;69;632786
93;2020-07-28;2;1;3;279820;229699;79;509519
93;2020-07-28;6;1;7;171274;113716;89;284990
93;2020-07-28;2;0;2;58896;21758;90;80654
93;2020-07-28;57;51;108;2639673;2415978;0;5055651
94;2020-07-28;0;0;0;16311;17433;09;33744
94;2020-07-28;0;0;0;16679;18132;19;34811
94;2020-07-28;0;0;0;16782;16579;29;33361
94;2020-07-28;0;0;0;23044;20580;39;43624
94;2020-07-28;1;0;1;23065;22140;49;45205
94;2020-07-28;0;0;0;24549;23421;59;47970
94;2020-07-28;0;0;0;23212;21883;69;45095
94;2020-07-28;0;0;0;19544;17141;79;36685
94;2020-07-28;0;0;0;11227;8178;89;19405
94;2020-07-28;0;0;0;3332;1447;90;4779
94;2020-07-28;1;0;1;177745;166934;0;344679
01;2020-07-29;0;0;0;19979;20155;09;40134
01;2020-07-29;0;0;0;24994;25489;19;50483
01;2020-07-29;2;0;2;17868;16690;29;34558
01;2020-07-29;0;0;0;22328;14821;39;37149
01;2020-07-29;0;0;0;28652;20276;49;48928
01;2020-07-29;0;0;0;33264;27260;59;60524
01;2020-07-29;0;0;0;27135;23978;69;51113
01;2020-07-29;0;0;0;18401;14661;79;33062
01;2020-07-29;0;0;0;9633;6375;89;16008
01;2020-07-29;0;0;0;3410;1510;90;4920
01;2020-07-29;2;0;2;205664;171215;0;376879
02;2020-07-29;0;0;0;16881;17110;09;33991
02;2020-07-29;0;0;0;21410;21604;19;43014
02;2020-07-29;0;0;0;16017;15479;29;31496
02;2020-07-29;1;0;1;19825;14455;39;34280
02;2020-07-29;0;0;0;24719;18248;49;42967
02;2020-07-29;0;0;0;34361;28310;59;62671
02;2020-07-29;1;0;1;28061;24495;69;52556
02;2020-07-29;0;0;0;18231;15278;79;33509
02;2020-07-29;0;0;0;11090;7677;89;18767
02;2020-07-29;0;0;0;3992;1506;90;5498
02;2020-07-29;2;0;2;194587;164162;0;358749
03;2020-07-29;3;3;6;31123;30920;09;62043
03;2020-07-29;1;11;16;29370;29268;19;58638
03;2020-07-29;9;10;20;21458;18963;29;40421
03;2020-07-29;7;13;20;21276;18326;39;39602
03;2020-07-29;10;3;14;18164;16593;49;34757
03;2020-07-29;5;6;11;13469;13557;59;27026
03;2020-07-29;1;5;6;8776;8670;69;17446
03;2020-07-29;1;1;2;3777;3591;79;7368
03;2020-07-29;1;0;1;1649;1072;89;2721
03;2020-07-29;0;0;0;485;184;90;669
03;2020-07-29;38;52;96;149547;141144;0;290691
04;2020-07-29;0;0;0;60314;61377;09;121691
04;2020-07-29;0;0;0;66065;68387;19;134452
04;2020-07-29;1;0;1;51059;47156;29;98215
04;2020-07-29;0;0;0;58788;45780;39;104568
04;2020-07-29;0;0;0;61408;52207;49;113615
04;2020-07-29;0;0;0;64838;60759;59;125597
04;2020-07-29;0;0;0;47008;42843;69;89851
04;2020-07-29;0;0;0;25509;21184;79;46693
04;2020-07-29;0;0;0;13168;7647;89;20815
04;2020-07-29;0;0;0;3209;1253;90;4462
04;2020-07-29;1;0;1;451366;408593;0;859959
05;2020-07-29;0;0;0;362.366008612902;341.338819562748;09;703.704828175651
05;2020-07-29;0;0;0;353.376145114279;370.349735405642;19;723.725880519921
05;2020-07-29;0;0;0;218.593559489256;256.539602589476;29;475.133162078732
05;2020-07-29;0;0;0;404.225408693299;360.321910454353;39;764.547319147651
05;2020-07-29;0;0;0;520.067953604221;497.108383964256;49;1017.17633756848
05;2020-07-29;0;0;0;468.146063921917;510.087601910415;59;978.233665832332
05;2020-07-29;0;0;0;340.368470050554;334.366842191253;69;674.735312241807
05;2020-07-29;0;0;0;212.598666888387;192.597753227106;79;405.196420115493
05;2020-07-29;0;0;0;148.727797095705;61.8681715431829;89;210.595968638888
05;2020-07-29;0;0;0;32.9601271090696;10.9909785719784;90;43.9511056810479
05;2020-07-29;0;0;0;3061.43020057959;2935.56979942041;0;5997
06;2020-07-29;1;0;1;42583;42380;09;84963
06;2020-07-29;1;1;2;33369;31925;19;65294
06;2020-07-29;0;3;3;21571;15080;29;36651
06;2020-07-29;3;0;3;21550;16147;39;37697
06;2020-07-29;2;1;3;14193;13939;49;28132
06;2020-07-29;0;1;1;7171;7597;59;14768
06;2020-07-29;0;0;0;3629;4117;69;7746
06;2020-07-29;0;0;0;1577;1457;79;3034
06;2020-07-29;0;0;0;531;474;89;1005
06;2020-07-29;0;0;0;88;93;90;181
06;2020-07-29;7;6;13;146262;133209;0;279471
07;2020-07-29;0;0;0;485;549;09;1034
07;2020-07-29;0;0;0;403;432;19;835
07;2020-07-29;0;0;0;764;841;29;1605
07;2020-07-29;0;0;0;824;928;39;1752
07;2020-07-29;0;0;0;788;1020;49;1808
07;2020-07-29;0;0;0;678;870;59;1548
07;2020-07-29;0;0;0;360;382;69;742
07;2020-07-29;0;0;0;231;190;79;421
07;2020-07-29;0;0;0;114;67;89;181
07;2020-07-29;0;0;0;24;11;90;35
07;2020-07-29;0;0;0;4671;5290;0;9961
08;2020-07-29;0;0;0;2715.22592983026;2997.75551488675;09;5712.98144471701
08;2020-07-29;0;0;0;2778.51901080978;3160.9156459093;19;5939.43465671908
08;2020-07-29;0;0;0;2080.8882988764;1718.16634315323;29;3799.05464202964
08;2020-07-29;0;0;0;2701.8582062647;1896.52641413317;39;4598.38462039786
08;2020-07-29;0;0;0;3151.45861023308;2460.52498233809;49;5611.98359257117
08;2020-07-29;0;0;0;2620.29868333099;2422.23566154656;59;5042.53434487755
08;2020-07-29;0;0;0;1621.44173420671;1438.58325779464;69;3060.02499200135
08;2020-07-29;0;0;0;626.575909335673;526.358467843651;79;1152.93437717932
08;2020-07-29;0;0;0;205.018522985054;140.993639349697;89;346.012162334751
08;2020-07-29;0;0;0;50.0325684687745;20.62259870351;90;70.6551671722846
08;2020-07-29;0;0;0;18551.3174743414;16782.6825256586;0;35334
11;2020-07-29;9;10;19;783071;811785;09;1594856
11;2020-07-29;16;24;41;761456;784653;19;1546109
11;2020-07-29;92;72;164;850145;801772;29;1651917
11;2020-07-29;56;62;118;914360;843488;39;1757848
11;2020-07-29;41;40;81;845609;826202;49;1671811
11;2020-07-29;32;31;63;793566;745070;59;1538636
11;2020-07-29;31;20;51;628649;549192;69;1177841
11;2020-07-29;14;14;28;434606;358356;79;792962
11;2020-07-29;9;1;10;261425;162933;89;424358
11;2020-07-29;6;0;6;89253;32619;90;121872
11;2020-07-29;306;275;585;6362140;5916070;0;12278210
24;2020-07-29;0;0;0;139720;144686;09;284406
24;2020-07-29;2;0;2;152979;161185;19;314164
24;2020-07-29;1;9;10;122237;126536;29;248773
24;2020-07-29;3;0;3;150359;142009;39;292368
24;2020-07-29;1;3;4;161829;158758;49;320587
24;2020-07-29;4;0;4;172552;168011;59;340563
24;2020-07-29;0;1;1;172509;158177;69;330686
24;2020-07-29;1;0;1;129428;110593;79;240021
24;2020-07-29;0;0;0;87342;56882;89;144224
24;2020-07-29;0;0;0;31210;12071;90;43281
24;2020-07-29;12;13;25;1320165;1238908;0;2559073
27;2020-07-29;0;1;1;143373;149679;09;293052
27;2020-07-29;0;1;1;160962;173003;19;333965
27;2020-07-29;2;3;5;133746;142254;29;276000
27;2020-07-29;1;1;2;160004;155407;39;315411
27;2020-07-29;1;1;2;172333;169564;49;341897
27;2020-07-29;0;6;6;189979;183788;59;373767
27;2020-07-29;1;0;1;192591;178206;69;370797
27;2020-07-29;0;0;0;146876;127546;79;274422
27;2020-07-29;1;0;1;96896;61575;89;158471
27;2020-07-29;0;0;0;33148;12109;90;45257
27;2020-07-29;6;13;19;1429908;1353131;0;2783039
28;2020-07-29;0;0;0;180735;186856;09;367591
28;2020-07-29;1;4;5;200125;213621;19;413746
28;2020-07-29;2;4;6;168922;173007;29;341929
28;2020-07-29;1;0;1;196628;188487;39;385115
28;2020-07-29;1;0;1;205396;201699;49;407095
28;2020-07-29;3;2;5;222002;213866;59;435868
28;2020-07-29;1;1;2;224688;203758;69;428446
28;2020-07-29;1;1;2;163192;135543;79;298735
28;2020-07-29;0;0;0;109691;65377;89;175068
28;2020-07-29;0;0;0;37222;12685;90;49907
28;2020-07-29;11;12;23;1708601;1594899;0;3303500
32;2020-07-29;4;1;5;358062;373689;09;731751
32;2020-07-29;13;8;21;387045;406742;19;793787
32;2020-07-29;8;15;23;342304;348587;29;690891
32;2020-07-29;9;12;21;382485;369972;39;752457
32;2020-07-29;9;10;19;382510;376716;49;759226
32;2020-07-29;5;12;17;386937;376527;59;763464
32;2020-07-29;6;6;12;371211;330938;69;702149
32;2020-07-29;7;6;13;250542;201459;79;452001
32;2020-07-29;4;1;5;163399;89786;89;253185
32;2020-07-29;0;0;0;48384;15367;90;63751
32;2020-07-29;65;71;136;3072879;2889783;0;5962662
44;2020-07-29;0;1;2;291525;306839;09;598364
44;2020-07-29;3;3;8;320255;339504;19;659759
44;2020-07-29;4;7;11;302020;314428;29;616448
44;2020-07-29;5;5;10;342222;333292;39;675514
44;2020-07-29;3;2;5;349727;344491;49;694218
44;2020-07-29;6;7;13;381371;373239;59;754610
44;2020-07-29;3;1;4;367165;335850;69;703015
44;2020-07-29;1;0;1;250387;215436;79;465823
44;2020-07-29;2;0;2;170825;105192;89;276017
44;2020-07-29;1;0;1;51248;16731;90;67979
44;2020-07-29;28;26;57;2826745;2685002;0;5511747
52;2020-07-29;0;0;0;213594;223900;09;437494
52;2020-07-29;5;8;13;240818;255197;19;496015
52;2020-07-29;11;7;18;197010;200630;29;397640
52;2020-07-29;6;1;7;231204;224885;39;456089
52;2020-07-29;6;4;10;243874;243418;49;487292
52;2020-07-29;8;6;14;244100;239116;59;483216
52;2020-07-29;2;1;3;241796;221345;69;463141
52;2020-07-29;1;3;4;177805;149903;79;327708
52;2020-07-29;0;5;5;119561;75822;89;195383
52;2020-07-29;2;0;2;42559;15260;90;57819
52;2020-07-29;41;35;76;1952321;1849476;0;3801797
53;2020-07-29;0;0;0;173813;182358;09;356171
53;2020-07-29;2;1;3;202720;214740;19;417460
53;2020-07-29;3;10;13;163116;173196;29;336312
53;2020-07-29;0;2;2;190526;187674;39;378200
53;2020-07-29;4;1;5;212098;212015;49;424113
53;2020-07-29;2;4;6;223699;219176;59;442875
53;2020-07-29;1;2;3;227435;209274;69;436709
53;2020-07-29;2;0;2;169992;140910;79;310902
53;2020-07-29;0;1;1;118117;69883;89;188000
53;2020-07-29;0;1;1;37370;12267;90;49637
53;2020-07-29;14;22;36;1718886;1621493;0;3340379
75;2020-07-29;0;0;0;293104;305291;09;598395
75;2020-07-29;1;1;2;337141;357785;19;694926
75;2020-07-29;4;4;8;295024;300618;29;595642
75;2020-07-29;3;0;3;347871;331233;39;679104
75;2020-07-29;0;4;4;384742;372771;49;757513
75;2020-07-29;2;1;3;413361;390880;59;804241
75;2020-07-29;1;3;4;425623;384060;69;809683
75;2020-07-29;0;1;1;325086;276298;79;601384
75;2020-07-29;0;0;0;213986;139308;89;353294
75;2020-07-29;0;0;0;77600;28200;90;105800
75;2020-07-29;11;14;25;3113538;2886444;0;5999982
76;2020-07-29;0;2;2;305956;318589;09;624545
76;2020-07-29;11;8;19;338942;356969;19;695911
76;2020-07-29;14;13;27;316210;319570;29;635780
76;2020-07-29;3;6;9;356758;337587;39;694345
76;2020-07-29;6;11;17;376541;363812;49;740353
76;2020-07-29;7;4;11;402608;383750;59;786358
76;2020-07-29;1;2;3;394889;358997;69;753886
76;2020-07-29;3;1;4;308664;263806;79;572470
76;2020-07-29;4;4;8;195838;129272;89;325110
76;2020-07-29;1;0;1;69372;26728;90;96100
76;2020-07-29;50;51;101;3065778;2859080;0;5924858
84;2020-07-29;3;5;8;459549;481088;09;940637
84;2020-07-29;10;10;20;487711;511905;19;999616
84;2020-07-29;17;10;27;443824;451094;29;894918
84;2020-07-29;18;14;32;512522;493262;39;1005784
84;2020-07-29;7;4;11;520248;515106;49;1035354
84;2020-07-29;5;10;15;529611;514848;59;1044459
84;2020-07-29;5;3;8;486720;439940;69;926660
84;2020-07-29;3;2;5;372151;315211;79;687362
84;2020-07-29;1;0;1;237198;150524;89;387722
84;2020-07-29;0;0;0;81185;28680;90;109865
84;2020-07-29;69;59;128;4130719;3901658;0;8032377
93;2020-07-29;2;0;2;268834;283093;09;551927
93;2020-07-29;11;12;23;280751;296087;19;576838
93;2020-07-29;26;23;49;254404;255552;29;509956
93;2020-07-29;10;13;23;310704;288398;39;599102
93;2020-07-29;6;5;11;325559;305827;49;631386
93;2020-07-29;7;6;13;353104;325389;59;678493
93;2020-07-29;9;2;11;336327;296459;69;632786
93;2020-07-29;2;5;7;279820;229699;79;509519
93;2020-07-29;3;1;4;171274;113716;89;284990
93;2020-07-29;0;2;2;58896;21758;90;80654
93;2020-07-29;76;69;145;2639673;2415978;0;5055651
94;2020-07-29;0;0;0;16311;17433;09;33744
94;2020-07-29;0;1;1;16679;18132;19;34811
94;2020-07-29;0;0;0;16782;16579;29;33361
94;2020-07-29;0;0;0;23044;20580;39;43624
94;2020-07-29;0;0;0;23065;22140;49;45205
94;2020-07-29;0;0;0;24549;23421;59;47970
94;2020-07-29;0;0;0;23212;21883;69;45095
94;2020-07-29;0;0;0;19544;17141;79;36685
94;2020-07-29;0;0;0;11227;8178;89;19405
94;2020-07-29;0;0;0;3332;1447;90;4779
94;2020-07-29;0;1;1;177745;166934;0;344679
01;2020-07-30;0;0;0;19979;20155;09;40134
01;2020-07-30;0;0;0;24994;25489;19;50483
01;2020-07-30;1;0;1;17868;16690;29;34558
01;2020-07-30;0;0;0;22328;14821;39;37149
01;2020-07-30;0;1;1;28652;20276;49;48928
01;2020-07-30;0;0;0;33264;27260;59;60524
01;2020-07-30;0;0;0;27135;23978;69;51113
01;2020-07-30;0;0;0;18401;14661;79;33062
01;2020-07-30;0;0;0;9633;6375;89;16008
01;2020-07-30;0;0;0;3410;1510;90;4920
01;2020-07-30;1;1;2;205664;171215;0;376879
02;2020-07-30;0;0;0;16881;17110;09;33991
02;2020-07-30;0;0;0;21410;21604;19;43014
02;2020-07-30;0;0;0;16017;15479;29;31496
02;2020-07-30;1;0;1;19825;14455;39;34280
02;2020-07-30;0;0;0;24719;18248;49;42967
02;2020-07-30;1;1;2;34361;28310;59;62671
02;2020-07-30;1;0;1;28061;24495;69;52556
02;2020-07-30;0;0;0;18231;15278;79;33509
02;2020-07-30;0;0;0;11090;7677;89;18767
02;2020-07-30;0;0;0;3992;1506;90;5498
02;2020-07-30;3;1;4;194587;164162;0;358749
03;2020-07-30;2;1;3;31123;30920;09;62043
03;2020-07-30;10;3;13;29370;29268;19;58638
03;2020-07-30;10;5;15;21458;18963;29;40421
03;2020-07-30;5;5;10;21276;18326;39;39602
03;2020-07-30;5;5;11;18164;16593;49;34757
03;2020-07-30;2;3;5;13469;13557;59;27026
03;2020-07-30;3;0;3;8776;8670;69;17446
03;2020-07-30;2;1;3;3777;3591;79;7368
03;2020-07-30;0;1;1;1649;1072;89;2721
03;2020-07-30;0;0;0;485;184;90;669
03;2020-07-30;39;24;64;149547;141144;0;290691
04;2020-07-30;0;0;0;60314;61377;09;121691
04;2020-07-30;1;1;2;66065;68387;19;134452
04;2020-07-30;1;1;2;51059;47156;29;98215
04;2020-07-30;2;1;3;58788;45780;39;104568
04;2020-07-30;1;1;2;61408;52207;49;113615
04;2020-07-30;0;1;1;64838;60759;59;125597
04;2020-07-30;0;0;0;47008;42843;69;89851
04;2020-07-30;0;0;0;25509;21184;79;46693
04;2020-07-30;0;0;0;13168;7647;89;20815
04;2020-07-30;0;0;0;3209;1253;90;4462
04;2020-07-30;5;5;10;451366;408593;0;859959
05;2020-07-30;0;0;0;362.366008612902;341.338819562748;09;703.704828175651
05;2020-07-30;0;0;0;353.376145114279;370.349735405642;19;723.725880519921
05;2020-07-30;0;0;0;218.593559489256;256.539602589476;29;475.133162078732
05;2020-07-30;0;0;0;404.225408693299;360.321910454353;39;764.547319147651
05;2020-07-30;0;0;0;520.067953604221;497.108383964256;49;1017.17633756848
05;2020-07-30;0;0;0;468.146063921917;510.087601910415;59;978.233665832332
05;2020-07-30;0;0;0;340.368470050554;334.366842191253;69;674.735312241807
05;2020-07-30;0;0;0;212.598666888387;192.597753227106;79;405.196420115493
05;2020-07-30;0;0;0;148.727797095705;61.8681715431829;89;210.595968638888
05;2020-07-30;0;0;0;32.9601271090696;10.9909785719784;90;43.9511056810479
05;2020-07-30;0;0;0;3061.43020057959;2935.56979942041;0;5997
06;2020-07-30;0;1;1;42583;42380;09;84963
06;2020-07-30;3;0;3;33369;31925;19;65294
06;2020-07-30;0;2;2;21571;15080;29;36651
06;2020-07-30;0;2;2;21550;16147;39;37697
06;2020-07-30;0;2;2;14193;13939;49;28132
06;2020-07-30;0;2;2;7171;7597;59;14768
06;2020-07-30;1;0;1;3629;4117;69;7746
06;2020-07-30;0;1;1;1577;1457;79;3034
06;2020-07-30;0;0;0;531;474;89;1005
06;2020-07-30;0;0;0;88;93;90;181
06;2020-07-30;4;10;15;146262;133209;0;279471
07;2020-07-30;0;0;0;485;549;09;1034
07;2020-07-30;0;0;0;403;432;19;835
07;2020-07-30;0;1;1;764;841;29;1605
07;2020-07-30;0;0;0;824;928;39;1752
07;2020-07-30;0;0;0;788;1020;49;1808
07;2020-07-30;0;0;0;678;870;59;1548
07;2020-07-30;0;0;0;360;382;69;742
07;2020-07-30;0;0;0;231;190;79;421
07;2020-07-30;0;0;0;114;67;89;181
07;2020-07-30;0;0;0;24;11;90;35
07;2020-07-30;0;1;1;4671;5290;0;9961
08;2020-07-30;0;0;0;2715.22592983026;2997.75551488675;09;5712.98144471701
08;2020-07-30;0;0;0;2778.51901080978;3160.9156459093;19;5939.43465671908
08;2020-07-30;0;0;0;2080.8882988764;1718.16634315323;29;3799.05464202964
08;2020-07-30;0;0;0;2701.8582062647;1896.52641413317;39;4598.38462039786
08;2020-07-30;0;0;0;3151.45861023308;2460.52498233809;49;5611.98359257117
08;2020-07-30;0;0;0;2620.29868333099;2422.23566154656;59;5042.53434487755
08;2020-07-30;0;0;0;1621.44173420671;1438.58325779464;69;3060.02499200135
08;2020-07-30;0;0;0;626.575909335673;526.358467843651;79;1152.93437717932
08;2020-07-30;0;0;0;205.018522985054;140.993639349697;89;346.012162334751
08;2020-07-30;0;0;0;50.0325684687745;20.62259870351;90;70.6551671722846
08;2020-07-30;0;0;0;18551.3174743414;16782.6825256586;0;35334
11;2020-07-30;5;6;11;783071;811785;09;1594856
11;2020-07-30;24;26;50;761456;784653;19;1546109
11;2020-07-30;79;90;169;850145;801772;29;1651917
11;2020-07-30;48;56;104;914360;843488;39;1757848
11;2020-07-30;28;37;65;845609;826202;49;1671811
11;2020-07-30;31;27;58;793566;745070;59;1538636
11;2020-07-30;23;22;45;628649;549192;69;1177841
11;2020-07-30;2;8;10;434606;358356;79;792962
11;2020-07-30;11;8;19;261425;162933;89;424358
11;2020-07-30;2;1;3;89253;32619;90;121872
11;2020-07-30;253;281;535;6362140;5916070;0;12278210
24;2020-07-30;0;1;1;139720;144686;09;284406
24;2020-07-30;2;6;8;152979;161185;19;314164
24;2020-07-30;9;1;10;122237;126536;29;248773
24;2020-07-30;5;1;6;150359;142009;39;292368
24;2020-07-30;4;0;4;161829;158758;49;320587
24;2020-07-30;2;5;7;172552;168011;59;340563
24;2020-07-30;2;2;4;172509;158177;69;330686
24;2020-07-30;1;0;1;129428;110593;79;240021
24;2020-07-30;0;0;0;87342;56882;89;144224
24;2020-07-30;0;1;1;31210;12071;90;43281
24;2020-07-30;25;17;42;1320165;1238908;0;2559073
27;2020-07-30;0;0;0;143373;149679;09;293052
27;2020-07-30;1;0;1;160962;173003;19;333965
27;2020-07-30;3;2;5;133746;142254;29;276000
27;2020-07-30;1;2;3;160004;155407;39;315411
27;2020-07-30;1;0;1;172333;169564;49;341897
27;2020-07-30;1;0;1;189979;183788;59;373767
27;2020-07-30;2;0;2;192591;178206;69;370797
27;2020-07-30;3;2;5;146876;127546;79;274422
27;2020-07-30;0;1;1;96896;61575;89;158471
27;2020-07-30;1;0;1;33148;12109;90;45257
27;2020-07-30;13;7;20;1429908;1353131;0;2783039
28;2020-07-30;1;1;2;180735;186856;09;367591
28;2020-07-30;1;3;4;200125;213621;19;413746
28;2020-07-30;0;6;6;168922;173007;29;341929
28;2020-07-30;1;1;2;196628;188487;39;385115
28;2020-07-30;1;0;1;205396;201699;49;407095
28;2020-07-30;0;0;0;222002;213866;59;435868
28;2020-07-30;0;0;0;224688;203758;69;428446
28;2020-07-30;0;0;0;163192;135543;79;298735
28;2020-07-30;0;0;0;109691;65377;89;175068
28;2020-07-30;1;0;1;37222;12685;90;49907
28;2020-07-30;5;11;16;1708601;1594899;0;3303500
32;2020-07-30;4;8;12;358062;373689;09;731751
32;2020-07-30;10;7;17;387045;406742;19;793787
32;2020-07-30;17;28;45;342304;348587;29;690891
32;2020-07-30;21;20;41;382485;369972;39;752457
32;2020-07-30;9;13;22;382510;376716;49;759226
32;2020-07-30;10;6;16;386937;376527;59;763464
32;2020-07-30;13;4;17;371211;330938;69;702149
32;2020-07-30;1;5;7;250542;201459;79;452001
32;2020-07-30;3;3;6;163399;89786;89;253185
32;2020-07-30;2;0;2;48384;15367;90;63751
32;2020-07-30;90;94;185;3072879;2889783;0;5962662
44;2020-07-30;1;2;3;291525;306839;09;598364
44;2020-07-30;5;3;8;320255;339504;19;659759
44;2020-07-30;6;10;16;302020;314428;29;616448
44;2020-07-30;6;7;13;342222;333292;39;675514
44;2020-07-30;7;4;11;349727;344491;49;694218
44;2020-07-30;7;5;12;381371;373239;59;754610
44;2020-07-30;3;1;4;367165;335850;69;703015
44;2020-07-30;1;1;2;250387;215436;79;465823
44;2020-07-30;4;2;6;170825;105192;89;276017
44;2020-07-30;0;1;1;51248;16731;90;67979
44;2020-07-30;40;36;76;2826745;2685002;0;5511747
52;2020-07-30;1;0;1;213594;223900;09;437494
52;2020-07-30;7;3;10;240818;255197;19;496015
52;2020-07-30;10;12;22;197010;200630;29;397640
52;2020-07-30;9;8;17;231204;224885;39;456089
52;2020-07-30;4;0;4;243874;243418;49;487292
52;2020-07-30;4;6;10;244100;239116;59;483216
52;2020-07-30;4;1;5;241796;221345;69;463141
52;2020-07-30;0;2;2;177805;149903;79;327708
52;2020-07-30;1;0;1;119561;75822;89;195383
52;2020-07-30;1;0;1;42559;15260;90;57819
52;2020-07-30;41;32;73;1952321;1849476;0;3801797
53;2020-07-30;2;0;2;173813;182358;09;356171
53;2020-07-30;1;7;8;202720;214740;19;417460
53;2020-07-30;3;3;6;163116;173196;29;336312
53;2020-07-30;1;5;6;190526;187674;39;378200
53;2020-07-30;0;3;3;212098;212015;49;424113
53;2020-07-30;3;5;8;223699;219176;59;442875
53;2020-07-30;0;2;2;227435;209274;69;436709
53;2020-07-30;0;1;1;169992;140910;79;310902
53;2020-07-30;1;0;1;118117;69883;89;188000
53;2020-07-30;0;0;0;37370;12267;90;49637
53;2020-07-30;11;26;37;1718886;1621493;0;3340379
75;2020-07-30;0;0;0;293104;305291;09;598395
75;2020-07-30;0;0;0;337141;357785;19;694926
75;2020-07-30;6;7;13;295024;300618;29;595642
75;2020-07-30;4;2;6;347871;331233;39;679104
75;2020-07-30;0;1;1;384742;372771;49;757513
75;2020-07-30;1;2;3;413361;390880;59;804241
75;2020-07-30;2;1;3;425623;384060;69;809683
75;2020-07-30;0;0;1;325086;276298;79;601384
75;2020-07-30;0;0;0;213986;139308;89;353294
75;2020-07-30;0;0;0;77600;28200;90;105800
75;2020-07-30;13;13;27;3113538;2886444;0;5999982
76;2020-07-30;2;2;4;305956;318589;09;624545
76;2020-07-30;7;6;13;338942;356969;19;695911
76;2020-07-30;17;15;32;316210;319570;29;635780
76;2020-07-30;6;15;21;356758;337587;39;694345
76;2020-07-30;8;1;9;376541;363812;49;740353
76;2020-07-30;5;3;8;402608;383750;59;786358
76;2020-07-30;4;7;11;394889;358997;69;753886
76;2020-07-30;4;2;6;308664;263806;79;572470
76;2020-07-30;0;2;2;195838;129272;89;325110
76;2020-07-30;2;0;2;69372;26728;90;96100
76;2020-07-30;55;53;108;3065778;2859080;0;5924858
84;2020-07-30;4;2;7;459549;481088;09;940637
84;2020-07-30;11;16;27;487711;511905;19;999616
84;2020-07-30;22;12;34;443824;451094;29;894918
84;2020-07-30;14;17;31;512522;493262;39;1005784
84;2020-07-30;11;6;17;520248;515106;49;1035354
84;2020-07-30;8;5;13;529611;514848;59;1044459
84;2020-07-30;2;2;4;486720;439940;69;926660
84;2020-07-30;1;5;6;372151;315211;79;687362
84;2020-07-30;0;0;0;237198;150524;89;387722
84;2020-07-30;1;0;1;81185;28680;90;109865
84;2020-07-30;74;65;140;4130719;3901658;0;8032377
93;2020-07-30;6;7;13;268834;283093;09;551927
93;2020-07-30;21;10;31;280751;296087;19;576838
93;2020-07-30;23;24;47;254404;255552;29;509956
93;2020-07-30;21;18;39;310704;288398;39;599102
93;2020-07-30;6;5;11;325559;305827;49;631386
93;2020-07-30;11;9;20;353104;325389;59;678493
93;2020-07-30;6;4;10;336327;296459;69;632786
93;2020-07-30;4;1;5;279820;229699;79;509519
93;2020-07-30;5;2;7;171274;113716;89;284990
93;2020-07-30;6;0;6;58896;21758;90;80654
93;2020-07-30;109;80;189;2639673;2415978;0;5055651
94;2020-07-30;0;0;0;16311;17433;09;33744
94;2020-07-30;0;0;0;16679;18132;19;34811
94;2020-07-30;0;0;0;16782;16579;29;33361
94;2020-07-30;0;0;0;23044;20580;39;43624
94;2020-07-30;0;0;0;23065;22140;49;45205
94;2020-07-30;0;0;0;24549;23421;59;47970
94;2020-07-30;0;0;0;23212;21883;69;45095
94;2020-07-30;0;0;0;19544;17141;79;36685
94;2020-07-30;0;0;0;11227;8178;89;19405
94;2020-07-30;0;0;0;3332;1447;90;4779
94;2020-07-30;0;0;0;177745;166934;0;344679
01;2020-07-31;0;0;0;19979;20155;09;40134
01;2020-07-31;0;0;0;24994;25489;19;50483
01;2020-07-31;1;0;1;17868;16690;29;34558
01;2020-07-31;0;2;2;22328;14821;39;37149
01;2020-07-31;0;0;0;28652;20276;49;48928
01;2020-07-31;0;0;0;33264;27260;59;60524
01;2020-07-31;0;0;0;27135;23978;69;51113
01;2020-07-31;0;0;0;18401;14661;79;33062
01;2020-07-31;0;0;0;9633;6375;89;16008
01;2020-07-31;0;0;0;3410;1510;90;4920
01;2020-07-31;1;2;3;205664;171215;0;376879
02;2020-07-31;0;0;0;16881;17110;09;33991
02;2020-07-31;1;1;2;21410;21604;19;43014
02;2020-07-31;0;1;1;16017;15479;29;31496
02;2020-07-31;0;3;3;19825;14455;39;34280
02;2020-07-31;0;0;0;24719;18248;49;42967
02;2020-07-31;1;2;3;34361;28310;59;62671
02;2020-07-31;0;0;0;28061;24495;69;52556
02;2020-07-31;0;0;0;18231;15278;79;33509
02;2020-07-31;0;0;0;11090;7677;89;18767
02;2020-07-31;0;0;0;3992;1506;90;5498
02;2020-07-31;2;7;9;194587;164162;0;358749
03;2020-07-31;2;2;4;31123;30920;09;62043
03;2020-07-31;9;3;13;29370;29268;19;58638
03;2020-07-31;14;3;19;21458;18963;29;40421
03;2020-07-31;8;7;15;21276;18326;39;39602
03;2020-07-31;7;2;10;18164;16593;49;34757
03;2020-07-31;5;7;13;13469;13557;59;27026
03;2020-07-31;2;3;5;8776;8670;69;17446
03;2020-07-31;1;0;1;3777;3591;79;7368
03;2020-07-31;0;0;0;1649;1072;89;2721
03;2020-07-31;0;0;0;485;184;90;669
03;2020-07-31;48;27;80;149547;141144;0;290691
04;2020-07-31;0;0;0;60314;61377;09;121691
04;2020-07-31;0;0;0;66065;68387;19;134452
04;2020-07-31;1;0;1;51059;47156;29;98215
04;2020-07-31;1;2;3;58788;45780;39;104568
04;2020-07-31;0;0;0;61408;52207;49;113615
04;2020-07-31;1;0;1;64838;60759;59;125597
04;2020-07-31;1;1;2;47008;42843;69;89851
04;2020-07-31;1;0;1;25509;21184;79;46693
04;2020-07-31;0;0;0;13168;7647;89;20815
04;2020-07-31;0;0;0;3209;1253;90;4462
04;2020-07-31;5;3;8;451366;408593;0;859959
05;2020-07-31;0;0;0;362.366008612902;341.338819562748;09;703.704828175651
05;2020-07-31;0;0;0;353.376145114279;370.349735405642;19;723.725880519921
05;2020-07-31;0;0;0;218.593559489256;256.539602589476;29;475.133162078732
05;2020-07-31;0;0;0;404.225408693299;360.321910454353;39;764.547319147651
05;2020-07-31;0;0;0;520.067953604221;497.108383964256;49;1017.17633756848
05;2020-07-31;0;0;0;468.146063921917;510.087601910415;59;978.233665832332
05;2020-07-31;0;0;0;340.368470050554;334.366842191253;69;674.735312241807
05;2020-07-31;0;0;0;212.598666888387;192.597753227106;79;405.196420115493
05;2020-07-31;0;0;0;148.727797095705;61.8681715431829;89;210.595968638888
05;2020-07-31;0;0;0;32.9601271090696;10.9909785719784;90;43.9511056810479
05;2020-07-31;0;0;0;3061.43020057959;2935.56979942041;0;5997
06;2020-07-31;0;0;0;42583;42380;09;84963
06;2020-07-31;0;1;1;33369;31925;19;65294
06;2020-07-31;0;0;0;21571;15080;29;36651
06;2020-07-31;1;2;3;21550;16147;39;37697
06;2020-07-31;1;0;1;14193;13939;49;28132
06;2020-07-31;0;0;0;7171;7597;59;14768
06;2020-07-31;0;0;0;3629;4117;69;7746
06;2020-07-31;0;0;0;1577;1457;79;3034
06;2020-07-31;0;0;0;531;474;89;1005
06;2020-07-31;0;0;0;88;93;90;181
06;2020-07-31;2;3;5;146262;133209;0;279471
07;2020-07-31;0;0;0;485;549;09;1034
07;2020-07-31;0;0;0;403;432;19;835
07;2020-07-31;0;0;0;764;841;29;1605
07;2020-07-31;0;0;0;824;928;39;1752
07;2020-07-31;0;0;0;788;1020;49;1808
07;2020-07-31;0;0;0;678;870;59;1548
07;2020-07-31;0;0;0;360;382;69;742
07;2020-07-31;0;0;0;231;190;79;421
07;2020-07-31;0;0;0;114;67;89;181
07;2020-07-31;0;0;0;24;11;90;35
07;2020-07-31;0;0;0;4671;5290;0;9961
08;2020-07-31;0;0;0;2715.22592983026;2997.75551488675;09;5712.98144471701
08;2020-07-31;0;0;0;2778.51901080978;3160.9156459093;19;5939.43465671908
08;2020-07-31;0;0;0;2080.8882988764;1718.16634315323;29;3799.05464202964
08;2020-07-31;0;0;0;2701.8582062647;1896.52641413317;39;4598.38462039786
08;2020-07-31;0;1;1;3151.45861023308;2460.52498233809;49;5611.98359257117
08;2020-07-31;0;0;0;2620.29868333099;2422.23566154656;59;5042.53434487755
08;2020-07-31;0;0;0;1621.44173420671;1438.58325779464;69;3060.02499200135
08;2020-07-31;0;0;0;626.575909335673;526.358467843651;79;1152.93437717932
08;2020-07-31;0;0;0;205.018522985054;140.993639349697;89;346.012162334751
08;2020-07-31;0;0;0;50.0325684687745;20.62259870351;90;70.6551671722846
08;2020-07-31;0;1;1;18551.3174743414;16782.6825256586;0;35334
11;2020-07-31;9;16;27;783071;811785;09;1594856
11;2020-07-31;27;22;51;761456;784653;19;1546109
11;2020-07-31;86;81;167;850145;801772;29;1651917
11;2020-07-31;57;58;115;914360;843488;39;1757848
11;2020-07-31;33;31;64;845609;826202;49;1671811
11;2020-07-31;37;33;70;793566;745070;59;1538636
11;2020-07-31;24;16;40;628649;549192;69;1177841
11;2020-07-31;5;13;18;434606;358356;79;792962
11;2020-07-31;3;4;7;261425;162933;89;424358
11;2020-07-31;4;1;5;89253;32619;90;121872
11;2020-07-31;285;275;564;6362140;5916070;0;12278210
24;2020-07-31;1;1;2;139720;144686;09;284406
24;2020-07-31;3;4;7;152979;161185;19;314164
24;2020-07-31;5;4;9;122237;126536;29;248773
24;2020-07-31;7;6;13;150359;142009;39;292368
24;2020-07-31;2;1;3;161829;158758;49;320587
24;2020-07-31;3;1;4;172552;168011;59;340563
24;2020-07-31;2;1;3;172509;158177;69;330686
24;2020-07-31;0;0;0;129428;110593;79;240021
24;2020-07-31;2;0;2;87342;56882;89;144224
24;2020-07-31;0;0;0;31210;12071;90;43281
24;2020-07-31;25;18;43;1320165;1238908;0;2559073
27;2020-07-31;0;1;1;143373;149679;09;293052
27;2020-07-31;2;3;5;160962;173003;19;333965
27;2020-07-31;1;3;4;133746;142254;29;276000
27;2020-07-31;1;0;1;160004;155407;39;315411
27;2020-07-31;2;1;3;172333;169564;49;341897
27;2020-07-31;4;0;4;189979;183788;59;373767
27;2020-07-31;0;1;1;192591;178206;69;370797
27;2020-07-31;1;1;2;146876;127546;79;274422
27;2020-07-31;1;1;2;96896;61575;89;158471
27;2020-07-31;0;0;0;33148;12109;90;45257
27;2020-07-31;12;11;23;1429908;1353131;0;2783039
28;2020-07-31;0;0;0;180735;186856;09;367591
28;2020-07-31;2;2;4;200125;213621;19;413746
28;2020-07-31;3;8;11;168922;173007;29;341929
28;2020-07-31;2;2;4;196628;188487;39;385115
28;2020-07-31;1;0;1;205396;201699;49;407095
28;2020-07-31;2;3;5;222002;213866;59;435868
28;2020-07-31;0;2;2;224688;203758;69;428446
28;2020-07-31;1;0;1;163192;135543;79;298735
28;2020-07-31;0;0;0;109691;65377;89;175068
28;2020-07-31;0;0;0;37222;12685;90;49907
28;2020-07-31;11;17;28;1708601;1594899;0;3303500
32;2020-07-31;6;6;12;358062;373689;09;731751
32;2020-07-31;6;8;14;387045;406742;19;793787
32;2020-07-31;21;11;32;342304;348587;29;690891
32;2020-07-31;13;11;24;382485;369972;39;752457
32;2020-07-31;4;14;18;382510;376716;49;759226
32;2020-07-31;11;5;16;386937;376527;59;763464
32;2020-07-31;6;6;12;371211;330938;69;702149
32;2020-07-31;1;3;4;250542;201459;79;452001
32;2020-07-31;2;1;3;163399;89786;89;253185
32;2020-07-31;1;1;2;48384;15367;90;63751
32;2020-07-31;71;66;137;3072879;2889783;0;5962662
44;2020-07-31;7;2;9;291525;306839;09;598364
44;2020-07-31;6;7;13;320255;339504;19;659759
44;2020-07-31;13;12;25;302020;314428;29;616448
44;2020-07-31;6;9;15;342222;333292;39;675514
44;2020-07-31;8;5;13;349727;344491;49;694218
44;2020-07-31;10;7;17;381371;373239;59;754610
44;2020-07-31;6;5;11;367165;335850;69;703015
44;2020-07-31;2;3;5;250387;215436;79;465823
44;2020-07-31;2;1;3;170825;105192;89;276017
44;2020-07-31;1;0;1;51248;16731;90;67979
44;2020-07-31;61;51;112;2826745;2685002;0;5511747
52;2020-07-31;7;6;13;213594;223900;09;437494
52;2020-07-31;10;12;22;240818;255197;19;496015
52;2020-07-31;15;15;30;197010;200630;29;397640
52;2020-07-31;7;4;11;231204;224885;39;456089
52;2020-07-31;4;7;11;243874;243418;49;487292
52;2020-07-31;1;6;7;244100;239116;59;483216
52;2020-07-31;0;2;2;241796;221345;69;463141
52;2020-07-31;0;2;2;177805;149903;79;327708
52;2020-07-31;1;1;2;119561;75822;89;195383
52;2020-07-31;0;0;0;42559;15260;90;57819
52;2020-07-31;45;55;100;1952321;1849476;0;3801797
53;2020-07-31;1;0;1;173813;182358;09;356171
53;2020-07-31;2;9;11;202720;214740;19;417460
53;2020-07-31;6;15;21;163116;173196;29;336312
53;2020-07-31;2;5;7;190526;187674;39;378200
53;2020-07-31;6;1;7;212098;212015;49;424113
53;2020-07-31;3;5;8;223699;219176;59;442875
53;2020-07-31;1;0;1;227435;209274;69;436709
53;2020-07-31;1;0;1;169992;140910;79;310902
53;2020-07-31;3;0;3;118117;69883;89;188000
53;2020-07-31;3;0;3;37370;12267;90;49637
53;2020-07-31;28;35;63;1718886;1621493;0;3340379
75;2020-07-31;0;1;1;293104;305291;09;598395
75;2020-07-31;0;1;1;337141;357785;19;694926
75;2020-07-31;5;4;9;295024;300618;29;595642
75;2020-07-31;2;5;7;347871;331233;39;679104
75;2020-07-31;2;0;2;384742;372771;49;757513
75;2020-07-31;1;2;3;413361;390880;59;804241
75;2020-07-31;2;2;4;425623;384060;69;809683
75;2020-07-31;0;0;0;325086;276298;79;601384
75;2020-07-31;1;0;1;213986;139308;89;353294
75;2020-07-31;0;0;0;77600;28200;90;105800
75;2020-07-31;13;15;28;3113538;2886444;0;5999982
76;2020-07-31;4;4;8;305956;318589;09;624545
76;2020-07-31;8;16;24;338942;356969;19;695911
76;2020-07-31;24;14;38;316210;319570;29;635780
76;2020-07-31;6;9;15;356758;337587;39;694345
76;2020-07-31;6;8;14;376541;363812;49;740353
76;2020-07-31;5;2;7;402608;383750;59;786358
76;2020-07-31;3;1;4;394889;358997;69;753886
76;2020-07-31;1;5;6;308664;263806;79;572470
76;2020-07-31;1;1;2;195838;129272;89;325110
76;2020-07-31;0;0;0;69372;26728;90;96100
76;2020-07-31;58;60;118;3065778;2859080;0;5924858
84;2020-07-31;4;3;7;459549;481088;09;940637
84;2020-07-31;3;6;9;487711;511905;19;999616
84;2020-07-31;19;16;35;443824;451094;29;894918
84;2020-07-31;13;16;29;512522;493262;39;1005784
84;2020-07-31;4;6;10;520248;515106;49;1035354
84;2020-07-31;11;4;15;529611;514848;59;1044459
84;2020-07-31;6;3;9;486720;439940;69;926660
84;2020-07-31;2;2;4;372151;315211;79;687362
84;2020-07-31;0;1;1;237198;150524;89;387722
84;2020-07-31;0;0;0;81185;28680;90;109865
84;2020-07-31;62;57;119;4130719;3901658;0;8032377
93;2020-07-31;2;1;3;268834;283093;09;551927
93;2020-07-31;10;8;18;280751;296087;19;576838
93;2020-07-31;33;37;70;254404;255552;29;509956
93;2020-07-31;11;13;24;310704;288398;39;599102
93;2020-07-31;13;15;28;325559;305827;49;631386
93;2020-07-31;7;6;13;353104;325389;59;678493
93;2020-07-31;3;7;10;336327;296459;69;632786
93;2020-07-31;5;4;9;279820;229699;79;509519
93;2020-07-31;1;0;1;171274;113716;89;284990
93;2020-07-31;3;1;4;58896;21758;90;80654
93;2020-07-31;88;92;180;2639673;2415978;0;5055651
94;2020-07-31;0;0;0;16311;17433;09;33744
94;2020-07-31;0;0;0;16679;18132;19;34811
94;2020-07-31;0;0;0;16782;16579;29;33361
94;2020-07-31;0;0;0;23044;20580;39;43624
94;2020-07-31;1;0;1;23065;22140;49;45205
94;2020-07-31;0;0;0;24549;23421;59;47970
94;2020-07-31;0;0;0;23212;21883;69;45095
94;2020-07-31;1;1;2;19544;17141;79;36685
94;2020-07-31;0;0;0;11227;8178;89;19405
94;2020-07-31;0;0;0;3332;1447;90;4779
94;2020-07-31;2;1;3;177745;166934;0;344679
01;2020-08-01;0;0;0;19979;20155;09;40134
01;2020-08-01;1;0;1;24994;25489;19;50483
01;2020-08-01;2;0;2;17868;16690;29;34558
01;2020-08-01;0;0;0;22328;14821;39;37149
01;2020-08-01;1;0;1;28652;20276;49;48928
01;2020-08-01;0;0;0;33264;27260;59;60524
01;2020-08-01;0;0;0;27135;23978;69;51113
01;2020-08-01;0;0;0;18401;14661;79;33062
01;2020-08-01;0;0;0;9633;6375;89;16008
01;2020-08-01;0;0;0;3410;1510;90;4920
01;2020-08-01;4;0;4;205664;171215;0;376879
02;2020-08-01;0;0;0;16881;17110;09;33991
02;2020-08-01;0;0;0;21410;21604;19;43014
02;2020-08-01;0;0;0;16017;15479;29;31496
02;2020-08-01;0;0;0;19825;14455;39;34280
02;2020-08-01;0;0;0;24719;18248;49;42967
02;2020-08-01;0;0;0;34361;28310;59;62671
02;2020-08-01;0;0;0;28061;24495;69;52556
02;2020-08-01;0;0;0;18231;15278;79;33509
02;2020-08-01;0;0;0;11090;7677;89;18767
02;2020-08-01;0;0;0;3992;1506;90;5498
02;2020-08-01;0;0;0;194587;164162;0;358749
03;2020-08-01;0;0;0;31123;30920;09;62043
03;2020-08-01;1;1;3;29370;29268;19;58638
03;2020-08-01;5;2;7;21458;18963;29;40421
03;2020-08-01;6;3;11;21276;18326;39;39602
03;2020-08-01;6;4;10;18164;16593;49;34757
03;2020-08-01;4;4;9;13469;13557;59;27026
03;2020-08-01;3;2;5;8776;8670;69;17446
03;2020-08-01;1;1;2;3777;3591;79;7368
03;2020-08-01;1;0;2;1649;1072;89;2721
03;2020-08-01;0;0;0;485;184;90;669
03;2020-08-01;27;17;49;149547;141144;0;290691
04;2020-08-01;0;0;0;60314;61377;09;121691
04;2020-08-01;0;0;0;66065;68387;19;134452
04;2020-08-01;0;0;0;51059;47156;29;98215
04;2020-08-01;0;0;0;58788;45780;39;104568
04;2020-08-01;0;0;0;61408;52207;49;113615
04;2020-08-01;0;1;1;64838;60759;59;125597
04;2020-08-01;0;0;0;47008;42843;69;89851
04;2020-08-01;0;0;0;25509;21184;79;46693
04;2020-08-01;0;0;0;13168;7647;89;20815
04;2020-08-01;0;0;0;3209;1253;90;4462
04;2020-08-01;0;1;1;451366;408593;0;859959
05;2020-08-01;0;0;0;362.366008612902;341.338819562748;09;703.704828175651
05;2020-08-01;0;0;0;353.376145114279;370.349735405642;19;723.725880519921
05;2020-08-01;0;0;0;218.593559489256;256.539602589476;29;475.133162078732
05;2020-08-01;0;0;0;404.225408693299;360.321910454353;39;764.547319147651
05;2020-08-01;0;0;0;520.067953604221;497.108383964256;49;1017.17633756848
05;2020-08-01;0;0;0;468.146063921917;510.087601910415;59;978.233665832332
05;2020-08-01;0;0;0;340.368470050554;334.366842191253;69;674.735312241807
05;2020-08-01;0;0;0;212.598666888387;192.597753227106;79;405.196420115493
05;2020-08-01;0;0;0;148.727797095705;61.8681715431829;89;210.595968638888
05;2020-08-01;0;0;0;32.9601271090696;10.9909785719784;90;43.9511056810479
05;2020-08-01;0;0;0;3061.43020057959;2935.56979942041;0;5997
06;2020-08-01;0;0;0;42583;42380;09;84963
06;2020-08-01;1;1;2;33369;31925;19;65294
06;2020-08-01;1;0;1;21571;15080;29;36651
06;2020-08-01;0;0;0;21550;16147;39;37697
06;2020-08-01;0;0;0;14193;13939;49;28132
06;2020-08-01;1;2;3;7171;7597;59;14768
06;2020-08-01;1;0;1;3629;4117;69;7746
06;2020-08-01;0;0;0;1577;1457;79;3034
06;2020-08-01;0;0;0;531;474;89;1005
06;2020-08-01;0;0;0;88;93;90;181
06;2020-08-01;4;3;7;146262;133209;0;279471
07;2020-08-01;0;0;0;485;549;09;1034
07;2020-08-01;0;0;0;403;432;19;835
07;2020-08-01;0;0;0;764;841;29;1605
07;2020-08-01;0;0;0;824;928;39;1752
07;2020-08-01;0;0;0;788;1020;49;1808
07;2020-08-01;0;0;0;678;870;59;1548
07;2020-08-01;0;0;0;360;382;69;742
07;2020-08-01;0;0;0;231;190;79;421
07;2020-08-01;0;0;0;114;67;89;181
07;2020-08-01;0;0;0;24;11;90;35
07;2020-08-01;0;0;0;4671;5290;0;9961
08;2020-08-01;0;0;0;2715.22592983026;2997.75551488675;09;5712.98144471701
08;2020-08-01;0;0;0;2778.51901080978;3160.9156459093;19;5939.43465671908
08;2020-08-01;0;0;0;2080.8882988764;1718.16634315323;29;3799.05464202964
08;2020-08-01;0;0;0;2701.8582062647;1896.52641413317;39;4598.38462039786
08;2020-08-01;0;0;0;3151.45861023308;2460.52498233809;49;5611.98359257117
08;2020-08-01;1;0;1;2620.29868333099;2422.23566154656;59;5042.53434487755
08;2020-08-01;0;0;0;1621.44173420671;1438.58325779464;69;3060.02499200135
08;2020-08-01;0;0;0;626.575909335673;526.358467843651;79;1152.93437717932
08;2020-08-01;0;0;0;205.018522985054;140.993639349697;89;346.012162334751
08;2020-08-01;0;0;0;50.0325684687745;20.62259870351;90;70.6551671722846
08;2020-08-01;1;0;1;18551.3174743414;16782.6825256586;0;35334
11;2020-08-01;4;10;14;783071;811785;09;1594856
11;2020-08-01;12;14;26;761456;784653;19;1546109
11;2020-08-01;29;35;64;850145;801772;29;1651917
11;2020-08-01;19;32;51;914360;843488;39;1757848
11;2020-08-01;19;12;31;845609;826202;49;1671811
11;2020-08-01;11;17;28;793566;745070;59;1538636
11;2020-08-01;8;8;16;628649;549192;69;1177841
11;2020-08-01;8;6;14;434606;358356;79;792962
11;2020-08-01;1;5;6;261425;162933;89;424358
11;2020-08-01;0;0;0;89253;32619;90;121872
11;2020-08-01;111;140;251;6362140;5916070;0;12278210
24;2020-08-01;0;0;0;139720;144686;09;284406
24;2020-08-01;0;2;2;152979;161185;19;314164
24;2020-08-01;1;4;5;122237;126536;29;248773
24;2020-08-01;0;0;0;150359;142009;39;292368
24;2020-08-01;1;0;1;161829;158758;49;320587
24;2020-08-01;1;1;2;172552;168011;59;340563
24;2020-08-01;0;1;1;172509;158177;69;330686
24;2020-08-01;0;1;1;129428;110593;79;240021
24;2020-08-01;1;0;1;87342;56882;89;144224
24;2020-08-01;0;0;0;31210;12071;90;43281
24;2020-08-01;4;9;13;1320165;1238908;0;2559073
27;2020-08-01;0;0;0;143373;149679;09;293052
27;2020-08-01;1;0;1;160962;173003;19;333965
27;2020-08-01;0;2;2;133746;142254;29;276000
27;2020-08-01;2;2;4;160004;155407;39;315411
27;2020-08-01;0;0;0;172333;169564;49;341897
27;2020-08-01;1;0;1;189979;183788;59;373767
27;2020-08-01;0;0;0;192591;178206;69;370797
27;2020-08-01;1;0;1;146876;127546;79;274422
27;2020-08-01;0;0;0;96896;61575;89;158471
27;2020-08-01;0;0;0;33148;12109;90;45257
27;2020-08-01;5;4;9;1429908;1353131;0;2783039
28;2020-08-01;1;0;1;180735;186856;09;367591
28;2020-08-01;1;0;1;200125;213621;19;413746
28;2020-08-01;4;7;11;168922;173007;29;341929
28;2020-08-01;0;1;1;196628;188487;39;385115
28;2020-08-01;0;0;0;205396;201699;49;407095
28;2020-08-01;1;0;1;222002;213866;59;435868
28;2020-08-01;0;1;1;224688;203758;69;428446
28;2020-08-01;0;1;1;163192;135543;79;298735
28;2020-08-01;0;0;0;109691;65377;89;175068
28;2020-08-01;0;0;0;37222;12685;90;49907
28;2020-08-01;7;10;17;1708601;1594899;0;3303500
32;2020-08-01;5;4;9;358062;373689;09;731751
32;2020-08-01;6;9;15;387045;406742;19;793787
32;2020-08-01;10;15;25;342304;348587;29;690891
32;2020-08-01;3;4;7;382485;369972;39;752457
32;2020-08-01;5;4;9;382510;376716;49;759226
32;2020-08-01;6;5;11;386937;376527;59;763464
32;2020-08-01;5;2;7;371211;330938;69;702149
32;2020-08-01;3;2;5;250542;201459;79;452001
32;2020-08-01;3;0;3;163399;89786;89;253185
32;2020-08-01;1;0;1;48384;15367;90;63751
32;2020-08-01;47;45;92;3072879;2889783;0;5962662
44;2020-08-01;0;0;0;291525;306839;09;598364
44;2020-08-01;1;3;4;320255;339504;19;659759
44;2020-08-01;2;12;14;302020;314428;29;616448
44;2020-08-01;4;2;6;342222;333292;39;675514
44;2020-08-01;2;1;3;349727;344491;49;694218
44;2020-08-01;3;3;6;381371;373239;59;754610
44;2020-08-01;4;1;5;367165;335850;69;703015
44;2020-08-01;1;3;4;250387;215436;79;465823
44;2020-08-01;0;2;2;170825;105192;89;276017
44;2020-08-01;0;0;0;51248;16731;90;67979
44;2020-08-01;17;27;44;2826745;2685002;0;5511747
52;2020-08-01;1;0;1;213594;223900;09;437494
52;2020-08-01;4;7;11;240818;255197;19;496015
52;2020-08-01;3;1;4;197010;200630;29;397640
52;2020-08-01;3;8;11;231204;224885;39;456089
52;2020-08-01;3;2;5;243874;243418;49;487292
52;2020-08-01;6;3;9;244100;239116;59;483216
52;2020-08-01;1;4;5;241796;221345;69;463141
52;2020-08-01;0;1;1;177805;149903;79;327708
52;2020-08-01;0;2;2;119561;75822;89;195383
52;2020-08-01;1;0;1;42559;15260;90;57819
52;2020-08-01;22;28;50;1952321;1849476;0;3801797
53;2020-08-01;3;1;4;173813;182358;09;356171
53;2020-08-01;0;1;1;202720;214740;19;417460
53;2020-08-01;2;2;4;163116;173196;29;336312
53;2020-08-01;2;1;3;190526;187674;39;378200
53;2020-08-01;2;1;3;212098;212015;49;424113
53;2020-08-01;2;1;3;223699;219176;59;442875
53;2020-08-01;0;1;1;227435;209274;69;436709
53;2020-08-01;0;0;0;169992;140910;79;310902
53;2020-08-01;0;1;1;118117;69883;89;188000
53;2020-08-01;1;1;2;37370;12267;90;49637
53;2020-08-01;12;10;22;1718886;1621493;0;3340379
75;2020-08-01;0;1;1;293104;305291;09;598395
75;2020-08-01;3;1;4;337141;357785;19;694926
75;2020-08-01;4;3;7;295024;300618;29;595642
75;2020-08-01;0;3;3;347871;331233;39;679104
75;2020-08-01;0;1;1;384742;372771;49;757513
75;2020-08-01;1;1;2;413361;390880;59;804241
75;2020-08-01;1;1;2;425623;384060;69;809683
75;2020-08-01;0;0;0;325086;276298;79;601384
75;2020-08-01;1;1;2;213986;139308;89;353294
75;2020-08-01;1;0;1;77600;28200;90;105800
75;2020-08-01;11;12;23;3113538;2886444;0;5999982
76;2020-08-01;0;1;1;305956;318589;09;624545
76;2020-08-01;0;3;3;338942;356969;19;695911
76;2020-08-01;6;9;15;316210;319570;29;635780
76;2020-08-01;6;5;11;356758;337587;39;694345
76;2020-08-01;2;3;5;376541;363812;49;740353
76;2020-08-01;0;0;0;402608;383750;59;786358
76;2020-08-01;0;2;2;394889;358997;69;753886
76;2020-08-01;0;1;1;308664;263806;79;572470
76;2020-08-01;0;1;1;195838;129272;89;325110
76;2020-08-01;0;0;0;69372;26728;90;96100
76;2020-08-01;14;25;39;3065778;2859080;0;5924858
84;2020-08-01;1;6;7;459549;481088;09;940637
84;2020-08-01;5;2;7;487711;511905;19;999616
84;2020-08-01;4;11;15;443824;451094;29;894918
84;2020-08-01;4;8;12;512522;493262;39;1005784
84;2020-08-01;3;0;3;520248;515106;49;1035354
84;2020-08-01;4;3;7;529611;514848;59;1044459
84;2020-08-01;2;5;7;486720;439940;69;926660
84;2020-08-01;0;1;1;372151;315211;79;687362
84;2020-08-01;0;0;0;237198;150524;89;387722
84;2020-08-01;0;0;0;81185;28680;90;109865
84;2020-08-01;23;36;59;4130719;3901658;0;8032377
93;2020-08-01;3;0;3;268834;283093;09;551927
93;2020-08-01;8;2;10;280751;296087;19;576838
93;2020-08-01;16;12;28;254404;255552;29;509956
93;2020-08-01;12;12;24;310704;288398;39;599102
93;2020-08-01;9;6;15;325559;305827;49;631386
93;2020-08-01;7;7;14;353104;325389;59;678493
93;2020-08-01;0;4;4;336327;296459;69;632786
93;2020-08-01;3;2;5;279820;229699;79;509519
93;2020-08-01;1;1;2;171274;113716;89;284990
93;2020-08-01;2;0;2;58896;21758;90;80654
93;2020-08-01;61;46;107;2639673;2415978;0;5055651
94;2020-08-01;0;0;0;16311;17433;09;33744
94;2020-08-01;0;0;0;16679;18132;19;34811
94;2020-08-01;0;0;0;16782;16579;29;33361
94;2020-08-01;0;0;0;23044;20580;39;43624
94;2020-08-01;0;0;0;23065;22140;49;45205
94;2020-08-01;0;0;0;24549;23421;59;47970
94;2020-08-01;0;0;0;23212;21883;69;45095
94;2020-08-01;0;0;0;19544;17141;79;36685
94;2020-08-01;0;0;0;11227;8178;89;19405
94;2020-08-01;0;0;0;3332;1447;90;4779
94;2020-08-01;0;0;0;177745;166934;0;344679
01;2020-08-02;0;0;0;19979;20155;09;40134
01;2020-08-02;0;0;0;24994;25489;19;50483
01;2020-08-02;1;0;1;17868;16690;29;34558
01;2020-08-02;0;0;0;22328;14821;39;37149
01;2020-08-02;0;0;0;28652;20276;49;48928
01;2020-08-02;0;0;0;33264;27260;59;60524
01;2020-08-02;0;0;0;27135;23978;69;51113
01;2020-08-02;0;0;0;18401;14661;79;33062
01;2020-08-02;0;0;0;9633;6375;89;16008
01;2020-08-02;0;0;0;3410;1510;90;4920
01;2020-08-02;1;0;1;205664;171215;0;376879
02;2020-08-02;0;0;0;16881;17110;09;33991
02;2020-08-02;0;0;0;21410;21604;19;43014
02;2020-08-02;0;0;0;16017;15479;29;31496
02;2020-08-02;0;0;0;19825;14455;39;34280
02;2020-08-02;0;0;0;24719;18248;49;42967
02;2020-08-02;0;0;0;34361;28310;59;62671
02;2020-08-02;0;0;0;28061;24495;69;52556
02;2020-08-02;0;0;0;18231;15278;79;33509
02;2020-08-02;0;0;0;11090;7677;89;18767
02;2020-08-02;0;0;0;3992;1506;90;5498
02;2020-08-02;0;0;0;194587;164162;0;358749
03;2020-08-02;0;0;0;31123;30920;09;62043
03;2020-08-02;0;1;2;29370;29268;19;58638
03;2020-08-02;2;2;4;21458;18963;29;40421
03;2020-08-02;1;0;1;21276;18326;39;39602
03;2020-08-02;2;0;2;18164;16593;49;34757
03;2020-08-02;2;1;3;13469;13557;59;27026
03;2020-08-02;1;1;2;8776;8670;69;17446
03;2020-08-02;1;0;1;3777;3591;79;7368
03;2020-08-02;0;1;1;1649;1072;89;2721
03;2020-08-02;0;0;0;485;184;90;669
03;2020-08-02;9;6;16;149547;141144;0;290691
04;2020-08-02;0;0;0;60314;61377;09;121691
04;2020-08-02;0;0;0;66065;68387;19;134452
04;2020-08-02;0;1;1;51059;47156;29;98215
04;2020-08-02;0;0;0;58788;45780;39;104568
04;2020-08-02;0;0;0;61408;52207;49;113615
04;2020-08-02;0;0;0;64838;60759;59;125597
04;2020-08-02;0;0;0;47008;42843;69;89851
04;2020-08-02;0;0;0;25509;21184;79;46693
04;2020-08-02;0;0;0;13168;7647;89;20815
04;2020-08-02;0;0;0;3209;1253;90;4462
04;2020-08-02;0;1;1;451366;408593;0;859959
05;2020-08-02;0;0;0;362.366008612902;341.338819562748;09;703.704828175651
05;2020-08-02;0;0;0;353.376145114279;370.349735405642;19;723.725880519921
05;2020-08-02;0;0;0;218.593559489256;256.539602589476;29;475.133162078732
05;2020-08-02;0;0;0;404.225408693299;360.321910454353;39;764.547319147651
05;2020-08-02;0;0;0;520.067953604221;497.108383964256;49;1017.17633756848
05;2020-08-02;0;0;0;468.146063921917;510.087601910415;59;978.233665832332
05;2020-08-02;0;0;0;340.368470050554;334.366842191253;69;674.735312241807
05;2020-08-02;0;0;0;212.598666888387;192.597753227106;79;405.196420115493
05;2020-08-02;0;0;0;148.727797095705;61.8681715431829;89;210.595968638888
05;2020-08-02;0;0;0;32.9601271090696;10.9909785719784;90;43.9511056810479
05;2020-08-02;0;0;0;3061.43020057959;2935.56979942041;0;5997
06;2020-08-02;0;0;0;42583;42380;09;84963
06;2020-08-02;0;0;0;33369;31925;19;65294
06;2020-08-02;0;0;0;21571;15080;29;36651
06;2020-08-02;0;0;0;21550;16147;39;37697
06;2020-08-02;0;0;0;14193;13939;49;28132
06;2020-08-02;0;0;0;7171;7597;59;14768
06;2020-08-02;0;0;0;3629;4117;69;7746
06;2020-08-02;0;1;1;1577;1457;79;3034
06;2020-08-02;0;0;0;531;474;89;1005
06;2020-08-02;0;0;0;88;93;90;181
06;2020-08-02;0;1;1;146262;133209;0;279471
07;2020-08-02;0;0;0;485;549;09;1034
07;2020-08-02;0;0;0;403;432;19;835
07;2020-08-02;0;0;0;764;841;29;1605
07;2020-08-02;0;0;0;824;928;39;1752
07;2020-08-02;0;0;0;788;1020;49;1808
07;2020-08-02;0;0;0;678;870;59;1548
07;2020-08-02;0;0;0;360;382;69;742
07;2020-08-02;0;0;0;231;190;79;421
07;2020-08-02;0;0;0;114;67;89;181
07;2020-08-02;0;0;0;24;11;90;35
07;2020-08-02;0;0;0;4671;5290;0;9961
08;2020-08-02;0;0;0;2715.22592983026;2997.75551488675;09;5712.98144471701
08;2020-08-02;0;0;0;2778.51901080978;3160.9156459093;19;5939.43465671908
08;2020-08-02;0;0;0;2080.8882988764;1718.16634315323;29;3799.05464202964
08;2020-08-02;0;0;0;2701.8582062647;1896.52641413317;39;4598.38462039786
08;2020-08-02;0;0;0;3151.45861023308;2460.52498233809;49;5611.98359257117
08;2020-08-02;0;0;0;2620.29868333099;2422.23566154656;59;5042.53434487755
08;2020-08-02;0;0;0;1621.44173420671;1438.58325779464;69;3060.02499200135
08;2020-08-02;0;0;0;626.575909335673;526.358467843651;79;1152.93437717932
08;2020-08-02;0;0;0;205.018522985054;140.993639349697;89;346.012162334751
08;2020-08-02;0;0;0;50.0325684687745;20.62259870351;90;70.6551671722846
08;2020-08-02;0;0;0;18551.3174743414;16782.6825256586;0;35334
11;2020-08-02;1;1;2;783071;811785;09;1594856
11;2020-08-02;4;3;7;761456;784653;19;1546109
11;2020-08-02;17;18;35;850145;801772;29;1651917
11;2020-08-02;14;14;28;914360;843488;39;1757848
11;2020-08-02;3;7;10;845609;826202;49;1671811
11;2020-08-02;5;3;8;793566;745070;59;1538636
11;2020-08-02;3;3;6;628649;549192;69;1177841
11;2020-08-02;2;5;7;434606;358356;79;792962
11;2020-08-02;1;3;4;261425;162933;89;424358
11;2020-08-02;1;1;2;89253;32619;90;121872
11;2020-08-02;51;58;109;6362140;5916070;0;12278210
24;2020-08-02;0;0;0;139720;144686;09;284406
24;2020-08-02;0;1;1;152979;161185;19;314164
24;2020-08-02;1;0;1;122237;126536;29;248773
24;2020-08-02;0;0;0;150359;142009;39;292368
24;2020-08-02;0;0;0;161829;158758;49;320587
24;2020-08-02;0;0;0;172552;168011;59;340563
24;2020-08-02;1;0;1;172509;158177;69;330686
24;2020-08-02;1;1;2;129428;110593;79;240021
24;2020-08-02;0;0;0;87342;56882;89;144224
24;2020-08-02;0;0;0;31210;12071;90;43281
24;2020-08-02;3;2;5;1320165;1238908;0;2559073
27;2020-08-02;0;0;0;143373;149679;09;293052
27;2020-08-02;0;0;0;160962;173003;19;333965
27;2020-08-02;2;0;2;133746;142254;29;276000
27;2020-08-02;0;0;0;160004;155407;39;315411
27;2020-08-02;0;1;1;172333;169564;49;341897
27;2020-08-02;0;0;0;189979;183788;59;373767
27;2020-08-02;0;0;0;192591;178206;69;370797
27;2020-08-02;0;2;2;146876;127546;79;274422
27;2020-08-02;1;0;1;96896;61575;89;158471
27;2020-08-02;0;0;0;33148;12109;90;45257
27;2020-08-02;3;3;6;1429908;1353131;0;2783039
28;2020-08-02;1;1;2;180735;186856;09;367591
28;2020-08-02;1;0;1;200125;213621;19;413746
28;2020-08-02;3;1;4;168922;173007;29;341929
28;2020-08-02;1;0;1;196628;188487;39;385115
28;2020-08-02;1;1;2;205396;201699;49;407095
28;2020-08-02;1;0;1;222002;213866;59;435868
28;2020-08-02;0;0;0;224688;203758;69;428446
28;2020-08-02;0;0;0;163192;135543;79;298735
28;2020-08-02;0;0;0;109691;65377;89;175068
28;2020-08-02;0;0;0;37222;12685;90;49907
28;2020-08-02;8;3;11;1708601;1594899;0;3303500
32;2020-08-02;1;0;1;358062;373689;09;731751
32;2020-08-02;2;0;2;387045;406742;19;793787
32;2020-08-02;2;2;4;342304;348587;29;690891
32;2020-08-02;2;0;2;382485;369972;39;752457
32;2020-08-02;0;0;0;382510;376716;49;759226
32;2020-08-02;0;1;1;386937;376527;59;763464
32;2020-08-02;0;1;1;371211;330938;69;702149
32;2020-08-02;0;1;1;250542;201459;79;452001
32;2020-08-02;0;0;0;163399;89786;89;253185
32;2020-08-02;0;0;0;48384;15367;90;63751
32;2020-08-02;7;5;12;3072879;2889783;0;5962662
44;2020-08-02;2;0;2;291525;306839;09;598364
44;2020-08-02;0;0;0;320255;339504;19;659759
44;2020-08-02;1;1;2;302020;314428;29;616448
44;2020-08-02;1;0;1;342222;333292;39;675514
44;2020-08-02;1;0;1;349727;344491;49;694218
44;2020-08-02;0;0;0;381371;373239;59;754610
44;2020-08-02;0;0;0;367165;335850;69;703015
44;2020-08-02;0;1;1;250387;215436;79;465823
44;2020-08-02;1;0;1;170825;105192;89;276017
44;2020-08-02;1;0;1;51248;16731;90;67979
44;2020-08-02;7;2;9;2826745;2685002;0;5511747
52;2020-08-02;0;0;0;213594;223900;09;437494
52;2020-08-02;1;1;2;240818;255197;19;496015
52;2020-08-02;1;2;3;197010;200630;29;397640
52;2020-08-02;2;1;3;231204;224885;39;456089
52;2020-08-02;0;1;1;243874;243418;49;487292
52;2020-08-02;1;1;2;244100;239116;59;483216
52;2020-08-02;0;1;1;241796;221345;69;463141
52;2020-08-02;0;0;0;177805;149903;79;327708
52;2020-08-02;0;0;0;119561;75822;89;195383
52;2020-08-02;0;0;0;42559;15260;90;57819
52;2020-08-02;5;7;12;1952321;1849476;0;3801797
53;2020-08-02;1;0;1;173813;182358;09;356171
53;2020-08-02;1;0;1;202720;214740;19;417460
53;2020-08-02;3;2;5;163116;173196;29;336312
53;2020-08-02;0;0;0;190526;187674;39;378200
53;2020-08-02;1;0;1;212098;212015;49;424113
53;2020-08-02;1;1;2;223699;219176;59;442875
53;2020-08-02;1;1;2;227435;209274;69;436709
53;2020-08-02;0;0;0;169992;140910;79;310902
53;2020-08-02;0;0;0;118117;69883;89;188000
53;2020-08-02;0;0;0;37370;12267;90;49637
53;2020-08-02;8;4;14;1718886;1621493;0;3340379
75;2020-08-02;0;0;0;293104;305291;09;598395
75;2020-08-02;0;0;0;337141;357785;19;694926
75;2020-08-02;1;1;2;295024;300618;29;595642
75;2020-08-02;0;1;1;347871;331233;39;679104
75;2020-08-02;0;0;0;384742;372771;49;757513
75;2020-08-02;0;0;0;413361;390880;59;804241
75;2020-08-02;0;0;0;425623;384060;69;809683
75;2020-08-02;0;1;1;325086;276298;79;601384
75;2020-08-02;0;0;0;213986;139308;89;353294
75;2020-08-02;0;1;1;77600;28200;90;105800
75;2020-08-02;1;4;5;3113538;2886444;0;5999982
76;2020-08-02;0;1;1;305956;318589;09;624545
76;2020-08-02;0;0;0;338942;356969;19;695911
76;2020-08-02;2;3;5;316210;319570;29;635780
76;2020-08-02;3;1;4;356758;337587;39;694345
76;2020-08-02;1;1;2;376541;363812;49;740353
76;2020-08-02;3;1;4;402608;383750;59;786358
76;2020-08-02;0;0;0;394889;358997;69;753886
76;2020-08-02;0;0;0;308664;263806;79;572470
76;2020-08-02;0;0;0;195838;129272;89;325110
76;2020-08-02;0;0;0;69372;26728;90;96100
76;2020-08-02;9;7;16;3065778;2859080;0;5924858
84;2020-08-02;0;0;0;459549;481088;09;940637
84;2020-08-02;0;0;0;487711;511905;19;999616
84;2020-08-02;1;1;2;443824;451094;29;894918
84;2020-08-02;0;4;4;512522;493262;39;1005784
84;2020-08-02;0;0;0;520248;515106;49;1035354
84;2020-08-02;0;1;1;529611;514848;59;1044459
84;2020-08-02;2;0;2;486720;439940;69;926660
84;2020-08-02;0;3;3;372151;315211;79;687362
84;2020-08-02;0;0;0;237198;150524;89;387722
84;2020-08-02;0;0;0;81185;28680;90;109865
84;2020-08-02;3;9;12;4130719;3901658;0;8032377
93;2020-08-02;0;0;0;268834;283093;09;551927
93;2020-08-02;0;0;0;280751;296087;19;576838
93;2020-08-02;5;2;7;254404;255552;29;509956
93;2020-08-02;2;0;2;310704;288398;39;599102
93;2020-08-02;0;1;1;325559;305827;49;631386
93;2020-08-02;2;0;2;353104;325389;59;678493
93;2020-08-02;1;1;2;336327;296459;69;632786
93;2020-08-02;0;0;0;279820;229699;79;509519
93;2020-08-02;0;1;1;171274;113716;89;284990
93;2020-08-02;0;0;0;58896;21758;90;80654
93;2020-08-02;11;5;16;2639673;2415978;0;5055651
94;2020-08-02;0;0;0;16311;17433;09;33744
94;2020-08-02;0;0;0;16679;18132;19;34811
94;2020-08-02;0;0;0;16782;16579;29;33361
94;2020-08-02;1;0;1;23044;20580;39;43624
94;2020-08-02;0;0;0;23065;22140;49;45205
94;2020-08-02;0;0;0;24549;23421;59;47970
94;2020-08-02;0;0;0;23212;21883;69;45095
94;2020-08-02;0;0;0;19544;17141;79;36685
94;2020-08-02;0;0;0;11227;8178;89;19405
94;2020-08-02;0;0;0;3332;1447;90;4779
94;2020-08-02;1;0;1;177745;166934;0;344679
01;2020-08-03;0;0;0;19979;20155;09;40134
01;2020-08-03;0;1;1;24994;25489;19;50483
01;2020-08-03;1;2;3;17868;16690;29;34558
01;2020-08-03;1;1;2;22328;14821;39;37149
01;2020-08-03;0;1;1;28652;20276;49;48928
01;2020-08-03;0;0;0;33264;27260;59;60524
01;2020-08-03;0;1;1;27135;23978;69;51113
01;2020-08-03;0;0;0;18401;14661;79;33062
01;2020-08-03;0;0;0;9633;6375;89;16008
01;2020-08-03;0;0;0;3410;1510;90;4920
01;2020-08-03;2;6;8;205664;171215;0;376879
02;2020-08-03;0;1;1;16881;17110;09;33991
02;2020-08-03;2;1;3;21410;21604;19;43014
02;2020-08-03;0;0;0;16017;15479;29;31496
02;2020-08-03;1;2;3;19825;14455;39;34280
02;2020-08-03;0;1;1;24719;18248;49;42967
02;2020-08-03;0;1;1;34361;28310;59;62671
02;2020-08-03;0;0;0;28061;24495;69;52556
02;2020-08-03;2;0;2;18231;15278;79;33509
02;2020-08-03;0;0;0;11090;7677;89;18767
02;2020-08-03;0;0;0;3992;1506;90;5498
02;2020-08-03;5;6;11;194587;164162;0;358749
03;2020-08-03;2;3;5;31123;30920;09;62043
03;2020-08-03;3;6;9;29370;29268;19;58638
03;2020-08-03;7;4;11;21458;18963;29;40421
03;2020-08-03;10;2;12;21276;18326;39;39602
03;2020-08-03;6;6;12;18164;16593;49;34757
03;2020-08-03;1;2;3;13469;13557;59;27026
03;2020-08-03;3;1;4;8776;8670;69;17446
03;2020-08-03;0;0;0;3777;3591;79;7368
03;2020-08-03;1;0;1;1649;1072;89;2721
03;2020-08-03;0;0;0;485;184;90;669
03;2020-08-03;33;24;57;149547;141144;0;290691
04;2020-08-03;0;0;0;60314;61377;09;121691
04;2020-08-03;0;2;2;66065;68387;19;134452
04;2020-08-03;1;1;2;51059;47156;29;98215
04;2020-08-03;1;0;1;58788;45780;39;104568
04;2020-08-03;0;0;0;61408;52207;49;113615
04;2020-08-03;0;0;0;64838;60759;59;125597
04;2020-08-03;1;0;1;47008;42843;69;89851
04;2020-08-03;0;0;0;25509;21184;79;46693
04;2020-08-03;0;0;0;13168;7647;89;20815
04;2020-08-03;0;0;0;3209;1253;90;4462
04;2020-08-03;3;3;6;451366;408593;0;859959
05;2020-08-03;0;0;0;362.366008612902;341.338819562748;09;703.704828175651
05;2020-08-03;0;0;0;353.376145114279;370.349735405642;19;723.725880519921
05;2020-08-03;0;0;0;218.593559489256;256.539602589476;29;475.133162078732
05;2020-08-03;0;0;0;404.225408693299;360.321910454353;39;764.547319147651
05;2020-08-03;0;0;0;520.067953604221;497.108383964256;49;1017.17633756848
05;2020-08-03;0;0;0;468.146063921917;510.087601910415;59;978.233665832332
05;2020-08-03;0;0;0;340.368470050554;334.366842191253;69;674.735312241807
05;2020-08-03;0;0;0;212.598666888387;192.597753227106;79;405.196420115493
05;2020-08-03;0;0;0;148.727797095705;61.8681715431829;89;210.595968638888
05;2020-08-03;0;0;0;32.9601271090696;10.9909785719784;90;43.9511056810479
05;2020-08-03;0;0;0;3061.43020057959;2935.56979942041;0;5997
06;2020-08-03;0;0;0;42583;42380;09;84963
06;2020-08-03;1;2;3;33369;31925;19;65294
06;2020-08-03;0;2;2;21571;15080;29;36651
06;2020-08-03;1;3;4;21550;16147;39;37697
06;2020-08-03;2;1;3;14193;13939;49;28132
06;2020-08-03;2;2;4;7171;7597;59;14768
06;2020-08-03;0;1;1;3629;4117;69;7746
06;2020-08-03;0;0;0;1577;1457;79;3034
06;2020-08-03;0;0;0;531;474;89;1005
06;2020-08-03;0;0;0;88;93;90;181
06;2020-08-03;6;11;17;146262;133209;0;279471
07;2020-08-03;0;0;0;485;549;09;1034
07;2020-08-03;0;0;0;403;432;19;835
07;2020-08-03;0;1;1;764;841;29;1605
07;2020-08-03;0;0;0;824;928;39;1752
07;2020-08-03;0;0;0;788;1020;49;1808
07;2020-08-03;0;0;0;678;870;59;1548
07;2020-08-03;0;0;0;360;382;69;742
07;2020-08-03;0;0;0;231;190;79;421
07;2020-08-03;0;0;0;114;67;89;181
07;2020-08-03;0;0;0;24;11;90;35
07;2020-08-03;0;1;1;4671;5290;0;9961
08;2020-08-03;0;0;0;2715.22592983026;2997.75551488675;09;5712.98144471701
08;2020-08-03;0;0;0;2778.51901080978;3160.9156459093;19;5939.43465671908
08;2020-08-03;0;0;0;2080.8882988764;1718.16634315323;29;3799.05464202964
08;2020-08-03;2;0;2;2701.8582062647;1896.52641413317;39;4598.38462039786
08;2020-08-03;3;0;3;3151.45861023308;2460.52498233809;49;5611.98359257117
08;2020-08-03;0;0;0;2620.29868333099;2422.23566154656;59;5042.53434487755
08;2020-08-03;0;0;0;1621.44173420671;1438.58325779464;69;3060.02499200135
08;2020-08-03;0;0;0;626.575909335673;526.358467843651;79;1152.93437717932
08;2020-08-03;0;0;0;205.018522985054;140.993639349697;89;346.012162334751
08;2020-08-03;0;0;0;50.0325684687745;20.62259870351;90;70.6551671722846
08;2020-08-03;5;0;5;18551.3174743414;16782.6825256586;0;35334
11;2020-08-03;12;15;28;783071;811785;09;1594856
11;2020-08-03;32;28;61;761456;784653;19;1546109
11;2020-08-03;102;111;213;850145;801772;29;1651917
11;2020-08-03;77;65;142;914360;843488;39;1757848
11;2020-08-03;51;46;97;845609;826202;49;1671811
11;2020-08-03;32;24;57;793566;745070;59;1538636
11;2020-08-03;23;30;53;628649;549192;69;1177841
11;2020-08-03;12;17;29;434606;358356;79;792962
11;2020-08-03;11;1;12;261425;162933;89;424358
11;2020-08-03;3;4;7;89253;32619;90;121872
11;2020-08-03;356;341;702;6362140;5916070;0;12278210
24;2020-08-03;1;1;2;139720;144686;09;284406
24;2020-08-03;3;4;7;152979;161185;19;314164
24;2020-08-03;13;2;15;122237;126536;29;248773
24;2020-08-03;2;4;6;150359;142009;39;292368
24;2020-08-03;4;2;6;161829;158758;49;320587
24;2020-08-03;0;0;0;172552;168011;59;340563
24;2020-08-03;3;1;4;172509;158177;69;330686
24;2020-08-03;1;0;1;129428;110593;79;240021
24;2020-08-03;0;0;0;87342;56882;89;144224
24;2020-08-03;0;0;0;31210;12071;90;43281
24;2020-08-03;27;14;41;1320165;1238908;0;2559073
27;2020-08-03;0;1;1;143373;149679;09;293052
27;2020-08-03;2;0;2;160962;173003;19;333965
27;2020-08-03;2;3;5;133746;142254;29;276000
27;2020-08-03;1;7;8;160004;155407;39;315411
27;2020-08-03;5;1;6;172333;169564;49;341897
27;2020-08-03;1;1;2;189979;183788;59;373767
27;2020-08-03;2;2;4;192591;178206;69;370797
27;2020-08-03;0;2;2;146876;127546;79;274422
27;2020-08-03;0;0;0;96896;61575;89;158471
27;2020-08-03;1;0;1;33148;12109;90;45257
27;2020-08-03;14;17;31;1429908;1353131;0;2783039
28;2020-08-03;0;0;0;180735;186856;09;367591
28;2020-08-03;7;3;10;200125;213621;19;413746
28;2020-08-03;4;4;8;168922;173007;29;341929
28;2020-08-03;2;3;5;196628;188487;39;385115
28;2020-08-03;0;1;1;205396;201699;49;407095
28;2020-08-03;3;0;3;222002;213866;59;435868
28;2020-08-03;0;0;0;224688;203758;69;428446
28;2020-08-03;0;0;0;163192;135543;79;298735
28;2020-08-03;0;0;0;109691;65377;89;175068
28;2020-08-03;0;0;0;37222;12685;90;49907
28;2020-08-03;16;11;27;1708601;1594899;0;3303500
32;2020-08-03;7;10;18;358062;373689;09;731751
32;2020-08-03;18;11;29;387045;406742;19;793787
32;2020-08-03;32;18;50;342304;348587;29;690891
32;2020-08-03;16;12;28;382485;369972;39;752457
32;2020-08-03;19;14;34;382510;376716;49;759226
32;2020-08-03;9;7;16;386937;376527;59;763464
32;2020-08-03;5;5;10;371211;330938;69;702149
32;2020-08-03;5;10;15;250542;201459;79;452001
32;2020-08-03;2;2;4;163399;89786;89;253185
32;2020-08-03;2;1;3;48384;15367;90;63751
32;2020-08-03;115;90;207;3072879;2889783;0;5962662
44;2020-08-03;3;4;7;291525;306839;09;598364
44;2020-08-03;6;8;14;320255;339504;19;659759
44;2020-08-03;22;15;37;302020;314428;29;616448
44;2020-08-03;7;5;12;342222;333292;39;675514
44;2020-08-03;4;7;11;349727;344491;49;694218
44;2020-08-03;7;5;12;381371;373239;59;754610
44;2020-08-03;3;2;5;367165;335850;69;703015
44;2020-08-03;1;4;5;250387;215436;79;465823
44;2020-08-03;1;1;2;170825;105192;89;276017
44;2020-08-03;1;1;2;51248;16731;90;67979
44;2020-08-03;55;52;107;2826745;2685002;0;5511747
52;2020-08-03;0;2;2;213594;223900;09;437494
52;2020-08-03;9;4;13;240818;255197;19;496015
52;2020-08-03;10;13;23;197010;200630;29;397640
52;2020-08-03;9;6;15;231204;224885;39;456089
52;2020-08-03;1;4;5;243874;243418;49;487292
52;2020-08-03;1;5;6;244100;239116;59;483216
52;2020-08-03;2;4;6;241796;221345;69;463141
52;2020-08-03;6;1;7;177805;149903;79;327708
52;2020-08-03;0;2;2;119561;75822;89;195383
52;2020-08-03;2;3;5;42559;15260;90;57819
52;2020-08-03;40;44;84;1952321;1849476;0;3801797
53;2020-08-03;1;4;5;173813;182358;09;356171
53;2020-08-03;3;8;11;202720;214740;19;417460
53;2020-08-03;9;5;14;163116;173196;29;336312
53;2020-08-03;10;8;18;190526;187674;39;378200
53;2020-08-03;4;2;6;212098;212015;49;424113
53;2020-08-03;6;8;14;223699;219176;59;442875
53;2020-08-03;2;1;3;227435;209274;69;436709
53;2020-08-03;0;2;2;169992;140910;79;310902
53;2020-08-03;2;2;4;118117;69883;89;188000
53;2020-08-03;1;0;1;37370;12267;90;49637
53;2020-08-03;39;40;79;1718886;1621493;0;3340379
75;2020-08-03;0;0;1;293104;305291;09;598395
75;2020-08-03;2;0;2;337141;357785;19;694926
75;2020-08-03;6;10;16;295024;300618;29;595642
75;2020-08-03;4;3;7;347871;331233;39;679104
75;2020-08-03;2;0;2;384742;372771;49;757513
75;2020-08-03;3;1;4;413361;390880;59;804241
75;2020-08-03;6;2;8;425623;384060;69;809683
75;2020-08-03;1;1;2;325086;276298;79;601384
75;2020-08-03;0;0;0;213986;139308;89;353294
75;2020-08-03;0;0;0;77600;28200;90;105800
75;2020-08-03;24;17;42;3113538;2886444;0;5999982
76;2020-08-03;0;2;2;305956;318589;09;624545
76;2020-08-03;8;22;30;338942;356969;19;695911
76;2020-08-03;24;24;48;316210;319570;29;635780
76;2020-08-03;11;13;24;356758;337587;39;694345
76;2020-08-03;8;7;15;376541;363812;49;740353
76;2020-08-03;3;5;8;402608;383750;59;786358
76;2020-08-03;3;2;5;394889;358997;69;753886
76;2020-08-03;1;3;4;308664;263806;79;572470
76;2020-08-03;1;0;1;195838;129272;89;325110
76;2020-08-03;0;0;0;69372;26728;90;96100
76;2020-08-03;60;78;138;3065778;2859080;0;5924858
84;2020-08-03;4;5;9;459549;481088;09;940637
84;2020-08-03;12;9;21;487711;511905;19;999616
84;2020-08-03;20;17;37;443824;451094;29;894918
84;2020-08-03;12;19;31;512522;493262;39;1005784
84;2020-08-03;13;7;20;520248;515106;49;1035354
84;2020-08-03;5;4;9;529611;514848;59;1044459
84;2020-08-03;4;3;7;486720;439940;69;926660
84;2020-08-03;3;4;7;372151;315211;79;687362
84;2020-08-03;1;0;1;237198;150524;89;387722
84;2020-08-03;3;0;3;81185;28680;90;109865
84;2020-08-03;77;68;145;4130719;3901658;0;8032377
93;2020-08-03;5;1;6;268834;283093;09;551927
93;2020-08-03;19;13;33;280751;296087;19;576838
93;2020-08-03;53;47;100;254404;255552;29;509956
93;2020-08-03;23;37;60;310704;288398;39;599102
93;2020-08-03;21;14;35;325559;305827;49;631386
93;2020-08-03;15;19;34;353104;325389;59;678493
93;2020-08-03;7;12;19;336327;296459;69;632786
93;2020-08-03;4;4;8;279820;229699;79;509519
93;2020-08-03;1;2;3;171274;113716;89;284990
93;2020-08-03;0;0;0;58896;21758;90;80654
93;2020-08-03;148;149;298;2639673;2415978;0;5055651
94;2020-08-03;0;0;0;16311;17433;09;33744
94;2020-08-03;0;0;0;16679;18132;19;34811
94;2020-08-03;0;3;3;16782;16579;29;33361
94;2020-08-03;0;0;0;23044;20580;39;43624
94;2020-08-03;0;0;0;23065;22140;49;45205
94;2020-08-03;0;0;0;24549;23421;59;47970
94;2020-08-03;0;0;0;23212;21883;69;45095
94;2020-08-03;0;0;0;19544;17141;79;36685
94;2020-08-03;0;0;0;11227;8178;89;19405
94;2020-08-03;0;0;0;3332;1447;90;4779
94;2020-08-03;0;3;3;177745;166934;0;344679
01;2020-08-04;0;0;0;19979;20155;09;40134
01;2020-08-04;1;0;1;24994;25489;19;50483
01;2020-08-04;0;2;2;17868;16690;29;34558
01;2020-08-04;0;0;0;22328;14821;39;37149
01;2020-08-04;0;0;0;28652;20276;49;48928
01;2020-08-04;1;0;1;33264;27260;59;60524
01;2020-08-04;0;0;0;27135;23978;69;51113
01;2020-08-04;0;0;0;18401;14661;79;33062
01;2020-08-04;0;0;0;9633;6375;89;16008
01;2020-08-04;0;0;0;3410;1510;90;4920
01;2020-08-04;2;2;4;205664;171215;0;376879
02;2020-08-04;0;2;2;16881;17110;09;33991
02;2020-08-04;1;2;3;21410;21604;19;43014
02;2020-08-04;4;1;5;16017;15479;29;31496
02;2020-08-04;4;2;6;19825;14455;39;34280
02;2020-08-04;2;1;3;24719;18248;49;42967
02;2020-08-04;2;3;5;34361;28310;59;62671
02;2020-08-04;1;1;2;28061;24495;69;52556
02;2020-08-04;0;2;2;18231;15278;79;33509
02;2020-08-04;0;0;0;11090;7677;89;18767
02;2020-08-04;0;0;0;3992;1506;90;5498
02;2020-08-04;14;14;28;194587;164162;0;358749
03;2020-08-04;3;1;5;31123;30920;09;62043
03;2020-08-04;10;7;18;29370;29268;19;58638
03;2020-08-04;16;5;22;21458;18963;29;40421
03;2020-08-04;9;9;19;21276;18326;39;39602
03;2020-08-04;10;5;15;18164;16593;49;34757
03;2020-08-04;4;1;5;13469;13557;59;27026
03;2020-08-04;2;3;6;8776;8670;69;17446
03;2020-08-04;0;1;1;3777;3591;79;7368
03;2020-08-04;0;0;0;1649;1072;89;2721
03;2020-08-04;0;0;0;485;184;90;669
03;2020-08-04;54;32;91;149547;141144;0;290691
04;2020-08-04;0;0;0;60314;61377;09;121691
04;2020-08-04;1;1;2;66065;68387;19;134452
04;2020-08-04;0;0;0;51059;47156;29;98215
04;2020-08-04;0;0;0;58788;45780;39;104568
04;2020-08-04;0;0;0;61408;52207;49;113615
04;2020-08-04;1;0;1;64838;60759;59;125597
04;2020-08-04;0;0;0;47008;42843;69;89851
04;2020-08-04;0;0;0;25509;21184;79;46693
04;2020-08-04;0;0;0;13168;7647;89;20815
04;2020-08-04;0;0;0;3209;1253;90;4462
04;2020-08-04;2;1;3;451366;408593;0;859959
05;2020-08-04;0;0;0;362.366008612902;341.338819562748;09;703.704828175651
05;2020-08-04;0;0;0;353.376145114279;370.349735405642;19;723.725880519921
05;2020-08-04;0;0;0;218.593559489256;256.539602589476;29;475.133162078732
05;2020-08-04;0;0;0;404.225408693299;360.321910454353;39;764.547319147651
05;2020-08-04;0;0;0;520.067953604221;497.108383964256;49;1017.17633756848
05;2020-08-04;0;0;0;468.146063921917;510.087601910415;59;978.233665832332
05;2020-08-04;0;0;0;340.368470050554;334.366842191253;69;674.735312241807
05;2020-08-04;0;0;0;212.598666888387;192.597753227106;79;405.196420115493
05;2020-08-04;0;0;0;148.727797095705;61.8681715431829;89;210.595968638888
05;2020-08-04;0;0;0;32.9601271090696;10.9909785719784;90;43.9511056810479
05;2020-08-04;0;0;0;3061.43020057959;2935.56979942041;0;5997
06;2020-08-04;0;0;0;42583;42380;09;84963
06;2020-08-04;0;1;1;33369;31925;19;65294
06;2020-08-04;4;3;7;21571;15080;29;36651
06;2020-08-04;0;0;0;21550;16147;39;37697
06;2020-08-04;0;1;1;14193;13939;49;28132
06;2020-08-04;2;0;2;7171;7597;59;14768
06;2020-08-04;0;0;0;3629;4117;69;7746
06;2020-08-04;0;0;0;1577;1457;79;3034
06;2020-08-04;0;0;0;531;474;89;1005
06;2020-08-04;0;0;0;88;93;90;181
06;2020-08-04;6;5;11;146262;133209;0;279471
07;2020-08-04;0;0;0;485;549;09;1034
07;2020-08-04;0;0;0;403;432;19;835
07;2020-08-04;0;0;0;764;841;29;1605
07;2020-08-04;0;0;0;824;928;39;1752
07;2020-08-04;0;0;0;788;1020;49;1808
07;2020-08-04;0;0;0;678;870;59;1548
07;2020-08-04;0;0;0;360;382;69;742
07;2020-08-04;0;0;0;231;190;79;421
07;2020-08-04;0;0;0;114;67;89;181
07;2020-08-04;0;0;0;24;11;90;35
07;2020-08-04;0;0;0;4671;5290;0;9961
08;2020-08-04;1;0;1;2715.22592983026;2997.75551488675;09;5712.98144471701
08;2020-08-04;0;0;0;2778.51901080978;3160.9156459093;19;5939.43465671908
08;2020-08-04;0;0;0;2080.8882988764;1718.16634315323;29;3799.05464202964
08;2020-08-04;0;0;0;2701.8582062647;1896.52641413317;39;4598.38462039786
08;2020-08-04;0;0;0;3151.45861023308;2460.52498233809;49;5611.98359257117
08;2020-08-04;1;1;2;2620.29868333099;2422.23566154656;59;5042.53434487755
08;2020-08-04;0;0;0;1621.44173420671;1438.58325779464;69;3060.02499200135
08;2020-08-04;0;0;0;626.575909335673;526.358467843651;79;1152.93437717932
08;2020-08-04;0;0;0;205.018522985054;140.993639349697;89;346.012162334751
08;2020-08-04;0;0;0;50.0325684687745;20.62259870351;90;70.6551671722846
08;2020-08-04;2;1;3;18551.3174743414;16782.6825256586;0;35334
11;2020-08-04;13;9;23;783071;811785;09;1594856
11;2020-08-04;28;26;55;761456;784653;19;1546109
11;2020-08-04;118;113;232;850145;801772;29;1651917
11;2020-08-04;77;84;161;914360;843488;39;1757848
11;2020-08-04;47;44;91;845609;826202;49;1671811
11;2020-08-04;40;42;82;793566;745070;59;1538636
11;2020-08-04;32;16;48;628649;549192;69;1177841
11;2020-08-04;11;16;27;434606;358356;79;792962
11;2020-08-04;10;6;16;261425;162933;89;424358
11;2020-08-04;8;3;11;89253;32619;90;121872
11;2020-08-04;384;360;751;6362140;5916070;0;12278210
24;2020-08-04;0;0;0;139720;144686;09;284406
24;2020-08-04;3;3;6;152979;161185;19;314164
24;2020-08-04;4;3;7;122237;126536;29;248773
24;2020-08-04;4;3;7;150359;142009;39;292368
24;2020-08-04;6;3;9;161829;158758;49;320587
24;2020-08-04;1;4;5;172552;168011;59;340563
24;2020-08-04;0;0;0;172509;158177;69;330686
24;2020-08-04;1;4;5;129428;110593;79;240021
24;2020-08-04;0;0;0;87342;56882;89;144224
24;2020-08-04;0;0;0;31210;12071;90;43281
24;2020-08-04;19;20;39;1320165;1238908;0;2559073
27;2020-08-04;0;1;1;143373;149679;09;293052
27;2020-08-04;1;0;1;160962;173003;19;333965
27;2020-08-04;1;4;5;133746;142254;29;276000
27;2020-08-04;2;3;5;160004;155407;39;315411
27;2020-08-04;1;0;1;172333;169564;49;341897
27;2020-08-04;0;1;1;189979;183788;59;373767
27;2020-08-04;0;1;1;192591;178206;69;370797
27;2020-08-04;1;0;1;146876;127546;79;274422
27;2020-08-04;2;0;2;96896;61575;89;158471
27;2020-08-04;0;0;0;33148;12109;90;45257
27;2020-08-04;8;10;18;1429908;1353131;0;2783039
28;2020-08-04;3;0;3;180735;186856;09;367591
28;2020-08-04;7;1;8;200125;213621;19;413746
28;2020-08-04;3;1;4;168922;173007;29;341929
28;2020-08-04;0;2;2;196628;188487;39;385115
28;2020-08-04;1;6;7;205396;201699;49;407095
28;2020-08-04;0;0;0;222002;213866;59;435868
28;2020-08-04;2;2;4;224688;203758;69;428446
28;2020-08-04;1;0;1;163192;135543;79;298735
28;2020-08-04;1;0;1;109691;65377;89;175068
28;2020-08-04;1;0;1;37222;12685;90;49907
28;2020-08-04;19;12;31;1708601;1594899;0;3303500
32;2020-08-04;6;0;6;358062;373689;09;731751
32;2020-08-04;7;7;14;387045;406742;19;793787
32;2020-08-04;17;16;33;342304;348587;29;690891
32;2020-08-04;14;20;34;382485;369972;39;752457
32;2020-08-04;8;9;17;382510;376716;49;759226
32;2020-08-04;8;8;16;386937;376527;59;763464
32;2020-08-04;8;3;11;371211;330938;69;702149
32;2020-08-04;3;6;9;250542;201459;79;452001
32;2020-08-04;4;3;7;163399;89786;89;253185
32;2020-08-04;1;2;3;48384;15367;90;63751
32;2020-08-04;76;74;150;3072879;2889783;0;5962662
44;2020-08-04;1;2;3;291525;306839;09;598364
44;2020-08-04;2;3;5;320255;339504;19;659759
44;2020-08-04;13;13;26;302020;314428;29;616448
44;2020-08-04;5;9;14;342222;333292;39;675514
44;2020-08-04;4;7;11;349727;344491;49;694218
44;2020-08-04;9;4;13;381371;373239;59;754610
44;2020-08-04;4;3;7;367165;335850;69;703015
44;2020-08-04;1;4;5;250387;215436;79;465823
44;2020-08-04;1;1;2;170825;105192;89;276017
44;2020-08-04;0;1;1;51248;16731;90;67979
44;2020-08-04;40;47;87;2826745;2685002;0;5511747
52;2020-08-04;3;7;11;213594;223900;09;437494
52;2020-08-04;6;0;6;240818;255197;19;496015
52;2020-08-04;16;13;29;197010;200630;29;397640
52;2020-08-04;11;6;17;231204;224885;39;456089
52;2020-08-04;7;7;14;243874;243418;49;487292
52;2020-08-04;2;5;7;244100;239116;59;483216
52;2020-08-04;0;1;1;241796;221345;69;463141
52;2020-08-04;5;0;5;177805;149903;79;327708
52;2020-08-04;5;2;7;119561;75822;89;195383
52;2020-08-04;2;1;3;42559;15260;90;57819
52;2020-08-04;57;42;100;1952321;1849476;0;3801797
53;2020-08-04;3;6;9;173813;182358;09;356171
53;2020-08-04;3;3;6;202720;214740;19;417460
53;2020-08-04;9;11;20;163116;173196;29;336312
53;2020-08-04;6;7;13;190526;187674;39;378200
53;2020-08-04;6;3;9;212098;212015;49;424113
53;2020-08-04;2;5;7;223699;219176;59;442875
53;2020-08-04;4;2;6;227435;209274;69;436709
53;2020-08-04;2;1;3;169992;140910;79;310902
53;2020-08-04;1;2;3;118117;69883;89;188000
53;2020-08-04;0;0;0;37370;12267;90;49637
53;2020-08-04;36;40;76;1718886;1621493;0;3340379
75;2020-08-04;2;1;3;293104;305291;09;598395
75;2020-08-04;1;1;2;337141;357785;19;694926
75;2020-08-04;5;6;11;295024;300618;29;595642
75;2020-08-04;0;6;6;347871;331233;39;679104
75;2020-08-04;4;2;6;384742;372771;49;757513
75;2020-08-04;2;2;4;413361;390880;59;804241
75;2020-08-04;2;0;2;425623;384060;69;809683
75;2020-08-04;3;0;3;325086;276298;79;601384
75;2020-08-04;1;3;4;213986;139308;89;353294
75;2020-08-04;0;0;0;77600;28200;90;105800
75;2020-08-04;20;21;41;3113538;2886444;0;5999982
76;2020-08-04;5;0;5;305956;318589;09;624545
76;2020-08-04;9;9;18;338942;356969;19;695911
76;2020-08-04;25;18;43;316210;319570;29;635780
76;2020-08-04;7;11;18;356758;337587;39;694345
76;2020-08-04;7;9;16;376541;363812;49;740353
76;2020-08-04;6;8;14;402608;383750;59;786358
76;2020-08-04;5;5;10;394889;358997;69;753886
76;2020-08-04;4;4;8;308664;263806;79;572470
76;2020-08-04;1;2;3;195838;129272;89;325110
76;2020-08-04;0;0;0;69372;26728;90;96100
76;2020-08-04;69;66;135;3065778;2859080;0;5924858
84;2020-08-04;5;2;7;459549;481088;09;940637
84;2020-08-04;9;4;13;487711;511905;19;999616
84;2020-08-04;24;13;37;443824;451094;29;894918
84;2020-08-04;11;12;23;512522;493262;39;1005784
84;2020-08-04;11;9;20;520248;515106;49;1035354
84;2020-08-04;12;6;18;529611;514848;59;1044459
84;2020-08-04;9;4;13;486720;439940;69;926660
84;2020-08-04;3;5;8;372151;315211;79;687362
84;2020-08-04;3;3;6;237198;150524;89;387722
84;2020-08-04;1;1;2;81185;28680;90;109865
84;2020-08-04;88;59;147;4130719;3901658;0;8032377
93;2020-08-04;5;4;9;268834;283093;09;551927
93;2020-08-04;15;20;35;280751;296087;19;576838
93;2020-08-04;45;45;90;254404;255552;29;509956
93;2020-08-04;28;33;61;310704;288398;39;599102
93;2020-08-04;17;14;31;325559;305827;49;631386
93;2020-08-04;15;14;29;353104;325389;59;678493
93;2020-08-04;7;8;15;336327;296459;69;632786
93;2020-08-04;5;6;11;279820;229699;79;509519
93;2020-08-04;3;2;5;171274;113716;89;284990
93;2020-08-04;1;0;1;58896;21758;90;80654
93;2020-08-04;141;146;287;2639673;2415978;0;5055651
94;2020-08-04;0;0;0;16311;17433;09;33744
94;2020-08-04;0;0;0;16679;18132;19;34811
94;2020-08-04;2;1;3;16782;16579;29;33361
94;2020-08-04;0;0;0;23044;20580;39;43624
94;2020-08-04;1;0;1;23065;22140;49;45205
94;2020-08-04;0;1;1;24549;23421;59;47970
94;2020-08-04;0;1;1;23212;21883;69;45095
94;2020-08-04;0;0;0;19544;17141;79;36685
94;2020-08-04;0;0;0;11227;8178;89;19405
94;2020-08-04;0;0;0;3332;1447;90;4779
94;2020-08-04;3;3;6;177745;166934;0;344679
01;2020-08-05;0;0;0;19979;20155;09;40134
01;2020-08-05;0;0;0;24994;25489;19;50483
01;2020-08-05;0;1;1;17868;16690;29;34558
01;2020-08-05;0;1;1;22328;14821;39;37149
01;2020-08-05;0;0;0;28652;20276;49;48928
01;2020-08-05;1;0;1;33264;27260;59;60524
01;2020-08-05;0;0;0;27135;23978;69;51113
01;2020-08-05;0;0;0;18401;14661;79;33062
01;2020-08-05;0;0;0;9633;6375;89;16008
01;2020-08-05;0;0;0;3410;1510;90;4920
01;2020-08-05;1;2;3;205664;171215;0;376879
02;2020-08-05;0;0;0;16881;17110;09;33991
02;2020-08-05;2;1;3;21410;21604;19;43014
02;2020-08-05;0;0;0;16017;15479;29;31496
02;2020-08-05;2;0;2;19825;14455;39;34280
02;2020-08-05;1;0;1;24719;18248;49;42967
02;2020-08-05;2;0;2;34361;28310;59;62671
02;2020-08-05;1;1;2;28061;24495;69;52556
02;2020-08-05;0;0;0;18231;15278;79;33509
02;2020-08-05;0;0;0;11090;7677;89;18767
02;2020-08-05;0;0;0;3992;1506;90;5498
02;2020-08-05;8;2;10;194587;164162;0;358749
03;2020-08-05;7;2;9;31123;30920;09;62043
03;2020-08-05;7;6;14;29370;29268;19;58638
03;2020-08-05;2;4;6;21458;18963;29;40421
03;2020-08-05;4;4;8;21276;18326;39;39602
03;2020-08-05;2;2;4;18164;16593;49;34757
03;2020-08-05;2;1;3;13469;13557;59;27026
03;2020-08-05;2;1;3;8776;8670;69;17446
03;2020-08-05;0;0;0;3777;3591;79;7368
03;2020-08-05;1;0;1;1649;1072;89;2721
03;2020-08-05;0;0;0;485;184;90;669
03;2020-08-05;27;20;48;149547;141144;0;290691
04;2020-08-05;0;0;0;60314;61377;09;121691
04;2020-08-05;2;0;2;66065;68387;19;134452
04;2020-08-05;0;1;1;51059;47156;29;98215
04;2020-08-05;0;0;0;58788;45780;39;104568
04;2020-08-05;0;0;0;61408;52207;49;113615
04;2020-08-05;0;0;0;64838;60759;59;125597
04;2020-08-05;0;0;0;47008;42843;69;89851
04;2020-08-05;0;0;0;25509;21184;79;46693
04;2020-08-05;0;0;0;13168;7647;89;20815
04;2020-08-05;0;0;0;3209;1253;90;4462
04;2020-08-05;2;1;3;451366;408593;0;859959
05;2020-08-05;0;0;0;362.366008612902;341.338819562748;09;703.704828175651
05;2020-08-05;0;0;0;353.376145114279;370.349735405642;19;723.725880519921
05;2020-08-05;0;0;0;218.593559489256;256.539602589476;29;475.133162078732
05;2020-08-05;0;0;0;404.225408693299;360.321910454353;39;764.547319147651
05;2020-08-05;0;0;0;520.067953604221;497.108383964256;49;1017.17633756848
05;2020-08-05;0;0;0;468.146063921917;510.087601910415;59;978.233665832332
05;2020-08-05;0;0;0;340.368470050554;334.366842191253;69;674.735312241807
05;2020-08-05;0;0;0;212.598666888387;192.597753227106;79;405.196420115493
05;2020-08-05;0;0;0;148.727797095705;61.8681715431829;89;210.595968638888
05;2020-08-05;0;0;0;32.9601271090696;10.9909785719784;90;43.9511056810479
05;2020-08-05;0;0;0;3061.43020057959;2935.56979942041;0;5997
06;2020-08-05;0;0;0;42583;42380;09;84963
06;2020-08-05;0;1;1;33369;31925;19;65294
06;2020-08-05;0;1;1;21571;15080;29;36651
06;2020-08-05;4;1;5;21550;16147;39;37697
06;2020-08-05;1;4;5;14193;13939;49;28132
06;2020-08-05;3;1;4;7171;7597;59;14768
06;2020-08-05;2;0;2;3629;4117;69;7746
06;2020-08-05;0;0;0;1577;1457;79;3034
06;2020-08-05;0;0;0;531;474;89;1005
06;2020-08-05;0;0;0;88;93;90;181
06;2020-08-05;10;8;18;146262;133209;0;279471
07;2020-08-05;0;0;0;485;549;09;1034
07;2020-08-05;0;0;0;403;432;19;835
07;2020-08-05;0;0;0;764;841;29;1605
07;2020-08-05;0;0;0;824;928;39;1752
07;2020-08-05;0;0;0;788;1020;49;1808
07;2020-08-05;0;0;0;678;870;59;1548
07;2020-08-05;0;0;0;360;382;69;742
07;2020-08-05;0;0;0;231;190;79;421
07;2020-08-05;0;1;1;114;67;89;181
07;2020-08-05;0;0;0;24;11;90;35
07;2020-08-05;0;1;1;4671;5290;0;9961
08;2020-08-05;1;0;1;2715.22592983026;2997.75551488675;09;5712.98144471701
08;2020-08-05;0;0;0;2778.51901080978;3160.9156459093;19;5939.43465671908
08;2020-08-05;0;0;0;2080.8882988764;1718.16634315323;29;3799.05464202964
08;2020-08-05;0;2;2;2701.8582062647;1896.52641413317;39;4598.38462039786
08;2020-08-05;1;0;1;3151.45861023308;2460.52498233809;49;5611.98359257117
08;2020-08-05;0;0;0;2620.29868333099;2422.23566154656;59;5042.53434487755
08;2020-08-05;0;0;0;1621.44173420671;1438.58325779464;69;3060.02499200135
08;2020-08-05;0;0;0;626.575909335673;526.358467843651;79;1152.93437717932
08;2020-08-05;0;0;0;205.018522985054;140.993639349697;89;346.012162334751
08;2020-08-05;0;0;0;50.0325684687745;20.62259870351;90;70.6551671722846
08;2020-08-05;2;2;4;18551.3174743414;16782.6825256586;0;35334
11;2020-08-05;4;10;14;783071;811785;09;1594856
11;2020-08-05;24;25;49;761456;784653;19;1546109
11;2020-08-05;127;119;246;850145;801772;29;1651917
11;2020-08-05;75;90;166;914360;843488;39;1757848
11;2020-08-05;44;40;84;845609;826202;49;1671811
11;2020-08-05;46;34;80;793566;745070;59;1538636
11;2020-08-05;17;28;45;628649;549192;69;1177841
11;2020-08-05;9;15;24;434606;358356;79;792962
11;2020-08-05;2;6;8;261425;162933;89;424358
11;2020-08-05;4;0;4;89253;32619;90;121872
11;2020-08-05;352;368;721;6362140;5916070;0;12278210
24;2020-08-05;0;0;0;139720;144686;09;284406
24;2020-08-05;2;2;4;152979;161185;19;314164
24;2020-08-05;2;4;6;122237;126536;29;248773
24;2020-08-05;3;4;7;150359;142009;39;292368
24;2020-08-05;1;3;4;161829;158758;49;320587
24;2020-08-05;2;2;4;172552;168011;59;340563
24;2020-08-05;1;0;1;172509;158177;69;330686
24;2020-08-05;0;2;2;129428;110593;79;240021
24;2020-08-05;1;0;1;87342;56882;89;144224
24;2020-08-05;0;0;0;31210;12071;90;43281
24;2020-08-05;12;17;29;1320165;1238908;0;2559073
27;2020-08-05;0;2;2;143373;149679;09;293052
27;2020-08-05;0;1;1;160962;173003;19;333965
27;2020-08-05;6;10;16;133746;142254;29;276000
27;2020-08-05;2;1;3;160004;155407;39;315411
27;2020-08-05;1;3;4;172333;169564;49;341897
27;2020-08-05;1;2;3;189979;183788;59;373767
27;2020-08-05;1;1;2;192591;178206;69;370797
27;2020-08-05;0;1;1;146876;127546;79;274422
27;2020-08-05;0;0;0;96896;61575;89;158471
27;2020-08-05;1;0;1;33148;12109;90;45257
27;2020-08-05;12;21;33;1429908;1353131;0;2783039
28;2020-08-05;0;3;3;180735;186856;09;367591
28;2020-08-05;3;1;4;200125;213621;19;413746
28;2020-08-05;2;5;7;168922;173007;29;341929
28;2020-08-05;2;4;6;196628;188487;39;385115
28;2020-08-05;4;3;7;205396;201699;49;407095
28;2020-08-05;2;2;4;222002;213866;59;435868
28;2020-08-05;1;0;1;224688;203758;69;428446
28;2020-08-05;3;2;5;163192;135543;79;298735
28;2020-08-05;0;0;0;109691;65377;89;175068
28;2020-08-05;0;0;0;37222;12685;90;49907
28;2020-08-05;17;20;37;1708601;1594899;0;3303500
32;2020-08-05;11;5;16;358062;373689;09;731751
32;2020-08-05;5;7;12;387045;406742;19;793787
32;2020-08-05;21;9;30;342304;348587;29;690891
32;2020-08-05;13;14;27;382485;369972;39;752457
32;2020-08-05;10;5;15;382510;376716;49;759226
32;2020-08-05;8;10;18;386937;376527;59;763464
32;2020-08-05;9;3;12;371211;330938;69;702149
32;2020-08-05;3;5;8;250542;201459;79;452001
32;2020-08-05;6;2;8;163399;89786;89;253185
32;2020-08-05;3;0;3;48384;15367;90;63751
32;2020-08-05;89;60;149;3072879;2889783;0;5962662
44;2020-08-05;0;0;0;291525;306839;09;598364
44;2020-08-05;7;1;8;320255;339504;19;659759
44;2020-08-05;8;21;29;302020;314428;29;616448
44;2020-08-05;7;4;11;342222;333292;39;675514
44;2020-08-05;4;4;8;349727;344491;49;694218
44;2020-08-05;3;5;8;381371;373239;59;754610
44;2020-08-05;3;0;3;367165;335850;69;703015
44;2020-08-05;3;6;9;250387;215436;79;465823
44;2020-08-05;0;0;0;170825;105192;89;276017
44;2020-08-05;0;3;3;51248;16731;90;67979
44;2020-08-05;35;44;80;2826745;2685002;0;5511747
52;2020-08-05;1;5;6;213594;223900;09;437494
52;2020-08-05;6;6;12;240818;255197;19;496015
52;2020-08-05;14;14;28;197010;200630;29;397640
52;2020-08-05;12;6;18;231204;224885;39;456089
52;2020-08-05;3;5;8;243874;243418;49;487292
52;2020-08-05;2;5;7;244100;239116;59;483216
52;2020-08-05;3;2;5;241796;221345;69;463141
52;2020-08-05;4;2;6;177805;149903;79;327708
52;2020-08-05;3;6;9;119561;75822;89;195383
52;2020-08-05;0;1;1;42559;15260;90;57819
52;2020-08-05;48;52;100;1952321;1849476;0;3801797
53;2020-08-05;3;1;4;173813;182358;09;356171
53;2020-08-05;5;3;8;202720;214740;19;417460
53;2020-08-05;7;17;24;163116;173196;29;336312
53;2020-08-05;2;10;12;190526;187674;39;378200
53;2020-08-05;9;8;17;212098;212015;49;424113
53;2020-08-05;3;7;10;223699;219176;59;442875
53;2020-08-05;4;5;9;227435;209274;69;436709
53;2020-08-05;0;0;0;169992;140910;79;310902
53;2020-08-05;1;1;2;118117;69883;89;188000
53;2020-08-05;0;0;0;37370;12267;90;49637
53;2020-08-05;34;52;86;1718886;1621493;0;3340379
75;2020-08-05;1;2;3;293104;305291;09;598395
75;2020-08-05;0;1;1;337141;357785;19;694926
75;2020-08-05;13;11;24;295024;300618;29;595642
75;2020-08-05;3;1;4;347871;331233;39;679104
75;2020-08-05;1;0;1;384742;372771;49;757513
75;2020-08-05;0;0;0;413361;390880;59;804241
75;2020-08-05;0;4;4;425623;384060;69;809683
75;2020-08-05;2;0;2;325086;276298;79;601384
75;2020-08-05;0;1;1;213986;139308;89;353294
75;2020-08-05;0;0;0;77600;28200;90;105800
75;2020-08-05;20;20;40;3113538;2886444;0;5999982
76;2020-08-05;4;0;4;305956;318589;09;624545
76;2020-08-05;10;4;14;338942;356969;19;695911
76;2020-08-05;17;27;44;316210;319570;29;635780
76;2020-08-05;11;7;18;356758;337587;39;694345
76;2020-08-05;8;7;15;376541;363812;49;740353
76;2020-08-05;8;9;17;402608;383750;59;786358
76;2020-08-05;6;5;11;394889;358997;69;753886
76;2020-08-05;4;4;8;308664;263806;79;572470
76;2020-08-05;5;3;8;195838;129272;89;325110
76;2020-08-05;0;0;0;69372;26728;90;96100
76;2020-08-05;73;66;139;3065778;2859080;0;5924858
84;2020-08-05;5;8;13;459549;481088;09;940637
84;2020-08-05;10;9;19;487711;511905;19;999616
84;2020-08-05;28;19;47;443824;451094;29;894918
84;2020-08-05;14;14;28;512522;493262;39;1005784
84;2020-08-05;9;9;18;520248;515106;49;1035354
84;2020-08-05;8;4;12;529611;514848;59;1044459
84;2020-08-05;5;4;9;486720;439940;69;926660
84;2020-08-05;0;1;1;372151;315211;79;687362
84;2020-08-05;0;1;1;237198;150524;89;387722
84;2020-08-05;0;0;0;81185;28680;90;109865
84;2020-08-05;79;69;148;4130719;3901658;0;8032377
93;2020-08-05;1;5;6;268834;283093;09;551927
93;2020-08-05;16;11;27;280751;296087;19;576838
93;2020-08-05;33;70;103;254404;255552;29;509956
93;2020-08-05;20;33;53;310704;288398;39;599102
93;2020-08-05;20;22;44;325559;305827;49;631386
93;2020-08-05;16;17;33;353104;325389;59;678493
93;2020-08-05;8;11;19;336327;296459;69;632786
93;2020-08-05;6;5;11;279820;229699;79;509519
93;2020-08-05;2;4;6;171274;113716;89;284990
93;2020-08-05;1;1;2;58896;21758;90;80654
93;2020-08-05;123;179;304;2639673;2415978;0;5055651
94;2020-08-05;0;1;1;16311;17433;09;33744
94;2020-08-05;0;0;0;16679;18132;19;34811
94;2020-08-05;0;0;0;16782;16579;29;33361
94;2020-08-05;0;0;0;23044;20580;39;43624
94;2020-08-05;0;0;0;23065;22140;49;45205
94;2020-08-05;1;0;1;24549;23421;59;47970
94;2020-08-05;0;0;0;23212;21883;69;45095
94;2020-08-05;0;0;0;19544;17141;79;36685
94;2020-08-05;0;0;0;11227;8178;89;19405
94;2020-08-05;0;0;0;3332;1447;90;4779
94;2020-08-05;1;1;2;177745;166934;0;344679
01;2020-08-06;0;0;0;19979;20155;09;40134
01;2020-08-06;0;0;0;24994;25489;19;50483
01;2020-08-06;4;4;8;17868;16690;29;34558
01;2020-08-06;3;1;4;22328;14821;39;37149
01;2020-08-06;1;2;3;28652;20276;49;48928
01;2020-08-06;0;0;0;33264;27260;59;60524
01;2020-08-06;0;0;0;27135;23978;69;51113
01;2020-08-06;1;2;3;18401;14661;79;33062
01;2020-08-06;0;0;0;9633;6375;89;16008
01;2020-08-06;0;0;0;3410;1510;90;4920
01;2020-08-06;9;9;18;205664;171215;0;376879
02;2020-08-06;0;0;0;16881;17110;09;33991
02;2020-08-06;0;1;1;21410;21604;19;43014
02;2020-08-06;1;2;3;16017;15479;29;31496
02;2020-08-06;2;2;4;19825;14455;39;34280
02;2020-08-06;0;1;1;24719;18248;49;42967
02;2020-08-06;0;0;0;34361;28310;59;62671
02;2020-08-06;0;0;0;28061;24495;69;52556
02;2020-08-06;0;0;0;18231;15278;79;33509
02;2020-08-06;0;0;0;11090;7677;89;18767
02;2020-08-06;0;0;0;3992;1506;90;5498
02;2020-08-06;3;6;9;194587;164162;0;358749
03;2020-08-06;3;6;9;31123;30920;09;62043
03;2020-08-06;4;4;8;29370;29268;19;58638
03;2020-08-06;4;5;9;21458;18963;29;40421
03;2020-08-06;4;8;12;21276;18326;39;39602
03;2020-08-06;3;6;9;18164;16593;49;34757
03;2020-08-06;2;2;4;13469;13557;59;27026
03;2020-08-06;0;0;0;8776;8670;69;17446
03;2020-08-06;2;1;3;3777;3591;79;7368
03;2020-08-06;0;1;1;1649;1072;89;2721
03;2020-08-06;0;0;0;485;184;90;669
03;2020-08-06;22;33;55;149547;141144;0;290691
04;2020-08-06;0;0;0;60314;61377;09;121691
04;2020-08-06;0;0;0;66065;68387;19;134452
04;2020-08-06;1;1;2;51059;47156;29;98215
04;2020-08-06;1;0;1;58788;45780;39;104568
04;2020-08-06;0;1;1;61408;52207;49;113615
04;2020-08-06;0;1;1;64838;60759;59;125597
04;2020-08-06;0;1;1;47008;42843;69;89851
04;2020-08-06;0;1;1;25509;21184;79;46693
04;2020-08-06;0;1;1;13168;7647;89;20815
04;2020-08-06;0;1;1;3209;1253;90;4462
04;2020-08-06;2;7;9;451366;408593;0;859959
05;2020-08-06;0;0;0;362.366008612902;341.338819562748;09;703.704828175651
05;2020-08-06;0;0;0;353.376145114279;370.349735405642;19;723.725880519921
05;2020-08-06;0;0;0;218.593559489256;256.539602589476;29;475.133162078732
05;2020-08-06;0;0;0;404.225408693299;360.321910454353;39;764.547319147651
05;2020-08-06;0;0;0;520.067953604221;497.108383964256;49;1017.17633756848
05;2020-08-06;0;0;0;468.146063921917;510.087601910415;59;978.233665832332
05;2020-08-06;0;0;0;340.368470050554;334.366842191253;69;674.735312241807
05;2020-08-06;0;0;0;212.598666888387;192.597753227106;79;405.196420115493
05;2020-08-06;0;0;0;148.727797095705;61.8681715431829;89;210.595968638888
05;2020-08-06;0;0;0;32.9601271090696;10.9909785719784;90;43.9511056810479
05;2020-08-06;0;0;0;3061.43020057959;2935.56979942041;0;5997
06;2020-08-06;0;0;1;42583;42380;09;84963
06;2020-08-06;2;3;5;33369;31925;19;65294
06;2020-08-06;0;2;2;21571;15080;29;36651
06;2020-08-06;2;3;5;21550;16147;39;37697
06;2020-08-06;2;1;3;14193;13939;49;28132
06;2020-08-06;1;0;1;7171;7597;59;14768
06;2020-08-06;1;1;2;3629;4117;69;7746
06;2020-08-06;0;0;0;1577;1457;79;3034
06;2020-08-06;0;0;0;531;474;89;1005
06;2020-08-06;0;0;0;88;93;90;181
06;2020-08-06;8;10;19;146262;133209;0;279471
07;2020-08-06;0;0;0;485;549;09;1034
07;2020-08-06;0;0;0;403;432;19;835
07;2020-08-06;0;0;0;764;841;29;1605
07;2020-08-06;0;0;0;824;928;39;1752
07;2020-08-06;0;0;0;788;1020;49;1808
07;2020-08-06;0;0;0;678;870;59;1548
07;2020-08-06;0;0;0;360;382;69;742
07;2020-08-06;0;0;0;231;190;79;421
07;2020-08-06;0;0;0;114;67;89;181
07;2020-08-06;0;0;0;24;11;90;35
07;2020-08-06;0;0;0;4671;5290;0;9961
08;2020-08-06;0;0;0;2715.22592983026;2997.75551488675;09;5712.98144471701
08;2020-08-06;0;1;1;2778.51901080978;3160.9156459093;19;5939.43465671908
08;2020-08-06;0;0;0;2080.8882988764;1718.16634315323;29;3799.05464202964
08;2020-08-06;0;0;0;2701.8582062647;1896.52641413317;39;4598.38462039786
08;2020-08-06;1;0;1;3151.45861023308;2460.52498233809;49;5611.98359257117
08;2020-08-06;0;1;1;2620.29868333099;2422.23566154656;59;5042.53434487755
08;2020-08-06;1;0;1;1621.44173420671;1438.58325779464;69;3060.02499200135
08;2020-08-06;0;0;0;626.575909335673;526.358467843651;79;1152.93437717932
08;2020-08-06;0;0;0;205.018522985054;140.993639349697;89;346.012162334751
08;2020-08-06;0;0;0;50.0325684687745;20.62259870351;90;70.6551671722846
08;2020-08-06;2;2;4;18551.3174743414;16782.6825256586;0;35334
11;2020-08-06;7;15;23;783071;811785;09;1594856
11;2020-08-06;33;35;70;761456;784653;19;1546109
11;2020-08-06;123;108;231;850145;801772;29;1651917
11;2020-08-06;70;87;157;914360;843488;39;1757848
11;2020-08-06;50;49;99;845609;826202;49;1671811
11;2020-08-06;39;44;83;793566;745070;59;1538636
11;2020-08-06;33;23;56;628649;549192;69;1177841
11;2020-08-06;16;14;30;434606;358356;79;792962
11;2020-08-06;8;9;17;261425;162933;89;424358
11;2020-08-06;2;0;2;89253;32619;90;121872
11;2020-08-06;381;384;771;6362140;5916070;0;12278210
24;2020-08-06;2;1;3;139720;144686;09;284406
24;2020-08-06;6;7;13;152979;161185;19;314164
24;2020-08-06;12;10;22;122237;126536;29;248773
24;2020-08-06;7;1;8;150359;142009;39;292368
24;2020-08-06;4;3;7;161829;158758;49;320587
24;2020-08-06;1;2;3;172552;168011;59;340563
24;2020-08-06;4;4;8;172509;158177;69;330686
24;2020-08-06;0;0;0;129428;110593;79;240021
24;2020-08-06;0;1;1;87342;56882;89;144224
24;2020-08-06;0;0;0;31210;12071;90;43281
24;2020-08-06;36;29;65;1320165;1238908;0;2559073
27;2020-08-06;0;1;1;143373;149679;09;293052
27;2020-08-06;3;0;3;160962;173003;19;333965
27;2020-08-06;6;3;9;133746;142254;29;276000
27;2020-08-06;3;2;5;160004;155407;39;315411
27;2020-08-06;1;4;5;172333;169564;49;341897
27;2020-08-06;1;1;2;189979;183788;59;373767
27;2020-08-06;2;2;4;192591;178206;69;370797
27;2020-08-06;0;1;1;146876;127546;79;274422
27;2020-08-06;0;1;1;96896;61575;89;158471
27;2020-08-06;0;0;0;33148;12109;90;45257
27;2020-08-06;16;15;31;1429908;1353131;0;2783039
28;2020-08-06;1;0;1;180735;186856;09;367591
28;2020-08-06;2;0;2;200125;213621;19;413746
28;2020-08-06;4;4;8;168922;173007;29;341929
28;2020-08-06;1;3;4;196628;188487;39;385115
28;2020-08-06;4;4;8;205396;201699;49;407095
28;2020-08-06;2;0;2;222002;213866;59;435868
28;2020-08-06;2;1;3;224688;203758;69;428446
28;2020-08-06;1;0;1;163192;135543;79;298735
28;2020-08-06;0;0;0;109691;65377;89;175068
28;2020-08-06;1;0;1;37222;12685;90;49907
28;2020-08-06;18;12;34;1708601;1594899;0;3303500
32;2020-08-06;4;3;7;358062;373689;09;731751
32;2020-08-06;16;9;25;387045;406742;19;793787
32;2020-08-06;20;14;34;342304;348587;29;690891
32;2020-08-06;14;13;27;382485;369972;39;752457
32;2020-08-06;12;14;26;382510;376716;49;759226
32;2020-08-06;12;7;19;386937;376527;59;763464
32;2020-08-06;5;5;10;371211;330938;69;702149
32;2020-08-06;2;5;7;250542;201459;79;452001
32;2020-08-06;3;2;5;163399;89786;89;253185
32;2020-08-06;2;1;3;48384;15367;90;63751
32;2020-08-06;90;73;163;3072879;2889783;0;5962662
44;2020-08-06;2;2;4;291525;306839;09;598364
44;2020-08-06;5;8;13;320255;339504;19;659759
44;2020-08-06;16;16;32;302020;314428;29;616448
44;2020-08-06;12;19;31;342222;333292;39;675514
44;2020-08-06;7;6;13;349727;344491;49;694218
44;2020-08-06;8;5;13;381371;373239;59;754610
44;2020-08-06;4;4;8;367165;335850;69;703015
44;2020-08-06;2;3;5;250387;215436;79;465823
44;2020-08-06;11;2;13;170825;105192;89;276017
44;2020-08-06;14;1;15;51248;16731;90;67979
44;2020-08-06;81;66;147;2826745;2685002;0;5511747
52;2020-08-06;3;3;6;213594;223900;09;437494
52;2020-08-06;8;8;16;240818;255197;19;496015
52;2020-08-06;16;9;25;197010;200630;29;397640
52;2020-08-06;6;12;18;231204;224885;39;456089
52;2020-08-06;6;7;13;243874;243418;49;487292
52;2020-08-06;7;5;12;244100;239116;59;483216
52;2020-08-06;3;2;5;241796;221345;69;463141
52;2020-08-06;1;2;3;177805;149903;79;327708
52;2020-08-06;1;1;2;119561;75822;89;195383
52;2020-08-06;0;1;1;42559;15260;90;57819
52;2020-08-06;51;51;102;1952321;1849476;0;3801797
53;2020-08-06;3;3;6;173813;182358;09;356171
53;2020-08-06;3;3;6;202720;214740;19;417460
53;2020-08-06;3;11;14;163116;173196;29;336312
53;2020-08-06;2;2;4;190526;187674;39;378200
53;2020-08-06;4;6;10;212098;212015;49;424113
53;2020-08-06;2;2;4;223699;219176;59;442875
53;2020-08-06;1;2;3;227435;209274;69;436709
53;2020-08-06;0;1;1;169992;140910;79;310902
53;2020-08-06;1;1;2;118117;69883;89;188000
53;2020-08-06;0;0;0;37370;12267;90;49637
53;2020-08-06;19;31;50;1718886;1621493;0;3340379
75;2020-08-06;0;1;1;293104;305291;09;598395
75;2020-08-06;7;6;13;337141;357785;19;694926
75;2020-08-06;12;8;20;295024;300618;29;595642
75;2020-08-06;5;5;10;347871;331233;39;679104
75;2020-08-06;6;3;9;384742;372771;49;757513
75;2020-08-06;4;1;5;413361;390880;59;804241
75;2020-08-06;2;2;4;425623;384060;69;809683
75;2020-08-06;1;3;4;325086;276298;79;601384
75;2020-08-06;0;2;2;213986;139308;89;353294
75;2020-08-06;0;0;0;77600;28200;90;105800
75;2020-08-06;37;31;68;3113538;2886444;0;5999982
76;2020-08-06;4;2;6;305956;318589;09;624545
76;2020-08-06;10;10;20;338942;356969;19;695911
76;2020-08-06;21;30;51;316210;319570;29;635780
76;2020-08-06;12;22;34;356758;337587;39;694345
76;2020-08-06;14;10;24;376541;363812;49;740353
76;2020-08-06;9;9;18;402608;383750;59;786358
76;2020-08-06;7;6;13;394889;358997;69;753886
76;2020-08-06;5;4;9;308664;263806;79;572470
76;2020-08-06;1;1;2;195838;129272;89;325110
76;2020-08-06;1;0;1;69372;26728;90;96100
76;2020-08-06;84;95;179;3065778;2859080;0;5924858
84;2020-08-06;1;2;3;459549;481088;09;940637
84;2020-08-06;4;11;15;487711;511905;19;999616
84;2020-08-06;14;21;35;443824;451094;29;894918
84;2020-08-06;12;11;23;512522;493262;39;1005784
84;2020-08-06;6;15;21;520248;515106;49;1035354
84;2020-08-06;8;3;11;529611;514848;59;1044459
84;2020-08-06;4;7;11;486720;439940;69;926660
84;2020-08-06;0;1;1;372151;315211;79;687362
84;2020-08-06;1;0;1;237198;150524;89;387722
84;2020-08-06;1;2;3;81185;28680;90;109865
84;2020-08-06;51;73;124;4130719;3901658;0;8032377
93;2020-08-06;1;1;2;268834;283093;09;551927
93;2020-08-06;17;11;28;280751;296087;19;576838
93;2020-08-06;56;44;100;254404;255552;29;509956
93;2020-08-06;20;26;46;310704;288398;39;599102
93;2020-08-06;15;19;34;325559;305827;49;631386
93;2020-08-06;16;21;37;353104;325389;59;678493
93;2020-08-06;9;11;20;336327;296459;69;632786
93;2020-08-06;7;12;19;279820;229699;79;509519
93;2020-08-06;4;2;6;171274;113716;89;284990
93;2020-08-06;4;1;5;58896;21758;90;80654
93;2020-08-06;149;148;297;2639673;2415978;0;5055651
94;2020-08-06;0;0;0;16311;17433;09;33744
94;2020-08-06;1;0;1;16679;18132;19;34811
94;2020-08-06;0;2;2;16782;16579;29;33361
94;2020-08-06;0;0;0;23044;20580;39;43624
94;2020-08-06;1;0;1;23065;22140;49;45205
94;2020-08-06;0;0;0;24549;23421;59;47970
94;2020-08-06;0;0;0;23212;21883;69;45095
94;2020-08-06;0;0;0;19544;17141;79;36685
94;2020-08-06;0;0;0;11227;8178;89;19405
94;2020-08-06;0;0;0;3332;1447;90;4779
94;2020-08-06;2;2;4;177745;166934;0;344679
01;2020-08-07;0;0;0;19979;20155;09;40134
01;2020-08-07;0;1;1;24994;25489;19;50483
01;2020-08-07;4;1;5;17868;16690;29;34558
01;2020-08-07;0;0;0;22328;14821;39;37149
01;2020-08-07;0;0;0;28652;20276;49;48928
01;2020-08-07;0;0;0;33264;27260;59;60524
01;2020-08-07;0;0;0;27135;23978;69;51113
01;2020-08-07;0;0;0;18401;14661;79;33062
01;2020-08-07;0;0;0;9633;6375;89;16008
01;2020-08-07;0;0;0;3410;1510;90;4920
01;2020-08-07;4;2;6;205664;171215;0;376879
02;2020-08-07;0;0;0;16881;17110;09;33991
02;2020-08-07;0;0;0;21410;21604;19;43014
02;2020-08-07;1;1;2;16017;15479;29;31496
02;2020-08-07;1;1;2;19825;14455;39;34280
02;2020-08-07;1;0;1;24719;18248;49;42967
02;2020-08-07;1;0;1;34361;28310;59;62671
02;2020-08-07;0;0;0;28061;24495;69;52556
02;2020-08-07;0;0;0;18231;15278;79;33509
02;2020-08-07;0;0;0;11090;7677;89;18767
02;2020-08-07;0;0;0;3992;1506;90;5498
02;2020-08-07;4;2;6;194587;164162;0;358749
03;2020-08-07;4;1;5;31123;30920;09;62043
03;2020-08-07;3;1;4;29370;29268;19;58638
03;2020-08-07;9;4;14;21458;18963;29;40421
03;2020-08-07;4;6;12;21276;18326;39;39602
03;2020-08-07;4;5;9;18164;16593;49;34757
03;2020-08-07;4;6;10;13469;13557;59;27026
03;2020-08-07;1;2;3;8776;8670;69;17446
03;2020-08-07;1;2;3;3777;3591;79;7368
03;2020-08-07;0;1;1;1649;1072;89;2721
03;2020-08-07;0;0;0;485;184;90;669
03;2020-08-07;30;28;61;149547;141144;0;290691
04;2020-08-07;0;0;0;60314;61377;09;121691
04;2020-08-07;2;0;2;66065;68387;19;134452
04;2020-08-07;1;0;1;51059;47156;29;98215
04;2020-08-07;1;1;2;58788;45780;39;104568
04;2020-08-07;2;1;3;61408;52207;49;113615
04;2020-08-07;2;1;3;64838;60759;59;125597
04;2020-08-07;0;0;0;47008;42843;69;89851
04;2020-08-07;1;0;1;25509;21184;79;46693
04;2020-08-07;0;0;0;13168;7647;89;20815
04;2020-08-07;0;0;0;3209;1253;90;4462
04;2020-08-07;9;3;12;451366;408593;0;859959
05;2020-08-07;0;0;0;362.366008612902;341.338819562748;09;703.704828175651
05;2020-08-07;0;0;0;353.376145114279;370.349735405642;19;723.725880519921
05;2020-08-07;0;0;0;218.593559489256;256.539602589476;29;475.133162078732
05;2020-08-07;0;0;0;404.225408693299;360.321910454353;39;764.547319147651
05;2020-08-07;0;0;0;520.067953604221;497.108383964256;49;1017.17633756848
05;2020-08-07;0;0;0;468.146063921917;510.087601910415;59;978.233665832332
05;2020-08-07;0;0;0;340.368470050554;334.366842191253;69;674.735312241807
05;2020-08-07;0;0;0;212.598666888387;192.597753227106;79;405.196420115493
05;2020-08-07;0;0;0;148.727797095705;61.8681715431829;89;210.595968638888
05;2020-08-07;0;0;0;32.9601271090696;10.9909785719784;90;43.9511056810479
05;2020-08-07;0;0;0;3061.43020057959;2935.56979942041;0;5997
06;2020-08-07;0;1;1;42583;42380;09;84963
06;2020-08-07;2;0;2;33369;31925;19;65294
06;2020-08-07;0;4;4;21571;15080;29;36651
06;2020-08-07;0;0;0;21550;16147;39;37697
06;2020-08-07;1;1;2;14193;13939;49;28132
06;2020-08-07;1;0;1;7171;7597;59;14768
06;2020-08-07;0;0;0;3629;4117;69;7746
06;2020-08-07;0;0;0;1577;1457;79;3034
06;2020-08-07;0;1;1;531;474;89;1005
06;2020-08-07;0;0;0;88;93;90;181
06;2020-08-07;4;7;11;146262;133209;0;279471
07;2020-08-07;0;0;0;485;549;09;1034
07;2020-08-07;0;0;0;403;432;19;835
07;2020-08-07;0;1;1;764;841;29;1605
07;2020-08-07;0;0;0;824;928;39;1752
07;2020-08-07;0;0;0;788;1020;49;1808
07;2020-08-07;0;0;0;678;870;59;1548
07;2020-08-07;0;0;0;360;382;69;742
07;2020-08-07;0;0;0;231;190;79;421
07;2020-08-07;0;0;0;114;67;89;181
07;2020-08-07;0;0;0;24;11;90;35
07;2020-08-07;0;1;1;4671;5290;0;9961
08;2020-08-07;0;0;0;2715.22592983026;2997.75551488675;09;5712.98144471701
08;2020-08-07;0;0;0;2778.51901080978;3160.9156459093;19;5939.43465671908
08;2020-08-07;0;0;0;2080.8882988764;1718.16634315323;29;3799.05464202964
08;2020-08-07;0;1;1;2701.8582062647;1896.52641413317;39;4598.38462039786
08;2020-08-07;0;2;2;3151.45861023308;2460.52498233809;49;5611.98359257117
08;2020-08-07;1;0;1;2620.29868333099;2422.23566154656;59;5042.53434487755
08;2020-08-07;2;2;4;1621.44173420671;1438.58325779464;69;3060.02499200135
08;2020-08-07;0;0;0;626.575909335673;526.358467843651;79;1152.93437717932
08;2020-08-07;0;0;0;205.018522985054;140.993639349697;89;346.012162334751
08;2020-08-07;0;0;0;50.0325684687745;20.62259870351;90;70.6551671722846
08;2020-08-07;3;5;8;18551.3174743414;16782.6825256586;0;35334
11;2020-08-07;12;16;28;783071;811785;09;1594856
11;2020-08-07;49;30;79;761456;784653;19;1546109
11;2020-08-07;136;109;245;850145;801772;29;1651917
11;2020-08-07;92;104;196;914360;843488;39;1757848
11;2020-08-07;64;51;115;845609;826202;49;1671811
11;2020-08-07;51;36;87;793566;745070;59;1538636
11;2020-08-07;24;28;52;628649;549192;69;1177841
11;2020-08-07;14;12;26;434606;358356;79;792962
11;2020-08-07;12;9;21;261425;162933;89;424358
11;2020-08-07;3;2;5;89253;32619;90;121872
11;2020-08-07;457;397;854;6362140;5916070;0;12278210
24;2020-08-07;1;0;1;139720;144686;09;284406
24;2020-08-07;6;3;9;152979;161185;19;314164
24;2020-08-07;7;7;14;122237;126536;29;248773
24;2020-08-07;8;3;11;150359;142009;39;292368
24;2020-08-07;5;1;6;161829;158758;49;320587
24;2020-08-07;2;3;5;172552;168011;59;340563
24;2020-08-07;1;4;5;172509;158177;69;330686
24;2020-08-07;2;0;2;129428;110593;79;240021
24;2020-08-07;0;1;1;87342;56882;89;144224
24;2020-08-07;0;0;0;31210;12071;90;43281
24;2020-08-07;32;24;56;1320165;1238908;0;2559073
27;2020-08-07;0;2;2;143373;149679;09;293052
27;2020-08-07;0;4;4;160962;173003;19;333965
27;2020-08-07;5;3;8;133746;142254;29;276000
27;2020-08-07;5;4;9;160004;155407;39;315411
27;2020-08-07;0;1;1;172333;169564;49;341897
27;2020-08-07;2;0;2;189979;183788;59;373767
27;2020-08-07;3;1;4;192591;178206;69;370797
27;2020-08-07;2;0;2;146876;127546;79;274422
27;2020-08-07;1;0;1;96896;61575;89;158471
27;2020-08-07;0;0;0;33148;12109;90;45257
27;2020-08-07;18;15;33;1429908;1353131;0;2783039
28;2020-08-07;2;3;5;180735;186856;09;367591
28;2020-08-07;1;3;4;200125;213621;19;413746
28;2020-08-07;5;5;10;168922;173007;29;341929
28;2020-08-07;5;3;8;196628;188487;39;385115
28;2020-08-07;3;3;6;205396;201699;49;407095
28;2020-08-07;6;1;7;222002;213866;59;435868
28;2020-08-07;3;1;4;224688;203758;69;428446
28;2020-08-07;0;1;1;163192;135543;79;298735
28;2020-08-07;0;0;0;109691;65377;89;175068
28;2020-08-07;0;0;0;37222;12685;90;49907
28;2020-08-07;25;20;45;1708601;1594899;0;3303500
32;2020-08-07;7;6;13;358062;373689;09;731751
32;2020-08-07;12;13;25;387045;406742;19;793787
32;2020-08-07;20;20;40;342304;348587;29;690891
32;2020-08-07;15;13;29;382485;369972;39;752457
32;2020-08-07;13;8;21;382510;376716;49;759226
32;2020-08-07;5;7;12;386937;376527;59;763464
32;2020-08-07;7;2;9;371211;330938;69;702149
32;2020-08-07;4;8;12;250542;201459;79;452001
32;2020-08-07;2;1;3;163399;89786;89;253185
32;2020-08-07;0;0;0;48384;15367;90;63751
32;2020-08-07;85;78;164;3072879;2889783;0;5962662
44;2020-08-07;5;2;7;291525;306839;09;598364
44;2020-08-07;7;5;12;320255;339504;19;659759
44;2020-08-07;11;9;20;302020;314428;29;616448
44;2020-08-07;11;4;15;342222;333292;39;675514
44;2020-08-07;2;5;7;349727;344491;49;694218
44;2020-08-07;7;2;9;381371;373239;59;754610
44;2020-08-07;4;1;5;367165;335850;69;703015
44;2020-08-07;1;1;2;250387;215436;79;465823
44;2020-08-07;4;1;5;170825;105192;89;276017
44;2020-08-07;1;2;3;51248;16731;90;67979
44;2020-08-07;53;32;85;2826745;2685002;0;5511747
52;2020-08-07;2;2;5;213594;223900;09;437494
52;2020-08-07;13;5;18;240818;255197;19;496015
52;2020-08-07;14;7;21;197010;200630;29;397640
52;2020-08-07;10;16;26;231204;224885;39;456089
52;2020-08-07;4;6;10;243874;243418;49;487292
52;2020-08-07;12;5;17;244100;239116;59;483216
52;2020-08-07;4;2;6;241796;221345;69;463141
52;2020-08-07;0;5;5;177805;149903;79;327708
52;2020-08-07;1;0;1;119561;75822;89;195383
52;2020-08-07;1;1;2;42559;15260;90;57819
52;2020-08-07;61;49;111;1952321;1849476;0;3801797
53;2020-08-07;1;5;6;173813;182358;09;356171
53;2020-08-07;4;10;14;202720;214740;19;417460
53;2020-08-07;13;10;23;163116;173196;29;336312
53;2020-08-07;6;2;8;190526;187674;39;378200
53;2020-08-07;3;5;8;212098;212015;49;424113
53;2020-08-07;3;2;5;223699;219176;59;442875
53;2020-08-07;3;1;4;227435;209274;69;436709
53;2020-08-07;1;1;2;169992;140910;79;310902
53;2020-08-07;1;0;1;118117;69883;89;188000
53;2020-08-07;1;0;1;37370;12267;90;49637
53;2020-08-07;36;36;72;1718886;1621493;0;3340379
75;2020-08-07;1;0;1;293104;305291;09;598395
75;2020-08-07;2;3;5;337141;357785;19;694926
75;2020-08-07;11;11;22;295024;300618;29;595642
75;2020-08-07;6;11;17;347871;331233;39;679104
75;2020-08-07;4;6;10;384742;372771;49;757513
75;2020-08-07;1;0;1;413361;390880;59;804241
75;2020-08-07;2;1;3;425623;384060;69;809683
75;2020-08-07;4;0;4;325086;276298;79;601384
75;2020-08-07;1;0;1;213986;139308;89;353294
75;2020-08-07;0;0;0;77600;28200;90;105800
75;2020-08-07;32;32;64;3113538;2886444;0;5999982
76;2020-08-07;4;3;7;305956;318589;09;624545
76;2020-08-07;13;9;22;338942;356969;19;695911
76;2020-08-07;33;27;60;316210;319570;29;635780
76;2020-08-07;12;9;21;356758;337587;39;694345
76;2020-08-07;15;9;24;376541;363812;49;740353
76;2020-08-07;12;5;17;402608;383750;59;786358
76;2020-08-07;4;5;9;394889;358997;69;753886
76;2020-08-07;0;2;2;308664;263806;79;572470
76;2020-08-07;2;1;3;195838;129272;89;325110
76;2020-08-07;0;0;0;69372;26728;90;96100
76;2020-08-07;95;70;165;3065778;2859080;0;5924858
84;2020-08-07;1;0;1;459549;481088;09;940637
84;2020-08-07;10;9;19;487711;511905;19;999616
84;2020-08-07;20;32;52;443824;451094;29;894918
84;2020-08-07;11;13;24;512522;493262;39;1005784
84;2020-08-07;7;13;20;520248;515106;49;1035354
84;2020-08-07;6;5;11;529611;514848;59;1044459
84;2020-08-07;7;3;10;486720;439940;69;926660
84;2020-08-07;2;3;5;372151;315211;79;687362
84;2020-08-07;2;10;12;237198;150524;89;387722
84;2020-08-07;5;2;7;81185;28680;90;109865
84;2020-08-07;71;90;161;4130719;3901658;0;8032377
93;2020-08-07;14;3;17;268834;283093;09;551927
93;2020-08-07;22;11;33;280751;296087;19;576838
93;2020-08-07;50;51;101;254404;255552;29;509956
93;2020-08-07;27;37;64;310704;288398;39;599102
93;2020-08-07;29;27;56;325559;305827;49;631386
93;2020-08-07;21;15;36;353104;325389;59;678493
93;2020-08-07;12;14;26;336327;296459;69;632786
93;2020-08-07;6;8;14;279820;229699;79;509519
93;2020-08-07;10;3;13;171274;113716;89;284990
93;2020-08-07;1;1;2;58896;21758;90;80654
93;2020-08-07;192;170;362;2639673;2415978;0;5055651
94;2020-08-07;1;0;1;16311;17433;09;33744
94;2020-08-07;0;0;0;16679;18132;19;34811
94;2020-08-07;0;0;0;16782;16579;29;33361
94;2020-08-07;0;0;0;23044;20580;39;43624
94;2020-08-07;0;0;0;23065;22140;49;45205
94;2020-08-07;0;0;0;24549;23421;59;47970
94;2020-08-07;0;0;0;23212;21883;69;45095
94;2020-08-07;0;0;0;19544;17141;79;36685
94;2020-08-07;0;0;0;11227;8178;89;19405
94;2020-08-07;0;1;1;3332;1447;90;4779
94;2020-08-07;1;1;2;177745;166934;0;344679
01;2020-08-08;0;0;0;19979;20155;09;40134
01;2020-08-08;0;0;0;24994;25489;19;50483
01;2020-08-08;2;1;3;17868;16690;29;34558
01;2020-08-08;1;0;1;22328;14821;39;37149
01;2020-08-08;1;1;2;28652;20276;49;48928
01;2020-08-08;0;0;0;33264;27260;59;60524
01;2020-08-08;1;0;1;27135;23978;69;51113
01;2020-08-08;0;0;0;18401;14661;79;33062
01;2020-08-08;0;0;0;9633;6375;89;16008
01;2020-08-08;0;0;0;3410;1510;90;4920
01;2020-08-08;5;2;7;205664;171215;0;376879
02;2020-08-08;0;0;0;16881;17110;09;33991
02;2020-08-08;0;0;0;21410;21604;19;43014
02;2020-08-08;0;1;1;16017;15479;29;31496
02;2020-08-08;1;1;2;19825;14455;39;34280
02;2020-08-08;0;1;1;24719;18248;49;42967
02;2020-08-08;0;0;0;34361;28310;59;62671
02;2020-08-08;0;0;0;28061;24495;69;52556
02;2020-08-08;0;0;0;18231;15278;79;33509
02;2020-08-08;0;0;0;11090;7677;89;18767
02;2020-08-08;0;0;0;3992;1506;90;5498
02;2020-08-08;1;3;4;194587;164162;0;358749
03;2020-08-08;1;0;2;31123;30920;09;62043
03;2020-08-08;1;0;1;29370;29268;19;58638
03;2020-08-08;4;5;9;21458;18963;29;40421
03;2020-08-08;4;3;7;21276;18326;39;39602
03;2020-08-08;4;1;5;18164;16593;49;34757
03;2020-08-08;0;2;2;13469;13557;59;27026
03;2020-08-08;1;1;2;8776;8670;69;17446
03;2020-08-08;0;1;1;3777;3591;79;7368
03;2020-08-08;0;0;0;1649;1072;89;2721
03;2020-08-08;0;0;0;485;184;90;669
03;2020-08-08;15;13;29;149547;141144;0;290691
04;2020-08-08;0;0;0;60314;61377;09;121691
04;2020-08-08;0;2;2;66065;68387;19;134452
04;2020-08-08;1;0;1;51059;47156;29;98215
04;2020-08-08;0;1;1;58788;45780;39;104568
04;2020-08-08;1;2;3;61408;52207;49;113615
04;2020-08-08;0;0;0;64838;60759;59;125597
04;2020-08-08;0;0;0;47008;42843;69;89851
04;2020-08-08;0;0;0;25509;21184;79;46693
04;2020-08-08;0;0;0;13168;7647;89;20815
04;2020-08-08;0;0;0;3209;1253;90;4462
04;2020-08-08;2;5;7;451366;408593;0;859959
05;2020-08-08;0;0;0;362.366008612902;341.338819562748;09;703.704828175651
05;2020-08-08;0;0;0;353.376145114279;370.349735405642;19;723.725880519921
05;2020-08-08;0;0;0;218.593559489256;256.539602589476;29;475.133162078732
05;2020-08-08;0;0;0;404.225408693299;360.321910454353;39;764.547319147651
05;2020-08-08;0;0;0;520.067953604221;497.108383964256;49;1017.17633756848
05;2020-08-08;0;0;0;468.146063921917;510.087601910415;59;978.233665832332
05;2020-08-08;0;0;0;340.368470050554;334.366842191253;69;674.735312241807
05;2020-08-08;0;0;0;212.598666888387;192.597753227106;79;405.196420115493
05;2020-08-08;0;0;0;148.727797095705;61.8681715431829;89;210.595968638888
05;2020-08-08;0;0;0;32.9601271090696;10.9909785719784;90;43.9511056810479
05;2020-08-08;0;0;0;3061.43020057959;2935.56979942041;0;5997
06;2020-08-08;1;0;1;42583;42380;09;84963
06;2020-08-08;0;1;1;33369;31925;19;65294
06;2020-08-08;0;1;1;21571;15080;29;36651
06;2020-08-08;0;0;0;21550;16147;39;37697
06;2020-08-08;2;1;3;14193;13939;49;28132
06;2020-08-08;0;1;1;7171;7597;59;14768
06;2020-08-08;0;0;0;3629;4117;69;7746
06;2020-08-08;0;0;0;1577;1457;79;3034
06;2020-08-08;0;0;0;531;474;89;1005
06;2020-08-08;0;0;0;88;93;90;181
06;2020-08-08;3;4;7;146262;133209;0;279471
07;2020-08-08;0;0;0;485;549;09;1034
07;2020-08-08;0;0;0;403;432;19;835
07;2020-08-08;0;0;0;764;841;29;1605
07;2020-08-08;0;0;0;824;928;39;1752
07;2020-08-08;0;0;0;788;1020;49;1808
07;2020-08-08;0;0;0;678;870;59;1548
07;2020-08-08;0;0;0;360;382;69;742
07;2020-08-08;0;0;0;231;190;79;421
07;2020-08-08;0;0;0;114;67;89;181
07;2020-08-08;0;0;0;24;11;90;35
07;2020-08-08;0;0;0;4671;5290;0;9961
08;2020-08-08;0;0;0;2715.22592983026;2997.75551488675;09;5712.98144471701
08;2020-08-08;0;0;0;2778.51901080978;3160.9156459093;19;5939.43465671908
08;2020-08-08;0;0;0;2080.8882988764;1718.16634315323;29;3799.05464202964
08;2020-08-08;0;0;0;2701.8582062647;1896.52641413317;39;4598.38462039786
08;2020-08-08;0;0;0;3151.45861023308;2460.52498233809;49;5611.98359257117
08;2020-08-08;0;0;0;2620.29868333099;2422.23566154656;59;5042.53434487755
08;2020-08-08;0;1;1;1621.44173420671;1438.58325779464;69;3060.02499200135
08;2020-08-08;0;0;0;626.575909335673;526.358467843651;79;1152.93437717932
08;2020-08-08;0;0;0;205.018522985054;140.993639349697;89;346.012162334751
08;2020-08-08;0;0;0;50.0325684687745;20.62259870351;90;70.6551671722846
08;2020-08-08;0;1;1;18551.3174743414;16782.6825256586;0;35334
11;2020-08-08;8;1;9;783071;811785;09;1594856
11;2020-08-08;14;13;28;761456;784653;19;1546109
11;2020-08-08;38;53;92;850145;801772;29;1651917
11;2020-08-08;32;40;73;914360;843488;39;1757848
11;2020-08-08;18;20;38;845609;826202;49;1671811
11;2020-08-08;16;20;36;793566;745070;59;1538636
11;2020-08-08;11;15;26;628649;549192;69;1177841
11;2020-08-08;10;25;35;434606;358356;79;792962
11;2020-08-08;8;8;16;261425;162933;89;424358
11;2020-08-08;3;0;3;89253;32619;90;121872
11;2020-08-08;158;195;356;6362140;5916070;0;12278210
24;2020-08-08;2;0;2;139720;144686;09;284406
24;2020-08-08;4;2;6;152979;161185;19;314164
24;2020-08-08;7;2;9;122237;126536;29;248773
24;2020-08-08;6;2;8;150359;142009;39;292368
24;2020-08-08;4;1;5;161829;158758;49;320587
24;2020-08-08;5;0;5;172552;168011;59;340563
24;2020-08-08;1;1;2;172509;158177;69;330686
24;2020-08-08;0;0;0;129428;110593;79;240021
24;2020-08-08;0;0;0;87342;56882;89;144224
24;2020-08-08;0;0;0;31210;12071;90;43281
24;2020-08-08;29;8;37;1320165;1238908;0;2559073
27;2020-08-08;0;0;0;143373;149679;09;293052
27;2020-08-08;0;1;1;160962;173003;19;333965
27;2020-08-08;4;4;8;133746;142254;29;276000
27;2020-08-08;2;2;4;160004;155407;39;315411
27;2020-08-08;0;1;1;172333;169564;49;341897
27;2020-08-08;2;1;3;189979;183788;59;373767
27;2020-08-08;0;1;1;192591;178206;69;370797
27;2020-08-08;0;0;0;146876;127546;79;274422
27;2020-08-08;0;1;1;96896;61575;89;158471
27;2020-08-08;0;0;0;33148;12109;90;45257
27;2020-08-08;8;11;19;1429908;1353131;0;2783039
28;2020-08-08;2;1;4;180735;186856;09;367591
28;2020-08-08;1;1;2;200125;213621;19;413746
28;2020-08-08;4;3;7;168922;173007;29;341929
28;2020-08-08;5;1;6;196628;188487;39;385115
28;2020-08-08;0;0;0;205396;201699;49;407095
28;2020-08-08;1;0;1;222002;213866;59;435868
28;2020-08-08;0;2;2;224688;203758;69;428446
28;2020-08-08;0;1;1;163192;135543;79;298735
28;2020-08-08;0;0;0;109691;65377;89;175068
28;2020-08-08;1;0;1;37222;12685;90;49907
28;2020-08-08;14;9;24;1708601;1594899;0;3303500
32;2020-08-08;3;3;6;358062;373689;09;731751
32;2020-08-08;5;10;15;387045;406742;19;793787
32;2020-08-08;5;2;8;342304;348587;29;690891
32;2020-08-08;7;5;12;382485;369972;39;752457
32;2020-08-08;6;5;11;382510;376716;49;759226
32;2020-08-08;2;6;8;386937;376527;59;763464
32;2020-08-08;1;1;2;371211;330938;69;702149
32;2020-08-08;2;0;2;250542;201459;79;452001
32;2020-08-08;1;2;3;163399;89786;89;253185
32;2020-08-08;0;0;0;48384;15367;90;63751
32;2020-08-08;32;34;67;3072879;2889783;0;5962662
44;2020-08-08;1;2;3;291525;306839;09;598364
44;2020-08-08;2;1;4;320255;339504;19;659759
44;2020-08-08;3;2;5;302020;314428;29;616448
44;2020-08-08;8;6;14;342222;333292;39;675514
44;2020-08-08;3;3;6;349727;344491;49;694218
44;2020-08-08;1;2;3;381371;373239;59;754610
44;2020-08-08;1;2;3;367165;335850;69;703015
44;2020-08-08;2;1;3;250387;215436;79;465823
44;2020-08-08;0;0;0;170825;105192;89;276017
44;2020-08-08;0;1;1;51248;16731;90;67979
44;2020-08-08;21;20;42;2826745;2685002;0;5511747
52;2020-08-08;1;1;2;213594;223900;09;437494
52;2020-08-08;3;2;6;240818;255197;19;496015
52;2020-08-08;5;3;8;197010;200630;29;397640
52;2020-08-08;8;3;11;231204;224885;39;456089
52;2020-08-08;1;1;2;243874;243418;49;487292
52;2020-08-08;3;2;5;244100;239116;59;483216
52;2020-08-08;3;1;4;241796;221345;69;463141
52;2020-08-08;0;0;0;177805;149903;79;327708
52;2020-08-08;1;1;2;119561;75822;89;195383
52;2020-08-08;0;0;0;42559;15260;90;57819
52;2020-08-08;25;14;40;1952321;1849476;0;3801797
53;2020-08-08;2;3;5;173813;182358;09;356171
53;2020-08-08;4;0;4;202720;214740;19;417460
53;2020-08-08;5;5;10;163116;173196;29;336312
53;2020-08-08;1;2;3;190526;187674;39;378200
53;2020-08-08;2;0;2;212098;212015;49;424113
53;2020-08-08;1;2;3;223699;219176;59;442875
53;2020-08-08;0;1;1;227435;209274;69;436709
53;2020-08-08;1;0;1;169992;140910;79;310902
53;2020-08-08;0;1;1;118117;69883;89;188000
53;2020-08-08;0;0;0;37370;12267;90;49637
53;2020-08-08;16;14;30;1718886;1621493;0;3340379
75;2020-08-08;0;0;0;293104;305291;09;598395
75;2020-08-08;1;1;2;337141;357785;19;694926
75;2020-08-08;6;3;9;295024;300618;29;595642
75;2020-08-08;0;3;3;347871;331233;39;679104
75;2020-08-08;1;1;2;384742;372771;49;757513
75;2020-08-08;2;3;5;413361;390880;59;804241
75;2020-08-08;1;1;2;425623;384060;69;809683
75;2020-08-08;0;0;0;325086;276298;79;601384
75;2020-08-08;0;0;0;213986;139308;89;353294
75;2020-08-08;0;0;0;77600;28200;90;105800
75;2020-08-08;11;12;23;3113538;2886444;0;5999982
76;2020-08-08;0;2;3;305956;318589;09;624545
76;2020-08-08;3;3;6;338942;356969;19;695911
76;2020-08-08;13;13;26;316210;319570;29;635780
76;2020-08-08;5;8;13;356758;337587;39;694345
76;2020-08-08;8;3;11;376541;363812;49;740353
76;2020-08-08;3;1;4;402608;383750;59;786358
76;2020-08-08;3;3;6;394889;358997;69;753886
76;2020-08-08;1;2;3;308664;263806;79;572470
76;2020-08-08;1;0;1;195838;129272;89;325110
76;2020-08-08;0;0;0;69372;26728;90;96100
76;2020-08-08;37;35;73;3065778;2859080;0;5924858
84;2020-08-08;3;3;6;459549;481088;09;940637
84;2020-08-08;4;3;7;487711;511905;19;999616
84;2020-08-08;12;11;23;443824;451094;29;894918
84;2020-08-08;5;6;11;512522;493262;39;1005784
84;2020-08-08;6;5;11;520248;515106;49;1035354
84;2020-08-08;6;3;9;529611;514848;59;1044459
84;2020-08-08;2;2;4;486720;439940;69;926660
84;2020-08-08;3;1;4;372151;315211;79;687362
84;2020-08-08;1;1;2;237198;150524;89;387722
84;2020-08-08;0;0;0;81185;28680;90;109865
84;2020-08-08;42;35;77;4130719;3901658;0;8032377
93;2020-08-08;0;2;2;268834;283093;09;551927
93;2020-08-08;5;5;10;280751;296087;19;576838
93;2020-08-08;18;18;36;254404;255552;29;509956
93;2020-08-08;11;10;21;310704;288398;39;599102
93;2020-08-08;12;12;24;325559;305827;49;631386
93;2020-08-08;6;12;18;353104;325389;59;678493
93;2020-08-08;8;1;9;336327;296459;69;632786
93;2020-08-08;1;4;5;279820;229699;79;509519
93;2020-08-08;5;5;10;171274;113716;89;284990
93;2020-08-08;4;1;5;58896;21758;90;80654
93;2020-08-08;70;70;140;2639673;2415978;0;5055651
94;2020-08-08;0;0;0;16311;17433;09;33744
94;2020-08-08;0;0;0;16679;18132;19;34811
94;2020-08-08;0;1;1;16782;16579;29;33361
94;2020-08-08;0;0;0;23044;20580;39;43624
94;2020-08-08;0;0;0;23065;22140;49;45205
94;2020-08-08;0;0;0;24549;23421;59;47970
94;2020-08-08;0;0;0;23212;21883;69;45095
94;2020-08-08;0;0;0;19544;17141;79;36685
94;2020-08-08;0;0;0;11227;8178;89;19405
94;2020-08-08;0;0;0;3332;1447;90;4779
94;2020-08-08;0;1;1;177745;166934;0;344679
01;2020-08-09;0;0;0;19979;20155;09;40134
01;2020-08-09;0;0;0;24994;25489;19;50483
01;2020-08-09;2;1;3;17868;16690;29;34558
01;2020-08-09;0;1;1;22328;14821;39;37149
01;2020-08-09;0;0;0;28652;20276;49;48928
01;2020-08-09;1;0;1;33264;27260;59;60524
01;2020-08-09;0;0;0;27135;23978;69;51113
01;2020-08-09;0;0;0;18401;14661;79;33062
01;2020-08-09;0;0;0;9633;6375;89;16008
01;2020-08-09;0;0;0;3410;1510;90;4920
01;2020-08-09;3;2;5;205664;171215;0;376879
02;2020-08-09;0;0;0;16881;17110;09;33991
02;2020-08-09;0;0;0;21410;21604;19;43014
02;2020-08-09;0;0;0;16017;15479;29;31496
02;2020-08-09;0;0;0;19825;14455;39;34280
02;2020-08-09;0;1;1;24719;18248;49;42967
02;2020-08-09;0;0;0;34361;28310;59;62671
02;2020-08-09;0;0;0;28061;24495;69;52556
02;2020-08-09;0;0;0;18231;15278;79;33509
02;2020-08-09;0;0;0;11090;7677;89;18767
02;2020-08-09;0;0;0;3992;1506;90;5498
02;2020-08-09;0;1;1;194587;164162;0;358749
03;2020-08-09;0;0;0;31123;30920;09;62043
03;2020-08-09;3;1;4;29370;29268;19;58638
03;2020-08-09;2;2;4;21458;18963;29;40421
03;2020-08-09;1;2;3;21276;18326;39;39602
03;2020-08-09;1;1;2;18164;16593;49;34757
03;2020-08-09;0;0;0;13469;13557;59;27026
03;2020-08-09;1;0;1;8776;8670;69;17446
03;2020-08-09;0;2;2;3777;3591;79;7368
03;2020-08-09;0;0;0;1649;1072;89;2721
03;2020-08-09;0;0;0;485;184;90;669
03;2020-08-09;8;8;16;149547;141144;0;290691
04;2020-08-09;0;0;0;60314;61377;09;121691
04;2020-08-09;2;0;2;66065;68387;19;134452
04;2020-08-09;2;0;2;51059;47156;29;98215
04;2020-08-09;0;0;0;58788;45780;39;104568
04;2020-08-09;1;1;2;61408;52207;49;113615
04;2020-08-09;0;0;0;64838;60759;59;125597
04;2020-08-09;0;0;0;47008;42843;69;89851
04;2020-08-09;0;0;0;25509;21184;79;46693
04;2020-08-09;0;0;0;13168;7647;89;20815
04;2020-08-09;0;0;0;3209;1253;90;4462
04;2020-08-09;5;1;6;451366;408593;0;859959
05;2020-08-09;0;0;0;362.366008612902;341.338819562748;09;703.704828175651
05;2020-08-09;0;0;0;353.376145114279;370.349735405642;19;723.725880519921
05;2020-08-09;0;0;0;218.593559489256;256.539602589476;29;475.133162078732
05;2020-08-09;0;0;0;404.225408693299;360.321910454353;39;764.547319147651
05;2020-08-09;0;0;0;520.067953604221;497.108383964256;49;1017.17633756848
05;2020-08-09;0;0;0;468.146063921917;510.087601910415;59;978.233665832332
05;2020-08-09;0;0;0;340.368470050554;334.366842191253;69;674.735312241807
05;2020-08-09;0;0;0;212.598666888387;192.597753227106;79;405.196420115493
05;2020-08-09;0;0;0;148.727797095705;61.8681715431829;89;210.595968638888
05;2020-08-09;0;0;0;32.9601271090696;10.9909785719784;90;43.9511056810479
05;2020-08-09;0;0;0;3061.43020057959;2935.56979942041;0;5997
06;2020-08-09;0;0;0;42583;42380;09;84963
06;2020-08-09;0;0;0;33369;31925;19;65294
06;2020-08-09;0;0;0;21571;15080;29;36651
06;2020-08-09;0;0;0;21550;16147;39;37697
06;2020-08-09;0;0;0;14193;13939;49;28132
06;2020-08-09;0;0;0;7171;7597;59;14768
06;2020-08-09;0;0;0;3629;4117;69;7746
06;2020-08-09;0;0;0;1577;1457;79;3034
06;2020-08-09;0;0;0;531;474;89;1005
06;2020-08-09;0;0;0;88;93;90;181
06;2020-08-09;0;0;0;146262;133209;0;279471
07;2020-08-09;0;0;0;485;549;09;1034
07;2020-08-09;0;0;0;403;432;19;835
07;2020-08-09;0;0;0;764;841;29;1605
07;2020-08-09;0;0;0;824;928;39;1752
07;2020-08-09;0;0;0;788;1020;49;1808
07;2020-08-09;0;0;0;678;870;59;1548
07;2020-08-09;0;0;0;360;382;69;742
07;2020-08-09;0;0;0;231;190;79;421
07;2020-08-09;0;0;0;114;67;89;181
07;2020-08-09;0;0;0;24;11;90;35
07;2020-08-09;0;0;0;4671;5290;0;9961
08;2020-08-09;0;0;0;2715.22592983026;2997.75551488675;09;5712.98144471701
08;2020-08-09;0;0;0;2778.51901080978;3160.9156459093;19;5939.43465671908
08;2020-08-09;0;0;0;2080.8882988764;1718.16634315323;29;3799.05464202964
08;2020-08-09;0;0;0;2701.8582062647;1896.52641413317;39;4598.38462039786
08;2020-08-09;0;0;0;3151.45861023308;2460.52498233809;49;5611.98359257117
08;2020-08-09;0;0;0;2620.29868333099;2422.23566154656;59;5042.53434487755
08;2020-08-09;0;0;0;1621.44173420671;1438.58325779464;69;3060.02499200135
08;2020-08-09;0;0;0;626.575909335673;526.358467843651;79;1152.93437717932
08;2020-08-09;0;0;0;205.018522985054;140.993639349697;89;346.012162334751
08;2020-08-09;0;0;0;50.0325684687745;20.62259870351;90;70.6551671722846
08;2020-08-09;0;0;0;18551.3174743414;16782.6825256586;0;35334
11;2020-08-09;0;5;5;783071;811785;09;1594856
11;2020-08-09;13;8;21;761456;784653;19;1546109
11;2020-08-09;26;29;55;850145;801772;29;1651917
11;2020-08-09;16;22;38;914360;843488;39;1757848
11;2020-08-09;9;16;25;845609;826202;49;1671811
11;2020-08-09;16;13;29;793566;745070;59;1538636
11;2020-08-09;16;8;24;628649;549192;69;1177841
11;2020-08-09;6;21;27;434606;358356;79;792962
11;2020-08-09;4;2;6;261425;162933;89;424358
11;2020-08-09;1;0;1;89253;32619;90;121872
11;2020-08-09;107;124;231;6362140;5916070;0;12278210
24;2020-08-09;0;0;0;139720;144686;09;284406
24;2020-08-09;0;0;0;152979;161185;19;314164
24;2020-08-09;0;2;2;122237;126536;29;248773
24;2020-08-09;0;0;0;150359;142009;39;292368
24;2020-08-09;0;0;0;161829;158758;49;320587
24;2020-08-09;0;0;0;172552;168011;59;340563
24;2020-08-09;0;0;0;172509;158177;69;330686
24;2020-08-09;0;0;0;129428;110593;79;240021
24;2020-08-09;0;0;0;87342;56882;89;144224
24;2020-08-09;0;0;0;31210;12071;90;43281
24;2020-08-09;0;2;2;1320165;1238908;0;2559073
27;2020-08-09;0;0;0;143373;149679;09;293052
27;2020-08-09;0;0;0;160962;173003;19;333965
27;2020-08-09;0;2;2;133746;142254;29;276000
27;2020-08-09;0;0;0;160004;155407;39;315411
27;2020-08-09;0;0;0;172333;169564;49;341897
27;2020-08-09;0;0;0;189979;183788;59;373767
27;2020-08-09;0;0;0;192591;178206;69;370797
27;2020-08-09;0;1;1;146876;127546;79;274422
27;2020-08-09;1;0;1;96896;61575;89;158471
27;2020-08-09;0;0;0;33148;12109;90;45257
27;2020-08-09;1;3;4;1429908;1353131;0;2783039
28;2020-08-09;0;1;1;180735;186856;09;367591
28;2020-08-09;0;0;0;200125;213621;19;413746
28;2020-08-09;1;2;3;168922;173007;29;341929
28;2020-08-09;2;2;4;196628;188487;39;385115
28;2020-08-09;0;0;0;205396;201699;49;407095
28;2020-08-09;0;2;2;222002;213866;59;435868
28;2020-08-09;1;1;2;224688;203758;69;428446
28;2020-08-09;0;0;0;163192;135543;79;298735
28;2020-08-09;1;0;1;109691;65377;89;175068
28;2020-08-09;0;1;1;37222;12685;90;49907
28;2020-08-09;5;9;14;1708601;1594899;0;3303500
32;2020-08-09;0;0;0;358062;373689;09;731751
32;2020-08-09;1;1;2;387045;406742;19;793787
32;2020-08-09;2;2;4;342304;348587;29;690891
32;2020-08-09;0;0;0;382485;369972;39;752457
32;2020-08-09;1;0;1;382510;376716;49;759226
32;2020-08-09;0;0;0;386937;376527;59;763464
32;2020-08-09;1;2;3;371211;330938;69;702149
32;2020-08-09;1;1;2;250542;201459;79;452001
32;2020-08-09;2;1;3;163399;89786;89;253185
32;2020-08-09;0;0;0;48384;15367;90;63751
32;2020-08-09;8;7;15;3072879;2889783;0;5962662
44;2020-08-09;1;0;1;291525;306839;09;598364
44;2020-08-09;0;0;0;320255;339504;19;659759
44;2020-08-09;0;0;0;302020;314428;29;616448
44;2020-08-09;0;0;0;342222;333292;39;675514
44;2020-08-09;0;0;0;349727;344491;49;694218
44;2020-08-09;0;0;0;381371;373239;59;754610
44;2020-08-09;0;0;0;367165;335850;69;703015
44;2020-08-09;0;0;0;250387;215436;79;465823
44;2020-08-09;0;0;0;170825;105192;89;276017
44;2020-08-09;0;0;0;51248;16731;90;67979
44;2020-08-09;1;0;1;2826745;2685002;0;5511747
52;2020-08-09;0;0;0;213594;223900;09;437494
52;2020-08-09;1;1;2;240818;255197;19;496015
52;2020-08-09;2;1;3;197010;200630;29;397640
52;2020-08-09;2;3;5;231204;224885;39;456089
52;2020-08-09;1;2;3;243874;243418;49;487292
52;2020-08-09;1;0;1;244100;239116;59;483216
52;2020-08-09;1;0;1;241796;221345;69;463141
52;2020-08-09;0;0;0;177805;149903;79;327708
52;2020-08-09;0;1;1;119561;75822;89;195383
52;2020-08-09;0;0;0;42559;15260;90;57819
52;2020-08-09;8;8;16;1952321;1849476;0;3801797
53;2020-08-09;0;0;0;173813;182358;09;356171
53;2020-08-09;0;0;0;202720;214740;19;417460
53;2020-08-09;0;1;1;163116;173196;29;336312
53;2020-08-09;1;1;2;190526;187674;39;378200
53;2020-08-09;0;1;1;212098;212015;49;424113
53;2020-08-09;0;1;1;223699;219176;59;442875
53;2020-08-09;2;0;2;227435;209274;69;436709
53;2020-08-09;0;1;1;169992;140910;79;310902
53;2020-08-09;2;0;2;118117;69883;89;188000
53;2020-08-09;0;0;0;37370;12267;90;49637
53;2020-08-09;5;5;10;1718886;1621493;0;3340379
75;2020-08-09;1;0;1;293104;305291;09;598395
75;2020-08-09;1;0;1;337141;357785;19;694926
75;2020-08-09;0;5;5;295024;300618;29;595642
75;2020-08-09;0;2;2;347871;331233;39;679104
75;2020-08-09;2;0;2;384742;372771;49;757513
75;2020-08-09;0;0;0;413361;390880;59;804241
75;2020-08-09;0;0;0;425623;384060;69;809683
75;2020-08-09;0;0;0;325086;276298;79;601384
75;2020-08-09;0;1;1;213986;139308;89;353294
75;2020-08-09;0;0;0;77600;28200;90;105800
75;2020-08-09;4;8;12;3113538;2886444;0;5999982
76;2020-08-09;3;2;5;305956;318589;09;624545
76;2020-08-09;1;4;5;338942;356969;19;695911
76;2020-08-09;5;4;9;316210;319570;29;635780
76;2020-08-09;3;2;5;356758;337587;39;694345
76;2020-08-09;0;4;4;376541;363812;49;740353
76;2020-08-09;2;1;3;402608;383750;59;786358
76;2020-08-09;1;1;2;394889;358997;69;753886
76;2020-08-09;0;1;1;308664;263806;79;572470
76;2020-08-09;0;0;0;195838;129272;89;325110
76;2020-08-09;0;0;0;69372;26728;90;96100
76;2020-08-09;15;19;34;3065778;2859080;0;5924858
84;2020-08-09;1;0;1;459549;481088;09;940637
84;2020-08-09;2;1;3;487711;511905;19;999616
84;2020-08-09;4;3;7;443824;451094;29;894918
84;2020-08-09;1;1;2;512522;493262;39;1005784
84;2020-08-09;1;1;2;520248;515106;49;1035354
84;2020-08-09;0;1;1;529611;514848;59;1044459
84;2020-08-09;0;1;1;486720;439940;69;926660
84;2020-08-09;1;0;1;372151;315211;79;687362
84;2020-08-09;0;0;0;237198;150524;89;387722
84;2020-08-09;1;0;1;81185;28680;90;109865
84;2020-08-09;11;8;19;4130719;3901658;0;8032377
93;2020-08-09;0;1;1;268834;283093;09;551927
93;2020-08-09;1;1;2;280751;296087;19;576838
93;2020-08-09;0;4;4;254404;255552;29;509956
93;2020-08-09;1;4;5;310704;288398;39;599102
93;2020-08-09;0;2;2;325559;305827;49;631386
93;2020-08-09;2;4;6;353104;325389;59;678493
93;2020-08-09;1;0;1;336327;296459;69;632786
93;2020-08-09;1;1;2;279820;229699;79;509519
93;2020-08-09;0;1;1;171274;113716;89;284990
93;2020-08-09;0;0;0;58896;21758;90;80654
93;2020-08-09;6;18;24;2639673;2415978;0;5055651
94;2020-08-09;0;0;0;16311;17433;09;33744
94;2020-08-09;0;0;0;16679;18132;19;34811
94;2020-08-09;0;0;0;16782;16579;29;33361
94;2020-08-09;0;0;0;23044;20580;39;43624
94;2020-08-09;0;0;0;23065;22140;49;45205
94;2020-08-09;0;0;0;24549;23421;59;47970
94;2020-08-09;0;0;0;23212;21883;69;45095
94;2020-08-09;0;0;0;19544;17141;79;36685
94;2020-08-09;0;0;0;11227;8178;89;19405
94;2020-08-09;1;0;1;3332;1447;90;4779
94;2020-08-09;1;0;1;177745;166934;0;344679
01;2020-08-10;1;1;2;19979;20155;09;40134
01;2020-08-10;2;0;2;24994;25489;19;50483
01;2020-08-10;1;1;2;17868;16690;29;34558
01;2020-08-10;4;1;5;22328;14821;39;37149
01;2020-08-10;1;1;2;28652;20276;49;48928
01;2020-08-10;1;0;1;33264;27260;59;60524
01;2020-08-10;3;3;6;27135;23978;69;51113
01;2020-08-10;0;0;0;18401;14661;79;33062
01;2020-08-10;0;0;0;9633;6375;89;16008
01;2020-08-10;0;0;0;3410;1510;90;4920
01;2020-08-10;13;7;20;205664;171215;0;376879
02;2020-08-10;0;0;0;16881;17110;09;33991
02;2020-08-10;1;1;2;21410;21604;19;43014
02;2020-08-10;3;1;4;16017;15479;29;31496
02;2020-08-10;1;3;4;19825;14455;39;34280
02;2020-08-10;3;0;3;24719;18248;49;42967
02;2020-08-10;2;1;3;34361;28310;59;62671
02;2020-08-10;1;1;2;28061;24495;69;52556
02;2020-08-10;0;0;1;18231;15278;79;33509
02;2020-08-10;1;0;1;11090;7677;89;18767
02;2020-08-10;0;0;0;3992;1506;90;5498
02;2020-08-10;12;7;20;194587;164162;0;358749
03;2020-08-10;10;3;13;31123;30920;09;62043
03;2020-08-10;5;3;8;29370;29268;19;58638
03;2020-08-10;11;7;18;21458;18963;29;40421
03;2020-08-10;5;3;8;21276;18326;39;39602
03;2020-08-10;4;3;7;18164;16593;49;34757
03;2020-08-10;2;0;2;13469;13557;59;27026
03;2020-08-10;2;1;3;8776;8670;69;17446
03;2020-08-10;1;1;2;3777;3591;79;7368
03;2020-08-10;0;0;0;1649;1072;89;2721
03;2020-08-10;0;0;0;485;184;90;669
03;2020-08-10;40;21;61;149547;141144;0;290691
04;2020-08-10;1;0;1;60314;61377;09;121691
04;2020-08-10;3;0;3;66065;68387;19;134452
04;2020-08-10;0;2;2;51059;47156;29;98215
04;2020-08-10;2;0;2;58788;45780;39;104568
04;2020-08-10;3;1;4;61408;52207;49;113615
04;2020-08-10;0;2;2;64838;60759;59;125597
04;2020-08-10;1;1;2;47008;42843;69;89851
04;2020-08-10;0;1;1;25509;21184;79;46693
04;2020-08-10;1;0;1;13168;7647;89;20815
04;2020-08-10;0;0;0;3209;1253;90;4462
04;2020-08-10;11;7;18;451366;408593;0;859959
05;2020-08-10;0;0;0;362.366008612902;341.338819562748;09;703.704828175651
05;2020-08-10;0;0;0;353.376145114279;370.349735405642;19;723.725880519921
05;2020-08-10;0;0;0;218.593559489256;256.539602589476;29;475.133162078732
05;2020-08-10;0;0;0;404.225408693299;360.321910454353;39;764.547319147651
05;2020-08-10;0;0;0;520.067953604221;497.108383964256;49;1017.17633756848
05;2020-08-10;0;0;0;468.146063921917;510.087601910415;59;978.233665832332
05;2020-08-10;0;0;0;340.368470050554;334.366842191253;69;674.735312241807
05;2020-08-10;0;0;0;212.598666888387;192.597753227106;79;405.196420115493
05;2020-08-10;0;0;0;148.727797095705;61.8681715431829;89;210.595968638888
05;2020-08-10;0;0;0;32.9601271090696;10.9909785719784;90;43.9511056810479
05;2020-08-10;0;0;0;3061.43020057959;2935.56979942041;0;5997
06;2020-08-10;0;0;0;42583;42380;09;84963
06;2020-08-10;0;5;5;33369;31925;19;65294
06;2020-08-10;1;3;4;21571;15080;29;36651
06;2020-08-10;1;1;2;21550;16147;39;37697
06;2020-08-10;0;5;5;14193;13939;49;28132
06;2020-08-10;1;0;1;7171;7597;59;14768
06;2020-08-10;0;1;1;3629;4117;69;7746
06;2020-08-10;0;0;0;1577;1457;79;3034
06;2020-08-10;0;0;0;531;474;89;1005
06;2020-08-10;0;0;0;88;93;90;181
06;2020-08-10;3;15;18;146262;133209;0;279471
07;2020-08-10;0;0;0;485;549;09;1034
07;2020-08-10;0;0;0;403;432;19;835
07;2020-08-10;0;0;0;764;841;29;1605
07;2020-08-10;0;0;0;824;928;39;1752
07;2020-08-10;0;0;0;788;1020;49;1808
07;2020-08-10;0;0;0;678;870;59;1548
07;2020-08-10;0;0;0;360;382;69;742
07;2020-08-10;0;0;0;231;190;79;421
07;2020-08-10;0;0;0;114;67;89;181
07;2020-08-10;0;0;0;24;11;90;35
07;2020-08-10;0;0;0;4671;5290;0;9961
08;2020-08-10;0;0;0;2715.22592983026;2997.75551488675;09;5712.98144471701
08;2020-08-10;0;0;0;2778.51901080978;3160.9156459093;19;5939.43465671908
08;2020-08-10;0;0;0;2080.8882988764;1718.16634315323;29;3799.05464202964
08;2020-08-10;0;0;0;2701.8582062647;1896.52641413317;39;4598.38462039786
08;2020-08-10;0;0;0;3151.45861023308;2460.52498233809;49;5611.98359257117
08;2020-08-10;0;0;0;2620.29868333099;2422.23566154656;59;5042.53434487755
08;2020-08-10;2;3;5;1621.44173420671;1438.58325779464;69;3060.02499200135
08;2020-08-10;0;0;0;626.575909335673;526.358467843651;79;1152.93437717932
08;2020-08-10;0;0;0;205.018522985054;140.993639349697;89;346.012162334751
08;2020-08-10;0;0;0;50.0325684687745;20.62259870351;90;70.6551671722846
08;2020-08-10;2;3;5;18551.3174743414;16782.6825256586;0;35334
11;2020-08-10;11;17;28;783071;811785;09;1594856
11;2020-08-10;40;46;87;761456;784653;19;1546109
11;2020-08-10;167;158;325;850145;801772;29;1651917
11;2020-08-10;91;110;201;914360;843488;39;1757848
11;2020-08-10;52;59;111;845609;826202;49;1671811
11;2020-08-10;47;59;106;793566;745070;59;1538636
11;2020-08-10;22;28;50;628649;549192;69;1177841
11;2020-08-10;11;16;27;434606;358356;79;792962
11;2020-08-10;7;6;13;261425;162933;89;424358
11;2020-08-10;2;3;5;89253;32619;90;121872
11;2020-08-10;450;502;955;6362140;5916070;0;12278210
24;2020-08-10;2;0;2;139720;144686;09;284406
24;2020-08-10;11;4;15;152979;161185;19;314164
24;2020-08-10;9;14;23;122237;126536;29;248773
24;2020-08-10;6;9;15;150359;142009;39;292368
24;2020-08-10;8;1;9;161829;158758;49;320587
24;2020-08-10;4;3;7;172552;168011;59;340563
24;2020-08-10;2;1;3;172509;158177;69;330686
24;2020-08-10;3;0;3;129428;110593;79;240021
24;2020-08-10;0;0;0;87342;56882;89;144224
24;2020-08-10;1;0;1;31210;12071;90;43281
24;2020-08-10;46;32;78;1320165;1238908;0;2559073
27;2020-08-10;4;1;5;143373;149679;09;293052
27;2020-08-10;2;2;4;160962;173003;19;333965
27;2020-08-10;4;2;6;133746;142254;29;276000
27;2020-08-10;6;3;9;160004;155407;39;315411
27;2020-08-10;4;3;7;172333;169564;49;341897
27;2020-08-10;2;3;5;189979;183788;59;373767
27;2020-08-10;0;1;1;192591;178206;69;370797
27;2020-08-10;1;0;1;146876;127546;79;274422
27;2020-08-10;0;1;1;96896;61575;89;158471
27;2020-08-10;0;0;0;33148;12109;90;45257
27;2020-08-10;23;16;39;1429908;1353131;0;2783039
28;2020-08-10;0;1;1;180735;186856;09;367591
28;2020-08-10;3;2;5;200125;213621;19;413746
28;2020-08-10;5;5;10;168922;173007;29;341929
28;2020-08-10;2;4;6;196628;188487;39;385115
28;2020-08-10;4;1;5;205396;201699;49;407095
28;2020-08-10;2;1;3;222002;213866;59;435868
28;2020-08-10;4;0;4;224688;203758;69;428446
28;2020-08-10;2;0;2;163192;135543;79;298735
28;2020-08-10;0;0;0;109691;65377;89;175068
28;2020-08-10;1;0;1;37222;12685;90;49907
28;2020-08-10;23;14;37;1708601;1594899;0;3303500
32;2020-08-10;8;5;13;358062;373689;09;731751
32;2020-08-10;8;17;25;387045;406742;19;793787
32;2020-08-10;21;20;41;342304;348587;29;690891
32;2020-08-10;16;15;31;382485;369972;39;752457
32;2020-08-10;14;7;21;382510;376716;49;759226
32;2020-08-10;14;17;31;386937;376527;59;763464
32;2020-08-10;6;8;14;371211;330938;69;702149
32;2020-08-10;5;6;11;250542;201459;79;452001
32;2020-08-10;4;2;6;163399;89786;89;253185
32;2020-08-10;1;1;2;48384;15367;90;63751
32;2020-08-10;97;98;195;3072879;2889783;0;5962662
44;2020-08-10;3;1;4;291525;306839;09;598364
44;2020-08-10;6;2;8;320255;339504;19;659759
44;2020-08-10;13;11;24;302020;314428;29;616448
44;2020-08-10;5;6;11;342222;333292;39;675514
44;2020-08-10;3;10;13;349727;344491;49;694218
44;2020-08-10;7;7;14;381371;373239;59;754610
44;2020-08-10;3;2;5;367165;335850;69;703015
44;2020-08-10;2;5;7;250387;215436;79;465823
44;2020-08-10;3;1;4;170825;105192;89;276017
44;2020-08-10;1;2;3;51248;16731;90;67979
44;2020-08-10;46;47;93;2826745;2685002;0;5511747
52;2020-08-10;8;5;13;213594;223900;09;437494
52;2020-08-10;6;7;13;240818;255197;19;496015
52;2020-08-10;5;13;18;197010;200630;29;397640
52;2020-08-10;8;7;15;231204;224885;39;456089
52;2020-08-10;11;3;14;243874;243418;49;487292
52;2020-08-10;4;6;10;244100;239116;59;483216
52;2020-08-10;4;6;10;241796;221345;69;463141
52;2020-08-10;3;0;3;177805;149903;79;327708
52;2020-08-10;8;1;9;119561;75822;89;195383
52;2020-08-10;4;0;4;42559;15260;90;57819
52;2020-08-10;61;48;109;1952321;1849476;0;3801797
53;2020-08-10;2;3;5;173813;182358;09;356171
53;2020-08-10;3;4;7;202720;214740;19;417460
53;2020-08-10;10;9;19;163116;173196;29;336312
53;2020-08-10;4;2;6;190526;187674;39;378200
53;2020-08-10;2;4;6;212098;212015;49;424113
53;2020-08-10;6;3;9;223699;219176;59;442875
53;2020-08-10;2;1;3;227435;209274;69;436709
53;2020-08-10;0;1;1;169992;140910;79;310902
53;2020-08-10;1;0;1;118117;69883;89;188000
53;2020-08-10;1;0;1;37370;12267;90;49637
53;2020-08-10;31;27;58;1718886;1621493;0;3340379
75;2020-08-10;0;0;0;293104;305291;09;598395
75;2020-08-10;6;8;14;337141;357785;19;694926
75;2020-08-10;9;22;31;295024;300618;29;595642
75;2020-08-10;7;14;21;347871;331233;39;679104
75;2020-08-10;5;5;10;384742;372771;49;757513
75;2020-08-10;6;3;9;413361;390880;59;804241
75;2020-08-10;3;4;7;425623;384060;69;809683
75;2020-08-10;1;1;2;325086;276298;79;601384
75;2020-08-10;0;1;1;213986;139308;89;353294
75;2020-08-10;0;0;0;77600;28200;90;105800
75;2020-08-10;37;58;95;3113538;2886444;0;5999982
76;2020-08-10;1;0;1;305956;318589;09;624545
76;2020-08-10;11;7;18;338942;356969;19;695911
76;2020-08-10;39;32;71;316210;319570;29;635780
76;2020-08-10;18;14;32;356758;337587;39;694345
76;2020-08-10;16;10;26;376541;363812;49;740353
76;2020-08-10;8;18;26;402608;383750;59;786358
76;2020-08-10;8;4;12;394889;358997;69;753886
76;2020-08-10;3;4;7;308664;263806;79;572470
76;2020-08-10;0;3;3;195838;129272;89;325110
76;2020-08-10;0;0;0;69372;26728;90;96100
76;2020-08-10;104;92;196;3065778;2859080;0;5924858
84;2020-08-10;7;1;8;459549;481088;09;940637
84;2020-08-10;15;11;26;487711;511905;19;999616
84;2020-08-10;31;28;59;443824;451094;29;894918
84;2020-08-10;21;22;43;512522;493262;39;1005784
84;2020-08-10;10;9;19;520248;515106;49;1035354
84;2020-08-10;14;12;26;529611;514848;59;1044459
84;2020-08-10;8;6;14;486720;439940;69;926660
84;2020-08-10;6;4;10;372151;315211;79;687362
84;2020-08-10;2;2;4;237198;150524;89;387722
84;2020-08-10;1;0;1;81185;28680;90;109865
84;2020-08-10;115;95;210;4130719;3901658;0;8032377
93;2020-08-10;7;8;15;268834;283093;09;551927
93;2020-08-10;29;22;51;280751;296087;19;576838
93;2020-08-10;94;84;178;254404;255552;29;509956
93;2020-08-10;46;55;101;310704;288398;39;599102
93;2020-08-10;30;44;74;325559;305827;49;631386
93;2020-08-10;33;43;76;353104;325389;59;678493
93;2020-08-10;21;16;37;336327;296459;69;632786
93;2020-08-10;11;7;18;279820;229699;79;509519
93;2020-08-10;5;3;8;171274;113716;89;284990
93;2020-08-10;3;0;3;58896;21758;90;80654
93;2020-08-10;279;282;561;2639673;2415978;0;5055651
94;2020-08-10;0;0;0;16311;17433;09;33744
94;2020-08-10;0;0;0;16679;18132;19;34811
94;2020-08-10;1;1;2;16782;16579;29;33361
94;2020-08-10;0;0;0;23044;20580;39;43624
94;2020-08-10;0;0;0;23065;22140;49;45205
94;2020-08-10;0;1;1;24549;23421;59;47970
94;2020-08-10;0;0;0;23212;21883;69;45095
94;2020-08-10;0;1;1;19544;17141;79;36685
94;2020-08-10;0;0;0;11227;8178;89;19405
94;2020-08-10;0;0;0;3332;1447;90;4779
94;2020-08-10;1;3;4;177745;166934;0;344679
01;2020-08-11;0;1;1;19979;20155;09;40134
01;2020-08-11;3;2;5;24994;25489;19;50483
01;2020-08-11;5;5;10;17868;16690;29;34558
01;2020-08-11;2;4;6;22328;14821;39;37149
01;2020-08-11;3;3;6;28652;20276;49;48928
01;2020-08-11;2;4;6;33264;27260;59;60524
01;2020-08-11;1;1;2;27135;23978;69;51113
01;2020-08-11;1;0;1;18401;14661;79;33062
01;2020-08-11;1;0;1;9633;6375;89;16008
01;2020-08-11;0;0;0;3410;1510;90;4920
01;2020-08-11;18;20;38;205664;171215;0;376879
02;2020-08-11;1;1;2;16881;17110;09;33991
02;2020-08-11;1;0;1;21410;21604;19;43014
02;2020-08-11;6;5;11;16017;15479;29;31496
02;2020-08-11;3;3;6;19825;14455;39;34280
02;2020-08-11;1;2;3;24719;18248;49;42967
02;2020-08-11;2;2;4;34361;28310;59;62671
02;2020-08-11;2;1;3;28061;24495;69;52556
02;2020-08-11;0;0;0;18231;15278;79;33509
02;2020-08-11;0;0;0;11090;7677;89;18767
02;2020-08-11;0;0;0;3992;1506;90;5498
02;2020-08-11;16;14;30;194587;164162;0;358749
03;2020-08-11;5;7;13;31123;30920;09;62043
03;2020-08-11;3;1;4;29370;29268;19;58638
03;2020-08-11;4;7;12;21458;18963;29;40421
03;2020-08-11;7;1;8;21276;18326;39;39602
03;2020-08-11;2;5;7;18164;16593;49;34757
03;2020-08-11;2;3;5;13469;13557;59;27026
03;2020-08-11;1;1;2;8776;8670;69;17446
03;2020-08-11;0;1;1;3777;3591;79;7368
03;2020-08-11;0;0;0;1649;1072;89;2721
03;2020-08-11;0;0;0;485;184;90;669
03;2020-08-11;24;26;52;149547;141144;0;290691
04;2020-08-11;0;1;1;60314;61377;09;121691
04;2020-08-11;6;0;6;66065;68387;19;134452
04;2020-08-11;3;0;3;51059;47156;29;98215
04;2020-08-11;4;1;5;58788;45780;39;104568
04;2020-08-11;7;4;11;61408;52207;49;113615
04;2020-08-11;4;3;7;64838;60759;59;125597
04;2020-08-11;2;1;3;47008;42843;69;89851
04;2020-08-11;0;0;0;25509;21184;79;46693
04;2020-08-11;0;0;0;13168;7647;89;20815
04;2020-08-11;0;0;0;3209;1253;90;4462
04;2020-08-11;26;10;36;451366;408593;0;859959
05;2020-08-11;0;0;0;362.366008612902;341.338819562748;09;703.704828175651
05;2020-08-11;0;0;0;353.376145114279;370.349735405642;19;723.725880519921
05;2020-08-11;0;0;0;218.593559489256;256.539602589476;29;475.133162078732
05;2020-08-11;0;0;0;404.225408693299;360.321910454353;39;764.547319147651
05;2020-08-11;0;0;0;520.067953604221;497.108383964256;49;1017.17633756848
05;2020-08-11;0;0;0;468.146063921917;510.087601910415;59;978.233665832332
05;2020-08-11;0;0;0;340.368470050554;334.366842191253;69;674.735312241807
05;2020-08-11;0;0;0;212.598666888387;192.597753227106;79;405.196420115493
05;2020-08-11;0;0;0;148.727797095705;61.8681715431829;89;210.595968638888
05;2020-08-11;0;0;0;32.9601271090696;10.9909785719784;90;43.9511056810479
05;2020-08-11;0;0;0;3061.43020057959;2935.56979942041;0;5997
06;2020-08-11;0;0;0;42583;42380;09;84963
06;2020-08-11;1;1;2;33369;31925;19;65294
06;2020-08-11;2;1;3;21571;15080;29;36651
06;2020-08-11;1;2;3;21550;16147;39;37697
06;2020-08-11;1;3;4;14193;13939;49;28132
06;2020-08-11;0;1;1;7171;7597;59;14768
06;2020-08-11;2;0;2;3629;4117;69;7746
06;2020-08-11;0;0;0;1577;1457;79;3034
06;2020-08-11;0;1;1;531;474;89;1005
06;2020-08-11;0;0;0;88;93;90;181
06;2020-08-11;7;9;16;146262;133209;0;279471
07;2020-08-11;0;0;0;485;549;09;1034
07;2020-08-11;0;0;0;403;432;19;835
07;2020-08-11;0;0;0;764;841;29;1605
07;2020-08-11;0;0;0;824;928;39;1752
07;2020-08-11;0;0;0;788;1020;49;1808
07;2020-08-11;0;0;0;678;870;59;1548
07;2020-08-11;0;0;0;360;382;69;742
07;2020-08-11;0;0;0;231;190;79;421
07;2020-08-11;0;0;0;114;67;89;181
07;2020-08-11;0;0;0;24;11;90;35
07;2020-08-11;0;0;0;4671;5290;0;9961
08;2020-08-11;0;0;0;2715.22592983026;2997.75551488675;09;5712.98144471701
08;2020-08-11;0;0;0;2778.51901080978;3160.9156459093;19;5939.43465671908
08;2020-08-11;1;0;1;2080.8882988764;1718.16634315323;29;3799.05464202964
08;2020-08-11;1;0;1;2701.8582062647;1896.52641413317;39;4598.38462039786
08;2020-08-11;0;0;0;3151.45861023308;2460.52498233809;49;5611.98359257117
08;2020-08-11;0;0;0;2620.29868333099;2422.23566154656;59;5042.53434487755
08;2020-08-11;0;2;2;1621.44173420671;1438.58325779464;69;3060.02499200135
08;2020-08-11;0;0;0;626.575909335673;526.358467843651;79;1152.93437717932
08;2020-08-11;0;0;0;205.018522985054;140.993639349697;89;346.012162334751
08;2020-08-11;0;0;0;50.0325684687745;20.62259870351;90;70.6551671722846
08;2020-08-11;2;2;4;18551.3174743414;16782.6825256586;0;35334
11;2020-08-11;10;21;33;783071;811785;09;1594856
11;2020-08-11;51;37;88;761456;784653;19;1546109
11;2020-08-11;151;143;294;850145;801772;29;1651917
11;2020-08-11;84;96;180;914360;843488;39;1757848
11;2020-08-11;55;60;115;845609;826202;49;1671811
11;2020-08-11;42;41;83;793566;745070;59;1538636
11;2020-08-11;35;23;58;628649;549192;69;1177841
11;2020-08-11;17;17;34;434606;358356;79;792962
11;2020-08-11;11;6;17;261425;162933;89;424358
11;2020-08-11;4;2;6;89253;32619;90;121872
11;2020-08-11;461;446;911;6362140;5916070;0;12278210
24;2020-08-11;3;2;5;139720;144686;09;284406
24;2020-08-11;6;0;6;152979;161185;19;314164
24;2020-08-11;7;8;15;122237;126536;29;248773
24;2020-08-11;6;6;12;150359;142009;39;292368
24;2020-08-11;4;6;10;161829;158758;49;320587
24;2020-08-11;2;2;4;172552;168011;59;340563
24;2020-08-11;1;2;3;172509;158177;69;330686
24;2020-08-11;0;1;1;129428;110593;79;240021
24;2020-08-11;0;0;0;87342;56882;89;144224
24;2020-08-11;1;0;1;31210;12071;90;43281
24;2020-08-11;30;27;57;1320165;1238908;0;2559073
27;2020-08-11;1;0;1;143373;149679;09;293052
27;2020-08-11;1;2;3;160962;173003;19;333965
27;2020-08-11;0;8;8;133746;142254;29;276000
27;2020-08-11;4;4;8;160004;155407;39;315411
27;2020-08-11;1;0;1;172333;169564;49;341897
27;2020-08-11;2;4;6;189979;183788;59;373767
27;2020-08-11;3;5;8;192591;178206;69;370797
27;2020-08-11;1;0;1;146876;127546;79;274422
27;2020-08-11;1;1;2;96896;61575;89;158471
27;2020-08-11;0;0;0;33148;12109;90;45257
27;2020-08-11;14;24;38;1429908;1353131;0;2783039
28;2020-08-11;0;3;3;180735;186856;09;367591
28;2020-08-11;4;5;9;200125;213621;19;413746
28;2020-08-11;6;9;15;168922;173007;29;341929
28;2020-08-11;1;4;5;196628;188487;39;385115
28;2020-08-11;4;2;6;205396;201699;49;407095
28;2020-08-11;1;4;5;222002;213866;59;435868
28;2020-08-11;1;0;1;224688;203758;69;428446
28;2020-08-11;0;0;0;163192;135543;79;298735
28;2020-08-11;1;1;2;109691;65377;89;175068
28;2020-08-11;0;0;0;37222;12685;90;49907
28;2020-08-11;18;28;46;1708601;1594899;0;3303500
32;2020-08-11;4;5;9;358062;373689;09;731751
32;2020-08-11;13;11;24;387045;406742;19;793787
32;2020-08-11;20;29;49;342304;348587;29;690891
32;2020-08-11;21;11;32;382485;369972;39;752457
32;2020-08-11;12;13;25;382510;376716;49;759226
32;2020-08-11;7;8;15;386937;376527;59;763464
32;2020-08-11;8;5;13;371211;330938;69;702149
32;2020-08-11;7;6;13;250542;201459;79;452001
32;2020-08-11;4;4;8;163399;89786;89;253185
32;2020-08-11;0;0;0;48384;15367;90;63751
32;2020-08-11;96;92;188;3072879;2889783;0;5962662
44;2020-08-11;4;3;7;291525;306839;09;598364
44;2020-08-11;7;7;14;320255;339504;19;659759
44;2020-08-11;20;18;38;302020;314428;29;616448
44;2020-08-11;12;11;23;342222;333292;39;675514
44;2020-08-11;1;4;5;349727;344491;49;694218
44;2020-08-11;4;3;7;381371;373239;59;754610
44;2020-08-11;6;3;9;367165;335850;69;703015
44;2020-08-11;3;1;4;250387;215436;79;465823
44;2020-08-11;2;2;4;170825;105192;89;276017
44;2020-08-11;0;0;0;51248;16731;90;67979
44;2020-08-11;59;52;111;2826745;2685002;0;5511747
52;2020-08-11;3;6;9;213594;223900;09;437494
52;2020-08-11;5;4;9;240818;255197;19;496015
52;2020-08-11;16;13;29;197010;200630;29;397640
52;2020-08-11;6;13;19;231204;224885;39;456089
52;2020-08-11;10;2;12;243874;243418;49;487292
52;2020-08-11;3;3;6;244100;239116;59;483216
52;2020-08-11;3;2;5;241796;221345;69;463141
52;2020-08-11;0;3;3;177805;149903;79;327708
52;2020-08-11;0;1;1;119561;75822;89;195383
52;2020-08-11;1;0;1;42559;15260;90;57819
52;2020-08-11;47;47;94;1952321;1849476;0;3801797
53;2020-08-11;0;1;1;173813;182358;09;356171
53;2020-08-11;3;2;6;202720;214740;19;417460
53;2020-08-11;7;8;15;163116;173196;29;336312
53;2020-08-11;3;2;5;190526;187674;39;378200
53;2020-08-11;5;8;13;212098;212015;49;424113
53;2020-08-11;3;4;7;223699;219176;59;442875
53;2020-08-11;3;3;6;227435;209274;69;436709
53;2020-08-11;1;0;1;169992;140910;79;310902
53;2020-08-11;0;0;0;118117;69883;89;188000
53;2020-08-11;0;1;1;37370;12267;90;49637
53;2020-08-11;25;29;55;1718886;1621493;0;3340379
75;2020-08-11;1;0;1;293104;305291;09;598395
75;2020-08-11;13;3;16;337141;357785;19;694926
75;2020-08-11;14;6;20;295024;300618;29;595642
75;2020-08-11;4;9;13;347871;331233;39;679104
75;2020-08-11;9;9;18;384742;372771;49;757513
75;2020-08-11;7;4;11;413361;390880;59;804241
75;2020-08-11;2;3;5;425623;384060;69;809683
75;2020-08-11;1;4;5;325086;276298;79;601384
75;2020-08-11;3;0;3;213986;139308;89;353294
75;2020-08-11;1;0;1;77600;28200;90;105800
75;2020-08-11;55;38;93;3113538;2886444;0;5999982
76;2020-08-11;6;3;9;305956;318589;09;624545
76;2020-08-11;10;22;32;338942;356969;19;695911
76;2020-08-11;38;34;72;316210;319570;29;635780
76;2020-08-11;15;25;40;356758;337587;39;694345
76;2020-08-11;22;22;44;376541;363812;49;740353
76;2020-08-11;18;6;24;402608;383750;59;786358
76;2020-08-11;6;1;7;394889;358997;69;753886
76;2020-08-11;2;2;4;308664;263806;79;572470
76;2020-08-11;1;0;1;195838;129272;89;325110
76;2020-08-11;0;0;0;69372;26728;90;96100
76;2020-08-11;118;115;233;3065778;2859080;0;5924858
84;2020-08-11;1;4;5;459549;481088;09;940637
84;2020-08-11;12;10;22;487711;511905;19;999616
84;2020-08-11;38;28;66;443824;451094;29;894918
84;2020-08-11;14;10;24;512522;493262;39;1005784
84;2020-08-11;11;7;18;520248;515106;49;1035354
84;2020-08-11;16;4;20;529611;514848;59;1044459
84;2020-08-11;9;8;17;486720;439940;69;926660
84;2020-08-11;4;8;12;372151;315211;79;687362
84;2020-08-11;5;4;9;237198;150524;89;387722
84;2020-08-11;1;0;1;81185;28680;90;109865
84;2020-08-11;111;83;194;4130719;3901658;0;8032377
93;2020-08-11;2;3;5;268834;283093;09;551927
93;2020-08-11;21;24;45;280751;296087;19;576838
93;2020-08-11;64;71;135;254404;255552;29;509956
93;2020-08-11;32;56;88;310704;288398;39;599102
93;2020-08-11;30;25;55;325559;305827;49;631386
93;2020-08-11;20;29;49;353104;325389;59;678493
93;2020-08-11;13;14;27;336327;296459;69;632786
93;2020-08-11;6;9;15;279820;229699;79;509519
93;2020-08-11;10;4;14;171274;113716;89;284990
93;2020-08-11;7;3;10;58896;21758;90;80654
93;2020-08-11;205;238;443;2639673;2415978;0;5055651
94;2020-08-11;0;0;0;16311;17433;09;33744
94;2020-08-11;0;0;0;16679;18132;19;34811
94;2020-08-11;0;0;0;16782;16579;29;33361
94;2020-08-11;0;0;0;23044;20580;39;43624
94;2020-08-11;0;0;0;23065;22140;49;45205
94;2020-08-11;0;1;1;24549;23421;59;47970
94;2020-08-11;0;0;0;23212;21883;69;45095
94;2020-08-11;0;0;0;19544;17141;79;36685
94;2020-08-11;0;0;0;11227;8178;89;19405
94;2020-08-11;0;0;0;3332;1447;90;4779
94;2020-08-11;0;1;1;177745;166934;0;344679
01;2020-08-12;0;0;0;19979;20155;09;40134
01;2020-08-12;2;0;2;24994;25489;19;50483
01;2020-08-12;6;5;11;17868;16690;29;34558
01;2020-08-12;3;2;5;22328;14821;39;37149
01;2020-08-12;1;0;1;28652;20276;49;48928
01;2020-08-12;0;1;1;33264;27260;59;60524
01;2020-08-12;1;2;3;27135;23978;69;51113
01;2020-08-12;0;0;0;18401;14661;79;33062
01;2020-08-12;0;0;0;9633;6375;89;16008
01;2020-08-12;0;0;0;3410;1510;90;4920
01;2020-08-12;13;10;23;205664;171215;0;376879
02;2020-08-12;1;1;2;16881;17110;09;33991
02;2020-08-12;2;1;3;21410;21604;19;43014
02;2020-08-12;3;1;4;16017;15479;29;31496
02;2020-08-12;0;0;0;19825;14455;39;34280
02;2020-08-12;3;1;4;24719;18248;49;42967
02;2020-08-12;1;2;3;34361;28310;59;62671
02;2020-08-12;1;2;3;28061;24495;69;52556
02;2020-08-12;1;0;1;18231;15278;79;33509
02;2020-08-12;0;0;0;11090;7677;89;18767
02;2020-08-12;0;0;0;3992;1506;90;5498
02;2020-08-12;12;8;20;194587;164162;0;358749
03;2020-08-12;5;4;9;31123;30920;09;62043
03;2020-08-12;1;2;3;29370;29268;19;58638
03;2020-08-12;5;4;9;21458;18963;29;40421
03;2020-08-12;3;7;10;21276;18326;39;39602
03;2020-08-12;5;1;6;18164;16593;49;34757
03;2020-08-12;1;0;1;13469;13557;59;27026
03;2020-08-12;2;2;4;8776;8670;69;17446
03;2020-08-12;1;0;1;3777;3591;79;7368
03;2020-08-12;0;1;1;1649;1072;89;2721
03;2020-08-12;0;0;0;485;184;90;669
03;2020-08-12;23;21;44;149547;141144;0;290691
04;2020-08-12;0;0;0;60314;61377;09;121691
04;2020-08-12;2;0;2;66065;68387;19;134452
04;2020-08-12;4;1;5;51059;47156;29;98215
04;2020-08-12;1;1;2;58788;45780;39;104568
04;2020-08-12;2;2;4;61408;52207;49;113615
04;2020-08-12;1;2;3;64838;60759;59;125597
04;2020-08-12;1;1;2;47008;42843;69;89851
04;2020-08-12;1;1;2;25509;21184;79;46693
04;2020-08-12;0;1;1;13168;7647;89;20815
04;2020-08-12;0;0;0;3209;1253;90;4462
04;2020-08-12;12;9;21;451366;408593;0;859959
05;2020-08-12;0;0;0;362.366008612902;341.338819562748;09;703.704828175651
05;2020-08-12;0;0;0;353.376145114279;370.349735405642;19;723.725880519921
05;2020-08-12;0;0;0;218.593559489256;256.539602589476;29;475.133162078732
05;2020-08-12;0;0;0;404.225408693299;360.321910454353;39;764.547319147651
05;2020-08-12;0;0;0;520.067953604221;497.108383964256;49;1017.17633756848
05;2020-08-12;0;0;0;468.146063921917;510.087601910415;59;978.233665832332
05;2020-08-12;0;0;0;340.368470050554;334.366842191253;69;674.735312241807
05;2020-08-12;0;0;0;212.598666888387;192.597753227106;79;405.196420115493
05;2020-08-12;0;0;0;148.727797095705;61.8681715431829;89;210.595968638888
05;2020-08-12;0;0;0;32.9601271090696;10.9909785719784;90;43.9511056810479
05;2020-08-12;0;0;0;3061.43020057959;2935.56979942041;0;5997
06;2020-08-12;0;0;0;42583;42380;09;84963
06;2020-08-12;2;1;3;33369;31925;19;65294
06;2020-08-12;2;4;6;21571;15080;29;36651
06;2020-08-12;1;3;4;21550;16147;39;37697
06;2020-08-12;1;0;1;14193;13939;49;28132
06;2020-08-12;0;1;1;7171;7597;59;14768
06;2020-08-12;0;0;0;3629;4117;69;7746
06;2020-08-12;0;0;0;1577;1457;79;3034
06;2020-08-12;0;0;0;531;474;89;1005
06;2020-08-12;0;0;0;88;93;90;181
06;2020-08-12;6;9;15;146262;133209;0;279471
07;2020-08-12;0;0;0;485;549;09;1034
07;2020-08-12;0;1;1;403;432;19;835
07;2020-08-12;0;0;0;764;841;29;1605
07;2020-08-12;0;0;0;824;928;39;1752
07;2020-08-12;0;0;0;788;1020;49;1808
07;2020-08-12;0;0;0;678;870;59;1548
07;2020-08-12;0;0;0;360;382;69;742
07;2020-08-12;0;0;0;231;190;79;421
07;2020-08-12;0;0;0;114;67;89;181
07;2020-08-12;0;0;0;24;11;90;35
07;2020-08-12;0;1;1;4671;5290;0;9961
08;2020-08-12;0;0;0;2715.22592983026;2997.75551488675;09;5712.98144471701
08;2020-08-12;0;0;0;2778.51901080978;3160.9156459093;19;5939.43465671908
08;2020-08-12;0;0;0;2080.8882988764;1718.16634315323;29;3799.05464202964
08;2020-08-12;0;0;0;2701.8582062647;1896.52641413317;39;4598.38462039786
08;2020-08-12;0;1;1;3151.45861023308;2460.52498233809;49;5611.98359257117
08;2020-08-12;0;0;0;2620.29868333099;2422.23566154656;59;5042.53434487755
08;2020-08-12;3;1;4;1621.44173420671;1438.58325779464;69;3060.02499200135
08;2020-08-12;0;1;1;626.575909335673;526.358467843651;79;1152.93437717932
08;2020-08-12;0;0;0;205.018522985054;140.993639349697;89;346.012162334751
08;2020-08-12;0;0;0;50.0325684687745;20.62259870351;90;70.6551671722846
08;2020-08-12;3;3;6;18551.3174743414;16782.6825256586;0;35334
11;2020-08-12;17;13;32;783071;811785;09;1594856
11;2020-08-12;41;40;83;761456;784653;19;1546109
11;2020-08-12;145;171;316;850145;801772;29;1651917
11;2020-08-12;74;123;197;914360;843488;39;1757848
11;2020-08-12;55;70;125;845609;826202;49;1671811
11;2020-08-12;47;48;95;793566;745070;59;1538636
11;2020-08-12;35;22;57;628649;549192;69;1177841
11;2020-08-12;12;16;28;434606;358356;79;792962
11;2020-08-12;7;3;10;261425;162933;89;424358
11;2020-08-12;3;0;3;89253;32619;90;121872
11;2020-08-12;436;506;948;6362140;5916070;0;12278210
24;2020-08-12;0;3;3;139720;144686;09;284406
24;2020-08-12;8;2;10;152979;161185;19;314164
24;2020-08-12;11;8;19;122237;126536;29;248773
24;2020-08-12;7;7;14;150359;142009;39;292368
24;2020-08-12;6;6;12;161829;158758;49;320587
24;2020-08-12;3;7;10;172552;168011;59;340563
24;2020-08-12;3;3;6;172509;158177;69;330686
24;2020-08-12;0;3;3;129428;110593;79;240021
24;2020-08-12;1;1;2;87342;56882;89;144224
24;2020-08-12;0;0;0;31210;12071;90;43281
24;2020-08-12;39;40;79;1320165;1238908;0;2559073
27;2020-08-12;0;1;1;143373;149679;09;293052
27;2020-08-12;5;0;5;160962;173003;19;333965
27;2020-08-12;7;7;14;133746;142254;29;276000
27;2020-08-12;3;3;6;160004;155407;39;315411
27;2020-08-12;1;0;1;172333;169564;49;341897
27;2020-08-12;3;4;7;189979;183788;59;373767
27;2020-08-12;1;4;5;192591;178206;69;370797
27;2020-08-12;2;2;4;146876;127546;79;274422
27;2020-08-12;0;0;0;96896;61575;89;158471
27;2020-08-12;0;0;0;33148;12109;90;45257
27;2020-08-12;22;21;43;1429908;1353131;0;2783039
28;2020-08-12;0;3;3;180735;186856;09;367591
28;2020-08-12;0;3;3;200125;213621;19;413746
28;2020-08-12;4;6;10;168922;173007;29;341929
28;2020-08-12;6;4;10;196628;188487;39;385115
28;2020-08-12;2;5;7;205396;201699;49;407095
28;2020-08-12;5;3;8;222002;213866;59;435868
28;2020-08-12;0;2;2;224688;203758;69;428446
28;2020-08-12;0;0;0;163192;135543;79;298735
28;2020-08-12;0;0;0;109691;65377;89;175068
28;2020-08-12;0;0;0;37222;12685;90;49907
28;2020-08-12;17;26;43;1708601;1594899;0;3303500
32;2020-08-12;5;3;8;358062;373689;09;731751
32;2020-08-12;10;15;25;387045;406742;19;793787
32;2020-08-12;26;28;54;342304;348587;29;690891
32;2020-08-12;9;16;25;382485;369972;39;752457
32;2020-08-12;11;10;21;382510;376716;49;759226
32;2020-08-12;6;9;15;386937;376527;59;763464
32;2020-08-12;7;6;13;371211;330938;69;702149
32;2020-08-12;5;5;10;250542;201459;79;452001
32;2020-08-12;4;4;8;163399;89786;89;253185
32;2020-08-12;0;0;0;48384;15367;90;63751
32;2020-08-12;83;96;179;3072879;2889783;0;5962662
44;2020-08-12;1;5;6;291525;306839;09;598364
44;2020-08-12;9;8;17;320255;339504;19;659759
44;2020-08-12;14;25;39;302020;314428;29;616448
44;2020-08-12;13;7;20;342222;333292;39;675514
44;2020-08-12;14;11;25;349727;344491;49;694218
44;2020-08-12;5;6;11;381371;373239;59;754610
44;2020-08-12;2;4;6;367165;335850;69;703015
44;2020-08-12;4;3;7;250387;215436;79;465823
44;2020-08-12;3;4;7;170825;105192;89;276017
44;2020-08-12;0;0;0;51248;16731;90;67979
44;2020-08-12;65;73;138;2826745;2685002;0;5511747
52;2020-08-12;4;3;7;213594;223900;09;437494
52;2020-08-12;5;9;14;240818;255197;19;496015
52;2020-08-12;9;11;20;197010;200630;29;397640
52;2020-08-12;9;11;20;231204;224885;39;456089
52;2020-08-12;6;12;18;243874;243418;49;487292
52;2020-08-12;4;6;10;244100;239116;59;483216
52;2020-08-12;3;6;9;241796;221345;69;463141
52;2020-08-12;0;2;2;177805;149903;79;327708
52;2020-08-12;2;1;3;119561;75822;89;195383
52;2020-08-12;2;0;2;42559;15260;90;57819
52;2020-08-12;44;61;105;1952321;1849476;0;3801797
53;2020-08-12;0;0;0;173813;182358;09;356171
53;2020-08-12;2;3;5;202720;214740;19;417460
53;2020-08-12;4;10;14;163116;173196;29;336312
53;2020-08-12;3;5;8;190526;187674;39;378200
53;2020-08-12;6;3;9;212098;212015;49;424113
53;2020-08-12;3;4;7;223699;219176;59;442875
53;2020-08-12;1;1;2;227435;209274;69;436709
53;2020-08-12;2;0;2;169992;140910;79;310902
53;2020-08-12;0;0;0;118117;69883;89;188000
53;2020-08-12;0;0;0;37370;12267;90;49637
53;2020-08-12;21;26;47;1718886;1621493;0;3340379
75;2020-08-12;0;0;0;293104;305291;09;598395
75;2020-08-12;14;3;17;337141;357785;19;694926
75;2020-08-12;17;22;39;295024;300618;29;595642
75;2020-08-12;13;14;27;347871;331233;39;679104
75;2020-08-12;7;8;15;384742;372771;49;757513
75;2020-08-12;5;4;9;413361;390880;59;804241
75;2020-08-12;3;0;3;425623;384060;69;809683
75;2020-08-12;2;5;7;325086;276298;79;601384
75;2020-08-12;0;0;0;213986;139308;89;353294
75;2020-08-12;1;0;1;77600;28200;90;105800
75;2020-08-12;62;56;118;3113538;2886444;0;5999982
76;2020-08-12;3;4;7;305956;318589;09;624545
76;2020-08-12;19;16;35;338942;356969;19;695911
76;2020-08-12;58;50;108;316210;319570;29;635780
76;2020-08-12;18;31;49;356758;337587;39;694345
76;2020-08-12;20;19;39;376541;363812;49;740353
76;2020-08-12;16;13;29;402608;383750;59;786358
76;2020-08-12;10;10;20;394889;358997;69;753886
76;2020-08-12;7;3;10;308664;263806;79;572470
76;2020-08-12;4;3;7;195838;129272;89;325110
76;2020-08-12;1;0;1;69372;26728;90;96100
76;2020-08-12;156;149;305;3065778;2859080;0;5924858
84;2020-08-12;8;10;18;459549;481088;09;940637
84;2020-08-12;11;9;20;487711;511905;19;999616
84;2020-08-12;32;46;78;443824;451094;29;894918
84;2020-08-12;12;23;35;512522;493262;39;1005784
84;2020-08-12;14;16;30;520248;515106;49;1035354
84;2020-08-12;10;8;18;529611;514848;59;1044459
84;2020-08-12;9;3;12;486720;439940;69;926660
84;2020-08-12;4;3;7;372151;315211;79;687362
84;2020-08-12;0;4;4;237198;150524;89;387722
84;2020-08-12;2;0;2;81185;28680;90;109865
84;2020-08-12;102;122;224;4130719;3901658;0;8032377
93;2020-08-12;9;1;10;268834;283093;09;551927
93;2020-08-12;28;21;49;280751;296087;19;576838
93;2020-08-12;99;86;185;254404;255552;29;509956
93;2020-08-12;27;45;72;310704;288398;39;599102
93;2020-08-12;28;34;62;325559;305827;49;631386
93;2020-08-12;28;33;61;353104;325389;59;678493
93;2020-08-12;17;20;37;336327;296459;69;632786
93;2020-08-12;7;4;11;279820;229699;79;509519
93;2020-08-12;3;6;9;171274;113716;89;284990
93;2020-08-12;4;1;5;58896;21758;90;80654
93;2020-08-12;250;251;501;2639673;2415978;0;5055651
94;2020-08-12;0;0;0;16311;17433;09;33744
94;2020-08-12;0;0;0;16679;18132;19;34811
94;2020-08-12;1;1;2;16782;16579;29;33361
94;2020-08-12;1;0;1;23044;20580;39;43624
94;2020-08-12;1;0;1;23065;22140;49;45205
94;2020-08-12;0;0;0;24549;23421;59;47970
94;2020-08-12;0;0;0;23212;21883;69;45095
94;2020-08-12;0;0;0;19544;17141;79;36685
94;2020-08-12;0;0;0;11227;8178;89;19405
94;2020-08-12;0;0;0;3332;1447;90;4779
94;2020-08-12;3;1;4;177745;166934;0;344679
01;2020-08-13;1;3;4;19979;20155;09;40134
01;2020-08-13;1;2;3;24994;25489;19;50483
01;2020-08-13;8;9;17;17868;16690;29;34558
01;2020-08-13;7;4;11;22328;14821;39;37149
01;2020-08-13;3;4;7;28652;20276;49;48928
01;2020-08-13;2;1;3;33264;27260;59;60524
01;2020-08-13;2;2;4;27135;23978;69;51113
01;2020-08-13;2;2;4;18401;14661;79;33062
01;2020-08-13;0;0;0;9633;6375;89;16008
01;2020-08-13;0;0;0;3410;1510;90;4920
01;2020-08-13;26;27;53;205664;171215;0;376879
02;2020-08-13;0;1;1;16881;17110;09;33991
02;2020-08-13;0;0;0;21410;21604;19;43014
02;2020-08-13;3;1;4;16017;15479;29;31496
02;2020-08-13;1;6;7;19825;14455;39;34280
02;2020-08-13;1;4;5;24719;18248;49;42967
02;2020-08-13;2;2;4;34361;28310;59;62671
02;2020-08-13;0;1;1;28061;24495;69;52556
02;2020-08-13;1;0;1;18231;15278;79;33509
02;2020-08-13;0;1;1;11090;7677;89;18767
02;2020-08-13;0;0;0;3992;1506;90;5498
02;2020-08-13;8;16;24;194587;164162;0;358749
03;2020-08-13;2;2;4;31123;30920;09;62043
03;2020-08-13;7;7;14;29370;29268;19;58638
03;2020-08-13;9;3;12;21458;18963;29;40421
03;2020-08-13;7;4;11;21276;18326;39;39602
03;2020-08-13;8;10;19;18164;16593;49;34757
03;2020-08-13;4;4;8;13469;13557;59;27026
03;2020-08-13;1;3;4;8776;8670;69;17446
03;2020-08-13;1;1;2;3777;3591;79;7368
03;2020-08-13;1;0;1;1649;1072;89;2721
03;2020-08-13;0;0;0;485;184;90;669
03;2020-08-13;40;34;75;149547;141144;0;290691
04;2020-08-13;3;1;4;60314;61377;09;121691
04;2020-08-13;5;7;12;66065;68387;19;134452
04;2020-08-13;9;2;11;51059;47156;29;98215
04;2020-08-13;2;3;5;58788;45780;39;104568
04;2020-08-13;3;3;6;61408;52207;49;113615
04;2020-08-13;1;2;3;64838;60759;59;125597
04;2020-08-13;1;1;2;47008;42843;69;89851
04;2020-08-13;0;1;1;25509;21184;79;46693
04;2020-08-13;0;0;0;13168;7647;89;20815
04;2020-08-13;0;0;0;3209;1253;90;4462
04;2020-08-13;24;20;44;451366;408593;0;859959
05;2020-08-13;0;0;0;362.366008612902;341.338819562748;09;703.704828175651
05;2020-08-13;0;0;0;353.376145114279;370.349735405642;19;723.725880519921
05;2020-08-13;0;0;0;218.593559489256;256.539602589476;29;475.133162078732
05;2020-08-13;0;0;0;404.225408693299;360.321910454353;39;764.547319147651
05;2020-08-13;0;0;0;520.067953604221;497.108383964256;49;1017.17633756848
05;2020-08-13;0;0;0;468.146063921917;510.087601910415;59;978.233665832332
05;2020-08-13;0;0;0;340.368470050554;334.366842191253;69;674.735312241807
05;2020-08-13;0;0;0;212.598666888387;192.597753227106;79;405.196420115493
05;2020-08-13;0;0;0;148.727797095705;61.8681715431829;89;210.595968638888
05;2020-08-13;0;0;0;32.9601271090696;10.9909785719784;90;43.9511056810479
05;2020-08-13;0;0;0;3061.43020057959;2935.56979942041;0;5997
06;2020-08-13;0;0;0;42583;42380;09;84963
06;2020-08-13;2;0;2;33369;31925;19;65294
06;2020-08-13;2;1;3;21571;15080;29;36651
06;2020-08-13;3;0;3;21550;16147;39;37697
06;2020-08-13;0;1;1;14193;13939;49;28132
06;2020-08-13;0;1;1;7171;7597;59;14768
06;2020-08-13;0;1;1;3629;4117;69;7746
06;2020-08-13;0;0;0;1577;1457;79;3034
06;2020-08-13;0;0;0;531;474;89;1005
06;2020-08-13;0;0;0;88;93;90;181
06;2020-08-13;7;4;11;146262;133209;0;279471
07;2020-08-13;0;0;0;485;549;09;1034
07;2020-08-13;0;0;0;403;432;19;835
07;2020-08-13;0;0;0;764;841;29;1605
07;2020-08-13;0;0;0;824;928;39;1752
07;2020-08-13;0;0;0;788;1020;49;1808
07;2020-08-13;0;0;0;678;870;59;1548
07;2020-08-13;0;0;0;360;382;69;742
07;2020-08-13;0;0;0;231;190;79;421
07;2020-08-13;0;0;0;114;67;89;181
07;2020-08-13;0;0;0;24;11;90;35
07;2020-08-13;0;0;0;4671;5290;0;9961
08;2020-08-13;0;0;0;2715.22592983026;2997.75551488675;09;5712.98144471701
08;2020-08-13;0;1;1;2778.51901080978;3160.9156459093;19;5939.43465671908
08;2020-08-13;1;1;2;2080.8882988764;1718.16634315323;29;3799.05464202964
08;2020-08-13;2;1;3;2701.8582062647;1896.52641413317;39;4598.38462039786
08;2020-08-13;1;0;1;3151.45861023308;2460.52498233809;49;5611.98359257117
08;2020-08-13;0;1;1;2620.29868333099;2422.23566154656;59;5042.53434487755
08;2020-08-13;1;5;6;1621.44173420671;1438.58325779464;69;3060.02499200135
08;2020-08-13;0;0;0;626.575909335673;526.358467843651;79;1152.93437717932
08;2020-08-13;0;0;0;205.018522985054;140.993639349697;89;346.012162334751
08;2020-08-13;0;0;0;50.0325684687745;20.62259870351;90;70.6551671722846
08;2020-08-13;5;9;14;18551.3174743414;16782.6825256586;0;35334
11;2020-08-13;14;17;31;783071;811785;09;1594856
11;2020-08-13;61;59;120;761456;784653;19;1546109
11;2020-08-13;188;179;367;850145;801772;29;1651917
11;2020-08-13;114;128;242;914360;843488;39;1757848
11;2020-08-13;77;74;151;845609;826202;49;1671811
11;2020-08-13;52;57;109;793566;745070;59;1538636
11;2020-08-13;36;32;68;628649;549192;69;1177841
11;2020-08-13;23;19;42;434606;358356;79;792962
11;2020-08-13;16;7;23;261425;162933;89;424358
11;2020-08-13;7;2;9;89253;32619;90;121872
11;2020-08-13;588;575;1165;6362140;5916070;0;12278210
24;2020-08-13;8;2;10;139720;144686;09;284406
24;2020-08-13;9;10;19;152979;161185;19;314164
24;2020-08-13;10;12;22;122237;126536;29;248773
24;2020-08-13;13;3;16;150359;142009;39;292368
24;2020-08-13;14;8;22;161829;158758;49;320587
24;2020-08-13;9;6;15;172552;168011;59;340563
24;2020-08-13;3;0;3;172509;158177;69;330686
24;2020-08-13;4;1;5;129428;110593;79;240021
24;2020-08-13;4;1;5;87342;56882;89;144224
24;2020-08-13;0;0;0;31210;12071;90;43281
24;2020-08-13;74;43;117;1320165;1238908;0;2559073
27;2020-08-13;0;0;0;143373;149679;09;293052
27;2020-08-13;9;4;13;160962;173003;19;333965
27;2020-08-13;8;8;16;133746;142254;29;276000
27;2020-08-13;3;5;8;160004;155407;39;315411
27;2020-08-13;1;1;2;172333;169564;49;341897
27;2020-08-13;4;1;5;189979;183788;59;373767
27;2020-08-13;1;0;1;192591;178206;69;370797
27;2020-08-13;0;0;0;146876;127546;79;274422
27;2020-08-13;0;1;1;96896;61575;89;158471
27;2020-08-13;0;1;1;33148;12109;90;45257
27;2020-08-13;26;21;47;1429908;1353131;0;2783039
28;2020-08-13;0;0;0;180735;186856;09;367591
28;2020-08-13;3;1;4;200125;213621;19;413746
28;2020-08-13;13;12;25;168922;173007;29;341929
28;2020-08-13;3;2;5;196628;188487;39;385115
28;2020-08-13;5;3;8;205396;201699;49;407095
28;2020-08-13;1;0;1;222002;213866;59;435868
28;2020-08-13;0;1;1;224688;203758;69;428446
28;2020-08-13;1;0;1;163192;135543;79;298735
28;2020-08-13;1;2;3;109691;65377;89;175068
28;2020-08-13;0;0;0;37222;12685;90;49907
28;2020-08-13;27;21;48;1708601;1594899;0;3303500
32;2020-08-13;6;4;10;358062;373689;09;731751
32;2020-08-13;21;13;35;387045;406742;19;793787
32;2020-08-13;24;22;46;342304;348587;29;690891
32;2020-08-13;19;20;39;382485;369972;39;752457
32;2020-08-13;15;13;28;382510;376716;49;759226
32;2020-08-13;9;11;20;386937;376527;59;763464
32;2020-08-13;5;2;7;371211;330938;69;702149
32;2020-08-13;4;1;5;250542;201459;79;452001
32;2020-08-13;2;3;5;163399;89786;89;253185
32;2020-08-13;2;0;2;48384;15367;90;63751
32;2020-08-13;107;89;197;3072879;2889783;0;5962662
44;2020-08-13;0;3;3;291525;306839;09;598364
44;2020-08-13;7;9;16;320255;339504;19;659759
44;2020-08-13;15;15;30;302020;314428;29;616448
44;2020-08-13;11;16;27;342222;333292;39;675514
44;2020-08-13;8;11;19;349727;344491;49;694218
44;2020-08-13;6;9;15;381371;373239;59;754610
44;2020-08-13;2;1;3;367165;335850;69;703015
44;2020-08-13;4;4;8;250387;215436;79;465823
44;2020-08-13;5;3;8;170825;105192;89;276017
44;2020-08-13;5;2;7;51248;16731;90;67979
44;2020-08-13;63;73;136;2826745;2685002;0;5511747
52;2020-08-13;2;2;4;213594;223900;09;437494
52;2020-08-13;8;13;22;240818;255197;19;496015
52;2020-08-13;22;21;43;197010;200630;29;397640
52;2020-08-13;11;15;26;231204;224885;39;456089
52;2020-08-13;15;6;21;243874;243418;49;487292
52;2020-08-13;14;13;27;244100;239116;59;483216
52;2020-08-13;3;5;8;241796;221345;69;463141
52;2020-08-13;1;1;2;177805;149903;79;327708
52;2020-08-13;0;0;0;119561;75822;89;195383
52;2020-08-13;0;0;0;42559;15260;90;57819
52;2020-08-13;76;76;153;1952321;1849476;0;3801797
53;2020-08-13;1;1;2;173813;182358;09;356171
53;2020-08-13;4;0;4;202720;214740;19;417460
53;2020-08-13;10;14;24;163116;173196;29;336312
53;2020-08-13;3;7;10;190526;187674;39;378200
53;2020-08-13;4;4;8;212098;212015;49;424113
53;2020-08-13;4;4;8;223699;219176;59;442875
53;2020-08-13;1;2;3;227435;209274;69;436709
53;2020-08-13;1;4;5;169992;140910;79;310902
53;2020-08-13;0;1;1;118117;69883;89;188000
53;2020-08-13;1;0;1;37370;12267;90;49637
53;2020-08-13;29;37;66;1718886;1621493;0;3340379
75;2020-08-13;2;2;4;293104;305291;09;598395
75;2020-08-13;18;10;28;337141;357785;19;694926
75;2020-08-13;21;17;38;295024;300618;29;595642
75;2020-08-13;4;10;14;347871;331233;39;679104
75;2020-08-13;19;9;28;384742;372771;49;757513
75;2020-08-13;9;14;23;413361;390880;59;804241
75;2020-08-13;4;1;5;425623;384060;69;809683
75;2020-08-13;0;1;1;325086;276298;79;601384
75;2020-08-13;0;1;1;213986;139308;89;353294
75;2020-08-13;0;0;0;77600;28200;90;105800
75;2020-08-13;77;65;142;3113538;2886444;0;5999982
76;2020-08-13;7;5;12;305956;318589;09;624545
76;2020-08-13;19;19;38;338942;356969;19;695911
76;2020-08-13;35;38;73;316210;319570;29;635780
76;2020-08-13;41;30;71;356758;337587;39;694345
76;2020-08-13;28;30;58;376541;363812;49;740353
76;2020-08-13;26;23;49;402608;383750;59;786358
76;2020-08-13;7;10;17;394889;358997;69;753886
76;2020-08-13;5;3;8;308664;263806;79;572470
76;2020-08-13;1;1;2;195838;129272;89;325110
76;2020-08-13;3;0;3;69372;26728;90;96100
76;2020-08-13;172;159;331;3065778;2859080;0;5924858
84;2020-08-13;4;2;6;459549;481088;09;940637
84;2020-08-13;17;16;33;487711;511905;19;999616
84;2020-08-13;31;49;80;443824;451094;29;894918
84;2020-08-13;26;27;53;512522;493262;39;1005784
84;2020-08-13;20;15;35;520248;515106;49;1035354
84;2020-08-13;10;12;22;529611;514848;59;1044459
84;2020-08-13;7;6;13;486720;439940;69;926660
84;2020-08-13;5;6;11;372151;315211;79;687362
84;2020-08-13;2;3;5;237198;150524;89;387722
84;2020-08-13;0;1;1;81185;28680;90;109865
84;2020-08-13;122;137;259;4130719;3901658;0;8032377
93;2020-08-13;6;3;9;268834;283093;09;551927
93;2020-08-13;34;23;57;280751;296087;19;576838
93;2020-08-13;108;92;200;254404;255552;29;509956
93;2020-08-13;52;59;111;310704;288398;39;599102
93;2020-08-13;35;42;78;325559;305827;49;631386
93;2020-08-13;38;35;73;353104;325389;59;678493
93;2020-08-13;20;21;41;336327;296459;69;632786
93;2020-08-13;8;6;14;279820;229699;79;509519
93;2020-08-13;11;4;15;171274;113716;89;284990
93;2020-08-13;6;0;6;58896;21758;90;80654
93;2020-08-13;318;285;604;2639673;2415978;0;5055651
94;2020-08-13;0;0;0;16311;17433;09;33744
94;2020-08-13;0;0;0;16679;18132;19;34811
94;2020-08-13;0;0;0;16782;16579;29;33361
94;2020-08-13;0;0;0;23044;20580;39;43624
94;2020-08-13;0;1;1;23065;22140;49;45205
94;2020-08-13;0;0;0;24549;23421;59;47970
94;2020-08-13;0;0;0;23212;21883;69;45095
94;2020-08-13;0;0;0;19544;17141;79;36685
94;2020-08-13;0;0;0;11227;8178;89;19405
94;2020-08-13;0;0;0;3332;1447;90;4779
94;2020-08-13;0;1;1;177745;166934;0;344679
01;2020-08-14;0;0;0;19979;20155;09;40134
01;2020-08-14;0;2;2;24994;25489;19;50483
01;2020-08-14;6;3;9;17868;16690;29;34558
01;2020-08-14;4;6;10;22328;14821;39;37149
01;2020-08-14;2;1;3;28652;20276;49;48928
01;2020-08-14;1;0;1;33264;27260;59;60524
01;2020-08-14;1;0;1;27135;23978;69;51113
01;2020-08-14;0;0;0;18401;14661;79;33062
01;2020-08-14;0;0;0;9633;6375;89;16008
01;2020-08-14;0;0;0;3410;1510;90;4920
01;2020-08-14;14;12;26;205664;171215;0;376879
02;2020-08-14;0;0;0;16881;17110;09;33991
02;2020-08-14;2;0;2;21410;21604;19;43014
02;2020-08-14;2;7;9;16017;15479;29;31496
02;2020-08-14;0;3;3;19825;14455;39;34280
02;2020-08-14;3;3;6;24719;18248;49;42967
02;2020-08-14;1;6;7;34361;28310;59;62671
02;2020-08-14;0;1;1;28061;24495;69;52556
02;2020-08-14;0;0;0;18231;15278;79;33509
02;2020-08-14;1;0;1;11090;7677;89;18767
02;2020-08-14;0;0;0;3992;1506;90;5498
02;2020-08-14;9;20;29;194587;164162;0;358749
03;2020-08-14;2;2;4;31123;30920;09;62043
03;2020-08-14;3;5;8;29370;29268;19;58638
03;2020-08-14;8;3;11;21458;18963;29;40421
03;2020-08-14;2;1;3;21276;18326;39;39602
03;2020-08-14;2;3;5;18164;16593;49;34757
03;2020-08-14;1;2;3;13469;13557;59;27026
03;2020-08-14;1;0;1;8776;8670;69;17446
03;2020-08-14;0;2;2;3777;3591;79;7368
03;2020-08-14;0;0;0;1649;1072;89;2721
03;2020-08-14;0;0;0;485;184;90;669
03;2020-08-14;19;18;37;149547;141144;0;290691
04;2020-08-14;3;1;4;60314;61377;09;121691
04;2020-08-14;14;8;22;66065;68387;19;134452
04;2020-08-14;4;4;8;51059;47156;29;98215
04;2020-08-14;4;1;5;58788;45780;39;104568
04;2020-08-14;4;4;8;61408;52207;49;113615
04;2020-08-14;4;3;7;64838;60759;59;125597
04;2020-08-14;0;1;1;47008;42843;69;89851
04;2020-08-14;1;1;2;25509;21184;79;46693
04;2020-08-14;0;3;3;13168;7647;89;20815
04;2020-08-14;0;0;0;3209;1253;90;4462
04;2020-08-14;34;26;60;451366;408593;0;859959
05;2020-08-14;0;0;0;362.366008612902;341.338819562748;09;703.704828175651
05;2020-08-14;0;0;0;353.376145114279;370.349735405642;19;723.725880519921
05;2020-08-14;0;0;0;218.593559489256;256.539602589476;29;475.133162078732
05;2020-08-14;0;0;0;404.225408693299;360.321910454353;39;764.547319147651
05;2020-08-14;0;0;0;520.067953604221;497.108383964256;49;1017.17633756848
05;2020-08-14;0;0;0;468.146063921917;510.087601910415;59;978.233665832332
05;2020-08-14;0;0;0;340.368470050554;334.366842191253;69;674.735312241807
05;2020-08-14;0;0;0;212.598666888387;192.597753227106;79;405.196420115493
05;2020-08-14;0;0;0;148.727797095705;61.8681715431829;89;210.595968638888
05;2020-08-14;0;0;0;32.9601271090696;10.9909785719784;90;43.9511056810479
05;2020-08-14;0;0;0;3061.43020057959;2935.56979942041;0;5997
06;2020-08-14;0;0;0;42583;42380;09;84963
06;2020-08-14;3;1;4;33369;31925;19;65294
06;2020-08-14;1;2;3;21571;15080;29;36651
06;2020-08-14;1;1;2;21550;16147;39;37697
06;2020-08-14;0;0;0;14193;13939;49;28132
06;2020-08-14;0;1;1;7171;7597;59;14768
06;2020-08-14;0;0;0;3629;4117;69;7746
06;2020-08-14;0;0;0;1577;1457;79;3034
06;2020-08-14;0;0;0;531;474;89;1005
06;2020-08-14;0;0;0;88;93;90;181
06;2020-08-14;5;5;10;146262;133209;0;279471
07;2020-08-14;0;0;0;485;549;09;1034
07;2020-08-14;0;0;0;403;432;19;835
07;2020-08-14;0;0;0;764;841;29;1605
07;2020-08-14;0;0;0;824;928;39;1752
07;2020-08-14;0;0;0;788;1020;49;1808
07;2020-08-14;0;0;0;678;870;59;1548
07;2020-08-14;0;0;0;360;382;69;742
07;2020-08-14;0;0;0;231;190;79;421
07;2020-08-14;0;0;0;114;67;89;181
07;2020-08-14;0;0;0;24;11;90;35
07;2020-08-14;0;0;0;4671;5290;0;9961
08;2020-08-14;0;0;0;2715.22592983026;2997.75551488675;09;5712.98144471701
08;2020-08-14;0;0;0;2778.51901080978;3160.9156459093;19;5939.43465671908
08;2020-08-14;1;0;1;2080.8882988764;1718.16634315323;29;3799.05464202964
08;2020-08-14;0;0;0;2701.8582062647;1896.52641413317;39;4598.38462039786
08;2020-08-14;1;1;2;3151.45861023308;2460.52498233809;49;5611.98359257117
08;2020-08-14;0;0;0;2620.29868333099;2422.23566154656;59;5042.53434487755
08;2020-08-14;0;0;0;1621.44173420671;1438.58325779464;69;3060.02499200135
08;2020-08-14;0;0;0;626.575909335673;526.358467843651;79;1152.93437717932
08;2020-08-14;0;0;0;205.018522985054;140.993639349697;89;346.012162334751
08;2020-08-14;0;0;0;50.0325684687745;20.62259870351;90;70.6551671722846
08;2020-08-14;2;1;3;18551.3174743414;16782.6825256586;0;35334
11;2020-08-14;11;22;34;783071;811785;09;1594856
11;2020-08-14;55;47;102;761456;784653;19;1546109
11;2020-08-14;170;218;388;850145;801772;29;1651917
11;2020-08-14;95;142;237;914360;843488;39;1757848
11;2020-08-14;73;82;155;845609;826202;49;1671811
11;2020-08-14;68;50;118;793566;745070;59;1538636
11;2020-08-14;31;40;71;628649;549192;69;1177841
11;2020-08-14;19;30;49;434606;358356;79;792962
11;2020-08-14;7;5;12;261425;162933;89;424358
11;2020-08-14;3;1;4;89253;32619;90;121872
11;2020-08-14;532;637;1170;6362140;5916070;0;12278210
24;2020-08-14;3;4;7;139720;144686;09;284406
24;2020-08-14;16;12;28;152979;161185;19;314164
24;2020-08-14;11;18;29;122237;126536;29;248773
24;2020-08-14;9;11;20;150359;142009;39;292368
24;2020-08-14;4;4;8;161829;158758;49;320587
24;2020-08-14;7;11;18;172552;168011;59;340563
24;2020-08-14;6;1;7;172509;158177;69;330686
24;2020-08-14;0;1;1;129428;110593;79;240021
24;2020-08-14;1;3;4;87342;56882;89;144224
24;2020-08-14;0;1;1;31210;12071;90;43281
24;2020-08-14;57;66;123;1320165;1238908;0;2559073
27;2020-08-14;2;1;3;143373;149679;09;293052
27;2020-08-14;3;3;6;160962;173003;19;333965
27;2020-08-14;8;11;19;133746;142254;29;276000
27;2020-08-14;4;4;8;160004;155407;39;315411
27;2020-08-14;4;3;7;172333;169564;49;341897
27;2020-08-14;3;5;8;189979;183788;59;373767
27;2020-08-14;2;1;3;192591;178206;69;370797
27;2020-08-14;3;0;3;146876;127546;79;274422
27;2020-08-14;1;1;2;96896;61575;89;158471
27;2020-08-14;0;1;1;33148;12109;90;45257
27;2020-08-14;30;30;60;1429908;1353131;0;2783039
28;2020-08-14;1;3;4;180735;186856;09;367591
28;2020-08-14;4;1;5;200125;213621;19;413746
28;2020-08-14;11;8;19;168922;173007;29;341929
28;2020-08-14;4;5;9;196628;188487;39;385115
28;2020-08-14;5;4;9;205396;201699;49;407095
28;2020-08-14;3;2;5;222002;213866;59;435868
28;2020-08-14;3;3;6;224688;203758;69;428446
28;2020-08-14;2;0;2;163192;135543;79;298735
28;2020-08-14;3;4;7;109691;65377;89;175068
28;2020-08-14;0;0;0;37222;12685;90;49907
28;2020-08-14;36;30;66;1708601;1594899;0;3303500
32;2020-08-14;4;1;5;358062;373689;09;731751
32;2020-08-14;13;12;27;387045;406742;19;793787
32;2020-08-14;24;31;56;342304;348587;29;690891
32;2020-08-14;16;15;31;382485;369972;39;752457
32;2020-08-14;18;13;31;382510;376716;49;759226
32;2020-08-14;13;16;29;386937;376527;59;763464
32;2020-08-14;2;8;10;371211;330938;69;702149
32;2020-08-14;6;8;14;250542;201459;79;452001
32;2020-08-14;4;1;5;163399;89786;89;253185
32;2020-08-14;3;0;3;48384;15367;90;63751
32;2020-08-14;103;105;211;3072879;2889783;0;5962662
44;2020-08-14;2;1;3;291525;306839;09;598364
44;2020-08-14;10;13;23;320255;339504;19;659759
44;2020-08-14;22;21;43;302020;314428;29;616448
44;2020-08-14;14;13;27;342222;333292;39;675514
44;2020-08-14;11;12;23;349727;344491;49;694218
44;2020-08-14;4;11;15;381371;373239;59;754610
44;2020-08-14;2;4;6;367165;335850;69;703015
44;2020-08-14;4;8;12;250387;215436;79;465823
44;2020-08-14;2;1;3;170825;105192;89;276017
44;2020-08-14;0;2;2;51248;16731;90;67979
44;2020-08-14;71;86;157;2826745;2685002;0;5511747
52;2020-08-14;8;6;15;213594;223900;09;437494
52;2020-08-14;18;21;40;240818;255197;19;496015
52;2020-08-14;25;19;44;197010;200630;29;397640
52;2020-08-14;19;13;32;231204;224885;39;456089
52;2020-08-14;11;13;24;243874;243418;49;487292
52;2020-08-14;18;16;34;244100;239116;59;483216
52;2020-08-14;4;7;11;241796;221345;69;463141
52;2020-08-14;7;5;12;177805;149903;79;327708
52;2020-08-14;4;4;8;119561;75822;89;195383
52;2020-08-14;3;0;3;42559;15260;90;57819
52;2020-08-14;117;104;223;1952321;1849476;0;3801797
53;2020-08-14;2;2;4;173813;182358;09;356171
53;2020-08-14;2;7;9;202720;214740;19;417460
53;2020-08-14;10;22;32;163116;173196;29;336312
53;2020-08-14;4;13;17;190526;187674;39;378200
53;2020-08-14;7;9;16;212098;212015;49;424113
53;2020-08-14;6;12;18;223699;219176;59;442875
53;2020-08-14;1;1;2;227435;209274;69;436709
53;2020-08-14;3;2;5;169992;140910;79;310902
53;2020-08-14;1;1;2;118117;69883;89;188000
53;2020-08-14;0;0;0;37370;12267;90;49637
53;2020-08-14;36;69;105;1718886;1621493;0;3340379
75;2020-08-14;3;2;5;293104;305291;09;598395
75;2020-08-14;18;5;23;337141;357785;19;694926
75;2020-08-14;17;17;34;295024;300618;29;595642
75;2020-08-14;7;14;21;347871;331233;39;679104
75;2020-08-14;6;6;12;384742;372771;49;757513
75;2020-08-14;9;8;17;413361;390880;59;804241
75;2020-08-14;3;5;8;425623;384060;69;809683
75;2020-08-14;3;4;7;325086;276298;79;601384
75;2020-08-14;1;2;3;213986;139308;89;353294
75;2020-08-14;0;2;2;77600;28200;90;105800
75;2020-08-14;67;65;132;3113538;2886444;0;5999982
76;2020-08-14;4;7;11;305956;318589;09;624545
76;2020-08-14;18;12;31;338942;356969;19;695911
76;2020-08-14;59;54;113;316210;319570;29;635780
76;2020-08-14;23;33;56;356758;337587;39;694345
76;2020-08-14;31;31;62;376541;363812;49;740353
76;2020-08-14;15;18;33;402608;383750;59;786358
76;2020-08-14;12;14;26;394889;358997;69;753886
76;2020-08-14;5;4;9;308664;263806;79;572470
76;2020-08-14;0;1;1;195838;129272;89;325110
76;2020-08-14;1;0;1;69372;26728;90;96100
76;2020-08-14;168;174;343;3065778;2859080;0;5924858
84;2020-08-14;6;4;10;459549;481088;09;940637
84;2020-08-14;32;22;54;487711;511905;19;999616
84;2020-08-14;41;63;104;443824;451094;29;894918
84;2020-08-14;21;24;45;512522;493262;39;1005784
84;2020-08-14;17;21;38;520248;515106;49;1035354
84;2020-08-14;17;14;31;529611;514848;59;1044459
84;2020-08-14;6;11;17;486720;439940;69;926660
84;2020-08-14;5;9;14;372151;315211;79;687362
84;2020-08-14;2;2;4;237198;150524;89;387722
84;2020-08-14;0;0;0;81185;28680;90;109865
84;2020-08-14;147;170;317;4130719;3901658;0;8032377
93;2020-08-14;9;7;16;268834;283093;09;551927
93;2020-08-14;39;28;68;280751;296087;19;576838
93;2020-08-14;114;127;242;254404;255552;29;509956
93;2020-08-14;60;75;135;310704;288398;39;599102
93;2020-08-14;46;39;85;325559;305827;49;631386
93;2020-08-14;43;50;93;353104;325389;59;678493
93;2020-08-14;24;25;49;336327;296459;69;632786
93;2020-08-14;14;18;32;279820;229699;79;509519
93;2020-08-14;7;7;14;171274;113716;89;284990
93;2020-08-14;7;1;8;58896;21758;90;80654
93;2020-08-14;363;377;742;2639673;2415978;0;5055651
94;2020-08-14;0;0;0;16311;17433;09;33744
94;2020-08-14;2;0;2;16679;18132;19;34811
94;2020-08-14;1;1;2;16782;16579;29;33361
94;2020-08-14;0;0;0;23044;20580;39;43624
94;2020-08-14;0;1;1;23065;22140;49;45205
94;2020-08-14;0;0;0;24549;23421;59;47970
94;2020-08-14;0;0;0;23212;21883;69;45095
94;2020-08-14;1;0;1;19544;17141;79;36685
94;2020-08-14;0;0;0;11227;8178;89;19405
94;2020-08-14;0;0;0;3332;1447;90;4779
94;2020-08-14;4;2;6;177745;166934;0;344679
01;2020-08-15;0;0;0;19979;20155;09;40134
01;2020-08-15;0;0;0;24994;25489;19;50483
01;2020-08-15;1;0;1;17868;16690;29;34558
01;2020-08-15;1;2;3;22328;14821;39;37149
01;2020-08-15;1;1;2;28652;20276;49;48928
01;2020-08-15;2;1;3;33264;27260;59;60524
01;2020-08-15;0;0;0;27135;23978;69;51113
01;2020-08-15;0;0;0;18401;14661;79;33062
01;2020-08-15;0;0;0;9633;6375;89;16008
01;2020-08-15;0;0;0;3410;1510;90;4920
01;2020-08-15;5;4;10;205664;171215;0;376879
02;2020-08-15;0;0;0;16881;17110;09;33991
02;2020-08-15;0;0;0;21410;21604;19;43014
02;2020-08-15;0;0;0;16017;15479;29;31496
02;2020-08-15;0;0;0;19825;14455;39;34280
02;2020-08-15;0;0;0;24719;18248;49;42967
02;2020-08-15;0;0;0;34361;28310;59;62671
02;2020-08-15;0;0;0;28061;24495;69;52556
02;2020-08-15;0;0;0;18231;15278;79;33509
02;2020-08-15;0;0;0;11090;7677;89;18767
02;2020-08-15;0;0;0;3992;1506;90;5498
02;2020-08-15;0;0;0;194587;164162;0;358749
03;2020-08-15;0;0;0;31123;30920;09;62043
03;2020-08-15;3;1;4;29370;29268;19;58638
03;2020-08-15;6;1;7;21458;18963;29;40421
03;2020-08-15;4;2;6;21276;18326;39;39602
03;2020-08-15;4;4;8;18164;16593;49;34757
03;2020-08-15;0;0;0;13469;13557;59;27026
03;2020-08-15;0;1;1;8776;8670;69;17446
03;2020-08-15;0;0;0;3777;3591;79;7368
03;2020-08-15;0;0;0;1649;1072;89;2721
03;2020-08-15;0;0;0;485;184;90;669
03;2020-08-15;17;9;26;149547;141144;0;290691
04;2020-08-15;1;0;1;60314;61377;09;121691
04;2020-08-15;0;4;4;66065;68387;19;134452
04;2020-08-15;3;0;3;51059;47156;29;98215
04;2020-08-15;3;0;3;58788;45780;39;104568
04;2020-08-15;2;2;4;61408;52207;49;113615
04;2020-08-15;3;2;5;64838;60759;59;125597
04;2020-08-15;0;0;0;47008;42843;69;89851
04;2020-08-15;0;0;0;25509;21184;79;46693
04;2020-08-15;0;0;0;13168;7647;89;20815
04;2020-08-15;0;0;0;3209;1253;90;4462
04;2020-08-15;12;8;20;451366;408593;0;859959
05;2020-08-15;0;0;0;362.366008612902;341.338819562748;09;703.704828175651
05;2020-08-15;0;0;0;353.376145114279;370.349735405642;19;723.725880519921
05;2020-08-15;0;0;0;218.593559489256;256.539602589476;29;475.133162078732
05;2020-08-15;0;0;0;404.225408693299;360.321910454353;39;764.547319147651
05;2020-08-15;0;0;0;520.067953604221;497.108383964256;49;1017.17633756848
05;2020-08-15;0;0;0;468.146063921917;510.087601910415;59;978.233665832332
05;2020-08-15;0;0;0;340.368470050554;334.366842191253;69;674.735312241807
05;2020-08-15;0;0;0;212.598666888387;192.597753227106;79;405.196420115493
05;2020-08-15;0;0;0;148.727797095705;61.8681715431829;89;210.595968638888
05;2020-08-15;0;0;0;32.9601271090696;10.9909785719784;90;43.9511056810479
05;2020-08-15;0;0;0;3061.43020057959;2935.56979942041;0;5997
06;2020-08-15;0;1;1;42583;42380;09;84963
06;2020-08-15;0;1;1;33369;31925;19;65294
06;2020-08-15;0;0;0;21571;15080;29;36651
06;2020-08-15;0;1;1;21550;16147;39;37697
06;2020-08-15;0;2;2;14193;13939;49;28132
06;2020-08-15;0;0;0;7171;7597;59;14768
06;2020-08-15;0;1;1;3629;4117;69;7746
06;2020-08-15;0;0;0;1577;1457;79;3034
06;2020-08-15;0;0;0;531;474;89;1005
06;2020-08-15;0;0;0;88;93;90;181
06;2020-08-15;0;6;6;146262;133209;0;279471
07;2020-08-15;0;0;0;485;549;09;1034
07;2020-08-15;0;0;0;403;432;19;835
07;2020-08-15;0;0;0;764;841;29;1605
07;2020-08-15;0;0;0;824;928;39;1752
07;2020-08-15;0;0;0;788;1020;49;1808
07;2020-08-15;0;0;0;678;870;59;1548
07;2020-08-15;0;0;0;360;382;69;742
07;2020-08-15;0;0;0;231;190;79;421
07;2020-08-15;0;0;0;114;67;89;181
07;2020-08-15;0;0;0;24;11;90;35
07;2020-08-15;0;0;0;4671;5290;0;9961
08;2020-08-15;0;0;0;2715.22592983026;2997.75551488675;09;5712.98144471701
08;2020-08-15;0;0;0;2778.51901080978;3160.9156459093;19;5939.43465671908
08;2020-08-15;0;0;0;2080.8882988764;1718.16634315323;29;3799.05464202964
08;2020-08-15;0;1;1;2701.8582062647;1896.52641413317;39;4598.38462039786
08;2020-08-15;0;0;0;3151.45861023308;2460.52498233809;49;5611.98359257117
08;2020-08-15;0;0;0;2620.29868333099;2422.23566154656;59;5042.53434487755
08;2020-08-15;0;0;0;1621.44173420671;1438.58325779464;69;3060.02499200135
08;2020-08-15;0;0;0;626.575909335673;526.358467843651;79;1152.93437717932
08;2020-08-15;0;0;0;205.018522985054;140.993639349697;89;346.012162334751
08;2020-08-15;0;0;0;50.0325684687745;20.62259870351;90;70.6551671722846
08;2020-08-15;0;1;1;18551.3174743414;16782.6825256586;0;35334
11;2020-08-15;0;1;1;783071;811785;09;1594856
11;2020-08-15;11;5;16;761456;784653;19;1546109
11;2020-08-15;36;49;85;850145;801772;29;1651917
11;2020-08-15;22;22;44;914360;843488;39;1757848
11;2020-08-15;4;18;22;845609;826202;49;1671811
11;2020-08-15;3;12;15;793566;745070;59;1538636
11;2020-08-15;6;5;11;628649;549192;69;1177841
11;2020-08-15;4;7;11;434606;358356;79;792962
11;2020-08-15;4;3;7;261425;162933;89;424358
11;2020-08-15;1;1;2;89253;32619;90;121872
11;2020-08-15;91;123;215;6362140;5916070;0;12278210
24;2020-08-15;0;0;0;139720;144686;09;284406
24;2020-08-15;0;1;1;152979;161185;19;314164
24;2020-08-15;8;0;8;122237;126536;29;248773
24;2020-08-15;1;1;2;150359;142009;39;292368
24;2020-08-15;0;1;1;161829;158758;49;320587
24;2020-08-15;1;1;2;172552;168011;59;340563
24;2020-08-15;2;0;2;172509;158177;69;330686
24;2020-08-15;1;4;5;129428;110593;79;240021
24;2020-08-15;1;1;2;87342;56882;89;144224
24;2020-08-15;2;0;2;31210;12071;90;43281
24;2020-08-15;16;9;25;1320165;1238908;0;2559073
27;2020-08-15;0;0;0;143373;149679;09;293052
27;2020-08-15;0;2;2;160962;173003;19;333965
27;2020-08-15;5;3;8;133746;142254;29;276000
27;2020-08-15;2;2;4;160004;155407;39;315411
27;2020-08-15;3;2;5;172333;169564;49;341897
27;2020-08-15;1;2;3;189979;183788;59;373767
27;2020-08-15;0;0;0;192591;178206;69;370797
27;2020-08-15;0;0;0;146876;127546;79;274422
27;2020-08-15;0;0;0;96896;61575;89;158471
27;2020-08-15;0;0;0;33148;12109;90;45257
27;2020-08-15;11;11;22;1429908;1353131;0;2783039
28;2020-08-15;0;1;1;180735;186856;09;367591
28;2020-08-15;0;3;3;200125;213621;19;413746
28;2020-08-15;5;3;8;168922;173007;29;341929
28;2020-08-15;2;2;4;196628;188487;39;385115
28;2020-08-15;0;2;2;205396;201699;49;407095
28;2020-08-15;1;0;1;222002;213866;59;435868
28;2020-08-15;2;2;4;224688;203758;69;428446
28;2020-08-15;1;3;4;163192;135543;79;298735
28;2020-08-15;2;1;3;109691;65377;89;175068
28;2020-08-15;3;3;6;37222;12685;90;49907
28;2020-08-15;16;20;36;1708601;1594899;0;3303500
32;2020-08-15;0;1;1;358062;373689;09;731751
32;2020-08-15;2;1;3;387045;406742;19;793787
32;2020-08-15;3;5;8;342304;348587;29;690891
32;2020-08-15;2;0;2;382485;369972;39;752457
32;2020-08-15;3;2;5;382510;376716;49;759226
32;2020-08-15;0;0;0;386937;376527;59;763464
32;2020-08-15;2;0;2;371211;330938;69;702149
32;2020-08-15;2;1;3;250542;201459;79;452001
32;2020-08-15;1;2;3;163399;89786;89;253185
32;2020-08-15;0;0;0;48384;15367;90;63751
32;2020-08-15;15;12;27;3072879;2889783;0;5962662
44;2020-08-15;1;0;1;291525;306839;09;598364
44;2020-08-15;4;0;4;320255;339504;19;659759
44;2020-08-15;3;3;6;302020;314428;29;616448
44;2020-08-15;3;2;5;342222;333292;39;675514
44;2020-08-15;1;1;2;349727;344491;49;694218
44;2020-08-15;2;1;3;381371;373239;59;754610
44;2020-08-15;2;0;2;367165;335850;69;703015
44;2020-08-15;3;0;3;250387;215436;79;465823
44;2020-08-15;3;0;3;170825;105192;89;276017
44;2020-08-15;1;1;2;51248;16731;90;67979
44;2020-08-15;23;8;31;2826745;2685002;0;5511747
52;2020-08-15;2;3;5;213594;223900;09;437494
52;2020-08-15;4;1;5;240818;255197;19;496015
52;2020-08-15;3;4;7;197010;200630;29;397640
52;2020-08-15;8;4;12;231204;224885;39;456089
52;2020-08-15;4;5;9;243874;243418;49;487292
52;2020-08-15;4;4;8;244100;239116;59;483216
52;2020-08-15;3;3;6;241796;221345;69;463141
52;2020-08-15;2;4;6;177805;149903;79;327708
52;2020-08-15;2;0;2;119561;75822;89;195383
52;2020-08-15;0;0;0;42559;15260;90;57819
52;2020-08-15;32;28;60;1952321;1849476;0;3801797
53;2020-08-15;0;0;0;173813;182358;09;356171
53;2020-08-15;0;0;0;202720;214740;19;417460
53;2020-08-15;1;3;4;163116;173196;29;336312
53;2020-08-15;3;0;3;190526;187674;39;378200
53;2020-08-15;0;0;0;212098;212015;49;424113
53;2020-08-15;0;0;0;223699;219176;59;442875
53;2020-08-15;0;1;1;227435;209274;69;436709
53;2020-08-15;0;0;0;169992;140910;79;310902
53;2020-08-15;0;0;0;118117;69883;89;188000
53;2020-08-15;1;0;1;37370;12267;90;49637
53;2020-08-15;5;4;9;1718886;1621493;0;3340379
75;2020-08-15;0;1;1;293104;305291;09;598395
75;2020-08-15;5;5;10;337141;357785;19;694926
75;2020-08-15;7;8;15;295024;300618;29;595642
75;2020-08-15;4;4;8;347871;331233;39;679104
75;2020-08-15;1;0;1;384742;372771;49;757513
75;2020-08-15;4;5;9;413361;390880;59;804241
75;2020-08-15;1;0;1;425623;384060;69;809683
75;2020-08-15;0;0;0;325086;276298;79;601384
75;2020-08-15;0;0;0;213986;139308;89;353294
75;2020-08-15;0;0;0;77600;28200;90;105800
75;2020-08-15;22;23;45;3113538;2886444;0;5999982
76;2020-08-15;0;0;0;305956;318589;09;624545
76;2020-08-15;3;3;6;338942;356969;19;695911
76;2020-08-15;10;20;30;316210;319570;29;635780
76;2020-08-15;7;3;10;356758;337587;39;694345
76;2020-08-15;4;5;9;376541;363812;49;740353
76;2020-08-15;4;3;7;402608;383750;59;786358
76;2020-08-15;0;1;1;394889;358997;69;753886
76;2020-08-15;1;3;4;308664;263806;79;572470
76;2020-08-15;1;1;2;195838;129272;89;325110
76;2020-08-15;1;0;1;69372;26728;90;96100
76;2020-08-15;31;39;70;3065778;2859080;0;5924858
84;2020-08-15;0;0;0;459549;481088;09;940637
84;2020-08-15;3;0;3;487711;511905;19;999616
84;2020-08-15;11;4;15;443824;451094;29;894918
84;2020-08-15;4;4;8;512522;493262;39;1005784
84;2020-08-15;4;2;6;520248;515106;49;1035354
84;2020-08-15;0;4;4;529611;514848;59;1044459
84;2020-08-15;2;1;3;486720;439940;69;926660
84;2020-08-15;0;3;3;372151;315211;79;687362
84;2020-08-15;0;1;1;237198;150524;89;387722
84;2020-08-15;0;0;0;81185;28680;90;109865
84;2020-08-15;24;19;43;4130719;3901658;0;8032377
93;2020-08-15;2;2;4;268834;283093;09;551927
93;2020-08-15;4;4;8;280751;296087;19;576838
93;2020-08-15;12;15;27;254404;255552;29;509956
93;2020-08-15;6;6;12;310704;288398;39;599102
93;2020-08-15;5;8;13;325559;305827;49;631386
93;2020-08-15;2;3;5;353104;325389;59;678493
93;2020-08-15;4;3;7;336327;296459;69;632786
93;2020-08-15;0;5;5;279820;229699;79;509519
93;2020-08-15;1;2;3;171274;113716;89;284990
93;2020-08-15;1;0;1;58896;21758;90;80654
93;2020-08-15;37;48;85;2639673;2415978;0;5055651
94;2020-08-15;0;0;0;16311;17433;09;33744
94;2020-08-15;0;0;0;16679;18132;19;34811
94;2020-08-15;0;0;0;16782;16579;29;33361
94;2020-08-15;0;0;0;23044;20580;39;43624
94;2020-08-15;0;0;0;23065;22140;49;45205
94;2020-08-15;0;0;0;24549;23421;59;47970
94;2020-08-15;0;0;0;23212;21883;69;45095
94;2020-08-15;0;0;0;19544;17141;79;36685
94;2020-08-15;0;0;0;11227;8178;89;19405
94;2020-08-15;0;0;0;3332;1447;90;4779
94;2020-08-15;0;0;0;177745;166934;0;344679
01;2020-08-16;0;0;0;19979;20155;09;40134
01;2020-08-16;0;0;0;24994;25489;19;50483
01;2020-08-16;2;0;2;17868;16690;29;34558
01;2020-08-16;4;2;6;22328;14821;39;37149
01;2020-08-16;0;0;0;28652;20276;49;48928
01;2020-08-16;0;0;0;33264;27260;59;60524
01;2020-08-16;0;0;0;27135;23978;69;51113
01;2020-08-16;0;0;0;18401;14661;79;33062
01;2020-08-16;0;0;0;9633;6375;89;16008
01;2020-08-16;1;0;1;3410;1510;90;4920
01;2020-08-16;7;2;9;205664;171215;0;376879
02;2020-08-16;0;0;0;16881;17110;09;33991
02;2020-08-16;0;0;0;21410;21604;19;43014
02;2020-08-16;0;0;0;16017;15479;29;31496
02;2020-08-16;0;1;1;19825;14455;39;34280
02;2020-08-16;0;1;1;24719;18248;49;42967
02;2020-08-16;0;0;0;34361;28310;59;62671
02;2020-08-16;0;0;0;28061;24495;69;52556
02;2020-08-16;0;0;0;18231;15278;79;33509
02;2020-08-16;0;0;0;11090;7677;89;18767
02;2020-08-16;0;0;0;3992;1506;90;5498
02;2020-08-16;0;2;2;194587;164162;0;358749
03;2020-08-16;1;0;1;31123;30920;09;62043
03;2020-08-16;0;0;0;29370;29268;19;58638
03;2020-08-16;2;1;3;21458;18963;29;40421
03;2020-08-16;2;0;2;21276;18326;39;39602
03;2020-08-16;1;0;1;18164;16593;49;34757
03;2020-08-16;1;1;2;13469;13557;59;27026
03;2020-08-16;0;0;0;8776;8670;69;17446
03;2020-08-16;0;0;0;3777;3591;79;7368
03;2020-08-16;0;0;0;1649;1072;89;2721
03;2020-08-16;0;0;0;485;184;90;669
03;2020-08-16;7;2;9;149547;141144;0;290691
04;2020-08-16;1;0;1;60314;61377;09;121691
04;2020-08-16;5;0;5;66065;68387;19;134452
04;2020-08-16;4;4;8;51059;47156;29;98215
04;2020-08-16;4;0;4;58788;45780;39;104568
04;2020-08-16;4;1;5;61408;52207;49;113615
04;2020-08-16;1;2;3;64838;60759;59;125597
04;2020-08-16;1;1;2;47008;42843;69;89851
04;2020-08-16;0;2;2;25509;21184;79;46693
04;2020-08-16;0;0;0;13168;7647;89;20815
04;2020-08-16;0;1;1;3209;1253;90;4462
04;2020-08-16;20;11;31;451366;408593;0;859959
05;2020-08-16;0;0;0;362.366008612902;341.338819562748;09;703.704828175651
05;2020-08-16;0;0;0;353.376145114279;370.349735405642;19;723.725880519921
05;2020-08-16;0;0;0;218.593559489256;256.539602589476;29;475.133162078732
05;2020-08-16;0;0;0;404.225408693299;360.321910454353;39;764.547319147651
05;2020-08-16;0;0;0;520.067953604221;497.108383964256;49;1017.17633756848
05;2020-08-16;0;0;0;468.146063921917;510.087601910415;59;978.233665832332
05;2020-08-16;0;0;0;340.368470050554;334.366842191253;69;674.735312241807
05;2020-08-16;0;0;0;212.598666888387;192.597753227106;79;405.196420115493
05;2020-08-16;0;0;0;148.727797095705;61.8681715431829;89;210.595968638888
05;2020-08-16;0;0;0;32.9601271090696;10.9909785719784;90;43.9511056810479
05;2020-08-16;0;0;0;3061.43020057959;2935.56979942041;0;5997
06;2020-08-16;0;0;0;42583;42380;09;84963
06;2020-08-16;0;0;0;33369;31925;19;65294
06;2020-08-16;0;3;3;21571;15080;29;36651
06;2020-08-16;1;1;2;21550;16147;39;37697
06;2020-08-16;1;1;2;14193;13939;49;28132
06;2020-08-16;0;0;0;7171;7597;59;14768
06;2020-08-16;0;0;0;3629;4117;69;7746
06;2020-08-16;0;0;0;1577;1457;79;3034
06;2020-08-16;0;0;0;531;474;89;1005
06;2020-08-16;0;0;0;88;93;90;181
06;2020-08-16;2;5;7;146262;133209;0;279471
07;2020-08-16;0;0;0;485;549;09;1034
07;2020-08-16;0;0;0;403;432;19;835
07;2020-08-16;0;0;0;764;841;29;1605
07;2020-08-16;0;0;0;824;928;39;1752
07;2020-08-16;0;0;0;788;1020;49;1808
07;2020-08-16;0;0;0;678;870;59;1548
07;2020-08-16;0;0;0;360;382;69;742
07;2020-08-16;0;0;0;231;190;79;421
07;2020-08-16;0;0;0;114;67;89;181
07;2020-08-16;0;0;0;24;11;90;35
07;2020-08-16;0;0;0;4671;5290;0;9961
08;2020-08-16;0;0;0;2715.22592983026;2997.75551488675;09;5712.98144471701
08;2020-08-16;0;0;0;2778.51901080978;3160.9156459093;19;5939.43465671908
08;2020-08-16;0;0;0;2080.8882988764;1718.16634315323;29;3799.05464202964
08;2020-08-16;1;0;1;2701.8582062647;1896.52641413317;39;4598.38462039786
08;2020-08-16;0;0;0;3151.45861023308;2460.52498233809;49;5611.98359257117
08;2020-08-16;1;0;1;2620.29868333099;2422.23566154656;59;5042.53434487755
08;2020-08-16;1;1;2;1621.44173420671;1438.58325779464;69;3060.02499200135
08;2020-08-16;1;0;1;626.575909335673;526.358467843651;79;1152.93437717932
08;2020-08-16;0;0;0;205.018522985054;140.993639349697;89;346.012162334751
08;2020-08-16;0;0;0;50.0325684687745;20.62259870351;90;70.6551671722846
08;2020-08-16;4;1;5;18551.3174743414;16782.6825256586;0;35334
11;2020-08-16;3;0;3;783071;811785;09;1594856
11;2020-08-16;12;6;18;761456;784653;19;1546109
11;2020-08-16;51;46;97;850145;801772;29;1651917
11;2020-08-16;11;21;32;914360;843488;39;1757848
11;2020-08-16;10;20;30;845609;826202;49;1671811
11;2020-08-16;8;11;19;793566;745070;59;1538636
11;2020-08-16;6;6;12;628649;549192;69;1177841
11;2020-08-16;3;3;6;434606;358356;79;792962
11;2020-08-16;2;3;5;261425;162933;89;424358
11;2020-08-16;1;0;1;89253;32619;90;121872
11;2020-08-16;107;116;223;6362140;5916070;0;12278210
24;2020-08-16;1;1;2;139720;144686;09;284406
24;2020-08-16;1;0;1;152979;161185;19;314164
24;2020-08-16;1;2;3;122237;126536;29;248773
24;2020-08-16;6;1;7;150359;142009;39;292368
24;2020-08-16;1;2;3;161829;158758;49;320587
24;2020-08-16;1;0;1;172552;168011;59;340563
24;2020-08-16;2;0;2;172509;158177;69;330686
24;2020-08-16;1;2;3;129428;110593;79;240021
24;2020-08-16;1;0;1;87342;56882;89;144224
24;2020-08-16;3;0;3;31210;12071;90;43281
24;2020-08-16;18;8;26;1320165;1238908;0;2559073
27;2020-08-16;0;0;0;143373;149679;09;293052
27;2020-08-16;2;1;3;160962;173003;19;333965
27;2020-08-16;5;2;7;133746;142254;29;276000
27;2020-08-16;3;1;4;160004;155407;39;315411
27;2020-08-16;3;1;4;172333;169564;49;341897
27;2020-08-16;1;0;1;189979;183788;59;373767
27;2020-08-16;1;1;2;192591;178206;69;370797
27;2020-08-16;1;0;1;146876;127546;79;274422
27;2020-08-16;0;1;1;96896;61575;89;158471
27;2020-08-16;0;0;0;33148;12109;90;45257
27;2020-08-16;16;7;23;1429908;1353131;0;2783039
28;2020-08-16;0;1;1;180735;186856;09;367591
28;2020-08-16;1;1;2;200125;213621;19;413746
28;2020-08-16;5;3;8;168922;173007;29;341929
28;2020-08-16;1;3;4;196628;188487;39;385115
28;2020-08-16;0;3;3;205396;201699;49;407095
28;2020-08-16;3;0;3;222002;213866;59;435868
28;2020-08-16;2;1;3;224688;203758;69;428446
28;2020-08-16;0;0;0;163192;135543;79;298735
28;2020-08-16;2;1;3;109691;65377;89;175068
28;2020-08-16;6;1;7;37222;12685;90;49907
28;2020-08-16;20;14;34;1708601;1594899;0;3303500
32;2020-08-16;0;0;0;358062;373689;09;731751
32;2020-08-16;1;0;1;387045;406742;19;793787
32;2020-08-16;3;1;4;342304;348587;29;690891
32;2020-08-16;0;0;0;382485;369972;39;752457
32;2020-08-16;0;1;1;382510;376716;49;759226
32;2020-08-16;3;1;4;386937;376527;59;763464
32;2020-08-16;0;1;1;371211;330938;69;702149
32;2020-08-16;0;0;0;250542;201459;79;452001
32;2020-08-16;2;1;3;163399;89786;89;253185
32;2020-08-16;0;0;0;48384;15367;90;63751
32;2020-08-16;9;5;14;3072879;2889783;0;5962662
44;2020-08-16;0;0;0;291525;306839;09;598364
44;2020-08-16;0;0;0;320255;339504;19;659759
44;2020-08-16;1;3;4;302020;314428;29;616448
44;2020-08-16;3;2;5;342222;333292;39;675514
44;2020-08-16;1;0;1;349727;344491;49;694218
44;2020-08-16;0;1;1;381371;373239;59;754610
44;2020-08-16;0;0;0;367165;335850;69;703015
44;2020-08-16;1;0;1;250387;215436;79;465823
44;2020-08-16;0;1;1;170825;105192;89;276017
44;2020-08-16;0;0;0;51248;16731;90;67979
44;2020-08-16;6;7;13;2826745;2685002;0;5511747
52;2020-08-16;4;4;8;213594;223900;09;437494
52;2020-08-16;4;3;8;240818;255197;19;496015
52;2020-08-16;11;2;13;197010;200630;29;397640
52;2020-08-16;2;5;7;231204;224885;39;456089
52;2020-08-16;5;5;10;243874;243418;49;487292
52;2020-08-16;1;4;5;244100;239116;59;483216
52;2020-08-16;5;2;7;241796;221345;69;463141
52;2020-08-16;1;2;3;177805;149903;79;327708
52;2020-08-16;0;1;1;119561;75822;89;195383
52;2020-08-16;0;1;1;42559;15260;90;57819
52;2020-08-16;33;29;63;1952321;1849476;0;3801797
53;2020-08-16;0;0;0;173813;182358;09;356171
53;2020-08-16;0;0;0;202720;214740;19;417460
53;2020-08-16;1;6;7;163116;173196;29;336312
53;2020-08-16;2;1;3;190526;187674;39;378200
53;2020-08-16;2;1;3;212098;212015;49;424113
53;2020-08-16;0;2;2;223699;219176;59;442875
53;2020-08-16;0;0;0;227435;209274;69;436709
53;2020-08-16;0;1;1;169992;140910;79;310902
53;2020-08-16;0;0;0;118117;69883;89;188000
53;2020-08-16;1;0;1;37370;12267;90;49637
53;2020-08-16;6;11;17;1718886;1621493;0;3340379
75;2020-08-16;3;0;3;293104;305291;09;598395
75;2020-08-16;4;1;5;337141;357785;19;694926
75;2020-08-16;4;14;18;295024;300618;29;595642
75;2020-08-16;1;2;3;347871;331233;39;679104
75;2020-08-16;3;2;5;384742;372771;49;757513
75;2020-08-16;4;1;5;413361;390880;59;804241
75;2020-08-16;0;2;2;425623;384060;69;809683
75;2020-08-16;0;0;0;325086;276298;79;601384
75;2020-08-16;0;1;1;213986;139308;89;353294
75;2020-08-16;0;0;0;77600;28200;90;105800
75;2020-08-16;19;23;42;3113538;2886444;0;5999982
76;2020-08-16;1;1;2;305956;318589;09;624545
76;2020-08-16;3;4;7;338942;356969;19;695911
76;2020-08-16;4;3;7;316210;319570;29;635780
76;2020-08-16;3;7;10;356758;337587;39;694345
76;2020-08-16;0;1;1;376541;363812;49;740353
76;2020-08-16;1;3;4;402608;383750;59;786358
76;2020-08-16;2;2;4;394889;358997;69;753886
76;2020-08-16;2;3;5;308664;263806;79;572470
76;2020-08-16;2;0;2;195838;129272;89;325110
76;2020-08-16;0;0;0;69372;26728;90;96100
76;2020-08-16;18;24;42;3065778;2859080;0;5924858
84;2020-08-16;2;0;2;459549;481088;09;940637
84;2020-08-16;3;3;6;487711;511905;19;999616
84;2020-08-16;3;5;8;443824;451094;29;894918
84;2020-08-16;7;6;13;512522;493262;39;1005784
84;2020-08-16;2;5;7;520248;515106;49;1035354
84;2020-08-16;2;3;5;529611;514848;59;1044459
84;2020-08-16;1;2;3;486720;439940;69;926660
84;2020-08-16;0;2;2;372151;315211;79;687362
84;2020-08-16;0;0;0;237198;150524;89;387722
84;2020-08-16;0;0;0;81185;28680;90;109865
84;2020-08-16;20;26;46;4130719;3901658;0;8032377
93;2020-08-16;1;2;3;268834;283093;09;551927
93;2020-08-16;4;2;6;280751;296087;19;576838
93;2020-08-16;9;11;20;254404;255552;29;509956
93;2020-08-16;5;6;11;310704;288398;39;599102
93;2020-08-16;5;2;7;325559;305827;49;631386
93;2020-08-16;3;3;6;353104;325389;59;678493
93;2020-08-16;3;3;6;336327;296459;69;632786
93;2020-08-16;1;0;1;279820;229699;79;509519
93;2020-08-16;3;0;3;171274;113716;89;284990
93;2020-08-16;1;0;1;58896;21758;90;80654
93;2020-08-16;35;29;64;2639673;2415978;0;5055651
94;2020-08-16;0;0;0;16311;17433;09;33744
94;2020-08-16;0;0;0;16679;18132;19;34811
94;2020-08-16;0;0;0;16782;16579;29;33361
94;2020-08-16;0;0;0;23044;20580;39;43624
94;2020-08-16;0;0;0;23065;22140;49;45205
94;2020-08-16;0;0;0;24549;23421;59;47970
94;2020-08-16;0;0;0;23212;21883;69;45095
94;2020-08-16;0;0;0;19544;17141;79;36685
94;2020-08-16;0;0;0;11227;8178;89;19405
94;2020-08-16;0;0;0;3332;1447;90;4779
94;2020-08-16;0;0;0;177745;166934;0;344679
01;2020-08-17;2;2;4;19979;20155;09;40134
01;2020-08-17;3;0;3;24994;25489;19;50483
01;2020-08-17;20;10;30;17868;16690;29;34558
01;2020-08-17;16;11;27;22328;14821;39;37149
01;2020-08-17;2;3;5;28652;20276;49;48928
01;2020-08-17;3;2;5;33264;27260;59;60524
01;2020-08-17;2;1;3;27135;23978;69;51113
01;2020-08-17;0;0;0;18401;14661;79;33062
01;2020-08-17;0;0;0;9633;6375;89;16008
01;2020-08-17;0;0;0;3410;1510;90;4920
01;2020-08-17;48;29;77;205664;171215;0;376879
02;2020-08-17;0;0;0;16881;17110;09;33991
02;2020-08-17;5;1;6;21410;21604;19;43014
02;2020-08-17;6;4;10;16017;15479;29;31496
02;2020-08-17;10;5;15;19825;14455;39;34280
02;2020-08-17;5;2;7;24719;18248;49;42967
02;2020-08-17;3;3;6;34361;28310;59;62671
02;2020-08-17;3;0;3;28061;24495;69;52556
02;2020-08-17;1;1;2;18231;15278;79;33509
02;2020-08-17;0;1;2;11090;7677;89;18767
02;2020-08-17;1;0;1;3992;1506;90;5498
02;2020-08-17;34;17;52;194587;164162;0;358749
03;2020-08-17;0;3;3;31123;30920;09;62043
03;2020-08-17;4;2;6;29370;29268;19;58638
03;2020-08-17;5;4;9;21458;18963;29;40421
03;2020-08-17;2;1;3;21276;18326;39;39602
03;2020-08-17;3;2;5;18164;16593;49;34757
03;2020-08-17;2;3;5;13469;13557;59;27026
03;2020-08-17;3;4;7;8776;8670;69;17446
03;2020-08-17;0;0;0;3777;3591;79;7368
03;2020-08-17;0;0;0;1649;1072;89;2721
03;2020-08-17;0;0;0;485;184;90;669
03;2020-08-17;19;19;38;149547;141144;0;290691
04;2020-08-17;1;2;3;60314;61377;09;121691
04;2020-08-17;6;5;11;66065;68387;19;134452
04;2020-08-17;2;3;5;51059;47156;29;98215
04;2020-08-17;3;3;6;58788;45780;39;104568
04;2020-08-17;0;3;3;61408;52207;49;113615
04;2020-08-17;4;3;7;64838;60759;59;125597
04;2020-08-17;3;3;6;47008;42843;69;89851
04;2020-08-17;0;2;2;25509;21184;79;46693
04;2020-08-17;0;0;0;13168;7647;89;20815
04;2020-08-17;0;0;0;3209;1253;90;4462
04;2020-08-17;19;24;43;451366;408593;0;859959
05;2020-08-17;0;0;0;362.366008612902;341.338819562748;09;703.704828175651
05;2020-08-17;0;0;0;353.376145114279;370.349735405642;19;723.725880519921
05;2020-08-17;0;0;0;218.593559489256;256.539602589476;29;475.133162078732
05;2020-08-17;0;0;0;404.225408693299;360.321910454353;39;764.547319147651
05;2020-08-17;0;0;0;520.067953604221;497.108383964256;49;1017.17633756848
05;2020-08-17;0;0;0;468.146063921917;510.087601910415;59;978.233665832332
05;2020-08-17;0;0;0;340.368470050554;334.366842191253;69;674.735312241807
05;2020-08-17;0;0;0;212.598666888387;192.597753227106;79;405.196420115493
05;2020-08-17;0;0;0;148.727797095705;61.8681715431829;89;210.595968638888
05;2020-08-17;0;0;0;32.9601271090696;10.9909785719784;90;43.9511056810479
05;2020-08-17;0;0;0;3061.43020057959;2935.56979942041;0;5997
06;2020-08-17;0;0;0;42583;42380;09;84963
06;2020-08-17;1;2;4;33369;31925;19;65294
06;2020-08-17;3;2;5;21571;15080;29;36651
06;2020-08-17;0;2;2;21550;16147;39;37697
06;2020-08-17;3;4;7;14193;13939;49;28132
06;2020-08-17;1;0;1;7171;7597;59;14768
06;2020-08-17;0;0;0;3629;4117;69;7746
06;2020-08-17;0;0;0;1577;1457;79;3034
06;2020-08-17;0;0;0;531;474;89;1005
06;2020-08-17;0;0;0;88;93;90;181
06;2020-08-17;8;10;19;146262;133209;0;279471
07;2020-08-17;0;0;0;485;549;09;1034
07;2020-08-17;0;0;0;403;432;19;835
07;2020-08-17;0;0;0;764;841;29;1605
07;2020-08-17;0;1;1;824;928;39;1752
07;2020-08-17;0;0;0;788;1020;49;1808
07;2020-08-17;0;0;0;678;870;59;1548
07;2020-08-17;0;0;0;360;382;69;742
07;2020-08-17;0;0;0;231;190;79;421
07;2020-08-17;0;0;0;114;67;89;181
07;2020-08-17;0;0;0;24;11;90;35
07;2020-08-17;0;1;1;4671;5290;0;9961
08;2020-08-17;0;0;0;2715.22592983026;2997.75551488675;09;5712.98144471701
08;2020-08-17;1;0;1;2778.51901080978;3160.9156459093;19;5939.43465671908
08;2020-08-17;0;1;1;2080.8882988764;1718.16634315323;29;3799.05464202964
08;2020-08-17;2;0;2;2701.8582062647;1896.52641413317;39;4598.38462039786
08;2020-08-17;0;1;1;3151.45861023308;2460.52498233809;49;5611.98359257117
08;2020-08-17;2;0;2;2620.29868333099;2422.23566154656;59;5042.53434487755
08;2020-08-17;2;0;2;1621.44173420671;1438.58325779464;69;3060.02499200135
08;2020-08-17;0;0;0;626.575909335673;526.358467843651;79;1152.93437717932
08;2020-08-17;0;0;0;205.018522985054;140.993639349697;89;346.012162334751
08;2020-08-17;0;0;0;50.0325684687745;20.62259870351;90;70.6551671722846
08;2020-08-17;7;2;9;18551.3174743414;16782.6825256586;0;35334
11;2020-08-17;16;18;34;783071;811785;09;1594856
11;2020-08-17;63;88;151;761456;784653;19;1546109
11;2020-08-17;259;256;515;850145;801772;29;1651917
11;2020-08-17;143;171;314;914360;843488;39;1757848
11;2020-08-17;70;87;157;845609;826202;49;1671811
11;2020-08-17;62;49;111;793566;745070;59;1538636
11;2020-08-17;38;33;71;628649;549192;69;1177841
11;2020-08-17;11;22;33;434606;358356;79;792962
11;2020-08-17;13;10;23;261425;162933;89;424358
11;2020-08-17;4;2;6;89253;32619;90;121872
11;2020-08-17;679;736;1417;6362140;5916070;0;12278210
24;2020-08-17;7;3;10;139720;144686;09;284406
24;2020-08-17;13;13;26;152979;161185;19;314164
24;2020-08-17;19;26;45;122237;126536;29;248773
24;2020-08-17;10;8;18;150359;142009;39;292368
24;2020-08-17;13;16;29;161829;158758;49;320587
24;2020-08-17;8;10;18;172552;168011;59;340563
24;2020-08-17;8;3;11;172509;158177;69;330686
24;2020-08-17;3;4;7;129428;110593;79;240021
24;2020-08-17;3;1;4;87342;56882;89;144224
24;2020-08-17;0;0;0;31210;12071;90;43281
24;2020-08-17;84;84;168;1320165;1238908;0;2559073
27;2020-08-17;1;0;1;143373;149679;09;293052
27;2020-08-17;6;1;7;160962;173003;19;333965
27;2020-08-17;19;19;38;133746;142254;29;276000
27;2020-08-17;4;8;12;160004;155407;39;315411
27;2020-08-17;8;9;17;172333;169564;49;341897
27;2020-08-17;10;4;14;189979;183788;59;373767
27;2020-08-17;2;6;8;192591;178206;69;370797
27;2020-08-17;0;0;0;146876;127546;79;274422
27;2020-08-17;1;1;2;96896;61575;89;158471
27;2020-08-17;0;0;0;33148;12109;90;45257
27;2020-08-17;51;48;99;1429908;1353131;0;2783039
28;2020-08-17;1;0;1;180735;186856;09;367591
28;2020-08-17;6;4;10;200125;213621;19;413746
28;2020-08-17;8;12;21;168922;173007;29;341929
28;2020-08-17;6;5;11;196628;188487;39;385115
28;2020-08-17;5;4;9;205396;201699;49;407095
28;2020-08-17;2;4;6;222002;213866;59;435868
28;2020-08-17;4;3;7;224688;203758;69;428446
28;2020-08-17;0;2;2;163192;135543;79;298735
28;2020-08-17;1;2;3;109691;65377;89;175068
28;2020-08-17;1;0;1;37222;12685;90;49907
28;2020-08-17;34;36;71;1708601;1594899;0;3303500
32;2020-08-17;6;0;6;358062;373689;09;731751
32;2020-08-17;9;15;24;387045;406742;19;793787
32;2020-08-17;22;33;55;342304;348587;29;690891
32;2020-08-17;20;24;44;382485;369972;39;752457
32;2020-08-17;12;15;27;382510;376716;49;759226
32;2020-08-17;6;14;20;386937;376527;59;763464
32;2020-08-17;6;7;13;371211;330938;69;702149
32;2020-08-17;9;5;14;250542;201459;79;452001
32;2020-08-17;4;4;8;163399;89786;89;253185
32;2020-08-17;2;1;3;48384;15367;90;63751
32;2020-08-17;96;118;214;3072879;2889783;0;5962662
44;2020-08-17;7;2;9;291525;306839;09;598364
44;2020-08-17;14;12;26;320255;339504;19;659759
44;2020-08-17;23;46;69;302020;314428;29;616448
44;2020-08-17;17;13;30;342222;333292;39;675514
44;2020-08-17;17;19;36;349727;344491;49;694218
44;2020-08-17;11;10;21;381371;373239;59;754610
44;2020-08-17;8;5;13;367165;335850;69;703015
44;2020-08-17;2;4;6;250387;215436;79;465823
44;2020-08-17;1;2;3;170825;105192;89;276017
44;2020-08-17;2;0;2;51248;16731;90;67979
44;2020-08-17;102;113;215;2826745;2685002;0;5511747
52;2020-08-17;4;3;7;213594;223900;09;437494
52;2020-08-17;8;14;22;240818;255197;19;496015
52;2020-08-17;26;28;54;197010;200630;29;397640
52;2020-08-17;17;17;34;231204;224885;39;456089
52;2020-08-17;19;5;24;243874;243418;49;487292
52;2020-08-17;11;6;17;244100;239116;59;483216
52;2020-08-17;3;4;7;241796;221345;69;463141
52;2020-08-17;1;5;6;177805;149903;79;327708
52;2020-08-17;1;4;5;119561;75822;89;195383
52;2020-08-17;2;0;2;42559;15260;90;57819
52;2020-08-17;92;86;178;1952321;1849476;0;3801797
53;2020-08-17;4;0;4;173813;182358;09;356171
53;2020-08-17;5;5;10;202720;214740;19;417460
53;2020-08-17;12;14;26;163116;173196;29;336312
53;2020-08-17;6;6;12;190526;187674;39;378200
53;2020-08-17;10;7;17;212098;212015;49;424113
53;2020-08-17;8;8;16;223699;219176;59;442875
53;2020-08-17;7;4;11;227435;209274;69;436709
53;2020-08-17;2;0;2;169992;140910;79;310902
53;2020-08-17;0;0;0;118117;69883;89;188000
53;2020-08-17;0;0;0;37370;12267;90;49637
53;2020-08-17;54;44;98;1718886;1621493;0;3340379
75;2020-08-17;3;0;4;293104;305291;09;598395
75;2020-08-17;24;16;41;337141;357785;19;694926
75;2020-08-17;39;39;78;295024;300618;29;595642
75;2020-08-17;15;13;28;347871;331233;39;679104
75;2020-08-17;13;18;31;384742;372771;49;757513
75;2020-08-17;15;12;27;413361;390880;59;804241
75;2020-08-17;10;9;19;425623;384060;69;809683
75;2020-08-17;4;1;5;325086;276298;79;601384
75;2020-08-17;3;1;4;213986;139308;89;353294
75;2020-08-17;0;0;0;77600;28200;90;105800
75;2020-08-17;126;109;237;3113538;2886444;0;5999982
76;2020-08-17;7;10;18;305956;318589;09;624545
76;2020-08-17;24;21;45;338942;356969;19;695911
76;2020-08-17;65;75;140;316210;319570;29;635780
76;2020-08-17;54;55;109;356758;337587;39;694345
76;2020-08-17;36;41;77;376541;363812;49;740353
76;2020-08-17;25;32;57;402608;383750;59;786358
76;2020-08-17;16;14;30;394889;358997;69;753886
76;2020-08-17;6;9;15;308664;263806;79;572470
76;2020-08-17;2;2;4;195838;129272;89;325110
76;2020-08-17;0;0;0;69372;26728;90;96100
76;2020-08-17;235;259;495;3065778;2859080;0;5924858
84;2020-08-17;10;8;18;459549;481088;09;940637
84;2020-08-17;27;30;57;487711;511905;19;999616
84;2020-08-17;81;95;176;443824;451094;29;894918
84;2020-08-17;42;55;97;512522;493262;39;1005784
84;2020-08-17;23;31;54;520248;515106;49;1035354
84;2020-08-17;19;31;50;529611;514848;59;1044459
84;2020-08-17;12;15;27;486720;439940;69;926660
84;2020-08-17;6;4;10;372151;315211;79;687362
84;2020-08-17;3;3;6;237198;150524;89;387722
84;2020-08-17;6;0;6;81185;28680;90;109865
84;2020-08-17;229;272;501;4130719;3901658;0;8032377
93;2020-08-17;11;11;22;268834;283093;09;551927
93;2020-08-17;56;32;88;280751;296087;19;576838
93;2020-08-17;157;177;335;254404;255552;29;509956
93;2020-08-17;77;104;181;310704;288398;39;599102
93;2020-08-17;71;65;136;325559;305827;49;631386
93;2020-08-17;63;60;124;353104;325389;59;678493
93;2020-08-17;37;39;76;336327;296459;69;632786
93;2020-08-17;14;11;25;279820;229699;79;509519
93;2020-08-17;7;9;16;171274;113716;89;284990
93;2020-08-17;6;1;7;58896;21758;90;80654
93;2020-08-17;499;509;1010;2639673;2415978;0;5055651
94;2020-08-17;0;0;0;16311;17433;09;33744
94;2020-08-17;0;1;1;16679;18132;19;34811
94;2020-08-17;0;1;1;16782;16579;29;33361
94;2020-08-17;1;1;2;23044;20580;39;43624
94;2020-08-17;0;1;1;23065;22140;49;45205
94;2020-08-17;2;1;3;24549;23421;59;47970
94;2020-08-17;1;0;1;23212;21883;69;45095
94;2020-08-17;0;0;0;19544;17141;79;36685
94;2020-08-17;0;0;0;11227;8178;89;19405
94;2020-08-17;0;0;0;3332;1447;90;4779
94;2020-08-17;4;5;9;177745;166934;0;344679
01;2020-08-18;0;1;1;19979;20155;09;40134
01;2020-08-18;5;1;6;24994;25489;19;50483
01;2020-08-18;11;14;25;17868;16690;29;34558
01;2020-08-18;10;7;17;22328;14821;39;37149
01;2020-08-18;3;4;7;28652;20276;49;48928
01;2020-08-18;3;4;7;33264;27260;59;60524
01;2020-08-18;3;1;4;27135;23978;69;51113
01;2020-08-18;2;2;4;18401;14661;79;33062
01;2020-08-18;0;1;1;9633;6375;89;16008
01;2020-08-18;0;0;0;3410;1510;90;4920
01;2020-08-18;37;35;72;205664;171215;0;376879
02;2020-08-18;0;0;0;16881;17110;09;33991
02;2020-08-18;1;4;5;21410;21604;19;43014
02;2020-08-18;3;3;6;16017;15479;29;31496
02;2020-08-18;6;2;8;19825;14455;39;34280
02;2020-08-18;3;4;7;24719;18248;49;42967
02;2020-08-18;1;2;3;34361;28310;59;62671
02;2020-08-18;0;0;1;28061;24495;69;52556
02;2020-08-18;0;0;0;18231;15278;79;33509
02;2020-08-18;1;0;1;11090;7677;89;18767
02;2020-08-18;0;0;0;3992;1506;90;5498
02;2020-08-18;15;15;31;194587;164162;0;358749
03;2020-08-18;0;0;0;31123;30920;09;62043
03;2020-08-18;9;4;14;29370;29268;19;58638
03;2020-08-18;10;3;13;21458;18963;29;40421
03;2020-08-18;9;6;15;21276;18326;39;39602
03;2020-08-18;3;4;7;18164;16593;49;34757
03;2020-08-18;1;2;3;13469;13557;59;27026
03;2020-08-18;2;0;2;8776;8670;69;17446
03;2020-08-18;1;0;1;3777;3591;79;7368
03;2020-08-18;0;1;1;1649;1072;89;2721
03;2020-08-18;0;0;0;485;184;90;669
03;2020-08-18;35;20;56;149547;141144;0;290691
04;2020-08-18;0;0;0;60314;61377;09;121691
04;2020-08-18;3;2;5;66065;68387;19;134452
04;2020-08-18;9;3;12;51059;47156;29;98215
04;2020-08-18;5;1;6;58788;45780;39;104568
04;2020-08-18;3;3;6;61408;52207;49;113615
04;2020-08-18;4;3;7;64838;60759;59;125597
04;2020-08-18;3;4;7;47008;42843;69;89851
04;2020-08-18;1;0;1;25509;21184;79;46693
04;2020-08-18;0;0;0;13168;7647;89;20815
04;2020-08-18;0;0;0;3209;1253;90;4462
04;2020-08-18;28;16;44;451366;408593;0;859959
05;2020-08-18;0;0;0;362.366008612902;341.338819562748;09;703.704828175651
05;2020-08-18;0;0;0;353.376145114279;370.349735405642;19;723.725880519921
05;2020-08-18;0;0;0;218.593559489256;256.539602589476;29;475.133162078732
05;2020-08-18;0;0;0;404.225408693299;360.321910454353;39;764.547319147651
05;2020-08-18;0;0;0;520.067953604221;497.108383964256;49;1017.17633756848
05;2020-08-18;0;0;0;468.146063921917;510.087601910415;59;978.233665832332
05;2020-08-18;0;0;0;340.368470050554;334.366842191253;69;674.735312241807
05;2020-08-18;0;0;0;212.598666888387;192.597753227106;79;405.196420115493
05;2020-08-18;0;0;0;148.727797095705;61.8681715431829;89;210.595968638888
05;2020-08-18;0;0;0;32.9601271090696;10.9909785719784;90;43.9511056810479
05;2020-08-18;0;0;0;3061.43020057959;2935.56979942041;0;5997
06;2020-08-18;0;0;0;42583;42380;09;84963
06;2020-08-18;1;2;3;33369;31925;19;65294
06;2020-08-18;1;5;6;21571;15080;29;36651
06;2020-08-18;0;2;2;21550;16147;39;37697
06;2020-08-18;1;1;2;14193;13939;49;28132
06;2020-08-18;0;0;0;7171;7597;59;14768
06;2020-08-18;0;1;1;3629;4117;69;7746
06;2020-08-18;0;0;0;1577;1457;79;3034
06;2020-08-18;0;0;0;531;474;89;1005
06;2020-08-18;0;0;0;88;93;90;181
06;2020-08-18;3;11;14;146262;133209;0;279471
07;2020-08-18;0;0;0;485;549;09;1034
07;2020-08-18;0;0;0;403;432;19;835
07;2020-08-18;0;0;0;764;841;29;1605
07;2020-08-18;0;0;0;824;928;39;1752
07;2020-08-18;0;0;0;788;1020;49;1808
07;2020-08-18;0;0;0;678;870;59;1548
07;2020-08-18;0;0;0;360;382;69;742
07;2020-08-18;0;0;0;231;190;79;421
07;2020-08-18;0;0;0;114;67;89;181
07;2020-08-18;0;0;0;24;11;90;35
07;2020-08-18;0;0;0;4671;5290;0;9961
08;2020-08-18;1;0;1;2715.22592983026;2997.75551488675;09;5712.98144471701
08;2020-08-18;2;0;2;2778.51901080978;3160.9156459093;19;5939.43465671908
08;2020-08-18;0;3;3;2080.8882988764;1718.16634315323;29;3799.05464202964
08;2020-08-18;2;2;4;2701.8582062647;1896.52641413317;39;4598.38462039786
08;2020-08-18;2;2;4;3151.45861023308;2460.52498233809;49;5611.98359257117
08;2020-08-18;4;0;4;2620.29868333099;2422.23566154656;59;5042.53434487755
08;2020-08-18;1;0;1;1621.44173420671;1438.58325779464;69;3060.02499200135
08;2020-08-18;1;2;3;626.575909335673;526.358467843651;79;1152.93437717932
08;2020-08-18;0;0;0;205.018522985054;140.993639349697;89;346.012162334751
08;2020-08-18;0;0;0;50.0325684687745;20.62259870351;90;70.6551671722846
08;2020-08-18;13;9;22;18551.3174743414;16782.6825256586;0;35334
11;2020-08-18;13;13;27;783071;811785;09;1594856
11;2020-08-18;57;61;118;761456;784653;19;1546109
11;2020-08-18;236;260;497;850145;801772;29;1651917
11;2020-08-18;125;156;281;914360;843488;39;1757848
11;2020-08-18;72;84;156;845609;826202;49;1671811
11;2020-08-18;68;64;133;793566;745070;59;1538636
11;2020-08-18;37;43;80;628649;549192;69;1177841
11;2020-08-18;10;18;28;434606;358356;79;792962
11;2020-08-18;8;8;16;261425;162933;89;424358
11;2020-08-18;11;2;13;89253;32619;90;121872
11;2020-08-18;637;709;1350;6362140;5916070;0;12278210
24;2020-08-18;3;4;7;139720;144686;09;284406
24;2020-08-18;13;7;20;152979;161185;19;314164
24;2020-08-18;21;24;45;122237;126536;29;248773
24;2020-08-18;10;20;30;150359;142009;39;292368
24;2020-08-18;8;4;12;161829;158758;49;320587
24;2020-08-18;7;4;11;172552;168011;59;340563
24;2020-08-18;6;3;9;172509;158177;69;330686
24;2020-08-18;0;2;2;129428;110593;79;240021
24;2020-08-18;1;1;2;87342;56882;89;144224
24;2020-08-18;0;0;0;31210;12071;90;43281
24;2020-08-18;69;69;138;1320165;1238908;0;2559073
27;2020-08-18;0;2;2;143373;149679;09;293052
27;2020-08-18;4;9;14;160962;173003;19;333965
27;2020-08-18;10;22;32;133746;142254;29;276000
27;2020-08-18;4;9;13;160004;155407;39;315411
27;2020-08-18;7;5;12;172333;169564;49;341897
27;2020-08-18;6;4;10;189979;183788;59;373767
27;2020-08-18;1;4;5;192591;178206;69;370797
27;2020-08-18;3;2;5;146876;127546;79;274422
27;2020-08-18;0;1;1;96896;61575;89;158471
27;2020-08-18;0;0;0;33148;12109;90;45257
27;2020-08-18;35;58;94;1429908;1353131;0;2783039
28;2020-08-18;2;0;2;180735;186856;09;367591
28;2020-08-18;5;5;10;200125;213621;19;413746
28;2020-08-18;14;17;31;168922;173007;29;341929
28;2020-08-18;6;9;15;196628;188487;39;385115
28;2020-08-18;11;6;17;205396;201699;49;407095
28;2020-08-18;6;3;9;222002;213866;59;435868
28;2020-08-18;1;2;3;224688;203758;69;428446
28;2020-08-18;2;3;5;163192;135543;79;298735
28;2020-08-18;1;1;2;109691;65377;89;175068
28;2020-08-18;0;0;0;37222;12685;90;49907
28;2020-08-18;48;46;94;1708601;1594899;0;3303500
32;2020-08-18;7;10;17;358062;373689;09;731751
32;2020-08-18;14;12;26;387045;406742;19;793787
32;2020-08-18;32;38;70;342304;348587;29;690891
32;2020-08-18;17;21;38;382485;369972;39;752457
32;2020-08-18;18;18;36;382510;376716;49;759226
32;2020-08-18;11;10;21;386937;376527;59;763464
32;2020-08-18;8;6;14;371211;330938;69;702149
32;2020-08-18;4;2;6;250542;201459;79;452001
32;2020-08-18;1;2;3;163399;89786;89;253185
32;2020-08-18;1;0;1;48384;15367;90;63751
32;2020-08-18;113;119;233;3072879;2889783;0;5962662
44;2020-08-18;5;3;9;291525;306839;09;598364
44;2020-08-18;17;10;27;320255;339504;19;659759
44;2020-08-18;26;28;54;302020;314428;29;616448
44;2020-08-18;12;16;28;342222;333292;39;675514
44;2020-08-18;9;13;22;349727;344491;49;694218
44;2020-08-18;12;15;27;381371;373239;59;754610
44;2020-08-18;4;2;6;367165;335850;69;703015
44;2020-08-18;2;1;3;250387;215436;79;465823
44;2020-08-18;0;0;0;170825;105192;89;276017
44;2020-08-18;1;0;1;51248;16731;90;67979
44;2020-08-18;88;88;177;2826745;2685002;0;5511747
52;2020-08-18;2;0;2;213594;223900;09;437494
52;2020-08-18;11;11;22;240818;255197;19;496015
52;2020-08-18;28;29;57;197010;200630;29;397640
52;2020-08-18;16;23;39;231204;224885;39;456089
52;2020-08-18;14;17;31;243874;243418;49;487292
52;2020-08-18;12;10;22;244100;239116;59;483216
52;2020-08-18;4;4;8;241796;221345;69;463141
52;2020-08-18;1;2;3;177805;149903;79;327708
52;2020-08-18;0;1;1;119561;75822;89;195383
52;2020-08-18;1;0;1;42559;15260;90;57819
52;2020-08-18;89;97;186;1952321;1849476;0;3801797
53;2020-08-18;3;1;4;173813;182358;09;356171
53;2020-08-18;7;6;13;202720;214740;19;417460
53;2020-08-18;19;19;38;163116;173196;29;336312
53;2020-08-18;8;8;16;190526;187674;39;378200
53;2020-08-18;2;12;14;212098;212015;49;424113
53;2020-08-18;7;6;13;223699;219176;59;442875
53;2020-08-18;5;4;9;227435;209274;69;436709
53;2020-08-18;0;1;1;169992;140910;79;310902
53;2020-08-18;2;0;2;118117;69883;89;188000
53;2020-08-18;1;0;1;37370;12267;90;49637
53;2020-08-18;54;57;111;1718886;1621493;0;3340379
75;2020-08-18;6;5;11;293104;305291;09;598395
75;2020-08-18;24;19;43;337141;357785;19;694926
75;2020-08-18;61;61;122;295024;300618;29;595642
75;2020-08-18;24;20;44;347871;331233;39;679104
75;2020-08-18;17;18;35;384742;372771;49;757513
75;2020-08-18;22;19;41;413361;390880;59;804241
75;2020-08-18;10;12;22;425623;384060;69;809683
75;2020-08-18;4;2;6;325086;276298;79;601384
75;2020-08-18;8;2;10;213986;139308;89;353294
75;2020-08-18;5;1;6;77600;28200;90;105800
75;2020-08-18;181;159;340;3113538;2886444;0;5999982
76;2020-08-18;8;7;15;305956;318589;09;624545
76;2020-08-18;22;18;40;338942;356969;19;695911
76;2020-08-18;71;65;136;316210;319570;29;635780
76;2020-08-18;55;62;118;356758;337587;39;694345
76;2020-08-18;24;40;64;376541;363812;49;740353
76;2020-08-18;30;41;71;402608;383750;59;786358
76;2020-08-18;21;26;47;394889;358997;69;753886
76;2020-08-18;8;14;22;308664;263806;79;572470
76;2020-08-18;6;4;10;195838;129272;89;325110
76;2020-08-18;2;1;3;69372;26728;90;96100
76;2020-08-18;247;278;526;3065778;2859080;0;5924858
84;2020-08-18;8;5;13;459549;481088;09;940637
84;2020-08-18;17;23;40;487711;511905;19;999616
84;2020-08-18;61;84;145;443824;451094;29;894918
84;2020-08-18;40;37;77;512522;493262;39;1005784
84;2020-08-18;28;32;60;520248;515106;49;1035354
84;2020-08-18;17;19;36;529611;514848;59;1044459
84;2020-08-18;13;5;18;486720;439940;69;926660
84;2020-08-18;5;8;13;372151;315211;79;687362
84;2020-08-18;4;0;4;237198;150524;89;387722
84;2020-08-18;2;1;3;81185;28680;90;109865
84;2020-08-18;195;214;409;4130719;3901658;0;8032377
93;2020-08-18;12;10;22;268834;283093;09;551927
93;2020-08-18;40;20;60;280751;296087;19;576838
93;2020-08-18;140;149;289;254404;255552;29;509956
93;2020-08-18;58;68;126;310704;288398;39;599102
93;2020-08-18;64;68;132;325559;305827;49;631386
93;2020-08-18;35;43;78;353104;325389;59;678493
93;2020-08-18;20;18;38;336327;296459;69;632786
93;2020-08-18;8;14;22;279820;229699;79;509519
93;2020-08-18;11;7;18;171274;113716;89;284990
93;2020-08-18;5;3;8;58896;21758;90;80654
93;2020-08-18;393;400;793;2639673;2415978;0;5055651
94;2020-08-18;0;0;0;16311;17433;09;33744
94;2020-08-18;1;0;1;16679;18132;19;34811
94;2020-08-18;0;0;0;16782;16579;29;33361
94;2020-08-18;3;0;3;23044;20580;39;43624
94;2020-08-18;0;0;0;23065;22140;49;45205
94;2020-08-18;0;0;0;24549;23421;59;47970
94;2020-08-18;1;1;2;23212;21883;69;45095
94;2020-08-18;0;0;0;19544;17141;79;36685
94;2020-08-18;0;0;0;11227;8178;89;19405
94;2020-08-18;0;0;0;3332;1447;90;4779
94;2020-08-18;5;1;6;177745;166934;0;344679
01;2020-08-19;0;0;0;19979;20155;09;40134
01;2020-08-19;4;3;7;24994;25489;19;50483
01;2020-08-19;18;12;30;17868;16690;29;34558
01;2020-08-19;8;9;17;22328;14821;39;37149
01;2020-08-19;3;2;5;28652;20276;49;48928
01;2020-08-19;4;1;5;33264;27260;59;60524
01;2020-08-19;0;4;4;27135;23978;69;51113
01;2020-08-19;0;0;0;18401;14661;79;33062
01;2020-08-19;0;0;0;9633;6375;89;16008
01;2020-08-19;0;0;0;3410;1510;90;4920
01;2020-08-19;37;31;68;205664;171215;0;376879
02;2020-08-19;1;0;1;16881;17110;09;33991
02;2020-08-19;0;0;0;21410;21604;19;43014
02;2020-08-19;2;1;3;16017;15479;29;31496
02;2020-08-19;1;2;3;19825;14455;39;34280
02;2020-08-19;1;0;1;24719;18248;49;42967
02;2020-08-19;4;3;7;34361;28310;59;62671
02;2020-08-19;2;1;3;28061;24495;69;52556
02;2020-08-19;0;1;1;18231;15278;79;33509
02;2020-08-19;0;0;0;11090;7677;89;18767
02;2020-08-19;0;0;0;3992;1506;90;5498
02;2020-08-19;11;8;19;194587;164162;0;358749
03;2020-08-19;2;0;2;31123;30920;09;62043
03;2020-08-19;1;4;5;29370;29268;19;58638
03;2020-08-19;1;2;4;21458;18963;29;40421
03;2020-08-19;1;1;2;21276;18326;39;39602
03;2020-08-19;4;1;5;18164;16593;49;34757
03;2020-08-19;3;2;5;13469;13557;59;27026
03;2020-08-19;2;2;4;8776;8670;69;17446
03;2020-08-19;0;0;0;3777;3591;79;7368
03;2020-08-19;0;0;0;1649;1072;89;2721
03;2020-08-19;0;0;0;485;184;90;669
03;2020-08-19;14;12;27;149547;141144;0;290691
04;2020-08-19;5;1;6;60314;61377;09;121691
04;2020-08-19;8;3;11;66065;68387;19;134452
04;2020-08-19;6;4;10;51059;47156;29;98215
04;2020-08-19;4;5;9;58788;45780;39;104568
04;2020-08-19;3;2;5;61408;52207;49;113615
04;2020-08-19;2;3;5;64838;60759;59;125597
04;2020-08-19;2;3;5;47008;42843;69;89851
04;2020-08-19;1;2;3;25509;21184;79;46693
04;2020-08-19;2;1;3;13168;7647;89;20815
04;2020-08-19;0;0;0;3209;1253;90;4462
04;2020-08-19;33;24;57;451366;408593;0;859959
05;2020-08-19;0;0;0;362.366008612902;341.338819562748;09;703.704828175651
05;2020-08-19;0;0;0;353.376145114279;370.349735405642;19;723.725880519921
05;2020-08-19;0;0;0;218.593559489256;256.539602589476;29;475.133162078732
05;2020-08-19;0;0;0;404.225408693299;360.321910454353;39;764.547319147651
05;2020-08-19;0;0;0;520.067953604221;497.108383964256;49;1017.17633756848
05;2020-08-19;0;0;0;468.146063921917;510.087601910415;59;978.233665832332
05;2020-08-19;0;0;0;340.368470050554;334.366842191253;69;674.735312241807
05;2020-08-19;0;0;0;212.598666888387;192.597753227106;79;405.196420115493
05;2020-08-19;0;0;0;148.727797095705;61.8681715431829;89;210.595968638888
05;2020-08-19;0;0;0;32.9601271090696;10.9909785719784;90;43.9511056810479
05;2020-08-19;0;0;0;3061.43020057959;2935.56979942041;0;5997
06;2020-08-19;0;0;0;42583;42380;09;84963
06;2020-08-19;1;5;6;33369;31925;19;65294
06;2020-08-19;1;6;7;21571;15080;29;36651
06;2020-08-19;1;1;2;21550;16147;39;37697
06;2020-08-19;1;4;5;14193;13939;49;28132
06;2020-08-19;1;1;2;7171;7597;59;14768
06;2020-08-19;2;1;3;3629;4117;69;7746
06;2020-08-19;0;0;0;1577;1457;79;3034
06;2020-08-19;0;0;0;531;474;89;1005
06;2020-08-19;0;0;0;88;93;90;181
06;2020-08-19;7;18;25;146262;133209;0;279471
07;2020-08-19;0;0;0;485;549;09;1034
07;2020-08-19;0;0;0;403;432;19;835
07;2020-08-19;0;0;0;764;841;29;1605
07;2020-08-19;0;0;0;824;928;39;1752
07;2020-08-19;0;0;0;788;1020;49;1808
07;2020-08-19;0;0;0;678;870;59;1548
07;2020-08-19;0;0;0;360;382;69;742
07;2020-08-19;0;0;0;231;190;79;421
07;2020-08-19;0;0;0;114;67;89;181
07;2020-08-19;0;0;0;24;11;90;35
07;2020-08-19;0;0;0;4671;5290;0;9961
08;2020-08-19;1;0;1;2715.22592983026;2997.75551488675;09;5712.98144471701
08;2020-08-19;0;0;0;2778.51901080978;3160.9156459093;19;5939.43465671908
08;2020-08-19;2;1;3;2080.8882988764;1718.16634315323;29;3799.05464202964
08;2020-08-19;0;1;1;2701.8582062647;1896.52641413317;39;4598.38462039786
08;2020-08-19;0;2;2;3151.45861023308;2460.52498233809;49;5611.98359257117
08;2020-08-19;1;1;2;2620.29868333099;2422.23566154656;59;5042.53434487755
08;2020-08-19;1;0;1;1621.44173420671;1438.58325779464;69;3060.02499200135
08;2020-08-19;0;0;0;626.575909335673;526.358467843651;79;1152.93437717932
08;2020-08-19;0;0;0;205.018522985054;140.993639349697;89;346.012162334751
08;2020-08-19;0;0;0;50.0325684687745;20.62259870351;90;70.6551671722846
08;2020-08-19;5;5;10;18551.3174743414;16782.6825256586;0;35334
11;2020-08-19;16;22;39;783071;811785;09;1594856
11;2020-08-19;63;56;119;761456;784653;19;1546109
11;2020-08-19;248;285;533;850145;801772;29;1651917
11;2020-08-19;131;145;276;914360;843488;39;1757848
11;2020-08-19;87;84;171;845609;826202;49;1671811
11;2020-08-19;61;60;121;793566;745070;59;1538636
11;2020-08-19;41;37;78;628649;549192;69;1177841
11;2020-08-19;16;17;33;434606;358356;79;792962
11;2020-08-19;15;9;24;261425;162933;89;424358
11;2020-08-19;7;3;10;89253;32619;90;121872
11;2020-08-19;685;718;1404;6362140;5916070;0;12278210
24;2020-08-19;2;0;2;139720;144686;09;284406
24;2020-08-19;4;4;8;152979;161185;19;314164
24;2020-08-19;8;18;26;122237;126536;29;248773
24;2020-08-19;6;3;9;150359;142009;39;292368
24;2020-08-19;3;4;7;161829;158758;49;320587
24;2020-08-19;2;5;7;172552;168011;59;340563
24;2020-08-19;3;2;5;172509;158177;69;330686
24;2020-08-19;3;0;3;129428;110593;79;240021
24;2020-08-19;1;1;2;87342;56882;89;144224
24;2020-08-19;2;0;2;31210;12071;90;43281
24;2020-08-19;34;37;71;1320165;1238908;0;2559073
27;2020-08-19;2;1;3;143373;149679;09;293052
27;2020-08-19;5;6;11;160962;173003;19;333965
27;2020-08-19;11;20;31;133746;142254;29;276000
27;2020-08-19;8;6;14;160004;155407;39;315411
27;2020-08-19;5;4;9;172333;169564;49;341897
27;2020-08-19;5;3;8;189979;183788;59;373767
27;2020-08-19;1;4;5;192591;178206;69;370797
27;2020-08-19;0;1;1;146876;127546;79;274422
27;2020-08-19;0;1;1;96896;61575;89;158471
27;2020-08-19;0;0;0;33148;12109;90;45257
27;2020-08-19;37;46;83;1429908;1353131;0;2783039
28;2020-08-19;4;2;8;180735;186856;09;367591
28;2020-08-19;3;7;10;200125;213621;19;413746
28;2020-08-19;15;16;31;168922;173007;29;341929
28;2020-08-19;2;5;7;196628;188487;39;385115
28;2020-08-19;2;7;9;205396;201699;49;407095
28;2020-08-19;4;4;8;222002;213866;59;435868
28;2020-08-19;4;2;6;224688;203758;69;428446
28;2020-08-19;2;0;2;163192;135543;79;298735
28;2020-08-19;3;0;3;109691;65377;89;175068
28;2020-08-19;1;1;2;37222;12685;90;49907
28;2020-08-19;40;44;86;1708601;1594899;0;3303500
32;2020-08-19;5;3;8;358062;373689;09;731751
32;2020-08-19;12;7;19;387045;406742;19;793787
32;2020-08-19;29;25;54;342304;348587;29;690891
32;2020-08-19;17;17;35;382485;369972;39;752457
32;2020-08-19;14;13;27;382510;376716;49;759226
32;2020-08-19;12;9;21;386937;376527;59;763464
32;2020-08-19;5;7;12;371211;330938;69;702149
32;2020-08-19;1;2;3;250542;201459;79;452001
32;2020-08-19;0;1;1;163399;89786;89;253185
32;2020-08-19;0;0;0;48384;15367;90;63751
32;2020-08-19;95;84;180;3072879;2889783;0;5962662
44;2020-08-19;5;3;8;291525;306839;09;598364
44;2020-08-19;11;10;21;320255;339504;19;659759
44;2020-08-19;25;31;56;302020;314428;29;616448
44;2020-08-19;15;16;31;342222;333292;39;675514
44;2020-08-19;9;9;18;349727;344491;49;694218
44;2020-08-19;10;13;23;381371;373239;59;754610
44;2020-08-19;5;4;9;367165;335850;69;703015
44;2020-08-19;5;7;12;250387;215436;79;465823
44;2020-08-19;1;0;1;170825;105192;89;276017
44;2020-08-19;1;0;1;51248;16731;90;67979
44;2020-08-19;87;93;180;2826745;2685002;0;5511747
52;2020-08-19;4;2;6;213594;223900;09;437494
52;2020-08-19;10;15;25;240818;255197;19;496015
52;2020-08-19;33;32;65;197010;200630;29;397640
52;2020-08-19;11;19;31;231204;224885;39;456089
52;2020-08-19;17;20;37;243874;243418;49;487292
52;2020-08-19;19;13;32;244100;239116;59;483216
52;2020-08-19;7;11;18;241796;221345;69;463141
52;2020-08-19;6;3;9;177805;149903;79;327708
52;2020-08-19;0;4;4;119561;75822;89;195383
52;2020-08-19;0;0;0;42559;15260;90;57819
52;2020-08-19;107;120;228;1952321;1849476;0;3801797
53;2020-08-19;4;5;9;173813;182358;09;356171
53;2020-08-19;4;5;9;202720;214740;19;417460
53;2020-08-19;13;16;29;163116;173196;29;336312
53;2020-08-19;8;15;23;190526;187674;39;378200
53;2020-08-19;5;3;8;212098;212015;49;424113
53;2020-08-19;4;3;7;223699;219176;59;442875
53;2020-08-19;3;3;6;227435;209274;69;436709
53;2020-08-19;1;2;3;169992;140910;79;310902
53;2020-08-19;0;1;1;118117;69883;89;188000
53;2020-08-19;0;0;0;37370;12267;90;49637
53;2020-08-19;42;53;95;1718886;1621493;0;3340379
75;2020-08-19;3;8;11;293104;305291;09;598395
75;2020-08-19;18;22;40;337141;357785;19;694926
75;2020-08-19;60;70;130;295024;300618;29;595642
75;2020-08-19;22;17;39;347871;331233;39;679104
75;2020-08-19;16;17;33;384742;372771;49;757513
75;2020-08-19;19;19;38;413361;390880;59;804241
75;2020-08-19;6;4;10;425623;384060;69;809683
75;2020-08-19;1;5;6;325086;276298;79;601384
75;2020-08-19;2;0;2;213986;139308;89;353294
75;2020-08-19;0;2;2;77600;28200;90;105800
75;2020-08-19;148;164;312;3113538;2886444;0;5999982
76;2020-08-19;2;3;5;305956;318589;09;624545
76;2020-08-19;20;19;39;338942;356969;19;695911
76;2020-08-19;80;60;140;316210;319570;29;635780
76;2020-08-19;29;44;73;356758;337587;39;694345
76;2020-08-19;23;44;67;376541;363812;49;740353
76;2020-08-19;29;31;60;402608;383750;59;786358
76;2020-08-19;20;20;40;394889;358997;69;753886
76;2020-08-19;6;7;13;308664;263806;79;572470
76;2020-08-19;6;5;11;195838;129272;89;325110
76;2020-08-19;2;0;2;69372;26728;90;96100
76;2020-08-19;217;233;450;3065778;2859080;0;5924858
84;2020-08-19;7;4;11;459549;481088;09;940637
84;2020-08-19;28;19;47;487711;511905;19;999616
84;2020-08-19;77;92;169;443824;451094;29;894918
84;2020-08-19;32;40;72;512522;493262;39;1005784
84;2020-08-19;22;34;56;520248;515106;49;1035354
84;2020-08-19;28;21;49;529611;514848;59;1044459
84;2020-08-19;13;4;17;486720;439940;69;926660
84;2020-08-19;9;4;13;372151;315211;79;687362
84;2020-08-19;2;0;2;237198;150524;89;387722
84;2020-08-19;0;0;0;81185;28680;90;109865
84;2020-08-19;218;218;436;4130719;3901658;0;8032377
93;2020-08-19;9;9;18;268834;283093;09;551927
93;2020-08-19;62;49;111;280751;296087;19;576838
93;2020-08-19;162;183;346;254404;255552;29;509956
93;2020-08-19;92;105;197;310704;288398;39;599102
93;2020-08-19;72;67;139;325559;305827;49;631386
93;2020-08-19;65;55;120;353104;325389;59;678493
93;2020-08-19;34;40;74;336327;296459;69;632786
93;2020-08-19;18;13;31;279820;229699;79;509519
93;2020-08-19;9;12;21;171274;113716;89;284990
93;2020-08-19;4;2;6;58896;21758;90;80654
93;2020-08-19;528;535;1064;2639673;2415978;0;5055651
94;2020-08-19;0;0;0;16311;17433;09;33744
94;2020-08-19;0;0;0;16679;18132;19;34811
94;2020-08-19;0;2;2;16782;16579;29;33361
94;2020-08-19;0;1;1;23044;20580;39;43624
94;2020-08-19;0;1;1;23065;22140;49;45205
94;2020-08-19;0;0;0;24549;23421;59;47970
94;2020-08-19;0;0;0;23212;21883;69;45095
94;2020-08-19;1;1;2;19544;17141;79;36685
94;2020-08-19;0;1;1;11227;8178;89;19405
94;2020-08-19;0;0;0;3332;1447;90;4779
94;2020-08-19;1;6;7;177745;166934;0;344679
01;2020-08-20;0;0;0;19979;20155;09;40134
01;2020-08-20;7;4;11;24994;25489;19;50483
01;2020-08-20;15;11;26;17868;16690;29;34558
01;2020-08-20;3;8;11;22328;14821;39;37149
01;2020-08-20;6;6;12;28652;20276;49;48928
01;2020-08-20;7;3;10;33264;27260;59;60524
01;2020-08-20;1;1;2;27135;23978;69;51113
01;2020-08-20;0;1;1;18401;14661;79;33062
01;2020-08-20;0;0;0;9633;6375;89;16008
01;2020-08-20;0;0;0;3410;1510;90;4920
01;2020-08-20;39;34;73;205664;171215;0;376879
02;2020-08-20;1;0;1;16881;17110;09;33991
02;2020-08-20;2;1;3;21410;21604;19;43014
02;2020-08-20;4;1;5;16017;15479;29;31496
02;2020-08-20;5;0;5;19825;14455;39;34280
02;2020-08-20;1;1;2;24719;18248;49;42967
02;2020-08-20;3;4;7;34361;28310;59;62671
02;2020-08-20;3;1;4;28061;24495;69;52556
02;2020-08-20;0;0;0;18231;15278;79;33509
02;2020-08-20;0;1;2;11090;7677;89;18767
02;2020-08-20;0;0;0;3992;1506;90;5498
02;2020-08-20;19;9;29;194587;164162;0;358749
03;2020-08-20;1;3;4;31123;30920;09;62043
03;2020-08-20;4;6;10;29370;29268;19;58638
03;2020-08-20;9;6;15;21458;18963;29;40421
03;2020-08-20;5;3;8;21276;18326;39;39602
03;2020-08-20;6;4;10;18164;16593;49;34757
03;2020-08-20;3;2;5;13469;13557;59;27026
03;2020-08-20;0;2;2;8776;8670;69;17446
03;2020-08-20;0;2;2;3777;3591;79;7368
03;2020-08-20;0;1;1;1649;1072;89;2721
03;2020-08-20;0;0;0;485;184;90;669
03;2020-08-20;28;29;57;149547;141144;0;290691
04;2020-08-20;1;5;6;60314;61377;09;121691
04;2020-08-20;11;10;21;66065;68387;19;134452
04;2020-08-20;9;9;18;51059;47156;29;98215
04;2020-08-20;3;5;8;58788;45780;39;104568
04;2020-08-20;4;5;9;61408;52207;49;113615
04;2020-08-20;3;1;4;64838;60759;59;125597
04;2020-08-20;2;0;2;47008;42843;69;89851
04;2020-08-20;0;0;0;25509;21184;79;46693
04;2020-08-20;1;1;2;13168;7647;89;20815
04;2020-08-20;0;0;0;3209;1253;90;4462
04;2020-08-20;34;36;70;451366;408593;0;859959
05;2020-08-20;0;0;0;362.366008612902;341.338819562748;09;703.704828175651
05;2020-08-20;0;0;0;353.376145114279;370.349735405642;19;723.725880519921
05;2020-08-20;0;0;0;218.593559489256;256.539602589476;29;475.133162078732
05;2020-08-20;0;0;0;404.225408693299;360.321910454353;39;764.547319147651
05;2020-08-20;0;0;0;520.067953604221;497.108383964256;49;1017.17633756848
05;2020-08-20;0;0;0;468.146063921917;510.087601910415;59;978.233665832332
05;2020-08-20;0;0;0;340.368470050554;334.366842191253;69;674.735312241807
05;2020-08-20;0;0;0;212.598666888387;192.597753227106;79;405.196420115493
05;2020-08-20;0;0;0;148.727797095705;61.8681715431829;89;210.595968638888
05;2020-08-20;0;0;0;32.9601271090696;10.9909785719784;90;43.9511056810479
05;2020-08-20;0;0;0;3061.43020057959;2935.56979942041;0;5997
06;2020-08-20;0;0;0;42583;42380;09;84963
06;2020-08-20;0;0;0;33369;31925;19;65294
06;2020-08-20;3;2;5;21571;15080;29;36651
06;2020-08-20;1;2;3;21550;16147;39;37697
06;2020-08-20;0;0;0;14193;13939;49;28132
06;2020-08-20;0;0;0;7171;7597;59;14768
06;2020-08-20;1;0;1;3629;4117;69;7746
06;2020-08-20;0;0;0;1577;1457;79;3034
06;2020-08-20;0;0;0;531;474;89;1005
06;2020-08-20;0;0;0;88;93;90;181
06;2020-08-20;5;4;9;146262;133209;0;279471
07;2020-08-20;0;0;0;485;549;09;1034
07;2020-08-20;0;0;0;403;432;19;835
07;2020-08-20;0;0;0;764;841;29;1605
07;2020-08-20;0;0;0;824;928;39;1752
07;2020-08-20;0;0;0;788;1020;49;1808
07;2020-08-20;0;0;0;678;870;59;1548
07;2020-08-20;0;0;0;360;382;69;742
07;2020-08-20;0;0;0;231;190;79;421
07;2020-08-20;0;0;0;114;67;89;181
07;2020-08-20;0;0;0;24;11;90;35
07;2020-08-20;0;0;0;4671;5290;0;9961
08;2020-08-20;0;0;0;2715.22592983026;2997.75551488675;09;5712.98144471701
08;2020-08-20;0;0;0;2778.51901080978;3160.9156459093;19;5939.43465671908
08;2020-08-20;0;1;1;2080.8882988764;1718.16634315323;29;3799.05464202964
08;2020-08-20;1;1;2;2701.8582062647;1896.52641413317;39;4598.38462039786
08;2020-08-20;0;0;0;3151.45861023308;2460.52498233809;49;5611.98359257117
08;2020-08-20;0;0;0;2620.29868333099;2422.23566154656;59;5042.53434487755
08;2020-08-20;0;1;1;1621.44173420671;1438.58325779464;69;3060.02499200135
08;2020-08-20;0;0;0;626.575909335673;526.358467843651;79;1152.93437717932
08;2020-08-20;0;0;0;205.018522985054;140.993639349697;89;346.012162334751
08;2020-08-20;0;0;0;50.0325684687745;20.62259870351;90;70.6551671722846
08;2020-08-20;1;3;4;18551.3174743414;16782.6825256586;0;35334
11;2020-08-20;13;22;36;783071;811785;09;1594856
11;2020-08-20;90;83;173;761456;784653;19;1546109
11;2020-08-20;298;300;599;850145;801772;29;1651917
11;2020-08-20;136;174;310;914360;843488;39;1757848
11;2020-08-20;74;97;171;845609;826202;49;1671811
11;2020-08-20;72;74;146;793566;745070;59;1538636
11;2020-08-20;36;50;86;628649;549192;69;1177841
11;2020-08-20;13;11;24;434606;358356;79;792962
11;2020-08-20;8;11;19;261425;162933;89;424358
11;2020-08-20;2;1;3;89253;32619;90;121872
11;2020-08-20;742;823;1567;6362140;5916070;0;12278210
24;2020-08-20;4;2;6;139720;144686;09;284406
24;2020-08-20;6;9;15;152979;161185;19;314164
24;2020-08-20;30;14;44;122237;126536;29;248773
24;2020-08-20;7;15;22;150359;142009;39;292368
24;2020-08-20;8;8;16;161829;158758;49;320587
24;2020-08-20;5;4;9;172552;168011;59;340563
24;2020-08-20;6;4;10;172509;158177;69;330686
24;2020-08-20;1;1;2;129428;110593;79;240021
24;2020-08-20;1;1;2;87342;56882;89;144224
24;2020-08-20;1;0;1;31210;12071;90;43281
24;2020-08-20;69;58;127;1320165;1238908;0;2559073
27;2020-08-20;1;1;2;143373;149679;09;293052
27;2020-08-20;1;9;10;160962;173003;19;333965
27;2020-08-20;9;22;31;133746;142254;29;276000
27;2020-08-20;5;10;15;160004;155407;39;315411
27;2020-08-20;5;6;11;172333;169564;49;341897
27;2020-08-20;5;3;8;189979;183788;59;373767
27;2020-08-20;3;3;6;192591;178206;69;370797
27;2020-08-20;1;1;2;146876;127546;79;274422
27;2020-08-20;0;0;0;96896;61575;89;158471
27;2020-08-20;0;0;0;33148;12109;90;45257
27;2020-08-20;30;55;85;1429908;1353131;0;2783039
28;2020-08-20;3;2;6;180735;186856;09;367591
28;2020-08-20;4;3;7;200125;213621;19;413746
28;2020-08-20;8;6;14;168922;173007;29;341929
28;2020-08-20;8;6;14;196628;188487;39;385115
28;2020-08-20;7;8;15;205396;201699;49;407095
28;2020-08-20;3;1;4;222002;213866;59;435868
28;2020-08-20;4;2;6;224688;203758;69;428446
28;2020-08-20;1;3;4;163192;135543;79;298735
28;2020-08-20;2;2;4;109691;65377;89;175068
28;2020-08-20;4;1;5;37222;12685;90;49907
28;2020-08-20;44;34;79;1708601;1594899;0;3303500
32;2020-08-20;9;8;18;358062;373689;09;731751
32;2020-08-20;8;11;19;387045;406742;19;793787
32;2020-08-20;38;44;82;342304;348587;29;690891
32;2020-08-20;17;21;38;382485;369972;39;752457
32;2020-08-20;9;10;19;382510;376716;49;759226
32;2020-08-20;5;10;15;386937;376527;59;763464
32;2020-08-20;10;10;21;371211;330938;69;702149
32;2020-08-20;8;7;15;250542;201459;79;452001
32;2020-08-20;3;2;5;163399;89786;89;253185
32;2020-08-20;1;1;2;48384;15367;90;63751
32;2020-08-20;108;124;234;3072879;2889783;0;5962662
44;2020-08-20;4;3;7;291525;306839;09;598364
44;2020-08-20;7;18;26;320255;339504;19;659759
44;2020-08-20;22;28;50;302020;314428;29;616448
44;2020-08-20;17;20;37;342222;333292;39;675514
44;2020-08-20;11;10;21;349727;344491;49;694218
44;2020-08-20;4;9;13;381371;373239;59;754610
44;2020-08-20;5;4;9;367165;335850;69;703015
44;2020-08-20;0;1;1;250387;215436;79;465823
44;2020-08-20;1;1;2;170825;105192;89;276017
44;2020-08-20;1;0;1;51248;16731;90;67979
44;2020-08-20;72;94;167;2826745;2685002;0;5511747
52;2020-08-20;8;7;15;213594;223900;09;437494
52;2020-08-20;14;13;27;240818;255197;19;496015
52;2020-08-20;19;22;41;197010;200630;29;397640
52;2020-08-20;17;16;33;231204;224885;39;456089
52;2020-08-20;20;10;30;243874;243418;49;487292
52;2020-08-20;9;8;17;244100;239116;59;483216
52;2020-08-20;10;5;15;241796;221345;69;463141
52;2020-08-20;3;6;9;177805;149903;79;327708
52;2020-08-20;2;1;3;119561;75822;89;195383
52;2020-08-20;1;0;1;42559;15260;90;57819
52;2020-08-20;103;88;191;1952321;1849476;0;3801797
53;2020-08-20;3;0;3;173813;182358;09;356171
53;2020-08-20;10;6;17;202720;214740;19;417460
53;2020-08-20;22;22;44;163116;173196;29;336312
53;2020-08-20;1;5;6;190526;187674;39;378200
53;2020-08-20;7;5;12;212098;212015;49;424113
53;2020-08-20;4;9;13;223699;219176;59;442875
53;2020-08-20;1;0;1;227435;209274;69;436709
53;2020-08-20;0;1;1;169992;140910;79;310902
53;2020-08-20;1;1;2;118117;69883;89;188000
53;2020-08-20;1;1;2;37370;12267;90;49637
53;2020-08-20;50;50;101;1718886;1621493;0;3340379
75;2020-08-20;9;8;18;293104;305291;09;598395
75;2020-08-20;23;20;43;337141;357785;19;694926
75;2020-08-20;49;72;121;295024;300618;29;595642
75;2020-08-20;27;24;51;347871;331233;39;679104
75;2020-08-20;16;12;28;384742;372771;49;757513
75;2020-08-20;17;15;32;413361;390880;59;804241
75;2020-08-20;9;11;20;425623;384060;69;809683
75;2020-08-20;6;3;9;325086;276298;79;601384
75;2020-08-20;2;0;2;213986;139308;89;353294
75;2020-08-20;0;0;0;77600;28200;90;105800
75;2020-08-20;159;165;325;3113538;2886444;0;5999982
76;2020-08-20;10;9;20;305956;318589;09;624545
76;2020-08-20;37;31;69;338942;356969;19;695911
76;2020-08-20;72;94;166;316210;319570;29;635780
76;2020-08-20;49;33;82;356758;337587;39;694345
76;2020-08-20;34;29;63;376541;363812;49;740353
76;2020-08-20;33;28;61;402608;383750;59;786358
76;2020-08-20;13;12;25;394889;358997;69;753886
76;2020-08-20;6;11;17;308664;263806;79;572470
76;2020-08-20;4;2;6;195838;129272;89;325110
76;2020-08-20;6;0;6;69372;26728;90;96100
76;2020-08-20;264;249;515;3065778;2859080;0;5924858
84;2020-08-20;3;10;13;459549;481088;09;940637
84;2020-08-20;34;31;65;487711;511905;19;999616
84;2020-08-20;82;94;176;443824;451094;29;894918
84;2020-08-20;39;42;81;512522;493262;39;1005784
84;2020-08-20;40;31;71;520248;515106;49;1035354
84;2020-08-20;41;29;70;529611;514848;59;1044459
84;2020-08-20;12;14;27;486720;439940;69;926660
84;2020-08-20;7;4;11;372151;315211;79;687362
84;2020-08-20;4;3;7;237198;150524;89;387722
84;2020-08-20;2;3;5;81185;28680;90;109865
84;2020-08-20;264;261;526;4130719;3901658;0;8032377
93;2020-08-20;14;7;22;268834;283093;09;551927
93;2020-08-20;39;30;70;280751;296087;19;576838
93;2020-08-20;143;156;299;254404;255552;29;509956
93;2020-08-20;70;88;158;310704;288398;39;599102
93;2020-08-20;54;50;104;325559;305827;49;631386
93;2020-08-20;59;52;111;353104;325389;59;678493
93;2020-08-20;30;46;76;336327;296459;69;632786
93;2020-08-20;17;20;37;279820;229699;79;509519
93;2020-08-20;6;7;13;171274;113716;89;284990
93;2020-08-20;6;2;8;58896;21758;90;80654
93;2020-08-20;438;458;898;2639673;2415978;0;5055651
94;2020-08-20;0;1;1;16311;17433;09;33744
94;2020-08-20;0;0;0;16679;18132;19;34811
94;2020-08-20;1;0;1;16782;16579;29;33361
94;2020-08-20;1;1;2;23044;20580;39;43624
94;2020-08-20;3;0;3;23065;22140;49;45205
94;2020-08-20;0;0;0;24549;23421;59;47970
94;2020-08-20;0;0;0;23212;21883;69;45095
94;2020-08-20;0;0;0;19544;17141;79;36685
94;2020-08-20;0;0;0;11227;8178;89;19405
94;2020-08-20;0;0;0;3332;1447;90;4779
94;2020-08-20;5;2;7;177745;166934;0;344679
01;2020-08-21;0;0;0;19979;20155;09;40134
01;2020-08-21;1;0;1;24994;25489;19;50483
01;2020-08-21;3;3;6;17868;16690;29;34558
01;2020-08-21;4;1;5;22328;14821;39;37149
01;2020-08-21;0;0;0;28652;20276;49;48928
01;2020-08-21;4;4;8;33264;27260;59;60524
01;2020-08-21;2;1;3;27135;23978;69;51113
01;2020-08-21;1;0;1;18401;14661;79;33062
01;2020-08-21;1;0;1;9633;6375;89;16008
01;2020-08-21;0;0;0;3410;1510;90;4920
01;2020-08-21;16;9;25;205664;171215;0;376879
02;2020-08-21;2;0;2;16881;17110;09;33991
02;2020-08-21;2;1;3;21410;21604;19;43014
02;2020-08-21;6;1;8;16017;15479;29;31496
02;2020-08-21;3;7;10;19825;14455;39;34280
02;2020-08-21;0;2;2;24719;18248;49;42967
02;2020-08-21;1;4;5;34361;28310;59;62671
02;2020-08-21;1;2;3;28061;24495;69;52556
02;2020-08-21;1;0;1;18231;15278;79;33509
02;2020-08-21;1;0;1;11090;7677;89;18767
02;2020-08-21;0;0;0;3992;1506;90;5498
02;2020-08-21;17;17;35;194587;164162;0;358749
03;2020-08-21;1;3;4;31123;30920;09;62043
03;2020-08-21;2;4;6;29370;29268;19;58638
03;2020-08-21;5;4;9;21458;18963;29;40421
03;2020-08-21;8;2;10;21276;18326;39;39602
03;2020-08-21;3;2;5;18164;16593;49;34757
03;2020-08-21;1;6;7;13469;13557;59;27026
03;2020-08-21;2;0;2;8776;8670;69;17446
03;2020-08-21;0;1;1;3777;3591;79;7368
03;2020-08-21;2;0;2;1649;1072;89;2721
03;2020-08-21;0;0;0;485;184;90;669
03;2020-08-21;24;22;46;149547;141144;0;290691
04;2020-08-21;5;6;11;60314;61377;09;121691
04;2020-08-21;12;7;19;66065;68387;19;134452
04;2020-08-21;8;3;11;51059;47156;29;98215
04;2020-08-21;8;6;14;58788;45780;39;104568
04;2020-08-21;8;3;11;61408;52207;49;113615
04;2020-08-21;2;3;5;64838;60759;59;125597
04;2020-08-21;4;1;5;47008;42843;69;89851
04;2020-08-21;2;2;4;25509;21184;79;46693
04;2020-08-21;0;0;0;13168;7647;89;20815
04;2020-08-21;0;0;0;3209;1253;90;4462
04;2020-08-21;49;31;80;451366;408593;0;859959
05;2020-08-21;0;0;0;362.366008612902;341.338819562748;09;703.704828175651
05;2020-08-21;0;0;0;353.376145114279;370.349735405642;19;723.725880519921
05;2020-08-21;0;0;0;218.593559489256;256.539602589476;29;475.133162078732
05;2020-08-21;0;0;0;404.225408693299;360.321910454353;39;764.547319147651
05;2020-08-21;0;0;0;520.067953604221;497.108383964256;49;1017.17633756848
05;2020-08-21;0;0;0;468.146063921917;510.087601910415;59;978.233665832332
05;2020-08-21;0;0;0;340.368470050554;334.366842191253;69;674.735312241807
05;2020-08-21;0;0;0;212.598666888387;192.597753227106;79;405.196420115493
05;2020-08-21;0;0;0;148.727797095705;61.8681715431829;89;210.595968638888
05;2020-08-21;0;0;0;32.9601271090696;10.9909785719784;90;43.9511056810479
05;2020-08-21;0;0;0;3061.43020057959;2935.56979942041;0;5997
06;2020-08-21;0;0;0;42583;42380;09;84963
06;2020-08-21;1;0;1;33369;31925;19;65294
06;2020-08-21;1;1;2;21571;15080;29;36651
06;2020-08-21;1;2;3;21550;16147;39;37697
06;2020-08-21;0;1;1;14193;13939;49;28132
06;2020-08-21;0;1;1;7171;7597;59;14768
06;2020-08-21;0;1;1;3629;4117;69;7746
06;2020-08-21;0;0;0;1577;1457;79;3034
06;2020-08-21;0;0;0;531;474;89;1005
06;2020-08-21;0;0;0;88;93;90;181
06;2020-08-21;3;6;9;146262;133209;0;279471
07;2020-08-21;0;0;0;485;549;09;1034
07;2020-08-21;0;0;0;403;432;19;835
07;2020-08-21;0;0;0;764;841;29;1605
07;2020-08-21;0;0;0;824;928;39;1752
07;2020-08-21;0;0;0;788;1020;49;1808
07;2020-08-21;0;0;0;678;870;59;1548
07;2020-08-21;0;0;0;360;382;69;742
07;2020-08-21;0;0;0;231;190;79;421
07;2020-08-21;0;0;0;114;67;89;181
07;2020-08-21;0;0;0;24;11;90;35
07;2020-08-21;0;0;0;4671;5290;0;9961
08;2020-08-21;0;0;0;2715.22592983026;2997.75551488675;09;5712.98144471701
08;2020-08-21;0;1;1;2778.51901080978;3160.9156459093;19;5939.43465671908
08;2020-08-21;1;0;1;2080.8882988764;1718.16634315323;29;3799.05464202964
08;2020-08-21;0;1;1;2701.8582062647;1896.52641413317;39;4598.38462039786
08;2020-08-21;0;1;1;3151.45861023308;2460.52498233809;49;5611.98359257117
08;2020-08-21;1;1;2;2620.29868333099;2422.23566154656;59;5042.53434487755
08;2020-08-21;0;2;2;1621.44173420671;1438.58325779464;69;3060.02499200135
08;2020-08-21;0;0;0;626.575909335673;526.358467843651;79;1152.93437717932
08;2020-08-21;0;0;0;205.018522985054;140.993639349697;89;346.012162334751
08;2020-08-21;0;0;0;50.0325684687745;20.62259870351;90;70.6551671722846
08;2020-08-21;2;6;8;18551.3174743414;16782.6825256586;0;35334
11;2020-08-21;12;16;29;783071;811785;09;1594856
11;2020-08-21;87;88;178;761456;784653;19;1546109
11;2020-08-21;250;294;544;850145;801772;29;1651917
11;2020-08-21;143;169;312;914360;843488;39;1757848
11;2020-08-21;75;84;161;845609;826202;49;1671811
11;2020-08-21;72;66;138;793566;745070;59;1538636
11;2020-08-21;32;45;77;628649;549192;69;1177841
11;2020-08-21;18;14;32;434606;358356;79;792962
11;2020-08-21;11;7;18;261425;162933;89;424358
11;2020-08-21;9;1;10;89253;32619;90;121872
11;2020-08-21;709;785;1503;6362140;5916070;0;12278210
24;2020-08-21;1;1;2;139720;144686;09;284406
24;2020-08-21;10;9;19;152979;161185;19;314164
24;2020-08-21;14;22;36;122237;126536;29;248773
24;2020-08-21;15;8;23;150359;142009;39;292368
24;2020-08-21;12;9;21;161829;158758;49;320587
24;2020-08-21;6;7;13;172552;168011;59;340563
24;2020-08-21;4;4;8;172509;158177;69;330686
24;2020-08-21;0;2;2;129428;110593;79;240021
24;2020-08-21;1;2;3;87342;56882;89;144224
24;2020-08-21;2;0;2;31210;12071;90;43281
24;2020-08-21;65;64;129;1320165;1238908;0;2559073
27;2020-08-21;1;4;5;143373;149679;09;293052
27;2020-08-21;4;5;9;160962;173003;19;333965
27;2020-08-21;14;38;52;133746;142254;29;276000
27;2020-08-21;11;6;17;160004;155407;39;315411
27;2020-08-21;4;5;9;172333;169564;49;341897
27;2020-08-21;4;5;9;189979;183788;59;373767
27;2020-08-21;5;3;8;192591;178206;69;370797
27;2020-08-21;1;0;1;146876;127546;79;274422
27;2020-08-21;1;0;1;96896;61575;89;158471
27;2020-08-21;2;0;2;33148;12109;90;45257
27;2020-08-21;48;68;116;1429908;1353131;0;2783039
28;2020-08-21;2;2;4;180735;186856;09;367591
28;2020-08-21;5;6;11;200125;213621;19;413746
28;2020-08-21;15;8;23;168922;173007;29;341929
28;2020-08-21;7;5;12;196628;188487;39;385115
28;2020-08-21;2;6;8;205396;201699;49;407095
28;2020-08-21;4;3;7;222002;213866;59;435868
28;2020-08-21;2;7;9;224688;203758;69;428446
28;2020-08-21;2;1;3;163192;135543;79;298735
28;2020-08-21;0;0;0;109691;65377;89;175068
28;2020-08-21;0;0;0;37222;12685;90;49907
28;2020-08-21;39;38;77;1708601;1594899;0;3303500
32;2020-08-21;7;4;11;358062;373689;09;731751
32;2020-08-21;13;16;29;387045;406742;19;793787
32;2020-08-21;27;41;68;342304;348587;29;690891
32;2020-08-21;18;21;39;382485;369972;39;752457
32;2020-08-21;19;23;42;382510;376716;49;759226
32;2020-08-21;14;24;38;386937;376527;59;763464
32;2020-08-21;6;7;13;371211;330938;69;702149
32;2020-08-21;2;7;9;250542;201459;79;452001
32;2020-08-21;4;1;5;163399;89786;89;253185
32;2020-08-21;2;0;2;48384;15367;90;63751
32;2020-08-21;112;144;256;3072879;2889783;0;5962662
44;2020-08-21;4;2;6;291525;306839;09;598364
44;2020-08-21;11;8;19;320255;339504;19;659759
44;2020-08-21;30;38;68;302020;314428;29;616448
44;2020-08-21;12;27;39;342222;333292;39;675514
44;2020-08-21;13;8;21;349727;344491;49;694218
44;2020-08-21;9;8;17;381371;373239;59;754610
44;2020-08-21;4;5;9;367165;335850;69;703015
44;2020-08-21;4;1;5;250387;215436;79;465823
44;2020-08-21;4;0;4;170825;105192;89;276017
44;2020-08-21;0;0;0;51248;16731;90;67979
44;2020-08-21;91;97;188;2826745;2685002;0;5511747
52;2020-08-21;4;2;6;213594;223900;09;437494
52;2020-08-21;10;18;28;240818;255197;19;496015
52;2020-08-21;17;29;46;197010;200630;29;397640
52;2020-08-21;12;9;21;231204;224885;39;456089
52;2020-08-21;10;14;24;243874;243418;49;487292
52;2020-08-21;8;11;19;244100;239116;59;483216
52;2020-08-21;7;6;13;241796;221345;69;463141
52;2020-08-21;1;3;4;177805;149903;79;327708
52;2020-08-21;2;0;2;119561;75822;89;195383
52;2020-08-21;1;0;1;42559;15260;90;57819
52;2020-08-21;72;92;164;1952321;1849476;0;3801797
53;2020-08-21;1;0;1;173813;182358;09;356171
53;2020-08-21;9;3;12;202720;214740;19;417460
53;2020-08-21;13;18;31;163116;173196;29;336312
53;2020-08-21;12;6;18;190526;187674;39;378200
53;2020-08-21;9;4;13;212098;212015;49;424113
53;2020-08-21;8;1;9;223699;219176;59;442875
53;2020-08-21;2;1;3;227435;209274;69;436709
53;2020-08-21;2;3;5;169992;140910;79;310902
53;2020-08-21;0;0;0;118117;69883;89;188000
53;2020-08-21;0;1;1;37370;12267;90;49637
53;2020-08-21;56;37;93;1718886;1621493;0;3340379
75;2020-08-21;1;6;7;293104;305291;09;598395
75;2020-08-21;21;22;44;337141;357785;19;694926
75;2020-08-21;56;68;124;295024;300618;29;595642
75;2020-08-21;20;17;37;347871;331233;39;679104
75;2020-08-21;20;17;37;384742;372771;49;757513
75;2020-08-21;27;14;41;413361;390880;59;804241
75;2020-08-21;9;10;19;425623;384060;69;809683
75;2020-08-21;7;5;12;325086;276298;79;601384
75;2020-08-21;3;0;3;213986;139308;89;353294
75;2020-08-21;1;1;2;77600;28200;90;105800
75;2020-08-21;165;160;326;3113538;2886444;0;5999982
76;2020-08-21;0;5;5;305956;318589;09;624545
76;2020-08-21;33;24;57;338942;356969;19;695911
76;2020-08-21;88;59;148;316210;319570;29;635780
76;2020-08-21;34;38;72;356758;337587;39;694345
76;2020-08-21;30;23;53;376541;363812;49;740353
76;2020-08-21;34;23;57;402608;383750;59;786358
76;2020-08-21;13;14;27;394889;358997;69;753886
76;2020-08-21;4;6;10;308664;263806;79;572470
76;2020-08-21;5;1;6;195838;129272;89;325110
76;2020-08-21;2;0;2;69372;26728;90;96100
76;2020-08-21;243;193;437;3065778;2859080;0;5924858
84;2020-08-21;10;17;27;459549;481088;09;940637
84;2020-08-21;42;42;84;487711;511905;19;999616
84;2020-08-21;87;117;204;443824;451094;29;894918
84;2020-08-21;54;58;112;512522;493262;39;1005784
84;2020-08-21;37;35;72;520248;515106;49;1035354
84;2020-08-21;28;19;47;529611;514848;59;1044459
84;2020-08-21;12;17;29;486720;439940;69;926660
84;2020-08-21;5;7;12;372151;315211;79;687362
84;2020-08-21;2;4;6;237198;150524;89;387722
84;2020-08-21;0;1;1;81185;28680;90;109865
84;2020-08-21;277;317;594;4130719;3901658;0;8032377
93;2020-08-21;18;10;28;268834;283093;09;551927
93;2020-08-21;55;50;105;280751;296087;19;576838
93;2020-08-21;149;150;299;254404;255552;29;509956
93;2020-08-21;76;120;196;310704;288398;39;599102
93;2020-08-21;60;60;120;325559;305827;49;631386
93;2020-08-21;45;48;93;353104;325389;59;678493
93;2020-08-21;30;30;60;336327;296459;69;632786
93;2020-08-21;15;17;32;279820;229699;79;509519
93;2020-08-21;15;7;22;171274;113716;89;284990
93;2020-08-21;8;3;11;58896;21758;90;80654
93;2020-08-21;471;495;966;2639673;2415978;0;5055651
94;2020-08-21;0;0;0;16311;17433;09;33744
94;2020-08-21;0;0;0;16679;18132;19;34811
94;2020-08-21;3;2;5;16782;16579;29;33361
94;2020-08-21;0;0;0;23044;20580;39;43624
94;2020-08-21;1;0;1;23065;22140;49;45205
94;2020-08-21;0;0;0;24549;23421;59;47970
94;2020-08-21;0;0;0;23212;21883;69;45095
94;2020-08-21;0;0;0;19544;17141;79;36685
94;2020-08-21;0;0;0;11227;8178;89;19405
94;2020-08-21;0;0;0;3332;1447;90;4779
94;2020-08-21;4;2;6;177745;166934;0;344679
01;2020-08-22;0;0;0;19979;20155;09;40134
01;2020-08-22;0;0;0;24994;25489;19;50483
01;2020-08-22;1;1;2;17868;16690;29;34558
01;2020-08-22;0;1;1;22328;14821;39;37149
01;2020-08-22;0;1;1;28652;20276;49;48928
01;2020-08-22;0;0;0;33264;27260;59;60524
01;2020-08-22;0;1;1;27135;23978;69;51113
01;2020-08-22;0;2;2;18401;14661;79;33062
01;2020-08-22;0;0;0;9633;6375;89;16008
01;2020-08-22;0;0;0;3410;1510;90;4920
01;2020-08-22;1;6;7;205664;171215;0;376879
02;2020-08-22;0;0;0;16881;17110;09;33991
02;2020-08-22;1;0;1;21410;21604;19;43014
02;2020-08-22;2;0;2;16017;15479;29;31496
02;2020-08-22;0;1;1;19825;14455;39;34280
02;2020-08-22;1;1;2;24719;18248;49;42967
02;2020-08-22;2;1;3;34361;28310;59;62671
02;2020-08-22;0;0;0;28061;24495;69;52556
02;2020-08-22;0;0;0;18231;15278;79;33509
02;2020-08-22;0;0;0;11090;7677;89;18767
02;2020-08-22;0;0;0;3992;1506;90;5498
02;2020-08-22;6;3;9;194587;164162;0;358749
03;2020-08-22;3;0;3;31123;30920;09;62043
03;2020-08-22;1;4;5;29370;29268;19;58638
03;2020-08-22;4;3;7;21458;18963;29;40421
03;2020-08-22;1;2;3;21276;18326;39;39602
03;2020-08-22;1;2;3;18164;16593;49;34757
03;2020-08-22;2;2;4;13469;13557;59;27026
03;2020-08-22;2;0;2;8776;8670;69;17446
03;2020-08-22;0;0;0;3777;3591;79;7368
03;2020-08-22;0;0;0;1649;1072;89;2721
03;2020-08-22;0;0;0;485;184;90;669
03;2020-08-22;14;13;27;149547;141144;0;290691
04;2020-08-22;0;0;0;60314;61377;09;121691
04;2020-08-22;5;11;16;66065;68387;19;134452
04;2020-08-22;5;1;6;51059;47156;29;98215
04;2020-08-22;10;2;12;58788;45780;39;104568
04;2020-08-22;9;2;11;61408;52207;49;113615
04;2020-08-22;2;5;7;64838;60759;59;125597
04;2020-08-22;3;7;10;47008;42843;69;89851
04;2020-08-22;1;1;2;25509;21184;79;46693
04;2020-08-22;0;1;1;13168;7647;89;20815
04;2020-08-22;1;0;1;3209;1253;90;4462
04;2020-08-22;36;30;66;451366;408593;0;859959
05;2020-08-22;0;0;0;362.366008612902;341.338819562748;09;703.704828175651
05;2020-08-22;0;0;0;353.376145114279;370.349735405642;19;723.725880519921
05;2020-08-22;0;0;0;218.593559489256;256.539602589476;29;475.133162078732
05;2020-08-22;0;0;0;404.225408693299;360.321910454353;39;764.547319147651
05;2020-08-22;0;0;0;520.067953604221;497.108383964256;49;1017.17633756848
05;2020-08-22;0;0;0;468.146063921917;510.087601910415;59;978.233665832332
05;2020-08-22;0;0;0;340.368470050554;334.366842191253;69;674.735312241807
05;2020-08-22;0;0;0;212.598666888387;192.597753227106;79;405.196420115493
05;2020-08-22;0;0;0;148.727797095705;61.8681715431829;89;210.595968638888
05;2020-08-22;0;0;0;32.9601271090696;10.9909785719784;90;43.9511056810479
05;2020-08-22;0;0;0;3061.43020057959;2935.56979942041;0;5997
06;2020-08-22;0;0;0;42583;42380;09;84963
06;2020-08-22;1;0;1;33369;31925;19;65294
06;2020-08-22;0;1;1;21571;15080;29;36651
06;2020-08-22;0;0;0;21550;16147;39;37697
06;2020-08-22;0;0;0;14193;13939;49;28132
06;2020-08-22;0;0;0;7171;7597;59;14768
06;2020-08-22;0;0;0;3629;4117;69;7746
06;2020-08-22;0;0;0;1577;1457;79;3034
06;2020-08-22;0;0;0;531;474;89;1005
06;2020-08-22;0;0;0;88;93;90;181
06;2020-08-22;1;1;2;146262;133209;0;279471
07;2020-08-22;0;0;0;485;549;09;1034
07;2020-08-22;0;0;0;403;432;19;835
07;2020-08-22;0;0;0;764;841;29;1605
07;2020-08-22;0;0;0;824;928;39;1752
07;2020-08-22;0;0;0;788;1020;49;1808
07;2020-08-22;0;0;0;678;870;59;1548
07;2020-08-22;0;0;0;360;382;69;742
07;2020-08-22;0;0;0;231;190;79;421
07;2020-08-22;0;0;0;114;67;89;181
07;2020-08-22;0;0;0;24;11;90;35
07;2020-08-22;0;0;0;4671;5290;0;9961
08;2020-08-22;0;0;0;2715.22592983026;2997.75551488675;09;5712.98144471701
08;2020-08-22;1;0;1;2778.51901080978;3160.9156459093;19;5939.43465671908
08;2020-08-22;0;0;0;2080.8882988764;1718.16634315323;29;3799.05464202964
08;2020-08-22;0;0;0;2701.8582062647;1896.52641413317;39;4598.38462039786
08;2020-08-22;0;0;0;3151.45861023308;2460.52498233809;49;5611.98359257117
08;2020-08-22;0;0;0;2620.29868333099;2422.23566154656;59;5042.53434487755
08;2020-08-22;0;0;0;1621.44173420671;1438.58325779464;69;3060.02499200135
08;2020-08-22;0;0;0;626.575909335673;526.358467843651;79;1152.93437717932
08;2020-08-22;0;0;0;205.018522985054;140.993639349697;89;346.012162334751
08;2020-08-22;0;0;0;50.0325684687745;20.62259870351;90;70.6551671722846
08;2020-08-22;1;0;1;18551.3174743414;16782.6825256586;0;35334
11;2020-08-22;3;9;12;783071;811785;09;1594856
11;2020-08-22;38;34;72;761456;784653;19;1546109
11;2020-08-22;115;119;234;850145;801772;29;1651917
11;2020-08-22;45;66;111;914360;843488;39;1757848
11;2020-08-22;27;32;59;845609;826202;49;1671811
11;2020-08-22;27;34;61;793566;745070;59;1538636
11;2020-08-22;12;19;31;628649;549192;69;1177841
11;2020-08-22;4;3;7;434606;358356;79;792962
11;2020-08-22;3;5;8;261425;162933;89;424358
11;2020-08-22;5;2;7;89253;32619;90;121872
11;2020-08-22;279;323;602;6362140;5916070;0;12278210
24;2020-08-22;0;0;0;139720;144686;09;284406
24;2020-08-22;7;2;9;152979;161185;19;314164
24;2020-08-22;6;13;19;122237;126536;29;248773
24;2020-08-22;5;3;8;150359;142009;39;292368
24;2020-08-22;4;1;5;161829;158758;49;320587
24;2020-08-22;4;6;10;172552;168011;59;340563
24;2020-08-22;0;2;2;172509;158177;69;330686
24;2020-08-22;0;2;2;129428;110593;79;240021
24;2020-08-22;1;0;1;87342;56882;89;144224
24;2020-08-22;0;0;0;31210;12071;90;43281
24;2020-08-22;27;29;56;1320165;1238908;0;2559073
27;2020-08-22;1;3;4;143373;149679;09;293052
27;2020-08-22;3;5;8;160962;173003;19;333965
27;2020-08-22;11;12;23;133746;142254;29;276000
27;2020-08-22;3;7;10;160004;155407;39;315411
27;2020-08-22;3;9;12;172333;169564;49;341897
27;2020-08-22;0;3;3;189979;183788;59;373767
27;2020-08-22;1;4;5;192591;178206;69;370797
27;2020-08-22;0;0;0;146876;127546;79;274422
27;2020-08-22;0;0;0;96896;61575;89;158471
27;2020-08-22;0;0;0;33148;12109;90;45257
27;2020-08-22;22;43;65;1429908;1353131;0;2783039
28;2020-08-22;4;2;6;180735;186856;09;367591
28;2020-08-22;4;7;11;200125;213621;19;413746
28;2020-08-22;7;13;20;168922;173007;29;341929
28;2020-08-22;4;4;8;196628;188487;39;385115
28;2020-08-22;1;6;7;205396;201699;49;407095
28;2020-08-22;0;4;4;222002;213866;59;435868
28;2020-08-22;4;2;6;224688;203758;69;428446
28;2020-08-22;2;3;5;163192;135543;79;298735
28;2020-08-22;0;0;0;109691;65377;89;175068
28;2020-08-22;0;0;0;37222;12685;90;49907
28;2020-08-22;26;41;67;1708601;1594899;0;3303500
32;2020-08-22;0;1;1;358062;373689;09;731751
32;2020-08-22;6;4;10;387045;406742;19;793787
32;2020-08-22;10;20;30;342304;348587;29;690891
32;2020-08-22;11;6;17;382485;369972;39;752457
32;2020-08-22;7;10;17;382510;376716;49;759226
32;2020-08-22;9;2;11;386937;376527;59;763464
32;2020-08-22;5;6;11;371211;330938;69;702149
32;2020-08-22;1;2;3;250542;201459;79;452001
32;2020-08-22;0;1;1;163399;89786;89;253185
32;2020-08-22;0;1;1;48384;15367;90;63751
32;2020-08-22;49;53;102;3072879;2889783;0;5962662
44;2020-08-22;3;4;7;291525;306839;09;598364
44;2020-08-22;4;6;10;320255;339504;19;659759
44;2020-08-22;26;22;48;302020;314428;29;616448
44;2020-08-22;9;11;20;342222;333292;39;675514
44;2020-08-22;9;9;18;349727;344491;49;694218
44;2020-08-22;8;2;10;381371;373239;59;754610
44;2020-08-22;1;2;3;367165;335850;69;703015
44;2020-08-22;2;3;5;250387;215436;79;465823
44;2020-08-22;3;1;4;170825;105192;89;276017
44;2020-08-22;0;0;0;51248;16731;90;67979
44;2020-08-22;65;60;125;2826745;2685002;0;5511747
52;2020-08-22;2;0;2;213594;223900;09;437494
52;2020-08-22;5;2;7;240818;255197;19;496015
52;2020-08-22;6;15;21;197010;200630;29;397640
52;2020-08-22;2;7;9;231204;224885;39;456089
52;2020-08-22;7;2;9;243874;243418;49;487292
52;2020-08-22;3;1;4;244100;239116;59;483216
52;2020-08-22;2;0;2;241796;221345;69;463141
52;2020-08-22;0;1;1;177805;149903;79;327708
52;2020-08-22;0;1;1;119561;75822;89;195383
52;2020-08-22;1;0;1;42559;15260;90;57819
52;2020-08-22;28;29;57;1952321;1849476;0;3801797
53;2020-08-22;2;1;3;173813;182358;09;356171
53;2020-08-22;5;8;13;202720;214740;19;417460
53;2020-08-22;9;14;23;163116;173196;29;336312
53;2020-08-22;1;3;4;190526;187674;39;378200
53;2020-08-22;3;4;7;212098;212015;49;424113
53;2020-08-22;2;4;6;223699;219176;59;442875
53;2020-08-22;1;2;3;227435;209274;69;436709
53;2020-08-22;1;1;2;169992;140910;79;310902
53;2020-08-22;1;1;2;118117;69883;89;188000
53;2020-08-22;0;0;0;37370;12267;90;49637
53;2020-08-22;25;38;63;1718886;1621493;0;3340379
75;2020-08-22;2;6;8;293104;305291;09;598395
75;2020-08-22;21;14;35;337141;357785;19;694926
75;2020-08-22;39;57;96;295024;300618;29;595642
75;2020-08-22;11;16;27;347871;331233;39;679104
75;2020-08-22;12;11;23;384742;372771;49;757513
75;2020-08-22;11;13;24;413361;390880;59;804241
75;2020-08-22;5;2;7;425623;384060;69;809683
75;2020-08-22;2;3;5;325086;276298;79;601384
75;2020-08-22;1;1;2;213986;139308;89;353294
75;2020-08-22;0;0;0;77600;28200;90;105800
75;2020-08-22;104;123;227;3113538;2886444;0;5999982
76;2020-08-22;1;0;1;305956;318589;09;624545
76;2020-08-22;9;6;15;338942;356969;19;695911
76;2020-08-22;25;42;67;316210;319570;29;635780
76;2020-08-22;17;18;35;356758;337587;39;694345
76;2020-08-22;15;19;34;376541;363812;49;740353
76;2020-08-22;11;7;18;402608;383750;59;786358
76;2020-08-22;2;8;10;394889;358997;69;753886
76;2020-08-22;3;8;11;308664;263806;79;572470
76;2020-08-22;3;2;5;195838;129272;89;325110
76;2020-08-22;0;1;1;69372;26728;90;96100
76;2020-08-22;87;111;198;3065778;2859080;0;5924858
84;2020-08-22;3;3;6;459549;481088;09;940637
84;2020-08-22;7;4;11;487711;511905;19;999616
84;2020-08-22;41;25;66;443824;451094;29;894918
84;2020-08-22;9;12;21;512522;493262;39;1005784
84;2020-08-22;8;12;20;520248;515106;49;1035354
84;2020-08-22;6;11;17;529611;514848;59;1044459
84;2020-08-22;8;2;10;486720;439940;69;926660
84;2020-08-22;3;3;6;372151;315211;79;687362
84;2020-08-22;3;0;3;237198;150524;89;387722
84;2020-08-22;0;0;0;81185;28680;90;109865
84;2020-08-22;88;72;160;4130719;3901658;0;8032377
93;2020-08-22;5;4;9;268834;283093;09;551927
93;2020-08-22;18;10;28;280751;296087;19;576838
93;2020-08-22;63;51;114;254404;255552;29;509956
93;2020-08-22;23;29;52;310704;288398;39;599102
93;2020-08-22;16;24;40;325559;305827;49;631386
93;2020-08-22;18;21;39;353104;325389;59;678493
93;2020-08-22;9;3;12;336327;296459;69;632786
93;2020-08-22;8;12;20;279820;229699;79;509519
93;2020-08-22;5;10;15;171274;113716;89;284990
93;2020-08-22;3;0;3;58896;21758;90;80654
93;2020-08-22;168;164;333;2639673;2415978;0;5055651
94;2020-08-22;1;0;1;16311;17433;09;33744
94;2020-08-22;0;1;1;16679;18132;19;34811
94;2020-08-22;0;0;0;16782;16579;29;33361
94;2020-08-22;0;2;2;23044;20580;39;43624
94;2020-08-22;0;0;0;23065;22140;49;45205
94;2020-08-22;0;1;1;24549;23421;59;47970
94;2020-08-22;0;0;0;23212;21883;69;45095
94;2020-08-22;0;0;0;19544;17141;79;36685
94;2020-08-22;0;0;0;11227;8178;89;19405
94;2020-08-22;0;0;0;3332;1447;90;4779
94;2020-08-22;1;4;5;177745;166934;0;344679
01;2020-08-23;0;0;0;19979;20155;09;40134
01;2020-08-23;0;0;0;24994;25489;19;50483
01;2020-08-23;4;1;5;17868;16690;29;34558
01;2020-08-23;2;3;5;22328;14821;39;37149
01;2020-08-23;0;0;0;28652;20276;49;48928
01;2020-08-23;0;0;0;33264;27260;59;60524
01;2020-08-23;0;0;0;27135;23978;69;51113
01;2020-08-23;1;0;1;18401;14661;79;33062
01;2020-08-23;0;1;1;9633;6375;89;16008
01;2020-08-23;0;0;0;3410;1510;90;4920
01;2020-08-23;7;5;12;205664;171215;0;376879
02;2020-08-23;0;0;0;16881;17110;09;33991
02;2020-08-23;0;0;0;21410;21604;19;43014
02;2020-08-23;0;0;0;16017;15479;29;31496
02;2020-08-23;0;0;0;19825;14455;39;34280
02;2020-08-23;0;0;0;24719;18248;49;42967
02;2020-08-23;0;0;0;34361;28310;59;62671
02;2020-08-23;0;0;0;28061;24495;69;52556
02;2020-08-23;0;0;0;18231;15278;79;33509
02;2020-08-23;0;0;0;11090;7677;89;18767
02;2020-08-23;0;0;0;3992;1506;90;5498
02;2020-08-23;0;0;0;194587;164162;0;358749
03;2020-08-23;0;0;0;31123;30920;09;62043
03;2020-08-23;0;0;0;29370;29268;19;58638
03;2020-08-23;1;0;1;21458;18963;29;40421
03;2020-08-23;0;0;0;21276;18326;39;39602
03;2020-08-23;3;0;3;18164;16593;49;34757
03;2020-08-23;1;0;1;13469;13557;59;27026
03;2020-08-23;1;0;1;8776;8670;69;17446
03;2020-08-23;0;0;0;3777;3591;79;7368
03;2020-08-23;0;0;0;1649;1072;89;2721
03;2020-08-23;0;0;0;485;184;90;669
03;2020-08-23;6;0;6;149547;141144;0;290691
04;2020-08-23;0;1;1;60314;61377;09;121691
04;2020-08-23;3;2;5;66065;68387;19;134452
04;2020-08-23;2;1;3;51059;47156;29;98215
04;2020-08-23;0;3;3;58788;45780;39;104568
04;2020-08-23;0;2;2;61408;52207;49;113615
04;2020-08-23;0;1;1;64838;60759;59;125597
04;2020-08-23;1;0;1;47008;42843;69;89851
04;2020-08-23;0;0;0;25509;21184;79;46693
04;2020-08-23;0;0;0;13168;7647;89;20815
04;2020-08-23;0;0;0;3209;1253;90;4462
04;2020-08-23;6;10;16;451366;408593;0;859959
05;2020-08-23;0;0;0;362.366008612902;341.338819562748;09;703.704828175651
05;2020-08-23;0;0;0;353.376145114279;370.349735405642;19;723.725880519921
05;2020-08-23;0;0;0;218.593559489256;256.539602589476;29;475.133162078732
05;2020-08-23;0;0;0;404.225408693299;360.321910454353;39;764.547319147651
05;2020-08-23;0;0;0;520.067953604221;497.108383964256;49;1017.17633756848
05;2020-08-23;0;0;0;468.146063921917;510.087601910415;59;978.233665832332
05;2020-08-23;0;0;0;340.368470050554;334.366842191253;69;674.735312241807
05;2020-08-23;0;0;0;212.598666888387;192.597753227106;79;405.196420115493
05;2020-08-23;0;0;0;148.727797095705;61.8681715431829;89;210.595968638888
05;2020-08-23;0;0;0;32.9601271090696;10.9909785719784;90;43.9511056810479
05;2020-08-23;0;0;0;3061.43020057959;2935.56979942041;0;5997
06;2020-08-23;0;0;0;42583;42380;09;84963
06;2020-08-23;1;1;2;33369;31925;19;65294
06;2020-08-23;1;1;2;21571;15080;29;36651
06;2020-08-23;1;1;2;21550;16147;39;37697
06;2020-08-23;0;0;0;14193;13939;49;28132
06;2020-08-23;0;0;0;7171;7597;59;14768
06;2020-08-23;0;0;0;3629;4117;69;7746
06;2020-08-23;0;0;0;1577;1457;79;3034
06;2020-08-23;0;0;0;531;474;89;1005
06;2020-08-23;0;0;0;88;93;90;181
06;2020-08-23;3;3;6;146262;133209;0;279471
07;2020-08-23;0;0;0;485;549;09;1034
07;2020-08-23;0;0;0;403;432;19;835
07;2020-08-23;0;0;0;764;841;29;1605
07;2020-08-23;0;0;0;824;928;39;1752
07;2020-08-23;0;0;0;788;1020;49;1808
07;2020-08-23;0;0;0;678;870;59;1548
07;2020-08-23;0;0;0;360;382;69;742
07;2020-08-23;0;0;0;231;190;79;421
07;2020-08-23;0;0;0;114;67;89;181
07;2020-08-23;0;0;0;24;11;90;35
07;2020-08-23;0;0;0;4671;5290;0;9961
08;2020-08-23;0;0;0;2715.22592983026;2997.75551488675;09;5712.98144471701
08;2020-08-23;0;0;0;2778.51901080978;3160.9156459093;19;5939.43465671908
08;2020-08-23;0;0;0;2080.8882988764;1718.16634315323;29;3799.05464202964
08;2020-08-23;0;0;0;2701.8582062647;1896.52641413317;39;4598.38462039786
08;2020-08-23;0;0;0;3151.45861023308;2460.52498233809;49;5611.98359257117
08;2020-08-23;0;0;0;2620.29868333099;2422.23566154656;59;5042.53434487755
08;2020-08-23;1;0;1;1621.44173420671;1438.58325779464;69;3060.02499200135
08;2020-08-23;0;0;0;626.575909335673;526.358467843651;79;1152.93437717932
08;2020-08-23;0;1;1;205.018522985054;140.993639349697;89;346.012162334751
08;2020-08-23;0;0;0;50.0325684687745;20.62259870351;90;70.6551671722846
08;2020-08-23;1;1;2;18551.3174743414;16782.6825256586;0;35334
11;2020-08-23;2;1;3;783071;811785;09;1594856
11;2020-08-23;18;8;26;761456;784653;19;1546109
11;2020-08-23;65;59;124;850145;801772;29;1651917
11;2020-08-23;18;49;67;914360;843488;39;1757848
11;2020-08-23;19;22;41;845609;826202;49;1671811
11;2020-08-23;6;14;20;793566;745070;59;1538636
11;2020-08-23;7;15;22;628649;549192;69;1177841
11;2020-08-23;6;5;11;434606;358356;79;792962
11;2020-08-23;1;2;3;261425;162933;89;424358
11;2020-08-23;0;0;0;89253;32619;90;121872
11;2020-08-23;142;175;317;6362140;5916070;0;12278210
24;2020-08-23;0;0;0;139720;144686;09;284406
24;2020-08-23;1;1;2;152979;161185;19;314164
24;2020-08-23;3;4;7;122237;126536;29;248773
24;2020-08-23;1;0;1;150359;142009;39;292368
24;2020-08-23;1;1;2;161829;158758;49;320587
24;2020-08-23;1;0;1;172552;168011;59;340563
24;2020-08-23;2;1;3;172509;158177;69;330686
24;2020-08-23;0;0;0;129428;110593;79;240021
24;2020-08-23;0;0;0;87342;56882;89;144224
24;2020-08-23;0;0;0;31210;12071;90;43281
24;2020-08-23;9;7;16;1320165;1238908;0;2559073
27;2020-08-23;0;1;1;143373;149679;09;293052
27;2020-08-23;3;1;4;160962;173003;19;333965
27;2020-08-23;4;8;12;133746;142254;29;276000
27;2020-08-23;4;2;6;160004;155407;39;315411
27;2020-08-23;5;0;5;172333;169564;49;341897
27;2020-08-23;0;3;3;189979;183788;59;373767
27;2020-08-23;1;1;2;192591;178206;69;370797
27;2020-08-23;0;2;2;146876;127546;79;274422
27;2020-08-23;1;1;2;96896;61575;89;158471
27;2020-08-23;1;0;1;33148;12109;90;45257
27;2020-08-23;19;19;38;1429908;1353131;0;2783039
28;2020-08-23;0;0;0;180735;186856;09;367591
28;2020-08-23;1;1;2;200125;213621;19;413746
28;2020-08-23;5;8;13;168922;173007;29;341929
28;2020-08-23;0;1;1;196628;188487;39;385115
28;2020-08-23;3;1;4;205396;201699;49;407095
28;2020-08-23;0;0;0;222002;213866;59;435868
28;2020-08-23;0;0;0;224688;203758;69;428446
28;2020-08-23;0;0;0;163192;135543;79;298735
28;2020-08-23;0;0;0;109691;65377;89;175068
28;2020-08-23;0;0;0;37222;12685;90;49907
28;2020-08-23;9;11;20;1708601;1594899;0;3303500
32;2020-08-23;1;0;1;358062;373689;09;731751
32;2020-08-23;3;0;3;387045;406742;19;793787
32;2020-08-23;4;6;10;342304;348587;29;690891
32;2020-08-23;1;1;2;382485;369972;39;752457
32;2020-08-23;2;1;3;382510;376716;49;759226
32;2020-08-23;2;0;2;386937;376527;59;763464
32;2020-08-23;0;1;1;371211;330938;69;702149
32;2020-08-23;1;2;3;250542;201459;79;452001
32;2020-08-23;0;0;0;163399;89786;89;253185
32;2020-08-23;0;0;0;48384;15367;90;63751
32;2020-08-23;14;11;25;3072879;2889783;0;5962662
44;2020-08-23;1;0;1;291525;306839;09;598364
44;2020-08-23;2;2;4;320255;339504;19;659759
44;2020-08-23;3;5;8;302020;314428;29;616448
44;2020-08-23;5;3;8;342222;333292;39;675514
44;2020-08-23;1;2;3;349727;344491;49;694218
44;2020-08-23;0;0;0;381371;373239;59;754610
44;2020-08-23;1;2;3;367165;335850;69;703015
44;2020-08-23;0;1;1;250387;215436;79;465823
44;2020-08-23;0;0;0;170825;105192;89;276017
44;2020-08-23;0;0;0;51248;16731;90;67979
44;2020-08-23;13;15;28;2826745;2685002;0;5511747
52;2020-08-23;0;1;1;213594;223900;09;437494
52;2020-08-23;1;4;5;240818;255197;19;496015
52;2020-08-23;4;3;7;197010;200630;29;397640
52;2020-08-23;1;2;3;231204;224885;39;456089
52;2020-08-23;1;3;4;243874;243418;49;487292
52;2020-08-23;0;1;1;244100;239116;59;483216
52;2020-08-23;1;0;1;241796;221345;69;463141
52;2020-08-23;0;2;2;177805;149903;79;327708
52;2020-08-23;2;1;3;119561;75822;89;195383
52;2020-08-23;0;0;0;42559;15260;90;57819
52;2020-08-23;10;17;27;1952321;1849476;0;3801797
53;2020-08-23;0;0;0;173813;182358;09;356171
53;2020-08-23;1;0;1;202720;214740;19;417460
53;2020-08-23;1;8;11;163116;173196;29;336312
53;2020-08-23;3;4;7;190526;187674;39;378200
53;2020-08-23;2;0;2;212098;212015;49;424113
53;2020-08-23;0;0;0;223699;219176;59;442875
53;2020-08-23;0;1;1;227435;209274;69;436709
53;2020-08-23;0;1;1;169992;140910;79;310902
53;2020-08-23;0;0;0;118117;69883;89;188000
53;2020-08-23;0;0;0;37370;12267;90;49637
53;2020-08-23;7;14;23;1718886;1621493;0;3340379
75;2020-08-23;1;2;3;293104;305291;09;598395
75;2020-08-23;17;7;24;337141;357785;19;694926
75;2020-08-23;27;28;55;295024;300618;29;595642
75;2020-08-23;12;19;31;347871;331233;39;679104
75;2020-08-23;5;6;11;384742;372771;49;757513
75;2020-08-23;7;7;14;413361;390880;59;804241
75;2020-08-23;2;3;5;425623;384060;69;809683
75;2020-08-23;0;0;0;325086;276298;79;601384
75;2020-08-23;0;0;0;213986;139308;89;353294
75;2020-08-23;0;0;0;77600;28200;90;105800
75;2020-08-23;71;72;143;3113538;2886444;0;5999982
76;2020-08-23;0;2;2;305956;318589;09;624545
76;2020-08-23;3;2;5;338942;356969;19;695911
76;2020-08-23;10;25;35;316210;319570;29;635780
76;2020-08-23;8;11;19;356758;337587;39;694345
76;2020-08-23;4;5;9;376541;363812;49;740353
76;2020-08-23;2;3;5;402608;383750;59;786358
76;2020-08-23;6;7;13;394889;358997;69;753886
76;2020-08-23;4;6;10;308664;263806;79;572470
76;2020-08-23;3;0;3;195838;129272;89;325110
76;2020-08-23;1;1;2;69372;26728;90;96100
76;2020-08-23;41;62;103;3065778;2859080;0;5924858
84;2020-08-23;2;1;3;459549;481088;09;940637
84;2020-08-23;5;2;7;487711;511905;19;999616
84;2020-08-23;13;16;29;443824;451094;29;894918
84;2020-08-23;6;3;9;512522;493262;39;1005784
84;2020-08-23;3;5;8;520248;515106;49;1035354
84;2020-08-23;2;5;7;529611;514848;59;1044459
84;2020-08-23;1;1;2;486720;439940;69;926660
84;2020-08-23;3;1;4;372151;315211;79;687362
84;2020-08-23;1;0;1;237198;150524;89;387722
84;2020-08-23;0;1;1;81185;28680;90;109865
84;2020-08-23;36;35;71;4130719;3901658;0;8032377
93;2020-08-23;1;2;3;268834;283093;09;551927
93;2020-08-23;2;3;5;280751;296087;19;576838
93;2020-08-23;20;8;28;254404;255552;29;509956
93;2020-08-23;11;9;20;310704;288398;39;599102
93;2020-08-23;4;9;13;325559;305827;49;631386
93;2020-08-23;4;4;8;353104;325389;59;678493
93;2020-08-23;3;7;10;336327;296459;69;632786
93;2020-08-23;0;3;3;279820;229699;79;509519
93;2020-08-23;1;1;2;171274;113716;89;284990
93;2020-08-23;4;0;4;58896;21758;90;80654
93;2020-08-23;50;46;96;2639673;2415978;0;5055651
94;2020-08-23;0;0;0;16311;17433;09;33744
94;2020-08-23;0;0;0;16679;18132;19;34811
94;2020-08-23;0;0;0;16782;16579;29;33361
94;2020-08-23;0;0;0;23044;20580;39;43624
94;2020-08-23;0;0;0;23065;22140;49;45205
94;2020-08-23;0;0;0;24549;23421;59;47970
94;2020-08-23;0;0;0;23212;21883;69;45095
94;2020-08-23;0;0;0;19544;17141;79;36685
94;2020-08-23;0;0;0;11227;8178;89;19405
94;2020-08-23;0;0;0;3332;1447;90;4779
94;2020-08-23;0;0;0;177745;166934;0;344679
01;2020-08-24;0;1;1;19979;20155;09;40134
01;2020-08-24;5;4;9;24994;25489;19;50483
01;2020-08-24;19;15;34;17868;16690;29;34558
01;2020-08-24;16;21;37;22328;14821;39;37149
01;2020-08-24;14;11;25;28652;20276;49;48928
01;2020-08-24;10;16;26;33264;27260;59;60524
01;2020-08-24;6;6;12;27135;23978;69;51113
01;2020-08-24;3;3;6;18401;14661;79;33062
01;2020-08-24;2;0;2;9633;6375;89;16008
01;2020-08-24;0;0;0;3410;1510;90;4920
01;2020-08-24;75;77;152;205664;171215;0;376879
02;2020-08-24;1;0;1;16881;17110;09;33991
02;2020-08-24;0;1;1;21410;21604;19;43014
02;2020-08-24;3;4;7;16017;15479;29;31496
02;2020-08-24;1;1;3;19825;14455;39;34280
02;2020-08-24;0;2;2;24719;18248;49;42967
02;2020-08-24;4;1;5;34361;28310;59;62671
02;2020-08-24;1;1;2;28061;24495;69;52556
02;2020-08-24;0;0;1;18231;15278;79;33509
02;2020-08-24;1;1;3;11090;7677;89;18767
02;2020-08-24;0;0;0;3992;1506;90;5498
02;2020-08-24;11;11;25;194587;164162;0;358749
03;2020-08-24;0;1;1;31123;30920;09;62043
03;2020-08-24;5;5;10;29370;29268;19;58638
03;2020-08-24;2;7;9;21458;18963;29;40421
03;2020-08-24;1;0;1;21276;18326;39;39602
03;2020-08-24;3;0;3;18164;16593;49;34757
03;2020-08-24;1;4;5;13469;13557;59;27026
03;2020-08-24;1;1;2;8776;8670;69;17446
03;2020-08-24;0;1;1;3777;3591;79;7368
03;2020-08-24;0;1;1;1649;1072;89;2721
03;2020-08-24;0;0;0;485;184;90;669
03;2020-08-24;13;20;33;149547;141144;0;290691
04;2020-08-24;5;1;6;60314;61377;09;121691
04;2020-08-24;8;5;13;66065;68387;19;134452
04;2020-08-24;17;1;18;51059;47156;29;98215
04;2020-08-24;9;2;11;58788;45780;39;104568
04;2020-08-24;11;6;17;61408;52207;49;113615
04;2020-08-24;4;4;8;64838;60759;59;125597
04;2020-08-24;4;4;8;47008;42843;69;89851
04;2020-08-24;3;2;5;25509;21184;79;46693
04;2020-08-24;0;0;0;13168;7647;89;20815
04;2020-08-24;0;0;0;3209;1253;90;4462
04;2020-08-24;61;25;86;451366;408593;0;859959
05;2020-08-24;0;0;0;362.366008612902;341.338819562748;09;703.704828175651
05;2020-08-24;0;0;0;353.376145114279;370.349735405642;19;723.725880519921
05;2020-08-24;0;0;0;218.593559489256;256.539602589476;29;475.133162078732
05;2020-08-24;0;0;0;404.225408693299;360.321910454353;39;764.547319147651
05;2020-08-24;0;0;0;520.067953604221;497.108383964256;49;1017.17633756848
05;2020-08-24;0;0;0;468.146063921917;510.087601910415;59;978.233665832332
05;2020-08-24;0;0;0;340.368470050554;334.366842191253;69;674.735312241807
05;2020-08-24;0;0;0;212.598666888387;192.597753227106;79;405.196420115493
05;2020-08-24;0;0;0;148.727797095705;61.8681715431829;89;210.595968638888
05;2020-08-24;0;0;0;32.9601271090696;10.9909785719784;90;43.9511056810479
05;2020-08-24;0;0;0;3061.43020057959;2935.56979942041;0;5997
06;2020-08-24;0;1;1;42583;42380;09;84963
06;2020-08-24;1;1;2;33369;31925;19;65294
06;2020-08-24;0;2;2;21571;15080;29;36651
06;2020-08-24;0;2;2;21550;16147;39;37697
06;2020-08-24;4;1;5;14193;13939;49;28132
06;2020-08-24;2;1;3;7171;7597;59;14768
06;2020-08-24;0;0;0;3629;4117;69;7746
06;2020-08-24;0;0;0;1577;1457;79;3034
06;2020-08-24;0;0;0;531;474;89;1005
06;2020-08-24;0;0;0;88;93;90;181
06;2020-08-24;7;8;15;146262;133209;0;279471
07;2020-08-24;0;0;0;485;549;09;1034
07;2020-08-24;0;0;0;403;432;19;835
07;2020-08-24;0;0;0;764;841;29;1605
07;2020-08-24;1;2;3;824;928;39;1752
07;2020-08-24;0;0;0;788;1020;49;1808
07;2020-08-24;0;0;0;678;870;59;1548
07;2020-08-24;0;0;0;360;382;69;742
07;2020-08-24;0;0;0;231;190;79;421
07;2020-08-24;0;0;0;114;67;89;181
07;2020-08-24;0;0;0;24;11;90;35
07;2020-08-24;1;2;3;4671;5290;0;9961
08;2020-08-24;0;0;0;2715.22592983026;2997.75551488675;09;5712.98144471701
08;2020-08-24;0;0;0;2778.51901080978;3160.9156459093;19;5939.43465671908
08;2020-08-24;0;0;0;2080.8882988764;1718.16634315323;29;3799.05464202964
08;2020-08-24;2;0;2;2701.8582062647;1896.52641413317;39;4598.38462039786
08;2020-08-24;1;1;2;3151.45861023308;2460.52498233809;49;5611.98359257117
08;2020-08-24;1;0;1;2620.29868333099;2422.23566154656;59;5042.53434487755
08;2020-08-24;0;0;0;1621.44173420671;1438.58325779464;69;3060.02499200135
08;2020-08-24;1;1;2;626.575909335673;526.358467843651;79;1152.93437717932
08;2020-08-24;0;0;0;205.018522985054;140.993639349697;89;346.012162334751
08;2020-08-24;0;0;0;50.0325684687745;20.62259870351;90;70.6551671722846
08;2020-08-24;5;2;7;18551.3174743414;16782.6825256586;0;35334
11;2020-08-24;26;18;45;783071;811785;09;1594856
11;2020-08-24;106;87;194;761456;784653;19;1546109
11;2020-08-24;412;404;817;850145;801772;29;1651917
11;2020-08-24;213;240;453;914360;843488;39;1757848
11;2020-08-24;122;137;259;845609;826202;49;1671811
11;2020-08-24;97;101;198;793566;745070;59;1538636
11;2020-08-24;55;68;123;628649;549192;69;1177841
11;2020-08-24;24;32;56;434606;358356;79;792962
11;2020-08-24;9;7;16;261425;162933;89;424358
11;2020-08-24;4;2;6;89253;32619;90;121872
11;2020-08-24;1069;1096;2169;6362140;5916070;0;12278210
24;2020-08-24;1;4;5;139720;144686;09;284406
24;2020-08-24;18;8;26;152979;161185;19;314164
24;2020-08-24;30;33;63;122237;126536;29;248773
24;2020-08-24;13;8;21;150359;142009;39;292368
24;2020-08-24;5;6;11;161829;158758;49;320587
24;2020-08-24;10;9;19;172552;168011;59;340563
24;2020-08-24;2;4;6;172509;158177;69;330686
24;2020-08-24;4;3;7;129428;110593;79;240021
24;2020-08-24;2;2;4;87342;56882;89;144224
24;2020-08-24;2;1;3;31210;12071;90;43281
24;2020-08-24;87;78;165;1320165;1238908;0;2559073
27;2020-08-24;0;2;2;143373;149679;09;293052
27;2020-08-24;14;6;20;160962;173003;19;333965
27;2020-08-24;27;23;50;133746;142254;29;276000
27;2020-08-24;10;9;19;160004;155407;39;315411
27;2020-08-24;9;13;22;172333;169564;49;341897
27;2020-08-24;7;6;13;189979;183788;59;373767
27;2020-08-24;4;2;6;192591;178206;69;370797
27;2020-08-24;3;1;4;146876;127546;79;274422
27;2020-08-24;5;6;11;96896;61575;89;158471
27;2020-08-24;0;0;0;33148;12109;90;45257
27;2020-08-24;79;68;147;1429908;1353131;0;2783039
28;2020-08-24;4;1;5;180735;186856;09;367591
28;2020-08-24;6;8;14;200125;213621;19;413746
28;2020-08-24;20;25;46;168922;173007;29;341929
28;2020-08-24;7;12;19;196628;188487;39;385115
28;2020-08-24;5;5;10;205396;201699;49;407095
28;2020-08-24;6;6;12;222002;213866;59;435868
28;2020-08-24;3;2;5;224688;203758;69;428446
28;2020-08-24;1;1;2;163192;135543;79;298735
28;2020-08-24;1;0;1;109691;65377;89;175068
28;2020-08-24;3;0;3;37222;12685;90;49907
28;2020-08-24;56;60;117;1708601;1594899;0;3303500
32;2020-08-24;4;6;10;358062;373689;09;731751
32;2020-08-24;19;26;45;387045;406742;19;793787
32;2020-08-24;34;37;71;342304;348587;29;690891
32;2020-08-24;28;22;50;382485;369972;39;752457
32;2020-08-24;23;26;49;382510;376716;49;759226
32;2020-08-24;11;16;27;386937;376527;59;763464
32;2020-08-24;8;6;14;371211;330938;69;702149
32;2020-08-24;4;4;8;250542;201459;79;452001
32;2020-08-24;2;4;6;163399;89786;89;253185
32;2020-08-24;0;0;0;48384;15367;90;63751
32;2020-08-24;133;147;280;3072879;2889783;0;5962662
44;2020-08-24;4;5;9;291525;306839;09;598364
44;2020-08-24;21;24;45;320255;339504;19;659759
44;2020-08-24;32;43;75;302020;314428;29;616448
44;2020-08-24;23;22;45;342222;333292;39;675514
44;2020-08-24;24;23;47;349727;344491;49;694218
44;2020-08-24;5;20;25;381371;373239;59;754610
44;2020-08-24;7;11;18;367165;335850;69;703015
44;2020-08-24;4;6;10;250387;215436;79;465823
44;2020-08-24;3;1;4;170825;105192;89;276017
44;2020-08-24;4;0;4;51248;16731;90;67979
44;2020-08-24;127;155;282;2826745;2685002;0;5511747
52;2020-08-24;2;4;8;213594;223900;09;437494
52;2020-08-24;15;14;29;240818;255197;19;496015
52;2020-08-24;24;31;55;197010;200630;29;397640
52;2020-08-24;13;13;26;231204;224885;39;456089
52;2020-08-24;8;15;23;243874;243418;49;487292
52;2020-08-24;10;15;25;244100;239116;59;483216
52;2020-08-24;3;3;6;241796;221345;69;463141
52;2020-08-24;2;4;6;177805;149903;79;327708
52;2020-08-24;1;0;1;119561;75822;89;195383
52;2020-08-24;0;1;1;42559;15260;90;57819
52;2020-08-24;78;100;180;1952321;1849476;0;3801797
53;2020-08-24;6;4;10;173813;182358;09;356171
53;2020-08-24;5;7;12;202720;214740;19;417460
53;2020-08-24;18;27;45;163116;173196;29;336312
53;2020-08-24;11;9;20;190526;187674;39;378200
53;2020-08-24;7;7;14;212098;212015;49;424113
53;2020-08-24;3;9;12;223699;219176;59;442875
53;2020-08-24;1;2;3;227435;209274;69;436709
53;2020-08-24;1;0;1;169992;140910;79;310902
53;2020-08-24;2;0;2;118117;69883;89;188000
53;2020-08-24;0;0;0;37370;12267;90;49637
53;2020-08-24;54;65;119;1718886;1621493;0;3340379
75;2020-08-24;8;2;10;293104;305291;09;598395
75;2020-08-24;42;27;70;337141;357785;19;694926
75;2020-08-24;90;88;178;295024;300618;29;595642
75;2020-08-24;27;34;61;347871;331233;39;679104
75;2020-08-24;24;24;48;384742;372771;49;757513
75;2020-08-24;20;25;45;413361;390880;59;804241
75;2020-08-24;5;16;21;425623;384060;69;809683
75;2020-08-24;8;8;16;325086;276298;79;601384
75;2020-08-24;2;2;4;213986;139308;89;353294
75;2020-08-24;2;0;2;77600;28200;90;105800
75;2020-08-24;228;226;455;3113538;2886444;0;5999982
76;2020-08-24;7;8;16;305956;318589;09;624545
76;2020-08-24;38;29;68;338942;356969;19;695911
76;2020-08-24;80;93;173;316210;319570;29;635780
76;2020-08-24;43;39;82;356758;337587;39;694345
76;2020-08-24;44;45;89;376541;363812;49;740353
76;2020-08-24;34;38;72;402608;383750;59;786358
76;2020-08-24;19;17;36;394889;358997;69;753886
76;2020-08-24;10;8;18;308664;263806;79;572470
76;2020-08-24;7;5;12;195838;129272;89;325110
76;2020-08-24;5;0;5;69372;26728;90;96100
76;2020-08-24;287;282;571;3065778;2859080;0;5924858
84;2020-08-24;17;11;29;459549;481088;09;940637
84;2020-08-24;34;40;74;487711;511905;19;999616
84;2020-08-24;116;134;250;443824;451094;29;894918
84;2020-08-24;52;55;107;512522;493262;39;1005784
84;2020-08-24;33;44;77;520248;515106;49;1035354
84;2020-08-24;24;41;65;529611;514848;59;1044459
84;2020-08-24;18;10;28;486720;439940;69;926660
84;2020-08-24;6;7;13;372151;315211;79;687362
84;2020-08-24;9;4;13;237198;150524;89;387722
84;2020-08-24;1;3;4;81185;28680;90;109865
84;2020-08-24;310;349;660;4130719;3901658;0;8032377
93;2020-08-24;16;17;33;268834;283093;09;551927
93;2020-08-24;68;64;132;280751;296087;19;576838
93;2020-08-24;221;187;408;254404;255552;29;509956
93;2020-08-24;120;118;238;310704;288398;39;599102
93;2020-08-24;107;93;201;325559;305827;49;631386
93;2020-08-24;100;85;186;353104;325389;59;678493
93;2020-08-24;55;39;94;336327;296459;69;632786
93;2020-08-24;34;27;61;279820;229699;79;509519
93;2020-08-24;13;17;30;171274;113716;89;284990
93;2020-08-24;3;0;3;58896;21758;90;80654
93;2020-08-24;738;647;1387;2639673;2415978;0;5055651
94;2020-08-24;0;4;4;16311;17433;09;33744
94;2020-08-24;0;1;1;16679;18132;19;34811
94;2020-08-24;4;5;9;16782;16579;29;33361
94;2020-08-24;4;5;9;23044;20580;39;43624
94;2020-08-24;1;2;3;23065;22140;49;45205
94;2020-08-24;0;4;4;24549;23421;59;47970
94;2020-08-24;1;0;1;23212;21883;69;45095
94;2020-08-24;1;0;1;19544;17141;79;36685
94;2020-08-24;0;0;0;11227;8178;89;19405
94;2020-08-24;0;0;0;3332;1447;90;4779
94;2020-08-24;11;21;32;177745;166934;0;344679
01;2020-08-25;2;0;2;19979;20155;09;40134
01;2020-08-25;5;4;9;24994;25489;19;50483
01;2020-08-25;13;16;29;17868;16690;29;34558
01;2020-08-25;12;11;23;22328;14821;39;37149
01;2020-08-25;17;10;27;28652;20276;49;48928
01;2020-08-25;16;15;31;33264;27260;59;60524
01;2020-08-25;8;8;16;27135;23978;69;51113
01;2020-08-25;3;3;6;18401;14661;79;33062
01;2020-08-25;1;0;1;9633;6375;89;16008
01;2020-08-25;0;0;0;3410;1510;90;4920
01;2020-08-25;77;67;144;205664;171215;0;376879
02;2020-08-25;0;1;1;16881;17110;09;33991
02;2020-08-25;2;0;2;21410;21604;19;43014
02;2020-08-25;5;3;8;16017;15479;29;31496
02;2020-08-25;3;1;4;19825;14455;39;34280
02;2020-08-25;2;1;3;24719;18248;49;42967
02;2020-08-25;2;0;2;34361;28310;59;62671
02;2020-08-25;3;0;3;28061;24495;69;52556
02;2020-08-25;0;0;0;18231;15278;79;33509
02;2020-08-25;0;1;1;11090;7677;89;18767
02;2020-08-25;0;0;0;3992;1506;90;5498
02;2020-08-25;17;7;24;194587;164162;0;358749
03;2020-08-25;0;0;0;31123;30920;09;62043
03;2020-08-25;2;2;4;29370;29268;19;58638
03;2020-08-25;5;1;6;21458;18963;29;40421
03;2020-08-25;5;2;7;21276;18326;39;39602
03;2020-08-25;4;1;5;18164;16593;49;34757
03;2020-08-25;2;2;4;13469;13557;59;27026
03;2020-08-25;2;2;4;8776;8670;69;17446
03;2020-08-25;1;0;1;3777;3591;79;7368
03;2020-08-25;0;0;0;1649;1072;89;2721
03;2020-08-25;0;0;0;485;184;90;669
03;2020-08-25;21;10;31;149547;141144;0;290691
04;2020-08-25;5;1;6;60314;61377;09;121691
04;2020-08-25;9;6;15;66065;68387;19;134452
04;2020-08-25;8;4;12;51059;47156;29;98215
04;2020-08-25;10;7;17;58788;45780;39;104568
04;2020-08-25;0;4;4;61408;52207;49;113615
04;2020-08-25;4;3;7;64838;60759;59;125597
04;2020-08-25;5;3;8;47008;42843;69;89851
04;2020-08-25;0;2;2;25509;21184;79;46693
04;2020-08-25;2;0;2;13168;7647;89;20815
04;2020-08-25;0;0;0;3209;1253;90;4462
04;2020-08-25;43;30;73;451366;408593;0;859959
05;2020-08-25;0;0;0;362.366008612902;341.338819562748;09;703.704828175651
05;2020-08-25;0;0;0;353.376145114279;370.349735405642;19;723.725880519921
05;2020-08-25;0;0;0;218.593559489256;256.539602589476;29;475.133162078732
05;2020-08-25;0;1;1;404.225408693299;360.321910454353;39;764.547319147651
05;2020-08-25;0;0;0;520.067953604221;497.108383964256;49;1017.17633756848
05;2020-08-25;0;0;0;468.146063921917;510.087601910415;59;978.233665832332
05;2020-08-25;0;0;0;340.368470050554;334.366842191253;69;674.735312241807
05;2020-08-25;0;0;0;212.598666888387;192.597753227106;79;405.196420115493
05;2020-08-25;0;0;0;148.727797095705;61.8681715431829;89;210.595968638888
05;2020-08-25;0;0;0;32.9601271090696;10.9909785719784;90;43.9511056810479
05;2020-08-25;0;1;1;3061.43020057959;2935.56979942041;0;5997
06;2020-08-25;0;0;0;42583;42380;09;84963
06;2020-08-25;2;1;3;33369;31925;19;65294
06;2020-08-25;2;3;5;21571;15080;29;36651
06;2020-08-25;2;2;4;21550;16147;39;37697
06;2020-08-25;0;0;0;14193;13939;49;28132
06;2020-08-25;0;1;1;7171;7597;59;14768
06;2020-08-25;1;0;1;3629;4117;69;7746
06;2020-08-25;0;0;0;1577;1457;79;3034
06;2020-08-25;0;0;0;531;474;89;1005
06;2020-08-25;1;0;1;88;93;90;181
06;2020-08-25;8;7;15;146262;133209;0;279471
07;2020-08-25;0;0;0;485;549;09;1034
07;2020-08-25;0;0;0;403;432;19;835
07;2020-08-25;0;0;0;764;841;29;1605
07;2020-08-25;0;0;0;824;928;39;1752
07;2020-08-25;0;0;0;788;1020;49;1808
07;2020-08-25;0;0;0;678;870;59;1548
07;2020-08-25;0;0;0;360;382;69;742
07;2020-08-25;0;0;0;231;190;79;421
07;2020-08-25;0;0;0;114;67;89;181
07;2020-08-25;0;0;0;24;11;90;35
07;2020-08-25;0;0;0;4671;5290;0;9961
08;2020-08-25;0;0;0;2715.22592983026;2997.75551488675;09;5712.98144471701
08;2020-08-25;0;0;0;2778.51901080978;3160.9156459093;19;5939.43465671908
08;2020-08-25;0;0;0;2080.8882988764;1718.16634315323;29;3799.05464202964
08;2020-08-25;2;1;3;2701.8582062647;1896.52641413317;39;4598.38462039786
08;2020-08-25;0;0;0;3151.45861023308;2460.52498233809;49;5611.98359257117
08;2020-08-25;0;4;4;2620.29868333099;2422.23566154656;59;5042.53434487755
08;2020-08-25;1;1;2;1621.44173420671;1438.58325779464;69;3060.02499200135
08;2020-08-25;0;0;0;626.575909335673;526.358467843651;79;1152.93437717932
08;2020-08-25;0;0;0;205.018522985054;140.993639349697;89;346.012162334751
08;2020-08-25;0;0;0;50.0325684687745;20.62259870351;90;70.6551671722846
08;2020-08-25;3;6;9;18551.3174743414;16782.6825256586;0;35334
11;2020-08-25;28;30;58;783071;811785;09;1594856
11;2020-08-25;115;107;223;761456;784653;19;1546109
11;2020-08-25;415;425;840;850145;801772;29;1651917
11;2020-08-25;195;233;429;914360;843488;39;1757848
11;2020-08-25;118;112;230;845609;826202;49;1671811
11;2020-08-25;104;91;195;793566;745070;59;1538636
11;2020-08-25;61;57;118;628649;549192;69;1177841
11;2020-08-25;20;16;36;434606;358356;79;792962
11;2020-08-25;13;9;22;261425;162933;89;424358
11;2020-08-25;4;3;7;89253;32619;90;121872
11;2020-08-25;1074;1083;2162;6362140;5916070;0;12278210
24;2020-08-25;1;3;4;139720;144686;09;284406
24;2020-08-25;17;12;29;152979;161185;19;314164
24;2020-08-25;17;19;36;122237;126536;29;248773
24;2020-08-25;13;10;23;150359;142009;39;292368
24;2020-08-25;4;7;11;161829;158758;49;320587
24;2020-08-25;8;7;15;172552;168011;59;340563
24;2020-08-25;4;6;10;172509;158177;69;330686
24;2020-08-25;3;4;7;129428;110593;79;240021
24;2020-08-25;2;1;3;87342;56882;89;144224
24;2020-08-25;0;0;0;31210;12071;90;43281
24;2020-08-25;69;69;138;1320165;1238908;0;2559073
27;2020-08-25;3;2;5;143373;149679;09;293052
27;2020-08-25;11;8;19;160962;173003;19;333965
27;2020-08-25;20;22;42;133746;142254;29;276000
27;2020-08-25;8;5;13;160004;155407;39;315411
27;2020-08-25;12;12;24;172333;169564;49;341897
27;2020-08-25;12;5;17;189979;183788;59;373767
27;2020-08-25;1;3;4;192591;178206;69;370797
27;2020-08-25;1;0;1;146876;127546;79;274422
27;2020-08-25;1;1;2;96896;61575;89;158471
27;2020-08-25;0;1;1;33148;12109;90;45257
27;2020-08-25;70;60;130;1429908;1353131;0;2783039
28;2020-08-25;2;2;6;180735;186856;09;367591
28;2020-08-25;12;9;22;200125;213621;19;413746
28;2020-08-25;14;23;37;168922;173007;29;341929
28;2020-08-25;12;12;24;196628;188487;39;385115
28;2020-08-25;11;20;31;205396;201699;49;407095
28;2020-08-25;11;10;21;222002;213866;59;435868
28;2020-08-25;8;9;17;224688;203758;69;428446
28;2020-08-25;4;2;6;163192;135543;79;298735
28;2020-08-25;0;2;2;109691;65377;89;175068
28;2020-08-25;0;0;0;37222;12685;90;49907
28;2020-08-25;74;89;166;1708601;1594899;0;3303500
32;2020-08-25;3;1;5;358062;373689;09;731751
32;2020-08-25;15;26;42;387045;406742;19;793787
32;2020-08-25;40;39;81;342304;348587;29;690891
32;2020-08-25;23;21;45;382485;369972;39;752457
32;2020-08-25;16;27;43;382510;376716;49;759226
32;2020-08-25;15;10;26;386937;376527;59;763464
32;2020-08-25;8;8;16;371211;330938;69;702149
32;2020-08-25;3;7;10;250542;201459;79;452001
32;2020-08-25;3;2;5;163399;89786;89;253185
32;2020-08-25;0;0;0;48384;15367;90;63751
32;2020-08-25;126;141;273;3072879;2889783;0;5962662
44;2020-08-25;9;10;22;291525;306839;09;598364
44;2020-08-25;19;23;44;320255;339504;19;659759
44;2020-08-25;34;36;70;302020;314428;29;616448
44;2020-08-25;21;25;46;342222;333292;39;675514
44;2020-08-25;18;17;35;349727;344491;49;694218
44;2020-08-25;11;13;24;381371;373239;59;754610
44;2020-08-25;11;7;18;367165;335850;69;703015
44;2020-08-25;4;7;11;250387;215436;79;465823
44;2020-08-25;3;2;5;170825;105192;89;276017
44;2020-08-25;1;2;3;51248;16731;90;67979
44;2020-08-25;131;142;278;2826745;2685002;0;5511747
52;2020-08-25;3;2;5;213594;223900;09;437494
52;2020-08-25;10;13;23;240818;255197;19;496015
52;2020-08-25;29;30;59;197010;200630;29;397640
52;2020-08-25;10;19;29;231204;224885;39;456089
52;2020-08-25;12;12;24;243874;243418;49;487292
52;2020-08-25;12;7;19;244100;239116;59;483216
52;2020-08-25;4;5;9;241796;221345;69;463141
52;2020-08-25;4;3;7;177805;149903;79;327708
52;2020-08-25;2;2;4;119561;75822;89;195383
52;2020-08-25;0;0;0;42559;15260;90;57819
52;2020-08-25;86;93;179;1952321;1849476;0;3801797
53;2020-08-25;1;2;3;173813;182358;09;356171
53;2020-08-25;10;12;22;202720;214740;19;417460
53;2020-08-25;21;24;45;163116;173196;29;336312
53;2020-08-25;6;9;15;190526;187674;39;378200
53;2020-08-25;5;3;8;212098;212015;49;424113
53;2020-08-25;5;1;6;223699;219176;59;442875
53;2020-08-25;5;5;10;227435;209274;69;436709
53;2020-08-25;4;4;8;169992;140910;79;310902
53;2020-08-25;3;2;5;118117;69883;89;188000
53;2020-08-25;1;0;1;37370;12267;90;49637
53;2020-08-25;61;62;123;1718886;1621493;0;3340379
75;2020-08-25;10;8;18;293104;305291;09;598395
75;2020-08-25;33;34;68;337141;357785;19;694926
75;2020-08-25;87;111;199;295024;300618;29;595642
75;2020-08-25;36;41;77;347871;331233;39;679104
75;2020-08-25;29;22;51;384742;372771;49;757513
75;2020-08-25;20;19;39;413361;390880;59;804241
75;2020-08-25;15;11;26;425623;384060;69;809683
75;2020-08-25;8;7;15;325086;276298;79;601384
75;2020-08-25;6;0;6;213986;139308;89;353294
75;2020-08-25;0;1;1;77600;28200;90;105800
75;2020-08-25;244;256;502;3113538;2886444;0;5999982
76;2020-08-25;4;8;12;305956;318589;09;624545
76;2020-08-25;40;35;75;338942;356969;19;695911
76;2020-08-25;85;89;174;316210;319570;29;635780
76;2020-08-25;44;45;89;356758;337587;39;694345
76;2020-08-25;45;41;86;376541;363812;49;740353
76;2020-08-25;38;46;84;402608;383750;59;786358
76;2020-08-25;15;23;38;394889;358997;69;753886
76;2020-08-25;17;11;28;308664;263806;79;572470
76;2020-08-25;2;3;5;195838;129272;89;325110
76;2020-08-25;1;1;2;69372;26728;90;96100
76;2020-08-25;292;302;594;3065778;2859080;0;5924858
84;2020-08-25;6;9;15;459549;481088;09;940637
84;2020-08-25;37;53;90;487711;511905;19;999616
84;2020-08-25;115;121;236;443824;451094;29;894918
84;2020-08-25;49;48;97;512522;493262;39;1005784
84;2020-08-25;32;41;73;520248;515106;49;1035354
84;2020-08-25;30;40;70;529611;514848;59;1044459
84;2020-08-25;13;9;22;486720;439940;69;926660
84;2020-08-25;9;10;19;372151;315211;79;687362
84;2020-08-25;2;5;7;237198;150524;89;387722
84;2020-08-25;5;1;6;81185;28680;90;109865
84;2020-08-25;298;337;635;4130719;3901658;0;8032377
93;2020-08-25;10;18;28;268834;283093;09;551927
93;2020-08-25;68;72;141;280751;296087;19;576838
93;2020-08-25;186;178;364;254404;255552;29;509956
93;2020-08-25;100;120;220;310704;288398;39;599102
93;2020-08-25;77;78;155;325559;305827;49;631386
93;2020-08-25;76;57;133;353104;325389;59;678493
93;2020-08-25;50;46;96;336327;296459;69;632786
93;2020-08-25;16;24;40;279820;229699;79;509519
93;2020-08-25;16;11;27;171274;113716;89;284990
93;2020-08-25;8;2;10;58896;21758;90;80654
93;2020-08-25;608;606;1215;2639673;2415978;0;5055651
94;2020-08-25;0;0;0;16311;17433;09;33744
94;2020-08-25;0;1;1;16679;18132;19;34811
94;2020-08-25;6;2;8;16782;16579;29;33361
94;2020-08-25;2;2;4;23044;20580;39;43624
94;2020-08-25;1;4;5;23065;22140;49;45205
94;2020-08-25;1;1;2;24549;23421;59;47970
94;2020-08-25;1;1;2;23212;21883;69;45095
94;2020-08-25;0;0;0;19544;17141;79;36685
94;2020-08-25;0;0;0;11227;8178;89;19405
94;2020-08-25;0;0;0;3332;1447;90;4779
94;2020-08-25;11;11;22;177745;166934;0;344679
01;2020-08-26;1;2;3;19979;20155;09;40134
01;2020-08-26;4;0;4;24994;25489;19;50483
01;2020-08-26;14;17;31;17868;16690;29;34558
01;2020-08-26;19;15;34;22328;14821;39;37149
01;2020-08-26;20;13;33;28652;20276;49;48928
01;2020-08-26;11;5;16;33264;27260;59;60524
01;2020-08-26;6;4;10;27135;23978;69;51113
01;2020-08-26;2;1;3;18401;14661;79;33062
01;2020-08-26;1;0;1;9633;6375;89;16008
01;2020-08-26;0;0;0;3410;1510;90;4920
01;2020-08-26;78;57;135;205664;171215;0;376879
02;2020-08-26;0;0;0;16881;17110;09;33991
02;2020-08-26;1;0;1;21410;21604;19;43014
02;2020-08-26;6;2;8;16017;15479;29;31496
02;2020-08-26;2;1;3;19825;14455;39;34280
02;2020-08-26;1;4;5;24719;18248;49;42967
02;2020-08-26;3;6;9;34361;28310;59;62671
02;2020-08-26;0;1;1;28061;24495;69;52556
02;2020-08-26;1;0;1;18231;15278;79;33509
02;2020-08-26;1;0;2;11090;7677;89;18767
02;2020-08-26;0;0;0;3992;1506;90;5498
02;2020-08-26;15;14;30;194587;164162;0;358749
03;2020-08-26;1;1;2;31123;30920;09;62043
03;2020-08-26;2;6;8;29370;29268;19;58638
03;2020-08-26;6;5;11;21458;18963;29;40421
03;2020-08-26;9;3;12;21276;18326;39;39602
03;2020-08-26;2;3;5;18164;16593;49;34757
03;2020-08-26;2;2;4;13469;13557;59;27026
03;2020-08-26;0;3;3;8776;8670;69;17446
03;2020-08-26;0;1;1;3777;3591;79;7368
03;2020-08-26;0;1;1;1649;1072;89;2721
03;2020-08-26;0;0;0;485;184;90;669
03;2020-08-26;22;25;47;149547;141144;0;290691
04;2020-08-26;5;7;12;60314;61377;09;121691
04;2020-08-26;5;10;15;66065;68387;19;134452
04;2020-08-26;7;7;14;51059;47156;29;98215
04;2020-08-26;4;2;6;58788;45780;39;104568
04;2020-08-26;3;3;6;61408;52207;49;113615
04;2020-08-26;3;7;10;64838;60759;59;125597
04;2020-08-26;2;6;8;47008;42843;69;89851
04;2020-08-26;2;1;3;25509;21184;79;46693
04;2020-08-26;0;0;0;13168;7647;89;20815
04;2020-08-26;0;0;0;3209;1253;90;4462
04;2020-08-26;31;43;74;451366;408593;0;859959
05;2020-08-26;0;0;0;362.366008612902;341.338819562748;09;703.704828175651
05;2020-08-26;0;0;0;353.376145114279;370.349735405642;19;723.725880519921
05;2020-08-26;0;0;0;218.593559489256;256.539602589476;29;475.133162078732
05;2020-08-26;0;0;0;404.225408693299;360.321910454353;39;764.547319147651
05;2020-08-26;0;0;0;520.067953604221;497.108383964256;49;1017.17633756848
05;2020-08-26;0;0;0;468.146063921917;510.087601910415;59;978.233665832332
05;2020-08-26;0;0;0;340.368470050554;334.366842191253;69;674.735312241807
05;2020-08-26;0;0;0;212.598666888387;192.597753227106;79;405.196420115493
05;2020-08-26;0;0;0;148.727797095705;61.8681715431829;89;210.595968638888
05;2020-08-26;0;0;0;32.9601271090696;10.9909785719784;90;43.9511056810479
05;2020-08-26;0;0;0;3061.43020057959;2935.56979942041;0;5997
06;2020-08-26;0;0;0;42583;42380;09;84963
06;2020-08-26;0;1;1;33369;31925;19;65294
06;2020-08-26;2;3;5;21571;15080;29;36651
06;2020-08-26;0;1;1;21550;16147;39;37697
06;2020-08-26;2;1;3;14193;13939;49;28132
06;2020-08-26;2;0;2;7171;7597;59;14768
06;2020-08-26;0;0;0;3629;4117;69;7746
06;2020-08-26;0;0;0;1577;1457;79;3034
06;2020-08-26;0;0;0;531;474;89;1005
06;2020-08-26;0;0;0;88;93;90;181
06;2020-08-26;6;6;12;146262;133209;0;279471
07;2020-08-26;0;0;0;485;549;09;1034
07;2020-08-26;0;0;0;403;432;19;835
07;2020-08-26;0;0;0;764;841;29;1605
07;2020-08-26;0;0;0;824;928;39;1752
07;2020-08-26;0;0;0;788;1020;49;1808
07;2020-08-26;0;0;0;678;870;59;1548
07;2020-08-26;0;0;0;360;382;69;742
07;2020-08-26;0;0;0;231;190;79;421
07;2020-08-26;0;0;0;114;67;89;181
07;2020-08-26;0;0;0;24;11;90;35
07;2020-08-26;0;0;0;4671;5290;0;9961
08;2020-08-26;0;0;0;2715.22592983026;2997.75551488675;09;5712.98144471701
08;2020-08-26;0;0;0;2778.51901080978;3160.9156459093;19;5939.43465671908
08;2020-08-26;1;1;2;2080.8882988764;1718.16634315323;29;3799.05464202964
08;2020-08-26;1;0;1;2701.8582062647;1896.52641413317;39;4598.38462039786
08;2020-08-26;0;0;0;3151.45861023308;2460.52498233809;49;5611.98359257117
08;2020-08-26;0;0;0;2620.29868333099;2422.23566154656;59;5042.53434487755
08;2020-08-26;1;1;2;1621.44173420671;1438.58325779464;69;3060.02499200135
08;2020-08-26;0;0;0;626.575909335673;526.358467843651;79;1152.93437717932
08;2020-08-26;0;0;0;205.018522985054;140.993639349697;89;346.012162334751
08;2020-08-26;0;0;0;50.0325684687745;20.62259870351;90;70.6551671722846
08;2020-08-26;3;2;5;18551.3174743414;16782.6825256586;0;35334
11;2020-08-26;21;25;48;783071;811785;09;1594856
11;2020-08-26;114;89;208;761456;784653;19;1546109
11;2020-08-26;459;421;883;850145;801772;29;1651917
11;2020-08-26;198;238;440;914360;843488;39;1757848
11;2020-08-26;119;114;234;845609;826202;49;1671811
11;2020-08-26;97;76;176;793566;745070;59;1538636
11;2020-08-26;71;54;125;628649;549192;69;1177841
11;2020-08-26;20;18;38;434606;358356;79;792962
11;2020-08-26;15;6;21;261425;162933;89;424358
11;2020-08-26;8;1;9;89253;32619;90;121872
11;2020-08-26;1122;1043;2187;6362140;5916070;0;12278210
24;2020-08-26;4;3;7;139720;144686;09;284406
24;2020-08-26;6;16;22;152979;161185;19;314164
24;2020-08-26;21;30;52;122237;126536;29;248773
24;2020-08-26;6;15;21;150359;142009;39;292368
24;2020-08-26;13;5;18;161829;158758;49;320587
24;2020-08-26;7;5;12;172552;168011;59;340563
24;2020-08-26;4;2;6;172509;158177;69;330686
24;2020-08-26;2;4;6;129428;110593;79;240021
24;2020-08-26;1;0;1;87342;56882;89;144224
24;2020-08-26;1;0;1;31210;12071;90;43281
24;2020-08-26;66;80;147;1320165;1238908;0;2559073
27;2020-08-26;3;2;5;143373;149679;09;293052
27;2020-08-26;13;6;19;160962;173003;19;333965
27;2020-08-26;24;20;44;133746;142254;29;276000
27;2020-08-26;13;9;22;160004;155407;39;315411
27;2020-08-26;8;11;19;172333;169564;49;341897
27;2020-08-26;4;5;9;189979;183788;59;373767
27;2020-08-26;5;8;13;192591;178206;69;370797
27;2020-08-26;5;4;9;146876;127546;79;274422
27;2020-08-26;2;3;5;96896;61575;89;158471
27;2020-08-26;1;0;1;33148;12109;90;45257
27;2020-08-26;78;68;146;1429908;1353131;0;2783039
28;2020-08-26;7;3;10;180735;186856;09;367591
28;2020-08-26;9;10;19;200125;213621;19;413746
28;2020-08-26;30;23;53;168922;173007;29;341929
28;2020-08-26;12;13;25;196628;188487;39;385115
28;2020-08-26;8;8;16;205396;201699;49;407095
28;2020-08-26;8;8;16;222002;213866;59;435868
28;2020-08-26;2;1;3;224688;203758;69;428446
28;2020-08-26;3;3;6;163192;135543;79;298735
28;2020-08-26;3;1;4;109691;65377;89;175068
28;2020-08-26;2;1;3;37222;12685;90;49907
28;2020-08-26;84;71;155;1708601;1594899;0;3303500
32;2020-08-26;9;9;18;358062;373689;09;731751
32;2020-08-26;18;21;39;387045;406742;19;793787
32;2020-08-26;34;38;72;342304;348587;29;690891
32;2020-08-26;15;25;40;382485;369972;39;752457
32;2020-08-26;22;18;41;382510;376716;49;759226
32;2020-08-26;17;13;30;386937;376527;59;763464
32;2020-08-26;10;15;25;371211;330938;69;702149
32;2020-08-26;9;1;10;250542;201459;79;452001
32;2020-08-26;0;3;3;163399;89786;89;253185
32;2020-08-26;1;0;1;48384;15367;90;63751
32;2020-08-26;135;143;279;3072879;2889783;0;5962662
44;2020-08-26;4;4;8;291525;306839;09;598364
44;2020-08-26;16;18;34;320255;339504;19;659759
44;2020-08-26;28;33;61;302020;314428;29;616448
44;2020-08-26;33;23;56;342222;333292;39;675514
44;2020-08-26;9;21;30;349727;344491;49;694218
44;2020-08-26;18;11;29;381371;373239;59;754610
44;2020-08-26;8;6;14;367165;335850;69;703015
44;2020-08-26;3;4;7;250387;215436;79;465823
44;2020-08-26;3;5;8;170825;105192;89;276017
44;2020-08-26;4;0;4;51248;16731;90;67979
44;2020-08-26;126;126;252;2826745;2685002;0;5511747
52;2020-08-26;2;3;5;213594;223900;09;437494
52;2020-08-26;8;14;22;240818;255197;19;496015
52;2020-08-26;21;21;42;197010;200630;29;397640
52;2020-08-26;13;14;27;231204;224885;39;456089
52;2020-08-26;13;6;19;243874;243418;49;487292
52;2020-08-26;14;12;26;244100;239116;59;483216
52;2020-08-26;4;6;10;241796;221345;69;463141
52;2020-08-26;3;1;4;177805;149903;79;327708
52;2020-08-26;1;0;1;119561;75822;89;195383
52;2020-08-26;0;0;0;42559;15260;90;57819
52;2020-08-26;79;77;156;1952321;1849476;0;3801797
53;2020-08-26;2;1;3;173813;182358;09;356171
53;2020-08-26;9;9;18;202720;214740;19;417460
53;2020-08-26;22;35;57;163116;173196;29;336312
53;2020-08-26;7;12;19;190526;187674;39;378200
53;2020-08-26;6;2;8;212098;212015;49;424113
53;2020-08-26;6;4;10;223699;219176;59;442875
53;2020-08-26;3;5;8;227435;209274;69;436709
53;2020-08-26;1;0;1;169992;140910;79;310902
53;2020-08-26;1;3;4;118117;69883;89;188000
53;2020-08-26;0;0;0;37370;12267;90;49637
53;2020-08-26;57;71;128;1718886;1621493;0;3340379
75;2020-08-26;7;4;11;293104;305291;09;598395
75;2020-08-26;52;42;95;337141;357785;19;694926
75;2020-08-26;88;102;190;295024;300618;29;595642
75;2020-08-26;37;47;84;347871;331233;39;679104
75;2020-08-26;25;32;57;384742;372771;49;757513
75;2020-08-26;26;22;48;413361;390880;59;804241
75;2020-08-26;10;11;21;425623;384060;69;809683
75;2020-08-26;5;5;10;325086;276298;79;601384
75;2020-08-26;3;2;5;213986;139308;89;353294
75;2020-08-26;0;1;1;77600;28200;90;105800
75;2020-08-26;253;269;523;3113538;2886444;0;5999982
76;2020-08-26;6;7;14;305956;318589;09;624545
76;2020-08-26;21;20;41;338942;356969;19;695911
76;2020-08-26;97;91;188;316210;319570;29;635780
76;2020-08-26;44;49;93;356758;337587;39;694345
76;2020-08-26;43;16;59;376541;363812;49;740353
76;2020-08-26;35;35;70;402608;383750;59;786358
76;2020-08-26;17;13;30;394889;358997;69;753886
76;2020-08-26;9;9;19;308664;263806;79;572470
76;2020-08-26;9;5;14;195838;129272;89;325110
76;2020-08-26;4;0;4;69372;26728;90;96100
76;2020-08-26;285;245;532;3065778;2859080;0;5924858
84;2020-08-26;8;8;16;459549;481088;09;940637
84;2020-08-26;32;34;66;487711;511905;19;999616
84;2020-08-26;104;129;233;443824;451094;29;894918
84;2020-08-26;59;69;129;512522;493262;39;1005784
84;2020-08-26;42;48;90;520248;515106;49;1035354
84;2020-08-26;29;39;68;529611;514848;59;1044459
84;2020-08-26;18;25;43;486720;439940;69;926660
84;2020-08-26;7;11;18;372151;315211;79;687362
84;2020-08-26;9;6;15;237198;150524;89;387722
84;2020-08-26;10;2;12;81185;28680;90;109865
84;2020-08-26;318;371;691;4130719;3901658;0;8032377
93;2020-08-26;15;16;31;268834;283093;09;551927
93;2020-08-26;65;43;108;280751;296087;19;576838
93;2020-08-26;156;162;318;254404;255552;29;509956
93;2020-08-26;85;95;181;310704;288398;39;599102
93;2020-08-26;71;61;132;325559;305827;49;631386
93;2020-08-26;63;42;105;353104;325389;59;678493
93;2020-08-26;45;39;84;336327;296459;69;632786
93;2020-08-26;21;15;36;279820;229699;79;509519
93;2020-08-26;10;5;15;171274;113716;89;284990
93;2020-08-26;9;4;13;58896;21758;90;80654
93;2020-08-26;540;482;1033;2639673;2415978;0;5055651
94;2020-08-26;0;0;0;16311;17433;09;33744
94;2020-08-26;4;1;5;16679;18132;19;34811
94;2020-08-26;6;8;14;16782;16579;29;33361
94;2020-08-26;2;5;7;23044;20580;39;43624
94;2020-08-26;1;3;4;23065;22140;49;45205
94;2020-08-26;0;4;4;24549;23421;59;47970
94;2020-08-26;0;1;1;23212;21883;69;45095
94;2020-08-26;1;0;1;19544;17141;79;36685
94;2020-08-26;0;0;0;11227;8178;89;19405
94;2020-08-26;0;0;0;3332;1447;90;4779
94;2020-08-26;14;22;36;177745;166934;0;344679
01;2020-08-27;0;3;3;19979;20155;09;40134
01;2020-08-27;12;4;16;24994;25489;19;50483
01;2020-08-27;12;17;29;17868;16690;29;34558
01;2020-08-27;19;10;29;22328;14821;39;37149
01;2020-08-27;14;12;26;28652;20276;49;48928
01;2020-08-27;12;11;23;33264;27260;59;60524
01;2020-08-27;1;5;6;27135;23978;69;51113
01;2020-08-27;1;4;5;18401;14661;79;33062
01;2020-08-27;0;2;2;9633;6375;89;16008
01;2020-08-27;0;0;0;3410;1510;90;4920
01;2020-08-27;71;68;139;205664;171215;0;376879
02;2020-08-27;0;0;0;16881;17110;09;33991
02;2020-08-27;4;1;5;21410;21604;19;43014
02;2020-08-27;1;2;3;16017;15479;29;31496
02;2020-08-27;2;2;4;19825;14455;39;34280
02;2020-08-27;0;0;0;24719;18248;49;42967
02;2020-08-27;0;1;1;34361;28310;59;62671
02;2020-08-27;0;2;2;28061;24495;69;52556
02;2020-08-27;1;0;1;18231;15278;79;33509
02;2020-08-27;0;0;0;11090;7677;89;18767
02;2020-08-27;0;0;0;3992;1506;90;5498
02;2020-08-27;8;8;16;194587;164162;0;358749
03;2020-08-27;1;0;1;31123;30920;09;62043
03;2020-08-27;5;1;6;29370;29268;19;58638
03;2020-08-27;6;7;13;21458;18963;29;40421
03;2020-08-27;6;4;10;21276;18326;39;39602
03;2020-08-27;4;4;8;18164;16593;49;34757
03;2020-08-27;5;4;9;13469;13557;59;27026
03;2020-08-27;2;2;4;8776;8670;69;17446
03;2020-08-27;2;1;3;3777;3591;79;7368
03;2020-08-27;0;1;1;1649;1072;89;2721
03;2020-08-27;0;0;0;485;184;90;669
03;2020-08-27;31;24;55;149547;141144;0;290691
04;2020-08-27;4;4;8;60314;61377;09;121691
04;2020-08-27;11;7;18;66065;68387;19;134452
04;2020-08-27;5;6;11;51059;47156;29;98215
04;2020-08-27;9;4;13;58788;45780;39;104568
04;2020-08-27;6;6;12;61408;52207;49;113615
04;2020-08-27;4;7;11;64838;60759;59;125597
04;2020-08-27;2;7;9;47008;42843;69;89851
04;2020-08-27;1;1;2;25509;21184;79;46693
04;2020-08-27;0;0;0;13168;7647;89;20815
04;2020-08-27;0;0;0;3209;1253;90;4462
04;2020-08-27;42;42;84;451366;408593;0;859959
05;2020-08-27;0;0;0;362.366008612902;341.338819562748;09;703.704828175651
05;2020-08-27;0;0;0;353.376145114279;370.349735405642;19;723.725880519921
05;2020-08-27;0;0;0;218.593559489256;256.539602589476;29;475.133162078732
05;2020-08-27;0;0;0;404.225408693299;360.321910454353;39;764.547319147651
05;2020-08-27;0;0;0;520.067953604221;497.108383964256;49;1017.17633756848
05;2020-08-27;0;0;0;468.146063921917;510.087601910415;59;978.233665832332
05;2020-08-27;0;0;0;340.368470050554;334.366842191253;69;674.735312241807
05;2020-08-27;0;0;0;212.598666888387;192.597753227106;79;405.196420115493
05;2020-08-27;0;0;0;148.727797095705;61.8681715431829;89;210.595968638888
05;2020-08-27;0;0;0;32.9601271090696;10.9909785719784;90;43.9511056810479
05;2020-08-27;0;0;0;3061.43020057959;2935.56979942041;0;5997
06;2020-08-27;0;0;0;42583;42380;09;84963
06;2020-08-27;0;1;1;33369;31925;19;65294
06;2020-08-27;2;4;6;21571;15080;29;36651
06;2020-08-27;2;1;3;21550;16147;39;37697
06;2020-08-27;0;3;3;14193;13939;49;28132
06;2020-08-27;0;3;3;7171;7597;59;14768
06;2020-08-27;1;1;2;3629;4117;69;7746
06;2020-08-27;0;0;0;1577;1457;79;3034
06;2020-08-27;0;1;1;531;474;89;1005
06;2020-08-27;0;0;0;88;93;90;181
06;2020-08-27;5;14;19;146262;133209;0;279471
07;2020-08-27;0;0;0;485;549;09;1034
07;2020-08-27;0;0;0;403;432;19;835
07;2020-08-27;0;1;1;764;841;29;1605
07;2020-08-27;1;0;1;824;928;39;1752
07;2020-08-27;0;0;0;788;1020;49;1808
07;2020-08-27;0;0;0;678;870;59;1548
07;2020-08-27;0;1;1;360;382;69;742
07;2020-08-27;0;0;0;231;190;79;421
07;2020-08-27;0;0;0;114;67;89;181
07;2020-08-27;0;0;0;24;11;90;35
07;2020-08-27;1;2;3;4671;5290;0;9961
08;2020-08-27;0;0;0;2715.22592983026;2997.75551488675;09;5712.98144471701
08;2020-08-27;0;2;2;2778.51901080978;3160.9156459093;19;5939.43465671908
08;2020-08-27;1;0;1;2080.8882988764;1718.16634315323;29;3799.05464202964
08;2020-08-27;1;0;1;2701.8582062647;1896.52641413317;39;4598.38462039786
08;2020-08-27;2;1;3;3151.45861023308;2460.52498233809;49;5611.98359257117
08;2020-08-27;1;1;2;2620.29868333099;2422.23566154656;59;5042.53434487755
08;2020-08-27;0;1;1;1621.44173420671;1438.58325779464;69;3060.02499200135
08;2020-08-27;0;1;1;626.575909335673;526.358467843651;79;1152.93437717932
08;2020-08-27;0;0;0;205.018522985054;140.993639349697;89;346.012162334751
08;2020-08-27;0;0;0;50.0325684687745;20.62259870351;90;70.6551671722846
08;2020-08-27;5;6;11;18551.3174743414;16782.6825256586;0;35334
11;2020-08-27;34;31;66;783071;811785;09;1594856
11;2020-08-27;132;107;239;761456;784653;19;1546109
11;2020-08-27;466;443;911;850145;801772;29;1651917
11;2020-08-27;201;258;460;914360;843488;39;1757848
11;2020-08-27;130;124;255;845609;826202;49;1671811
11;2020-08-27;99;86;185;793566;745070;59;1538636
11;2020-08-27;44;60;104;628649;549192;69;1177841
11;2020-08-27;19;21;40;434606;358356;79;792962
11;2020-08-27;15;6;21;261425;162933;89;424358
11;2020-08-27;9;2;11;89253;32619;90;121872
11;2020-08-27;1149;1138;2295;6362140;5916070;0;12278210
24;2020-08-27;4;7;11;139720;144686;09;284406
24;2020-08-27;18;11;29;152979;161185;19;314164
24;2020-08-27;23;40;63;122237;126536;29;248773
24;2020-08-27;13;9;22;150359;142009;39;292368
24;2020-08-27;13;10;23;161829;158758;49;320587
24;2020-08-27;7;4;11;172552;168011;59;340563
24;2020-08-27;6;9;15;172509;158177;69;330686
24;2020-08-27;2;0;2;129428;110593;79;240021
24;2020-08-27;1;0;1;87342;56882;89;144224
24;2020-08-27;1;0;1;31210;12071;90;43281
24;2020-08-27;88;90;178;1320165;1238908;0;2559073
27;2020-08-27;3;4;7;143373;149679;09;293052
27;2020-08-27;7;7;14;160962;173003;19;333965
27;2020-08-27;20;37;57;133746;142254;29;276000
27;2020-08-27;19;10;29;160004;155407;39;315411
27;2020-08-27;18;9;27;172333;169564;49;341897
27;2020-08-27;6;10;16;189979;183788;59;373767
27;2020-08-27;5;7;12;192591;178206;69;370797
27;2020-08-27;4;2;6;146876;127546;79;274422
27;2020-08-27;2;0;2;96896;61575;89;158471
27;2020-08-27;1;0;1;33148;12109;90;45257
27;2020-08-27;85;86;171;1429908;1353131;0;2783039
28;2020-08-27;8;5;13;180735;186856;09;367591
28;2020-08-27;8;20;28;200125;213621;19;413746
28;2020-08-27;38;35;73;168922;173007;29;341929
28;2020-08-27;23;8;31;196628;188487;39;385115
28;2020-08-27;20;14;34;205396;201699;49;407095
28;2020-08-27;14;9;23;222002;213866;59;435868
28;2020-08-27;8;3;11;224688;203758;69;428446
28;2020-08-27;6;4;10;163192;135543;79;298735
28;2020-08-27;4;1;5;109691;65377;89;175068
28;2020-08-27;0;0;0;37222;12685;90;49907
28;2020-08-27;129;99;228;1708601;1594899;0;3303500
32;2020-08-27;9;11;20;358062;373689;09;731751
32;2020-08-27;28;37;65;387045;406742;19;793787
32;2020-08-27;38;51;89;342304;348587;29;690891
32;2020-08-27;34;37;71;382485;369972;39;752457
32;2020-08-27;20;15;35;382510;376716;49;759226
32;2020-08-27;22;21;43;386937;376527;59;763464
32;2020-08-27;9;7;16;371211;330938;69;702149
32;2020-08-27;3;7;10;250542;201459;79;452001
32;2020-08-27;4;1;5;163399;89786;89;253185
32;2020-08-27;1;0;1;48384;15367;90;63751
32;2020-08-27;169;187;356;3072879;2889783;0;5962662
44;2020-08-27;7;4;11;291525;306839;09;598364
44;2020-08-27;18;12;30;320255;339504;19;659759
44;2020-08-27;49;45;94;302020;314428;29;616448
44;2020-08-27;30;25;55;342222;333292;39;675514
44;2020-08-27;21;14;35;349727;344491;49;694218
44;2020-08-27;6;10;16;381371;373239;59;754610
44;2020-08-27;5;7;12;367165;335850;69;703015
44;2020-08-27;5;5;10;250387;215436;79;465823
44;2020-08-27;4;1;5;170825;105192;89;276017
44;2020-08-27;2;0;2;51248;16731;90;67979
44;2020-08-27;147;123;270;2826745;2685002;0;5511747
52;2020-08-27;3;4;7;213594;223900;09;437494
52;2020-08-27;12;15;28;240818;255197;19;496015
52;2020-08-27;20;41;61;197010;200630;29;397640
52;2020-08-27;12;21;33;231204;224885;39;456089
52;2020-08-27;10;6;16;243874;243418;49;487292
52;2020-08-27;10;6;16;244100;239116;59;483216
52;2020-08-27;4;6;10;241796;221345;69;463141
52;2020-08-27;1;4;5;177805;149903;79;327708
52;2020-08-27;0;0;0;119561;75822;89;195383
52;2020-08-27;1;0;1;42559;15260;90;57819
52;2020-08-27;73;103;177;1952321;1849476;0;3801797
53;2020-08-27;0;1;1;173813;182358;09;356171
53;2020-08-27;9;7;16;202720;214740;19;417460
53;2020-08-27;21;37;60;163116;173196;29;336312
53;2020-08-27;10;11;21;190526;187674;39;378200
53;2020-08-27;7;7;14;212098;212015;49;424113
53;2020-08-27;5;4;9;223699;219176;59;442875
53;2020-08-27;4;4;8;227435;209274;69;436709
53;2020-08-27;2;0;2;169992;140910;79;310902
53;2020-08-27;2;0;2;118117;69883;89;188000
53;2020-08-27;0;0;0;37370;12267;90;49637
53;2020-08-27;60;71;133;1718886;1621493;0;3340379
75;2020-08-27;7;9;16;293104;305291;09;598395
75;2020-08-27;47;42;89;337141;357785;19;694926
75;2020-08-27;126;154;280;295024;300618;29;595642
75;2020-08-27;42;71;113;347871;331233;39;679104
75;2020-08-27;34;30;64;384742;372771;49;757513
75;2020-08-27;21;20;41;413361;390880;59;804241
75;2020-08-27;10;14;24;425623;384060;69;809683
75;2020-08-27;3;4;7;325086;276298;79;601384
75;2020-08-27;2;2;4;213986;139308;89;353294
75;2020-08-27;0;0;0;77600;28200;90;105800
75;2020-08-27;292;346;638;3113538;2886444;0;5999982
76;2020-08-27;8;5;13;305956;318589;09;624545
76;2020-08-27;32;19;52;338942;356969;19;695911
76;2020-08-27;74;97;171;316210;319570;29;635780
76;2020-08-27;43;45;88;356758;337587;39;694345
76;2020-08-27;32;29;61;376541;363812;49;740353
76;2020-08-27;41;29;70;402608;383750;59;786358
76;2020-08-27;15;14;29;394889;358997;69;753886
76;2020-08-27;7;14;21;308664;263806;79;572470
76;2020-08-27;4;2;6;195838;129272;89;325110
76;2020-08-27;1;1;2;69372;26728;90;96100
76;2020-08-27;257;255;513;3065778;2859080;0;5924858
84;2020-08-27;13;12;25;459549;481088;09;940637
84;2020-08-27;47;39;86;487711;511905;19;999616
84;2020-08-27;116;133;249;443824;451094;29;894918
84;2020-08-27;81;66;147;512522;493262;39;1005784
84;2020-08-27;47;41;88;520248;515106;49;1035354
84;2020-08-27;42;35;78;529611;514848;59;1044459
84;2020-08-27;17;18;35;486720;439940;69;926660
84;2020-08-27;14;9;23;372151;315211;79;687362
84;2020-08-27;13;11;24;237198;150524;89;387722
84;2020-08-27;11;5;16;81185;28680;90;109865
84;2020-08-27;401;369;771;4130719;3901658;0;8032377
93;2020-08-27;14;26;40;268834;283093;09;551927
93;2020-08-27;73;53;126;280751;296087;19;576838
93;2020-08-27;189;162;352;254404;255552;29;509956
93;2020-08-27;102;103;205;310704;288398;39;599102
93;2020-08-27;76;62;138;325559;305827;49;631386
93;2020-08-27;71;59;131;353104;325389;59;678493
93;2020-08-27;52;36;88;336327;296459;69;632786
93;2020-08-27;28;20;48;279820;229699;79;509519
93;2020-08-27;26;13;39;171274;113716;89;284990
93;2020-08-27;12;4;16;58896;21758;90;80654
93;2020-08-27;643;538;1183;2639673;2415978;0;5055651
94;2020-08-27;0;0;0;16311;17433;09;33744
94;2020-08-27;3;4;7;16679;18132;19;34811
94;2020-08-27;6;10;16;16782;16579;29;33361
94;2020-08-27;5;5;10;23044;20580;39;43624
94;2020-08-27;4;4;8;23065;22140;49;45205
94;2020-08-27;2;3;5;24549;23421;59;47970
94;2020-08-27;2;2;4;23212;21883;69;45095
94;2020-08-27;0;0;0;19544;17141;79;36685
94;2020-08-27;0;0;0;11227;8178;89;19405
94;2020-08-27;0;0;0;3332;1447;90;4779
94;2020-08-27;22;28;50;177745;166934;0;344679
01;2020-08-28;1;0;1;19979;20155;09;40134
01;2020-08-28;1;1;2;24994;25489;19;50483
01;2020-08-28;5;1;6;17868;16690;29;34558
01;2020-08-28;3;4;7;22328;14821;39;37149
01;2020-08-28;5;4;9;28652;20276;49;48928
01;2020-08-28;6;6;12;33264;27260;59;60524
01;2020-08-28;2;3;5;27135;23978;69;51113
01;2020-08-28;0;2;2;18401;14661;79;33062
01;2020-08-28;1;0;1;9633;6375;89;16008
01;2020-08-28;0;0;0;3410;1510;90;4920
01;2020-08-28;24;21;45;205664;171215;0;376879
02;2020-08-28;0;1;1;16881;17110;09;33991
02;2020-08-28;4;1;5;21410;21604;19;43014
02;2020-08-28;4;2;6;16017;15479;29;31496
02;2020-08-28;7;2;9;19825;14455;39;34280
02;2020-08-28;3;1;4;24719;18248;49;42967
02;2020-08-28;2;1;3;34361;28310;59;62671
02;2020-08-28;0;0;0;28061;24495;69;52556
02;2020-08-28;0;0;0;18231;15278;79;33509
02;2020-08-28;1;0;1;11090;7677;89;18767
02;2020-08-28;0;0;0;3992;1506;90;5498
02;2020-08-28;21;8;29;194587;164162;0;358749
03;2020-08-28;2;0;2;31123;30920;09;62043
03;2020-08-28;4;6;10;29370;29268;19;58638
03;2020-08-28;6;6;12;21458;18963;29;40421
03;2020-08-28;8;1;9;21276;18326;39;39602
03;2020-08-28;2;3;5;18164;16593;49;34757
03;2020-08-28;0;2;2;13469;13557;59;27026
03;2020-08-28;1;0;1;8776;8670;69;17446
03;2020-08-28;0;1;1;3777;3591;79;7368
03;2020-08-28;0;0;0;1649;1072;89;2721
03;2020-08-28;0;0;0;485;184;90;669
03;2020-08-28;23;19;42;149547;141144;0;290691
04;2020-08-28;8;5;13;60314;61377;09;121691
04;2020-08-28;9;10;19;66065;68387;19;134452
04;2020-08-28;5;3;8;51059;47156;29;98215
04;2020-08-28;8;3;11;58788;45780;39;104568
04;2020-08-28;6;4;10;61408;52207;49;113615
04;2020-08-28;8;4;12;64838;60759;59;125597
04;2020-08-28;5;2;7;47008;42843;69;89851
04;2020-08-28;3;1;4;25509;21184;79;46693
04;2020-08-28;1;0;1;13168;7647;89;20815
04;2020-08-28;0;0;0;3209;1253;90;4462
04;2020-08-28;53;32;85;451366;408593;0;859959
05;2020-08-28;0;0;0;362.366008612902;341.338819562748;09;703.704828175651
05;2020-08-28;0;0;0;353.376145114279;370.349735405642;19;723.725880519921
05;2020-08-28;0;0;0;218.593559489256;256.539602589476;29;475.133162078732
05;2020-08-28;0;0;0;404.225408693299;360.321910454353;39;764.547319147651
05;2020-08-28;0;0;0;520.067953604221;497.108383964256;49;1017.17633756848
05;2020-08-28;0;0;0;468.146063921917;510.087601910415;59;978.233665832332
05;2020-08-28;0;0;0;340.368470050554;334.366842191253;69;674.735312241807
05;2020-08-28;0;0;0;212.598666888387;192.597753227106;79;405.196420115493
05;2020-08-28;0;0;0;148.727797095705;61.8681715431829;89;210.595968638888
05;2020-08-28;0;0;0;32.9601271090696;10.9909785719784;90;43.9511056810479
05;2020-08-28;0;0;0;3061.43020057959;2935.56979942041;0;5997
06;2020-08-28;0;0;0;42583;42380;09;84963
06;2020-08-28;3;0;3;33369;31925;19;65294
06;2020-08-28;3;1;4;21571;15080;29;36651
06;2020-08-28;1;4;5;21550;16147;39;37697
06;2020-08-28;0;1;1;14193;13939;49;28132
06;2020-08-28;0;1;1;7171;7597;59;14768
06;2020-08-28;1;0;1;3629;4117;69;7746
06;2020-08-28;0;0;0;1577;1457;79;3034
06;2020-08-28;0;0;0;531;474;89;1005
06;2020-08-28;0;0;0;88;93;90;181
06;2020-08-28;8;7;15;146262;133209;0;279471
07;2020-08-28;0;0;0;485;549;09;1034
07;2020-08-28;0;1;1;403;432;19;835
07;2020-08-28;0;0;0;764;841;29;1605
07;2020-08-28;0;0;0;824;928;39;1752
07;2020-08-28;0;0;0;788;1020;49;1808
07;2020-08-28;0;0;0;678;870;59;1548
07;2020-08-28;0;0;0;360;382;69;742
07;2020-08-28;0;0;0;231;190;79;421
07;2020-08-28;0;0;0;114;67;89;181
07;2020-08-28;0;0;0;24;11;90;35
07;2020-08-28;0;1;1;4671;5290;0;9961
08;2020-08-28;0;0;0;2715.22592983026;2997.75551488675;09;5712.98144471701
08;2020-08-28;0;0;0;2778.51901080978;3160.9156459093;19;5939.43465671908
08;2020-08-28;0;0;0;2080.8882988764;1718.16634315323;29;3799.05464202964
08;2020-08-28;1;0;1;2701.8582062647;1896.52641413317;39;4598.38462039786
08;2020-08-28;2;1;3;3151.45861023308;2460.52498233809;49;5611.98359257117
08;2020-08-28;0;0;0;2620.29868333099;2422.23566154656;59;5042.53434487755
08;2020-08-28;1;1;2;1621.44173420671;1438.58325779464;69;3060.02499200135
08;2020-08-28;0;1;1;626.575909335673;526.358467843651;79;1152.93437717932
08;2020-08-28;1;0;1;205.018522985054;140.993639349697;89;346.012162334751
08;2020-08-28;0;0;0;50.0325684687745;20.62259870351;90;70.6551671722846
08;2020-08-28;5;3;8;18551.3174743414;16782.6825256586;0;35334
11;2020-08-28;46;27;77;783071;811785;09;1594856
11;2020-08-28;153;116;272;761456;784653;19;1546109
11;2020-08-28;452;404;859;850145;801772;29;1651917
11;2020-08-28;234;281;516;914360;843488;39;1757848
11;2020-08-28;151;147;304;845609;826202;49;1671811
11;2020-08-28;123;92;216;793566;745070;59;1538636
11;2020-08-28;73;63;137;628649;549192;69;1177841
11;2020-08-28;23;39;63;434606;358356;79;792962
11;2020-08-28;17;12;29;261425;162933;89;424358
11;2020-08-28;18;2;20;89253;32619;90;121872
11;2020-08-28;1290;1184;2499;6362140;5916070;0;12278210
24;2020-08-28;3;2;6;139720;144686;09;284406
24;2020-08-28;5;7;12;152979;161185;19;314164
24;2020-08-28;35;27;62;122237;126536;29;248773
24;2020-08-28;15;17;32;150359;142009;39;292368
24;2020-08-28;6;8;14;161829;158758;49;320587
24;2020-08-28;7;7;14;172552;168011;59;340563
24;2020-08-28;10;6;16;172509;158177;69;330686
24;2020-08-28;0;1;1;129428;110593;79;240021
24;2020-08-28;1;0;1;87342;56882;89;144224
24;2020-08-28;0;0;0;31210;12071;90;43281
24;2020-08-28;82;75;158;1320165;1238908;0;2559073
27;2020-08-28;5;4;9;143373;149679;09;293052
27;2020-08-28;11;15;26;160962;173003;19;333965
27;2020-08-28;35;30;65;133746;142254;29;276000
27;2020-08-28;14;11;25;160004;155407;39;315411
27;2020-08-28;15;9;24;172333;169564;49;341897
27;2020-08-28;7;9;16;189979;183788;59;373767
27;2020-08-28;7;5;12;192591;178206;69;370797
27;2020-08-28;2;4;6;146876;127546;79;274422
27;2020-08-28;3;1;4;96896;61575;89;158471
27;2020-08-28;0;0;0;33148;12109;90;45257
27;2020-08-28;99;88;187;1429908;1353131;0;2783039
28;2020-08-28;4;5;9;180735;186856;09;367591
28;2020-08-28;18;15;34;200125;213621;19;413746
28;2020-08-28;20;31;51;168922;173007;29;341929
28;2020-08-28;18;13;31;196628;188487;39;385115
28;2020-08-28;12;7;19;205396;201699;49;407095
28;2020-08-28;9;6;15;222002;213866;59;435868
28;2020-08-28;5;8;13;224688;203758;69;428446
28;2020-08-28;5;3;8;163192;135543;79;298735
28;2020-08-28;1;2;3;109691;65377;89;175068
28;2020-08-28;2;0;2;37222;12685;90;49907
28;2020-08-28;94;90;185;1708601;1594899;0;3303500
32;2020-08-28;7;2;9;358062;373689;09;731751
32;2020-08-28;9;20;30;387045;406742;19;793787
32;2020-08-28;55;53;108;342304;348587;29;690891
32;2020-08-28;16;33;49;382485;369972;39;752457
32;2020-08-28;26;21;47;382510;376716;49;759226
32;2020-08-28;21;18;40;386937;376527;59;763464
32;2020-08-28;7;9;17;371211;330938;69;702149
32;2020-08-28;8;7;15;250542;201459;79;452001
32;2020-08-28;2;1;3;163399;89786;89;253185
32;2020-08-28;1;2;3;48384;15367;90;63751
32;2020-08-28;152;166;321;3072879;2889783;0;5962662
44;2020-08-28;6;16;22;291525;306839;09;598364
44;2020-08-28;24;15;39;320255;339504;19;659759
44;2020-08-28;48;44;92;302020;314428;29;616448
44;2020-08-28;18;24;42;342222;333292;39;675514
44;2020-08-28;21;14;35;349727;344491;49;694218
44;2020-08-28;20;8;28;381371;373239;59;754610
44;2020-08-28;7;11;18;367165;335850;69;703015
44;2020-08-28;9;7;16;250387;215436;79;465823
44;2020-08-28;1;3;4;170825;105192;89;276017
44;2020-08-28;0;1;1;51248;16731;90;67979
44;2020-08-28;155;143;298;2826745;2685002;0;5511747
52;2020-08-28;3;4;8;213594;223900;09;437494
52;2020-08-28;19;22;42;240818;255197;19;496015
52;2020-08-28;24;42;66;197010;200630;29;397640
52;2020-08-28;14;17;31;231204;224885;39;456089
52;2020-08-28;15;19;34;243874;243418;49;487292
52;2020-08-28;10;15;25;244100;239116;59;483216
52;2020-08-28;4;6;10;241796;221345;69;463141
52;2020-08-28;8;7;15;177805;149903;79;327708
52;2020-08-28;0;0;0;119561;75822;89;195383
52;2020-08-28;1;0;1;42559;15260;90;57819
52;2020-08-28;98;132;232;1952321;1849476;0;3801797
53;2020-08-28;4;1;5;173813;182358;09;356171
53;2020-08-28;21;12;34;202720;214740;19;417460
53;2020-08-28;20;25;45;163116;173196;29;336312
53;2020-08-28;12;10;22;190526;187674;39;378200
53;2020-08-28;4;11;15;212098;212015;49;424113
53;2020-08-28;6;10;16;223699;219176;59;442875
53;2020-08-28;2;4;6;227435;209274;69;436709
53;2020-08-28;0;1;1;169992;140910;79;310902
53;2020-08-28;0;0;0;118117;69883;89;188000
53;2020-08-28;1;1;2;37370;12267;90;49637
53;2020-08-28;70;75;146;1718886;1621493;0;3340379
75;2020-08-28;7;9;18;293104;305291;09;598395
75;2020-08-28;50;32;82;337141;357785;19;694926
75;2020-08-28;110;128;238;295024;300618;29;595642
75;2020-08-28;40;44;84;347871;331233;39;679104
75;2020-08-28;25;32;57;384742;372771;49;757513
75;2020-08-28;28;28;56;413361;390880;59;804241
75;2020-08-28;13;12;25;425623;384060;69;809683
75;2020-08-28;11;4;15;325086;276298;79;601384
75;2020-08-28;1;1;2;213986;139308;89;353294
75;2020-08-28;1;0;1;77600;28200;90;105800
75;2020-08-28;286;290;578;3113538;2886444;0;5999982
76;2020-08-28;10;14;24;305956;318589;09;624545
76;2020-08-28;31;32;65;338942;356969;19;695911
76;2020-08-28;77;81;158;316210;319570;29;635780
76;2020-08-28;50;57;107;356758;337587;39;694345
76;2020-08-28;41;48;89;376541;363812;49;740353
76;2020-08-28;36;28;64;402608;383750;59;786358
76;2020-08-28;20;30;50;394889;358997;69;753886
76;2020-08-28;18;15;33;308664;263806;79;572470
76;2020-08-28;13;3;16;195838;129272;89;325110
76;2020-08-28;8;2;10;69372;26728;90;96100
76;2020-08-28;304;310;616;3065778;2859080;0;5924858
84;2020-08-28;15;12;27;459549;481088;09;940637
84;2020-08-28;47;49;96;487711;511905;19;999616
84;2020-08-28;120;129;249;443824;451094;29;894918
84;2020-08-28;74;81;155;512522;493262;39;1005784
84;2020-08-28;45;47;92;520248;515106;49;1035354
84;2020-08-28;58;27;85;529611;514848;59;1044459
84;2020-08-28;24;14;38;486720;439940;69;926660
84;2020-08-28;10;12;22;372151;315211;79;687362
84;2020-08-28;9;3;12;237198;150524;89;387722
84;2020-08-28;8;1;9;81185;28680;90;109865
84;2020-08-28;410;376;786;4130719;3901658;0;8032377
93;2020-08-28;18;30;48;268834;283093;09;551927
93;2020-08-28;75;76;151;280751;296087;19;576838
93;2020-08-28;163;145;310;254404;255552;29;509956
93;2020-08-28;109;105;214;310704;288398;39;599102
93;2020-08-28;90;61;152;325559;305827;49;631386
93;2020-08-28;88;63;151;353104;325389;59;678493
93;2020-08-28;49;43;92;336327;296459;69;632786
93;2020-08-28;25;29;54;279820;229699;79;509519
93;2020-08-28;13;18;31;171274;113716;89;284990
93;2020-08-28;8;3;11;58896;21758;90;80654
93;2020-08-28;638;573;1214;2639673;2415978;0;5055651
94;2020-08-28;0;0;0;16311;17433;09;33744
94;2020-08-28;4;2;6;16679;18132;19;34811
94;2020-08-28;3;7;10;16782;16579;29;33361
94;2020-08-28;4;7;11;23044;20580;39;43624
94;2020-08-28;2;6;8;23065;22140;49;45205
94;2020-08-28;1;2;3;24549;23421;59;47970
94;2020-08-28;1;2;3;23212;21883;69;45095
94;2020-08-28;1;1;2;19544;17141;79;36685
94;2020-08-28;0;0;0;11227;8178;89;19405
94;2020-08-28;2;0;2;3332;1447;90;4779
94;2020-08-28;18;27;45;177745;166934;0;344679
01;2020-08-29;0;0;0;19979;20155;09;40134
01;2020-08-29;0;1;1;24994;25489;19;50483
01;2020-08-29;1;2;3;17868;16690;29;34558
01;2020-08-29;1;2;3;22328;14821;39;37149
01;2020-08-29;1;2;3;28652;20276;49;48928
01;2020-08-29;3;1;4;33264;27260;59;60524
01;2020-08-29;2;1;3;27135;23978;69;51113
01;2020-08-29;0;2;2;18401;14661;79;33062
01;2020-08-29;0;0;0;9633;6375;89;16008
01;2020-08-29;0;0;0;3410;1510;90;4920
01;2020-08-29;8;11;19;205664;171215;0;376879
02;2020-08-29;1;0;1;16881;17110;09;33991
02;2020-08-29;0;1;1;21410;21604;19;43014
02;2020-08-29;0;0;0;16017;15479;29;31496
02;2020-08-29;1;0;1;19825;14455;39;34280
02;2020-08-29;1;1;2;24719;18248;49;42967
02;2020-08-29;1;2;3;34361;28310;59;62671
02;2020-08-29;0;0;0;28061;24495;69;52556
02;2020-08-29;0;0;0;18231;15278;79;33509
02;2020-08-29;0;0;0;11090;7677;89;18767
02;2020-08-29;0;0;0;3992;1506;90;5498
02;2020-08-29;4;4;8;194587;164162;0;358749
03;2020-08-29;2;0;3;31123;30920;09;62043
03;2020-08-29;0;2;2;29370;29268;19;58638
03;2020-08-29;5;1;6;21458;18963;29;40421
03;2020-08-29;4;2;7;21276;18326;39;39602
03;2020-08-29;2;0;2;18164;16593;49;34757
03;2020-08-29;0;2;2;13469;13557;59;27026
03;2020-08-29;1;0;1;8776;8670;69;17446
03;2020-08-29;1;1;2;3777;3591;79;7368
03;2020-08-29;0;0;0;1649;1072;89;2721
03;2020-08-29;0;0;0;485;184;90;669
03;2020-08-29;15;8;25;149547;141144;0;290691
04;2020-08-29;0;1;1;60314;61377;09;121691
04;2020-08-29;4;3;7;66065;68387;19;134452
04;2020-08-29;3;2;5;51059;47156;29;98215
04;2020-08-29;6;0;6;58788;45780;39;104568
04;2020-08-29;2;1;3;61408;52207;49;113615
04;2020-08-29;2;4;6;64838;60759;59;125597
04;2020-08-29;3;1;4;47008;42843;69;89851
04;2020-08-29;0;1;1;25509;21184;79;46693
04;2020-08-29;1;0;1;13168;7647;89;20815
04;2020-08-29;0;0;0;3209;1253;90;4462
04;2020-08-29;21;13;34;451366;408593;0;859959
05;2020-08-29;0;0;0;362.366008612902;341.338819562748;09;703.704828175651
05;2020-08-29;0;0;0;353.376145114279;370.349735405642;19;723.725880519921
05;2020-08-29;0;0;0;218.593559489256;256.539602589476;29;475.133162078732
05;2020-08-29;0;0;0;404.225408693299;360.321910454353;39;764.547319147651
05;2020-08-29;0;0;0;520.067953604221;497.108383964256;49;1017.17633756848
05;2020-08-29;0;0;0;468.146063921917;510.087601910415;59;978.233665832332
05;2020-08-29;0;0;0;340.368470050554;334.366842191253;69;674.735312241807
05;2020-08-29;0;0;0;212.598666888387;192.597753227106;79;405.196420115493
05;2020-08-29;0;0;0;148.727797095705;61.8681715431829;89;210.595968638888
05;2020-08-29;0;0;0;32.9601271090696;10.9909785719784;90;43.9511056810479
05;2020-08-29;0;0;0;3061.43020057959;2935.56979942041;0;5997
06;2020-08-29;0;0;0;42583;42380;09;84963
06;2020-08-29;0;1;1;33369;31925;19;65294
06;2020-08-29;0;1;1;21571;15080;29;36651
06;2020-08-29;0;0;0;21550;16147;39;37697
06;2020-08-29;0;0;0;14193;13939;49;28132
06;2020-08-29;0;0;0;7171;7597;59;14768
06;2020-08-29;0;0;0;3629;4117;69;7746
06;2020-08-29;0;0;0;1577;1457;79;3034
06;2020-08-29;0;1;1;531;474;89;1005
06;2020-08-29;0;0;0;88;93;90;181
06;2020-08-29;0;3;3;146262;133209;0;279471
07;2020-08-29;0;0;0;485;549;09;1034
07;2020-08-29;0;0;0;403;432;19;835
07;2020-08-29;0;0;0;764;841;29;1605
07;2020-08-29;0;0;0;824;928;39;1752
07;2020-08-29;0;0;0;788;1020;49;1808
07;2020-08-29;0;0;0;678;870;59;1548
07;2020-08-29;0;0;0;360;382;69;742
07;2020-08-29;0;0;0;231;190;79;421
07;2020-08-29;0;0;0;114;67;89;181
07;2020-08-29;0;0;0;24;11;90;35
07;2020-08-29;0;0;0;4671;5290;0;9961
08;2020-08-29;0;0;0;2715.22592983026;2997.75551488675;09;5712.98144471701
08;2020-08-29;0;0;0;2778.51901080978;3160.9156459093;19;5939.43465671908
08;2020-08-29;0;0;0;2080.8882988764;1718.16634315323;29;3799.05464202964
08;2020-08-29;0;0;0;2701.8582062647;1896.52641413317;39;4598.38462039786
08;2020-08-29;1;0;1;3151.45861023308;2460.52498233809;49;5611.98359257117
08;2020-08-29;0;0;0;2620.29868333099;2422.23566154656;59;5042.53434487755
08;2020-08-29;0;0;0;1621.44173420671;1438.58325779464;69;3060.02499200135
08;2020-08-29;0;2;2;626.575909335673;526.358467843651;79;1152.93437717932
08;2020-08-29;0;0;0;205.018522985054;140.993639349697;89;346.012162334751
08;2020-08-29;0;0;0;50.0325684687745;20.62259870351;90;70.6551671722846
08;2020-08-29;1;2;3;18551.3174743414;16782.6825256586;0;35334
11;2020-08-29;11;9;22;783071;811785;09;1594856
11;2020-08-29;50;36;87;761456;784653;19;1546109
11;2020-08-29;152;133;285;850145;801772;29;1651917
11;2020-08-29;70;85;155;914360;843488;39;1757848
11;2020-08-29;41;30;71;845609;826202;49;1671811
11;2020-08-29;44;33;77;793566;745070;59;1538636
11;2020-08-29;23;26;49;628649;549192;69;1177841
11;2020-08-29;11;7;18;434606;358356;79;792962
11;2020-08-29;2;4;6;261425;162933;89;424358
11;2020-08-29;1;0;1;89253;32619;90;121872
11;2020-08-29;405;365;773;6362140;5916070;0;12278210
24;2020-08-29;5;0;5;139720;144686;09;284406
24;2020-08-29;7;4;11;152979;161185;19;314164
24;2020-08-29;13;12;25;122237;126536;29;248773
24;2020-08-29;7;10;17;150359;142009;39;292368
24;2020-08-29;1;6;7;161829;158758;49;320587
24;2020-08-29;6;3;9;172552;168011;59;340563
24;2020-08-29;2;3;5;172509;158177;69;330686
24;2020-08-29;1;2;3;129428;110593;79;240021
24;2020-08-29;2;0;2;87342;56882;89;144224
24;2020-08-29;0;0;0;31210;12071;90;43281
24;2020-08-29;44;40;84;1320165;1238908;0;2559073
27;2020-08-29;3;0;3;143373;149679;09;293052
27;2020-08-29;4;6;10;160962;173003;19;333965
27;2020-08-29;13;11;24;133746;142254;29;276000
27;2020-08-29;11;8;19;160004;155407;39;315411
27;2020-08-29;6;5;11;172333;169564;49;341897
27;2020-08-29;5;5;10;189979;183788;59;373767
27;2020-08-29;1;4;5;192591;178206;69;370797
27;2020-08-29;1;0;1;146876;127546;79;274422
27;2020-08-29;2;0;2;96896;61575;89;158471
27;2020-08-29;0;0;0;33148;12109;90;45257
27;2020-08-29;46;39;85;1429908;1353131;0;2783039
28;2020-08-29;4;3;7;180735;186856;09;367591
28;2020-08-29;12;10;22;200125;213621;19;413746
28;2020-08-29;21;20;41;168922;173007;29;341929
28;2020-08-29;8;10;18;196628;188487;39;385115
28;2020-08-29;5;6;11;205396;201699;49;407095
28;2020-08-29;7;5;12;222002;213866;59;435868
28;2020-08-29;4;3;7;224688;203758;69;428446
28;2020-08-29;0;1;1;163192;135543;79;298735
28;2020-08-29;2;1;3;109691;65377;89;175068
28;2020-08-29;1;0;1;37222;12685;90;49907
28;2020-08-29;64;59;123;1708601;1594899;0;3303500
32;2020-08-29;2;2;4;358062;373689;09;731751
32;2020-08-29;17;17;34;387045;406742;19;793787
32;2020-08-29;13;19;32;342304;348587;29;690891
32;2020-08-29;12;10;22;382485;369972;39;752457
32;2020-08-29;2;14;16;382510;376716;49;759226
32;2020-08-29;8;6;14;386937;376527;59;763464
32;2020-08-29;4;5;9;371211;330938;69;702149
32;2020-08-29;2;6;8;250542;201459;79;452001
32;2020-08-29;1;2;3;163399;89786;89;253185
32;2020-08-29;0;0;0;48384;15367;90;63751
32;2020-08-29;61;81;142;3072879;2889783;0;5962662
44;2020-08-29;4;2;6;291525;306839;09;598364
44;2020-08-29;9;8;17;320255;339504;19;659759
44;2020-08-29;30;21;51;302020;314428;29;616448
44;2020-08-29;9;13;22;342222;333292;39;675514
44;2020-08-29;9;11;20;349727;344491;49;694218
44;2020-08-29;14;9;23;381371;373239;59;754610
44;2020-08-29;7;5;12;367165;335850;69;703015
44;2020-08-29;4;1;5;250387;215436;79;465823
44;2020-08-29;1;0;1;170825;105192;89;276017
44;2020-08-29;0;1;1;51248;16731;90;67979
44;2020-08-29;87;71;158;2826745;2685002;0;5511747
52;2020-08-29;0;0;2;213594;223900;09;437494
52;2020-08-29;8;13;23;240818;255197;19;496015
52;2020-08-29;16;7;23;197010;200630;29;397640
52;2020-08-29;6;7;13;231204;224885;39;456089
52;2020-08-29;11;9;20;243874;243418;49;487292
52;2020-08-29;5;2;7;244100;239116;59;483216
52;2020-08-29;0;0;0;241796;221345;69;463141
52;2020-08-29;0;0;0;177805;149903;79;327708
52;2020-08-29;1;0;1;119561;75822;89;195383
52;2020-08-29;0;0;0;42559;15260;90;57819
52;2020-08-29;47;38;89;1952321;1849476;0;3801797
53;2020-08-29;1;0;1;173813;182358;09;356171
53;2020-08-29;9;8;17;202720;214740;19;417460
53;2020-08-29;12;19;31;163116;173196;29;336312
53;2020-08-29;8;6;14;190526;187674;39;378200
53;2020-08-29;2;3;5;212098;212015;49;424113
53;2020-08-29;2;3;5;223699;219176;59;442875
53;2020-08-29;1;2;3;227435;209274;69;436709
53;2020-08-29;0;2;2;169992;140910;79;310902
53;2020-08-29;0;1;1;118117;69883;89;188000
53;2020-08-29;1;0;1;37370;12267;90;49637
53;2020-08-29;36;44;80;1718886;1621493;0;3340379
75;2020-08-29;5;9;14;293104;305291;09;598395
75;2020-08-29;17;17;34;337141;357785;19;694926
75;2020-08-29;58;59;117;295024;300618;29;595642
75;2020-08-29;25;25;50;347871;331233;39;679104
75;2020-08-29;13;11;24;384742;372771;49;757513
75;2020-08-29;16;13;29;413361;390880;59;804241
75;2020-08-29;6;9;15;425623;384060;69;809683
75;2020-08-29;6;3;9;325086;276298;79;601384
75;2020-08-29;4;0;4;213986;139308;89;353294
75;2020-08-29;1;0;1;77600;28200;90;105800
75;2020-08-29;151;146;297;3113538;2886444;0;5999982
76;2020-08-29;0;3;3;305956;318589;09;624545
76;2020-08-29;11;10;21;338942;356969;19;695911
76;2020-08-29;35;44;79;316210;319570;29;635780
76;2020-08-29;15;19;34;356758;337587;39;694345
76;2020-08-29;12;19;31;376541;363812;49;740353
76;2020-08-29;21;9;30;402608;383750;59;786358
76;2020-08-29;9;5;14;394889;358997;69;753886
76;2020-08-29;5;3;8;308664;263806;79;572470
76;2020-08-29;5;0;5;195838;129272;89;325110
76;2020-08-29;2;1;3;69372;26728;90;96100
76;2020-08-29;115;113;228;3065778;2859080;0;5924858
84;2020-08-29;5;4;9;459549;481088;09;940637
84;2020-08-29;17;17;34;487711;511905;19;999616
84;2020-08-29;59;42;101;443824;451094;29;894918
84;2020-08-29;21;29;50;512522;493262;39;1005784
84;2020-08-29;22;20;42;520248;515106;49;1035354
84;2020-08-29;17;18;35;529611;514848;59;1044459
84;2020-08-29;11;7;18;486720;439940;69;926660
84;2020-08-29;6;6;12;372151;315211;79;687362
84;2020-08-29;1;2;3;237198;150524;89;387722
84;2020-08-29;3;0;3;81185;28680;90;109865
84;2020-08-29;162;145;307;4130719;3901658;0;8032377
93;2020-08-29;4;8;12;268834;283093;09;551927
93;2020-08-29;21;22;43;280751;296087;19;576838
93;2020-08-29;64;55;119;254404;255552;29;509956
93;2020-08-29;51;41;92;310704;288398;39;599102
93;2020-08-29;21;20;41;325559;305827;49;631386
93;2020-08-29;33;28;61;353104;325389;59;678493
93;2020-08-29;17;20;37;336327;296459;69;632786
93;2020-08-29;14;9;23;279820;229699;79;509519
93;2020-08-29;10;8;18;171274;113716;89;284990
93;2020-08-29;8;3;11;58896;21758;90;80654
93;2020-08-29;243;214;457;2639673;2415978;0;5055651
94;2020-08-29;0;0;0;16311;17433;09;33744
94;2020-08-29;2;0;2;16679;18132;19;34811
94;2020-08-29;3;0;3;16782;16579;29;33361
94;2020-08-29;4;1;5;23044;20580;39;43624
94;2020-08-29;0;0;0;23065;22140;49;45205
94;2020-08-29;0;0;0;24549;23421;59;47970
94;2020-08-29;0;0;0;23212;21883;69;45095
94;2020-08-29;0;2;2;19544;17141;79;36685
94;2020-08-29;0;0;0;11227;8178;89;19405
94;2020-08-29;0;0;0;3332;1447;90;4779
94;2020-08-29;9;3;12;177745;166934;0;344679
01;2020-08-30;0;0;0;19979;20155;09;40134
01;2020-08-30;0;2;2;24994;25489;19;50483
01;2020-08-30;3;1;4;17868;16690;29;34558
01;2020-08-30;3;1;4;22328;14821;39;37149
01;2020-08-30;1;1;2;28652;20276;49;48928
01;2020-08-30;3;2;5;33264;27260;59;60524
01;2020-08-30;1;1;2;27135;23978;69;51113
01;2020-08-30;1;0;1;18401;14661;79;33062
01;2020-08-30;0;0;0;9633;6375;89;16008
01;2020-08-30;0;0;0;3410;1510;90;4920
01;2020-08-30;12;8;20;205664;171215;0;376879
02;2020-08-30;0;0;0;16881;17110;09;33991
02;2020-08-30;0;0;0;21410;21604;19;43014
02;2020-08-30;0;0;0;16017;15479;29;31496
02;2020-08-30;0;0;0;19825;14455;39;34280
02;2020-08-30;0;0;0;24719;18248;49;42967
02;2020-08-30;0;0;0;34361;28310;59;62671
02;2020-08-30;0;0;0;28061;24495;69;52556
02;2020-08-30;0;0;0;18231;15278;79;33509
02;2020-08-30;0;0;0;11090;7677;89;18767
02;2020-08-30;0;0;0;3992;1506;90;5498
02;2020-08-30;0;0;0;194587;164162;0;358749
03;2020-08-30;0;1;1;31123;30920;09;62043
03;2020-08-30;0;1;1;29370;29268;19;58638
03;2020-08-30;2;2;4;21458;18963;29;40421
03;2020-08-30;0;0;0;21276;18326;39;39602
03;2020-08-30;0;1;1;18164;16593;49;34757
03;2020-08-30;0;0;0;13469;13557;59;27026
03;2020-08-30;0;0;0;8776;8670;69;17446
03;2020-08-30;0;0;0;3777;3591;79;7368
03;2020-08-30;0;0;0;1649;1072;89;2721
03;2020-08-30;1;0;1;485;184;90;669
03;2020-08-30;3;5;8;149547;141144;0;290691
04;2020-08-30;2;0;2;60314;61377;09;121691
04;2020-08-30;7;2;9;66065;68387;19;134452
04;2020-08-30;1;2;3;51059;47156;29;98215
04;2020-08-30;3;2;5;58788;45780;39;104568
04;2020-08-30;3;3;6;61408;52207;49;113615
04;2020-08-30;1;0;1;64838;60759;59;125597
04;2020-08-30;0;2;2;47008;42843;69;89851
04;2020-08-30;0;0;0;25509;21184;79;46693
04;2020-08-30;1;0;1;13168;7647;89;20815
04;2020-08-30;0;0;0;3209;1253;90;4462
04;2020-08-30;18;11;29;451366;408593;0;859959
05;2020-08-30;0;0;0;362.366008612902;341.338819562748;09;703.704828175651
05;2020-08-30;0;0;0;353.376145114279;370.349735405642;19;723.725880519921
05;2020-08-30;0;0;0;218.593559489256;256.539602589476;29;475.133162078732
05;2020-08-30;0;0;0;404.225408693299;360.321910454353;39;764.547319147651
05;2020-08-30;0;0;0;520.067953604221;497.108383964256;49;1017.17633756848
05;2020-08-30;0;0;0;468.146063921917;510.087601910415;59;978.233665832332
05;2020-08-30;0;0;0;340.368470050554;334.366842191253;69;674.735312241807
05;2020-08-30;0;0;0;212.598666888387;192.597753227106;79;405.196420115493
05;2020-08-30;0;0;0;148.727797095705;61.8681715431829;89;210.595968638888
05;2020-08-30;0;0;0;32.9601271090696;10.9909785719784;90;43.9511056810479
05;2020-08-30;0;0;0;3061.43020057959;2935.56979942041;0;5997
06;2020-08-30;0;0;0;42583;42380;09;84963
06;2020-08-30;0;1;1;33369;31925;19;65294
06;2020-08-30;1;0;1;21571;15080;29;36651
06;2020-08-30;0;0;0;21550;16147;39;37697
06;2020-08-30;1;0;1;14193;13939;49;28132
06;2020-08-30;0;0;0;7171;7597;59;14768
06;2020-08-30;0;0;0;3629;4117;69;7746
06;2020-08-30;0;0;0;1577;1457;79;3034
06;2020-08-30;0;0;0;531;474;89;1005
06;2020-08-30;0;0;0;88;93;90;181
06;2020-08-30;2;1;3;146262;133209;0;279471
07;2020-08-30;0;0;0;485;549;09;1034
07;2020-08-30;0;0;0;403;432;19;835
07;2020-08-30;0;0;0;764;841;29;1605
07;2020-08-30;0;0;0;824;928;39;1752
07;2020-08-30;0;0;0;788;1020;49;1808
07;2020-08-30;0;0;0;678;870;59;1548
07;2020-08-30;0;0;0;360;382;69;742
07;2020-08-30;0;0;0;231;190;79;421
07;2020-08-30;0;0;0;114;67;89;181
07;2020-08-30;0;0;0;24;11;90;35
07;2020-08-30;0;0;0;4671;5290;0;9961
08;2020-08-30;0;0;0;2715.22592983026;2997.75551488675;09;5712.98144471701
08;2020-08-30;0;1;1;2778.51901080978;3160.9156459093;19;5939.43465671908
08;2020-08-30;0;0;0;2080.8882988764;1718.16634315323;29;3799.05464202964
08;2020-08-30;0;0;0;2701.8582062647;1896.52641413317;39;4598.38462039786
08;2020-08-30;0;0;0;3151.45861023308;2460.52498233809;49;5611.98359257117
08;2020-08-30;0;1;1;2620.29868333099;2422.23566154656;59;5042.53434487755
08;2020-08-30;0;0;0;1621.44173420671;1438.58325779464;69;3060.02499200135
08;2020-08-30;0;0;0;626.575909335673;526.358467843651;79;1152.93437717932
08;2020-08-30;0;0;0;205.018522985054;140.993639349697;89;346.012162334751
08;2020-08-30;0;0;0;50.0325684687745;20.62259870351;90;70.6551671722846
08;2020-08-30;0;2;2;18551.3174743414;16782.6825256586;0;35334
11;2020-08-30;2;2;4;783071;811785;09;1594856
11;2020-08-30;12;14;26;761456;784653;19;1546109
11;2020-08-30;75;77;152;850145;801772;29;1651917
11;2020-08-30;32;32;64;914360;843488;39;1757848
11;2020-08-30;29;17;46;845609;826202;49;1671811
11;2020-08-30;23;12;35;793566;745070;59;1538636
11;2020-08-30;14;11;25;628649;549192;69;1177841
11;2020-08-30;2;11;13;434606;358356;79;792962
11;2020-08-30;8;3;11;261425;162933;89;424358
11;2020-08-30;5;1;6;89253;32619;90;121872
11;2020-08-30;202;180;383;6362140;5916070;0;12278210
24;2020-08-30;2;1;3;139720;144686;09;284406
24;2020-08-30;2;2;4;152979;161185;19;314164
24;2020-08-30;4;3;7;122237;126536;29;248773
24;2020-08-30;4;1;5;150359;142009;39;292368
24;2020-08-30;0;1;1;161829;158758;49;320587
24;2020-08-30;0;1;1;172552;168011;59;340563
24;2020-08-30;1;1;2;172509;158177;69;330686
24;2020-08-30;0;0;0;129428;110593;79;240021
24;2020-08-30;0;0;0;87342;56882;89;144224
24;2020-08-30;0;0;0;31210;12071;90;43281
24;2020-08-30;13;10;23;1320165;1238908;0;2559073
27;2020-08-30;0;2;2;143373;149679;09;293052
27;2020-08-30;2;4;6;160962;173003;19;333965
27;2020-08-30;5;4;9;133746;142254;29;276000
27;2020-08-30;1;7;8;160004;155407;39;315411
27;2020-08-30;3;1;4;172333;169564;49;341897
27;2020-08-30;2;2;4;189979;183788;59;373767
27;2020-08-30;0;0;0;192591;178206;69;370797
27;2020-08-30;0;1;1;146876;127546;79;274422
27;2020-08-30;0;0;0;96896;61575;89;158471
27;2020-08-30;0;0;0;33148;12109;90;45257
27;2020-08-30;13;21;34;1429908;1353131;0;2783039
28;2020-08-30;5;2;7;180735;186856;09;367591
28;2020-08-30;5;10;15;200125;213621;19;413746
28;2020-08-30;16;11;27;168922;173007;29;341929
28;2020-08-30;8;13;21;196628;188487;39;385115
28;2020-08-30;5;6;11;205396;201699;49;407095
28;2020-08-30;3;2;5;222002;213866;59;435868
28;2020-08-30;1;1;2;224688;203758;69;428446
28;2020-08-30;0;1;1;163192;135543;79;298735
28;2020-08-30;0;2;2;109691;65377;89;175068
28;2020-08-30;0;0;0;37222;12685;90;49907
28;2020-08-30;43;48;91;1708601;1594899;0;3303500
32;2020-08-30;1;1;2;358062;373689;09;731751
32;2020-08-30;4;3;7;387045;406742;19;793787
32;2020-08-30;4;5;9;342304;348587;29;690891
32;2020-08-30;5;9;14;382485;369972;39;752457
32;2020-08-30;0;3;3;382510;376716;49;759226
32;2020-08-30;2;3;5;386937;376527;59;763464
32;2020-08-30;0;0;0;371211;330938;69;702149
32;2020-08-30;0;2;2;250542;201459;79;452001
32;2020-08-30;0;2;2;163399;89786;89;253185
32;2020-08-30;2;0;2;48384;15367;90;63751
32;2020-08-30;18;28;46;3072879;2889783;0;5962662
44;2020-08-30;0;1;1;291525;306839;09;598364
44;2020-08-30;1;2;3;320255;339504;19;659759
44;2020-08-30;5;4;9;302020;314428;29;616448
44;2020-08-30;2;4;6;342222;333292;39;675514
44;2020-08-30;3;0;3;349727;344491;49;694218
44;2020-08-30;2;1;3;381371;373239;59;754610
44;2020-08-30;1;0;1;367165;335850;69;703015
44;2020-08-30;0;1;1;250387;215436;79;465823
44;2020-08-30;0;0;0;170825;105192;89;276017
44;2020-08-30;2;1;3;51248;16731;90;67979
44;2020-08-30;16;14;30;2826745;2685002;0;5511747
52;2020-08-30;0;0;0;213594;223900;09;437494
52;2020-08-30;4;0;4;240818;255197;19;496015
52;2020-08-30;5;2;7;197010;200630;29;397640
52;2020-08-30;1;4;5;231204;224885;39;456089
52;2020-08-30;3;1;4;243874;243418;49;487292
52;2020-08-30;0;0;0;244100;239116;59;483216
52;2020-08-30;2;0;2;241796;221345;69;463141
52;2020-08-30;0;0;0;177805;149903;79;327708
52;2020-08-30;3;1;4;119561;75822;89;195383
52;2020-08-30;1;0;1;42559;15260;90;57819
52;2020-08-30;19;8;27;1952321;1849476;0;3801797
53;2020-08-30;0;0;0;173813;182358;09;356171
53;2020-08-30;2;1;3;202720;214740;19;417460
53;2020-08-30;9;10;19;163116;173196;29;336312
53;2020-08-30;3;3;6;190526;187674;39;378200
53;2020-08-30;2;1;3;212098;212015;49;424113
53;2020-08-30;0;0;0;223699;219176;59;442875
53;2020-08-30;0;0;0;227435;209274;69;436709
53;2020-08-30;0;0;0;169992;140910;79;310902
53;2020-08-30;0;0;0;118117;69883;89;188000
53;2020-08-30;1;0;1;37370;12267;90;49637
53;2020-08-30;17;15;32;1718886;1621493;0;3340379
75;2020-08-30;3;4;7;293104;305291;09;598395
75;2020-08-30;12;6;18;337141;357785;19;694926
75;2020-08-30;28;36;64;295024;300618;29;595642
75;2020-08-30;10;16;26;347871;331233;39;679104
75;2020-08-30;11;8;19;384742;372771;49;757513
75;2020-08-30;6;8;14;413361;390880;59;804241
75;2020-08-30;2;1;3;425623;384060;69;809683
75;2020-08-30;0;0;0;325086;276298;79;601384
75;2020-08-30;0;1;1;213986;139308;89;353294
75;2020-08-30;0;0;0;77600;28200;90;105800
75;2020-08-30;72;80;152;3113538;2886444;0;5999982
76;2020-08-30;3;3;6;305956;318589;09;624545
76;2020-08-30;9;12;21;338942;356969;19;695911
76;2020-08-30;12;14;27;316210;319570;29;635780
76;2020-08-30;15;14;29;356758;337587;39;694345
76;2020-08-30;5;10;15;376541;363812;49;740353
76;2020-08-30;9;5;14;402608;383750;59;786358
76;2020-08-30;2;3;5;394889;358997;69;753886
76;2020-08-30;1;4;5;308664;263806;79;572470
76;2020-08-30;3;0;3;195838;129272;89;325110
76;2020-08-30;0;0;0;69372;26728;90;96100
76;2020-08-30;59;65;125;3065778;2859080;0;5924858
84;2020-08-30;1;1;2;459549;481088;09;940637
84;2020-08-30;5;6;11;487711;511905;19;999616
84;2020-08-30;21;21;42;443824;451094;29;894918
84;2020-08-30;5;5;10;512522;493262;39;1005784
84;2020-08-30;10;5;15;520248;515106;49;1035354
84;2020-08-30;3;6;9;529611;514848;59;1044459
84;2020-08-30;1;1;2;486720;439940;69;926660
84;2020-08-30;6;1;7;372151;315211;79;687362
84;2020-08-30;2;1;3;237198;150524;89;387722
84;2020-08-30;1;0;1;81185;28680;90;109865
84;2020-08-30;55;47;102;4130719;3901658;0;8032377
93;2020-08-30;2;4;6;268834;283093;09;551927
93;2020-08-30;7;3;10;280751;296087;19;576838
93;2020-08-30;9;13;22;254404;255552;29;509956
93;2020-08-30;13;11;24;310704;288398;39;599102
93;2020-08-30;9;8;17;325559;305827;49;631386
93;2020-08-30;2;6;8;353104;325389;59;678493
93;2020-08-30;4;4;8;336327;296459;69;632786
93;2020-08-30;2;3;5;279820;229699;79;509519
93;2020-08-30;0;3;3;171274;113716;89;284990
93;2020-08-30;2;0;2;58896;21758;90;80654
93;2020-08-30;50;55;105;2639673;2415978;0;5055651
94;2020-08-30;0;0;0;16311;17433;09;33744
94;2020-08-30;0;0;0;16679;18132;19;34811
94;2020-08-30;1;1;2;16782;16579;29;33361
94;2020-08-30;1;0;1;23044;20580;39;43624
94;2020-08-30;1;0;1;23065;22140;49;45205
94;2020-08-30;0;1;1;24549;23421;59;47970
94;2020-08-30;0;0;0;23212;21883;69;45095
94;2020-08-30;0;0;0;19544;17141;79;36685
94;2020-08-30;0;0;0;11227;8178;89;19405
94;2020-08-30;0;0;0;3332;1447;90;4779
94;2020-08-30;3;2;5;177745;166934;0;344679
01;2020-08-31;1;2;3;19979;20155;09;40134
01;2020-08-31;11;4;15;24994;25489;19;50483
01;2020-08-31;28;25;53;17868;16690;29;34558
01;2020-08-31;26;27;53;22328;14821;39;37149
01;2020-08-31;21;18;39;28652;20276;49;48928
01;2020-08-31;20;10;30;33264;27260;59;60524
01;2020-08-31;17;11;28;27135;23978;69;51113
01;2020-08-31;4;4;8;18401;14661;79;33062
01;2020-08-31;1;0;1;9633;6375;89;16008
01;2020-08-31;0;0;0;3410;1510;90;4920
01;2020-08-31;129;101;230;205664;171215;0;376879
02;2020-08-31;1;0;1;16881;17110;09;33991
02;2020-08-31;3;4;7;21410;21604;19;43014
02;2020-08-31;4;7;11;16017;15479;29;31496
02;2020-08-31;6;6;12;19825;14455;39;34280
02;2020-08-31;4;3;7;24719;18248;49;42967
02;2020-08-31;3;5;8;34361;28310;59;62671
02;2020-08-31;2;0;2;28061;24495;69;52556
02;2020-08-31;1;1;2;18231;15278;79;33509
02;2020-08-31;0;0;0;11090;7677;89;18767
02;2020-08-31;0;0;0;3992;1506;90;5498
02;2020-08-31;24;26;50;194587;164162;0;358749
03;2020-08-31;1;4;5;31123;30920;09;62043
03;2020-08-31;11;11;22;29370;29268;19;58638
03;2020-08-31;6;4;10;21458;18963;29;40421
03;2020-08-31;6;2;8;21276;18326;39;39602
03;2020-08-31;5;2;7;18164;16593;49;34757
03;2020-08-31;5;1;6;13469;13557;59;27026
03;2020-08-31;2;2;4;8776;8670;69;17446
03;2020-08-31;0;1;1;3777;3591;79;7368
03;2020-08-31;0;0;0;1649;1072;89;2721
03;2020-08-31;0;0;0;485;184;90;669
03;2020-08-31;36;28;64;149547;141144;0;290691
04;2020-08-31;3;8;11;60314;61377;09;121691
04;2020-08-31;13;9;22;66065;68387;19;134452
04;2020-08-31;10;7;17;51059;47156;29;98215
04;2020-08-31;11;4;15;58788;45780;39;104568
04;2020-08-31;13;7;20;61408;52207;49;113615
04;2020-08-31;9;8;17;64838;60759;59;125597
04;2020-08-31;5;3;8;47008;42843;69;89851
04;2020-08-31;4;2;6;25509;21184;79;46693
04;2020-08-31;0;1;1;13168;7647;89;20815
04;2020-08-31;0;0;0;3209;1253;90;4462
04;2020-08-31;68;49;117;451366;408593;0;859959
05;2020-08-31;0;0;0;362.366008612902;341.338819562748;09;703.704828175651
05;2020-08-31;0;0;0;353.376145114279;370.349735405642;19;723.725880519921
05;2020-08-31;0;0;0;218.593559489256;256.539602589476;29;475.133162078732
05;2020-08-31;0;0;0;404.225408693299;360.321910454353;39;764.547319147651
05;2020-08-31;0;0;0;520.067953604221;497.108383964256;49;1017.17633756848
05;2020-08-31;0;0;0;468.146063921917;510.087601910415;59;978.233665832332
05;2020-08-31;0;0;0;340.368470050554;334.366842191253;69;674.735312241807
05;2020-08-31;0;0;0;212.598666888387;192.597753227106;79;405.196420115493
05;2020-08-31;0;0;0;148.727797095705;61.8681715431829;89;210.595968638888
05;2020-08-31;0;0;0;32.9601271090696;10.9909785719784;90;43.9511056810479
05;2020-08-31;0;0;0;3061.43020057959;2935.56979942041;0;5997
06;2020-08-31;0;0;0;42583;42380;09;84963
06;2020-08-31;3;1;4;33369;31925;19;65294
06;2020-08-31;2;1;3;21571;15080;29;36651
06;2020-08-31;3;1;4;21550;16147;39;37697
06;2020-08-31;1;0;1;14193;13939;49;28132
06;2020-08-31;2;0;2;7171;7597;59;14768
06;2020-08-31;0;2;2;3629;4117;69;7746
06;2020-08-31;1;0;1;1577;1457;79;3034
06;2020-08-31;0;0;0;531;474;89;1005
06;2020-08-31;0;0;0;88;93;90;181
06;2020-08-31;12;5;17;146262;133209;0;279471
07;2020-08-31;0;0;0;485;549;09;1034
07;2020-08-31;0;0;0;403;432;19;835
07;2020-08-31;0;0;0;764;841;29;1605
07;2020-08-31;0;0;0;824;928;39;1752
07;2020-08-31;0;0;0;788;1020;49;1808
07;2020-08-31;0;0;0;678;870;59;1548
07;2020-08-31;0;0;0;360;382;69;742
07;2020-08-31;0;0;0;231;190;79;421
07;2020-08-31;0;0;0;114;67;89;181
07;2020-08-31;0;0;0;24;11;90;35
07;2020-08-31;0;0;0;4671;5290;0;9961
08;2020-08-31;0;0;0;2715.22592983026;2997.75551488675;09;5712.98144471701
08;2020-08-31;0;1;1;2778.51901080978;3160.9156459093;19;5939.43465671908
08;2020-08-31;0;1;1;2080.8882988764;1718.16634315323;29;3799.05464202964
08;2020-08-31;1;0;1;2701.8582062647;1896.52641413317;39;4598.38462039786
08;2020-08-31;3;0;3;3151.45861023308;2460.52498233809;49;5611.98359257117
08;2020-08-31;0;4;4;2620.29868333099;2422.23566154656;59;5042.53434487755
08;2020-08-31;0;0;0;1621.44173420671;1438.58325779464;69;3060.02499200135
08;2020-08-31;0;0;0;626.575909335673;526.358467843651;79;1152.93437717932
08;2020-08-31;0;0;0;205.018522985054;140.993639349697;89;346.012162334751
08;2020-08-31;0;0;0;50.0325684687745;20.62259870351;90;70.6551671722846
08;2020-08-31;4;6;10;18551.3174743414;16782.6825256586;0;35334
11;2020-08-31;40;42;89;783071;811785;09;1594856
11;2020-08-31;183;134;328;761456;784653;19;1546109
11;2020-08-31;515;518;1038;850145;801772;29;1651917
11;2020-08-31;266;289;557;914360;843488;39;1757848
11;2020-08-31;167;165;334;845609;826202;49;1671811
11;2020-08-31;145;95;242;793566;745070;59;1538636
11;2020-08-31;89;79;168;628649;549192;69;1177841
11;2020-08-31;35;44;79;434606;358356;79;792962
11;2020-08-31;11;6;18;261425;162933;89;424358
11;2020-08-31;8;3;11;89253;32619;90;121872
11;2020-08-31;1459;1375;2864;6362140;5916070;0;12278210
24;2020-08-31;1;4;5;139720;144686;09;284406
24;2020-08-31;14;6;20;152979;161185;19;314164
24;2020-08-31;26;40;66;122237;126536;29;248773
24;2020-08-31;16;19;35;150359;142009;39;292368
24;2020-08-31;9;12;21;161829;158758;49;320587
24;2020-08-31;14;6;20;172552;168011;59;340563
24;2020-08-31;3;7;10;172509;158177;69;330686
24;2020-08-31;3;2;5;129428;110593;79;240021
24;2020-08-31;0;0;0;87342;56882;89;144224
24;2020-08-31;0;0;0;31210;12071;90;43281
24;2020-08-31;86;96;182;1320165;1238908;0;2559073
27;2020-08-31;2;3;5;143373;149679;09;293052
27;2020-08-31;15;14;29;160962;173003;19;333965
27;2020-08-31;27;31;58;133746;142254;29;276000
27;2020-08-31;11;15;26;160004;155407;39;315411
27;2020-08-31;7;10;17;172333;169564;49;341897
27;2020-08-31;15;7;22;189979;183788;59;373767
27;2020-08-31;4;6;10;192591;178206;69;370797
27;2020-08-31;4;3;7;146876;127546;79;274422
27;2020-08-31;8;4;12;96896;61575;89;158471
27;2020-08-31;6;2;8;33148;12109;90;45257
27;2020-08-31;99;95;194;1429908;1353131;0;2783039
28;2020-08-31;1;5;6;180735;186856;09;367591
28;2020-08-31;15;23;38;200125;213621;19;413746
28;2020-08-31;40;40;80;168922;173007;29;341929
28;2020-08-31;15;24;39;196628;188487;39;385115
28;2020-08-31;18;12;30;205396;201699;49;407095
28;2020-08-31;16;8;24;222002;213866;59;435868
28;2020-08-31;11;8;19;224688;203758;69;428446
28;2020-08-31;2;3;5;163192;135543;79;298735
28;2020-08-31;5;0;5;109691;65377;89;175068
28;2020-08-31;2;2;4;37222;12685;90;49907
28;2020-08-31;125;125;250;1708601;1594899;0;3303500
32;2020-08-31;8;8;16;358062;373689;09;731751
32;2020-08-31;54;51;105;387045;406742;19;793787
32;2020-08-31;73;79;153;342304;348587;29;690891
32;2020-08-31;39;40;79;382485;369972;39;752457
32;2020-08-31;29;27;56;382510;376716;49;759226
32;2020-08-31;21;21;42;386937;376527;59;763464
32;2020-08-31;17;8;25;371211;330938;69;702149
32;2020-08-31;14;10;24;250542;201459;79;452001
32;2020-08-31;2;3;5;163399;89786;89;253185
32;2020-08-31;1;0;1;48384;15367;90;63751
32;2020-08-31;258;247;506;3072879;2889783;0;5962662
44;2020-08-31;10;6;16;291525;306839;09;598364
44;2020-08-31;24;25;49;320255;339504;19;659759
44;2020-08-31;53;60;113;302020;314428;29;616448
44;2020-08-31;28;34;62;342222;333292;39;675514
44;2020-08-31;26;22;48;349727;344491;49;694218
44;2020-08-31;19;14;33;381371;373239;59;754610
44;2020-08-31;20;11;31;367165;335850;69;703015
44;2020-08-31;6;10;16;250387;215436;79;465823
44;2020-08-31;4;2;6;170825;105192;89;276017
44;2020-08-31;1;0;1;51248;16731;90;67979
44;2020-08-31;191;184;375;2826745;2685002;0;5511747
52;2020-08-31;5;6;11;213594;223900;09;437494
52;2020-08-31;28;13;41;240818;255197;19;496015
52;2020-08-31;41;42;83;197010;200630;29;397640
52;2020-08-31;9;17;26;231204;224885;39;456089
52;2020-08-31;20;18;38;243874;243418;49;487292
52;2020-08-31;14;11;25;244100;239116;59;483216
52;2020-08-31;8;11;19;241796;221345;69;463141
52;2020-08-31;3;0;3;177805;149903;79;327708
52;2020-08-31;3;7;11;119561;75822;89;195383
52;2020-08-31;1;0;1;42559;15260;90;57819
52;2020-08-31;132;125;258;1952321;1849476;0;3801797
53;2020-08-31;1;4;5;173813;182358;09;356171
53;2020-08-31;15;18;33;202720;214740;19;417460
53;2020-08-31;38;40;78;163116;173196;29;336312
53;2020-08-31;11;11;22;190526;187674;39;378200
53;2020-08-31;15;7;22;212098;212015;49;424113
53;2020-08-31;12;3;15;223699;219176;59;442875
53;2020-08-31;2;5;7;227435;209274;69;436709
53;2020-08-31;2;5;7;169992;140910;79;310902
53;2020-08-31;1;2;3;118117;69883;89;188000
53;2020-08-31;0;0;0;37370;12267;90;49637
53;2020-08-31;97;95;192;1718886;1621493;0;3340379
75;2020-08-31;11;12;24;293104;305291;09;598395
75;2020-08-31;51;49;100;337141;357785;19;694926
75;2020-08-31;105;137;242;295024;300618;29;595642
75;2020-08-31;66;57;123;347871;331233;39;679104
75;2020-08-31;47;47;94;384742;372771;49;757513
75;2020-08-31;43;27;70;413361;390880;59;804241
75;2020-08-31;17;27;44;425623;384060;69;809683
75;2020-08-31;4;9;13;325086;276298;79;601384
75;2020-08-31;4;6;10;213986;139308;89;353294
75;2020-08-31;2;0;2;77600;28200;90;105800
75;2020-08-31;351;372;724;3113538;2886444;0;5999982
76;2020-08-31;11;9;20;305956;318589;09;624545
76;2020-08-31;38;40;80;338942;356969;19;695911
76;2020-08-31;92;111;203;316210;319570;29;635780
76;2020-08-31;55;62;117;356758;337587;39;694345
76;2020-08-31;43;41;84;376541;363812;49;740353
76;2020-08-31;44;33;77;402608;383750;59;786358
76;2020-08-31;16;24;40;394889;358997;69;753886
76;2020-08-31;8;13;21;308664;263806;79;572470
76;2020-08-31;8;4;12;195838;129272;89;325110
76;2020-08-31;4;3;7;69372;26728;90;96100
76;2020-08-31;320;340;662;3065778;2859080;0;5924858
84;2020-08-31;18;23;43;459549;481088;09;940637
84;2020-08-31;56;61;117;487711;511905;19;999616
84;2020-08-31;164;159;323;443824;451094;29;894918
84;2020-08-31;93;98;191;512522;493262;39;1005784
84;2020-08-31;60;63;123;520248;515106;49;1035354
84;2020-08-31;55;47;102;529611;514848;59;1044459
84;2020-08-31;33;30;63;486720;439940;69;926660
84;2020-08-31;21;16;37;372151;315211;79;687362
84;2020-08-31;6;9;15;237198;150524;89;387722
84;2020-08-31;10;4;14;81185;28680;90;109865
84;2020-08-31;516;510;1028;4130719;3901658;0;8032377
93;2020-08-31;30;30;60;268834;283093;09;551927
93;2020-08-31;106;82;189;280751;296087;19;576838
93;2020-08-31;208;201;409;254404;255552;29;509956
93;2020-08-31;121;129;251;310704;288398;39;599102
93;2020-08-31;123;100;224;325559;305827;49;631386
93;2020-08-31;111;92;203;353104;325389;59;678493
93;2020-08-31;74;75;149;336327;296459;69;632786
93;2020-08-31;27;22;49;279820;229699;79;509519
93;2020-08-31;13;8;21;171274;113716;89;284990
93;2020-08-31;14;6;20;58896;21758;90;80654
93;2020-08-31;827;745;1575;2639673;2415978;0;5055651
94;2020-08-31;2;0;2;16311;17433;09;33744
94;2020-08-31;4;2;6;16679;18132;19;34811
94;2020-08-31;6;9;15;16782;16579;29;33361
94;2020-08-31;4;3;7;23044;20580;39;43624
94;2020-08-31;3;5;8;23065;22140;49;45205
94;2020-08-31;4;4;8;24549;23421;59;47970
94;2020-08-31;2;3;5;23212;21883;69;45095
94;2020-08-31;2;1;3;19544;17141;79;36685
94;2020-08-31;0;0;0;11227;8178;89;19405
94;2020-08-31;0;0;0;3332;1447;90;4779
94;2020-08-31;27;27;54;177745;166934;0;344679
01;2020-09-01;1;2;3;19979;20155;09;40134
01;2020-09-01;4;11;15;24994;25489;19;50483
01;2020-09-01;19;15;34;17868;16690;29;34558
01;2020-09-01;18;14;32;22328;14821;39;37149
01;2020-09-01;15;15;30;28652;20276;49;48928
01;2020-09-01;15;10;25;33264;27260;59;60524
01;2020-09-01;10;8;18;27135;23978;69;51113
01;2020-09-01;4;2;6;18401;14661;79;33062
01;2020-09-01;4;1;5;9633;6375;89;16008
01;2020-09-01;0;0;0;3410;1510;90;4920
01;2020-09-01;90;78;168;205664;171215;0;376879
02;2020-09-01;0;0;0;16881;17110;09;33991
02;2020-09-01;2;1;3;21410;21604;19;43014
02;2020-09-01;3;5;8;16017;15479;29;31496
02;2020-09-01;4;3;7;19825;14455;39;34280
02;2020-09-01;1;1;2;24719;18248;49;42967
02;2020-09-01;3;1;4;34361;28310;59;62671
02;2020-09-01;1;3;4;28061;24495;69;52556
02;2020-09-01;0;1;1;18231;15278;79;33509
02;2020-09-01;0;1;1;11090;7677;89;18767
02;2020-09-01;0;0;0;3992;1506;90;5498
02;2020-09-01;14;16;30;194587;164162;0;358749
03;2020-09-01;1;0;1;31123;30920;09;62043
03;2020-09-01;12;4;16;29370;29268;19;58638
03;2020-09-01;4;6;10;21458;18963;29;40421
03;2020-09-01;2;2;4;21276;18326;39;39602
03;2020-09-01;4;3;7;18164;16593;49;34757
03;2020-09-01;1;1;2;13469;13557;59;27026
03;2020-09-01;2;1;3;8776;8670;69;17446
03;2020-09-01;0;0;0;3777;3591;79;7368
03;2020-09-01;0;0;0;1649;1072;89;2721
03;2020-09-01;0;0;0;485;184;90;669
03;2020-09-01;26;17;43;149547;141144;0;290691
04;2020-09-01;8;5;13;60314;61377;09;121691
04;2020-09-01;10;10;20;66065;68387;19;134452
04;2020-09-01;16;10;26;51059;47156;29;98215
04;2020-09-01;10;4;14;58788;45780;39;104568
04;2020-09-01;9;9;18;61408;52207;49;113615
04;2020-09-01;10;9;19;64838;60759;59;125597
04;2020-09-01;6;5;11;47008;42843;69;89851
04;2020-09-01;2;3;5;25509;21184;79;46693
04;2020-09-01;0;2;2;13168;7647;89;20815
04;2020-09-01;0;0;0;3209;1253;90;4462
04;2020-09-01;71;57;128;451366;408593;0;859959
05;2020-09-01;0;0;0;362.366008612902;341.338819562748;09;703.704828175651
05;2020-09-01;0;0;0;353.376145114279;370.349735405642;19;723.725880519921
05;2020-09-01;0;0;0;218.593559489256;256.539602589476;29;475.133162078732
05;2020-09-01;0;0;0;404.225408693299;360.321910454353;39;764.547319147651
05;2020-09-01;0;0;0;520.067953604221;497.108383964256;49;1017.17633756848
05;2020-09-01;0;0;0;468.146063921917;510.087601910415;59;978.233665832332
05;2020-09-01;0;0;0;340.368470050554;334.366842191253;69;674.735312241807
05;2020-09-01;0;0;0;212.598666888387;192.597753227106;79;405.196420115493
05;2020-09-01;0;0;0;148.727797095705;61.8681715431829;89;210.595968638888
05;2020-09-01;0;0;0;32.9601271090696;10.9909785719784;90;43.9511056810479
05;2020-09-01;0;0;0;3061.43020057959;2935.56979942041;0;5997
06;2020-09-01;0;1;1;42583;42380;09;84963
06;2020-09-01;1;3;4;33369;31925;19;65294
06;2020-09-01;5;5;10;21571;15080;29;36651
06;2020-09-01;0;1;1;21550;16147;39;37697
06;2020-09-01;0;1;1;14193;13939;49;28132
06;2020-09-01;1;0;1;7171;7597;59;14768
06;2020-09-01;0;1;1;3629;4117;69;7746
06;2020-09-01;0;0;0;1577;1457;79;3034
06;2020-09-01;0;0;0;531;474;89;1005
06;2020-09-01;0;0;0;88;93;90;181
06;2020-09-01;7;12;19;146262;133209;0;279471
07;2020-09-01;0;0;0;485;549;09;1034
07;2020-09-01;0;0;0;403;432;19;835
07;2020-09-01;0;1;1;764;841;29;1605
07;2020-09-01;0;0;0;824;928;39;1752
07;2020-09-01;0;0;0;788;1020;49;1808
07;2020-09-01;0;0;0;678;870;59;1548
07;2020-09-01;0;1;1;360;382;69;742
07;2020-09-01;0;0;0;231;190;79;421
07;2020-09-01;0;0;0;114;67;89;181
07;2020-09-01;0;0;0;24;11;90;35
07;2020-09-01;0;2;2;4671;5290;0;9961
08;2020-09-01;0;0;0;2715.22592983026;2997.75551488675;09;5712.98144471701
08;2020-09-01;0;0;0;2778.51901080978;3160.9156459093;19;5939.43465671908
08;2020-09-01;0;0;0;2080.8882988764;1718.16634315323;29;3799.05464202964
08;2020-09-01;1;1;2;2701.8582062647;1896.52641413317;39;4598.38462039786
08;2020-09-01;0;0;0;3151.45861023308;2460.52498233809;49;5611.98359257117
08;2020-09-01;0;2;2;2620.29868333099;2422.23566154656;59;5042.53434487755
08;2020-09-01;0;0;0;1621.44173420671;1438.58325779464;69;3060.02499200135
08;2020-09-01;0;0;0;626.575909335673;526.358467843651;79;1152.93437717932
08;2020-09-01;0;0;0;205.018522985054;140.993639349697;89;346.012162334751
08;2020-09-01;0;0;0;50.0325684687745;20.62259870351;90;70.6551671722846
08;2020-09-01;1;3;4;18551.3174743414;16782.6825256586;0;35334
11;2020-09-01;31;34;65;783071;811785;09;1594856
11;2020-09-01;149;140;293;761456;784653;19;1546109
11;2020-09-01;479;445;928;850145;801772;29;1651917
11;2020-09-01;284;245;530;914360;843488;39;1757848
11;2020-09-01;157;162;324;845609;826202;49;1671811
11;2020-09-01;148;107;256;793566;745070;59;1538636
11;2020-09-01;82;61;144;628649;549192;69;1177841
11;2020-09-01;36;32;68;434606;358356;79;792962
11;2020-09-01;12;11;24;261425;162933;89;424358
11;2020-09-01;6;2;8;89253;32619;90;121872
11;2020-09-01;1387;1240;2646;6362140;5916070;0;12278210
24;2020-09-01;2;4;7;139720;144686;09;284406
24;2020-09-01;14;11;26;152979;161185;19;314164
24;2020-09-01;29;28;57;122237;126536;29;248773
24;2020-09-01;12;12;24;150359;142009;39;292368
24;2020-09-01;10;9;19;161829;158758;49;320587
24;2020-09-01;14;3;17;172552;168011;59;340563
24;2020-09-01;5;7;12;172509;158177;69;330686
24;2020-09-01;1;3;4;129428;110593;79;240021
24;2020-09-01;1;0;1;87342;56882;89;144224
24;2020-09-01;0;0;0;31210;12071;90;43281
24;2020-09-01;88;77;167;1320165;1238908;0;2559073
27;2020-09-01;4;0;4;143373;149679;09;293052
27;2020-09-01;11;15;26;160962;173003;19;333965
27;2020-09-01;32;29;61;133746;142254;29;276000
27;2020-09-01;11;9;20;160004;155407;39;315411
27;2020-09-01;20;9;29;172333;169564;49;341897
27;2020-09-01;11;14;25;189979;183788;59;373767
27;2020-09-01;7;2;9;192591;178206;69;370797
27;2020-09-01;6;4;10;146876;127546;79;274422
27;2020-09-01;4;0;4;96896;61575;89;158471
27;2020-09-01;0;1;1;33148;12109;90;45257
27;2020-09-01;106;83;189;1429908;1353131;0;2783039
28;2020-09-01;2;1;4;180735;186856;09;367591
28;2020-09-01;20;14;35;200125;213621;19;413746
28;2020-09-01;22;33;55;168922;173007;29;341929
28;2020-09-01;18;17;35;196628;188487;39;385115
28;2020-09-01;6;11;17;205396;201699;49;407095
28;2020-09-01;8;14;22;222002;213866;59;435868
28;2020-09-01;8;6;14;224688;203758;69;428446
28;2020-09-01;4;5;9;163192;135543;79;298735
28;2020-09-01;7;2;9;109691;65377;89;175068
28;2020-09-01;2;0;2;37222;12685;90;49907
28;2020-09-01;97;103;202;1708601;1594899;0;3303500
32;2020-09-01;10;8;18;358062;373689;09;731751
32;2020-09-01;86;64;151;387045;406742;19;793787
32;2020-09-01;76;103;180;342304;348587;29;690891
32;2020-09-01;38;40;78;382485;369972;39;752457
32;2020-09-01;34;20;54;382510;376716;49;759226
32;2020-09-01;18;21;39;386937;376527;59;763464
32;2020-09-01;10;12;22;371211;330938;69;702149
32;2020-09-01;13;7;20;250542;201459;79;452001
32;2020-09-01;6;2;8;163399;89786;89;253185
32;2020-09-01;1;0;1;48384;15367;90;63751
32;2020-09-01;292;277;571;3072879;2889783;0;5962662
44;2020-09-01;5;4;9;291525;306839;09;598364
44;2020-09-01;15;13;28;320255;339504;19;659759
44;2020-09-01;40;34;74;302020;314428;29;616448
44;2020-09-01;30;20;50;342222;333292;39;675514
44;2020-09-01;16;25;41;349727;344491;49;694218
44;2020-09-01;12;13;25;381371;373239;59;754610
44;2020-09-01;14;9;23;367165;335850;69;703015
44;2020-09-01;2;6;8;250387;215436;79;465823
44;2020-09-01;4;1;5;170825;105192;89;276017
44;2020-09-01;1;1;2;51248;16731;90;67979
44;2020-09-01;139;126;265;2826745;2685002;0;5511747
52;2020-09-01;10;5;16;213594;223900;09;437494
52;2020-09-01;20;27;48;240818;255197;19;496015
52;2020-09-01;43;45;88;197010;200630;29;397640
52;2020-09-01;18;26;44;231204;224885;39;456089
52;2020-09-01;18;12;31;243874;243418;49;487292
52;2020-09-01;9;12;21;244100;239116;59;483216
52;2020-09-01;8;10;18;241796;221345;69;463141
52;2020-09-01;4;2;6;177805;149903;79;327708
52;2020-09-01;1;2;3;119561;75822;89;195383
52;2020-09-01;0;0;0;42559;15260;90;57819
52;2020-09-01;131;141;275;1952321;1849476;0;3801797
53;2020-09-01;7;6;13;173813;182358;09;356171
53;2020-09-01;25;23;48;202720;214740;19;417460
53;2020-09-01;28;41;69;163116;173196;29;336312
53;2020-09-01;11;11;22;190526;187674;39;378200
53;2020-09-01;12;4;16;212098;212015;49;424113
53;2020-09-01;8;6;14;223699;219176;59;442875
53;2020-09-01;2;1;3;227435;209274;69;436709
53;2020-09-01;3;2;5;169992;140910;79;310902
53;2020-09-01;0;0;0;118117;69883;89;188000
53;2020-09-01;0;0;0;37370;12267;90;49637
53;2020-09-01;96;94;190;1718886;1621493;0;3340379
75;2020-09-01;9;7;16;293104;305291;09;598395
75;2020-09-01;53;48;101;337141;357785;19;694926
75;2020-09-01;136;169;305;295024;300618;29;595642
75;2020-09-01;50;69;119;347871;331233;39;679104
75;2020-09-01;52;36;88;384742;372771;49;757513
75;2020-09-01;54;37;91;413361;390880;59;804241
75;2020-09-01;16;23;39;425623;384060;69;809683
75;2020-09-01;8;5;13;325086;276298;79;601384
75;2020-09-01;8;7;15;213986;139308;89;353294
75;2020-09-01;4;4;8;77600;28200;90;105800
75;2020-09-01;390;405;795;3113538;2886444;0;5999982
76;2020-09-01;7;6;14;305956;318589;09;624545
76;2020-09-01;41;46;89;338942;356969;19;695911
76;2020-09-01;93;111;204;316210;319570;29;635780
76;2020-09-01;53;65;118;356758;337587;39;694345
76;2020-09-01;42;59;101;376541;363812;49;740353
76;2020-09-01;42;47;89;402608;383750;59;786358
76;2020-09-01;23;28;51;394889;358997;69;753886
76;2020-09-01;10;12;22;308664;263806;79;572470
76;2020-09-01;14;10;24;195838;129272;89;325110
76;2020-09-01;1;0;1;69372;26728;90;96100
76;2020-09-01;327;384;714;3065778;2859080;0;5924858
84;2020-09-01;19;20;39;459549;481088;09;940637
84;2020-09-01;54;73;128;487711;511905;19;999616
84;2020-09-01;144;156;300;443824;451094;29;894918
84;2020-09-01;86;78;164;512522;493262;39;1005784
84;2020-09-01;69;77;146;520248;515106;49;1035354
84;2020-09-01;64;61;125;529611;514848;59;1044459
84;2020-09-01;22;35;57;486720;439940;69;926660
84;2020-09-01;10;17;27;372151;315211;79;687362
84;2020-09-01;14;4;18;237198;150524;89;387722
84;2020-09-01;4;2;6;81185;28680;90;109865
84;2020-09-01;486;523;1010;4130719;3901658;0;8032377
93;2020-09-01;13;16;29;268834;283093;09;551927
93;2020-09-01;80;62;145;280751;296087;19;576838
93;2020-09-01;162;160;322;254404;255552;29;509956
93;2020-09-01;111;111;222;310704;288398;39;599102
93;2020-09-01;92;79;171;325559;305827;49;631386
93;2020-09-01;88;65;154;353104;325389;59;678493
93;2020-09-01;41;46;87;336327;296459;69;632786
93;2020-09-01;31;40;71;279820;229699;79;509519
93;2020-09-01;25;22;47;171274;113716;89;284990
93;2020-09-01;12;5;17;58896;21758;90;80654
93;2020-09-01;655;606;1265;2639673;2415978;0;5055651
94;2020-09-01;0;0;0;16311;17433;09;33744
94;2020-09-01;1;4;5;16679;18132;19;34811
94;2020-09-01;7;7;14;16782;16579;29;33361
94;2020-09-01;6;12;18;23044;20580;39;43624
94;2020-09-01;6;4;10;23065;22140;49;45205
94;2020-09-01;2;3;5;24549;23421;59;47970
94;2020-09-01;3;2;5;23212;21883;69;45095
94;2020-09-01;0;5;5;19544;17141;79;36685
94;2020-09-01;0;0;0;11227;8178;89;19405
94;2020-09-01;0;0;0;3332;1447;90;4779
94;2020-09-01;25;37;62;177745;166934;0;344679
01;2020-09-02;4;4;8;19979;20155;09;40134
01;2020-09-02;8;11;19;24994;25489;19;50483
01;2020-09-02;15;14;29;17868;16690;29;34558
01;2020-09-02;17;16;33;22328;14821;39;37149
01;2020-09-02;22;15;37;28652;20276;49;48928
01;2020-09-02;17;10;27;33264;27260;59;60524
01;2020-09-02;15;13;28;27135;23978;69;51113
01;2020-09-02;4;3;7;18401;14661;79;33062
01;2020-09-02;2;2;4;9633;6375;89;16008
01;2020-09-02;0;0;0;3410;1510;90;4920
01;2020-09-02;104;88;192;205664;171215;0;376879
02;2020-09-02;3;1;4;16881;17110;09;33991
02;2020-09-02;3;1;4;21410;21604;19;43014
02;2020-09-02;9;3;12;16017;15479;29;31496
02;2020-09-02;5;5;10;19825;14455;39;34280
02;2020-09-02;2;2;4;24719;18248;49;42967
02;2020-09-02;3;1;4;34361;28310;59;62671
02;2020-09-02;1;0;1;28061;24495;69;52556
02;2020-09-02;1;0;1;18231;15278;79;33509
02;2020-09-02;1;0;1;11090;7677;89;18767
02;2020-09-02;1;0;1;3992;1506;90;5498
02;2020-09-02;29;13;42;194587;164162;0;358749
03;2020-09-02;1;2;3;31123;30920;09;62043
03;2020-09-02;0;0;0;29370;29268;19;58638
03;2020-09-02;6;1;7;21458;18963;29;40421
03;2020-09-02;2;2;4;21276;18326;39;39602
03;2020-09-02;5;4;9;18164;16593;49;34757
03;2020-09-02;0;4;4;13469;13557;59;27026
03;2020-09-02;0;0;0;8776;8670;69;17446
03;2020-09-02;0;0;0;3777;3591;79;7368
03;2020-09-02;0;0;0;1649;1072;89;2721
03;2020-09-02;0;0;0;485;184;90;669
03;2020-09-02;14;13;27;149547;141144;0;290691
04;2020-09-02;7;8;15;60314;61377;09;121691
04;2020-09-02;16;11;27;66065;68387;19;134452
04;2020-09-02;17;12;29;51059;47156;29;98215
04;2020-09-02;11;6;17;58788;45780;39;104568
04;2020-09-02;10;6;16;61408;52207;49;113615
04;2020-09-02;8;4;12;64838;60759;59;125597
04;2020-09-02;4;5;9;47008;42843;69;89851
04;2020-09-02;0;1;1;25509;21184;79;46693
04;2020-09-02;2;0;2;13168;7647;89;20815
04;2020-09-02;0;0;0;3209;1253;90;4462
04;2020-09-02;75;53;128;451366;408593;0;859959
05;2020-09-02;0;0;0;362.366008612902;341.338819562748;09;703.704828175651
05;2020-09-02;0;0;0;353.376145114279;370.349735405642;19;723.725880519921
05;2020-09-02;0;0;0;218.593559489256;256.539602589476;29;475.133162078732
05;2020-09-02;0;0;0;404.225408693299;360.321910454353;39;764.547319147651
05;2020-09-02;0;0;0;520.067953604221;497.108383964256;49;1017.17633756848
05;2020-09-02;0;0;0;468.146063921917;510.087601910415;59;978.233665832332
05;2020-09-02;0;0;0;340.368470050554;334.366842191253;69;674.735312241807
05;2020-09-02;0;0;0;212.598666888387;192.597753227106;79;405.196420115493
05;2020-09-02;0;0;0;148.727797095705;61.8681715431829;89;210.595968638888
05;2020-09-02;0;0;0;32.9601271090696;10.9909785719784;90;43.9511056810479
05;2020-09-02;0;0;0;3061.43020057959;2935.56979942041;0;5997
06;2020-09-02;0;0;0;42583;42380;09;84963
06;2020-09-02;1;0;1;33369;31925;19;65294
06;2020-09-02;2;2;4;21571;15080;29;36651
06;2020-09-02;0;0;0;21550;16147;39;37697
06;2020-09-02;0;1;1;14193;13939;49;28132
06;2020-09-02;1;0;1;7171;7597;59;14768
06;2020-09-02;0;0;0;3629;4117;69;7746
06;2020-09-02;0;0;0;1577;1457;79;3034
06;2020-09-02;0;0;0;531;474;89;1005
06;2020-09-02;0;0;0;88;93;90;181
06;2020-09-02;4;3;7;146262;133209;0;279471
07;2020-09-02;0;0;0;485;549;09;1034
07;2020-09-02;0;0;0;403;432;19;835
07;2020-09-02;0;0;0;764;841;29;1605
07;2020-09-02;0;0;0;824;928;39;1752
07;2020-09-02;0;0;0;788;1020;49;1808
07;2020-09-02;0;1;1;678;870;59;1548
07;2020-09-02;0;0;0;360;382;69;742
07;2020-09-02;0;0;0;231;190;79;421
07;2020-09-02;0;0;0;114;67;89;181
07;2020-09-02;0;0;0;24;11;90;35
07;2020-09-02;0;1;1;4671;5290;0;9961
08;2020-09-02;0;0;0;2715.22592983026;2997.75551488675;09;5712.98144471701
08;2020-09-02;0;0;0;2778.51901080978;3160.9156459093;19;5939.43465671908
08;2020-09-02;0;0;0;2080.8882988764;1718.16634315323;29;3799.05464202964
08;2020-09-02;2;0;2;2701.8582062647;1896.52641413317;39;4598.38462039786
08;2020-09-02;0;2;2;3151.45861023308;2460.52498233809;49;5611.98359257117
08;2020-09-02;2;1;3;2620.29868333099;2422.23566154656;59;5042.53434487755
08;2020-09-02;1;0;1;1621.44173420671;1438.58325779464;69;3060.02499200135
08;2020-09-02;1;0;1;626.575909335673;526.358467843651;79;1152.93437717932
08;2020-09-02;0;0;0;205.018522985054;140.993639349697;89;346.012162334751
08;2020-09-02;0;0;0;50.0325684687745;20.62259870351;90;70.6551671722846
08;2020-09-02;6;3;9;18551.3174743414;16782.6825256586;0;35334
11;2020-09-02;26;45;79;783071;811785;09;1594856
11;2020-09-02;138;113;254;761456;784653;19;1546109
11;2020-09-02;460;457;920;850145;801772;29;1651917
11;2020-09-02;242;254;496;914360;843488;39;1757848
11;2020-09-02;135;125;261;845609;826202;49;1671811
11;2020-09-02;125;122;248;793566;745070;59;1538636
11;2020-09-02;75;60;137;628649;549192;69;1177841
11;2020-09-02;24;29;54;434606;358356;79;792962
11;2020-09-02;21;17;38;261425;162933;89;424358
11;2020-09-02;9;3;12;89253;32619;90;121872
11;2020-09-02;1255;1226;2501;6362140;5916070;0;12278210
24;2020-09-02;1;2;3;139720;144686;09;284406
24;2020-09-02;17;13;30;152979;161185;19;314164
24;2020-09-02;30;31;61;122237;126536;29;248773
24;2020-09-02;19;27;46;150359;142009;39;292368
24;2020-09-02;18;18;36;161829;158758;49;320587
24;2020-09-02;10;11;21;172552;168011;59;340563
24;2020-09-02;5;12;17;172509;158177;69;330686
24;2020-09-02;1;1;2;129428;110593;79;240021
24;2020-09-02;2;1;3;87342;56882;89;144224
24;2020-09-02;1;0;1;31210;12071;90;43281
24;2020-09-02;104;116;220;1320165;1238908;0;2559073
27;2020-09-02;5;5;10;143373;149679;09;293052
27;2020-09-02;10;11;21;160962;173003;19;333965
27;2020-09-02;27;27;54;133746;142254;29;276000
27;2020-09-02;15;11;26;160004;155407;39;315411
27;2020-09-02;16;8;24;172333;169564;49;341897
27;2020-09-02;8;13;21;189979;183788;59;373767
27;2020-09-02;4;2;6;192591;178206;69;370797
27;2020-09-02;3;3;6;146876;127546;79;274422
27;2020-09-02;0;1;1;96896;61575;89;158471
27;2020-09-02;1;0;1;33148;12109;90;45257
27;2020-09-02;89;81;170;1429908;1353131;0;2783039
28;2020-09-02;4;3;7;180735;186856;09;367591
28;2020-09-02;15;18;33;200125;213621;19;413746
28;2020-09-02;40;39;79;168922;173007;29;341929
28;2020-09-02;17;20;38;196628;188487;39;385115
28;2020-09-02;17;4;21;205396;201699;49;407095
28;2020-09-02;13;10;23;222002;213866;59;435868
28;2020-09-02;6;9;15;224688;203758;69;428446
28;2020-09-02;3;4;7;163192;135543;79;298735
28;2020-09-02;3;0;3;109691;65377;89;175068
28;2020-09-02;1;0;1;37222;12685;90;49907
28;2020-09-02;119;107;227;1708601;1594899;0;3303500
32;2020-09-02;14;12;26;358062;373689;09;731751
32;2020-09-02;96;96;192;387045;406742;19;793787
32;2020-09-02;115;159;275;342304;348587;29;690891
32;2020-09-02;44;42;86;382485;369972;39;752457
32;2020-09-02;43;47;90;382510;376716;49;759226
32;2020-09-02;31;33;64;386937;376527;59;763464
32;2020-09-02;17;14;31;371211;330938;69;702149
32;2020-09-02;6;7;13;250542;201459;79;452001
32;2020-09-02;6;5;11;163399;89786;89;253185
32;2020-09-02;1;1;2;48384;15367;90;63751
32;2020-09-02;373;416;790;3072879;2889783;0;5962662
44;2020-09-02;10;15;25;291525;306839;09;598364
44;2020-09-02;26;19;45;320255;339504;19;659759
44;2020-09-02;44;50;94;302020;314428;29;616448
44;2020-09-02;22;23;45;342222;333292;39;675514
44;2020-09-02;27;17;44;349727;344491;49;694218
44;2020-09-02;22;12;34;381371;373239;59;754610
44;2020-09-02;6;8;14;367165;335850;69;703015
44;2020-09-02;4;5;9;250387;215436;79;465823
44;2020-09-02;1;3;4;170825;105192;89;276017
44;2020-09-02;2;0;2;51248;16731;90;67979
44;2020-09-02;164;152;316;2826745;2685002;0;5511747
52;2020-09-02;4;6;12;213594;223900;09;437494
52;2020-09-02;29;21;51;240818;255197;19;496015
52;2020-09-02;49;59;109;197010;200630;29;397640
52;2020-09-02;17;25;42;231204;224885;39;456089
52;2020-09-02;13;15;29;243874;243418;49;487292
52;2020-09-02;12;11;23;244100;239116;59;483216
52;2020-09-02;12;12;24;241796;221345;69;463141
52;2020-09-02;0;3;3;177805;149903;79;327708
52;2020-09-02;1;0;1;119561;75822;89;195383
52;2020-09-02;1;0;1;42559;15260;90;57819
52;2020-09-02;138;152;295;1952321;1849476;0;3801797
53;2020-09-02;4;0;5;173813;182358;09;356171
53;2020-09-02;19;8;27;202720;214740;19;417460
53;2020-09-02;37;48;85;163116;173196;29;336312
53;2020-09-02;10;17;27;190526;187674;39;378200
53;2020-09-02;12;11;23;212098;212015;49;424113
53;2020-09-02;11;10;21;223699;219176;59;442875
53;2020-09-02;1;7;8;227435;209274;69;436709
53;2020-09-02;2;0;2;169992;140910;79;310902
53;2020-09-02;2;0;2;118117;69883;89;188000
53;2020-09-02;0;0;0;37370;12267;90;49637
53;2020-09-02;98;101;200;1718886;1621493;0;3340379
75;2020-09-02;9;8;17;293104;305291;09;598395
75;2020-09-02;67;60;127;337141;357785;19;694926
75;2020-09-02;141;185;326;295024;300618;29;595642
75;2020-09-02;59;89;149;347871;331233;39;679104
75;2020-09-02;43;48;91;384742;372771;49;757513
75;2020-09-02;45;40;85;413361;390880;59;804241
75;2020-09-02;23;27;50;425623;384060;69;809683
75;2020-09-02;11;8;19;325086;276298;79;601384
75;2020-09-02;3;5;8;213986;139308;89;353294
75;2020-09-02;1;0;1;77600;28200;90;105800
75;2020-09-02;402;471;874;3113538;2886444;0;5999982
76;2020-09-02;13;13;27;305956;318589;09;624545
76;2020-09-02;45;38;85;338942;356969;19;695911
76;2020-09-02;95;108;203;316210;319570;29;635780
76;2020-09-02;70;73;143;356758;337587;39;694345
76;2020-09-02;50;49;100;376541;363812;49;740353
76;2020-09-02;34;36;70;402608;383750;59;786358
76;2020-09-02;19;23;42;394889;358997;69;753886
76;2020-09-02;7;12;19;308664;263806;79;572470
76;2020-09-02;7;2;9;195838;129272;89;325110
76;2020-09-02;2;2;4;69372;26728;90;96100
76;2020-09-02;342;356;702;3065778;2859080;0;5924858
84;2020-09-02;13;13;27;459549;481088;09;940637
84;2020-09-02;58;69;127;487711;511905;19;999616
84;2020-09-02;143;138;281;443824;451094;29;894918
84;2020-09-02;85;81;166;512522;493262;39;1005784
84;2020-09-02;64;52;116;520248;515106;49;1035354
84;2020-09-02;61;39;100;529611;514848;59;1044459
84;2020-09-02;29;24;53;486720;439940;69;926660
84;2020-09-02;18;22;40;372151;315211;79;687362
84;2020-09-02;15;9;24;237198;150524;89;387722
84;2020-09-02;13;7;20;81185;28680;90;109865
84;2020-09-02;499;454;954;4130719;3901658;0;8032377
93;2020-09-02;12;16;28;268834;283093;09;551927
93;2020-09-02;52;64;116;280751;296087;19;576838
93;2020-09-02;177;143;320;254404;255552;29;509956
93;2020-09-02;115;133;248;310704;288398;39;599102
93;2020-09-02;68;83;152;325559;305827;49;631386
93;2020-09-02;88;78;166;353104;325389;59;678493
93;2020-09-02;57;58;115;336327;296459;69;632786
93;2020-09-02;17;29;46;279820;229699;79;509519
93;2020-09-02;20;20;40;171274;113716;89;284990
93;2020-09-02;10;8;18;58896;21758;90;80654
93;2020-09-02;617;632;1250;2639673;2415978;0;5055651
94;2020-09-02;0;1;1;16311;17433;09;33744
94;2020-09-02;1;4;5;16679;18132;19;34811
94;2020-09-02;5;12;17;16782;16579;29;33361
94;2020-09-02;4;2;6;23044;20580;39;43624
94;2020-09-02;0;3;3;23065;22140;49;45205
94;2020-09-02;5;5;10;24549;23421;59;47970
94;2020-09-02;3;4;7;23212;21883;69;45095
94;2020-09-02;0;4;4;19544;17141;79;36685
94;2020-09-02;1;0;1;11227;8178;89;19405
94;2020-09-02;1;0;1;3332;1447;90;4779
94;2020-09-02;20;35;55;177745;166934;0;344679
01;2020-09-03;2;1;3;19979;20155;09;40134
01;2020-09-03;8;7;15;24994;25489;19;50483
01;2020-09-03;19;13;32;17868;16690;29;34558
01;2020-09-03;26;11;37;22328;14821;39;37149
01;2020-09-03;17;13;30;28652;20276;49;48928
01;2020-09-03;12;11;23;33264;27260;59;60524
01;2020-09-03;5;6;11;27135;23978;69;51113
01;2020-09-03;1;1;2;18401;14661;79;33062
01;2020-09-03;1;0;1;9633;6375;89;16008
01;2020-09-03;0;0;0;3410;1510;90;4920
01;2020-09-03;91;63;154;205664;171215;0;376879
02;2020-09-03;0;1;1;16881;17110;09;33991
02;2020-09-03;1;2;3;21410;21604;19;43014
02;2020-09-03;6;1;7;16017;15479;29;31496
02;2020-09-03;10;2;12;19825;14455;39;34280
02;2020-09-03;7;1;8;24719;18248;49;42967
02;2020-09-03;4;3;7;34361;28310;59;62671
02;2020-09-03;0;1;1;28061;24495;69;52556
02;2020-09-03;1;1;2;18231;15278;79;33509
02;2020-09-03;0;0;0;11090;7677;89;18767
02;2020-09-03;0;0;0;3992;1506;90;5498
02;2020-09-03;29;12;41;194587;164162;0;358749
03;2020-09-03;0;0;0;31123;30920;09;62043
03;2020-09-03;6;1;7;29370;29268;19;58638
03;2020-09-03;7;2;9;21458;18963;29;40421
03;2020-09-03;3;7;10;21276;18326;39;39602
03;2020-09-03;2;2;4;18164;16593;49;34757
03;2020-09-03;2;1;3;13469;13557;59;27026
03;2020-09-03;0;2;2;8776;8670;69;17446
03;2020-09-03;0;0;0;3777;3591;79;7368
03;2020-09-03;0;0;0;1649;1072;89;2721
03;2020-09-03;0;0;0;485;184;90;669
03;2020-09-03;20;15;35;149547;141144;0;290691
04;2020-09-03;1;4;5;60314;61377;09;121691
04;2020-09-03;8;8;16;66065;68387;19;134452
04;2020-09-03;14;8;22;51059;47156;29;98215
04;2020-09-03;6;6;12;58788;45780;39;104568
04;2020-09-03;9;7;16;61408;52207;49;113615
04;2020-09-03;8;3;11;64838;60759;59;125597
04;2020-09-03;3;8;11;47008;42843;69;89851
04;2020-09-03;0;1;1;25509;21184;79;46693
04;2020-09-03;0;1;1;13168;7647;89;20815
04;2020-09-03;0;0;0;3209;1253;90;4462
04;2020-09-03;49;46;95;451366;408593;0;859959
05;2020-09-03;0;0;0;362.366008612902;341.338819562748;09;703.704828175651
05;2020-09-03;0;0;0;353.376145114279;370.349735405642;19;723.725880519921
05;2020-09-03;0;0;0;218.593559489256;256.539602589476;29;475.133162078732
05;2020-09-03;0;1;1;404.225408693299;360.321910454353;39;764.547319147651
05;2020-09-03;1;0;1;520.067953604221;497.108383964256;49;1017.17633756848
05;2020-09-03;0;0;0;468.146063921917;510.087601910415;59;978.233665832332
05;2020-09-03;0;0;0;340.368470050554;334.366842191253;69;674.735312241807
05;2020-09-03;0;0;0;212.598666888387;192.597753227106;79;405.196420115493
05;2020-09-03;0;0;0;148.727797095705;61.8681715431829;89;210.595968638888
05;2020-09-03;0;0;0;32.9601271090696;10.9909785719784;90;43.9511056810479
05;2020-09-03;1;1;2;3061.43020057959;2935.56979942041;0;5997
06;2020-09-03;0;0;0;42583;42380;09;84963
06;2020-09-03;6;1;7;33369;31925;19;65294
06;2020-09-03;7;5;12;21571;15080;29;36651
06;2020-09-03;2;2;4;21550;16147;39;37697
06;2020-09-03;1;0;1;14193;13939;49;28132
06;2020-09-03;1;2;3;7171;7597;59;14768
06;2020-09-03;1;1;2;3629;4117;69;7746
06;2020-09-03;0;0;0;1577;1457;79;3034
06;2020-09-03;0;0;0;531;474;89;1005
06;2020-09-03;0;0;0;88;93;90;181
06;2020-09-03;18;11;29;146262;133209;0;279471
07;2020-09-03;0;0;0;485;549;09;1034
07;2020-09-03;0;0;0;403;432;19;835
07;2020-09-03;0;0;0;764;841;29;1605
07;2020-09-03;0;0;0;824;928;39;1752
07;2020-09-03;0;0;0;788;1020;49;1808
07;2020-09-03;0;0;0;678;870;59;1548
07;2020-09-03;0;0;0;360;382;69;742
07;2020-09-03;0;0;0;231;190;79;421
07;2020-09-03;0;0;0;114;67;89;181
07;2020-09-03;0;0;0;24;11;90;35
07;2020-09-03;0;0;0;4671;5290;0;9961
08;2020-09-03;0;0;0;2715.22592983026;2997.75551488675;09;5712.98144471701
08;2020-09-03;0;0;0;2778.51901080978;3160.9156459093;19;5939.43465671908
08;2020-09-03;0;0;0;2080.8882988764;1718.16634315323;29;3799.05464202964
08;2020-09-03;0;0;0;2701.8582062647;1896.52641413317;39;4598.38462039786
08;2020-09-03;0;0;0;3151.45861023308;2460.52498233809;49;5611.98359257117
08;2020-09-03;1;0;1;2620.29868333099;2422.23566154656;59;5042.53434487755
08;2020-09-03;2;0;2;1621.44173420671;1438.58325779464;69;3060.02499200135
08;2020-09-03;0;0;0;626.575909335673;526.358467843651;79;1152.93437717932
08;2020-09-03;0;0;0;205.018522985054;140.993639349697;89;346.012162334751
08;2020-09-03;0;0;0;50.0325684687745;20.62259870351;90;70.6551671722846
08;2020-09-03;3;0;3;18551.3174743414;16782.6825256586;0;35334
11;2020-09-03;55;41;96;783071;811785;09;1594856
11;2020-09-03;111;93;205;761456;784653;19;1546109
11;2020-09-03;473;439;923;850145;801772;29;1651917
11;2020-09-03;280;296;580;914360;843488;39;1757848
11;2020-09-03;176;158;337;845609;826202;49;1671811
11;2020-09-03;135;118;255;793566;745070;59;1538636
11;2020-09-03;76;72;151;628649;549192;69;1177841
11;2020-09-03;17;19;36;434606;358356;79;792962
11;2020-09-03;14;15;29;261425;162933;89;424358
11;2020-09-03;8;2;10;89253;32619;90;121872
11;2020-09-03;1345;1253;2623;6362140;5916070;0;12278210
24;2020-09-03;3;6;9;139720;144686;09;284406
24;2020-09-03;9;7;16;152979;161185;19;314164
24;2020-09-03;28;26;54;122237;126536;29;248773
24;2020-09-03;15;13;28;150359;142009;39;292368
24;2020-09-03;12;14;26;161829;158758;49;320587
24;2020-09-03;11;10;21;172552;168011;59;340563
24;2020-09-03;5;9;14;172509;158177;69;330686
24;2020-09-03;1;5;6;129428;110593;79;240021
24;2020-09-03;2;2;4;87342;56882;89;144224
24;2020-09-03;1;0;1;31210;12071;90;43281
24;2020-09-03;87;92;179;1320165;1238908;0;2559073
27;2020-09-03;4;2;6;143373;149679;09;293052
27;2020-09-03;8;8;16;160962;173003;19;333965
27;2020-09-03;35;24;59;133746;142254;29;276000
27;2020-09-03;18;18;36;160004;155407;39;315411
27;2020-09-03;9;9;18;172333;169564;49;341897
27;2020-09-03;15;13;28;189979;183788;59;373767
27;2020-09-03;7;6;13;192591;178206;69;370797
27;2020-09-03;2;6;8;146876;127546;79;274422
27;2020-09-03;2;2;4;96896;61575;89;158471
27;2020-09-03;1;0;1;33148;12109;90;45257
27;2020-09-03;101;88;189;1429908;1353131;0;2783039
28;2020-09-03;3;4;7;180735;186856;09;367591
28;2020-09-03;14;16;30;200125;213621;19;413746
28;2020-09-03;44;32;76;168922;173007;29;341929
28;2020-09-03;24;30;54;196628;188487;39;385115
28;2020-09-03;19;21;40;205396;201699;49;407095
28;2020-09-03;12;15;27;222002;213866;59;435868
28;2020-09-03;12;7;19;224688;203758;69;428446
28;2020-09-03;0;3;3;163192;135543;79;298735
28;2020-09-03;2;1;3;109691;65377;89;175068
28;2020-09-03;2;0;2;37222;12685;90;49907
28;2020-09-03;132;129;261;1708601;1594899;0;3303500
32;2020-09-03;12;16;28;358062;373689;09;731751
32;2020-09-03;78;79;160;387045;406742;19;793787
32;2020-09-03;124;140;267;342304;348587;29;690891
32;2020-09-03;52;46;98;382485;369972;39;752457
32;2020-09-03;45;52;98;382510;376716;49;759226
32;2020-09-03;37;39;76;386937;376527;59;763464
32;2020-09-03;18;14;32;371211;330938;69;702149
32;2020-09-03;13;18;31;250542;201459;79;452001
32;2020-09-03;6;6;12;163399;89786;89;253185
32;2020-09-03;6;1;7;48384;15367;90;63751
32;2020-09-03;391;411;809;3072879;2889783;0;5962662
44;2020-09-03;4;10;14;291525;306839;09;598364
44;2020-09-03;11;16;27;320255;339504;19;659759
44;2020-09-03;28;53;81;302020;314428;29;616448
44;2020-09-03;25;28;53;342222;333292;39;675514
44;2020-09-03;21;14;35;349727;344491;49;694218
44;2020-09-03;21;18;39;381371;373239;59;754610
44;2020-09-03;10;13;23;367165;335850;69;703015
44;2020-09-03;6;4;10;250387;215436;79;465823
44;2020-09-03;2;2;4;170825;105192;89;276017
44;2020-09-03;0;0;0;51248;16731;90;67979
44;2020-09-03;128;158;286;2826745;2685002;0;5511747
52;2020-09-03;6;7;13;213594;223900;09;437494
52;2020-09-03;21;24;45;240818;255197;19;496015
52;2020-09-03;42;54;97;197010;200630;29;397640
52;2020-09-03;32;41;73;231204;224885;39;456089
52;2020-09-03;21;15;36;243874;243418;49;487292
52;2020-09-03;13;17;30;244100;239116;59;483216
52;2020-09-03;14;15;29;241796;221345;69;463141
52;2020-09-03;2;6;8;177805;149903;79;327708
52;2020-09-03;2;1;3;119561;75822;89;195383
52;2020-09-03;1;0;1;42559;15260;90;57819
52;2020-09-03;154;180;335;1952321;1849476;0;3801797
53;2020-09-03;9;9;18;173813;182358;09;356171
53;2020-09-03;28;42;71;202720;214740;19;417460
53;2020-09-03;41;57;98;163116;173196;29;336312
53;2020-09-03;25;23;48;190526;187674;39;378200
53;2020-09-03;11;13;24;212098;212015;49;424113
53;2020-09-03;8;10;18;223699;219176;59;442875
53;2020-09-03;4;5;9;227435;209274;69;436709
53;2020-09-03;1;1;2;169992;140910;79;310902
53;2020-09-03;4;1;5;118117;69883;89;188000
53;2020-09-03;4;0;4;37370;12267;90;49637
53;2020-09-03;135;161;297;1718886;1621493;0;3340379
75;2020-09-03;9;17;27;293104;305291;09;598395
75;2020-09-03;64;43;109;337141;357785;19;694926
75;2020-09-03;132;150;285;295024;300618;29;595642
75;2020-09-03;57;67;124;347871;331233;39;679104
75;2020-09-03;44;40;84;384742;372771;49;757513
75;2020-09-03;50;29;79;413361;390880;59;804241
75;2020-09-03;20;13;33;425623;384060;69;809683
75;2020-09-03;8;16;24;325086;276298;79;601384
75;2020-09-03;5;2;7;213986;139308;89;353294
75;2020-09-03;1;1;2;77600;28200;90;105800
75;2020-09-03;391;379;776;3113538;2886444;0;5999982
76;2020-09-03;21;11;35;305956;318589;09;624545
76;2020-09-03;54;56;112;338942;356969;19;695911
76;2020-09-03;126;140;267;316210;319570;29;635780
76;2020-09-03;93;71;165;356758;337587;39;694345
76;2020-09-03;56;53;109;376541;363812;49;740353
76;2020-09-03;52;51;103;402608;383750;59;786358
76;2020-09-03;32;20;52;394889;358997;69;753886
76;2020-09-03;17;17;34;308664;263806;79;572470
76;2020-09-03;10;9;19;195838;129272;89;325110
76;2020-09-03;9;2;11;69372;26728;90;96100
76;2020-09-03;472;430;909;3065778;2859080;0;5924858
84;2020-09-03;22;20;42;459549;481088;09;940637
84;2020-09-03;88;70;158;487711;511905;19;999616
84;2020-09-03;169;166;335;443824;451094;29;894918
84;2020-09-03;106;109;215;512522;493262;39;1005784
84;2020-09-03;72;72;144;520248;515106;49;1035354
84;2020-09-03;65;61;126;529611;514848;59;1044459
84;2020-09-03;28;21;49;486720;439940;69;926660
84;2020-09-03;24;21;45;372151;315211;79;687362
84;2020-09-03;15;16;31;237198;150524;89;387722
84;2020-09-03;20;5;25;81185;28680;90;109865
84;2020-09-03;610;561;1171;4130719;3901658;0;8032377
93;2020-09-03;28;17;45;268834;283093;09;551927
93;2020-09-03;63;74;138;280751;296087;19;576838
93;2020-09-03;149;148;297;254404;255552;29;509956
93;2020-09-03;125;116;241;310704;288398;39;599102
93;2020-09-03;101;88;189;325559;305827;49;631386
93;2020-09-03;90;75;165;353104;325389;59;678493
93;2020-09-03;59;53;112;336327;296459;69;632786
93;2020-09-03;33;35;68;279820;229699;79;509519
93;2020-09-03;30;23;53;171274;113716;89;284990
93;2020-09-03;12;7;19;58896;21758;90;80654
93;2020-09-03;690;636;1327;2639673;2415978;0;5055651
94;2020-09-03;2;1;3;16311;17433;09;33744
94;2020-09-03;2;4;6;16679;18132;19;34811
94;2020-09-03;5;13;18;16782;16579;29;33361
94;2020-09-03;10;8;18;23044;20580;39;43624
94;2020-09-03;2;8;10;23065;22140;49;45205
94;2020-09-03;2;2;4;24549;23421;59;47970
94;2020-09-03;1;3;4;23212;21883;69;45095
94;2020-09-03;0;2;2;19544;17141;79;36685
94;2020-09-03;0;0;0;11227;8178;89;19405
94;2020-09-03;0;0;0;3332;1447;90;4779
94;2020-09-03;24;41;65;177745;166934;0;344679
01;2020-09-04;0;2;2;19979;20155;09;40134
01;2020-09-04;1;3;4;24994;25489;19;50483
01;2020-09-04;7;7;14;17868;16690;29;34558
01;2020-09-04;11;5;16;22328;14821;39;37149
01;2020-09-04;7;6;13;28652;20276;49;48928
01;2020-09-04;6;7;13;33264;27260;59;60524
01;2020-09-04;2;10;12;27135;23978;69;51113
01;2020-09-04;6;4;10;18401;14661;79;33062
01;2020-09-04;4;4;8;9633;6375;89;16008
01;2020-09-04;3;2;5;3410;1510;90;4920
01;2020-09-04;47;50;97;205664;171215;0;376879
02;2020-09-04;1;0;1;16881;17110;09;33991
02;2020-09-04;2;1;3;21410;21604;19;43014
02;2020-09-04;4;2;6;16017;15479;29;31496
02;2020-09-04;5;5;10;19825;14455;39;34280
02;2020-09-04;3;4;7;24719;18248;49;42967
02;2020-09-04;8;6;14;34361;28310;59;62671
02;2020-09-04;1;2;3;28061;24495;69;52556
02;2020-09-04;0;0;0;18231;15278;79;33509
02;2020-09-04;0;1;1;11090;7677;89;18767
02;2020-09-04;0;0;0;3992;1506;90;5498
02;2020-09-04;24;21;45;194587;164162;0;358749
03;2020-09-04;4;0;4;31123;30920;09;62043
03;2020-09-04;4;6;10;29370;29268;19;58638
03;2020-09-04;1;2;3;21458;18963;29;40421
03;2020-09-04;6;3;9;21276;18326;39;39602
03;2020-09-04;7;1;8;18164;16593;49;34757
03;2020-09-04;0;3;3;13469;13557;59;27026
03;2020-09-04;1;3;4;8776;8670;69;17446
03;2020-09-04;0;2;2;3777;3591;79;7368
03;2020-09-04;0;0;0;1649;1072;89;2721
03;2020-09-04;0;0;0;485;184;90;669
03;2020-09-04;23;20;43;149547;141144;0;290691
04;2020-09-04;8;3;11;60314;61377;09;121691
04;2020-09-04;18;18;36;66065;68387;19;134452
04;2020-09-04;9;8;17;51059;47156;29;98215
04;2020-09-04;6;5;11;58788;45780;39;104568
04;2020-09-04;18;6;24;61408;52207;49;113615
04;2020-09-04;3;6;9;64838;60759;59;125597
04;2020-09-04;7;4;11;47008;42843;69;89851
04;2020-09-04;0;1;1;25509;21184;79;46693
04;2020-09-04;0;2;2;13168;7647;89;20815
04;2020-09-04;0;0;0;3209;1253;90;4462
04;2020-09-04;69;53;122;451366;408593;0;859959
05;2020-09-04;0;0;0;362.366008612902;341.338819562748;09;703.704828175651
05;2020-09-04;0;0;0;353.376145114279;370.349735405642;19;723.725880519921
05;2020-09-04;0;0;0;218.593559489256;256.539602589476;29;475.133162078732
05;2020-09-04;0;0;0;404.225408693299;360.321910454353;39;764.547319147651
05;2020-09-04;0;0;0;520.067953604221;497.108383964256;49;1017.17633756848
05;2020-09-04;0;0;0;468.146063921917;510.087601910415;59;978.233665832332
05;2020-09-04;0;0;0;340.368470050554;334.366842191253;69;674.735312241807
05;2020-09-04;0;0;0;212.598666888387;192.597753227106;79;405.196420115493
05;2020-09-04;0;0;0;148.727797095705;61.8681715431829;89;210.595968638888
05;2020-09-04;0;0;0;32.9601271090696;10.9909785719784;90;43.9511056810479
05;2020-09-04;0;0;0;3061.43020057959;2935.56979942041;0;5997
06;2020-09-04;0;0;0;42583;42380;09;84963
06;2020-09-04;1;3;4;33369;31925;19;65294
06;2020-09-04;8;12;20;21571;15080;29;36651
06;2020-09-04;1;4;5;21550;16147;39;37697
06;2020-09-04;1;1;2;14193;13939;49;28132
06;2020-09-04;3;1;4;7171;7597;59;14768
06;2020-09-04;0;0;0;3629;4117;69;7746
06;2020-09-04;0;0;0;1577;1457;79;3034
06;2020-09-04;0;0;0;531;474;89;1005
06;2020-09-04;0;0;0;88;93;90;181
06;2020-09-04;14;21;35;146262;133209;0;279471
07;2020-09-04;0;0;0;485;549;09;1034
07;2020-09-04;0;0;0;403;432;19;835
07;2020-09-04;0;0;0;764;841;29;1605
07;2020-09-04;0;0;0;824;928;39;1752
07;2020-09-04;0;2;2;788;1020;49;1808
07;2020-09-04;0;0;0;678;870;59;1548
07;2020-09-04;0;1;1;360;382;69;742
07;2020-09-04;0;0;0;231;190;79;421
07;2020-09-04;0;0;0;114;67;89;181
07;2020-09-04;0;0;0;24;11;90;35
07;2020-09-04;0;3;3;4671;5290;0;9961
08;2020-09-04;0;0;0;2715.22592983026;2997.75551488675;09;5712.98144471701
08;2020-09-04;0;0;0;2778.51901080978;3160.9156459093;19;5939.43465671908
08;2020-09-04;1;0;1;2080.8882988764;1718.16634315323;29;3799.05464202964
08;2020-09-04;0;0;0;2701.8582062647;1896.52641413317;39;4598.38462039786
08;2020-09-04;1;2;3;3151.45861023308;2460.52498233809;49;5611.98359257117
08;2020-09-04;1;0;1;2620.29868333099;2422.23566154656;59;5042.53434487755
08;2020-09-04;2;0;2;1621.44173420671;1438.58325779464;69;3060.02499200135
08;2020-09-04;0;0;0;626.575909335673;526.358467843651;79;1152.93437717932
08;2020-09-04;0;0;0;205.018522985054;140.993639349697;89;346.012162334751
08;2020-09-04;0;0;0;50.0325684687745;20.62259870351;90;70.6551671722846
08;2020-09-04;5;2;7;18551.3174743414;16782.6825256586;0;35334
11;2020-09-04;38;51;95;783071;811785;09;1594856
11;2020-09-04;144;115;265;761456;784653;19;1546109
11;2020-09-04;411;410;827;850145;801772;29;1651917
11;2020-09-04;268;266;541;914360;843488;39;1757848
11;2020-09-04;176;156;332;845609;826202;49;1671811
11;2020-09-04;153;130;284;793566;745070;59;1538636
11;2020-09-04;89;89;182;628649;549192;69;1177841
11;2020-09-04;29;27;58;434606;358356;79;792962
11;2020-09-04;14;9;23;261425;162933;89;424358
11;2020-09-04;8;1;9;89253;32619;90;121872
11;2020-09-04;1332;1254;2621;6362140;5916070;0;12278210
24;2020-09-04;7;9;16;139720;144686;09;284406
24;2020-09-04;19;23;42;152979;161185;19;314164
24;2020-09-04;22;26;48;122237;126536;29;248773
24;2020-09-04;13;24;37;150359;142009;39;292368
24;2020-09-04;20;10;30;161829;158758;49;320587
24;2020-09-04;12;8;20;172552;168011;59;340563
24;2020-09-04;13;10;23;172509;158177;69;330686
24;2020-09-04;3;6;9;129428;110593;79;240021
24;2020-09-04;5;2;7;87342;56882;89;144224
24;2020-09-04;8;0;8;31210;12071;90;43281
24;2020-09-04;122;118;240;1320165;1238908;0;2559073
27;2020-09-04;8;5;13;143373;149679;09;293052
27;2020-09-04;14;15;29;160962;173003;19;333965
27;2020-09-04;35;36;71;133746;142254;29;276000
27;2020-09-04;15;15;30;160004;155407;39;315411
27;2020-09-04;11;13;24;172333;169564;49;341897
27;2020-09-04;11;12;23;189979;183788;59;373767
27;2020-09-04;8;15;23;192591;178206;69;370797
27;2020-09-04;2;7;9;146876;127546;79;274422
27;2020-09-04;3;2;5;96896;61575;89;158471
27;2020-09-04;0;0;0;33148;12109;90;45257
27;2020-09-04;107;121;228;1429908;1353131;0;2783039
28;2020-09-04;4;9;13;180735;186856;09;367591
28;2020-09-04;23;17;40;200125;213621;19;413746
28;2020-09-04;37;47;84;168922;173007;29;341929
28;2020-09-04;22;21;43;196628;188487;39;385115
28;2020-09-04;18;13;31;205396;201699;49;407095
28;2020-09-04;11;20;31;222002;213866;59;435868
28;2020-09-04;9;4;13;224688;203758;69;428446
28;2020-09-04;6;4;10;163192;135543;79;298735
28;2020-09-04;2;1;3;109691;65377;89;175068
28;2020-09-04;0;0;0;37222;12685;90;49907
28;2020-09-04;132;136;268;1708601;1594899;0;3303500
32;2020-09-04;25;19;44;358062;373689;09;731751
32;2020-09-04;124;99;226;387045;406742;19;793787
32;2020-09-04;149;135;284;342304;348587;29;690891
32;2020-09-04;70;63;134;382485;369972;39;752457
32;2020-09-04;61;43;104;382510;376716;49;759226
32;2020-09-04;54;60;114;386937;376527;59;763464
32;2020-09-04;36;30;66;371211;330938;69;702149
32;2020-09-04;13;16;29;250542;201459;79;452001
32;2020-09-04;11;8;19;163399;89786;89;253185
32;2020-09-04;5;2;7;48384;15367;90;63751
32;2020-09-04;548;475;1027;3072879;2889783;0;5962662
44;2020-09-04;8;5;13;291525;306839;09;598364
44;2020-09-04;28;29;57;320255;339504;19;659759
44;2020-09-04;36;41;77;302020;314428;29;616448
44;2020-09-04;20;36;56;342222;333292;39;675514
44;2020-09-04;18;19;37;349727;344491;49;694218
44;2020-09-04;15;23;38;381371;373239;59;754610
44;2020-09-04;10;5;15;367165;335850;69;703015
44;2020-09-04;9;5;14;250387;215436;79;465823
44;2020-09-04;5;1;6;170825;105192;89;276017
44;2020-09-04;1;0;1;51248;16731;90;67979
44;2020-09-04;150;164;314;2826745;2685002;0;5511747
52;2020-09-04;11;12;24;213594;223900;09;437494
52;2020-09-04;34;26;60;240818;255197;19;496015
52;2020-09-04;54;48;102;197010;200630;29;397640
52;2020-09-04;39;30;69;231204;224885;39;456089
52;2020-09-04;19;23;42;243874;243418;49;487292
52;2020-09-04;27;16;43;244100;239116;59;483216
52;2020-09-04;11;15;26;241796;221345;69;463141
52;2020-09-04;3;7;10;177805;149903;79;327708
52;2020-09-04;4;1;5;119561;75822;89;195383
52;2020-09-04;0;1;1;42559;15260;90;57819
52;2020-09-04;202;179;382;1952321;1849476;0;3801797
53;2020-09-04;11;5;16;173813;182358;09;356171
53;2020-09-04;16;27;44;202720;214740;19;417460
53;2020-09-04;43;46;90;163116;173196;29;336312
53;2020-09-04;14;21;35;190526;187674;39;378200
53;2020-09-04;12;14;26;212098;212015;49;424113
53;2020-09-04;19;12;31;223699;219176;59;442875
53;2020-09-04;7;10;17;227435;209274;69;436709
53;2020-09-04;3;2;5;169992;140910;79;310902
53;2020-09-04;0;2;2;118117;69883;89;188000
53;2020-09-04;1;0;1;37370;12267;90;49637
53;2020-09-04;126;139;267;1718886;1621493;0;3340379
75;2020-09-04;14;18;32;293104;305291;09;598395
75;2020-09-04;57;48;105;337141;357785;19;694926
75;2020-09-04;122;136;258;295024;300618;29;595642
75;2020-09-04;69;85;154;347871;331233;39;679104
75;2020-09-04;64;60;124;384742;372771;49;757513
75;2020-09-04;38;50;88;413361;390880;59;804241
75;2020-09-04;23;23;46;425623;384060;69;809683
75;2020-09-04;12;9;21;325086;276298;79;601384
75;2020-09-04;9;5;14;213986;139308;89;353294
75;2020-09-04;5;4;9;77600;28200;90;105800
75;2020-09-04;413;439;852;3113538;2886444;0;5999982
76;2020-09-04;20;21;43;305956;318589;09;624545
76;2020-09-04;53;70;123;338942;356969;19;695911
76;2020-09-04;96;114;210;316210;319570;29;635780
76;2020-09-04;70;66;136;356758;337587;39;694345
76;2020-09-04;64;47;111;376541;363812;49;740353
76;2020-09-04;40;38;78;402608;383750;59;786358
76;2020-09-04;32;34;66;394889;358997;69;753886
76;2020-09-04;19;22;41;308664;263806;79;572470
76;2020-09-04;7;13;20;195838;129272;89;325110
76;2020-09-04;6;3;9;69372;26728;90;96100
76;2020-09-04;409;428;839;3065778;2859080;0;5924858
84;2020-09-04;18;27;45;459549;481088;09;940637
84;2020-09-04;70;69;142;487711;511905;19;999616
84;2020-09-04;155;149;304;443824;451094;29;894918
84;2020-09-04;95;87;182;512522;493262;39;1005784
84;2020-09-04;84;66;150;520248;515106;49;1035354
84;2020-09-04;57;56;113;529611;514848;59;1044459
84;2020-09-04;32;28;60;486720;439940;69;926660
84;2020-09-04;23;20;43;372151;315211;79;687362
84;2020-09-04;21;10;31;237198;150524;89;387722
84;2020-09-04;12;6;18;81185;28680;90;109865
84;2020-09-04;567;518;1088;4130719;3901658;0;8032377
93;2020-09-04;37;38;75;268834;283093;09;551927
93;2020-09-04;90;66;156;280751;296087;19;576838
93;2020-09-04;162;155;319;254404;255552;29;509956
93;2020-09-04;128;117;245;310704;288398;39;599102
93;2020-09-04;100;86;186;325559;305827;49;631386
93;2020-09-04;108;86;194;353104;325389;59;678493
93;2020-09-04;54;63;117;336327;296459;69;632786
93;2020-09-04;40;30;70;279820;229699;79;509519
93;2020-09-04;25;18;43;171274;113716;89;284990
93;2020-09-04;19;3;22;58896;21758;90;80654
93;2020-09-04;764;662;1428;2639673;2415978;0;5055651
94;2020-09-04;0;2;2;16311;17433;09;33744
94;2020-09-04;3;1;6;16679;18132;19;34811
94;2020-09-04;10;9;19;16782;16579;29;33361
94;2020-09-04;5;7;12;23044;20580;39;43624
94;2020-09-04;2;2;4;23065;22140;49;45205
94;2020-09-04;4;8;12;24549;23421;59;47970
94;2020-09-04;3;1;4;23212;21883;69;45095
94;2020-09-04;2;1;3;19544;17141;79;36685
94;2020-09-04;0;0;0;11227;8178;89;19405
94;2020-09-04;0;0;0;3332;1447;90;4779
94;2020-09-04;29;31;62;177745;166934;0;344679
01;2020-09-05;0;0;0;19979;20155;09;40134
01;2020-09-05;0;0;0;24994;25489;19;50483
01;2020-09-05;3;1;4;17868;16690;29;34558
01;2020-09-05;1;2;3;22328;14821;39;37149
01;2020-09-05;1;6;7;28652;20276;49;48928
01;2020-09-05;3;2;5;33264;27260;59;60524
01;2020-09-05;0;1;1;27135;23978;69;51113
01;2020-09-05;0;1;1;18401;14661;79;33062
01;2020-09-05;0;0;0;9633;6375;89;16008
01;2020-09-05;0;0;0;3410;1510;90;4920
01;2020-09-05;8;13;21;205664;171215;0;376879
02;2020-09-05;0;0;0;16881;17110;09;33991
02;2020-09-05;0;0;0;21410;21604;19;43014
02;2020-09-05;1;0;1;16017;15479;29;31496
02;2020-09-05;1;1;2;19825;14455;39;34280
02;2020-09-05;1;1;2;24719;18248;49;42967
02;2020-09-05;1;1;2;34361;28310;59;62671
02;2020-09-05;0;0;0;28061;24495;69;52556
02;2020-09-05;1;0;1;18231;15278;79;33509
02;2020-09-05;0;0;0;11090;7677;89;18767
02;2020-09-05;0;0;0;3992;1506;90;5498
02;2020-09-05;5;3;8;194587;164162;0;358749
03;2020-09-05;2;0;2;31123;30920;09;62043
03;2020-09-05;1;1;3;29370;29268;19;58638
03;2020-09-05;1;0;1;21458;18963;29;40421
03;2020-09-05;2;0;2;21276;18326;39;39602
03;2020-09-05;2;1;3;18164;16593;49;34757
03;2020-09-05;0;0;0;13469;13557;59;27026
03;2020-09-05;0;1;1;8776;8670;69;17446
03;2020-09-05;0;1;1;3777;3591;79;7368
03;2020-09-05;0;0;0;1649;1072;89;2721
03;2020-09-05;0;0;0;485;184;90;669
03;2020-09-05;8;4;13;149547;141144;0;290691
04;2020-09-05;2;1;3;60314;61377;09;121691
04;2020-09-05;7;8;15;66065;68387;19;134452
04;2020-09-05;2;2;4;51059;47156;29;98215
04;2020-09-05;1;2;3;58788;45780;39;104568
04;2020-09-05;6;3;9;61408;52207;49;113615
04;2020-09-05;2;1;3;64838;60759;59;125597
04;2020-09-05;3;3;6;47008;42843;69;89851
04;2020-09-05;4;0;4;25509;21184;79;46693
04;2020-09-05;0;0;0;13168;7647;89;20815
04;2020-09-05;0;0;0;3209;1253;90;4462
04;2020-09-05;27;20;47;451366;408593;0;859959
05;2020-09-05;0;0;0;362.366008612902;341.338819562748;09;703.704828175651
05;2020-09-05;0;0;0;353.376145114279;370.349735405642;19;723.725880519921
05;2020-09-05;0;0;0;218.593559489256;256.539602589476;29;475.133162078732
05;2020-09-05;0;0;0;404.225408693299;360.321910454353;39;764.547319147651
05;2020-09-05;0;0;0;520.067953604221;497.108383964256;49;1017.17633756848
05;2020-09-05;0;0;0;468.146063921917;510.087601910415;59;978.233665832332
05;2020-09-05;0;0;0;340.368470050554;334.366842191253;69;674.735312241807
05;2020-09-05;0;0;0;212.598666888387;192.597753227106;79;405.196420115493
05;2020-09-05;0;0;0;148.727797095705;61.8681715431829;89;210.595968638888
05;2020-09-05;0;0;0;32.9601271090696;10.9909785719784;90;43.9511056810479
05;2020-09-05;0;0;0;3061.43020057959;2935.56979942041;0;5997
06;2020-09-05;0;0;0;42583;42380;09;84963
06;2020-09-05;0;0;0;33369;31925;19;65294
06;2020-09-05;0;0;0;21571;15080;29;36651
06;2020-09-05;1;0;1;21550;16147;39;37697
06;2020-09-05;1;0;1;14193;13939;49;28132
06;2020-09-05;0;0;0;7171;7597;59;14768
06;2020-09-05;1;0;1;3629;4117;69;7746
06;2020-09-05;0;0;0;1577;1457;79;3034
06;2020-09-05;0;0;0;531;474;89;1005
06;2020-09-05;0;0;0;88;93;90;181
06;2020-09-05;3;0;3;146262;133209;0;279471
07;2020-09-05;0;0;0;485;549;09;1034
07;2020-09-05;0;0;0;403;432;19;835
07;2020-09-05;0;0;0;764;841;29;1605
07;2020-09-05;0;0;0;824;928;39;1752
07;2020-09-05;0;0;0;788;1020;49;1808
07;2020-09-05;0;0;0;678;870;59;1548
07;2020-09-05;0;0;0;360;382;69;742
07;2020-09-05;0;0;0;231;190;79;421
07;2020-09-05;0;0;0;114;67;89;181
07;2020-09-05;0;0;0;24;11;90;35
07;2020-09-05;0;0;0;4671;5290;0;9961
08;2020-09-05;0;0;0;2715.22592983026;2997.75551488675;09;5712.98144471701
08;2020-09-05;0;0;0;2778.51901080978;3160.9156459093;19;5939.43465671908
08;2020-09-05;0;1;1;2080.8882988764;1718.16634315323;29;3799.05464202964
08;2020-09-05;0;1;1;2701.8582062647;1896.52641413317;39;4598.38462039786
08;2020-09-05;0;0;0;3151.45861023308;2460.52498233809;49;5611.98359257117
08;2020-09-05;0;0;0;2620.29868333099;2422.23566154656;59;5042.53434487755
08;2020-09-05;0;0;0;1621.44173420671;1438.58325779464;69;3060.02499200135
08;2020-09-05;0;1;1;626.575909335673;526.358467843651;79;1152.93437717932
08;2020-09-05;0;0;0;205.018522985054;140.993639349697;89;346.012162334751
08;2020-09-05;0;0;0;50.0325684687745;20.62259870351;90;70.6551671722846
08;2020-09-05;0;3;3;18551.3174743414;16782.6825256586;0;35334
11;2020-09-05;15;18;36;783071;811785;09;1594856
11;2020-09-05;69;35;104;761456;784653;19;1546109
11;2020-09-05;179;162;343;850145;801772;29;1651917
11;2020-09-05;91;94;185;914360;843488;39;1757848
11;2020-09-05;78;65;143;845609;826202;49;1671811
11;2020-09-05;76;57;133;793566;745070;59;1538636
11;2020-09-05;37;35;75;628649;549192;69;1177841
11;2020-09-05;15;15;30;434606;358356;79;792962
11;2020-09-05;7;5;12;261425;162933;89;424358
11;2020-09-05;5;2;7;89253;32619;90;121872
11;2020-09-05;572;488;1068;6362140;5916070;0;12278210
24;2020-09-05;2;0;2;139720;144686;09;284406
24;2020-09-05;14;2;16;152979;161185;19;314164
24;2020-09-05;16;17;33;122237;126536;29;248773
24;2020-09-05;5;7;12;150359;142009;39;292368
24;2020-09-05;8;7;15;161829;158758;49;320587
24;2020-09-05;3;7;10;172552;168011;59;340563
24;2020-09-05;5;2;7;172509;158177;69;330686
24;2020-09-05;5;2;7;129428;110593;79;240021
24;2020-09-05;2;1;3;87342;56882;89;144224
24;2020-09-05;1;0;1;31210;12071;90;43281
24;2020-09-05;61;45;106;1320165;1238908;0;2559073
27;2020-09-05;4;1;5;143373;149679;09;293052
27;2020-09-05;12;6;18;160962;173003;19;333965
27;2020-09-05;9;6;15;133746;142254;29;276000
27;2020-09-05;3;8;11;160004;155407;39;315411
27;2020-09-05;9;8;17;172333;169564;49;341897
27;2020-09-05;13;16;29;189979;183788;59;373767
27;2020-09-05;8;4;12;192591;178206;69;370797
27;2020-09-05;1;3;4;146876;127546;79;274422
27;2020-09-05;5;0;5;96896;61575;89;158471
27;2020-09-05;1;0;1;33148;12109;90;45257
27;2020-09-05;65;52;117;1429908;1353131;0;2783039
28;2020-09-05;2;4;6;180735;186856;09;367591
28;2020-09-05;10;10;20;200125;213621;19;413746
28;2020-09-05;21;13;34;168922;173007;29;341929
28;2020-09-05;5;7;12;196628;188487;39;385115
28;2020-09-05;10;7;17;205396;201699;49;407095
28;2020-09-05;6;3;9;222002;213866;59;435868
28;2020-09-05;4;7;11;224688;203758;69;428446
28;2020-09-05;2;3;5;163192;135543;79;298735
28;2020-09-05;2;0;2;109691;65377;89;175068
28;2020-09-05;5;1;6;37222;12685;90;49907
28;2020-09-05;67;55;122;1708601;1594899;0;3303500
32;2020-09-05;16;10;26;358062;373689;09;731751
32;2020-09-05;59;48;107;387045;406742;19;793787
32;2020-09-05;90;66;156;342304;348587;29;690891
32;2020-09-05;30;34;64;382485;369972;39;752457
32;2020-09-05;35;26;61;382510;376716;49;759226
32;2020-09-05;24;22;46;386937;376527;59;763464
32;2020-09-05;13;10;23;371211;330938;69;702149
32;2020-09-05;11;8;19;250542;201459;79;452001
32;2020-09-05;4;4;8;163399;89786;89;253185
32;2020-09-05;4;0;4;48384;15367;90;63751
32;2020-09-05;286;228;514;3072879;2889783;0;5962662
44;2020-09-05;4;2;6;291525;306839;09;598364
44;2020-09-05;8;10;20;320255;339504;19;659759
44;2020-09-05;15;22;37;302020;314428;29;616448
44;2020-09-05;8;19;27;342222;333292;39;675514
44;2020-09-05;12;11;23;349727;344491;49;694218
44;2020-09-05;7;8;15;381371;373239;59;754610
44;2020-09-05;2;5;7;367165;335850;69;703015
44;2020-09-05;2;1;3;250387;215436;79;465823
44;2020-09-05;4;1;5;170825;105192;89;276017
44;2020-09-05;0;0;0;51248;16731;90;67979
44;2020-09-05;62;79;143;2826745;2685002;0;5511747
52;2020-09-05;8;7;16;213594;223900;09;437494
52;2020-09-05;12;11;23;240818;255197;19;496015
52;2020-09-05;26;17;43;197010;200630;29;397640
52;2020-09-05;16;14;30;231204;224885;39;456089
52;2020-09-05;7;12;19;243874;243418;49;487292
52;2020-09-05;7;10;17;244100;239116;59;483216
52;2020-09-05;3;4;7;241796;221345;69;463141
52;2020-09-05;2;5;7;177805;149903;79;327708
52;2020-09-05;2;3;5;119561;75822;89;195383
52;2020-09-05;1;2;3;42559;15260;90;57819
52;2020-09-05;84;85;170;1952321;1849476;0;3801797
53;2020-09-05;2;4;6;173813;182358;09;356171
53;2020-09-05;13;12;25;202720;214740;19;417460
53;2020-09-05;20;27;47;163116;173196;29;336312
53;2020-09-05;9;12;21;190526;187674;39;378200
53;2020-09-05;7;5;12;212098;212015;49;424113
53;2020-09-05;3;9;12;223699;219176;59;442875
53;2020-09-05;5;6;11;227435;209274;69;436709
53;2020-09-05;0;1;1;169992;140910;79;310902
53;2020-09-05;2;1;3;118117;69883;89;188000
53;2020-09-05;0;0;0;37370;12267;90;49637
53;2020-09-05;61;77;138;1718886;1621493;0;3340379
75;2020-09-05;7;10;17;293104;305291;09;598395
75;2020-09-05;31;18;49;337141;357785;19;694926
75;2020-09-05;51;50;101;295024;300618;29;595642
75;2020-09-05;25;23;48;347871;331233;39;679104
75;2020-09-05;28;17;45;384742;372771;49;757513
75;2020-09-05;14;15;29;413361;390880;59;804241
75;2020-09-05;9;14;23;425623;384060;69;809683
75;2020-09-05;7;3;10;325086;276298;79;601384
75;2020-09-05;6;2;8;213986;139308;89;353294
75;2020-09-05;1;0;1;77600;28200;90;105800
75;2020-09-05;179;152;331;3113538;2886444;0;5999982
76;2020-09-05;9;11;20;305956;318589;09;624545
76;2020-09-05;28;16;44;338942;356969;19;695911
76;2020-09-05;33;40;73;316210;319570;29;635780
76;2020-09-05;18;20;38;356758;337587;39;694345
76;2020-09-05;19;11;30;376541;363812;49;740353
76;2020-09-05;17;21;38;402608;383750;59;786358
76;2020-09-05;3;8;11;394889;358997;69;753886
76;2020-09-05;6;3;9;308664;263806;79;572470
76;2020-09-05;11;12;23;195838;129272;89;325110
76;2020-09-05;11;3;14;69372;26728;90;96100
76;2020-09-05;155;145;300;3065778;2859080;0;5924858
84;2020-09-05;8;10;18;459549;481088;09;940637
84;2020-09-05;24;24;48;487711;511905;19;999616
84;2020-09-05;57;49;107;443824;451094;29;894918
84;2020-09-05;34;22;56;512522;493262;39;1005784
84;2020-09-05;37;29;66;520248;515106;49;1035354
84;2020-09-05;17;18;35;529611;514848;59;1044459
84;2020-09-05;15;8;23;486720;439940;69;926660
84;2020-09-05;13;11;24;372151;315211;79;687362
84;2020-09-05;12;4;16;237198;150524;89;387722
84;2020-09-05;5;2;7;81185;28680;90;109865
84;2020-09-05;222;177;400;4130719;3901658;0;8032377
93;2020-09-05;10;14;24;268834;283093;09;551927
93;2020-09-05;30;22;52;280751;296087;19;576838
93;2020-09-05;42;52;94;254404;255552;29;509956
93;2020-09-05;33;31;64;310704;288398;39;599102
93;2020-09-05;33;29;62;325559;305827;49;631386
93;2020-09-05;29;24;53;353104;325389;59;678493
93;2020-09-05;13;18;31;336327;296459;69;632786
93;2020-09-05;8;10;18;279820;229699;79;509519
93;2020-09-05;19;5;24;171274;113716;89;284990
93;2020-09-05;7;2;10;58896;21758;90;80654
93;2020-09-05;224;207;432;2639673;2415978;0;5055651
94;2020-09-05;0;0;0;16311;17433;09;33744
94;2020-09-05;0;1;1;16679;18132;19;34811
94;2020-09-05;3;2;5;16782;16579;29;33361
94;2020-09-05;1;2;3;23044;20580;39;43624
94;2020-09-05;1;0;1;23065;22140;49;45205
94;2020-09-05;2;2;4;24549;23421;59;47970
94;2020-09-05;2;1;3;23212;21883;69;45095
94;2020-09-05;0;1;1;19544;17141;79;36685
94;2020-09-05;0;0;0;11227;8178;89;19405
94;2020-09-05;1;0;1;3332;1447;90;4779
94;2020-09-05;10;9;19;177745;166934;0;344679
01;2020-09-06;0;0;0;19979;20155;09;40134
01;2020-09-06;1;1;2;24994;25489;19;50483
01;2020-09-06;1;1;2;17868;16690;29;34558
01;2020-09-06;2;2;4;22328;14821;39;37149
01;2020-09-06;1;0;1;28652;20276;49;48928
01;2020-09-06;2;0;2;33264;27260;59;60524
01;2020-09-06;2;1;3;27135;23978;69;51113
01;2020-09-06;0;1;1;18401;14661;79;33062
01;2020-09-06;1;1;2;9633;6375;89;16008
01;2020-09-06;0;0;0;3410;1510;90;4920
01;2020-09-06;10;7;17;205664;171215;0;376879
02;2020-09-06;0;0;0;16881;17110;09;33991
02;2020-09-06;0;0;0;21410;21604;19;43014
02;2020-09-06;0;0;0;16017;15479;29;31496
02;2020-09-06;0;0;0;19825;14455;39;34280
02;2020-09-06;0;0;0;24719;18248;49;42967
02;2020-09-06;0;0;0;34361;28310;59;62671
02;2020-09-06;0;0;0;28061;24495;69;52556
02;2020-09-06;0;0;0;18231;15278;79;33509
02;2020-09-06;0;0;0;11090;7677;89;18767
02;2020-09-06;0;0;0;3992;1506;90;5498
02;2020-09-06;0;0;0;194587;164162;0;358749
03;2020-09-06;0;0;0;31123;30920;09;62043
03;2020-09-06;4;3;7;29370;29268;19;58638
03;2020-09-06;1;0;1;21458;18963;29;40421
03;2020-09-06;2;1;3;21276;18326;39;39602
03;2020-09-06;2;2;4;18164;16593;49;34757
03;2020-09-06;1;2;4;13469;13557;59;27026
03;2020-09-06;0;0;0;8776;8670;69;17446
03;2020-09-06;1;0;1;3777;3591;79;7368
03;2020-09-06;0;0;0;1649;1072;89;2721
03;2020-09-06;0;0;0;485;184;90;669
03;2020-09-06;11;8;20;149547;141144;0;290691
04;2020-09-06;2;1;3;60314;61377;09;121691
04;2020-09-06;0;2;2;66065;68387;19;134452
04;2020-09-06;2;1;3;51059;47156;29;98215
04;2020-09-06;2;2;4;58788;45780;39;104568
04;2020-09-06;3;0;3;61408;52207;49;113615
04;2020-09-06;0;0;0;64838;60759;59;125597
04;2020-09-06;2;0;2;47008;42843;69;89851
04;2020-09-06;0;0;0;25509;21184;79;46693
04;2020-09-06;0;0;0;13168;7647;89;20815
04;2020-09-06;0;0;0;3209;1253;90;4462
04;2020-09-06;11;6;17;451366;408593;0;859959
05;2020-09-06;0;0;0;362.366008612902;341.338819562748;09;703.704828175651
05;2020-09-06;0;0;0;353.376145114279;370.349735405642;19;723.725880519921
05;2020-09-06;0;0;0;218.593559489256;256.539602589476;29;475.133162078732
05;2020-09-06;0;0;0;404.225408693299;360.321910454353;39;764.547319147651
05;2020-09-06;0;0;0;520.067953604221;497.108383964256;49;1017.17633756848
05;2020-09-06;0;0;0;468.146063921917;510.087601910415;59;978.233665832332
05;2020-09-06;0;0;0;340.368470050554;334.366842191253;69;674.735312241807
05;2020-09-06;0;0;0;212.598666888387;192.597753227106;79;405.196420115493
05;2020-09-06;0;0;0;148.727797095705;61.8681715431829;89;210.595968638888
05;2020-09-06;0;0;0;32.9601271090696;10.9909785719784;90;43.9511056810479
05;2020-09-06;0;0;0;3061.43020057959;2935.56979942041;0;5997
06;2020-09-06;0;0;0;42583;42380;09;84963
06;2020-09-06;0;1;1;33369;31925;19;65294
06;2020-09-06;1;0;1;21571;15080;29;36651
06;2020-09-06;0;1;1;21550;16147;39;37697
06;2020-09-06;2;1;3;14193;13939;49;28132
06;2020-09-06;0;1;1;7171;7597;59;14768
06;2020-09-06;0;0;0;3629;4117;69;7746
06;2020-09-06;0;0;0;1577;1457;79;3034
06;2020-09-06;0;0;0;531;474;89;1005
06;2020-09-06;0;0;0;88;93;90;181
06;2020-09-06;3;4;7;146262;133209;0;279471
07;2020-09-06;0;0;0;485;549;09;1034
07;2020-09-06;0;0;0;403;432;19;835
07;2020-09-06;0;0;0;764;841;29;1605
07;2020-09-06;0;0;0;824;928;39;1752
07;2020-09-06;0;0;0;788;1020;49;1808
07;2020-09-06;0;0;0;678;870;59;1548
07;2020-09-06;0;0;0;360;382;69;742
07;2020-09-06;0;0;0;231;190;79;421
07;2020-09-06;0;0;0;114;67;89;181
07;2020-09-06;0;0;0;24;11;90;35
07;2020-09-06;0;0;0;4671;5290;0;9961
08;2020-09-06;0;0;0;2715.22592983026;2997.75551488675;09;5712.98144471701
08;2020-09-06;0;0;0;2778.51901080978;3160.9156459093;19;5939.43465671908
08;2020-09-06;0;0;0;2080.8882988764;1718.16634315323;29;3799.05464202964
08;2020-09-06;0;0;0;2701.8582062647;1896.52641413317;39;4598.38462039786
08;2020-09-06;0;0;0;3151.45861023308;2460.52498233809;49;5611.98359257117
08;2020-09-06;0;0;0;2620.29868333099;2422.23566154656;59;5042.53434487755
08;2020-09-06;0;0;0;1621.44173420671;1438.58325779464;69;3060.02499200135
08;2020-09-06;0;0;0;626.575909335673;526.358467843651;79;1152.93437717932
08;2020-09-06;0;0;0;205.018522985054;140.993639349697;89;346.012162334751
08;2020-09-06;0;0;0;50.0325684687745;20.62259870351;90;70.6551671722846
08;2020-09-06;0;0;0;18551.3174743414;16782.6825256586;0;35334
11;2020-09-06;7;2;10;783071;811785;09;1594856
11;2020-09-06;16;16;33;761456;784653;19;1546109
11;2020-09-06;49;51;100;850145;801772;29;1651917
11;2020-09-06;29;34;63;914360;843488;39;1757848
11;2020-09-06;23;24;47;845609;826202;49;1671811
11;2020-09-06;23;20;43;793566;745070;59;1538636
11;2020-09-06;18;13;31;628649;549192;69;1177841
11;2020-09-06;7;5;12;434606;358356;79;792962
11;2020-09-06;5;2;7;261425;162933;89;424358
11;2020-09-06;4;0;4;89253;32619;90;121872
11;2020-09-06;181;167;350;6362140;5916070;0;12278210
24;2020-09-06;0;1;1;139720;144686;09;284406
24;2020-09-06;3;0;3;152979;161185;19;314164
24;2020-09-06;2;2;4;122237;126536;29;248773
24;2020-09-06;2;2;4;150359;142009;39;292368
24;2020-09-06;2;3;5;161829;158758;49;320587
24;2020-09-06;0;0;0;172552;168011;59;340563
24;2020-09-06;1;0;1;172509;158177;69;330686
24;2020-09-06;0;0;0;129428;110593;79;240021
24;2020-09-06;2;4;6;87342;56882;89;144224
24;2020-09-06;1;1;2;31210;12071;90;43281
24;2020-09-06;13;13;26;1320165;1238908;0;2559073
27;2020-09-06;3;0;3;143373;149679;09;293052
27;2020-09-06;5;4;9;160962;173003;19;333965
27;2020-09-06;2;10;12;133746;142254;29;276000
27;2020-09-06;4;0;4;160004;155407;39;315411
27;2020-09-06;4;4;8;172333;169564;49;341897
27;2020-09-06;3;2;5;189979;183788;59;373767
27;2020-09-06;0;0;0;192591;178206;69;370797
27;2020-09-06;0;3;3;146876;127546;79;274422
27;2020-09-06;0;1;1;96896;61575;89;158471
27;2020-09-06;0;0;0;33148;12109;90;45257
27;2020-09-06;21;24;45;1429908;1353131;0;2783039
28;2020-09-06;2;4;6;180735;186856;09;367591
28;2020-09-06;16;14;30;200125;213621;19;413746
28;2020-09-06;25;15;40;168922;173007;29;341929
28;2020-09-06;10;18;28;196628;188487;39;385115
28;2020-09-06;7;7;14;205396;201699;49;407095
28;2020-09-06;10;12;22;222002;213866;59;435868
28;2020-09-06;5;7;12;224688;203758;69;428446
28;2020-09-06;8;4;12;163192;135543;79;298735
28;2020-09-06;7;1;8;109691;65377;89;175068
28;2020-09-06;3;0;3;37222;12685;90;49907
28;2020-09-06;93;82;175;1708601;1594899;0;3303500
32;2020-09-06;0;2;2;358062;373689;09;731751
32;2020-09-06;3;10;13;387045;406742;19;793787
32;2020-09-06;21;10;32;342304;348587;29;690891
32;2020-09-06;7;10;17;382485;369972;39;752457
32;2020-09-06;3;1;4;382510;376716;49;759226
32;2020-09-06;1;6;7;386937;376527;59;763464
32;2020-09-06;0;0;0;371211;330938;69;702149
32;2020-09-06;0;1;1;250542;201459;79;452001
32;2020-09-06;1;1;2;163399;89786;89;253185
32;2020-09-06;0;0;0;48384;15367;90;63751
32;2020-09-06;36;41;78;3072879;2889783;0;5962662
44;2020-09-06;0;0;0;291525;306839;09;598364
44;2020-09-06;3;2;5;320255;339504;19;659759
44;2020-09-06;6;3;9;302020;314428;29;616448
44;2020-09-06;0;1;1;342222;333292;39;675514
44;2020-09-06;1;2;3;349727;344491;49;694218
44;2020-09-06;1;2;3;381371;373239;59;754610
44;2020-09-06;2;0;2;367165;335850;69;703015
44;2020-09-06;1;0;1;250387;215436;79;465823
44;2020-09-06;0;1;1;170825;105192;89;276017
44;2020-09-06;1;0;1;51248;16731;90;67979
44;2020-09-06;15;11;26;2826745;2685002;0;5511747
52;2020-09-06;0;0;0;213594;223900;09;437494
52;2020-09-06;1;3;4;240818;255197;19;496015
52;2020-09-06;4;3;7;197010;200630;29;397640
52;2020-09-06;1;1;2;231204;224885;39;456089
52;2020-09-06;1;2;3;243874;243418;49;487292
52;2020-09-06;0;3;3;244100;239116;59;483216
52;2020-09-06;0;0;0;241796;221345;69;463141
52;2020-09-06;0;0;0;177805;149903;79;327708
52;2020-09-06;1;0;1;119561;75822;89;195383
52;2020-09-06;0;0;0;42559;15260;90;57819
52;2020-09-06;8;12;20;1952321;1849476;0;3801797
53;2020-09-06;0;2;2;173813;182358;09;356171
53;2020-09-06;1;2;3;202720;214740;19;417460
53;2020-09-06;4;9;13;163116;173196;29;336312
53;2020-09-06;5;3;8;190526;187674;39;378200
53;2020-09-06;3;3;6;212098;212015;49;424113
53;2020-09-06;4;3;7;223699;219176;59;442875
53;2020-09-06;3;2;5;227435;209274;69;436709
53;2020-09-06;2;1;3;169992;140910;79;310902
53;2020-09-06;1;0;1;118117;69883;89;188000
53;2020-09-06;0;0;0;37370;12267;90;49637
53;2020-09-06;23;25;48;1718886;1621493;0;3340379
75;2020-09-06;0;1;1;293104;305291;09;598395
75;2020-09-06;7;11;18;337141;357785;19;694926
75;2020-09-06;28;33;61;295024;300618;29;595642
75;2020-09-06;15;6;21;347871;331233;39;679104
75;2020-09-06;11;9;20;384742;372771;49;757513
75;2020-09-06;9;4;13;413361;390880;59;804241
75;2020-09-06;2;2;4;425623;384060;69;809683
75;2020-09-06;3;2;5;325086;276298;79;601384
75;2020-09-06;4;5;9;213986;139308;89;353294
75;2020-09-06;5;0;5;77600;28200;90;105800
75;2020-09-06;84;73;157;3113538;2886444;0;5999982
76;2020-09-06;1;3;4;305956;318589;09;624545
76;2020-09-06;11;12;23;338942;356969;19;695911
76;2020-09-06;18;25;43;316210;319570;29;635780
76;2020-09-06;5;17;22;356758;337587;39;694345
76;2020-09-06;9;11;20;376541;363812;49;740353
76;2020-09-06;4;4;8;402608;383750;59;786358
76;2020-09-06;3;5;8;394889;358997;69;753886
76;2020-09-06;4;5;9;308664;263806;79;572470
76;2020-09-06;2;5;7;195838;129272;89;325110
76;2020-09-06;0;1;1;69372;26728;90;96100
76;2020-09-06;57;88;145;3065778;2859080;0;5924858
84;2020-09-06;1;3;4;459549;481088;09;940637
84;2020-09-06;6;11;17;487711;511905;19;999616
84;2020-09-06;13;17;30;443824;451094;29;894918
84;2020-09-06;7;7;14;512522;493262;39;1005784
84;2020-09-06;14;5;19;520248;515106;49;1035354
84;2020-09-06;3;2;5;529611;514848;59;1044459
84;2020-09-06;6;3;9;486720;439940;69;926660
84;2020-09-06;1;4;5;372151;315211;79;687362
84;2020-09-06;5;3;8;237198;150524;89;387722
84;2020-09-06;6;0;6;81185;28680;90;109865
84;2020-09-06;62;55;117;4130719;3901658;0;8032377
93;2020-09-06;4;9;13;268834;283093;09;551927
93;2020-09-06;13;5;18;280751;296087;19;576838
93;2020-09-06;13;11;24;254404;255552;29;509956
93;2020-09-06;18;7;25;310704;288398;39;599102
93;2020-09-06;6;7;13;325559;305827;49;631386
93;2020-09-06;7;8;15;353104;325389;59;678493
93;2020-09-06;6;10;16;336327;296459;69;632786
93;2020-09-06;5;5;10;279820;229699;79;509519
93;2020-09-06;3;4;7;171274;113716;89;284990
93;2020-09-06;2;2;4;58896;21758;90;80654
93;2020-09-06;77;68;145;2639673;2415978;0;5055651
94;2020-09-06;0;0;0;16311;17433;09;33744
94;2020-09-06;0;1;1;16679;18132;19;34811
94;2020-09-06;0;0;0;16782;16579;29;33361
94;2020-09-06;0;0;0;23044;20580;39;43624
94;2020-09-06;0;2;2;23065;22140;49;45205
94;2020-09-06;0;0;0;24549;23421;59;47970
94;2020-09-06;0;0;0;23212;21883;69;45095
94;2020-09-06;0;0;0;19544;17141;79;36685
94;2020-09-06;1;0;1;11227;8178;89;19405
94;2020-09-06;0;0;0;3332;1447;90;4779
94;2020-09-06;1;3;4;177745;166934;0;344679
01;2020-09-07;1;1;2;19979;20155;09;40134
01;2020-09-07;10;13;23;24994;25489;19;50483
01;2020-09-07;12;10;22;17868;16690;29;34558
01;2020-09-07;30;15;45;22328;14821;39;37149
01;2020-09-07;27;25;52;28652;20276;49;48928
01;2020-09-07;23;15;38;33264;27260;59;60524
01;2020-09-07;7;8;15;27135;23978;69;51113
01;2020-09-07;2;1;3;18401;14661;79;33062
01;2020-09-07;1;1;2;9633;6375;89;16008
01;2020-09-07;0;0;0;3410;1510;90;4920
01;2020-09-07;113;89;202;205664;171215;0;376879
02;2020-09-07;0;0;0;16881;17110;09;33991
02;2020-09-07;0;2;2;21410;21604;19;43014
02;2020-09-07;3;1;4;16017;15479;29;31496
02;2020-09-07;2;4;6;19825;14455;39;34280
02;2020-09-07;3;1;4;24719;18248;49;42967
02;2020-09-07;4;6;10;34361;28310;59;62671
02;2020-09-07;1;1;2;28061;24495;69;52556
02;2020-09-07;0;0;0;18231;15278;79;33509
02;2020-09-07;1;0;1;11090;7677;89;18767
02;2020-09-07;0;0;0;3992;1506;90;5498
02;2020-09-07;14;15;29;194587;164162;0;358749
03;2020-09-07;3;3;6;31123;30920;09;62043
03;2020-09-07;1;2;3;29370;29268;19;58638
03;2020-09-07;5;5;10;21458;18963;29;40421
03;2020-09-07;4;3;7;21276;18326;39;39602
03;2020-09-07;1;3;4;18164;16593;49;34757
03;2020-09-07;2;3;5;13469;13557;59;27026
03;2020-09-07;0;1;1;8776;8670;69;17446
03;2020-09-07;0;0;0;3777;3591;79;7368
03;2020-09-07;1;0;1;1649;1072;89;2721
03;2020-09-07;0;0;0;485;184;90;669
03;2020-09-07;17;20;37;149547;141144;0;290691
04;2020-09-07;3;1;4;60314;61377;09;121691
04;2020-09-07;11;8;19;66065;68387;19;134452
04;2020-09-07;7;11;18;51059;47156;29;98215
04;2020-09-07;8;5;13;58788;45780;39;104568
04;2020-09-07;11;5;16;61408;52207;49;113615
04;2020-09-07;5;3;8;64838;60759;59;125597
04;2020-09-07;4;6;10;47008;42843;69;89851
04;2020-09-07;1;0;1;25509;21184;79;46693
04;2020-09-07;0;0;0;13168;7647;89;20815
04;2020-09-07;0;0;0;3209;1253;90;4462
04;2020-09-07;50;39;89;451366;408593;0;859959
05;2020-09-07;0;0;0;362.366008612902;341.338819562748;09;703.704828175651
05;2020-09-07;0;0;0;353.376145114279;370.349735405642;19;723.725880519921
05;2020-09-07;0;0;0;218.593559489256;256.539602589476;29;475.133162078732
05;2020-09-07;0;0;0;404.225408693299;360.321910454353;39;764.547319147651
05;2020-09-07;0;0;0;520.067953604221;497.108383964256;49;1017.17633756848
05;2020-09-07;0;0;0;468.146063921917;510.087601910415;59;978.233665832332
05;2020-09-07;0;0;0;340.368470050554;334.366842191253;69;674.735312241807
05;2020-09-07;0;0;0;212.598666888387;192.597753227106;79;405.196420115493
05;2020-09-07;0;0;0;148.727797095705;61.8681715431829;89;210.595968638888
05;2020-09-07;0;0;0;32.9601271090696;10.9909785719784;90;43.9511056810479
05;2020-09-07;0;0;0;3061.43020057959;2935.56979942041;0;5997
06;2020-09-07;0;0;0;42583;42380;09;84963
06;2020-09-07;4;5;9;33369;31925;19;65294
06;2020-09-07;6;6;12;21571;15080;29;36651
06;2020-09-07;4;2;6;21550;16147;39;37697
06;2020-09-07;2;2;4;14193;13939;49;28132
06;2020-09-07;2;1;3;7171;7597;59;14768
06;2020-09-07;0;0;0;3629;4117;69;7746
06;2020-09-07;1;0;1;1577;1457;79;3034
06;2020-09-07;0;0;0;531;474;89;1005
06;2020-09-07;0;0;0;88;93;90;181
06;2020-09-07;19;16;35;146262;133209;0;279471
07;2020-09-07;0;0;0;485;549;09;1034
07;2020-09-07;0;0;0;403;432;19;835
07;2020-09-07;0;0;0;764;841;29;1605
07;2020-09-07;0;0;0;824;928;39;1752
07;2020-09-07;0;0;0;788;1020;49;1808
07;2020-09-07;0;0;0;678;870;59;1548
07;2020-09-07;0;0;0;360;382;69;742
07;2020-09-07;0;0;0;231;190;79;421
07;2020-09-07;0;0;0;114;67;89;181
07;2020-09-07;0;0;0;24;11;90;35
07;2020-09-07;0;0;0;4671;5290;0;9961
08;2020-09-07;0;0;0;2715.22592983026;2997.75551488675;09;5712.98144471701
08;2020-09-07;0;0;0;2778.51901080978;3160.9156459093;19;5939.43465671908
08;2020-09-07;1;1;2;2080.8882988764;1718.16634315323;29;3799.05464202964
08;2020-09-07;2;0;2;2701.8582062647;1896.52641413317;39;4598.38462039786
08;2020-09-07;1;0;1;3151.45861023308;2460.52498233809;49;5611.98359257117
08;2020-09-07;1;0;1;2620.29868333099;2422.23566154656;59;5042.53434487755
08;2020-09-07;0;0;0;1621.44173420671;1438.58325779464;69;3060.02499200135
08;2020-09-07;1;0;1;626.575909335673;526.358467843651;79;1152.93437717932
08;2020-09-07;0;1;1;205.018522985054;140.993639349697;89;346.012162334751
08;2020-09-07;0;0;0;50.0325684687745;20.62259870351;90;70.6551671722846
08;2020-09-07;6;2;8;18551.3174743414;16782.6825256586;0;35334
11;2020-09-07;70;56;131;783071;811785;09;1594856
11;2020-09-07;182;159;358;761456;784653;19;1546109
11;2020-09-07;536;463;1005;850145;801772;29;1651917
11;2020-09-07;313;317;634;914360;843488;39;1757848
11;2020-09-07;250;197;450;845609;826202;49;1671811
11;2020-09-07;203;167;374;793566;745070;59;1538636
11;2020-09-07;106;98;210;628649;549192;69;1177841
11;2020-09-07;47;61;108;434606;358356;79;792962
11;2020-09-07;19;13;32;261425;162933;89;424358
11;2020-09-07;13;4;17;89253;32619;90;121872
11;2020-09-07;1739;1536;3321;6362140;5916070;0;12278210
24;2020-09-07;10;4;15;139720;144686;09;284406
24;2020-09-07;17;19;37;152979;161185;19;314164
24;2020-09-07;25;44;69;122237;126536;29;248773
24;2020-09-07;23;22;45;150359;142009;39;292368
24;2020-09-07;20;14;34;161829;158758;49;320587
24;2020-09-07;16;16;32;172552;168011;59;340563
24;2020-09-07;11;12;23;172509;158177;69;330686
24;2020-09-07;1;4;5;129428;110593;79;240021
24;2020-09-07;5;1;6;87342;56882;89;144224
24;2020-09-07;4;0;4;31210;12071;90;43281
24;2020-09-07;132;136;270;1320165;1238908;0;2559073
27;2020-09-07;9;6;15;143373;149679;09;293052
27;2020-09-07;21;21;42;160962;173003;19;333965
27;2020-09-07;25;44;69;133746;142254;29;276000
27;2020-09-07;24;18;42;160004;155407;39;315411
27;2020-09-07;21;16;37;172333;169564;49;341897
27;2020-09-07;16;10;26;189979;183788;59;373767
27;2020-09-07;7;5;12;192591;178206;69;370797
27;2020-09-07;14;3;17;146876;127546;79;274422
27;2020-09-07;9;2;11;96896;61575;89;158471
27;2020-09-07;6;2;8;33148;12109;90;45257
27;2020-09-07;152;127;279;1429908;1353131;0;2783039
28;2020-09-07;15;7;23;180735;186856;09;367591
28;2020-09-07;17;29;46;200125;213621;19;413746
28;2020-09-07;49;53;102;168922;173007;29;341929
28;2020-09-07;35;20;55;196628;188487;39;385115
28;2020-09-07;37;18;55;205396;201699;49;407095
28;2020-09-07;23;16;39;222002;213866;59;435868
28;2020-09-07;10;9;19;224688;203758;69;428446
28;2020-09-07;10;8;18;163192;135543;79;298735
28;2020-09-07;4;2;6;109691;65377;89;175068
28;2020-09-07;2;0;2;37222;12685;90;49907
28;2020-09-07;202;162;365;1708601;1594899;0;3303500
32;2020-09-07;32;23;59;358062;373689;09;731751
32;2020-09-07;146;135;287;387045;406742;19;793787
32;2020-09-07;199;213;414;342304;348587;29;690891
32;2020-09-07;90;82;173;382485;369972;39;752457
32;2020-09-07;83;97;181;382510;376716;49;759226
32;2020-09-07;56;47;103;386937;376527;59;763464
32;2020-09-07;29;36;66;371211;330938;69;702149
32;2020-09-07;24;18;42;250542;201459;79;452001
32;2020-09-07;14;9;23;163399;89786;89;253185
32;2020-09-07;9;3;12;48384;15367;90;63751
32;2020-09-07;683;663;1361;3072879;2889783;0;5962662
44;2020-09-07;7;15;22;291525;306839;09;598364
44;2020-09-07;26;17;43;320255;339504;19;659759
44;2020-09-07;46;45;92;302020;314428;29;616448
44;2020-09-07;37;24;61;342222;333292;39;675514
44;2020-09-07;26;15;41;349727;344491;49;694218
44;2020-09-07;25;22;47;381371;373239;59;754610
44;2020-09-07;12;11;23;367165;335850;69;703015
44;2020-09-07;8;16;24;250387;215436;79;465823
44;2020-09-07;3;5;8;170825;105192;89;276017
44;2020-09-07;2;1;3;51248;16731;90;67979
44;2020-09-07;192;172;365;2826745;2685002;0;5511747
52;2020-09-07;15;11;26;213594;223900;09;437494
52;2020-09-07;47;50;98;240818;255197;19;496015
52;2020-09-07;48;55;103;197010;200630;29;397640
52;2020-09-07;24;22;46;231204;224885;39;456089
52;2020-09-07;25;24;49;243874;243418;49;487292
52;2020-09-07;19;21;40;244100;239116;59;483216
52;2020-09-07;10;18;28;241796;221345;69;463141
52;2020-09-07;6;1;7;177805;149903;79;327708
52;2020-09-07;6;1;7;119561;75822;89;195383
52;2020-09-07;0;0;0;42559;15260;90;57819
52;2020-09-07;200;203;404;1952321;1849476;0;3801797
53;2020-09-07;6;11;17;173813;182358;09;356171
53;2020-09-07;37;23;60;202720;214740;19;417460
53;2020-09-07;47;45;92;163116;173196;29;336312
53;2020-09-07;22;18;40;190526;187674;39;378200
53;2020-09-07;19;10;29;212098;212015;49;424113
53;2020-09-07;11;17;28;223699;219176;59;442875
53;2020-09-07;12;5;17;227435;209274;69;436709
53;2020-09-07;3;2;5;169992;140910;79;310902
53;2020-09-07;5;1;6;118117;69883;89;188000
53;2020-09-07;2;0;2;37370;12267;90;49637
53;2020-09-07;164;132;296;1718886;1621493;0;3340379
75;2020-09-07;22;11;35;293104;305291;09;598395
75;2020-09-07;50;56;107;337141;357785;19;694926
75;2020-09-07;119;142;261;295024;300618;29;595642
75;2020-09-07;68;72;140;347871;331233;39;679104
75;2020-09-07;54;46;100;384742;372771;49;757513
75;2020-09-07;72;43;115;413361;390880;59;804241
75;2020-09-07;23;34;57;425623;384060;69;809683
75;2020-09-07;13;13;26;325086;276298;79;601384
75;2020-09-07;18;8;27;213986;139308;89;353294
75;2020-09-07;23;6;29;77600;28200;90;105800
75;2020-09-07;462;431;897;3113538;2886444;0;5999982
76;2020-09-07;18;21;40;305956;318589;09;624545
76;2020-09-07;63;75;138;338942;356969;19;695911
76;2020-09-07;126;145;271;316210;319570;29;635780
76;2020-09-07;79;78;157;356758;337587;39;694345
76;2020-09-07;79;45;125;376541;363812;49;740353
76;2020-09-07;84;50;134;402608;383750;59;786358
76;2020-09-07;30;38;68;394889;358997;69;753886
76;2020-09-07;23;20;43;308664;263806;79;572470
76;2020-09-07;25;11;36;195838;129272;89;325110
76;2020-09-07;23;6;29;69372;26728;90;96100
76;2020-09-07;551;489;1042;3065778;2859080;0;5924858
84;2020-09-07;34;30;65;459549;481088;09;940637
84;2020-09-07;83;87;172;487711;511905;19;999616
84;2020-09-07;164;208;372;443824;451094;29;894918
84;2020-09-07;126;100;226;512522;493262;39;1005784
84;2020-09-07;78;77;155;520248;515106;49;1035354
84;2020-09-07;97;77;174;529611;514848;59;1044459
84;2020-09-07;45;48;93;486720;439940;69;926660
84;2020-09-07;27;21;48;372151;315211;79;687362
84;2020-09-07;16;19;35;237198;150524;89;387722
84;2020-09-07;12;10;22;81185;28680;90;109865
84;2020-09-07;682;677;1363;4130719;3901658;0;8032377
93;2020-09-07;43;44;87;268834;283093;09;551927
93;2020-09-07;85;85;170;280751;296087;19;576838
93;2020-09-07;200;154;355;254404;255552;29;509956
93;2020-09-07;150;108;258;310704;288398;39;599102
93;2020-09-07;121;115;236;325559;305827;49;631386
93;2020-09-07;129;93;222;353104;325389;59;678493
93;2020-09-07;90;69;160;336327;296459;69;632786
93;2020-09-07;53;40;93;279820;229699;79;509519
93;2020-09-07;28;23;51;171274;113716;89;284990
93;2020-09-07;16;6;22;58896;21758;90;80654
93;2020-09-07;915;737;1654;2639673;2415978;0;5055651
94;2020-09-07;0;3;3;16311;17433;09;33744
94;2020-09-07;0;5;5;16679;18132;19;34811
94;2020-09-07;14;12;26;16782;16579;29;33361
94;2020-09-07;8;6;14;23044;20580;39;43624
94;2020-09-07;6;8;14;23065;22140;49;45205
94;2020-09-07;4;8;12;24549;23421;59;47970
94;2020-09-07;5;4;9;23212;21883;69;45095
94;2020-09-07;0;6;6;19544;17141;79;36685
94;2020-09-07;1;1;2;11227;8178;89;19405
94;2020-09-07;0;0;0;3332;1447;90;4779
94;2020-09-07;38;53;91;177745;166934;0;344679
01;2020-09-08;2;6;8;19979;20155;09;40134
01;2020-09-08;10;6;16;24994;25489;19;50483
01;2020-09-08;17;18;35;17868;16690;29;34558
01;2020-09-08;23;17;40;22328;14821;39;37149
01;2020-09-08;23;13;36;28652;20276;49;48928
01;2020-09-08;23;23;46;33264;27260;59;60524
01;2020-09-08;12;21;33;27135;23978;69;51113
01;2020-09-08;4;3;7;18401;14661;79;33062
01;2020-09-08;3;0;3;9633;6375;89;16008
01;2020-09-08;0;0;0;3410;1510;90;4920
01;2020-09-08;117;107;224;205664;171215;0;376879
02;2020-09-08;1;0;1;16881;17110;09;33991
02;2020-09-08;1;2;3;21410;21604;19;43014
02;2020-09-08;4;0;4;16017;15479;29;31496
02;2020-09-08;2;2;4;19825;14455;39;34280
02;2020-09-08;1;0;1;24719;18248;49;42967
02;2020-09-08;3;2;6;34361;28310;59;62671
02;2020-09-08;5;0;5;28061;24495;69;52556
02;2020-09-08;0;1;1;18231;15278;79;33509
02;2020-09-08;1;0;1;11090;7677;89;18767
02;2020-09-08;0;0;0;3992;1506;90;5498
02;2020-09-08;18;7;26;194587;164162;0;358749
03;2020-09-08;0;1;1;31123;30920;09;62043
03;2020-09-08;1;2;3;29370;29268;19;58638
03;2020-09-08;6;3;9;21458;18963;29;40421
03;2020-09-08;1;3;4;21276;18326;39;39602
03;2020-09-08;3;5;8;18164;16593;49;34757
03;2020-09-08;1;2;3;13469;13557;59;27026
03;2020-09-08;1;2;3;8776;8670;69;17446
03;2020-09-08;1;0;1;3777;3591;79;7368
03;2020-09-08;0;0;0;1649;1072;89;2721
03;2020-09-08;0;0;0;485;184;90;669
03;2020-09-08;14;18;32;149547;141144;0;290691
04;2020-09-08;4;6;10;60314;61377;09;121691
04;2020-09-08;13;9;22;66065;68387;19;134452
04;2020-09-08;6;7;13;51059;47156;29;98215
04;2020-09-08;6;4;10;58788;45780;39;104568
04;2020-09-08;10;6;16;61408;52207;49;113615
04;2020-09-08;16;10;26;64838;60759;59;125597
04;2020-09-08;3;2;5;47008;42843;69;89851
04;2020-09-08;0;1;1;25509;21184;79;46693
04;2020-09-08;1;0;1;13168;7647;89;20815
04;2020-09-08;0;0;0;3209;1253;90;4462
04;2020-09-08;59;45;104;451366;408593;0;859959
05;2020-09-08;0;0;0;362.366008612902;341.338819562748;09;703.704828175651
05;2020-09-08;0;0;0;353.376145114279;370.349735405642;19;723.725880519921
05;2020-09-08;0;0;0;218.593559489256;256.539602589476;29;475.133162078732
05;2020-09-08;0;0;0;404.225408693299;360.321910454353;39;764.547319147651
05;2020-09-08;0;0;0;520.067953604221;497.108383964256;49;1017.17633756848
05;2020-09-08;0;0;0;468.146063921917;510.087601910415;59;978.233665832332
05;2020-09-08;0;0;0;340.368470050554;334.366842191253;69;674.735312241807
05;2020-09-08;0;0;0;212.598666888387;192.597753227106;79;405.196420115493
05;2020-09-08;0;0;0;148.727797095705;61.8681715431829;89;210.595968638888
05;2020-09-08;0;0;0;32.9601271090696;10.9909785719784;90;43.9511056810479
05;2020-09-08;0;0;0;3061.43020057959;2935.56979942041;0;5997
06;2020-09-08;0;0;0;42583;42380;09;84963
06;2020-09-08;1;3;4;33369;31925;19;65294
06;2020-09-08;1;1;2;21571;15080;29;36651
06;2020-09-08;2;2;4;21550;16147;39;37697
06;2020-09-08;1;2;3;14193;13939;49;28132
06;2020-09-08;2;0;2;7171;7597;59;14768
06;2020-09-08;0;0;0;3629;4117;69;7746
06;2020-09-08;0;0;0;1577;1457;79;3034
06;2020-09-08;0;0;0;531;474;89;1005
06;2020-09-08;0;0;0;88;93;90;181
06;2020-09-08;7;8;15;146262;133209;0;279471
07;2020-09-08;0;0;0;485;549;09;1034
07;2020-09-08;0;0;0;403;432;19;835
07;2020-09-08;0;0;0;764;841;29;1605
07;2020-09-08;0;0;0;824;928;39;1752
07;2020-09-08;0;1;1;788;1020;49;1808
07;2020-09-08;0;0;0;678;870;59;1548
07;2020-09-08;0;0;0;360;382;69;742
07;2020-09-08;0;0;0;231;190;79;421
07;2020-09-08;0;0;0;114;67;89;181
07;2020-09-08;0;0;0;24;11;90;35
07;2020-09-08;0;1;1;4671;5290;0;9961
08;2020-09-08;0;0;0;2715.22592983026;2997.75551488675;09;5712.98144471701
08;2020-09-08;0;0;0;2778.51901080978;3160.9156459093;19;5939.43465671908
08;2020-09-08;0;0;0;2080.8882988764;1718.16634315323;29;3799.05464202964
08;2020-09-08;1;0;1;2701.8582062647;1896.52641413317;39;4598.38462039786
08;2020-09-08;2;0;2;3151.45861023308;2460.52498233809;49;5611.98359257117
08;2020-09-08;2;2;4;2620.29868333099;2422.23566154656;59;5042.53434487755
08;2020-09-08;0;0;0;1621.44173420671;1438.58325779464;69;3060.02499200135
08;2020-09-08;0;0;0;626.575909335673;526.358467843651;79;1152.93437717932
08;2020-09-08;0;0;0;205.018522985054;140.993639349697;89;346.012162334751
08;2020-09-08;0;0;0;50.0325684687745;20.62259870351;90;70.6551671722846
08;2020-09-08;5;2;7;18551.3174743414;16782.6825256586;0;35334
11;2020-09-08;68;54;130;783071;811785;09;1594856
11;2020-09-08;175;139;326;761456;784653;19;1546109
11;2020-09-08;533;448;984;850145;801772;29;1651917
11;2020-09-08;319;299;621;914360;843488;39;1757848
11;2020-09-08;251;184;435;845609;826202;49;1671811
11;2020-09-08;196;147;344;793566;745070;59;1538636
11;2020-09-08;96;87;185;628649;549192;69;1177841
11;2020-09-08;25;43;68;434606;358356;79;792962
11;2020-09-08;22;17;39;261425;162933;89;424358
11;2020-09-08;14;6;20;89253;32619;90;121872
11;2020-09-08;1699;1425;3153;6362140;5916070;0;12278210
24;2020-09-08;1;11;12;139720;144686;09;284406
24;2020-09-08;26;20;46;152979;161185;19;314164
24;2020-09-08;26;44;70;122237;126536;29;248773
24;2020-09-08;19;13;32;150359;142009;39;292368
24;2020-09-08;21;21;42;161829;158758;49;320587
24;2020-09-08;20;17;37;172552;168011;59;340563
24;2020-09-08;9;10;19;172509;158177;69;330686
24;2020-09-08;8;1;9;129428;110593;79;240021
24;2020-09-08;3;2;5;87342;56882;89;144224
24;2020-09-08;1;1;2;31210;12071;90;43281
24;2020-09-08;134;140;274;1320165;1238908;0;2559073
27;2020-09-08;5;14;20;143373;149679;09;293052
27;2020-09-08;19;20;39;160962;173003;19;333965
27;2020-09-08;27;35;62;133746;142254;29;276000
27;2020-09-08;24;23;47;160004;155407;39;315411
27;2020-09-08;16;18;34;172333;169564;49;341897
27;2020-09-08;15;14;29;189979;183788;59;373767
27;2020-09-08;11;9;20;192591;178206;69;370797
27;2020-09-08;3;5;8;146876;127546;79;274422
27;2020-09-08;10;0;10;96896;61575;89;158471
27;2020-09-08;3;1;4;33148;12109;90;45257
27;2020-09-08;134;139;274;1429908;1353131;0;2783039
28;2020-09-08;5;8;14;180735;186856;09;367591
28;2020-09-08;25;31;57;200125;213621;19;413746
28;2020-09-08;50;45;95;168922;173007;29;341929
28;2020-09-08;29;26;55;196628;188487;39;385115
28;2020-09-08;27;23;50;205396;201699;49;407095
28;2020-09-08;18;25;43;222002;213866;59;435868
28;2020-09-08;11;21;32;224688;203758;69;428446
28;2020-09-08;3;8;11;163192;135543;79;298735
28;2020-09-08;1;5;6;109691;65377;89;175068
28;2020-09-08;4;1;5;37222;12685;90;49907
28;2020-09-08;173;193;368;1708601;1594899;0;3303500
32;2020-09-08;29;33;63;358062;373689;09;731751
32;2020-09-08;112;104;220;387045;406742;19;793787
32;2020-09-08;193;203;397;342304;348587;29;690891
32;2020-09-08;75;73;151;382485;369972;39;752457
32;2020-09-08;69;68;139;382510;376716;49;759226
32;2020-09-08;63;57;120;386937;376527;59;763464
32;2020-09-08;35;23;58;371211;330938;69;702149
32;2020-09-08;20;11;31;250542;201459;79;452001
32;2020-09-08;7;7;14;163399;89786;89;253185
32;2020-09-08;3;1;4;48384;15367;90;63751
32;2020-09-08;606;580;1197;3072879;2889783;0;5962662
44;2020-09-08;14;11;26;291525;306839;09;598364
44;2020-09-08;35;28;63;320255;339504;19;659759
44;2020-09-08;53;53;106;302020;314428;29;616448
44;2020-09-08;30;29;59;342222;333292;39;675514
44;2020-09-08;22;23;45;349727;344491;49;694218
44;2020-09-08;26;18;44;381371;373239;59;754610
44;2020-09-08;10;8;18;367165;335850;69;703015
44;2020-09-08;10;11;21;250387;215436;79;465823
44;2020-09-08;3;4;7;170825;105192;89;276017
44;2020-09-08;2;0;2;51248;16731;90;67979
44;2020-09-08;205;185;391;2826745;2685002;0;5511747
52;2020-09-08;21;9;33;213594;223900;09;437494
52;2020-09-08;27;22;51;240818;255197;19;496015
52;2020-09-08;43;54;97;197010;200630;29;397640
52;2020-09-08;27;25;52;231204;224885;39;456089
52;2020-09-08;28;14;42;243874;243418;49;487292
52;2020-09-08;22;12;34;244100;239116;59;483216
52;2020-09-08;5;8;13;241796;221345;69;463141
52;2020-09-08;6;8;14;177805;149903;79;327708
52;2020-09-08;5;5;10;119561;75822;89;195383
52;2020-09-08;1;2;3;42559;15260;90;57819
52;2020-09-08;185;159;349;1952321;1849476;0;3801797
53;2020-09-08;4;6;10;173813;182358;09;356171
53;2020-09-08;19;16;35;202720;214740;19;417460
53;2020-09-08;50;53;103;163116;173196;29;336312
53;2020-09-08;18;23;41;190526;187674;39;378200
53;2020-09-08;12;14;26;212098;212015;49;424113
53;2020-09-08;9;13;22;223699;219176;59;442875
53;2020-09-08;8;9;17;227435;209274;69;436709
53;2020-09-08;3;3;6;169992;140910;79;310902
53;2020-09-08;1;5;6;118117;69883;89;188000
53;2020-09-08;0;0;0;37370;12267;90;49637
53;2020-09-08;124;142;266;1718886;1621493;0;3340379
75;2020-09-08;24;21;45;293104;305291;09;598395
75;2020-09-08;50;55;105;337141;357785;19;694926
75;2020-09-08;122;116;238;295024;300618;29;595642
75;2020-09-08;51;54;106;347871;331233;39;679104
75;2020-09-08;54;56;110;384742;372771;49;757513
75;2020-09-08;74;37;111;413361;390880;59;804241
75;2020-09-08;26;22;48;425623;384060;69;809683
75;2020-09-08;10;15;25;325086;276298;79;601384
75;2020-09-08;11;7;18;213986;139308;89;353294
75;2020-09-08;11;1;12;77600;28200;90;105800
75;2020-09-08;433;384;818;3113538;2886444;0;5999982
76;2020-09-08;17;27;45;305956;318589;09;624545
76;2020-09-08;81;89;172;338942;356969;19;695911
76;2020-09-08;132;143;275;316210;319570;29;635780
76;2020-09-08;85;75;160;356758;337587;39;694345
76;2020-09-08;53;58;111;376541;363812;49;740353
76;2020-09-08;60;53;114;402608;383750;59;786358
76;2020-09-08;35;32;67;394889;358997;69;753886
76;2020-09-08;20;16;36;308664;263806;79;572470
76;2020-09-08;21;11;32;195838;129272;89;325110
76;2020-09-08;12;4;16;69372;26728;90;96100
76;2020-09-08;517;508;1029;3065778;2859080;0;5924858
84;2020-09-08;52;29;82;459549;481088;09;940637
84;2020-09-08;105;107;215;487711;511905;19;999616
84;2020-09-08;212;267;479;443824;451094;29;894918
84;2020-09-08;112;100;212;512522;493262;39;1005784
84;2020-09-08;103;85;188;520248;515106;49;1035354
84;2020-09-08;86;100;186;529611;514848;59;1044459
84;2020-09-08;36;47;83;486720;439940;69;926660
84;2020-09-08;25;15;40;372151;315211;79;687362
84;2020-09-08;23;15;38;237198;150524;89;387722
84;2020-09-08;21;4;25;81185;28680;90;109865
84;2020-09-08;775;769;1548;4130719;3901658;0;8032377
93;2020-09-08;33;29;64;268834;283093;09;551927
93;2020-09-08;69;97;166;280751;296087;19;576838
93;2020-09-08;160;145;305;254404;255552;29;509956
93;2020-09-08;134;99;233;310704;288398;39;599102
93;2020-09-08;120;89;209;325559;305827;49;631386
93;2020-09-08;102;82;184;353104;325389;59;678493
93;2020-09-08;74;56;130;336327;296459;69;632786
93;2020-09-08;32;29;61;279820;229699;79;509519
93;2020-09-08;18;16;34;171274;113716;89;284990
93;2020-09-08;15;2;17;58896;21758;90;80654
93;2020-09-08;757;644;1403;2639673;2415978;0;5055651
94;2020-09-08;2;1;3;16311;17433;09;33744
94;2020-09-08;6;0;6;16679;18132;19;34811
94;2020-09-08;9;5;14;16782;16579;29;33361
94;2020-09-08;5;3;8;23044;20580;39;43624
94;2020-09-08;3;2;5;23065;22140;49;45205
94;2020-09-08;1;3;4;24549;23421;59;47970
94;2020-09-08;2;4;6;23212;21883;69;45095
94;2020-09-08;0;0;0;19544;17141;79;36685
94;2020-09-08;0;1;1;11227;8178;89;19405
94;2020-09-08;0;0;0;3332;1447;90;4779
94;2020-09-08;28;19;47;177745;166934;0;344679
01;2020-09-09;2;3;5;19979;20155;09;40134
01;2020-09-09;9;3;12;24994;25489;19;50483
01;2020-09-09;11;13;24;17868;16690;29;34558
01;2020-09-09;9;16;25;22328;14821;39;37149
01;2020-09-09;23;13;36;28652;20276;49;48928
01;2020-09-09;16;17;33;33264;27260;59;60524
01;2020-09-09;11;19;30;27135;23978;69;51113
01;2020-09-09;6;7;13;18401;14661;79;33062
01;2020-09-09;0;2;2;9633;6375;89;16008
01;2020-09-09;1;0;1;3410;1510;90;4920
01;2020-09-09;88;93;181;205664;171215;0;376879
02;2020-09-09;0;1;1;16881;17110;09;33991
02;2020-09-09;2;1;3;21410;21604;19;43014
02;2020-09-09;3;2;5;16017;15479;29;31496
02;2020-09-09;3;3;6;19825;14455;39;34280
02;2020-09-09;4;3;7;24719;18248;49;42967
02;2020-09-09;4;3;7;34361;28310;59;62671
02;2020-09-09;1;1;2;28061;24495;69;52556
02;2020-09-09;2;0;2;18231;15278;79;33509
02;2020-09-09;0;0;0;11090;7677;89;18767
02;2020-09-09;0;0;0;3992;1506;90;5498
02;2020-09-09;19;14;33;194587;164162;0;358749
03;2020-09-09;2;1;4;31123;30920;09;62043
03;2020-09-09;2;6;10;29370;29268;19;58638
03;2020-09-09;2;3;5;21458;18963;29;40421
03;2020-09-09;5;5;10;21276;18326;39;39602
03;2020-09-09;2;2;4;18164;16593;49;34757
03;2020-09-09;3;2;5;13469;13557;59;27026
03;2020-09-09;2;0;2;8776;8670;69;17446
03;2020-09-09;0;0;0;3777;3591;79;7368
03;2020-09-09;0;0;0;1649;1072;89;2721
03;2020-09-09;0;0;0;485;184;90;669
03;2020-09-09;18;19;40;149547;141144;0;290691
04;2020-09-09;2;3;5;60314;61377;09;121691
04;2020-09-09;9;16;25;66065;68387;19;134452
04;2020-09-09;12;8;20;51059;47156;29;98215
04;2020-09-09;5;5;10;58788;45780;39;104568
04;2020-09-09;16;8;24;61408;52207;49;113615
04;2020-09-09;8;9;17;64838;60759;59;125597
04;2020-09-09;7;10;17;47008;42843;69;89851
04;2020-09-09;1;2;3;25509;21184;79;46693
04;2020-09-09;0;0;0;13168;7647;89;20815
04;2020-09-09;0;0;0;3209;1253;90;4462
04;2020-09-09;60;61;121;451366;408593;0;859959
05;2020-09-09;0;0;0;362.366008612902;341.338819562748;09;703.704828175651
05;2020-09-09;0;0;0;353.376145114279;370.349735405642;19;723.725880519921
05;2020-09-09;0;0;0;218.593559489256;256.539602589476;29;475.133162078732
05;2020-09-09;0;0;0;404.225408693299;360.321910454353;39;764.547319147651
05;2020-09-09;0;0;0;520.067953604221;497.108383964256;49;1017.17633756848
05;2020-09-09;0;0;0;468.146063921917;510.087601910415;59;978.233665832332
05;2020-09-09;0;0;0;340.368470050554;334.366842191253;69;674.735312241807
05;2020-09-09;0;0;0;212.598666888387;192.597753227106;79;405.196420115493
05;2020-09-09;0;0;0;148.727797095705;61.8681715431829;89;210.595968638888
05;2020-09-09;0;0;0;32.9601271090696;10.9909785719784;90;43.9511056810479
05;2020-09-09;0;0;0;3061.43020057959;2935.56979942041;0;5997
06;2020-09-09;0;0;0;42583;42380;09;84963
06;2020-09-09;1;1;2;33369;31925;19;65294
06;2020-09-09;4;4;8;21571;15080;29;36651
06;2020-09-09;2;0;2;21550;16147;39;37697
06;2020-09-09;1;1;2;14193;13939;49;28132
06;2020-09-09;0;2;2;7171;7597;59;14768
06;2020-09-09;0;0;0;3629;4117;69;7746
06;2020-09-09;0;0;0;1577;1457;79;3034
06;2020-09-09;0;0;0;531;474;89;1005
06;2020-09-09;0;0;0;88;93;90;181
06;2020-09-09;8;8;16;146262;133209;0;279471
07;2020-09-09;0;0;0;485;549;09;1034
07;2020-09-09;0;0;0;403;432;19;835
07;2020-09-09;0;0;0;764;841;29;1605
07;2020-09-09;0;0;0;824;928;39;1752
07;2020-09-09;0;0;0;788;1020;49;1808
07;2020-09-09;0;0;0;678;870;59;1548
07;2020-09-09;0;0;0;360;382;69;742
07;2020-09-09;0;0;0;231;190;79;421
07;2020-09-09;0;0;0;114;67;89;181
07;2020-09-09;0;0;0;24;11;90;35
07;2020-09-09;0;0;0;4671;5290;0;9961
08;2020-09-09;0;0;0;2715.22592983026;2997.75551488675;09;5712.98144471701
08;2020-09-09;0;0;0;2778.51901080978;3160.9156459093;19;5939.43465671908
08;2020-09-09;1;0;1;2080.8882988764;1718.16634315323;29;3799.05464202964
08;2020-09-09;2;2;4;2701.8582062647;1896.52641413317;39;4598.38462039786
08;2020-09-09;2;0;2;3151.45861023308;2460.52498233809;49;5611.98359257117
08;2020-09-09;0;1;1;2620.29868333099;2422.23566154656;59;5042.53434487755
08;2020-09-09;0;1;1;1621.44173420671;1438.58325779464;69;3060.02499200135
08;2020-09-09;0;1;1;626.575909335673;526.358467843651;79;1152.93437717932
08;2020-09-09;1;0;1;205.018522985054;140.993639349697;89;346.012162334751
08;2020-09-09;0;0;0;50.0325684687745;20.62259870351;90;70.6551671722846
08;2020-09-09;6;5;11;18551.3174743414;16782.6825256586;0;35334
11;2020-09-09;56;59;121;783071;811785;09;1594856
11;2020-09-09;163;156;330;761456;784653;19;1546109
11;2020-09-09;475;466;950;850145;801772;29;1651917
11;2020-09-09;291;287;582;914360;843488;39;1757848
11;2020-09-09;189;208;400;845609;826202;49;1671811
11;2020-09-09;178;144;322;793566;745070;59;1538636
11;2020-09-09;82;83;166;628649;549192;69;1177841
11;2020-09-09;34;32;68;434606;358356;79;792962
11;2020-09-09;17;20;37;261425;162933;89;424358
11;2020-09-09;10;7;17;89253;32619;90;121872
11;2020-09-09;1495;1463;2998;6362140;5916070;0;12278210
24;2020-09-09;7;4;12;139720;144686;09;284406
24;2020-09-09;12;18;31;152979;161185;19;314164
24;2020-09-09;25;20;45;122237;126536;29;248773
24;2020-09-09;15;25;40;150359;142009;39;292368
24;2020-09-09;22;10;32;161829;158758;49;320587
24;2020-09-09;11;8;19;172552;168011;59;340563
24;2020-09-09;7;5;12;172509;158177;69;330686
24;2020-09-09;4;4;8;129428;110593;79;240021
24;2020-09-09;3;3;6;87342;56882;89;144224
24;2020-09-09;0;0;0;31210;12071;90;43281
24;2020-09-09;106;97;205;1320165;1238908;0;2559073
27;2020-09-09;5;6;11;143373;149679;09;293052
27;2020-09-09;13;14;28;160962;173003;19;333965
27;2020-09-09;20;24;44;133746;142254;29;276000
27;2020-09-09;17;20;37;160004;155407;39;315411
27;2020-09-09;16;15;31;172333;169564;49;341897
27;2020-09-09;13;16;29;189979;183788;59;373767
27;2020-09-09;4;8;12;192591;178206;69;370797
27;2020-09-09;5;3;8;146876;127546;79;274422
27;2020-09-09;2;0;2;96896;61575;89;158471
27;2020-09-09;2;0;2;33148;12109;90;45257
27;2020-09-09;97;106;204;1429908;1353131;0;2783039
28;2020-09-09;10;13;23;180735;186856;09;367591
28;2020-09-09;28;33;61;200125;213621;19;413746
28;2020-09-09;59;42;101;168922;173007;29;341929
28;2020-09-09;27;25;52;196628;188487;39;385115
28;2020-09-09;30;20;51;205396;201699;49;407095
28;2020-09-09;27;14;41;222002;213866;59;435868
28;2020-09-09;17;13;31;224688;203758;69;428446
28;2020-09-09;3;4;7;163192;135543;79;298735
28;2020-09-09;4;3;7;109691;65377;89;175068
28;2020-09-09;2;0;2;37222;12685;90;49907
28;2020-09-09;207;167;376;1708601;1594899;0;3303500
32;2020-09-09;20;15;35;358062;373689;09;731751
32;2020-09-09;110;100;212;387045;406742;19;793787
32;2020-09-09;183;175;359;342304;348587;29;690891
32;2020-09-09;69;70;140;382485;369972;39;752457
32;2020-09-09;86;78;167;382510;376716;49;759226
32;2020-09-09;85;55;141;386937;376527;59;763464
32;2020-09-09;34;32;67;371211;330938;69;702149
32;2020-09-09;22;19;41;250542;201459;79;452001
32;2020-09-09;4;3;7;163399;89786;89;253185
32;2020-09-09;3;2;5;48384;15367;90;63751
32;2020-09-09;617;549;1175;3072879;2889783;0;5962662
44;2020-09-09;7;10;17;291525;306839;09;598364
44;2020-09-09;35;34;69;320255;339504;19;659759
44;2020-09-09;68;66;134;302020;314428;29;616448
44;2020-09-09;32;21;53;342222;333292;39;675514
44;2020-09-09;21;20;41;349727;344491;49;694218
44;2020-09-09;21;18;40;381371;373239;59;754610
44;2020-09-09;13;12;25;367165;335850;69;703015
44;2020-09-09;9;4;13;250387;215436;79;465823
44;2020-09-09;4;2;6;170825;105192;89;276017
44;2020-09-09;2;0;2;51248;16731;90;67979
44;2020-09-09;213;187;401;2826745;2685002;0;5511747
52;2020-09-09;17;7;25;213594;223900;09;437494
52;2020-09-09;34;38;74;240818;255197;19;496015
52;2020-09-09;50;64;114;197010;200630;29;397640
52;2020-09-09;29;26;55;231204;224885;39;456089
52;2020-09-09;25;15;40;243874;243418;49;487292
52;2020-09-09;20;11;31;244100;239116;59;483216
52;2020-09-09;8;14;22;241796;221345;69;463141
52;2020-09-09;4;7;11;177805;149903;79;327708
52;2020-09-09;4;3;7;119561;75822;89;195383
52;2020-09-09;1;1;2;42559;15260;90;57819
52;2020-09-09;192;186;381;1952321;1849476;0;3801797
53;2020-09-09;5;8;14;173813;182358;09;356171
53;2020-09-09;35;38;74;202720;214740;19;417460
53;2020-09-09;46;52;99;163116;173196;29;336312
53;2020-09-09;14;21;35;190526;187674;39;378200
53;2020-09-09;10;27;37;212098;212015;49;424113
53;2020-09-09;15;16;31;223699;219176;59;442875
53;2020-09-09;7;6;13;227435;209274;69;436709
53;2020-09-09;7;3;10;169992;140910;79;310902
53;2020-09-09;1;6;7;118117;69883;89;188000
53;2020-09-09;4;0;4;37370;12267;90;49637
53;2020-09-09;144;177;324;1718886;1621493;0;3340379
75;2020-09-09;12;16;28;293104;305291;09;598395
75;2020-09-09;50;64;115;337141;357785;19;694926
75;2020-09-09;96;131;227;295024;300618;29;595642
75;2020-09-09;56;57;113;347871;331233;39;679104
75;2020-09-09;63;53;116;384742;372771;49;757513
75;2020-09-09;33;47;80;413361;390880;59;804241
75;2020-09-09;19;22;41;425623;384060;69;809683
75;2020-09-09;20;10;30;325086;276298;79;601384
75;2020-09-09;11;8;19;213986;139308;89;353294
75;2020-09-09;13;7;20;77600;28200;90;105800
75;2020-09-09;373;415;789;3113538;2886444;0;5999982
76;2020-09-09;26;21;47;305956;318589;09;624545
76;2020-09-09;76;103;180;338942;356969;19;695911
76;2020-09-09;132;142;274;316210;319570;29;635780
76;2020-09-09;78;56;134;356758;337587;39;694345
76;2020-09-09;71;61;132;376541;363812;49;740353
76;2020-09-09;57;49;106;402608;383750;59;786358
76;2020-09-09;24;29;53;394889;358997;69;753886
76;2020-09-09;21;26;47;308664;263806;79;572470
76;2020-09-09;17;12;29;195838;129272;89;325110
76;2020-09-09;27;6;33;69372;26728;90;96100
76;2020-09-09;530;505;1036;3065778;2859080;0;5924858
84;2020-09-09;32;40;73;459549;481088;09;940637
84;2020-09-09;87;100;189;487711;511905;19;999616
84;2020-09-09;190;207;401;443824;451094;29;894918
84;2020-09-09;88;99;187;512522;493262;39;1005784
84;2020-09-09;90;82;173;520248;515106;49;1035354
84;2020-09-09;79;78;157;529611;514848;59;1044459
84;2020-09-09;44;32;76;486720;439940;69;926660
84;2020-09-09;26;25;51;372151;315211;79;687362
84;2020-09-09;25;18;43;237198;150524;89;387722
84;2020-09-09;19;4;23;81185;28680;90;109865
84;2020-09-09;681;685;1374;4130719;3901658;0;8032377
93;2020-09-09;30;45;81;268834;283093;09;551927
93;2020-09-09;93;94;188;280751;296087;19;576838
93;2020-09-09;161;149;310;254404;255552;29;509956
93;2020-09-09;123;91;214;310704;288398;39;599102
93;2020-09-09;106;82;188;325559;305827;49;631386
93;2020-09-09;101;100;201;353104;325389;59;678493
93;2020-09-09;66;57;123;336327;296459;69;632786
93;2020-09-09;34;43;77;279820;229699;79;509519
93;2020-09-09;31;23;54;171274;113716;89;284990
93;2020-09-09;22;5;27;58896;21758;90;80654
93;2020-09-09;767;689;1463;2639673;2415978;0;5055651
94;2020-09-09;0;0;0;16311;17433;09;33744
94;2020-09-09;5;7;12;16679;18132;19;34811
94;2020-09-09;9;6;15;16782;16579;29;33361
94;2020-09-09;5;2;7;23044;20580;39;43624
94;2020-09-09;4;1;5;23065;22140;49;45205
94;2020-09-09;2;2;4;24549;23421;59;47970
94;2020-09-09;1;2;3;23212;21883;69;45095
94;2020-09-09;3;1;4;19544;17141;79;36685
94;2020-09-09;0;1;1;11227;8178;89;19405
94;2020-09-09;0;0;0;3332;1447;90;4779
94;2020-09-09;29;22;51;177745;166934;0;344679
01;2020-09-10;0;0;0;19979;20155;09;40134
01;2020-09-10;12;9;21;24994;25489;19;50483
01;2020-09-10;12;10;22;17868;16690;29;34558
01;2020-09-10;26;13;39;22328;14821;39;37149
01;2020-09-10;24;22;46;28652;20276;49;48928
01;2020-09-10;15;18;33;33264;27260;59;60524
01;2020-09-10;17;15;32;27135;23978;69;51113
01;2020-09-10;4;3;7;18401;14661;79;33062
01;2020-09-10;0;2;2;9633;6375;89;16008
01;2020-09-10;0;1;1;3410;1510;90;4920
01;2020-09-10;110;93;203;205664;171215;0;376879
02;2020-09-10;2;0;2;16881;17110;09;33991
02;2020-09-10;2;3;5;21410;21604;19;43014
02;2020-09-10;6;6;12;16017;15479;29;31496
02;2020-09-10;4;2;6;19825;14455;39;34280
02;2020-09-10;0;4;4;24719;18248;49;42967
02;2020-09-10;5;3;8;34361;28310;59;62671
02;2020-09-10;1;3;4;28061;24495;69;52556
02;2020-09-10;1;0;1;18231;15278;79;33509
02;2020-09-10;0;0;0;11090;7677;89;18767
02;2020-09-10;0;0;0;3992;1506;90;5498
02;2020-09-10;21;21;42;194587;164162;0;358749
03;2020-09-10;1;0;1;31123;30920;09;62043
03;2020-09-10;4;4;8;29370;29268;19;58638
03;2020-09-10;4;3;8;21458;18963;29;40421
03;2020-09-10;7;2;9;21276;18326;39;39602
03;2020-09-10;7;1;8;18164;16593;49;34757
03;2020-09-10;1;2;3;13469;13557;59;27026
03;2020-09-10;1;2;3;8776;8670;69;17446
03;2020-09-10;0;0;0;3777;3591;79;7368
03;2020-09-10;0;0;0;1649;1072;89;2721
03;2020-09-10;0;0;0;485;184;90;669
03;2020-09-10;25;14;40;149547;141144;0;290691
04;2020-09-10;8;2;10;60314;61377;09;121691
04;2020-09-10;10;8;18;66065;68387;19;134452
04;2020-09-10;9;7;16;51059;47156;29;98215
04;2020-09-10;7;8;15;58788;45780;39;104568
04;2020-09-10;6;4;10;61408;52207;49;113615
04;2020-09-10;8;4;12;64838;60759;59;125597
04;2020-09-10;4;3;7;47008;42843;69;89851
04;2020-09-10;2;1;3;25509;21184;79;46693
04;2020-09-10;1;1;2;13168;7647;89;20815
04;2020-09-10;1;0;1;3209;1253;90;4462
04;2020-09-10;56;38;94;451366;408593;0;859959
05;2020-09-10;0;0;0;362.366008612902;341.338819562748;09;703.704828175651
05;2020-09-10;0;0;0;353.376145114279;370.349735405642;19;723.725880519921
05;2020-09-10;0;0;0;218.593559489256;256.539602589476;29;475.133162078732
05;2020-09-10;0;0;0;404.225408693299;360.321910454353;39;764.547319147651
05;2020-09-10;0;0;0;520.067953604221;497.108383964256;49;1017.17633756848
05;2020-09-10;0;0;0;468.146063921917;510.087601910415;59;978.233665832332
05;2020-09-10;0;0;0;340.368470050554;334.366842191253;69;674.735312241807
05;2020-09-10;0;0;0;212.598666888387;192.597753227106;79;405.196420115493
05;2020-09-10;0;0;0;148.727797095705;61.8681715431829;89;210.595968638888
05;2020-09-10;0;0;0;32.9601271090696;10.9909785719784;90;43.9511056810479
05;2020-09-10;0;0;0;3061.43020057959;2935.56979942041;0;5997
06;2020-09-10;0;0;0;42583;42380;09;84963
06;2020-09-10;1;0;1;33369;31925;19;65294
06;2020-09-10;7;4;11;21571;15080;29;36651
06;2020-09-10;0;1;1;21550;16147;39;37697
06;2020-09-10;1;0;1;14193;13939;49;28132
06;2020-09-10;3;0;3;7171;7597;59;14768
06;2020-09-10;0;0;0;3629;4117;69;7746
06;2020-09-10;1;0;1;1577;1457;79;3034
06;2020-09-10;0;0;0;531;474;89;1005
06;2020-09-10;0;0;0;88;93;90;181
06;2020-09-10;13;5;18;146262;133209;0;279471
07;2020-09-10;0;0;0;485;549;09;1034
07;2020-09-10;0;0;0;403;432;19;835
07;2020-09-10;0;0;0;764;841;29;1605
07;2020-09-10;0;0;0;824;928;39;1752
07;2020-09-10;1;0;1;788;1020;49;1808
07;2020-09-10;0;0;0;678;870;59;1548
07;2020-09-10;0;0;0;360;382;69;742
07;2020-09-10;0;0;0;231;190;79;421
07;2020-09-10;0;0;0;114;67;89;181
07;2020-09-10;0;0;0;24;11;90;35
07;2020-09-10;1;0;1;4671;5290;0;9961
08;2020-09-10;0;0;0;2715.22592983026;2997.75551488675;09;5712.98144471701
08;2020-09-10;0;0;0;2778.51901080978;3160.9156459093;19;5939.43465671908
08;2020-09-10;1;1;2;2080.8882988764;1718.16634315323;29;3799.05464202964
08;2020-09-10;1;1;2;2701.8582062647;1896.52641413317;39;4598.38462039786
08;2020-09-10;1;1;2;3151.45861023308;2460.52498233809;49;5611.98359257117
08;2020-09-10;0;4;4;2620.29868333099;2422.23566154656;59;5042.53434487755
08;2020-09-10;2;5;7;1621.44173420671;1438.58325779464;69;3060.02499200135
08;2020-09-10;0;0;0;626.575909335673;526.358467843651;79;1152.93437717932
08;2020-09-10;0;0;0;205.018522985054;140.993639349697;89;346.012162334751
08;2020-09-10;1;0;1;50.0325684687745;20.62259870351;90;70.6551671722846
08;2020-09-10;6;12;18;18551.3174743414;16782.6825256586;0;35334
11;2020-09-10;66;77;146;783071;811785;09;1594856
11;2020-09-10;201;217;422;761456;784653;19;1546109
11;2020-09-10;516;496;1014;850145;801772;29;1651917
11;2020-09-10;309;322;634;914360;843488;39;1757848
11;2020-09-10;243;207;451;845609;826202;49;1671811
11;2020-09-10;202;165;371;793566;745070;59;1538636
11;2020-09-10;98;102;200;628649;549192;69;1177841
11;2020-09-10;34;41;75;434606;358356;79;792962
11;2020-09-10;16;15;33;261425;162933;89;424358
11;2020-09-10;13;6;19;89253;32619;90;121872
11;2020-09-10;1698;1648;3365;6362140;5916070;0;12278210
24;2020-09-10;3;5;9;139720;144686;09;284406
24;2020-09-10;16;15;31;152979;161185;19;314164
24;2020-09-10;36;32;68;122237;126536;29;248773
24;2020-09-10;23;14;37;150359;142009;39;292368
24;2020-09-10;21;24;45;161829;158758;49;320587
24;2020-09-10;8;14;22;172552;168011;59;340563
24;2020-09-10;9;10;19;172509;158177;69;330686
24;2020-09-10;2;5;7;129428;110593;79;240021
24;2020-09-10;4;2;6;87342;56882;89;144224
24;2020-09-10;1;1;2;31210;12071;90;43281
24;2020-09-10;123;122;246;1320165;1238908;0;2559073
27;2020-09-10;11;7;18;143373;149679;09;293052
27;2020-09-10;18;19;37;160962;173003;19;333965
27;2020-09-10;37;47;84;133746;142254;29;276000
27;2020-09-10;18;17;35;160004;155407;39;315411
27;2020-09-10;20;15;35;172333;169564;49;341897
27;2020-09-10;15;19;34;189979;183788;59;373767
27;2020-09-10;9;10;19;192591;178206;69;370797
27;2020-09-10;5;7;12;146876;127546;79;274422
27;2020-09-10;3;1;4;96896;61575;89;158471
27;2020-09-10;0;0;0;33148;12109;90;45257
27;2020-09-10;136;142;278;1429908;1353131;0;2783039
28;2020-09-10;7;15;22;180735;186856;09;367591
28;2020-09-10;23;29;55;200125;213621;19;413746
28;2020-09-10;50;47;97;168922;173007;29;341929
28;2020-09-10;32;40;72;196628;188487;39;385115
28;2020-09-10;32;22;54;205396;201699;49;407095
28;2020-09-10;21;22;43;222002;213866;59;435868
28;2020-09-10;18;18;36;224688;203758;69;428446
28;2020-09-10;7;6;13;163192;135543;79;298735
28;2020-09-10;6;3;9;109691;65377;89;175068
28;2020-09-10;0;0;0;37222;12685;90;49907
28;2020-09-10;196;202;401;1708601;1594899;0;3303500
32;2020-09-10;32;22;55;358062;373689;09;731751
32;2020-09-10;131;98;230;387045;406742;19;793787
32;2020-09-10;178;203;381;342304;348587;29;690891
32;2020-09-10;79;86;166;382485;369972;39;752457
32;2020-09-10;71;74;146;382510;376716;49;759226
32;2020-09-10;73;50;124;386937;376527;59;763464
32;2020-09-10;34;36;70;371211;330938;69;702149
32;2020-09-10;16;15;31;250542;201459;79;452001
32;2020-09-10;8;5;13;163399;89786;89;253185
32;2020-09-10;1;1;2;48384;15367;90;63751
32;2020-09-10;623;590;1218;3072879;2889783;0;5962662
44;2020-09-10;12;16;28;291525;306839;09;598364
44;2020-09-10;47;59;106;320255;339504;19;659759
44;2020-09-10;54;56;111;302020;314428;29;616448
44;2020-09-10;44;37;81;342222;333292;39;675514
44;2020-09-10;24;20;44;349727;344491;49;694218
44;2020-09-10;35;16;51;381371;373239;59;754610
44;2020-09-10;11;13;24;367165;335850;69;703015
44;2020-09-10;11;8;19;250387;215436;79;465823
44;2020-09-10;5;5;10;170825;105192;89;276017
44;2020-09-10;5;2;7;51248;16731;90;67979
44;2020-09-10;248;232;481;2826745;2685002;0;5511747
52;2020-09-10;3;8;12;213594;223900;09;437494
52;2020-09-10;27;35;62;240818;255197;19;496015
52;2020-09-10;47;35;82;197010;200630;29;397640
52;2020-09-10;24;23;47;231204;224885;39;456089
52;2020-09-10;27;28;55;243874;243418;49;487292
52;2020-09-10;17;17;34;244100;239116;59;483216
52;2020-09-10;14;7;21;241796;221345;69;463141
52;2020-09-10;9;5;14;177805;149903;79;327708
52;2020-09-10;2;2;4;119561;75822;89;195383
52;2020-09-10;3;2;5;42559;15260;90;57819
52;2020-09-10;173;162;336;1952321;1849476;0;3801797
53;2020-09-10;10;9;19;173813;182358;09;356171
53;2020-09-10;33;43;76;202720;214740;19;417460
53;2020-09-10;32;53;85;163116;173196;29;336312
53;2020-09-10;34;14;48;190526;187674;39;378200
53;2020-09-10;13;15;28;212098;212015;49;424113
53;2020-09-10;11;9;20;223699;219176;59;442875
53;2020-09-10;13;12;25;227435;209274;69;436709
53;2020-09-10;2;2;4;169992;140910;79;310902
53;2020-09-10;7;4;11;118117;69883;89;188000
53;2020-09-10;6;6;12;37370;12267;90;49637
53;2020-09-10;161;167;328;1718886;1621493;0;3340379
75;2020-09-10;23;21;44;293104;305291;09;598395
75;2020-09-10;63;57;120;337141;357785;19;694926
75;2020-09-10;119;112;231;295024;300618;29;595642
75;2020-09-10;61;89;150;347871;331233;39;679104
75;2020-09-10;51;52;103;384742;372771;49;757513
75;2020-09-10;44;43;88;413361;390880;59;804241
75;2020-09-10;28;23;52;425623;384060;69;809683
75;2020-09-10;14;29;43;325086;276298;79;601384
75;2020-09-10;22;9;31;213986;139308;89;353294
75;2020-09-10;10;3;13;77600;28200;90;105800
75;2020-09-10;435;438;875;3113538;2886444;0;5999982
76;2020-09-10;17;24;43;305956;318589;09;624545
76;2020-09-10;90;113;207;338942;356969;19;695911
76;2020-09-10;137;141;281;316210;319570;29;635780
76;2020-09-10;81;50;131;356758;337587;39;694345
76;2020-09-10;88;62;150;376541;363812;49;740353
76;2020-09-10;58;54;112;402608;383750;59;786358
76;2020-09-10;30;29;59;394889;358997;69;753886
76;2020-09-10;23;18;41;308664;263806;79;572470
76;2020-09-10;34;17;51;195838;129272;89;325110
76;2020-09-10;26;3;29;69372;26728;90;96100
76;2020-09-10;585;511;1105;3065778;2859080;0;5924858
84;2020-09-10;39;42;82;459549;481088;09;940637
84;2020-09-10;83;75;158;487711;511905;19;999616
84;2020-09-10;173;207;380;443824;451094;29;894918
84;2020-09-10;122;87;209;512522;493262;39;1005784
84;2020-09-10;93;92;185;520248;515106;49;1035354
84;2020-09-10;90;87;177;529611;514848;59;1044459
84;2020-09-10;47;48;95;486720;439940;69;926660
84;2020-09-10;31;26;57;372151;315211;79;687362
84;2020-09-10;31;17;48;237198;150524;89;387722
84;2020-09-10;39;8;47;81185;28680;90;109865
84;2020-09-10;748;689;1438;4130719;3901658;0;8032377
93;2020-09-10;24;33;57;268834;283093;09;551927
93;2020-09-10;65;78;143;280751;296087;19;576838
93;2020-09-10;172;115;287;254404;255552;29;509956
93;2020-09-10;120;103;223;310704;288398;39;599102
93;2020-09-10;107;78;185;325559;305827;49;631386
93;2020-09-10;102;103;205;353104;325389;59;678493
93;2020-09-10;59;55;114;336327;296459;69;632786
93;2020-09-10;41;29;70;279820;229699;79;509519
93;2020-09-10;27;15;42;171274;113716;89;284990
93;2020-09-10;23;5;28;58896;21758;90;80654
93;2020-09-10;741;614;1355;2639673;2415978;0;5055651
94;2020-09-10;0;2;2;16311;17433;09;33744
94;2020-09-10;3;2;5;16679;18132;19;34811
94;2020-09-10;7;8;15;16782;16579;29;33361
94;2020-09-10;0;2;2;23044;20580;39;43624
94;2020-09-10;4;3;7;23065;22140;49;45205
94;2020-09-10;6;6;12;24549;23421;59;47970
94;2020-09-10;0;0;0;23212;21883;69;45095
94;2020-09-10;2;1;3;19544;17141;79;36685
94;2020-09-10;1;1;2;11227;8178;89;19405
94;2020-09-10;0;0;0;3332;1447;90;4779
94;2020-09-10;23;25;48;177745;166934;0;344679
01;2020-09-11;0;2;2;19979;20155;09;40134
01;2020-09-11;4;3;7;24994;25489;19;50483
01;2020-09-11;2;5;7;17868;16690;29;34558
01;2020-09-11;5;2;7;22328;14821;39;37149
01;2020-09-11;7;6;13;28652;20276;49;48928
01;2020-09-11;10;11;21;33264;27260;59;60524
01;2020-09-11;8;5;13;27135;23978;69;51113
01;2020-09-11;2;2;4;18401;14661;79;33062
01;2020-09-11;1;1;2;9633;6375;89;16008
01;2020-09-11;0;0;0;3410;1510;90;4920
01;2020-09-11;39;37;76;205664;171215;0;376879
02;2020-09-11;1;0;1;16881;17110;09;33991
02;2020-09-11;1;4;5;21410;21604;19;43014
02;2020-09-11;3;4;7;16017;15479;29;31496
02;2020-09-11;7;4;11;19825;14455;39;34280
02;2020-09-11;5;2;7;24719;18248;49;42967
02;2020-09-11;2;3;5;34361;28310;59;62671
02;2020-09-11;1;3;4;28061;24495;69;52556
02;2020-09-11;0;0;0;18231;15278;79;33509
02;2020-09-11;1;0;1;11090;7677;89;18767
02;2020-09-11;0;0;0;3992;1506;90;5498
02;2020-09-11;21;20;41;194587;164162;0;358749
03;2020-09-11;0;3;3;31123;30920;09;62043
03;2020-09-11;2;3;6;29370;29268;19;58638
03;2020-09-11;3;2;5;21458;18963;29;40421
03;2020-09-11;2;0;2;21276;18326;39;39602
03;2020-09-11;3;2;5;18164;16593;49;34757
03;2020-09-11;2;0;2;13469;13557;59;27026
03;2020-09-11;1;0;1;8776;8670;69;17446
03;2020-09-11;0;1;1;3777;3591;79;7368
03;2020-09-11;0;2;2;1649;1072;89;2721
03;2020-09-11;0;0;0;485;184;90;669
03;2020-09-11;13;13;27;149547;141144;0;290691
04;2020-09-11;10;6;16;60314;61377;09;121691
04;2020-09-11;10;14;24;66065;68387;19;134452
04;2020-09-11;8;3;11;51059;47156;29;98215
04;2020-09-11;9;5;14;58788;45780;39;104568
04;2020-09-11;7;6;13;61408;52207;49;113615
04;2020-09-11;11;8;19;64838;60759;59;125597
04;2020-09-11;7;6;13;47008;42843;69;89851
04;2020-09-11;2;1;3;25509;21184;79;46693
04;2020-09-11;0;0;0;13168;7647;89;20815
04;2020-09-11;0;0;0;3209;1253;90;4462
04;2020-09-11;64;49;113;451366;408593;0;859959
05;2020-09-11;0;0;0;362.366008612902;341.338819562748;09;703.704828175651
05;2020-09-11;0;0;0;353.376145114279;370.349735405642;19;723.725880519921
05;2020-09-11;0;0;0;218.593559489256;256.539602589476;29;475.133162078732
05;2020-09-11;0;0;0;404.225408693299;360.321910454353;39;764.547319147651
05;2020-09-11;0;0;0;520.067953604221;497.108383964256;49;1017.17633756848
05;2020-09-11;0;0;0;468.146063921917;510.087601910415;59;978.233665832332
05;2020-09-11;0;0;0;340.368470050554;334.366842191253;69;674.735312241807
05;2020-09-11;0;0;0;212.598666888387;192.597753227106;79;405.196420115493
05;2020-09-11;0;0;0;148.727797095705;61.8681715431829;89;210.595968638888
05;2020-09-11;0;0;0;32.9601271090696;10.9909785719784;90;43.9511056810479
05;2020-09-11;0;0;0;3061.43020057959;2935.56979942041;0;5997
06;2020-09-11;0;0;0;42583;42380;09;84963
06;2020-09-11;2;1;3;33369;31925;19;65294
06;2020-09-11;6;2;8;21571;15080;29;36651
06;2020-09-11;2;2;4;21550;16147;39;37697
06;2020-09-11;1;1;2;14193;13939;49;28132
06;2020-09-11;1;2;3;7171;7597;59;14768
06;2020-09-11;0;1;1;3629;4117;69;7746
06;2020-09-11;0;0;0;1577;1457;79;3034
06;2020-09-11;0;0;0;531;474;89;1005
06;2020-09-11;0;0;0;88;93;90;181
06;2020-09-11;12;9;21;146262;133209;0;279471
07;2020-09-11;0;0;0;485;549;09;1034
07;2020-09-11;0;0;0;403;432;19;835
07;2020-09-11;0;0;0;764;841;29;1605
07;2020-09-11;0;0;0;824;928;39;1752
07;2020-09-11;0;0;0;788;1020;49;1808
07;2020-09-11;0;0;0;678;870;59;1548
07;2020-09-11;0;0;0;360;382;69;742
07;2020-09-11;0;0;0;231;190;79;421
07;2020-09-11;0;0;0;114;67;89;181
07;2020-09-11;0;0;0;24;11;90;35
07;2020-09-11;0;0;0;4671;5290;0;9961
08;2020-09-11;0;0;0;2715.22592983026;2997.75551488675;09;5712.98144471701
08;2020-09-11;0;0;0;2778.51901080978;3160.9156459093;19;5939.43465671908
08;2020-09-11;0;0;0;2080.8882988764;1718.16634315323;29;3799.05464202964
08;2020-09-11;2;2;4;2701.8582062647;1896.52641413317;39;4598.38462039786
08;2020-09-11;2;0;2;3151.45861023308;2460.52498233809;49;5611.98359257117
08;2020-09-11;0;0;0;2620.29868333099;2422.23566154656;59;5042.53434487755
08;2020-09-11;4;2;6;1621.44173420671;1438.58325779464;69;3060.02499200135
08;2020-09-11;1;0;1;626.575909335673;526.358467843651;79;1152.93437717932
08;2020-09-11;0;0;0;205.018522985054;140.993639349697;89;346.012162334751
08;2020-09-11;0;0;0;50.0325684687745;20.62259870351;90;70.6551671722846
08;2020-09-11;9;4;13;18551.3174743414;16782.6825256586;0;35334
11;2020-09-11;78;67;148;783071;811785;09;1594856
11;2020-09-11;218;209;438;761456;784653;19;1546109
11;2020-09-11;443;401;845;850145;801772;29;1651917
11;2020-09-11;312;272;588;914360;843488;39;1757848
11;2020-09-11;234;217;452;845609;826202;49;1671811
11;2020-09-11;195;176;372;793566;745070;59;1538636
11;2020-09-11;110;79;191;628649;549192;69;1177841
11;2020-09-11;40;44;85;434606;358356;79;792962
11;2020-09-11;26;22;49;261425;162933;89;424358
11;2020-09-11;4;3;7;89253;32619;90;121872
11;2020-09-11;1661;1490;3178;6362140;5916070;0;12278210
24;2020-09-11;6;9;15;139720;144686;09;284406
24;2020-09-11;21;15;37;152979;161185;19;314164
24;2020-09-11;27;27;54;122237;126536;29;248773
24;2020-09-11;24;17;41;150359;142009;39;292368
24;2020-09-11;18;18;36;161829;158758;49;320587
24;2020-09-11;22;8;30;172552;168011;59;340563
24;2020-09-11;4;5;9;172509;158177;69;330686
24;2020-09-11;5;7;12;129428;110593;79;240021
24;2020-09-11;2;6;8;87342;56882;89;144224
24;2020-09-11;4;1;5;31210;12071;90;43281
24;2020-09-11;133;113;247;1320165;1238908;0;2559073
27;2020-09-11;12;4;16;143373;149679;09;293052
27;2020-09-11;22;20;42;160962;173003;19;333965
27;2020-09-11;32;23;55;133746;142254;29;276000
27;2020-09-11;25;17;42;160004;155407;39;315411
27;2020-09-11;16;22;38;172333;169564;49;341897
27;2020-09-11;24;17;41;189979;183788;59;373767
27;2020-09-11;15;13;28;192591;178206;69;370797
27;2020-09-11;6;7;13;146876;127546;79;274422
27;2020-09-11;12;2;14;96896;61575;89;158471
27;2020-09-11;3;3;6;33148;12109;90;45257
27;2020-09-11;167;128;295;1429908;1353131;0;2783039
28;2020-09-11;7;14;21;180735;186856;09;367591
28;2020-09-11;33;23;57;200125;213621;19;413746
28;2020-09-11;52;46;98;168922;173007;29;341929
28;2020-09-11;45;25;70;196628;188487;39;385115
28;2020-09-11;36;27;63;205396;201699;49;407095
28;2020-09-11;28;30;58;222002;213866;59;435868
28;2020-09-11;12;21;33;224688;203758;69;428446
28;2020-09-11;12;11;23;163192;135543;79;298735
28;2020-09-11;6;3;9;109691;65377;89;175068
28;2020-09-11;2;1;3;37222;12685;90;49907
28;2020-09-11;233;201;435;1708601;1594899;0;3303500
32;2020-09-11;34;28;62;358062;373689;09;731751
32;2020-09-11;91;85;176;387045;406742;19;793787
32;2020-09-11;143;157;301;342304;348587;29;690891
32;2020-09-11;87;68;155;382485;369972;39;752457
32;2020-09-11;88;69;157;382510;376716;49;759226
32;2020-09-11;60;56;117;386937;376527;59;763464
32;2020-09-11;34;36;70;371211;330938;69;702149
32;2020-09-11;18;15;33;250542;201459;79;452001
32;2020-09-11;9;5;14;163399;89786;89;253185
32;2020-09-11;11;3;14;48384;15367;90;63751
32;2020-09-11;575;522;1099;3072879;2889783;0;5962662
44;2020-09-11;12;9;21;291525;306839;09;598364
44;2020-09-11;66;46;112;320255;339504;19;659759
44;2020-09-11;44;52;96;302020;314428;29;616448
44;2020-09-11;28;27;55;342222;333292;39;675514
44;2020-09-11;34;18;52;349727;344491;49;694218
44;2020-09-11;18;21;39;381371;373239;59;754610
44;2020-09-11;23;16;39;367165;335850;69;703015
44;2020-09-11;9;11;20;250387;215436;79;465823
44;2020-09-11;12;7;19;170825;105192;89;276017
44;2020-09-11;3;0;3;51248;16731;90;67979
44;2020-09-11;249;207;456;2826745;2685002;0;5511747
52;2020-09-11;9;11;23;213594;223900;09;437494
52;2020-09-11;35;26;61;240818;255197;19;496015
52;2020-09-11;50;51;101;197010;200630;29;397640
52;2020-09-11;24;17;41;231204;224885;39;456089
52;2020-09-11;21;17;38;243874;243418;49;487292
52;2020-09-11;16;13;29;244100;239116;59;483216
52;2020-09-11;10;12;22;241796;221345;69;463141
52;2020-09-11;9;5;14;177805;149903;79;327708
52;2020-09-11;4;5;9;119561;75822;89;195383
52;2020-09-11;1;1;2;42559;15260;90;57819
52;2020-09-11;180;158;341;1952321;1849476;0;3801797
53;2020-09-11;6;4;10;173813;182358;09;356171
53;2020-09-11;30;31;61;202720;214740;19;417460
53;2020-09-11;35;49;84;163116;173196;29;336312
53;2020-09-11;18;6;24;190526;187674;39;378200
53;2020-09-11;20;14;34;212098;212015;49;424113
53;2020-09-11;11;10;21;223699;219176;59;442875
53;2020-09-11;4;4;8;227435;209274;69;436709
53;2020-09-11;4;4;8;169992;140910;79;310902
53;2020-09-11;6;4;10;118117;69883;89;188000
53;2020-09-11;2;1;3;37370;12267;90;49637
53;2020-09-11;136;127;263;1718886;1621493;0;3340379
75;2020-09-11;21;25;46;293104;305291;09;598395
75;2020-09-11;48;56;106;337141;357785;19;694926
75;2020-09-11;89;89;179;295024;300618;29;595642
75;2020-09-11;73;58;131;347871;331233;39;679104
75;2020-09-11;65;47;112;384742;372771;49;757513
75;2020-09-11;55;47;102;413361;390880;59;804241
75;2020-09-11;35;28;63;425623;384060;69;809683
75;2020-09-11;17;17;34;325086;276298;79;601384
75;2020-09-11;8;4;12;213986;139308;89;353294
75;2020-09-11;5;1;6;77600;28200;90;105800
75;2020-09-11;416;373;792;3113538;2886444;0;5999982
76;2020-09-11;19;17;37;305956;318589;09;624545
76;2020-09-11;84;74;160;338942;356969;19;695911
76;2020-09-11;108;146;256;316210;319570;29;635780
76;2020-09-11;51;63;114;356758;337587;39;694345
76;2020-09-11;78;56;134;376541;363812;49;740353
76;2020-09-11;61;59;120;402608;383750;59;786358
76;2020-09-11;22;27;49;394889;358997;69;753886
76;2020-09-11;24;20;44;308664;263806;79;572470
76;2020-09-11;16;16;32;195838;129272;89;325110
76;2020-09-11;18;2;20;69372;26728;90;96100
76;2020-09-11;482;481;968;3065778;2859080;0;5924858
84;2020-09-11;34;49;83;459549;481088;09;940637
84;2020-09-11;88;103;191;487711;511905;19;999616
84;2020-09-11;171;169;340;443824;451094;29;894918
84;2020-09-11;102;114;216;512522;493262;39;1005784
84;2020-09-11;77;94;171;520248;515106;49;1035354
84;2020-09-11;91;70;161;529611;514848;59;1044459
84;2020-09-11;34;46;80;486720;439940;69;926660
84;2020-09-11;20;23;43;372151;315211;79;687362
84;2020-09-11;21;10;31;237198;150524;89;387722
84;2020-09-11;17;3;20;81185;28680;90;109865
84;2020-09-11;655;681;1336;4130719;3901658;0;8032377
93;2020-09-11;23;30;54;268834;283093;09;551927
93;2020-09-11;71;99;171;280751;296087;19;576838
93;2020-09-11;155;116;271;254404;255552;29;509956
93;2020-09-11;110;103;213;310704;288398;39;599102
93;2020-09-11;120;78;198;325559;305827;49;631386
93;2020-09-11;99;92;191;353104;325389;59;678493
93;2020-09-11;64;52;116;336327;296459;69;632786
93;2020-09-11;44;40;84;279820;229699;79;509519
93;2020-09-11;18;18;36;171274;113716;89;284990
93;2020-09-11;24;7;31;58896;21758;90;80654
93;2020-09-11;728;636;1366;2639673;2415978;0;5055651
94;2020-09-11;1;1;2;16311;17433;09;33744
94;2020-09-11;1;2;3;16679;18132;19;34811
94;2020-09-11;7;3;10;16782;16579;29;33361
94;2020-09-11;2;5;7;23044;20580;39;43624
94;2020-09-11;1;4;5;23065;22140;49;45205
94;2020-09-11;2;5;7;24549;23421;59;47970
94;2020-09-11;2;0;2;23212;21883;69;45095
94;2020-09-11;1;2;3;19544;17141;79;36685
94;2020-09-11;1;1;2;11227;8178;89;19405
94;2020-09-11;0;0;0;3332;1447;90;4779
94;2020-09-11;18;23;41;177745;166934;0;344679
01;2020-09-12;0;2;2;19979;20155;09;40134
01;2020-09-12;1;3;4;24994;25489;19;50483
01;2020-09-12;4;2;6;17868;16690;29;34558
01;2020-09-12;2;0;2;22328;14821;39;37149
01;2020-09-12;3;6;9;28652;20276;49;48928
01;2020-09-12;4;3;7;33264;27260;59;60524
01;2020-09-12;3;7;10;27135;23978;69;51113
01;2020-09-12;4;3;7;18401;14661;79;33062
01;2020-09-12;0;3;3;9633;6375;89;16008
01;2020-09-12;0;0;0;3410;1510;90;4920
01;2020-09-12;21;29;50;205664;171215;0;376879
02;2020-09-12;0;0;0;16881;17110;09;33991
02;2020-09-12;0;0;0;21410;21604;19;43014
02;2020-09-12;2;1;3;16017;15479;29;31496
02;2020-09-12;2;0;2;19825;14455;39;34280
02;2020-09-12;0;0;0;24719;18248;49;42967
02;2020-09-12;2;1;3;34361;28310;59;62671
02;2020-09-12;1;1;2;28061;24495;69;52556
02;2020-09-12;0;0;0;18231;15278;79;33509
02;2020-09-12;0;0;0;11090;7677;89;18767
02;2020-09-12;0;0;0;3992;1506;90;5498
02;2020-09-12;7;3;10;194587;164162;0;358749
03;2020-09-12;0;0;0;31123;30920;09;62043
03;2020-09-12;1;0;1;29370;29268;19;58638
03;2020-09-12;4;3;8;21458;18963;29;40421
03;2020-09-12;1;1;2;21276;18326;39;39602
03;2020-09-12;1;2;3;18164;16593;49;34757
03;2020-09-12;1;1;2;13469;13557;59;27026
03;2020-09-12;0;0;0;8776;8670;69;17446
03;2020-09-12;0;0;0;3777;3591;79;7368
03;2020-09-12;0;0;0;1649;1072;89;2721
03;2020-09-12;0;0;0;485;184;90;669
03;2020-09-12;8;7;16;149547;141144;0;290691
04;2020-09-12;3;3;6;60314;61377;09;121691
04;2020-09-12;8;6;14;66065;68387;19;134452
04;2020-09-12;3;4;7;51059;47156;29;98215
04;2020-09-12;3;0;3;58788;45780;39;104568
04;2020-09-12;4;3;7;61408;52207;49;113615
04;2020-09-12;1;3;4;64838;60759;59;125597
04;2020-09-12;2;1;3;47008;42843;69;89851
04;2020-09-12;1;2;3;25509;21184;79;46693
04;2020-09-12;1;0;1;13168;7647;89;20815
04;2020-09-12;0;0;0;3209;1253;90;4462
04;2020-09-12;26;22;48;451366;408593;0;859959
05;2020-09-12;0;0;0;362.366008612902;341.338819562748;09;703.704828175651
05;2020-09-12;0;0;0;353.376145114279;370.349735405642;19;723.725880519921
05;2020-09-12;0;0;0;218.593559489256;256.539602589476;29;475.133162078732
05;2020-09-12;0;0;0;404.225408693299;360.321910454353;39;764.547319147651
05;2020-09-12;0;0;0;520.067953604221;497.108383964256;49;1017.17633756848
05;2020-09-12;0;0;0;468.146063921917;510.087601910415;59;978.233665832332
05;2020-09-12;0;0;0;340.368470050554;334.366842191253;69;674.735312241807
05;2020-09-12;0;0;0;212.598666888387;192.597753227106;79;405.196420115493
05;2020-09-12;0;0;0;148.727797095705;61.8681715431829;89;210.595968638888
05;2020-09-12;0;0;0;32.9601271090696;10.9909785719784;90;43.9511056810479
05;2020-09-12;0;0;0;3061.43020057959;2935.56979942041;0;5997
06;2020-09-12;0;0;0;42583;42380;09;84963
06;2020-09-12;0;1;1;33369;31925;19;65294
06;2020-09-12;0;0;0;21571;15080;29;36651
06;2020-09-12;2;0;2;21550;16147;39;37697
06;2020-09-12;0;0;0;14193;13939;49;28132
06;2020-09-12;0;2;2;7171;7597;59;14768
06;2020-09-12;0;1;1;3629;4117;69;7746
06;2020-09-12;0;0;0;1577;1457;79;3034
06;2020-09-12;0;0;0;531;474;89;1005
06;2020-09-12;0;0;0;88;93;90;181
06;2020-09-12;2;4;6;146262;133209;0;279471
07;2020-09-12;0;0;0;485;549;09;1034
07;2020-09-12;0;0;0;403;432;19;835
07;2020-09-12;0;0;0;764;841;29;1605
07;2020-09-12;0;0;0;824;928;39;1752
07;2020-09-12;0;1;1;788;1020;49;1808
07;2020-09-12;0;0;0;678;870;59;1548
07;2020-09-12;0;0;0;360;382;69;742
07;2020-09-12;0;0;0;231;190;79;421
07;2020-09-12;0;0;0;114;67;89;181
07;2020-09-12;0;0;0;24;11;90;35
07;2020-09-12;0;1;1;4671;5290;0;9961
08;2020-09-12;0;0;0;2715.22592983026;2997.75551488675;09;5712.98144471701
08;2020-09-12;0;0;0;2778.51901080978;3160.9156459093;19;5939.43465671908
08;2020-09-12;0;0;0;2080.8882988764;1718.16634315323;29;3799.05464202964
08;2020-09-12;0;0;0;2701.8582062647;1896.52641413317;39;4598.38462039786
08;2020-09-12;0;1;1;3151.45861023308;2460.52498233809;49;5611.98359257117
08;2020-09-12;0;0;0;2620.29868333099;2422.23566154656;59;5042.53434487755
08;2020-09-12;0;0;0;1621.44173420671;1438.58325779464;69;3060.02499200135
08;2020-09-12;1;0;1;626.575909335673;526.358467843651;79;1152.93437717932
08;2020-09-12;0;0;0;205.018522985054;140.993639349697;89;346.012162334751
08;2020-09-12;0;0;0;50.0325684687745;20.62259870351;90;70.6551671722846
08;2020-09-12;1;1;2;18551.3174743414;16782.6825256586;0;35334
11;2020-09-12;25;14;40;783071;811785;09;1594856
11;2020-09-12;40;63;104;761456;784653;19;1546109
11;2020-09-12;169;137;306;850145;801772;29;1651917
11;2020-09-12;92;74;166;914360;843488;39;1757848
11;2020-09-12;61;72;133;845609;826202;49;1671811
11;2020-09-12;48;59;107;793566;745070;59;1538636
11;2020-09-12;28;37;65;628649;549192;69;1177841
11;2020-09-12;17;17;34;434606;358356;79;792962
11;2020-09-12;8;11;19;261425;162933;89;424358
11;2020-09-12;6;3;9;89253;32619;90;121872
11;2020-09-12;494;487;983;6362140;5916070;0;12278210
24;2020-09-12;0;0;0;139720;144686;09;284406
24;2020-09-12;11;11;24;152979;161185;19;314164
24;2020-09-12;14;8;22;122237;126536;29;248773
24;2020-09-12;9;13;22;150359;142009;39;292368
24;2020-09-12;11;7;18;161829;158758;49;320587
24;2020-09-12;7;5;12;172552;168011;59;340563
24;2020-09-12;3;2;5;172509;158177;69;330686
24;2020-09-12;2;3;5;129428;110593;79;240021
24;2020-09-12;2;0;2;87342;56882;89;144224
24;2020-09-12;2;1;3;31210;12071;90;43281
24;2020-09-12;61;50;113;1320165;1238908;0;2559073
27;2020-09-12;2;4;6;143373;149679;09;293052
27;2020-09-12;16;12;28;160962;173003;19;333965
27;2020-09-12;20;18;38;133746;142254;29;276000
27;2020-09-12;6;13;19;160004;155407;39;315411
27;2020-09-12;9;9;18;172333;169564;49;341897
27;2020-09-12;11;7;18;189979;183788;59;373767
27;2020-09-12;8;3;11;192591;178206;69;370797
27;2020-09-12;6;4;10;146876;127546;79;274422
27;2020-09-12;2;2;4;96896;61575;89;158471
27;2020-09-12;3;1;4;33148;12109;90;45257
27;2020-09-12;84;73;157;1429908;1353131;0;2783039
28;2020-09-12;4;4;8;180735;186856;09;367591
28;2020-09-12;9;19;29;200125;213621;19;413746
28;2020-09-12;27;20;47;168922;173007;29;341929
28;2020-09-12;23;12;35;196628;188487;39;385115
28;2020-09-12;13;12;26;205396;201699;49;407095
28;2020-09-12;10;10;20;222002;213866;59;435868
28;2020-09-12;5;5;10;224688;203758;69;428446
28;2020-09-12;4;9;13;163192;135543;79;298735
28;2020-09-12;3;2;5;109691;65377;89;175068
28;2020-09-12;0;0;0;37222;12685;90;49907
28;2020-09-12;98;93;193;1708601;1594899;0;3303500
32;2020-09-12;11;11;22;358062;373689;09;731751
32;2020-09-12;45;46;91;387045;406742;19;793787
32;2020-09-12;58;74;132;342304;348587;29;690891
32;2020-09-12;28;38;66;382485;369972;39;752457
32;2020-09-12;38;32;70;382510;376716;49;759226
32;2020-09-12;21;35;56;386937;376527;59;763464
32;2020-09-12;14;15;29;371211;330938;69;702149
32;2020-09-12;10;8;18;250542;201459;79;452001
32;2020-09-12;6;7;13;163399;89786;89;253185
32;2020-09-12;5;1;6;48384;15367;90;63751
32;2020-09-12;236;268;504;3072879;2889783;0;5962662
44;2020-09-12;6;8;14;291525;306839;09;598364
44;2020-09-12;27;15;43;320255;339504;19;659759
44;2020-09-12;35;53;88;302020;314428;29;616448
44;2020-09-12;16;20;36;342222;333292;39;675514
44;2020-09-12;20;14;34;349727;344491;49;694218
44;2020-09-12;6;6;12;381371;373239;59;754610
44;2020-09-12;11;10;21;367165;335850;69;703015
44;2020-09-12;2;6;8;250387;215436;79;465823
44;2020-09-12;2;4;6;170825;105192;89;276017
44;2020-09-12;5;2;7;51248;16731;90;67979
44;2020-09-12;130;138;269;2826745;2685002;0;5511747
52;2020-09-12;2;6;9;213594;223900;09;437494
52;2020-09-12;19;16;35;240818;255197;19;496015
52;2020-09-12;19;17;36;197010;200630;29;397640
52;2020-09-12;14;11;25;231204;224885;39;456089
52;2020-09-12;21;9;30;243874;243418;49;487292
52;2020-09-12;7;13;20;244100;239116;59;483216
52;2020-09-12;9;4;13;241796;221345;69;463141
52;2020-09-12;1;2;3;177805;149903;79;327708
52;2020-09-12;0;2;2;119561;75822;89;195383
52;2020-09-12;1;0;1;42559;15260;90;57819
52;2020-09-12;93;80;174;1952321;1849476;0;3801797
53;2020-09-12;2;3;5;173813;182358;09;356171
53;2020-09-12;15;9;25;202720;214740;19;417460
53;2020-09-12;19;17;36;163116;173196;29;336312
53;2020-09-12;7;10;17;190526;187674;39;378200
53;2020-09-12;9;9;18;212098;212015;49;424113
53;2020-09-12;7;9;16;223699;219176;59;442875
53;2020-09-12;4;3;7;227435;209274;69;436709
53;2020-09-12;2;2;4;169992;140910;79;310902
53;2020-09-12;3;6;9;118117;69883;89;188000
53;2020-09-12;1;0;1;37370;12267;90;49637
53;2020-09-12;69;68;138;1718886;1621493;0;3340379
75;2020-09-12;1;5;6;293104;305291;09;598395
75;2020-09-12;20;23;43;337141;357785;19;694926
75;2020-09-12;27;38;65;295024;300618;29;595642
75;2020-09-12;21;18;39;347871;331233;39;679104
75;2020-09-12;15;13;28;384742;372771;49;757513
75;2020-09-12;16;16;32;413361;390880;59;804241
75;2020-09-12;5;14;19;425623;384060;69;809683
75;2020-09-12;6;4;10;325086;276298;79;601384
75;2020-09-12;4;4;8;213986;139308;89;353294
75;2020-09-12;2;3;5;77600;28200;90;105800
75;2020-09-12;117;138;255;3113538;2886444;0;5999982
76;2020-09-12;4;6;10;305956;318589;09;624545
76;2020-09-12;22;32;54;338942;356969;19;695911
76;2020-09-12;60;44;105;316210;319570;29;635780
76;2020-09-12;22;19;41;356758;337587;39;694345
76;2020-09-12;15;18;33;376541;363812;49;740353
76;2020-09-12;20;32;52;402608;383750;59;786358
76;2020-09-12;6;9;15;394889;358997;69;753886
76;2020-09-12;9;10;19;308664;263806;79;572470
76;2020-09-12;3;4;7;195838;129272;89;325110
76;2020-09-12;4;2;6;69372;26728;90;96100
76;2020-09-12;165;176;342;3065778;2859080;0;5924858
84;2020-09-12;13;8;21;459549;481088;09;940637
84;2020-09-12;30;35;65;487711;511905;19;999616
84;2020-09-12;76;64;140;443824;451094;29;894918
84;2020-09-12;33;29;62;512522;493262;39;1005784
84;2020-09-12;43;37;80;520248;515106;49;1035354
84;2020-09-12;32;23;55;529611;514848;59;1044459
84;2020-09-12;18;18;36;486720;439940;69;926660
84;2020-09-12;14;19;33;372151;315211;79;687362
84;2020-09-12;19;11;30;237198;150524;89;387722
84;2020-09-12;9;5;14;81185;28680;90;109865
84;2020-09-12;287;249;536;4130719;3901658;0;8032377
93;2020-09-12;12;12;24;268834;283093;09;551927
93;2020-09-12;43;33;76;280751;296087;19;576838
93;2020-09-12;62;51;114;254404;255552;29;509956
93;2020-09-12;46;35;82;310704;288398;39;599102
93;2020-09-12;41;41;82;325559;305827;49;631386
93;2020-09-12;47;32;79;353104;325389;59;678493
93;2020-09-12;21;22;43;336327;296459;69;632786
93;2020-09-12;17;19;36;279820;229699;79;509519
93;2020-09-12;15;10;25;171274;113716;89;284990
93;2020-09-12;10;5;15;58896;21758;90;80654
93;2020-09-12;314;260;576;2639673;2415978;0;5055651
94;2020-09-12;0;1;1;16311;17433;09;33744
94;2020-09-12;1;2;3;16679;18132;19;34811
94;2020-09-12;2;3;5;16782;16579;29;33361
94;2020-09-12;1;1;2;23044;20580;39;43624
94;2020-09-12;3;0;3;23065;22140;49;45205
94;2020-09-12;4;1;5;24549;23421;59;47970
94;2020-09-12;1;0;1;23212;21883;69;45095
94;2020-09-12;3;1;4;19544;17141;79;36685
94;2020-09-12;1;1;2;11227;8178;89;19405
94;2020-09-12;0;0;0;3332;1447;90;4779
94;2020-09-12;16;10;26;177745;166934;0;344679
01;2020-09-13;1;1;2;19979;20155;09;40134
01;2020-09-13;0;0;0;24994;25489;19;50483
01;2020-09-13;0;0;0;17868;16690;29;34558
01;2020-09-13;1;2;3;22328;14821;39;37149
01;2020-09-13;4;3;7;28652;20276;49;48928
01;2020-09-13;2;3;5;33264;27260;59;60524
01;2020-09-13;0;5;5;27135;23978;69;51113
01;2020-09-13;2;1;3;18401;14661;79;33062
01;2020-09-13;2;1;3;9633;6375;89;16008
01;2020-09-13;0;0;0;3410;1510;90;4920
01;2020-09-13;12;16;28;205664;171215;0;376879
02;2020-09-13;0;0;0;16881;17110;09;33991
02;2020-09-13;0;0;0;21410;21604;19;43014
02;2020-09-13;0;0;0;16017;15479;29;31496
02;2020-09-13;0;0;0;19825;14455;39;34280
02;2020-09-13;0;0;0;24719;18248;49;42967
02;2020-09-13;0;0;0;34361;28310;59;62671
02;2020-09-13;0;0;0;28061;24495;69;52556
02;2020-09-13;0;0;0;18231;15278;79;33509
02;2020-09-13;0;0;0;11090;7677;89;18767
02;2020-09-13;0;0;0;3992;1506;90;5498
02;2020-09-13;0;0;0;194587;164162;0;358749
03;2020-09-13;0;0;0;31123;30920;09;62043
03;2020-09-13;0;0;0;29370;29268;19;58638
03;2020-09-13;2;0;2;21458;18963;29;40421
03;2020-09-13;0;0;0;21276;18326;39;39602
03;2020-09-13;0;0;0;18164;16593;49;34757
03;2020-09-13;0;0;0;13469;13557;59;27026
03;2020-09-13;0;0;0;8776;8670;69;17446
03;2020-09-13;0;0;0;3777;3591;79;7368
03;2020-09-13;0;0;0;1649;1072;89;2721
03;2020-09-13;0;0;0;485;184;90;669
03;2020-09-13;2;0;2;149547;141144;0;290691
04;2020-09-13;3;2;5;60314;61377;09;121691
04;2020-09-13;6;2;8;66065;68387;19;134452
04;2020-09-13;3;1;4;51059;47156;29;98215
04;2020-09-13;1;0;1;58788;45780;39;104568
04;2020-09-13;1;0;1;61408;52207;49;113615
04;2020-09-13;1;2;3;64838;60759;59;125597
04;2020-09-13;1;0;1;47008;42843;69;89851
04;2020-09-13;0;1;1;25509;21184;79;46693
04;2020-09-13;0;1;1;13168;7647;89;20815
04;2020-09-13;0;0;0;3209;1253;90;4462
04;2020-09-13;16;9;25;451366;408593;0;859959
05;2020-09-13;0;0;0;362.366008612902;341.338819562748;09;703.704828175651
05;2020-09-13;0;0;0;353.376145114279;370.349735405642;19;723.725880519921
05;2020-09-13;0;0;0;218.593559489256;256.539602589476;29;475.133162078732
05;2020-09-13;0;0;0;404.225408693299;360.321910454353;39;764.547319147651
05;2020-09-13;0;0;0;520.067953604221;497.108383964256;49;1017.17633756848
05;2020-09-13;0;0;0;468.146063921917;510.087601910415;59;978.233665832332
05;2020-09-13;0;0;0;340.368470050554;334.366842191253;69;674.735312241807
05;2020-09-13;0;0;0;212.598666888387;192.597753227106;79;405.196420115493
05;2020-09-13;0;0;0;148.727797095705;61.8681715431829;89;210.595968638888
05;2020-09-13;0;0;0;32.9601271090696;10.9909785719784;90;43.9511056810479
05;2020-09-13;0;0;0;3061.43020057959;2935.56979942041;0;5997
06;2020-09-13;1;0;1;42583;42380;09;84963
06;2020-09-13;0;0;0;33369;31925;19;65294
06;2020-09-13;2;0;2;21571;15080;29;36651
06;2020-09-13;0;0;0;21550;16147;39;37697
06;2020-09-13;2;1;3;14193;13939;49;28132
06;2020-09-13;1;0;1;7171;7597;59;14768
06;2020-09-13;0;0;0;3629;4117;69;7746
06;2020-09-13;0;0;0;1577;1457;79;3034
06;2020-09-13;0;0;0;531;474;89;1005
06;2020-09-13;0;0;0;88;93;90;181
06;2020-09-13;6;1;7;146262;133209;0;279471
07;2020-09-13;0;0;0;485;549;09;1034
07;2020-09-13;0;0;0;403;432;19;835
07;2020-09-13;0;0;0;764;841;29;1605
07;2020-09-13;0;0;0;824;928;39;1752
07;2020-09-13;0;0;0;788;1020;49;1808
07;2020-09-13;0;0;0;678;870;59;1548
07;2020-09-13;0;0;0;360;382;69;742
07;2020-09-13;0;0;0;231;190;79;421
07;2020-09-13;0;0;0;114;67;89;181
07;2020-09-13;0;0;0;24;11;90;35
07;2020-09-13;0;0;0;4671;5290;0;9961
08;2020-09-13;0;0;0;2715.22592983026;2997.75551488675;09;5712.98144471701
08;2020-09-13;0;0;0;2778.51901080978;3160.9156459093;19;5939.43465671908
08;2020-09-13;0;0;0;2080.8882988764;1718.16634315323;29;3799.05464202964
08;2020-09-13;0;0;0;2701.8582062647;1896.52641413317;39;4598.38462039786
08;2020-09-13;0;0;0;3151.45861023308;2460.52498233809;49;5611.98359257117
08;2020-09-13;0;0;0;2620.29868333099;2422.23566154656;59;5042.53434487755
08;2020-09-13;0;0;0;1621.44173420671;1438.58325779464;69;3060.02499200135
08;2020-09-13;0;0;0;626.575909335673;526.358467843651;79;1152.93437717932
08;2020-09-13;0;0;0;205.018522985054;140.993639349697;89;346.012162334751
08;2020-09-13;0;0;0;50.0325684687745;20.62259870351;90;70.6551671722846
08;2020-09-13;0;0;0;18551.3174743414;16782.6825256586;0;35334
11;2020-09-13;8;1;9;783071;811785;09;1594856
11;2020-09-13;13;21;34;761456;784653;19;1546109
11;2020-09-13;62;45;107;850145;801772;29;1651917
11;2020-09-13;32;48;80;914360;843488;39;1757848
11;2020-09-13;22;26;49;845609;826202;49;1671811
11;2020-09-13;18;23;41;793566;745070;59;1538636
11;2020-09-13;12;16;29;628649;549192;69;1177841
11;2020-09-13;7;11;18;434606;358356;79;792962
11;2020-09-13;10;10;20;261425;162933;89;424358
11;2020-09-13;1;1;2;89253;32619;90;121872
11;2020-09-13;185;202;389;6362140;5916070;0;12278210
24;2020-09-13;0;0;0;139720;144686;09;284406
24;2020-09-13;1;3;4;152979;161185;19;314164
24;2020-09-13;2;2;4;122237;126536;29;248773
24;2020-09-13;3;2;5;150359;142009;39;292368
24;2020-09-13;1;3;4;161829;158758;49;320587
24;2020-09-13;0;2;2;172552;168011;59;340563
24;2020-09-13;3;0;3;172509;158177;69;330686
24;2020-09-13;1;0;1;129428;110593;79;240021
24;2020-09-13;0;1;1;87342;56882;89;144224
24;2020-09-13;0;0;0;31210;12071;90;43281
24;2020-09-13;11;13;24;1320165;1238908;0;2559073
27;2020-09-13;4;0;4;143373;149679;09;293052
27;2020-09-13;2;3;5;160962;173003;19;333965
27;2020-09-13;10;9;19;133746;142254;29;276000
27;2020-09-13;4;5;9;160004;155407;39;315411
27;2020-09-13;3;5;8;172333;169564;49;341897
27;2020-09-13;5;5;10;189979;183788;59;373767
27;2020-09-13;3;1;4;192591;178206;69;370797
27;2020-09-13;1;1;2;146876;127546;79;274422
27;2020-09-13;2;2;4;96896;61575;89;158471
27;2020-09-13;0;1;1;33148;12109;90;45257
27;2020-09-13;34;32;66;1429908;1353131;0;2783039
28;2020-09-13;1;3;4;180735;186856;09;367591
28;2020-09-13;6;7;14;200125;213621;19;413746
28;2020-09-13;10;12;22;168922;173007;29;341929
28;2020-09-13;8;11;19;196628;188487;39;385115
28;2020-09-13;9;9;18;205396;201699;49;407095
28;2020-09-13;7;8;15;222002;213866;59;435868
28;2020-09-13;5;4;9;224688;203758;69;428446
28;2020-09-13;1;2;3;163192;135543;79;298735
28;2020-09-13;0;1;1;109691;65377;89;175068
28;2020-09-13;0;0;0;37222;12685;90;49907
28;2020-09-13;47;57;105;1708601;1594899;0;3303500
32;2020-09-13;2;3;5;358062;373689;09;731751
32;2020-09-13;8;8;16;387045;406742;19;793787
32;2020-09-13;9;5;14;342304;348587;29;690891
32;2020-09-13;6;9;15;382485;369972;39;752457
32;2020-09-13;9;5;14;382510;376716;49;759226
32;2020-09-13;9;11;20;386937;376527;59;763464
32;2020-09-13;5;3;8;371211;330938;69;702149
32;2020-09-13;4;5;9;250542;201459;79;452001
32;2020-09-13;5;1;6;163399;89786;89;253185
32;2020-09-13;2;0;2;48384;15367;90;63751
32;2020-09-13;59;50;109;3072879;2889783;0;5962662
44;2020-09-13;1;4;5;291525;306839;09;598364
44;2020-09-13;10;7;17;320255;339504;19;659759
44;2020-09-13;9;17;26;302020;314428;29;616448
44;2020-09-13;3;4;7;342222;333292;39;675514
44;2020-09-13;2;0;2;349727;344491;49;694218
44;2020-09-13;1;4;5;381371;373239;59;754610
44;2020-09-13;0;2;2;367165;335850;69;703015
44;2020-09-13;2;2;4;250387;215436;79;465823
44;2020-09-13;0;2;2;170825;105192;89;276017
44;2020-09-13;0;0;0;51248;16731;90;67979
44;2020-09-13;28;42;70;2826745;2685002;0;5511747
52;2020-09-13;1;0;1;213594;223900;09;437494
52;2020-09-13;3;1;4;240818;255197;19;496015
52;2020-09-13;6;5;11;197010;200630;29;397640
52;2020-09-13;2;2;4;231204;224885;39;456089
52;2020-09-13;2;1;3;243874;243418;49;487292
52;2020-09-13;0;1;1;244100;239116;59;483216
52;2020-09-13;0;0;0;241796;221345;69;463141
52;2020-09-13;3;1;4;177805;149903;79;327708
52;2020-09-13;0;1;1;119561;75822;89;195383
52;2020-09-13;0;1;1;42559;15260;90;57819
52;2020-09-13;17;13;30;1952321;1849476;0;3801797
53;2020-09-13;0;3;3;173813;182358;09;356171
53;2020-09-13;7;5;12;202720;214740;19;417460
53;2020-09-13;11;8;19;163116;173196;29;336312
53;2020-09-13;6;5;11;190526;187674;39;378200
53;2020-09-13;2;2;4;212098;212015;49;424113
53;2020-09-13;3;1;4;223699;219176;59;442875
53;2020-09-13;1;0;1;227435;209274;69;436709
53;2020-09-13;0;1;1;169992;140910;79;310902
53;2020-09-13;2;1;3;118117;69883;89;188000
53;2020-09-13;2;0;2;37370;12267;90;49637
53;2020-09-13;34;26;60;1718886;1621493;0;3340379
75;2020-09-13;6;7;13;293104;305291;09;598395
75;2020-09-13;7;11;18;337141;357785;19;694926
75;2020-09-13;19;29;48;295024;300618;29;595642
75;2020-09-13;12;8;20;347871;331233;39;679104
75;2020-09-13;7;4;11;384742;372771;49;757513
75;2020-09-13;6;8;14;413361;390880;59;804241
75;2020-09-13;4;4;8;425623;384060;69;809683
75;2020-09-13;2;5;7;325086;276298;79;601384
75;2020-09-13;0;2;2;213986;139308;89;353294
75;2020-09-13;1;0;1;77600;28200;90;105800
75;2020-09-13;64;78;142;3113538;2886444;0;5999982
76;2020-09-13;2;4;6;305956;318589;09;624545
76;2020-09-13;13;6;19;338942;356969;19;695911
76;2020-09-13;28;18;46;316210;319570;29;635780
76;2020-09-13;15;7;22;356758;337587;39;694345
76;2020-09-13;6;2;8;376541;363812;49;740353
76;2020-09-13;7;5;12;402608;383750;59;786358
76;2020-09-13;3;4;7;394889;358997;69;753886
76;2020-09-13;3;6;9;308664;263806;79;572470
76;2020-09-13;4;1;5;195838;129272;89;325110
76;2020-09-13;1;0;1;69372;26728;90;96100
76;2020-09-13;82;54;136;3065778;2859080;0;5924858
84;2020-09-13;2;1;3;459549;481088;09;940637
84;2020-09-13;5;5;10;487711;511905;19;999616
84;2020-09-13;14;18;32;443824;451094;29;894918
84;2020-09-13;12;9;21;512522;493262;39;1005784
84;2020-09-13;6;9;15;520248;515106;49;1035354
84;2020-09-13;3;8;11;529611;514848;59;1044459
84;2020-09-13;4;11;15;486720;439940;69;926660
84;2020-09-13;5;5;10;372151;315211;79;687362
84;2020-09-13;5;2;7;237198;150524;89;387722
84;2020-09-13;3;2;5;81185;28680;90;109865
84;2020-09-13;59;70;129;4130719;3901658;0;8032377
93;2020-09-13;7;4;11;268834;283093;09;551927
93;2020-09-13;8;8;16;280751;296087;19;576838
93;2020-09-13;19;14;33;254404;255552;29;509956
93;2020-09-13;20;7;27;310704;288398;39;599102
93;2020-09-13;18;10;28;325559;305827;49;631386
93;2020-09-13;12;13;25;353104;325389;59;678493
93;2020-09-13;10;7;17;336327;296459;69;632786
93;2020-09-13;9;8;17;279820;229699;79;509519
93;2020-09-13;8;7;15;171274;113716;89;284990
93;2020-09-13;9;4;13;58896;21758;90;80654
93;2020-09-13;120;82;202;2639673;2415978;0;5055651
94;2020-09-13;0;0;0;16311;17433;09;33744
94;2020-09-13;0;1;1;16679;18132;19;34811
94;2020-09-13;0;0;0;16782;16579;29;33361
94;2020-09-13;0;1;1;23044;20580;39;43624
94;2020-09-13;0;0;0;23065;22140;49;45205
94;2020-09-13;0;1;1;24549;23421;59;47970
94;2020-09-13;0;1;1;23212;21883;69;45095
94;2020-09-13;2;0;2;19544;17141;79;36685
94;2020-09-13;0;0;0;11227;8178;89;19405
94;2020-09-13;1;0;1;3332;1447;90;4779
94;2020-09-13;3;4;7;177745;166934;0;344679
01;2020-09-14;0;2;2;19979;20155;09;40134
01;2020-09-14;13;19;32;24994;25489;19;50483
01;2020-09-14;17;11;28;17868;16690;29;34558
01;2020-09-14;26;18;44;22328;14821;39;37149
01;2020-09-14;26;27;53;28652;20276;49;48928
01;2020-09-14;30;18;48;33264;27260;59;60524
01;2020-09-14;13;14;27;27135;23978;69;51113
01;2020-09-14;7;7;14;18401;14661;79;33062
01;2020-09-14;2;3;5;9633;6375;89;16008
01;2020-09-14;1;0;1;3410;1510;90;4920
01;2020-09-14;135;119;254;205664;171215;0;376879
02;2020-09-14;0;1;1;16881;17110;09;33991
02;2020-09-14;0;3;3;21410;21604;19;43014
02;2020-09-14;1;4;5;16017;15479;29;31496
02;2020-09-14;3;5;8;19825;14455;39;34280
02;2020-09-14;5;5;10;24719;18248;49;42967
02;2020-09-14;1;7;8;34361;28310;59;62671
02;2020-09-14;0;1;1;28061;24495;69;52556
02;2020-09-14;1;0;1;18231;15278;79;33509
02;2020-09-14;0;1;1;11090;7677;89;18767
02;2020-09-14;0;1;1;3992;1506;90;5498
02;2020-09-14;11;28;39;194587;164162;0;358749
03;2020-09-14;1;0;1;31123;30920;09;62043
03;2020-09-14;3;4;7;29370;29268;19;58638
03;2020-09-14;1;1;2;21458;18963;29;40421
03;2020-09-14;7;4;11;21276;18326;39;39602
03;2020-09-14;1;1;2;18164;16593;49;34757
03;2020-09-14;2;4;6;13469;13557;59;27026
03;2020-09-14;3;1;4;8776;8670;69;17446
03;2020-09-14;0;1;1;3777;3591;79;7368
03;2020-09-14;0;0;0;1649;1072;89;2721
03;2020-09-14;0;0;0;485;184;90;669
03;2020-09-14;18;16;34;149547;141144;0;290691
04;2020-09-14;6;5;11;60314;61377;09;121691
04;2020-09-14;15;10;25;66065;68387;19;134452
04;2020-09-14;12;6;18;51059;47156;29;98215
04;2020-09-14;14;6;20;58788;45780;39;104568
04;2020-09-14;5;6;11;61408;52207;49;113615
04;2020-09-14;14;12;26;64838;60759;59;125597
04;2020-09-14;4;1;5;47008;42843;69;89851
04;2020-09-14;5;1;6;25509;21184;79;46693
04;2020-09-14;0;1;1;13168;7647;89;20815
04;2020-09-14;0;0;0;3209;1253;90;4462
04;2020-09-14;75;48;123;451366;408593;0;859959
05;2020-09-14;0;0;0;362.366008612902;341.338819562748;09;703.704828175651
05;2020-09-14;0;0;0;353.376145114279;370.349735405642;19;723.725880519921
05;2020-09-14;0;0;0;218.593559489256;256.539602589476;29;475.133162078732
05;2020-09-14;0;0;0;404.225408693299;360.321910454353;39;764.547319147651
05;2020-09-14;0;0;0;520.067953604221;497.108383964256;49;1017.17633756848
05;2020-09-14;0;0;0;468.146063921917;510.087601910415;59;978.233665832332
05;2020-09-14;0;0;0;340.368470050554;334.366842191253;69;674.735312241807
05;2020-09-14;0;0;0;212.598666888387;192.597753227106;79;405.196420115493
05;2020-09-14;0;0;0;148.727797095705;61.8681715431829;89;210.595968638888
05;2020-09-14;0;0;0;32.9601271090696;10.9909785719784;90;43.9511056810479
05;2020-09-14;0;0;0;3061.43020057959;2935.56979942041;0;5997
06;2020-09-14;0;0;0;42583;42380;09;84963
06;2020-09-14;2;0;3;33369;31925;19;65294
06;2020-09-14;9;1;10;21571;15080;29;36651
06;2020-09-14;5;5;10;21550;16147;39;37697
06;2020-09-14;1;3;4;14193;13939;49;28132
06;2020-09-14;2;3;5;7171;7597;59;14768
06;2020-09-14;0;1;1;3629;4117;69;7746
06;2020-09-14;0;0;0;1577;1457;79;3034
06;2020-09-14;0;0;0;531;474;89;1005
06;2020-09-14;0;0;0;88;93;90;181
06;2020-09-14;19;13;33;146262;133209;0;279471
07;2020-09-14;0;0;0;485;549;09;1034
07;2020-09-14;0;0;0;403;432;19;835
07;2020-09-14;0;0;0;764;841;29;1605
07;2020-09-14;0;0;0;824;928;39;1752
07;2020-09-14;0;0;0;788;1020;49;1808
07;2020-09-14;0;0;0;678;870;59;1548
07;2020-09-14;1;0;1;360;382;69;742
07;2020-09-14;0;0;0;231;190;79;421
07;2020-09-14;0;0;0;114;67;89;181
07;2020-09-14;0;0;0;24;11;90;35
07;2020-09-14;1;0;1;4671;5290;0;9961
08;2020-09-14;0;0;0;2715.22592983026;2997.75551488675;09;5712.98144471701
08;2020-09-14;0;0;0;2778.51901080978;3160.9156459093;19;5939.43465671908
08;2020-09-14;2;1;3;2080.8882988764;1718.16634315323;29;3799.05464202964
08;2020-09-14;0;0;0;2701.8582062647;1896.52641413317;39;4598.38462039786
08;2020-09-14;1;0;1;3151.45861023308;2460.52498233809;49;5611.98359257117
08;2020-09-14;4;0;4;2620.29868333099;2422.23566154656;59;5042.53434487755
08;2020-09-14;3;2;5;1621.44173420671;1438.58325779464;69;3060.02499200135
08;2020-09-14;0;0;0;626.575909335673;526.358467843651;79;1152.93437717932
08;2020-09-14;0;0;0;205.018522985054;140.993639349697;89;346.012162334751
08;2020-09-14;0;0;0;50.0325684687745;20.62259870351;90;70.6551671722846
08;2020-09-14;10;3;13;18551.3174743414;16782.6825256586;0;35334
11;2020-09-14;66;62;131;783071;811785;09;1594856
11;2020-09-14;254;240;508;761456;784653;19;1546109
11;2020-09-14;582;510;1095;850145;801772;29;1651917
11;2020-09-14;417;338;759;914360;843488;39;1757848
11;2020-09-14;290;270;564;845609;826202;49;1671811
11;2020-09-14;266;226;496;793566;745070;59;1538636
11;2020-09-14;125;129;260;628649;549192;69;1177841
11;2020-09-14;65;59;125;434606;358356;79;792962
11;2020-09-14;43;25;68;261425;162933;89;424358
11;2020-09-14;28;9;37;89253;32619;90;121872
11;2020-09-14;2136;1869;4046;6362140;5916070;0;12278210
24;2020-09-14;15;12;28;139720;144686;09;284406
24;2020-09-14;21;14;35;152979;161185;19;314164
24;2020-09-14;31;32;63;122237;126536;29;248773
24;2020-09-14;37;17;54;150359;142009;39;292368
24;2020-09-14;26;15;41;161829;158758;49;320587
24;2020-09-14;14;12;26;172552;168011;59;340563
24;2020-09-14;21;12;33;172509;158177;69;330686
24;2020-09-14;15;4;19;129428;110593;79;240021
24;2020-09-14;9;8;17;87342;56882;89;144224
24;2020-09-14;10;3;13;31210;12071;90;43281
24;2020-09-14;199;129;329;1320165;1238908;0;2559073
27;2020-09-14;8;6;14;143373;149679;09;293052
27;2020-09-14;27;34;63;160962;173003;19;333965
27;2020-09-14;36;31;67;133746;142254;29;276000
27;2020-09-14;25;27;52;160004;155407;39;315411
27;2020-09-14;39;11;50;172333;169564;49;341897
27;2020-09-14;23;16;39;189979;183788;59;373767
27;2020-09-14;10;12;22;192591;178206;69;370797
27;2020-09-14;6;8;14;146876;127546;79;274422
27;2020-09-14;6;5;11;96896;61575;89;158471
27;2020-09-14;4;0;4;33148;12109;90;45257
27;2020-09-14;184;150;336;1429908;1353131;0;2783039
28;2020-09-14;14;20;34;180735;186856;09;367591
28;2020-09-14;30;33;64;200125;213621;19;413746
28;2020-09-14;45;41;86;168922;173007;29;341929
28;2020-09-14;50;39;89;196628;188487;39;385115
28;2020-09-14;41;40;81;205396;201699;49;407095
28;2020-09-14;39;29;68;222002;213866;59;435868
28;2020-09-14;28;18;46;224688;203758;69;428446
28;2020-09-14;15;15;30;163192;135543;79;298735
28;2020-09-14;17;9;26;109691;65377;89;175068
28;2020-09-14;19;5;24;37222;12685;90;49907
28;2020-09-14;298;249;548;1708601;1594899;0;3303500
32;2020-09-14;22;35;58;358062;373689;09;731751
32;2020-09-14;182;204;386;387045;406742;19;793787
32;2020-09-14;240;228;468;342304;348587;29;690891
32;2020-09-14;124;112;237;382485;369972;39;752457
32;2020-09-14;135;92;227;382510;376716;49;759226
32;2020-09-14;106;98;205;386937;376527;59;763464
32;2020-09-14;48;38;86;371211;330938;69;702149
32;2020-09-14;32;22;55;250542;201459;79;452001
32;2020-09-14;19;14;33;163399;89786;89;253185
32;2020-09-14;8;6;14;48384;15367;90;63751
32;2020-09-14;916;851;1771;3072879;2889783;0;5962662
44;2020-09-14;10;13;23;291525;306839;09;598364
44;2020-09-14;43;38;81;320255;339504;19;659759
44;2020-09-14;69;90;159;302020;314428;29;616448
44;2020-09-14;49;36;85;342222;333292;39;675514
44;2020-09-14;38;29;67;349727;344491;49;694218
44;2020-09-14;30;28;58;381371;373239;59;754610
44;2020-09-14;21;19;40;367165;335850;69;703015
44;2020-09-14;13;12;25;250387;215436;79;465823
44;2020-09-14;5;7;12;170825;105192;89;276017
44;2020-09-14;2;1;3;51248;16731;90;67979
44;2020-09-14;281;274;555;2826745;2685002;0;5511747
52;2020-09-14;6;5;12;213594;223900;09;437494
52;2020-09-14;45;39;86;240818;255197;19;496015
52;2020-09-14;43;42;85;197010;200630;29;397640
52;2020-09-14;28;19;47;231204;224885;39;456089
52;2020-09-14;23;15;38;243874;243418;49;487292
52;2020-09-14;21;21;42;244100;239116;59;483216
52;2020-09-14;12;9;21;241796;221345;69;463141
52;2020-09-14;11;10;21;177805;149903;79;327708
52;2020-09-14;7;2;9;119561;75822;89;195383
52;2020-09-14;1;0;1;42559;15260;90;57819
52;2020-09-14;197;162;362;1952321;1849476;0;3801797
53;2020-09-14;6;4;10;173813;182358;09;356171
53;2020-09-14;27;28;55;202720;214740;19;417460
53;2020-09-14;53;46;100;163116;173196;29;336312
53;2020-09-14;17;22;39;190526;187674;39;378200
53;2020-09-14;13;14;27;212098;212015;49;424113
53;2020-09-14;18;20;38;223699;219176;59;442875
53;2020-09-14;7;7;14;227435;209274;69;436709
53;2020-09-14;9;7;16;169992;140910;79;310902
53;2020-09-14;4;0;4;118117;69883;89;188000
53;2020-09-14;2;0;2;37370;12267;90;49637
53;2020-09-14;156;148;305;1718886;1621493;0;3340379
75;2020-09-14;20;27;48;293104;305291;09;598395
75;2020-09-14;69;66;139;337141;357785;19;694926
75;2020-09-14;117;104;222;295024;300618;29;595642
75;2020-09-14;76;63;139;347871;331233;39;679104
75;2020-09-14;67;50;118;384742;372771;49;757513
75;2020-09-14;64;73;137;413361;390880;59;804241
75;2020-09-14;25;40;65;425623;384060;69;809683
75;2020-09-14;16;30;46;325086;276298;79;601384
75;2020-09-14;23;11;34;213986;139308;89;353294
75;2020-09-14;26;13;39;77600;28200;90;105800
75;2020-09-14;503;478;988;3113538;2886444;0;5999982
76;2020-09-14;17;17;34;305956;318589;09;624545
76;2020-09-14;118;164;286;338942;356969;19;695911
76;2020-09-14;209;239;449;316210;319570;29;635780
76;2020-09-14;88;59;147;356758;337587;39;694345
76;2020-09-14;86;61;147;376541;363812;49;740353
76;2020-09-14;69;74;143;402608;383750;59;786358
76;2020-09-14;39;38;77;394889;358997;69;753886
76;2020-09-14;20;20;40;308664;263806;79;572470
76;2020-09-14;30;11;41;195838;129272;89;325110
76;2020-09-14;31;3;34;69372;26728;90;96100
76;2020-09-14;709;687;1401;3065778;2859080;0;5924858
84;2020-09-14;32;43;76;459549;481088;09;940637
84;2020-09-14;97;121;218;487711;511905;19;999616
84;2020-09-14;242;237;479;443824;451094;29;894918
84;2020-09-14;114;111;225;512522;493262;39;1005784
84;2020-09-14;114;106;220;520248;515106;49;1035354
84;2020-09-14;92;92;184;529611;514848;59;1044459
84;2020-09-14;69;57;126;486720;439940;69;926660
84;2020-09-14;31;38;69;372151;315211;79;687362
84;2020-09-14;38;26;64;237198;150524;89;387722
84;2020-09-14;41;7;48;81185;28680;90;109865
84;2020-09-14;870;838;1709;4130719;3901658;0;8032377
93;2020-09-14;38;38;76;268834;283093;09;551927
93;2020-09-14;96;109;206;280751;296087;19;576838
93;2020-09-14;176;128;304;254404;255552;29;509956
93;2020-09-14;155;123;278;310704;288398;39;599102
93;2020-09-14;121;89;210;325559;305827;49;631386
93;2020-09-14;150;110;260;353104;325389;59;678493
93;2020-09-14;77;76;153;336327;296459;69;632786
93;2020-09-14;45;39;84;279820;229699;79;509519
93;2020-09-14;33;21;54;171274;113716;89;284990
93;2020-09-14;15;7;22;58896;21758;90;80654
93;2020-09-14;906;740;1647;2639673;2415978;0;5055651
94;2020-09-14;2;0;2;16311;17433;09;33744
94;2020-09-14;4;1;6;16679;18132;19;34811
94;2020-09-14;6;7;13;16782;16579;29;33361
94;2020-09-14;3;4;7;23044;20580;39;43624
94;2020-09-14;5;3;8;23065;22140;49;45205
94;2020-09-14;3;2;5;24549;23421;59;47970
94;2020-09-14;3;0;3;23212;21883;69;45095
94;2020-09-14;0;1;1;19544;17141;79;36685
94;2020-09-14;1;1;2;11227;8178;89;19405
94;2020-09-14;0;0;0;3332;1447;90;4779
94;2020-09-14;27;19;47;177745;166934;0;344679
01;2020-09-15;0;2;2;19979;20155;09;40134
01;2020-09-15;13;14;27;24994;25489;19;50483
01;2020-09-15;16;25;41;17868;16690;29;34558
01;2020-09-15;24;9;33;22328;14821;39;37149
01;2020-09-15;20;22;42;28652;20276;49;48928
01;2020-09-15;18;20;38;33264;27260;59;60524
01;2020-09-15;15;20;35;27135;23978;69;51113
01;2020-09-15;4;8;12;18401;14661;79;33062
01;2020-09-15;1;1;2;9633;6375;89;16008
01;2020-09-15;1;0;1;3410;1510;90;4920
01;2020-09-15;112;121;233;205664;171215;0;376879
02;2020-09-15;2;0;2;16881;17110;09;33991
02;2020-09-15;2;1;3;21410;21604;19;43014
02;2020-09-15;4;6;10;16017;15479;29;31496
02;2020-09-15;4;5;9;19825;14455;39;34280
02;2020-09-15;1;1;2;24719;18248;49;42967
02;2020-09-15;0;6;6;34361;28310;59;62671
02;2020-09-15;3;0;3;28061;24495;69;52556
02;2020-09-15;0;0;0;18231;15278;79;33509
02;2020-09-15;0;1;1;11090;7677;89;18767
02;2020-09-15;0;0;0;3992;1506;90;5498
02;2020-09-15;16;20;36;194587;164162;0;358749
03;2020-09-15;1;3;4;31123;30920;09;62043
03;2020-09-15;3;0;3;29370;29268;19;58638
03;2020-09-15;5;3;8;21458;18963;29;40421
03;2020-09-15;6;1;7;21276;18326;39;39602
03;2020-09-15;1;1;3;18164;16593;49;34757
03;2020-09-15;1;2;3;13469;13557;59;27026
03;2020-09-15;1;0;1;8776;8670;69;17446
03;2020-09-15;0;0;0;3777;3591;79;7368
03;2020-09-15;0;0;0;1649;1072;89;2721
03;2020-09-15;0;0;0;485;184;90;669
03;2020-09-15;18;10;29;149547;141144;0;290691
04;2020-09-15;5;2;7;60314;61377;09;121691
04;2020-09-15;5;10;15;66065;68387;19;134452
04;2020-09-15;7;4;11;51059;47156;29;98215
04;2020-09-15;8;5;13;58788;45780;39;104568
04;2020-09-15;7;2;9;61408;52207;49;113615
04;2020-09-15;8;6;14;64838;60759;59;125597
04;2020-09-15;1;5;6;47008;42843;69;89851
04;2020-09-15;3;3;6;25509;21184;79;46693
04;2020-09-15;1;0;1;13168;7647;89;20815
04;2020-09-15;0;0;0;3209;1253;90;4462
04;2020-09-15;45;37;82;451366;408593;0;859959
05;2020-09-15;0;0;0;362.366008612902;341.338819562748;09;703.704828175651
05;2020-09-15;0;0;0;353.376145114279;370.349735405642;19;723.725880519921
05;2020-09-15;0;0;0;218.593559489256;256.539602589476;29;475.133162078732
05;2020-09-15;0;0;0;404.225408693299;360.321910454353;39;764.547319147651
05;2020-09-15;0;0;0;520.067953604221;497.108383964256;49;1017.17633756848
05;2020-09-15;0;0;0;468.146063921917;510.087601910415;59;978.233665832332
05;2020-09-15;0;0;0;340.368470050554;334.366842191253;69;674.735312241807
05;2020-09-15;0;0;0;212.598666888387;192.597753227106;79;405.196420115493
05;2020-09-15;0;0;0;148.727797095705;61.8681715431829;89;210.595968638888
05;2020-09-15;0;0;0;32.9601271090696;10.9909785719784;90;43.9511056810479
05;2020-09-15;0;0;0;3061.43020057959;2935.56979942041;0;5997
06;2020-09-15;0;0;0;42583;42380;09;84963
06;2020-09-15;0;0;0;33369;31925;19;65294
06;2020-09-15;2;2;4;21571;15080;29;36651
06;2020-09-15;1;1;2;21550;16147;39;37697
06;2020-09-15;2;1;3;14193;13939;49;28132
06;2020-09-15;1;0;1;7171;7597;59;14768
06;2020-09-15;0;0;0;3629;4117;69;7746
06;2020-09-15;0;0;0;1577;1457;79;3034
06;2020-09-15;0;0;0;531;474;89;1005
06;2020-09-15;0;0;0;88;93;90;181
06;2020-09-15;6;4;10;146262;133209;0;279471
07;2020-09-15;0;0;0;485;549;09;1034
07;2020-09-15;0;0;0;403;432;19;835
07;2020-09-15;0;1;1;764;841;29;1605
07;2020-09-15;0;1;1;824;928;39;1752
07;2020-09-15;0;1;1;788;1020;49;1808
07;2020-09-15;0;0;0;678;870;59;1548
07;2020-09-15;0;1;1;360;382;69;742
07;2020-09-15;0;0;0;231;190;79;421
07;2020-09-15;0;0;0;114;67;89;181
07;2020-09-15;0;0;0;24;11;90;35
07;2020-09-15;0;4;4;4671;5290;0;9961
08;2020-09-15;0;1;1;2715.22592983026;2997.75551488675;09;5712.98144471701
08;2020-09-15;0;0;0;2778.51901080978;3160.9156459093;19;5939.43465671908
08;2020-09-15;1;1;2;2080.8882988764;1718.16634315323;29;3799.05464202964
08;2020-09-15;0;1;1;2701.8582062647;1896.52641413317;39;4598.38462039786
08;2020-09-15;0;0;0;3151.45861023308;2460.52498233809;49;5611.98359257117
08;2020-09-15;1;0;1;2620.29868333099;2422.23566154656;59;5042.53434487755
08;2020-09-15;2;2;4;1621.44173420671;1438.58325779464;69;3060.02499200135
08;2020-09-15;0;0;0;626.575909335673;526.358467843651;79;1152.93437717932
08;2020-09-15;0;0;0;205.018522985054;140.993639349697;89;346.012162334751
08;2020-09-15;0;0;0;50.0325684687745;20.62259870351;90;70.6551671722846
08;2020-09-15;4;5;9;18551.3174743414;16782.6825256586;0;35334
11;2020-09-15;57;73;134;783071;811785;09;1594856
11;2020-09-15;213;214;436;761456;784653;19;1546109
11;2020-09-15;536;464;1002;850145;801772;29;1651917
11;2020-09-15;365;342;713;914360;843488;39;1757848
11;2020-09-15;277;268;549;845609;826202;49;1671811
11;2020-09-15;229;173;404;793566;745070;59;1538636
11;2020-09-15;104;110;215;628649;549192;69;1177841
11;2020-09-15;52;52;104;434606;358356;79;792962
11;2020-09-15;24;18;42;261425;162933;89;424358
11;2020-09-15;15;3;18;89253;32619;90;121872
11;2020-09-15;1873;1719;3624;6362140;5916070;0;12278210
24;2020-09-15;4;6;10;139720;144686;09;284406
24;2020-09-15;25;20;47;152979;161185;19;314164
24;2020-09-15;33;50;83;122237;126536;29;248773
24;2020-09-15;28;20;48;150359;142009;39;292368
24;2020-09-15;19;23;42;161829;158758;49;320587
24;2020-09-15;15;17;32;172552;168011;59;340563
24;2020-09-15;13;6;19;172509;158177;69;330686
24;2020-09-15;3;4;7;129428;110593;79;240021
24;2020-09-15;3;2;5;87342;56882;89;144224
24;2020-09-15;1;0;1;31210;12071;90;43281
24;2020-09-15;144;148;294;1320165;1238908;0;2559073
27;2020-09-15;11;13;24;143373;149679;09;293052
27;2020-09-15;24;20;44;160962;173003;19;333965
27;2020-09-15;30;26;57;133746;142254;29;276000
27;2020-09-15;13;23;36;160004;155407;39;315411
27;2020-09-15;23;9;32;172333;169564;49;341897
27;2020-09-15;16;22;38;189979;183788;59;373767
27;2020-09-15;10;13;23;192591;178206;69;370797
27;2020-09-15;4;8;12;146876;127546;79;274422
27;2020-09-15;2;2;4;96896;61575;89;158471
27;2020-09-15;1;2;3;33148;12109;90;45257
27;2020-09-15;134;138;273;1429908;1353131;0;2783039
28;2020-09-15;13;19;32;180735;186856;09;367591
28;2020-09-15;36;31;68;200125;213621;19;413746
28;2020-09-15;58;45;103;168922;173007;29;341929
28;2020-09-15;37;38;75;196628;188487;39;385115
28;2020-09-15;43;40;83;205396;201699;49;407095
28;2020-09-15;37;37;74;222002;213866;59;435868
28;2020-09-15;17;22;39;224688;203758;69;428446
28;2020-09-15;6;6;12;163192;135543;79;298735
28;2020-09-15;5;2;7;109691;65377;89;175068
28;2020-09-15;6;1;7;37222;12685;90;49907
28;2020-09-15;258;241;500;1708601;1594899;0;3303500
32;2020-09-15;31;47;80;358062;373689;09;731751
32;2020-09-15;165;135;305;387045;406742;19;793787
32;2020-09-15;219;231;454;342304;348587;29;690891
32;2020-09-15;99;93;195;382485;369972;39;752457
32;2020-09-15;113;101;216;382510;376716;49;759226
32;2020-09-15;88;87;176;386937;376527;59;763464
32;2020-09-15;59;40;99;371211;330938;69;702149
32;2020-09-15;27;22;50;250542;201459;79;452001
32;2020-09-15;10;19;30;163399;89786;89;253185
32;2020-09-15;12;5;17;48384;15367;90;63751
32;2020-09-15;824;780;1623;3072879;2889783;0;5962662
44;2020-09-15;8;11;19;291525;306839;09;598364
44;2020-09-15;84;50;134;320255;339504;19;659759
44;2020-09-15;85;75;160;302020;314428;29;616448
44;2020-09-15;39;39;79;342222;333292;39;675514
44;2020-09-15;20;14;34;349727;344491;49;694218
44;2020-09-15;23;14;37;381371;373239;59;754610
44;2020-09-15;16;16;32;367165;335850;69;703015
44;2020-09-15;6;13;19;250387;215436;79;465823
44;2020-09-15;6;5;11;170825;105192;89;276017
44;2020-09-15;4;0;4;51248;16731;90;67979
44;2020-09-15;291;237;529;2826745;2685002;0;5511747
52;2020-09-15;2;5;7;213594;223900;09;437494
52;2020-09-15;32;41;73;240818;255197;19;496015
52;2020-09-15;45;58;104;197010;200630;29;397640
52;2020-09-15;26;18;44;231204;224885;39;456089
52;2020-09-15;39;23;62;243874;243418;49;487292
52;2020-09-15;20;18;38;244100;239116;59;483216
52;2020-09-15;15;15;30;241796;221345;69;463141
52;2020-09-15;6;6;12;177805;149903;79;327708
52;2020-09-15;7;6;13;119561;75822;89;195383
52;2020-09-15;7;1;8;42559;15260;90;57819
52;2020-09-15;199;191;391;1952321;1849476;0;3801797
53;2020-09-15;7;9;16;173813;182358;09;356171
53;2020-09-15;41;38;79;202720;214740;19;417460
53;2020-09-15;64;58;122;163116;173196;29;336312
53;2020-09-15;26;18;44;190526;187674;39;378200
53;2020-09-15;18;13;31;212098;212015;49;424113
53;2020-09-15;23;13;36;223699;219176;59;442875
53;2020-09-15;4;6;10;227435;209274;69;436709
53;2020-09-15;9;5;14;169992;140910;79;310902
53;2020-09-15;16;8;24;118117;69883;89;188000
53;2020-09-15;4;1;5;37370;12267;90;49637
53;2020-09-15;212;169;381;1718886;1621493;0;3340379
75;2020-09-15;18;10;28;293104;305291;09;598395
75;2020-09-15;67;62;129;337141;357785;19;694926
75;2020-09-15;111;97;208;295024;300618;29;595642
75;2020-09-15;84;46;130;347871;331233;39;679104
75;2020-09-15;62;60;122;384742;372771;49;757513
75;2020-09-15;53;61;114;413361;390880;59;804241
75;2020-09-15;26;31;57;425623;384060;69;809683
75;2020-09-15;21;16;37;325086;276298;79;601384
75;2020-09-15;22;10;32;213986;139308;89;353294
75;2020-09-15;19;10;29;77600;28200;90;105800
75;2020-09-15;484;403;887;3113538;2886444;0;5999982
76;2020-09-15;26;24;51;305956;318589;09;624545
76;2020-09-15;120;116;239;338942;356969;19;695911
76;2020-09-15;194;196;390;316210;319570;29;635780
76;2020-09-15;79;75;154;356758;337587;39;694345
76;2020-09-15;95;70;166;376541;363812;49;740353
76;2020-09-15;76;52;128;402608;383750;59;786358
76;2020-09-15;35;51;87;394889;358997;69;753886
76;2020-09-15;29;24;53;308664;263806;79;572470
76;2020-09-15;24;15;39;195838;129272;89;325110
76;2020-09-15;7;8;15;69372;26728;90;96100
76;2020-09-15;685;631;1322;3065778;2859080;0;5924858
84;2020-09-15;40;49;91;459549;481088;09;940637
84;2020-09-15;97;105;203;487711;511905;19;999616
84;2020-09-15;219;203;422;443824;451094;29;894918
84;2020-09-15;124;107;231;512522;493262;39;1005784
84;2020-09-15;146;108;254;520248;515106;49;1035354
84;2020-09-15;118;97;215;529611;514848;59;1044459
84;2020-09-15;54;54;108;486720;439940;69;926660
84;2020-09-15;28;33;61;372151;315211;79;687362
84;2020-09-15;32;24;56;237198;150524;89;387722
84;2020-09-15;17;3;20;81185;28680;90;109865
84;2020-09-15;875;783;1661;4130719;3901658;0;8032377
93;2020-09-15;26;23;49;268834;283093;09;551927
93;2020-09-15;90;86;177;280751;296087;19;576838
93;2020-09-15;161;150;311;254404;255552;29;509956
93;2020-09-15;134;104;238;310704;288398;39;599102
93;2020-09-15;124;96;221;325559;305827;49;631386
93;2020-09-15;105;94;199;353104;325389;59;678493
93;2020-09-15;59;62;121;336327;296459;69;632786
93;2020-09-15;38;35;73;279820;229699;79;509519
93;2020-09-15;28;21;49;171274;113716;89;284990
93;2020-09-15;13;2;15;58896;21758;90;80654
93;2020-09-15;778;673;1454;2639673;2415978;0;5055651
94;2020-09-15;0;0;0;16311;17433;09;33744
94;2020-09-15;2;2;4;16679;18132;19;34811
94;2020-09-15;6;6;13;16782;16579;29;33361
94;2020-09-15;0;0;0;23044;20580;39;43624
94;2020-09-15;3;0;3;23065;22140;49;45205
94;2020-09-15;5;2;7;24549;23421;59;47970
94;2020-09-15;0;1;1;23212;21883;69;45095
94;2020-09-15;2;2;4;19544;17141;79;36685
94;2020-09-15;3;0;3;11227;8178;89;19405
94;2020-09-15;1;0;1;3332;1447;90;4779
94;2020-09-15;22;13;36;177745;166934;0;344679
01;2020-09-16;4;3;7;19979;20155;09;40134
01;2020-09-16;10;15;25;24994;25489;19;50483
01;2020-09-16;16;17;33;17868;16690;29;34558
01;2020-09-16;16;12;28;22328;14821;39;37149
01;2020-09-16;26;21;47;28652;20276;49;48928
01;2020-09-16;27;12;39;33264;27260;59;60524
01;2020-09-16;19;13;32;27135;23978;69;51113
01;2020-09-16;8;6;14;18401;14661;79;33062
01;2020-09-16;4;4;8;9633;6375;89;16008
01;2020-09-16;2;1;3;3410;1510;90;4920
01;2020-09-16;132;104;236;205664;171215;0;376879
02;2020-09-16;0;0;0;16881;17110;09;33991
02;2020-09-16;1;1;2;21410;21604;19;43014
02;2020-09-16;2;2;4;16017;15479;29;31496
02;2020-09-16;3;4;7;19825;14455;39;34280
02;2020-09-16;2;1;3;24719;18248;49;42967
02;2020-09-16;3;3;6;34361;28310;59;62671
02;2020-09-16;2;1;3;28061;24495;69;52556
02;2020-09-16;1;0;1;18231;15278;79;33509
02;2020-09-16;0;0;0;11090;7677;89;18767
02;2020-09-16;0;0;0;3992;1506;90;5498
02;2020-09-16;14;12;26;194587;164162;0;358749
03;2020-09-16;0;1;1;31123;30920;09;62043
03;2020-09-16;0;2;2;29370;29268;19;58638
03;2020-09-16;6;0;6;21458;18963;29;40421
03;2020-09-16;3;1;4;21276;18326;39;39602
03;2020-09-16;2;1;3;18164;16593;49;34757
03;2020-09-16;1;3;4;13469;13557;59;27026
03;2020-09-16;0;0;0;8776;8670;69;17446
03;2020-09-16;0;0;0;3777;3591;79;7368
03;2020-09-16;0;0;0;1649;1072;89;2721
03;2020-09-16;0;0;0;485;184;90;669
03;2020-09-16;12;8;20;149547;141144;0;290691
04;2020-09-16;3;3;6;60314;61377;09;121691
04;2020-09-16;13;8;21;66065;68387;19;134452
04;2020-09-16;13;10;23;51059;47156;29;98215
04;2020-09-16;6;4;10;58788;45780;39;104568
04;2020-09-16;5;8;13;61408;52207;49;113615
04;2020-09-16;7;4;11;64838;60759;59;125597
04;2020-09-16;6;8;14;47008;42843;69;89851
04;2020-09-16;1;2;3;25509;21184;79;46693
04;2020-09-16;1;0;1;13168;7647;89;20815
04;2020-09-16;0;0;0;3209;1253;90;4462
04;2020-09-16;55;47;102;451366;408593;0;859959
05;2020-09-16;0;0;0;362.366008612902;341.338819562748;09;703.704828175651
05;2020-09-16;0;0;0;353.376145114279;370.349735405642;19;723.725880519921
05;2020-09-16;0;0;0;218.593559489256;256.539602589476;29;475.133162078732
05;2020-09-16;0;0;0;404.225408693299;360.321910454353;39;764.547319147651
05;2020-09-16;0;0;0;520.067953604221;497.108383964256;49;1017.17633756848
05;2020-09-16;1;0;1;468.146063921917;510.087601910415;59;978.233665832332
05;2020-09-16;0;0;0;340.368470050554;334.366842191253;69;674.735312241807
05;2020-09-16;0;0;0;212.598666888387;192.597753227106;79;405.196420115493
05;2020-09-16;0;0;0;148.727797095705;61.8681715431829;89;210.595968638888
05;2020-09-16;0;0;0;32.9601271090696;10.9909785719784;90;43.9511056810479
05;2020-09-16;1;0;1;3061.43020057959;2935.56979942041;0;5997
06;2020-09-16;0;0;0;42583;42380;09;84963
06;2020-09-16;1;1;2;33369;31925;19;65294
06;2020-09-16;3;4;7;21571;15080;29;36651
06;2020-09-16;1;2;3;21550;16147;39;37697
06;2020-09-16;1;1;2;14193;13939;49;28132
06;2020-09-16;1;1;2;7171;7597;59;14768
06;2020-09-16;1;0;1;3629;4117;69;7746
06;2020-09-16;0;1;1;1577;1457;79;3034
06;2020-09-16;0;0;0;531;474;89;1005
06;2020-09-16;0;0;0;88;93;90;181
06;2020-09-16;8;10;18;146262;133209;0;279471
07;2020-09-16;0;0;0;485;549;09;1034
07;2020-09-16;0;0;0;403;432;19;835
07;2020-09-16;0;0;0;764;841;29;1605
07;2020-09-16;0;0;0;824;928;39;1752
07;2020-09-16;0;0;0;788;1020;49;1808
07;2020-09-16;0;0;0;678;870;59;1548
07;2020-09-16;1;0;1;360;382;69;742
07;2020-09-16;0;0;0;231;190;79;421
07;2020-09-16;0;0;0;114;67;89;181
07;2020-09-16;0;0;0;24;11;90;35
07;2020-09-16;1;0;1;4671;5290;0;9961
08;2020-09-16;0;0;0;2715.22592983026;2997.75551488675;09;5712.98144471701
08;2020-09-16;0;0;0;2778.51901080978;3160.9156459093;19;5939.43465671908
08;2020-09-16;1;0;1;2080.8882988764;1718.16634315323;29;3799.05464202964
08;2020-09-16;0;3;3;2701.8582062647;1896.52641413317;39;4598.38462039786
08;2020-09-16;1;0;1;3151.45861023308;2460.52498233809;49;5611.98359257117
08;2020-09-16;1;1;2;2620.29868333099;2422.23566154656;59;5042.53434487755
08;2020-09-16;1;0;1;1621.44173420671;1438.58325779464;69;3060.02499200135
08;2020-09-16;0;0;0;626.575909335673;526.358467843651;79;1152.93437717932
08;2020-09-16;0;0;0;205.018522985054;140.993639349697;89;346.012162334751
08;2020-09-16;0;0;0;50.0325684687745;20.62259870351;90;70.6551671722846
08;2020-09-16;4;4;8;18551.3174743414;16782.6825256586;0;35334
11;2020-09-16;50;63;119;783071;811785;09;1594856
11;2020-09-16;215;232;457;761456;784653;19;1546109
11;2020-09-16;529;548;1080;850145;801772;29;1651917
11;2020-09-16;343;323;668;914360;843488;39;1757848
11;2020-09-16;248;245;494;845609;826202;49;1671811
11;2020-09-16;241;171;417;793566;745070;59;1538636
11;2020-09-16;132;134;269;628649;549192;69;1177841
11;2020-09-16;50;39;89;434606;358356;79;792962
11;2020-09-16;31;18;49;261425;162933;89;424358
11;2020-09-16;10;6;16;89253;32619;90;121872
11;2020-09-16;1849;1780;3664;6362140;5916070;0;12278210
24;2020-09-16;5;7;13;139720;144686;09;284406
24;2020-09-16;22;30;52;152979;161185;19;314164
24;2020-09-16;34;40;74;122237;126536;29;248773
24;2020-09-16;18;28;46;150359;142009;39;292368
24;2020-09-16;17;14;31;161829;158758;49;320587
24;2020-09-16;18;16;34;172552;168011;59;340563
24;2020-09-16;9;11;20;172509;158177;69;330686
24;2020-09-16;8;3;11;129428;110593;79;240021
24;2020-09-16;3;2;5;87342;56882;89;144224
24;2020-09-16;1;0;1;31210;12071;90;43281
24;2020-09-16;135;151;287;1320165;1238908;0;2559073
27;2020-09-16;5;13;18;143373;149679;09;293052
27;2020-09-16;17;37;54;160962;173003;19;333965
27;2020-09-16;35;27;62;133746;142254;29;276000
27;2020-09-16;15;9;24;160004;155407;39;315411
27;2020-09-16;22;19;41;172333;169564;49;341897
27;2020-09-16;25;22;47;189979;183788;59;373767
27;2020-09-16;21;13;34;192591;178206;69;370797
27;2020-09-16;10;5;15;146876;127546;79;274422
27;2020-09-16;4;6;10;96896;61575;89;158471
27;2020-09-16;1;3;4;33148;12109;90;45257
27;2020-09-16;155;154;309;1429908;1353131;0;2783039
28;2020-09-16;7;12;20;180735;186856;09;367591
28;2020-09-16;45;32;79;200125;213621;19;413746
28;2020-09-16;45;56;101;168922;173007;29;341929
28;2020-09-16;50;40;90;196628;188487;39;385115
28;2020-09-16;47;39;86;205396;201699;49;407095
28;2020-09-16;29;33;62;222002;213866;59;435868
28;2020-09-16;22;23;46;224688;203758;69;428446
28;2020-09-16;14;15;29;163192;135543;79;298735
28;2020-09-16;12;5;17;109691;65377;89;175068
28;2020-09-16;5;4;9;37222;12685;90;49907
28;2020-09-16;276;259;539;1708601;1594899;0;3303500
32;2020-09-16;30;25;56;358062;373689;09;731751
32;2020-09-16;153;172;326;387045;406742;19;793787
32;2020-09-16;195;257;452;342304;348587;29;690891
32;2020-09-16;98;90;188;382485;369972;39;752457
32;2020-09-16;111;84;195;382510;376716;49;759226
32;2020-09-16;83;57;140;386937;376527;59;763464
32;2020-09-16;42;36;78;371211;330938;69;702149
32;2020-09-16;22;22;44;250542;201459;79;452001
32;2020-09-16;15;4;19;163399;89786;89;253185
32;2020-09-16;2;2;4;48384;15367;90;63751
32;2020-09-16;751;749;1502;3072879;2889783;0;5962662
44;2020-09-16;7;6;13;291525;306839;09;598364
44;2020-09-16;50;54;105;320255;339504;19;659759
44;2020-09-16;38;69;107;302020;314428;29;616448
44;2020-09-16;26;39;65;342222;333292;39;675514
44;2020-09-16;21;14;35;349727;344491;49;694218
44;2020-09-16;19;17;36;381371;373239;59;754610
44;2020-09-16;15;15;30;367165;335850;69;703015
44;2020-09-16;9;6;15;250387;215436;79;465823
44;2020-09-16;13;6;19;170825;105192;89;276017
44;2020-09-16;4;3;7;51248;16731;90;67979
44;2020-09-16;203;229;433;2826745;2685002;0;5511747
52;2020-09-16;7;7;16;213594;223900;09;437494
52;2020-09-16;54;45;106;240818;255197;19;496015
52;2020-09-16;47;64;112;197010;200630;29;397640
52;2020-09-16;28;29;57;231204;224885;39;456089
52;2020-09-16;26;29;55;243874;243418;49;487292
52;2020-09-16;21;25;46;244100;239116;59;483216
52;2020-09-16;11;20;31;241796;221345;69;463141
52;2020-09-16;4;9;13;177805;149903;79;327708
52;2020-09-16;4;3;7;119561;75822;89;195383
52;2020-09-16;0;1;1;42559;15260;90;57819
52;2020-09-16;202;232;444;1952321;1849476;0;3801797
53;2020-09-16;7;9;17;173813;182358;09;356171
53;2020-09-16;44;30;74;202720;214740;19;417460
53;2020-09-16;58;63;121;163116;173196;29;336312
53;2020-09-16;18;21;39;190526;187674;39;378200
53;2020-09-16;19;14;33;212098;212015;49;424113
53;2020-09-16;19;11;30;223699;219176;59;442875
53;2020-09-16;14;14;28;227435;209274;69;436709
53;2020-09-16;6;7;13;169992;140910;79;310902
53;2020-09-16;4;4;8;118117;69883;89;188000
53;2020-09-16;0;0;0;37370;12267;90;49637
53;2020-09-16;189;173;363;1718886;1621493;0;3340379
75;2020-09-16;16;16;32;293104;305291;09;598395
75;2020-09-16;46;47;94;337141;357785;19;694926
75;2020-09-16;87;88;175;295024;300618;29;595642
75;2020-09-16;70;66;136;347871;331233;39;679104
75;2020-09-16;73;56;130;384742;372771;49;757513
75;2020-09-16;49;31;80;413361;390880;59;804241
75;2020-09-16;34;35;69;425623;384060;69;809683
75;2020-09-16;14;23;37;325086;276298;79;601384
75;2020-09-16;27;17;44;213986;139308;89;353294
75;2020-09-16;33;6;39;77600;28200;90;105800
75;2020-09-16;449;385;836;3113538;2886444;0;5999982
76;2020-09-16;20;21;41;305956;318589;09;624545
76;2020-09-16;118;138;261;338942;356969;19;695911
76;2020-09-16;197;189;386;316210;319570;29;635780
76;2020-09-16;94;88;182;356758;337587;39;694345
76;2020-09-16;73;71;145;376541;363812;49;740353
76;2020-09-16;68;55;123;402608;383750;59;786358
76;2020-09-16;38;41;79;394889;358997;69;753886
76;2020-09-16;21;38;59;308664;263806;79;572470
76;2020-09-16;16;10;26;195838;129272;89;325110
76;2020-09-16;8;1;9;69372;26728;90;96100
76;2020-09-16;655;654;1315;3065778;2859080;0;5924858
84;2020-09-16;38;42;80;459549;481088;09;940637
84;2020-09-16;138;112;250;487711;511905;19;999616
84;2020-09-16;220;245;466;443824;451094;29;894918
84;2020-09-16;142;122;264;512522;493262;39;1005784
84;2020-09-16;127;108;235;520248;515106;49;1035354
84;2020-09-16;107;90;197;529611;514848;59;1044459
84;2020-09-16;63;46;109;486720;439940;69;926660
84;2020-09-16;36;33;69;372151;315211;79;687362
84;2020-09-16;26;18;44;237198;150524;89;387722
84;2020-09-16;21;7;28;81185;28680;90;109865
84;2020-09-16;918;824;1743;4130719;3901658;0;8032377
93;2020-09-16;20;29;49;268834;283093;09;551927
93;2020-09-16;99;113;212;280751;296087;19;576838
93;2020-09-16;161;120;282;254404;255552;29;509956
93;2020-09-16;131;107;238;310704;288398;39;599102
93;2020-09-16;103;90;193;325559;305827;49;631386
93;2020-09-16;99;70;169;353104;325389;59;678493
93;2020-09-16;47;67;114;336327;296459;69;632786
93;2020-09-16;40;39;79;279820;229699;79;509519
93;2020-09-16;18;16;34;171274;113716;89;284990
93;2020-09-16;9;3;12;58896;21758;90;80654
93;2020-09-16;727;654;1382;2639673;2415978;0;5055651
94;2020-09-16;0;0;0;16311;17433;09;33744
94;2020-09-16;5;2;7;16679;18132;19;34811
94;2020-09-16;5;6;11;16782;16579;29;33361
94;2020-09-16;1;4;5;23044;20580;39;43624
94;2020-09-16;0;5;5;23065;22140;49;45205
94;2020-09-16;2;5;7;24549;23421;59;47970
94;2020-09-16;2;6;8;23212;21883;69;45095
94;2020-09-16;1;1;2;19544;17141;79;36685
94;2020-09-16;2;0;2;11227;8178;89;19405
94;2020-09-16;0;0;0;3332;1447;90;4779
94;2020-09-16;18;29;47;177745;166934;0;344679
01;2020-09-17;2;2;4;19979;20155;09;40134
01;2020-09-17;15;9;24;24994;25489;19;50483
01;2020-09-17;17;9;26;17868;16690;29;34558
01;2020-09-17;19;13;32;22328;14821;39;37149
01;2020-09-17;28;20;48;28652;20276;49;48928
01;2020-09-17;21;28;49;33264;27260;59;60524
01;2020-09-17;14;11;25;27135;23978;69;51113
01;2020-09-17;2;12;14;18401;14661;79;33062
01;2020-09-17;2;3;5;9633;6375;89;16008
01;2020-09-17;1;0;1;3410;1510;90;4920
01;2020-09-17;121;107;228;205664;171215;0;376879
02;2020-09-17;2;2;4;16881;17110;09;33991
02;2020-09-17;1;0;1;21410;21604;19;43014
02;2020-09-17;0;4;4;16017;15479;29;31496
02;2020-09-17;4;1;5;19825;14455;39;34280
02;2020-09-17;0;1;1;24719;18248;49;42967
02;2020-09-17;9;7;16;34361;28310;59;62671
02;2020-09-17;0;3;3;28061;24495;69;52556
02;2020-09-17;0;1;1;18231;15278;79;33509
02;2020-09-17;0;0;0;11090;7677;89;18767
02;2020-09-17;0;0;0;3992;1506;90;5498
02;2020-09-17;16;19;35;194587;164162;0;358749
03;2020-09-17;0;0;0;31123;30920;09;62043
03;2020-09-17;0;1;1;29370;29268;19;58638
03;2020-09-17;2;0;2;21458;18963;29;40421
03;2020-09-17;3;1;4;21276;18326;39;39602
03;2020-09-17;3;1;4;18164;16593;49;34757
03;2020-09-17;3;4;7;13469;13557;59;27026
03;2020-09-17;0;2;2;8776;8670;69;17446
03;2020-09-17;1;0;1;3777;3591;79;7368
03;2020-09-17;1;0;1;1649;1072;89;2721
03;2020-09-17;0;0;0;485;184;90;669
03;2020-09-17;13;9;22;149547;141144;0;290691
04;2020-09-17;3;3;6;60314;61377;09;121691
04;2020-09-17;11;12;23;66065;68387;19;134452
04;2020-09-17;12;5;17;51059;47156;29;98215
04;2020-09-17;10;2;12;58788;45780;39;104568
04;2020-09-17;7;3;10;61408;52207;49;113615
04;2020-09-17;8;11;19;64838;60759;59;125597
04;2020-09-17;5;5;10;47008;42843;69;89851
04;2020-09-17;5;4;9;25509;21184;79;46693
04;2020-09-17;0;1;1;13168;7647;89;20815
04;2020-09-17;0;0;0;3209;1253;90;4462
04;2020-09-17;61;46;107;451366;408593;0;859959
05;2020-09-17;0;0;0;362.366008612902;341.338819562748;09;703.704828175651
05;2020-09-17;0;0;0;353.376145114279;370.349735405642;19;723.725880519921
05;2020-09-17;0;0;0;218.593559489256;256.539602589476;29;475.133162078732
05;2020-09-17;0;0;0;404.225408693299;360.321910454353;39;764.547319147651
05;2020-09-17;0;0;0;520.067953604221;497.108383964256;49;1017.17633756848
05;2020-09-17;0;0;0;468.146063921917;510.087601910415;59;978.233665832332
05;2020-09-17;0;0;0;340.368470050554;334.366842191253;69;674.735312241807
05;2020-09-17;0;0;0;212.598666888387;192.597753227106;79;405.196420115493
05;2020-09-17;0;0;0;148.727797095705;61.8681715431829;89;210.595968638888
05;2020-09-17;0;0;0;32.9601271090696;10.9909785719784;90;43.9511056810479
05;2020-09-17;0;0;0;3061.43020057959;2935.56979942041;0;5997
06;2020-09-17;0;0;0;42583;42380;09;84963
06;2020-09-17;4;0;4;33369;31925;19;65294
06;2020-09-17;2;1;3;21571;15080;29;36651
06;2020-09-17;2;1;3;21550;16147;39;37697
06;2020-09-17;1;4;5;14193;13939;49;28132
06;2020-09-17;0;1;1;7171;7597;59;14768
06;2020-09-17;0;0;0;3629;4117;69;7746
06;2020-09-17;0;0;0;1577;1457;79;3034
06;2020-09-17;0;0;0;531;474;89;1005
06;2020-09-17;0;0;0;88;93;90;181
06;2020-09-17;9;7;16;146262;133209;0;279471
07;2020-09-17;0;0;0;485;549;09;1034
07;2020-09-17;0;0;0;403;432;19;835
07;2020-09-17;0;0;0;764;841;29;1605
07;2020-09-17;0;0;0;824;928;39;1752
07;2020-09-17;0;0;0;788;1020;49;1808
07;2020-09-17;0;0;0;678;870;59;1548
07;2020-09-17;0;0;0;360;382;69;742
07;2020-09-17;0;0;0;231;190;79;421
07;2020-09-17;0;0;0;114;67;89;181
07;2020-09-17;0;0;0;24;11;90;35
07;2020-09-17;0;0;0;4671;5290;0;9961
08;2020-09-17;0;0;0;2715.22592983026;2997.75551488675;09;5712.98144471701
08;2020-09-17;0;1;1;2778.51901080978;3160.9156459093;19;5939.43465671908
08;2020-09-17;0;0;0;2080.8882988764;1718.16634315323;29;3799.05464202964
08;2020-09-17;1;1;2;2701.8582062647;1896.52641413317;39;4598.38462039786
08;2020-09-17;1;2;3;3151.45861023308;2460.52498233809;49;5611.98359257117
08;2020-09-17;1;0;1;2620.29868333099;2422.23566154656;59;5042.53434487755
08;2020-09-17;1;2;3;1621.44173420671;1438.58325779464;69;3060.02499200135
08;2020-09-17;0;0;0;626.575909335673;526.358467843651;79;1152.93437717932
08;2020-09-17;0;0;0;205.018522985054;140.993639349697;89;346.012162334751
08;2020-09-17;0;0;0;50.0325684687745;20.62259870351;90;70.6551671722846
08;2020-09-17;4;6;10;18551.3174743414;16782.6825256586;0;35334
11;2020-09-17;60;65;132;783071;811785;09;1594856
11;2020-09-17;231;220;460;761456;784653;19;1546109
11;2020-09-17;577;513;1094;850145;801772;29;1651917
11;2020-09-17;365;369;735;914360;843488;39;1757848
11;2020-09-17;296;245;542;845609;826202;49;1671811
11;2020-09-17;213;181;395;793566;745070;59;1538636
11;2020-09-17;126;123;249;628649;549192;69;1177841
11;2020-09-17;44;59;103;434606;358356;79;792962
11;2020-09-17;24;24;48;261425;162933;89;424358
11;2020-09-17;9;9;18;89253;32619;90;121872
11;2020-09-17;1946;1810;3783;6362140;5916070;0;12278210
24;2020-09-17;5;3;8;139720;144686;09;284406
24;2020-09-17;21;21;42;152979;161185;19;314164
24;2020-09-17;37;34;71;122237;126536;29;248773
24;2020-09-17;32;18;50;150359;142009;39;292368
24;2020-09-17;35;21;56;161829;158758;49;320587
24;2020-09-17;24;20;44;172552;168011;59;340563
24;2020-09-17;5;6;11;172509;158177;69;330686
24;2020-09-17;7;10;17;129428;110593;79;240021
24;2020-09-17;4;4;8;87342;56882;89;144224
24;2020-09-17;1;0;1;31210;12071;90;43281
24;2020-09-17;171;137;308;1320165;1238908;0;2559073
27;2020-09-17;4;10;14;143373;149679;09;293052
27;2020-09-17;25;26;51;160962;173003;19;333965
27;2020-09-17;31;38;69;133746;142254;29;276000
27;2020-09-17;26;32;58;160004;155407;39;315411
27;2020-09-17;19;18;37;172333;169564;49;341897
27;2020-09-17;24;20;44;189979;183788;59;373767
27;2020-09-17;17;7;24;192591;178206;69;370797
27;2020-09-17;10;5;15;146876;127546;79;274422
27;2020-09-17;15;5;20;96896;61575;89;158471
27;2020-09-17;5;1;6;33148;12109;90;45257
27;2020-09-17;176;162;338;1429908;1353131;0;2783039
28;2020-09-17;10;12;23;180735;186856;09;367591
28;2020-09-17;38;39;78;200125;213621;19;413746
28;2020-09-17;45;51;96;168922;173007;29;341929
28;2020-09-17;35;28;63;196628;188487;39;385115
28;2020-09-17;38;38;76;205396;201699;49;407095
28;2020-09-17;27;19;46;222002;213866;59;435868
28;2020-09-17;21;9;30;224688;203758;69;428446
28;2020-09-17;8;6;14;163192;135543;79;298735
28;2020-09-17;7;5;12;109691;65377;89;175068
28;2020-09-17;4;2;6;37222;12685;90;49907
28;2020-09-17;233;210;445;1708601;1594899;0;3303500
32;2020-09-17;23;43;66;358062;373689;09;731751
32;2020-09-17;146;148;294;387045;406742;19;793787
32;2020-09-17;218;230;449;342304;348587;29;690891
32;2020-09-17;118;109;228;382485;369972;39;752457
32;2020-09-17;123;97;221;382510;376716;49;759226
32;2020-09-17;82;66;148;386937;376527;59;763464
32;2020-09-17;52;51;103;371211;330938;69;702149
32;2020-09-17;34;28;62;250542;201459;79;452001
32;2020-09-17;17;11;28;163399;89786;89;253185
32;2020-09-17;5;4;9;48384;15367;90;63751
32;2020-09-17;818;787;1608;3072879;2889783;0;5962662
44;2020-09-17;6;5;11;291525;306839;09;598364
44;2020-09-17;33;36;69;320255;339504;19;659759
44;2020-09-17;54;64;118;302020;314428;29;616448
44;2020-09-17;23;29;52;342222;333292;39;675514
44;2020-09-17;22;19;41;349727;344491;49;694218
44;2020-09-17;26;18;44;381371;373239;59;754610
44;2020-09-17;13;13;26;367165;335850;69;703015
44;2020-09-17;5;11;16;250387;215436;79;465823
44;2020-09-17;10;7;17;170825;105192;89;276017
44;2020-09-17;10;0;10;51248;16731;90;67979
44;2020-09-17;203;202;406;2826745;2685002;0;5511747
52;2020-09-17;3;6;9;213594;223900;09;437494
52;2020-09-17;48;34;83;240818;255197;19;496015
52;2020-09-17;50;53;103;197010;200630;29;397640
52;2020-09-17;24;29;53;231204;224885;39;456089
52;2020-09-17;28;27;55;243874;243418;49;487292
52;2020-09-17;30;18;48;244100;239116;59;483216
52;2020-09-17;10;15;25;241796;221345;69;463141
52;2020-09-17;3;7;10;177805;149903;79;327708
52;2020-09-17;7;4;11;119561;75822;89;195383
52;2020-09-17;0;3;3;42559;15260;90;57819
52;2020-09-17;203;196;400;1952321;1849476;0;3801797
53;2020-09-17;6;8;15;173813;182358;09;356171
53;2020-09-17;42;28;70;202720;214740;19;417460
53;2020-09-17;79;88;168;163116;173196;29;336312
53;2020-09-17;25;24;49;190526;187674;39;378200
53;2020-09-17;21;14;35;212098;212015;49;424113
53;2020-09-17;21;28;49;223699;219176;59;442875
53;2020-09-17;7;9;16;227435;209274;69;436709
53;2020-09-17;4;7;11;169992;140910;79;310902
53;2020-09-17;6;2;8;118117;69883;89;188000
53;2020-09-17;2;2;4;37370;12267;90;49637
53;2020-09-17;213;210;425;1718886;1621493;0;3340379
75;2020-09-17;16;15;31;293104;305291;09;598395
75;2020-09-17;59;68;128;337141;357785;19;694926
75;2020-09-17;101;102;203;295024;300618;29;595642
75;2020-09-17;77;49;127;347871;331233;39;679104
75;2020-09-17;65;62;127;384742;372771;49;757513
75;2020-09-17;49;38;87;413361;390880;59;804241
75;2020-09-17;26;31;57;425623;384060;69;809683
75;2020-09-17;22;28;50;325086;276298;79;601384
75;2020-09-17;26;8;34;213986;139308;89;353294
75;2020-09-17;22;4;26;77600;28200;90;105800
75;2020-09-17;463;406;871;3113538;2886444;0;5999982
76;2020-09-17;25;23;52;305956;318589;09;624545
76;2020-09-17;141;144;287;338942;356969;19;695911
76;2020-09-17;227;257;485;316210;319570;29;635780
76;2020-09-17;101;95;196;356758;337587;39;694345
76;2020-09-17;76;80;156;376541;363812;49;740353
76;2020-09-17;65;58;123;402608;383750;59;786358
76;2020-09-17;37;36;73;394889;358997;69;753886
76;2020-09-17;20;17;37;308664;263806;79;572470
76;2020-09-17;33;8;41;195838;129272;89;325110
76;2020-09-17;26;9;35;69372;26728;90;96100
76;2020-09-17;752;727;1486;3065778;2859080;0;5924858
84;2020-09-17;29;21;51;459549;481088;09;940637
84;2020-09-17;137;150;288;487711;511905;19;999616
84;2020-09-17;213;245;459;443824;451094;29;894918
84;2020-09-17;133;93;226;512522;493262;39;1005784
84;2020-09-17;128;107;235;520248;515106;49;1035354
84;2020-09-17;103;92;195;529611;514848;59;1044459
84;2020-09-17;60;48;108;486720;439940;69;926660
84;2020-09-17;39;41;80;372151;315211;79;687362
84;2020-09-17;29;21;50;237198;150524;89;387722
84;2020-09-17;28;4;32;81185;28680;90;109865
84;2020-09-17;899;822;1724;4130719;3901658;0;8032377
93;2020-09-17;26;29;55;268834;283093;09;551927
93;2020-09-17;78;87;165;280751;296087;19;576838
93;2020-09-17;139;105;244;254404;255552;29;509956
93;2020-09-17;108;89;197;310704;288398;39;599102
93;2020-09-17;104;65;169;325559;305827;49;631386
93;2020-09-17;100;69;169;353104;325389;59;678493
93;2020-09-17;64;61;125;336327;296459;69;632786
93;2020-09-17;35;29;64;279820;229699;79;509519
93;2020-09-17;20;16;36;171274;113716;89;284990
93;2020-09-17;17;5;22;58896;21758;90;80654
93;2020-09-17;693;555;1248;2639673;2415978;0;5055651
94;2020-09-17;0;0;0;16311;17433;09;33744
94;2020-09-17;4;0;4;16679;18132;19;34811
94;2020-09-17;4;5;9;16782;16579;29;33361
94;2020-09-17;3;4;7;23044;20580;39;43624
94;2020-09-17;2;1;3;23065;22140;49;45205
94;2020-09-17;1;4;5;24549;23421;59;47970
94;2020-09-17;1;2;3;23212;21883;69;45095
94;2020-09-17;3;5;8;19544;17141;79;36685
94;2020-09-17;1;0;1;11227;8178;89;19405
94;2020-09-17;1;0;1;3332;1447;90;4779
94;2020-09-17;20;21;41;177745;166934;0;344679
01;2020-09-18;1;1;2;19979;20155;09;40134
01;2020-09-18;5;7;12;24994;25489;19;50483
01;2020-09-18;13;4;17;17868;16690;29;34558
01;2020-09-18;10;6;16;22328;14821;39;37149
01;2020-09-18;9;6;15;28652;20276;49;48928
01;2020-09-18;11;12;23;33264;27260;59;60524
01;2020-09-18;9;8;17;27135;23978;69;51113
01;2020-09-18;3;1;4;18401;14661;79;33062
01;2020-09-18;3;4;7;9633;6375;89;16008
01;2020-09-18;0;0;0;3410;1510;90;4920
01;2020-09-18;64;49;113;205664;171215;0;376879
02;2020-09-18;0;1;1;16881;17110;09;33991
02;2020-09-18;4;4;8;21410;21604;19;43014
02;2020-09-18;3;1;4;16017;15479;29;31496
02;2020-09-18;4;1;5;19825;14455;39;34280
02;2020-09-18;4;2;6;24719;18248;49;42967
02;2020-09-18;6;2;8;34361;28310;59;62671
02;2020-09-18;1;2;3;28061;24495;69;52556
02;2020-09-18;1;2;3;18231;15278;79;33509
02;2020-09-18;0;1;1;11090;7677;89;18767
02;2020-09-18;0;0;0;3992;1506;90;5498
02;2020-09-18;23;16;39;194587;164162;0;358749
03;2020-09-18;3;3;6;31123;30920;09;62043
03;2020-09-18;8;5;13;29370;29268;19;58638
03;2020-09-18;3;2;5;21458;18963;29;40421
03;2020-09-18;1;2;3;21276;18326;39;39602
03;2020-09-18;0;3;3;18164;16593;49;34757
03;2020-09-18;1;3;4;13469;13557;59;27026
03;2020-09-18;0;3;3;8776;8670;69;17446
03;2020-09-18;0;0;0;3777;3591;79;7368
03;2020-09-18;0;0;0;1649;1072;89;2721
03;2020-09-18;0;0;0;485;184;90;669
03;2020-09-18;16;21;37;149547;141144;0;290691
04;2020-09-18;6;5;11;60314;61377;09;121691
04;2020-09-18;6;7;13;66065;68387;19;134452
04;2020-09-18;10;4;14;51059;47156;29;98215
04;2020-09-18;7;2;9;58788;45780;39;104568
04;2020-09-18;4;3;7;61408;52207;49;113615
04;2020-09-18;11;5;16;64838;60759;59;125597
04;2020-09-18;2;6;8;47008;42843;69;89851
04;2020-09-18;3;3;6;25509;21184;79;46693
04;2020-09-18;1;1;2;13168;7647;89;20815
04;2020-09-18;0;0;0;3209;1253;90;4462
04;2020-09-18;50;36;86;451366;408593;0;859959
05;2020-09-18;0;0;0;362.366008612902;341.338819562748;09;703.704828175651
05;2020-09-18;0;0;0;353.376145114279;370.349735405642;19;723.725880519921
05;2020-09-18;0;0;0;218.593559489256;256.539602589476;29;475.133162078732
05;2020-09-18;0;0;0;404.225408693299;360.321910454353;39;764.547319147651
05;2020-09-18;0;0;0;520.067953604221;497.108383964256;49;1017.17633756848
05;2020-09-18;0;0;0;468.146063921917;510.087601910415;59;978.233665832332
05;2020-09-18;0;0;0;340.368470050554;334.366842191253;69;674.735312241807
05;2020-09-18;0;0;0;212.598666888387;192.597753227106;79;405.196420115493
05;2020-09-18;0;0;0;148.727797095705;61.8681715431829;89;210.595968638888
05;2020-09-18;0;0;0;32.9601271090696;10.9909785719784;90;43.9511056810479
05;2020-09-18;0;0;0;3061.43020057959;2935.56979942041;0;5997
06;2020-09-18;0;1;1;42583;42380;09;84963
06;2020-09-18;5;3;9;33369;31925;19;65294
06;2020-09-18;1;1;2;21571;15080;29;36651
06;2020-09-18;2;4;6;21550;16147;39;37697
06;2020-09-18;7;3;10;14193;13939;49;28132
06;2020-09-18;1;0;1;7171;7597;59;14768
06;2020-09-18;0;0;0;3629;4117;69;7746
06;2020-09-18;0;0;0;1577;1457;79;3034
06;2020-09-18;0;0;0;531;474;89;1005
06;2020-09-18;0;0;0;88;93;90;181
06;2020-09-18;16;12;29;146262;133209;0;279471
07;2020-09-18;0;0;0;485;549;09;1034
07;2020-09-18;0;0;0;403;432;19;835
07;2020-09-18;0;0;0;764;841;29;1605
07;2020-09-18;0;0;0;824;928;39;1752
07;2020-09-18;1;0;1;788;1020;49;1808
07;2020-09-18;0;1;1;678;870;59;1548
07;2020-09-18;0;0;0;360;382;69;742
07;2020-09-18;0;0;0;231;190;79;421
07;2020-09-18;0;0;0;114;67;89;181
07;2020-09-18;0;0;0;24;11;90;35
07;2020-09-18;1;1;2;4671;5290;0;9961
08;2020-09-18;0;0;0;2715.22592983026;2997.75551488675;09;5712.98144471701
08;2020-09-18;0;0;0;2778.51901080978;3160.9156459093;19;5939.43465671908
08;2020-09-18;1;2;3;2080.8882988764;1718.16634315323;29;3799.05464202964
08;2020-09-18;2;1;3;2701.8582062647;1896.52641413317;39;4598.38462039786
08;2020-09-18;0;0;0;3151.45861023308;2460.52498233809;49;5611.98359257117
08;2020-09-18;1;1;2;2620.29868333099;2422.23566154656;59;5042.53434487755
08;2020-09-18;0;0;0;1621.44173420671;1438.58325779464;69;3060.02499200135
08;2020-09-18;0;0;0;626.575909335673;526.358467843651;79;1152.93437717932
08;2020-09-18;0;0;0;205.018522985054;140.993639349697;89;346.012162334751
08;2020-09-18;0;0;0;50.0325684687745;20.62259870351;90;70.6551671722846
08;2020-09-18;4;4;8;18551.3174743414;16782.6825256586;0;35334
11;2020-09-18;44;44;92;783071;811785;09;1594856
11;2020-09-18;211;223;443;761456;784653;19;1546109
11;2020-09-18;510;503;1015;850145;801772;29;1651917
11;2020-09-18;368;334;703;914360;843488;39;1757848
11;2020-09-18;250;234;485;845609;826202;49;1671811
11;2020-09-18;216;194;411;793566;745070;59;1538636
11;2020-09-18;117;138;255;628649;549192;69;1177841
11;2020-09-18;43;46;89;434606;358356;79;792962
11;2020-09-18;17;21;38;261425;162933;89;424358
11;2020-09-18;16;9;25;89253;32619;90;121872
11;2020-09-18;1793;1747;3561;6362140;5916070;0;12278210
24;2020-09-18;7;6;14;139720;144686;09;284406
24;2020-09-18;21;13;35;152979;161185;19;314164
24;2020-09-18;33;17;50;122237;126536;29;248773
24;2020-09-18;29;17;48;150359;142009;39;292368
24;2020-09-18;17;20;37;161829;158758;49;320587
24;2020-09-18;25;16;41;172552;168011;59;340563
24;2020-09-18;13;5;18;172509;158177;69;330686
24;2020-09-18;9;3;12;129428;110593;79;240021
24;2020-09-18;12;13;25;87342;56882;89;144224
24;2020-09-18;10;5;15;31210;12071;90;43281
24;2020-09-18;176;115;295;1320165;1238908;0;2559073
27;2020-09-18;6;8;14;143373;149679;09;293052
27;2020-09-18;29;30;59;160962;173003;19;333965
27;2020-09-18;32;34;66;133746;142254;29;276000
27;2020-09-18;33;29;62;160004;155407;39;315411
27;2020-09-18;27;13;40;172333;169564;49;341897
27;2020-09-18;13;14;27;189979;183788;59;373767
27;2020-09-18;10;11;21;192591;178206;69;370797
27;2020-09-18;10;7;17;146876;127546;79;274422
27;2020-09-18;10;3;13;96896;61575;89;158471
27;2020-09-18;1;3;4;33148;12109;90;45257
27;2020-09-18;171;152;323;1429908;1353131;0;2783039
28;2020-09-18;17;14;32;180735;186856;09;367591
28;2020-09-18;45;37;83;200125;213621;19;413746
28;2020-09-18;60;64;124;168922;173007;29;341929
28;2020-09-18;52;32;84;196628;188487;39;385115
28;2020-09-18;36;31;67;205396;201699;49;407095
28;2020-09-18;33;26;59;222002;213866;59;435868
28;2020-09-18;28;12;41;224688;203758;69;428446
28;2020-09-18;12;11;23;163192;135543;79;298735
28;2020-09-18;7;11;18;109691;65377;89;175068
28;2020-09-18;8;3;11;37222;12685;90;49907
28;2020-09-18;298;241;542;1708601;1594899;0;3303500
32;2020-09-18;24;35;59;358062;373689;09;731751
32;2020-09-18;161;155;319;387045;406742;19;793787
32;2020-09-18;250;232;484;342304;348587;29;690891
32;2020-09-18;113;92;206;382485;369972;39;752457
32;2020-09-18;96;87;183;382510;376716;49;759226
32;2020-09-18;75;78;153;386937;376527;59;763464
32;2020-09-18;45;40;86;371211;330938;69;702149
32;2020-09-18;34;25;59;250542;201459;79;452001
32;2020-09-18;17;11;29;163399;89786;89;253185
32;2020-09-18;7;1;8;48384;15367;90;63751
32;2020-09-18;822;756;1586;3072879;2889783;0;5962662
44;2020-09-18;11;6;17;291525;306839;09;598364
44;2020-09-18;31;31;63;320255;339504;19;659759
44;2020-09-18;67;63;130;302020;314428;29;616448
44;2020-09-18;43;31;74;342222;333292;39;675514
44;2020-09-18;18;30;48;349727;344491;49;694218
44;2020-09-18;26;28;54;381371;373239;59;754610
44;2020-09-18;16;9;25;367165;335850;69;703015
44;2020-09-18;11;9;20;250387;215436;79;465823
44;2020-09-18;6;4;10;170825;105192;89;276017
44;2020-09-18;5;1;6;51248;16731;90;67979
44;2020-09-18;234;212;447;2826745;2685002;0;5511747
52;2020-09-18;10;2;12;213594;223900;09;437494
52;2020-09-18;56;37;94;240818;255197;19;496015
52;2020-09-18;46;55;101;197010;200630;29;397640
52;2020-09-18;27;29;56;231204;224885;39;456089
52;2020-09-18;32;25;57;243874;243418;49;487292
52;2020-09-18;18;19;37;244100;239116;59;483216
52;2020-09-18;11;6;17;241796;221345;69;463141
52;2020-09-18;11;11;22;177805;149903;79;327708
52;2020-09-18;3;5;8;119561;75822;89;195383
52;2020-09-18;4;3;7;42559;15260;90;57819
52;2020-09-18;218;192;411;1952321;1849476;0;3801797
53;2020-09-18;14;11;25;173813;182358;09;356171
53;2020-09-18;40;37;77;202720;214740;19;417460
53;2020-09-18;61;61;123;163116;173196;29;336312
53;2020-09-18;25;27;52;190526;187674;39;378200
53;2020-09-18;26;20;46;212098;212015;49;424113
53;2020-09-18;25;20;45;223699;219176;59;442875
53;2020-09-18;15;16;31;227435;209274;69;436709
53;2020-09-18;8;4;12;169992;140910;79;310902
53;2020-09-18;10;3;13;118117;69883;89;188000
53;2020-09-18;7;0;7;37370;12267;90;49637
53;2020-09-18;231;199;431;1718886;1621493;0;3340379
75;2020-09-18;16;26;44;293104;305291;09;598395
75;2020-09-18;64;67;133;337141;357785;19;694926
75;2020-09-18;79;110;189;295024;300618;29;595642
75;2020-09-18;78;55;133;347871;331233;39;679104
75;2020-09-18;71;53;124;384742;372771;49;757513
75;2020-09-18;39;40;79;413361;390880;59;804241
75;2020-09-18;27;33;60;425623;384060;69;809683
75;2020-09-18;18;16;34;325086;276298;79;601384
75;2020-09-18;17;7;24;213986;139308;89;353294
75;2020-09-18;12;8;20;77600;28200;90;105800
75;2020-09-18;421;416;841;3113538;2886444;0;5999982
76;2020-09-18;19;21;40;305956;318589;09;624545
76;2020-09-18;133;143;278;338942;356969;19;695911
76;2020-09-18;194;213;408;316210;319570;29;635780
76;2020-09-18;95;82;177;356758;337587;39;694345
76;2020-09-18;83;78;161;376541;363812;49;740353
76;2020-09-18;89;62;151;402608;383750;59;786358
76;2020-09-18;42;43;85;394889;358997;69;753886
76;2020-09-18;33;29;62;308664;263806;79;572470
76;2020-09-18;22;6;28;195838;129272;89;325110
76;2020-09-18;13;1;14;69372;26728;90;96100
76;2020-09-18;724;679;1406;3065778;2859080;0;5924858
84;2020-09-18;24;37;63;459549;481088;09;940637
84;2020-09-18;116;115;234;487711;511905;19;999616
84;2020-09-18;214;220;434;443824;451094;29;894918
84;2020-09-18;136;105;241;512522;493262;39;1005784
84;2020-09-18;116;91;208;520248;515106;49;1035354
84;2020-09-18;99;87;186;529611;514848;59;1044459
84;2020-09-18;55;56;111;486720;439940;69;926660
84;2020-09-18;24;32;56;372151;315211;79;687362
84;2020-09-18;27;30;57;237198;150524;89;387722
84;2020-09-18;11;6;17;81185;28680;90;109865
84;2020-09-18;822;779;1607;4130719;3901658;0;8032377
93;2020-09-18;29;22;51;268834;283093;09;551927
93;2020-09-18;87;70;158;280751;296087;19;576838
93;2020-09-18;147;121;268;254404;255552;29;509956
93;2020-09-18;107;109;218;310704;288398;39;599102
93;2020-09-18;95;76;171;325559;305827;49;631386
93;2020-09-18;89;86;175;353104;325389;59;678493
93;2020-09-18;58;47;105;336327;296459;69;632786
93;2020-09-18;29;43;72;279820;229699;79;509519
93;2020-09-18;23;18;41;171274;113716;89;284990
93;2020-09-18;10;4;14;58896;21758;90;80654
93;2020-09-18;675;596;1275;2639673;2415978;0;5055651
94;2020-09-18;0;1;1;16311;17433;09;33744
94;2020-09-18;0;2;2;16679;18132;19;34811
94;2020-09-18;5;3;8;16782;16579;29;33361
94;2020-09-18;6;1;7;23044;20580;39;43624
94;2020-09-18;1;1;2;23065;22140;49;45205
94;2020-09-18;3;1;4;24549;23421;59;47970
94;2020-09-18;3;4;7;23212;21883;69;45095
94;2020-09-18;1;0;1;19544;17141;79;36685
94;2020-09-18;0;0;0;11227;8178;89;19405
94;2020-09-18;1;0;1;3332;1447;90;4779
94;2020-09-18;20;13;33;177745;166934;0;344679
01;2020-09-19;0;0;0;19979;20155;09;40134
01;2020-09-19;1;0;1;24994;25489;19;50483
01;2020-09-19;1;1;2;17868;16690;29;34558
01;2020-09-19;3;2;5;22328;14821;39;37149
01;2020-09-19;2;3;5;28652;20276;49;48928
01;2020-09-19;2;3;5;33264;27260;59;60524
01;2020-09-19;1;1;2;27135;23978;69;51113
01;2020-09-19;1;3;4;18401;14661;79;33062
01;2020-09-19;1;2;3;9633;6375;89;16008
01;2020-09-19;1;0;1;3410;1510;90;4920
01;2020-09-19;13;15;28;205664;171215;0;376879
02;2020-09-19;0;1;1;16881;17110;09;33991
02;2020-09-19;0;0;0;21410;21604;19;43014
02;2020-09-19;0;1;1;16017;15479;29;31496
02;2020-09-19;0;1;1;19825;14455;39;34280
02;2020-09-19;1;1;3;24719;18248;49;42967
02;2020-09-19;0;1;1;34361;28310;59;62671
02;2020-09-19;0;1;1;28061;24495;69;52556
02;2020-09-19;0;0;0;18231;15278;79;33509
02;2020-09-19;0;0;0;11090;7677;89;18767
02;2020-09-19;0;0;0;3992;1506;90;5498
02;2020-09-19;1;6;8;194587;164162;0;358749
03;2020-09-19;0;0;0;31123;30920;09;62043
03;2020-09-19;1;2;3;29370;29268;19;58638
03;2020-09-19;0;0;0;21458;18963;29;40421
03;2020-09-19;3;0;3;21276;18326;39;39602
03;2020-09-19;3;2;5;18164;16593;49;34757
03;2020-09-19;0;1;1;13469;13557;59;27026
03;2020-09-19;0;0;0;8776;8670;69;17446
03;2020-09-19;0;0;0;3777;3591;79;7368
03;2020-09-19;0;1;1;1649;1072;89;2721
03;2020-09-19;0;0;0;485;184;90;669
03;2020-09-19;7;6;13;149547;141144;0;290691
04;2020-09-19;0;2;2;60314;61377;09;121691
04;2020-09-19;5;3;8;66065;68387;19;134452
04;2020-09-19;3;3;6;51059;47156;29;98215
04;2020-09-19;2;0;2;58788;45780;39;104568
04;2020-09-19;8;4;12;61408;52207;49;113615
04;2020-09-19;5;1;6;64838;60759;59;125597
04;2020-09-19;2;0;2;47008;42843;69;89851
04;2020-09-19;2;2;4;25509;21184;79;46693
04;2020-09-19;0;0;0;13168;7647;89;20815
04;2020-09-19;0;0;0;3209;1253;90;4462
04;2020-09-19;27;15;42;451366;408593;0;859959
05;2020-09-19;0;0;0;362.366008612902;341.338819562748;09;703.704828175651
05;2020-09-19;0;0;0;353.376145114279;370.349735405642;19;723.725880519921
05;2020-09-19;0;0;0;218.593559489256;256.539602589476;29;475.133162078732
05;2020-09-19;0;0;0;404.225408693299;360.321910454353;39;764.547319147651
05;2020-09-19;0;0;0;520.067953604221;497.108383964256;49;1017.17633756848
05;2020-09-19;0;0;0;468.146063921917;510.087601910415;59;978.233665832332
05;2020-09-19;0;0;0;340.368470050554;334.366842191253;69;674.735312241807
05;2020-09-19;0;0;0;212.598666888387;192.597753227106;79;405.196420115493
05;2020-09-19;0;0;0;148.727797095705;61.8681715431829;89;210.595968638888
05;2020-09-19;0;0;0;32.9601271090696;10.9909785719784;90;43.9511056810479
05;2020-09-19;0;0;0;3061.43020057959;2935.56979942041;0;5997
06;2020-09-19;0;0;0;42583;42380;09;84963
06;2020-09-19;0;0;0;33369;31925;19;65294
06;2020-09-19;0;0;0;21571;15080;29;36651
06;2020-09-19;0;3;3;21550;16147;39;37697
06;2020-09-19;0;0;0;14193;13939;49;28132
06;2020-09-19;0;1;1;7171;7597;59;14768
06;2020-09-19;0;0;0;3629;4117;69;7746
06;2020-09-19;1;0;1;1577;1457;79;3034
06;2020-09-19;0;0;0;531;474;89;1005
06;2020-09-19;0;0;0;88;93;90;181
06;2020-09-19;1;4;5;146262;133209;0;279471
07;2020-09-19;0;0;0;485;549;09;1034
07;2020-09-19;0;0;0;403;432;19;835
07;2020-09-19;0;0;0;764;841;29;1605
07;2020-09-19;0;0;0;824;928;39;1752
07;2020-09-19;0;0;0;788;1020;49;1808
07;2020-09-19;0;0;0;678;870;59;1548
07;2020-09-19;0;0;0;360;382;69;742
07;2020-09-19;0;0;0;231;190;79;421
07;2020-09-19;0;0;0;114;67;89;181
07;2020-09-19;0;0;0;24;11;90;35
07;2020-09-19;0;0;0;4671;5290;0;9961
08;2020-09-19;0;1;1;2715.22592983026;2997.75551488675;09;5712.98144471701
08;2020-09-19;0;0;0;2778.51901080978;3160.9156459093;19;5939.43465671908
08;2020-09-19;0;0;0;2080.8882988764;1718.16634315323;29;3799.05464202964
08;2020-09-19;0;0;0;2701.8582062647;1896.52641413317;39;4598.38462039786
08;2020-09-19;0;0;0;3151.45861023308;2460.52498233809;49;5611.98359257117
08;2020-09-19;0;0;0;2620.29868333099;2422.23566154656;59;5042.53434487755
08;2020-09-19;1;0;1;1621.44173420671;1438.58325779464;69;3060.02499200135
08;2020-09-19;0;1;1;626.575909335673;526.358467843651;79;1152.93437717932
08;2020-09-19;0;0;0;205.018522985054;140.993639349697;89;346.012162334751
08;2020-09-19;0;0;0;50.0325684687745;20.62259870351;90;70.6551671722846
08;2020-09-19;1;2;3;18551.3174743414;16782.6825256586;0;35334
11;2020-09-19;16;16;33;783071;811785;09;1594856
11;2020-09-19;103;92;203;761456;784653;19;1546109
11;2020-09-19;229;196;425;850145;801772;29;1651917
11;2020-09-19;139;153;293;914360;843488;39;1757848
11;2020-09-19;120;96;216;845609;826202;49;1671811
11;2020-09-19;74;102;176;793566;745070;59;1538636
11;2020-09-19;44;52;96;628649;549192;69;1177841
11;2020-09-19;21;28;49;434606;358356;79;792962
11;2020-09-19;17;11;28;261425;162933;89;424358
11;2020-09-19;12;2;14;89253;32619;90;121872
11;2020-09-19;775;748;1533;6362140;5916070;0;12278210
24;2020-09-19;3;4;7;139720;144686;09;284406
24;2020-09-19;9;11;20;152979;161185;19;314164
24;2020-09-19;12;8;20;122237;126536;29;248773
24;2020-09-19;8;10;18;150359;142009;39;292368
24;2020-09-19;8;5;13;161829;158758;49;320587
24;2020-09-19;8;4;12;172552;168011;59;340563
24;2020-09-19;9;3;12;172509;158177;69;330686
24;2020-09-19;5;4;9;129428;110593;79;240021
24;2020-09-19;3;5;8;87342;56882;89;144224
24;2020-09-19;1;3;4;31210;12071;90;43281
24;2020-09-19;66;57;123;1320165;1238908;0;2559073
27;2020-09-19;1;2;3;143373;149679;09;293052
27;2020-09-19;10;15;25;160962;173003;19;333965
27;2020-09-19;17;12;29;133746;142254;29;276000
27;2020-09-19;14;7;21;160004;155407;39;315411
27;2020-09-19;11;5;16;172333;169564;49;341897
27;2020-09-19;9;8;17;189979;183788;59;373767
27;2020-09-19;5;6;11;192591;178206;69;370797
27;2020-09-19;6;5;11;146876;127546;79;274422
27;2020-09-19;4;4;8;96896;61575;89;158471
27;2020-09-19;0;0;0;33148;12109;90;45257
27;2020-09-19;77;64;141;1429908;1353131;0;2783039
28;2020-09-19;4;3;7;180735;186856;09;367591
28;2020-09-19;16;20;36;200125;213621;19;413746
28;2020-09-19;38;36;74;168922;173007;29;341929
28;2020-09-19;17;13;30;196628;188487;39;385115
28;2020-09-19;25;15;41;205396;201699;49;407095
28;2020-09-19;10;7;17;222002;213866;59;435868
28;2020-09-19;13;9;22;224688;203758;69;428446
28;2020-09-19;4;2;6;163192;135543;79;298735
28;2020-09-19;7;1;8;109691;65377;89;175068
28;2020-09-19;1;1;2;37222;12685;90;49907
28;2020-09-19;135;107;243;1708601;1594899;0;3303500
32;2020-09-19;3;13;16;358062;373689;09;731751
32;2020-09-19;54;51;105;387045;406742;19;793787
32;2020-09-19;65;65;130;342304;348587;29;690891
32;2020-09-19;37;33;72;382485;369972;39;752457
32;2020-09-19;32;45;77;382510;376716;49;759226
32;2020-09-19;28;31;59;386937;376527;59;763464
32;2020-09-19;24;24;50;371211;330938;69;702149
32;2020-09-19;13;6;19;250542;201459;79;452001
32;2020-09-19;8;5;13;163399;89786;89;253185
32;2020-09-19;4;0;4;48384;15367;90;63751
32;2020-09-19;268;273;545;3072879;2889783;0;5962662
44;2020-09-19;2;2;4;291525;306839;09;598364
44;2020-09-19;20;24;44;320255;339504;19;659759
44;2020-09-19;28;32;60;302020;314428;29;616448
44;2020-09-19;12;16;28;342222;333292;39;675514
44;2020-09-19;13;11;24;349727;344491;49;694218
44;2020-09-19;10;12;22;381371;373239;59;754610
44;2020-09-19;3;8;11;367165;335850;69;703015
44;2020-09-19;4;4;8;250387;215436;79;465823
44;2020-09-19;3;4;7;170825;105192;89;276017
44;2020-09-19;1;0;1;51248;16731;90;67979
44;2020-09-19;96;113;209;2826745;2685002;0;5511747
52;2020-09-19;3;3;6;213594;223900;09;437494
52;2020-09-19;12;12;24;240818;255197;19;496015
52;2020-09-19;6;16;22;197010;200630;29;397640
52;2020-09-19;9;9;18;231204;224885;39;456089
52;2020-09-19;16;14;30;243874;243418;49;487292
52;2020-09-19;16;15;31;244100;239116;59;483216
52;2020-09-19;9;9;18;241796;221345;69;463141
52;2020-09-19;2;2;4;177805;149903;79;327708
52;2020-09-19;4;0;4;119561;75822;89;195383
52;2020-09-19;0;0;0;42559;15260;90;57819
52;2020-09-19;77;80;157;1952321;1849476;0;3801797
53;2020-09-19;3;2;5;173813;182358;09;356171
53;2020-09-19;16;13;29;202720;214740;19;417460
53;2020-09-19;29;37;66;163116;173196;29;336312
53;2020-09-19;9;12;21;190526;187674;39;378200
53;2020-09-19;5;11;16;212098;212015;49;424113
53;2020-09-19;13;20;33;223699;219176;59;442875
53;2020-09-19;3;4;7;227435;209274;69;436709
53;2020-09-19;2;4;6;169992;140910;79;310902
53;2020-09-19;0;2;2;118117;69883;89;188000
53;2020-09-19;1;0;1;37370;12267;90;49637
53;2020-09-19;81;105;186;1718886;1621493;0;3340379
75;2020-09-19;6;6;12;293104;305291;09;598395
75;2020-09-19;35;39;74;337141;357785;19;694926
75;2020-09-19;51;45;96;295024;300618;29;595642
75;2020-09-19;22;23;45;347871;331233;39;679104
75;2020-09-19;22;26;48;384742;372771;49;757513
75;2020-09-19;20;23;43;413361;390880;59;804241
75;2020-09-19;19;10;29;425623;384060;69;809683
75;2020-09-19;9;5;14;325086;276298;79;601384
75;2020-09-19;4;4;8;213986;139308;89;353294
75;2020-09-19;2;1;3;77600;28200;90;105800
75;2020-09-19;190;182;372;3113538;2886444;0;5999982
76;2020-09-19;4;2;6;305956;318589;09;624545
76;2020-09-19;60;43;103;338942;356969;19;695911
76;2020-09-19;72;84;156;316210;319570;29;635780
76;2020-09-19;25;32;57;356758;337587;39;694345
76;2020-09-19;28;32;60;376541;363812;49;740353
76;2020-09-19;25;21;46;402608;383750;59;786358
76;2020-09-19;19;9;28;394889;358997;69;753886
76;2020-09-19;13;7;20;308664;263806;79;572470
76;2020-09-19;6;8;14;195838;129272;89;325110
76;2020-09-19;7;0;7;69372;26728;90;96100
76;2020-09-19;259;238;497;3065778;2859080;0;5924858
84;2020-09-19;4;14;18;459549;481088;09;940637
84;2020-09-19;41;45;87;487711;511905;19;999616
84;2020-09-19;65;64;129;443824;451094;29;894918
84;2020-09-19;40;42;82;512522;493262;39;1005784
84;2020-09-19;40;41;81;520248;515106;49;1035354
84;2020-09-19;39;42;81;529611;514848;59;1044459
84;2020-09-19;23;19;42;486720;439940;69;926660
84;2020-09-19;14;16;30;372151;315211;79;687362
84;2020-09-19;15;6;21;237198;150524;89;387722
84;2020-09-19;6;1;7;81185;28680;90;109865
84;2020-09-19;288;290;579;4130719;3901658;0;8032377
93;2020-09-19;5;3;8;268834;283093;09;551927
93;2020-09-19;35;30;65;280751;296087;19;576838
93;2020-09-19;38;32;71;254404;255552;29;509956
93;2020-09-19;26;22;48;310704;288398;39;599102
93;2020-09-19;39;22;61;325559;305827;49;631386
93;2020-09-19;36;25;61;353104;325389;59;678493
93;2020-09-19;14;22;36;336327;296459;69;632786
93;2020-09-19;8;13;21;279820;229699;79;509519
93;2020-09-19;12;7;19;171274;113716;89;284990
93;2020-09-19;8;4;12;58896;21758;90;80654
93;2020-09-19;221;180;402;2639673;2415978;0;5055651
94;2020-09-19;0;0;0;16311;17433;09;33744
94;2020-09-19;0;2;2;16679;18132;19;34811
94;2020-09-19;1;2;3;16782;16579;29;33361
94;2020-09-19;0;2;2;23044;20580;39;43624
94;2020-09-19;2;1;3;23065;22140;49;45205
94;2020-09-19;1;1;2;24549;23421;59;47970
94;2020-09-19;1;0;1;23212;21883;69;45095
94;2020-09-19;0;0;0;19544;17141;79;36685
94;2020-09-19;0;0;0;11227;8178;89;19405
94;2020-09-19;0;0;0;3332;1447;90;4779
94;2020-09-19;5;8;13;177745;166934;0;344679
01;2020-09-20;1;0;1;19979;20155;09;40134
01;2020-09-20;3;0;3;24994;25489;19;50483
01;2020-09-20;3;1;4;17868;16690;29;34558
01;2020-09-20;4;3;7;22328;14821;39;37149
01;2020-09-20;4;2;6;28652;20276;49;48928
01;2020-09-20;4;3;7;33264;27260;59;60524
01;2020-09-20;3;2;5;27135;23978;69;51113
01;2020-09-20;0;3;3;18401;14661;79;33062
01;2020-09-20;3;2;5;9633;6375;89;16008
01;2020-09-20;1;0;1;3410;1510;90;4920
01;2020-09-20;26;16;42;205664;171215;0;376879
02;2020-09-20;0;0;0;16881;17110;09;33991
02;2020-09-20;0;0;0;21410;21604;19;43014
02;2020-09-20;0;0;0;16017;15479;29;31496
02;2020-09-20;1;0;1;19825;14455;39;34280
02;2020-09-20;0;0;0;24719;18248;49;42967
02;2020-09-20;0;0;0;34361;28310;59;62671
02;2020-09-20;0;0;0;28061;24495;69;52556
02;2020-09-20;0;0;0;18231;15278;79;33509
02;2020-09-20;0;0;0;11090;7677;89;18767
02;2020-09-20;0;0;0;3992;1506;90;5498
02;2020-09-20;1;0;1;194587;164162;0;358749
03;2020-09-20;0;0;0;31123;30920;09;62043
03;2020-09-20;3;1;4;29370;29268;19;58638
03;2020-09-20;0;0;0;21458;18963;29;40421
03;2020-09-20;0;0;0;21276;18326;39;39602
03;2020-09-20;0;0;0;18164;16593;49;34757
03;2020-09-20;0;0;0;13469;13557;59;27026
03;2020-09-20;0;0;0;8776;8670;69;17446
03;2020-09-20;0;0;0;3777;3591;79;7368
03;2020-09-20;0;0;0;1649;1072;89;2721
03;2020-09-20;0;0;0;485;184;90;669
03;2020-09-20;3;1;4;149547;141144;0;290691
04;2020-09-20;0;0;0;60314;61377;09;121691
04;2020-09-20;0;0;0;66065;68387;19;134452
04;2020-09-20;0;1;1;51059;47156;29;98215
04;2020-09-20;1;0;1;58788;45780;39;104568
04;2020-09-20;0;0;0;61408;52207;49;113615
04;2020-09-20;0;3;3;64838;60759;59;125597
04;2020-09-20;0;1;1;47008;42843;69;89851
04;2020-09-20;1;0;1;25509;21184;79;46693
04;2020-09-20;0;0;0;13168;7647;89;20815
04;2020-09-20;0;0;0;3209;1253;90;4462
04;2020-09-20;2;5;7;451366;408593;0;859959
05;2020-09-20;0;0;0;362.366008612902;341.338819562748;09;703.704828175651
05;2020-09-20;0;0;0;353.376145114279;370.349735405642;19;723.725880519921
05;2020-09-20;0;0;0;218.593559489256;256.539602589476;29;475.133162078732
05;2020-09-20;0;0;0;404.225408693299;360.321910454353;39;764.547319147651
05;2020-09-20;0;0;0;520.067953604221;497.108383964256;49;1017.17633756848
05;2020-09-20;0;0;0;468.146063921917;510.087601910415;59;978.233665832332
05;2020-09-20;0;0;0;340.368470050554;334.366842191253;69;674.735312241807
05;2020-09-20;0;0;0;212.598666888387;192.597753227106;79;405.196420115493
05;2020-09-20;0;0;0;148.727797095705;61.8681715431829;89;210.595968638888
05;2020-09-20;0;0;0;32.9601271090696;10.9909785719784;90;43.9511056810479
05;2020-09-20;0;0;0;3061.43020057959;2935.56979942041;0;5997
06;2020-09-20;0;0;0;42583;42380;09;84963
06;2020-09-20;0;0;0;33369;31925;19;65294
06;2020-09-20;0;0;0;21571;15080;29;36651
06;2020-09-20;0;0;0;21550;16147;39;37697
06;2020-09-20;0;0;0;14193;13939;49;28132
06;2020-09-20;0;0;0;7171;7597;59;14768
06;2020-09-20;0;1;1;3629;4117;69;7746
06;2020-09-20;0;0;0;1577;1457;79;3034
06;2020-09-20;0;0;0;531;474;89;1005
06;2020-09-20;0;0;0;88;93;90;181
06;2020-09-20;0;1;1;146262;133209;0;279471
07;2020-09-20;0;0;0;485;549;09;1034
07;2020-09-20;0;0;0;403;432;19;835
07;2020-09-20;0;0;0;764;841;29;1605
07;2020-09-20;0;0;0;824;928;39;1752
07;2020-09-20;0;0;0;788;1020;49;1808
07;2020-09-20;0;0;0;678;870;59;1548
07;2020-09-20;0;0;0;360;382;69;742
07;2020-09-20;0;0;0;231;190;79;421
07;2020-09-20;0;0;0;114;67;89;181
07;2020-09-20;0;0;0;24;11;90;35
07;2020-09-20;0;0;0;4671;5290;0;9961
08;2020-09-20;0;0;0;2715.22592983026;2997.75551488675;09;5712.98144471701
08;2020-09-20;0;0;0;2778.51901080978;3160.9156459093;19;5939.43465671908
08;2020-09-20;0;0;0;2080.8882988764;1718.16634315323;29;3799.05464202964
08;2020-09-20;0;0;0;2701.8582062647;1896.52641413317;39;4598.38462039786
08;2020-09-20;0;0;0;3151.45861023308;2460.52498233809;49;5611.98359257117
08;2020-09-20;0;0;0;2620.29868333099;2422.23566154656;59;5042.53434487755
08;2020-09-20;0;0;0;1621.44173420671;1438.58325779464;69;3060.02499200135
08;2020-09-20;0;0;0;626.575909335673;526.358467843651;79;1152.93437717932
08;2020-09-20;0;0;0;205.018522985054;140.993639349697;89;346.012162334751
08;2020-09-20;0;0;0;50.0325684687745;20.62259870351;90;70.6551671722846
08;2020-09-20;0;0;0;18551.3174743414;16782.6825256586;0;35334
11;2020-09-20;3;4;7;783071;811785;09;1594856
11;2020-09-20;20;28;48;761456;784653;19;1546109
11;2020-09-20;93;54;147;850145;801772;29;1651917
11;2020-09-20;50;41;91;914360;843488;39;1757848
11;2020-09-20;41;27;68;845609;826202;49;1671811
11;2020-09-20;29;37;66;793566;745070;59;1538636
11;2020-09-20;14;24;38;628649;549192;69;1177841
11;2020-09-20;6;13;19;434606;358356;79;792962
11;2020-09-20;6;13;19;261425;162933;89;424358
11;2020-09-20;3;4;7;89253;32619;90;121872
11;2020-09-20;265;246;511;6362140;5916070;0;12278210
24;2020-09-20;0;0;0;139720;144686;09;284406
24;2020-09-20;2;1;3;152979;161185;19;314164
24;2020-09-20;3;4;7;122237;126536;29;248773
24;2020-09-20;1;1;2;150359;142009;39;292368
24;2020-09-20;0;2;2;161829;158758;49;320587
24;2020-09-20;1;1;2;172552;168011;59;340563
24;2020-09-20;1;0;1;172509;158177;69;330686
24;2020-09-20;0;0;0;129428;110593;79;240021
24;2020-09-20;1;0;1;87342;56882;89;144224
24;2020-09-20;1;0;1;31210;12071;90;43281
24;2020-09-20;10;9;19;1320165;1238908;0;2559073
27;2020-09-20;0;1;1;143373;149679;09;293052
27;2020-09-20;5;3;8;160962;173003;19;333965
27;2020-09-20;15;13;28;133746;142254;29;276000
27;2020-09-20;8;6;14;160004;155407;39;315411
27;2020-09-20;3;4;7;172333;169564;49;341897
27;2020-09-20;5;2;7;189979;183788;59;373767
27;2020-09-20;1;2;3;192591;178206;69;370797
27;2020-09-20;1;4;5;146876;127546;79;274422
27;2020-09-20;1;0;1;96896;61575;89;158471
27;2020-09-20;2;0;2;33148;12109;90;45257
27;2020-09-20;41;35;76;1429908;1353131;0;2783039
28;2020-09-20;0;3;3;180735;186856;09;367591
28;2020-09-20;10;9;19;200125;213621;19;413746
28;2020-09-20;15;14;29;168922;173007;29;341929
28;2020-09-20;14;10;24;196628;188487;39;385115
28;2020-09-20;8;6;14;205396;201699;49;407095
28;2020-09-20;9;8;17;222002;213866;59;435868
28;2020-09-20;4;5;9;224688;203758;69;428446
28;2020-09-20;2;5;7;163192;135543;79;298735
28;2020-09-20;1;1;2;109691;65377;89;175068
28;2020-09-20;0;0;0;37222;12685;90;49907
28;2020-09-20;63;61;124;1708601;1594899;0;3303500
32;2020-09-20;7;1;8;358062;373689;09;731751
32;2020-09-20;22;19;41;387045;406742;19;793787
32;2020-09-20;41;42;83;342304;348587;29;690891
32;2020-09-20;18;13;31;382485;369972;39;752457
32;2020-09-20;13;14;27;382510;376716;49;759226
32;2020-09-20;10;15;25;386937;376527;59;763464
32;2020-09-20;5;3;8;371211;330938;69;702149
32;2020-09-20;3;2;5;250542;201459;79;452001
32;2020-09-20;3;2;5;163399;89786;89;253185
32;2020-09-20;3;1;4;48384;15367;90;63751
32;2020-09-20;125;112;237;3072879;2889783;0;5962662
44;2020-09-20;0;1;1;291525;306839;09;598364
44;2020-09-20;3;2;5;320255;339504;19;659759
44;2020-09-20;4;7;11;302020;314428;29;616448
44;2020-09-20;3;1;4;342222;333292;39;675514
44;2020-09-20;1;0;1;349727;344491;49;694218
44;2020-09-20;2;1;3;381371;373239;59;754610
44;2020-09-20;2;2;4;367165;335850;69;703015
44;2020-09-20;1;1;2;250387;215436;79;465823
44;2020-09-20;1;2;3;170825;105192;89;276017
44;2020-09-20;0;0;0;51248;16731;90;67979
44;2020-09-20;17;17;34;2826745;2685002;0;5511747
52;2020-09-20;1;0;1;213594;223900;09;437494
52;2020-09-20;2;2;4;240818;255197;19;496015
52;2020-09-20;2;11;13;197010;200630;29;397640
52;2020-09-20;2;1;3;231204;224885;39;456089
52;2020-09-20;1;4;5;243874;243418;49;487292
52;2020-09-20;1;0;1;244100;239116;59;483216
52;2020-09-20;1;4;5;241796;221345;69;463141
52;2020-09-20;0;0;0;177805;149903;79;327708
52;2020-09-20;1;3;4;119561;75822;89;195383
52;2020-09-20;0;0;0;42559;15260;90;57819
52;2020-09-20;11;25;36;1952321;1849476;0;3801797
53;2020-09-20;1;0;1;173813;182358;09;356171
53;2020-09-20;9;10;19;202720;214740;19;417460
53;2020-09-20;13;12;25;163116;173196;29;336312
53;2020-09-20;4;4;8;190526;187674;39;378200
53;2020-09-20;3;2;5;212098;212015;49;424113
53;2020-09-20;2;2;4;223699;219176;59;442875
53;2020-09-20;2;0;2;227435;209274;69;436709
53;2020-09-20;1;2;3;169992;140910;79;310902
53;2020-09-20;3;3;6;118117;69883;89;188000
53;2020-09-20;3;0;3;37370;12267;90;49637
53;2020-09-20;41;35;76;1718886;1621493;0;3340379
75;2020-09-20;2;2;4;293104;305291;09;598395
75;2020-09-20;7;5;12;337141;357785;19;694926
75;2020-09-20;12;26;38;295024;300618;29;595642
75;2020-09-20;8;8;16;347871;331233;39;679104
75;2020-09-20;4;6;10;384742;372771;49;757513
75;2020-09-20;2;3;5;413361;390880;59;804241
75;2020-09-20;1;2;3;425623;384060;69;809683
75;2020-09-20;3;3;6;325086;276298;79;601384
75;2020-09-20;5;2;7;213986;139308;89;353294
75;2020-09-20;1;1;2;77600;28200;90;105800
75;2020-09-20;45;58;103;3113538;2886444;0;5999982
76;2020-09-20;1;3;4;305956;318589;09;624545
76;2020-09-20;14;17;31;338942;356969;19;695911
76;2020-09-20;38;42;80;316210;319570;29;635780
76;2020-09-20;13;13;26;356758;337587;39;694345
76;2020-09-20;7;11;18;376541;363812;49;740353
76;2020-09-20;6;10;16;402608;383750;59;786358
76;2020-09-20;3;12;15;394889;358997;69;753886
76;2020-09-20;2;6;8;308664;263806;79;572470
76;2020-09-20;1;2;3;195838;129272;89;325110
76;2020-09-20;1;1;2;69372;26728;90;96100
76;2020-09-20;86;117;203;3065778;2859080;0;5924858
84;2020-09-20;4;2;6;459549;481088;09;940637
84;2020-09-20;4;12;16;487711;511905;19;999616
84;2020-09-20;22;18;40;443824;451094;29;894918
84;2020-09-20;17;5;22;512522;493262;39;1005784
84;2020-09-20;15;14;29;520248;515106;49;1035354
84;2020-09-20;8;13;21;529611;514848;59;1044459
84;2020-09-20;8;8;16;486720;439940;69;926660
84;2020-09-20;3;7;10;372151;315211;79;687362
84;2020-09-20;0;6;6;237198;150524;89;387722
84;2020-09-20;4;0;4;81185;28680;90;109865
84;2020-09-20;85;85;170;4130719;3901658;0;8032377
93;2020-09-20;5;4;9;268834;283093;09;551927
93;2020-09-20;2;3;5;280751;296087;19;576838
93;2020-09-20;7;5;12;254404;255552;29;509956
93;2020-09-20;8;5;13;310704;288398;39;599102
93;2020-09-20;11;5;16;325559;305827;49;631386
93;2020-09-20;10;6;16;353104;325389;59;678493
93;2020-09-20;6;4;10;336327;296459;69;632786
93;2020-09-20;7;6;13;279820;229699;79;509519
93;2020-09-20;1;5;6;171274;113716;89;284990
93;2020-09-20;1;3;4;58896;21758;90;80654
93;2020-09-20;58;46;104;2639673;2415978;0;5055651
94;2020-09-20;0;1;1;16311;17433;09;33744
94;2020-09-20;0;0;0;16679;18132;19;34811
94;2020-09-20;0;0;0;16782;16579;29;33361
94;2020-09-20;0;0;0;23044;20580;39;43624
94;2020-09-20;1;1;2;23065;22140;49;45205
94;2020-09-20;0;0;0;24549;23421;59;47970
94;2020-09-20;0;0;0;23212;21883;69;45095
94;2020-09-20;0;0;0;19544;17141;79;36685
94;2020-09-20;0;1;1;11227;8178;89;19405
94;2020-09-20;0;0;0;3332;1447;90;4779
94;2020-09-20;1;3;4;177745;166934;0;344679
01;2020-09-21;1;7;8;19979;20155;09;40134
01;2020-09-21;26;13;40;24994;25489;19;50483
01;2020-09-21;14;13;27;17868;16690;29;34558
01;2020-09-21;26;9;35;22328;14821;39;37149
01;2020-09-21;35;25;60;28652;20276;49;48928
01;2020-09-21;39;23;62;33264;27260;59;60524
01;2020-09-21;22;16;38;27135;23978;69;51113
01;2020-09-21;11;10;21;18401;14661;79;33062
01;2020-09-21;2;4;6;9633;6375;89;16008
01;2020-09-21;1;0;1;3410;1510;90;4920
01;2020-09-21;177;121;299;205664;171215;0;376879
02;2020-09-21;1;0;1;16881;17110;09;33991
02;2020-09-21;3;3;6;21410;21604;19;43014
02;2020-09-21;2;3;5;16017;15479;29;31496
02;2020-09-21;5;2;7;19825;14455;39;34280
02;2020-09-21;4;1;5;24719;18248;49;42967
02;2020-09-21;6;6;12;34361;28310;59;62671
02;2020-09-21;0;2;2;28061;24495;69;52556
02;2020-09-21;0;0;1;18231;15278;79;33509
02;2020-09-21;2;0;2;11090;7677;89;18767
02;2020-09-21;0;0;0;3992;1506;90;5498
02;2020-09-21;23;17;41;194587;164162;0;358749
03;2020-09-21;1;3;4;31123;30920;09;62043
03;2020-09-21;3;2;5;29370;29268;19;58638
03;2020-09-21;2;2;4;21458;18963;29;40421
03;2020-09-21;1;2;3;21276;18326;39;39602
03;2020-09-21;1;4;5;18164;16593;49;34757
03;2020-09-21;2;1;3;13469;13557;59;27026
03;2020-09-21;1;0;1;8776;8670;69;17446
03;2020-09-21;3;0;3;3777;3591;79;7368
03;2020-09-21;1;0;1;1649;1072;89;2721
03;2020-09-21;0;0;0;485;184;90;669
03;2020-09-21;15;14;29;149547;141144;0;290691
04;2020-09-21;7;8;15;60314;61377;09;121691
04;2020-09-21;17;17;34;66065;68387;19;134452
04;2020-09-21;10;6;16;51059;47156;29;98215
04;2020-09-21;9;7;16;58788;45780;39;104568
04;2020-09-21;6;2;8;61408;52207;49;113615
04;2020-09-21;12;13;25;64838;60759;59;125597
04;2020-09-21;3;4;7;47008;42843;69;89851
04;2020-09-21;4;1;5;25509;21184;79;46693
04;2020-09-21;0;0;0;13168;7647;89;20815
04;2020-09-21;0;0;0;3209;1253;90;4462
04;2020-09-21;68;58;126;451366;408593;0;859959
05;2020-09-21;0;0;0;362.366008612902;341.338819562748;09;703.704828175651
05;2020-09-21;0;0;0;353.376145114279;370.349735405642;19;723.725880519921
05;2020-09-21;0;0;0;218.593559489256;256.539602589476;29;475.133162078732
05;2020-09-21;0;0;0;404.225408693299;360.321910454353;39;764.547319147651
05;2020-09-21;0;0;0;520.067953604221;497.108383964256;49;1017.17633756848
05;2020-09-21;0;0;0;468.146063921917;510.087601910415;59;978.233665832332
05;2020-09-21;0;0;0;340.368470050554;334.366842191253;69;674.735312241807
05;2020-09-21;0;0;0;212.598666888387;192.597753227106;79;405.196420115493
05;2020-09-21;0;0;0;148.727797095705;61.8681715431829;89;210.595968638888
05;2020-09-21;0;0;0;32.9601271090696;10.9909785719784;90;43.9511056810479
05;2020-09-21;0;0;0;3061.43020057959;2935.56979942041;0;5997
06;2020-09-21;1;0;1;42583;42380;09;84963
06;2020-09-21;1;2;4;33369;31925;19;65294
06;2020-09-21;1;1;2;21571;15080;29;36651
06;2020-09-21;3;3;6;21550;16147;39;37697
06;2020-09-21;3;2;5;14193;13939;49;28132
06;2020-09-21;0;1;1;7171;7597;59;14768
06;2020-09-21;0;0;0;3629;4117;69;7746
06;2020-09-21;0;1;1;1577;1457;79;3034
06;2020-09-21;0;0;0;531;474;89;1005
06;2020-09-21;0;0;0;88;93;90;181
06;2020-09-21;9;10;20;146262;133209;0;279471
07;2020-09-21;0;0;0;485;549;09;1034
07;2020-09-21;0;0;0;403;432;19;835
07;2020-09-21;1;1;2;764;841;29;1605
07;2020-09-21;0;1;1;824;928;39;1752
07;2020-09-21;0;0;0;788;1020;49;1808
07;2020-09-21;1;0;1;678;870;59;1548
07;2020-09-21;0;1;1;360;382;69;742
07;2020-09-21;0;0;0;231;190;79;421
07;2020-09-21;0;0;0;114;67;89;181
07;2020-09-21;0;0;0;24;11;90;35
07;2020-09-21;2;3;5;4671;5290;0;9961
08;2020-09-21;0;0;0;2715.22592983026;2997.75551488675;09;5712.98144471701
08;2020-09-21;0;0;0;2778.51901080978;3160.9156459093;19;5939.43465671908
08;2020-09-21;2;1;3;2080.8882988764;1718.16634315323;29;3799.05464202964
08;2020-09-21;2;1;3;2701.8582062647;1896.52641413317;39;4598.38462039786
08;2020-09-21;2;0;2;3151.45861023308;2460.52498233809;49;5611.98359257117
08;2020-09-21;2;1;3;2620.29868333099;2422.23566154656;59;5042.53434487755
08;2020-09-21;0;0;0;1621.44173420671;1438.58325779464;69;3060.02499200135
08;2020-09-21;1;0;1;626.575909335673;526.358467843651;79;1152.93437717932
08;2020-09-21;0;0;0;205.018522985054;140.993639349697;89;346.012162334751
08;2020-09-21;0;0;0;50.0325684687745;20.62259870351;90;70.6551671722846
08;2020-09-21;9;3;12;18551.3174743414;16782.6825256586;0;35334
11;2020-09-21;39;56;105;783071;811785;09;1594856
11;2020-09-21;253;233;496;761456;784653;19;1546109
11;2020-09-21;659;588;1250;850145;801772;29;1651917
11;2020-09-21;478;413;891;914360;843488;39;1757848
11;2020-09-21;382;307;690;845609;826202;49;1671811
11;2020-09-21;300;225;525;793566;745070;59;1538636
11;2020-09-21;161;152;313;628649;549192;69;1177841
11;2020-09-21;59;75;134;434606;358356;79;792962
11;2020-09-21;44;35;79;261425;162933;89;424358
11;2020-09-21;30;14;44;89253;32619;90;121872
11;2020-09-21;2408;2101;4535;6362140;5916070;0;12278210
24;2020-09-21;3;6;9;139720;144686;09;284406
24;2020-09-21;19;18;37;152979;161185;19;314164
24;2020-09-21;42;30;72;122237;126536;29;248773
24;2020-09-21;31;28;59;150359;142009;39;292368
24;2020-09-21;20;20;40;161829;158758;49;320587
24;2020-09-21;21;17;38;172552;168011;59;340563
24;2020-09-21;20;15;35;172509;158177;69;330686
24;2020-09-21;6;15;21;129428;110593;79;240021
24;2020-09-21;15;9;24;87342;56882;89;144224
24;2020-09-21;11;2;13;31210;12071;90;43281
24;2020-09-21;188;160;348;1320165;1238908;0;2559073
27;2020-09-21;3;8;12;143373;149679;09;293052
27;2020-09-21;22;29;51;160962;173003;19;333965
27;2020-09-21;33;45;78;133746;142254;29;276000
27;2020-09-21;28;21;49;160004;155407;39;315411
27;2020-09-21;27;17;44;172333;169564;49;341897
27;2020-09-21;24;15;39;189979;183788;59;373767
27;2020-09-21;22;11;33;192591;178206;69;370797
27;2020-09-21;16;12;28;146876;127546;79;274422
27;2020-09-21;4;5;9;96896;61575;89;158471
27;2020-09-21;4;1;5;33148;12109;90;45257
27;2020-09-21;183;164;348;1429908;1353131;0;2783039
28;2020-09-21;10;18;29;180735;186856;09;367591
28;2020-09-21;47;50;98;200125;213621;19;413746
28;2020-09-21;83;74;157;168922;173007;29;341929
28;2020-09-21;37;46;84;196628;188487;39;385115
28;2020-09-21;37;23;60;205396;201699;49;407095
28;2020-09-21;30;35;65;222002;213866;59;435868
28;2020-09-21;24;17;41;224688;203758;69;428446
28;2020-09-21;8;11;19;163192;135543;79;298735
28;2020-09-21;7;6;13;109691;65377;89;175068
28;2020-09-21;4;1;5;37222;12685;90;49907
28;2020-09-21;287;281;571;1708601;1594899;0;3303500
32;2020-09-21;32;22;54;358062;373689;09;731751
32;2020-09-21;138;134;273;387045;406742;19;793787
32;2020-09-21;199;194;394;342304;348587;29;690891
32;2020-09-21;129;95;224;382485;369972;39;752457
32;2020-09-21;102;88;190;382510;376716;49;759226
32;2020-09-21;106;97;203;386937;376527;59;763464
32;2020-09-21;53;50;103;371211;330938;69;702149
32;2020-09-21;41;35;76;250542;201459;79;452001
32;2020-09-21;39;15;54;163399;89786;89;253185
32;2020-09-21;17;4;21;48384;15367;90;63751
32;2020-09-21;856;735;1593;3072879;2889783;0;5962662
44;2020-09-21;5;9;14;291525;306839;09;598364
44;2020-09-21;33;38;71;320255;339504;19;659759
44;2020-09-21;68;86;154;302020;314428;29;616448
44;2020-09-21;42;34;76;342222;333292;39;675514
44;2020-09-21;32;25;57;349727;344491;49;694218
44;2020-09-21;24;22;46;381371;373239;59;754610
44;2020-09-21;30;19;49;367165;335850;69;703015
44;2020-09-21;11;6;17;250387;215436;79;465823
44;2020-09-21;4;8;12;170825;105192;89;276017
44;2020-09-21;5;1;6;51248;16731;90;67979
44;2020-09-21;254;248;502;2826745;2685002;0;5511747
52;2020-09-21;5;10;15;213594;223900;09;437494
52;2020-09-21;54;44;99;240818;255197;19;496015
52;2020-09-21;64;59;123;197010;200630;29;397640
52;2020-09-21;40;23;63;231204;224885;39;456089
52;2020-09-21;29;26;55;243874;243418;49;487292
52;2020-09-21;27;20;47;244100;239116;59;483216
52;2020-09-21;27;21;48;241796;221345;69;463141
52;2020-09-21;18;14;32;177805;149903;79;327708
52;2020-09-21;12;5;17;119561;75822;89;195383
52;2020-09-21;9;1;10;42559;15260;90;57819
52;2020-09-21;285;223;509;1952321;1849476;0;3801797
53;2020-09-21;4;1;5;173813;182358;09;356171
53;2020-09-21;37;34;72;202720;214740;19;417460
53;2020-09-21;65;83;153;163116;173196;29;336312
53;2020-09-21;21;24;45;190526;187674;39;378200
53;2020-09-21;26;18;44;212098;212015;49;424113
53;2020-09-21;25;21;46;223699;219176;59;442875
53;2020-09-21;10;4;14;227435;209274;69;436709
53;2020-09-21;6;5;11;169992;140910;79;310902
53;2020-09-21;7;7;14;118117;69883;89;188000
53;2020-09-21;2;1;4;37370;12267;90;49637
53;2020-09-21;203;198;408;1718886;1621493;0;3340379
75;2020-09-21;16;17;33;293104;305291;09;598395
75;2020-09-21;84;90;174;337141;357785;19;694926
75;2020-09-21;99;131;230;295024;300618;29;595642
75;2020-09-21;62;60;122;347871;331233;39;679104
75;2020-09-21;67;51;118;384742;372771;49;757513
75;2020-09-21;41;42;83;413361;390880;59;804241
75;2020-09-21;23;40;63;425623;384060;69;809683
75;2020-09-21;23;17;40;325086;276298;79;601384
75;2020-09-21;12;8;20;213986;139308;89;353294
75;2020-09-21;11;5;16;77600;28200;90;105800
75;2020-09-21;438;461;899;3113538;2886444;0;5999982
76;2020-09-21;20;20;42;305956;318589;09;624545
76;2020-09-21;136;129;267;338942;356969;19;695911
76;2020-09-21;230;224;454;316210;319570;29;635780
76;2020-09-21;122;91;213;356758;337587;39;694345
76;2020-09-21;108;87;195;376541;363812;49;740353
76;2020-09-21;94;81;175;402608;383750;59;786358
76;2020-09-21;57;46;103;394889;358997;69;753886
76;2020-09-21;31;36;67;308664;263806;79;572470
76;2020-09-21;22;19;41;195838;129272;89;325110
76;2020-09-21;13;3;16;69372;26728;90;96100
76;2020-09-21;835;736;1575;3065778;2859080;0;5924858
84;2020-09-21;24;25;49;459549;481088;09;940637
84;2020-09-21;142;138;282;487711;511905;19;999616
84;2020-09-21;294;278;575;443824;451094;29;894918
84;2020-09-21;152;121;274;512522;493262;39;1005784
84;2020-09-21;147;122;269;520248;515106;49;1035354
84;2020-09-21;132;123;255;529611;514848;59;1044459
84;2020-09-21;61;78;139;486720;439940;69;926660
84;2020-09-21;42;47;89;372151;315211;79;687362
84;2020-09-21;37;23;60;237198;150524;89;387722
84;2020-09-21;12;9;21;81185;28680;90;109865
84;2020-09-21;1043;964;2013;4130719;3901658;0;8032377
93;2020-09-21;22;35;57;268834;283093;09;551927
93;2020-09-21;89;84;173;280751;296087;19;576838
93;2020-09-21;161;164;326;254404;255552;29;509956
93;2020-09-21;134;117;251;310704;288398;39;599102
93;2020-09-21;118;109;227;325559;305827;49;631386
93;2020-09-21;116;100;216;353104;325389;59;678493
93;2020-09-21;72;80;152;336327;296459;69;632786
93;2020-09-21;42;36;78;279820;229699;79;509519
93;2020-09-21;40;24;64;171274;113716;89;284990
93;2020-09-21;25;6;31;58896;21758;90;80654
93;2020-09-21;820;755;1576;2639673;2415978;0;5055651
94;2020-09-21;1;0;1;16311;17433;09;33744
94;2020-09-21;0;3;3;16679;18132;19;34811
94;2020-09-21;4;8;12;16782;16579;29;33361
94;2020-09-21;3;3;6;23044;20580;39;43624
94;2020-09-21;2;3;5;23065;22140;49;45205
94;2020-09-21;6;4;10;24549;23421;59;47970
94;2020-09-21;5;3;8;23212;21883;69;45095
94;2020-09-21;0;2;2;19544;17141;79;36685
94;2020-09-21;3;1;4;11227;8178;89;19405
94;2020-09-21;0;0;0;3332;1447;90;4779
94;2020-09-21;24;27;51;177745;166934;0;344679
01;2020-09-22;0;0;0;19979;20155;09;40134
01;2020-09-22;13;13;26;24994;25489;19;50483
01;2020-09-22;17;17;34;17868;16690;29;34558
01;2020-09-22;22;16;38;22328;14821;39;37149
01;2020-09-22;28;19;47;28652;20276;49;48928
01;2020-09-22;30;17;47;33264;27260;59;60524
01;2020-09-22;10;19;29;27135;23978;69;51113
01;2020-09-22;6;6;12;18401;14661;79;33062
01;2020-09-22;4;7;11;9633;6375;89;16008
01;2020-09-22;0;0;0;3410;1510;90;4920
01;2020-09-22;130;114;244;205664;171215;0;376879
02;2020-09-22;1;1;2;16881;17110;09;33991
02;2020-09-22;2;5;7;21410;21604;19;43014
02;2020-09-22;0;6;6;16017;15479;29;31496
02;2020-09-22;5;4;9;19825;14455;39;34280
02;2020-09-22;6;6;12;24719;18248;49;42967
02;2020-09-22;2;5;7;34361;28310;59;62671
02;2020-09-22;3;1;4;28061;24495;69;52556
02;2020-09-22;0;0;0;18231;15278;79;33509
02;2020-09-22;0;0;0;11090;7677;89;18767
02;2020-09-22;0;0;0;3992;1506;90;5498
02;2020-09-22;19;28;47;194587;164162;0;358749
03;2020-09-22;0;0;0;31123;30920;09;62043
03;2020-09-22;5;7;12;29370;29268;19;58638
03;2020-09-22;2;1;3;21458;18963;29;40421
03;2020-09-22;3;1;4;21276;18326;39;39602
03;2020-09-22;3;0;3;18164;16593;49;34757
03;2020-09-22;0;1;1;13469;13557;59;27026
03;2020-09-22;0;1;1;8776;8670;69;17446
03;2020-09-22;0;1;1;3777;3591;79;7368
03;2020-09-22;0;0;0;1649;1072;89;2721
03;2020-09-22;0;0;0;485;184;90;669
03;2020-09-22;13;12;25;149547;141144;0;290691
04;2020-09-22;6;2;8;60314;61377;09;121691
04;2020-09-22;15;13;28;66065;68387;19;134452
04;2020-09-22;4;10;14;51059;47156;29;98215
04;2020-09-22;9;3;12;58788;45780;39;104568
04;2020-09-22;6;3;9;61408;52207;49;113615
04;2020-09-22;5;3;8;64838;60759;59;125597
04;2020-09-22;4;2;6;47008;42843;69;89851
04;2020-09-22;5;2;7;25509;21184;79;46693
04;2020-09-22;0;1;1;13168;7647;89;20815
04;2020-09-22;1;0;1;3209;1253;90;4462
04;2020-09-22;55;40;95;451366;408593;0;859959
05;2020-09-22;0;0;0;362.366008612902;341.338819562748;09;703.704828175651
05;2020-09-22;0;0;0;353.376145114279;370.349735405642;19;723.725880519921
05;2020-09-22;0;0;0;218.593559489256;256.539602589476;29;475.133162078732
05;2020-09-22;0;0;0;404.225408693299;360.321910454353;39;764.547319147651
05;2020-09-22;0;0;0;520.067953604221;497.108383964256;49;1017.17633756848
05;2020-09-22;0;0;0;468.146063921917;510.087601910415;59;978.233665832332
05;2020-09-22;0;0;0;340.368470050554;334.366842191253;69;674.735312241807
05;2020-09-22;0;0;0;212.598666888387;192.597753227106;79;405.196420115493
05;2020-09-22;0;0;0;148.727797095705;61.8681715431829;89;210.595968638888
05;2020-09-22;0;0;0;32.9601271090696;10.9909785719784;90;43.9511056810479
05;2020-09-22;0;0;0;3061.43020057959;2935.56979942041;0;5997
06;2020-09-22;0;0;0;42583;42380;09;84963
06;2020-09-22;0;0;0;33369;31925;19;65294
06;2020-09-22;1;0;1;21571;15080;29;36651
06;2020-09-22;2;1;3;21550;16147;39;37697
06;2020-09-22;0;0;0;14193;13939;49;28132
06;2020-09-22;0;1;1;7171;7597;59;14768
06;2020-09-22;0;0;0;3629;4117;69;7746
06;2020-09-22;0;0;0;1577;1457;79;3034
06;2020-09-22;0;0;0;531;474;89;1005
06;2020-09-22;0;0;0;88;93;90;181
06;2020-09-22;3;2;5;146262;133209;0;279471
07;2020-09-22;0;0;0;485;549;09;1034
07;2020-09-22;0;0;0;403;432;19;835
07;2020-09-22;0;0;0;764;841;29;1605
07;2020-09-22;0;1;1;824;928;39;1752
07;2020-09-22;0;0;0;788;1020;49;1808
07;2020-09-22;1;0;1;678;870;59;1548
07;2020-09-22;0;0;0;360;382;69;742
07;2020-09-22;0;0;0;231;190;79;421
07;2020-09-22;0;0;0;114;67;89;181
07;2020-09-22;0;0;0;24;11;90;35
07;2020-09-22;1;1;2;4671;5290;0;9961
08;2020-09-22;0;0;0;2715.22592983026;2997.75551488675;09;5712.98144471701
08;2020-09-22;0;0;0;2778.51901080978;3160.9156459093;19;5939.43465671908
08;2020-09-22;0;0;0;2080.8882988764;1718.16634315323;29;3799.05464202964
08;2020-09-22;0;0;0;2701.8582062647;1896.52641413317;39;4598.38462039786
08;2020-09-22;0;1;1;3151.45861023308;2460.52498233809;49;5611.98359257117
08;2020-09-22;1;0;1;2620.29868333099;2422.23566154656;59;5042.53434487755
08;2020-09-22;0;1;1;1621.44173420671;1438.58325779464;69;3060.02499200135
08;2020-09-22;0;1;1;626.575909335673;526.358467843651;79;1152.93437717932
08;2020-09-22;0;0;0;205.018522985054;140.993639349697;89;346.012162334751
08;2020-09-22;0;0;0;50.0325684687745;20.62259870351;90;70.6551671722846
08;2020-09-22;1;3;4;18551.3174743414;16782.6825256586;0;35334
11;2020-09-22;36;31;68;783071;811785;09;1594856
11;2020-09-22;231;202;439;761456;784653;19;1546109
11;2020-09-22;621;552;1173;850145;801772;29;1651917
11;2020-09-22;460;444;904;914360;843488;39;1757848
11;2020-09-22;300;280;580;845609;826202;49;1671811
11;2020-09-22;284;223;507;793566;745070;59;1538636
11;2020-09-22;142;143;285;628649;549192;69;1177841
11;2020-09-22;68;69;137;434606;358356;79;792962
11;2020-09-22;33;27;60;261425;162933;89;424358
11;2020-09-22;15;9;24;89253;32619;90;121872
11;2020-09-22;2192;1986;4190;6362140;5916070;0;12278210
24;2020-09-22;3;0;3;139720;144686;09;284406
24;2020-09-22;20;19;42;152979;161185;19;314164
24;2020-09-22;41;37;78;122237;126536;29;248773
24;2020-09-22;22;20;42;150359;142009;39;292368
24;2020-09-22;18;23;41;161829;158758;49;320587
24;2020-09-22;22;25;47;172552;168011;59;340563
24;2020-09-22;15;10;25;172509;158177;69;330686
24;2020-09-22;8;13;21;129428;110593;79;240021
24;2020-09-22;5;5;10;87342;56882;89;144224
24;2020-09-22;5;3;8;31210;12071;90;43281
24;2020-09-22;159;155;317;1320165;1238908;0;2559073
27;2020-09-22;4;19;23;143373;149679;09;293052
27;2020-09-22;24;36;60;160962;173003;19;333965
27;2020-09-22;49;35;84;133746;142254;29;276000
27;2020-09-22;27;18;46;160004;155407;39;315411
27;2020-09-22;26;18;44;172333;169564;49;341897
27;2020-09-22;18;29;47;189979;183788;59;373767
27;2020-09-22;12;14;26;192591;178206;69;370797
27;2020-09-22;4;4;8;146876;127546;79;274422
27;2020-09-22;7;5;12;96896;61575;89;158471
27;2020-09-22;2;0;2;33148;12109;90;45257
27;2020-09-22;173;178;352;1429908;1353131;0;2783039
28;2020-09-22;16;5;21;180735;186856;09;367591
28;2020-09-22;31;32;66;200125;213621;19;413746
28;2020-09-22;81;56;137;168922;173007;29;341929
28;2020-09-22;71;34;105;196628;188487;39;385115
28;2020-09-22;36;38;74;205396;201699;49;407095
28;2020-09-22;35;26;61;222002;213866;59;435868
28;2020-09-22;28;31;59;224688;203758;69;428446
28;2020-09-22;12;22;34;163192;135543;79;298735
28;2020-09-22;27;11;38;109691;65377;89;175068
28;2020-09-22;25;4;29;37222;12685;90;49907
28;2020-09-22;362;259;624;1708601;1594899;0;3303500
32;2020-09-22;19;28;47;358062;373689;09;731751
32;2020-09-22;178;164;342;387045;406742;19;793787
32;2020-09-22;259;247;508;342304;348587;29;690891
32;2020-09-22;124;117;242;382485;369972;39;752457
32;2020-09-22;130;90;222;382510;376716;49;759226
32;2020-09-22;109;113;222;386937;376527;59;763464
32;2020-09-22;62;60;123;371211;330938;69;702149
32;2020-09-22;33;26;59;250542;201459;79;452001
32;2020-09-22;17;12;30;163399;89786;89;253185
32;2020-09-22;9;2;11;48384;15367;90;63751
32;2020-09-22;941;859;1807;3072879;2889783;0;5962662
44;2020-09-22;5;4;9;291525;306839;09;598364
44;2020-09-22;31;34;65;320255;339504;19;659759
44;2020-09-22;42;52;94;302020;314428;29;616448
44;2020-09-22;24;19;43;342222;333292;39;675514
44;2020-09-22;27;18;45;349727;344491;49;694218
44;2020-09-22;17;23;40;381371;373239;59;754610
44;2020-09-22;11;15;26;367165;335850;69;703015
44;2020-09-22;5;5;10;250387;215436;79;465823
44;2020-09-22;8;3;11;170825;105192;89;276017
44;2020-09-22;4;2;6;51248;16731;90;67979
44;2020-09-22;174;175;349;2826745;2685002;0;5511747
52;2020-09-22;6;5;11;213594;223900;09;437494
52;2020-09-22;39;42;82;240818;255197;19;496015
52;2020-09-22;55;57;113;197010;200630;29;397640
52;2020-09-22;29;32;61;231204;224885;39;456089
52;2020-09-22;23;35;58;243874;243418;49;487292
52;2020-09-22;17;22;39;244100;239116;59;483216
52;2020-09-22;18;13;31;241796;221345;69;463141
52;2020-09-22;5;9;14;177805;149903;79;327708
52;2020-09-22;6;10;16;119561;75822;89;195383
52;2020-09-22;4;1;5;42559;15260;90;57819
52;2020-09-22;202;226;430;1952321;1849476;0;3801797
53;2020-09-22;5;12;17;173813;182358;09;356171
53;2020-09-22;45;41;86;202720;214740;19;417460
53;2020-09-22;58;56;115;163116;173196;29;336312
53;2020-09-22;34;27;61;190526;187674;39;378200
53;2020-09-22;24;22;46;212098;212015;49;424113
53;2020-09-22;25;27;52;223699;219176;59;442875
53;2020-09-22;9;16;25;227435;209274;69;436709
53;2020-09-22;7;4;11;169992;140910;79;310902
53;2020-09-22;6;1;7;118117;69883;89;188000
53;2020-09-22;5;4;10;37370;12267;90;49637
53;2020-09-22;218;210;430;1718886;1621493;0;3340379
75;2020-09-22;14;12;26;293104;305291;09;598395
75;2020-09-22;50;68;118;337141;357785;19;694926
75;2020-09-22;103;93;196;295024;300618;29;595642
75;2020-09-22;54;55;109;347871;331233;39;679104
75;2020-09-22;61;38;99;384742;372771;49;757513
75;2020-09-22;48;34;82;413361;390880;59;804241
75;2020-09-22;29;30;60;425623;384060;69;809683
75;2020-09-22;22;17;39;325086;276298;79;601384
75;2020-09-22;16;5;21;213986;139308;89;353294
75;2020-09-22;19;1;20;77600;28200;90;105800
75;2020-09-22;416;355;772;3113538;2886444;0;5999982
76;2020-09-22;13;15;29;305956;318589;09;624545
76;2020-09-22;105;147;254;338942;356969;19;695911
76;2020-09-22;171;184;355;316210;319570;29;635780
76;2020-09-22;96;80;176;356758;337587;39;694345
76;2020-09-22;82;69;151;376541;363812;49;740353
76;2020-09-22;82;73;155;402608;383750;59;786358
76;2020-09-22;57;61;118;394889;358997;69;753886
76;2020-09-22;20;33;53;308664;263806;79;572470
76;2020-09-22;26;16;42;195838;129272;89;325110
76;2020-09-22;15;6;21;69372;26728;90;96100
76;2020-09-22;668;685;1356;3065778;2859080;0;5924858
84;2020-09-22;20;22;44;459549;481088;09;940637
84;2020-09-22;156;129;285;487711;511905;19;999616
84;2020-09-22;263;255;518;443824;451094;29;894918
84;2020-09-22;127;123;250;512522;493262;39;1005784
84;2020-09-22;130;132;262;520248;515106;49;1035354
84;2020-09-22;116;109;225;529611;514848;59;1044459
84;2020-09-22;59;64;123;486720;439940;69;926660
84;2020-09-22;36;54;90;372151;315211;79;687362
84;2020-09-22;34;18;52;237198;150524;89;387722
84;2020-09-22;23;7;30;81185;28680;90;109865
84;2020-09-22;965;914;1882;4130719;3901658;0;8032377
93;2020-09-22;15;10;25;268834;283093;09;551927
93;2020-09-22;72;66;138;280751;296087;19;576838
93;2020-09-22;125;103;229;254404;255552;29;509956
93;2020-09-22;86;77;163;310704;288398;39;599102
93;2020-09-22;91;72;163;325559;305827;49;631386
93;2020-09-22;71;90;161;353104;325389;59;678493
93;2020-09-22;63;55;118;336327;296459;69;632786
93;2020-09-22;31;23;54;279820;229699;79;509519
93;2020-09-22;20;15;37;171274;113716;89;284990
93;2020-09-22;16;5;21;58896;21758;90;80654
93;2020-09-22;591;516;1110;2639673;2415978;0;5055651
94;2020-09-22;0;1;1;16311;17433;09;33744
94;2020-09-22;6;1;7;16679;18132;19;34811
94;2020-09-22;2;3;5;16782;16579;29;33361
94;2020-09-22;1;0;1;23044;20580;39;43624
94;2020-09-22;0;3;3;23065;22140;49;45205
94;2020-09-22;1;1;2;24549;23421;59;47970
94;2020-09-22;0;1;1;23212;21883;69;45095
94;2020-09-22;4;1;5;19544;17141;79;36685
94;2020-09-22;0;0;0;11227;8178;89;19405
94;2020-09-22;0;0;0;3332;1447;90;4779
94;2020-09-22;14;11;25;177745;166934;0;344679
01;2020-09-23;0;1;1;19979;20155;09;40134
01;2020-09-23;9;10;19;24994;25489;19;50483
01;2020-09-23;5;13;18;17868;16690;29;34558
01;2020-09-23;20;13;33;22328;14821;39;37149
01;2020-09-23;24;11;35;28652;20276;49;48928
01;2020-09-23;13;18;31;33264;27260;59;60524
01;2020-09-23;13;9;22;27135;23978;69;51113
01;2020-09-23;5;6;11;18401;14661;79;33062
01;2020-09-23;2;2;4;9633;6375;89;16008
01;2020-09-23;0;0;0;3410;1510;90;4920
01;2020-09-23;91;83;174;205664;171215;0;376879
02;2020-09-23;1;1;2;16881;17110;09;33991
02;2020-09-23;1;2;3;21410;21604;19;43014
02;2020-09-23;1;3;4;16017;15479;29;31496
02;2020-09-23;3;6;9;19825;14455;39;34280
02;2020-09-23;3;3;6;24719;18248;49;42967
02;2020-09-23;8;6;14;34361;28310;59;62671
02;2020-09-23;5;1;6;28061;24495;69;52556
02;2020-09-23;1;0;1;18231;15278;79;33509
02;2020-09-23;0;1;1;11090;7677;89;18767
02;2020-09-23;0;0;0;3992;1506;90;5498
02;2020-09-23;23;23;46;194587;164162;0;358749
03;2020-09-23;0;0;0;31123;30920;09;62043
03;2020-09-23;3;3;9;29370;29268;19;58638
03;2020-09-23;4;5;9;21458;18963;29;40421
03;2020-09-23;3;2;5;21276;18326;39;39602
03;2020-09-23;1;1;2;18164;16593;49;34757
03;2020-09-23;0;1;1;13469;13557;59;27026
03;2020-09-23;0;0;0;8776;8670;69;17446
03;2020-09-23;1;0;1;3777;3591;79;7368
03;2020-09-23;0;0;0;1649;1072;89;2721
03;2020-09-23;0;0;0;485;184;90;669
03;2020-09-23;12;12;27;149547;141144;0;290691
04;2020-09-23;0;5;5;60314;61377;09;121691
04;2020-09-23;7;11;18;66065;68387;19;134452
04;2020-09-23;6;10;16;51059;47156;29;98215
04;2020-09-23;7;6;13;58788;45780;39;104568
04;2020-09-23;7;2;9;61408;52207;49;113615
04;2020-09-23;6;4;10;64838;60759;59;125597
04;2020-09-23;3;1;4;47008;42843;69;89851
04;2020-09-23;4;2;6;25509;21184;79;46693
04;2020-09-23;0;0;0;13168;7647;89;20815
04;2020-09-23;0;0;0;3209;1253;90;4462
04;2020-09-23;40;41;81;451366;408593;0;859959
05;2020-09-23;0;0;0;362.366008612902;341.338819562748;09;703.704828175651
05;2020-09-23;0;0;0;353.376145114279;370.349735405642;19;723.725880519921
05;2020-09-23;0;0;0;218.593559489256;256.539602589476;29;475.133162078732
05;2020-09-23;0;0;0;404.225408693299;360.321910454353;39;764.547319147651
05;2020-09-23;0;0;0;520.067953604221;497.108383964256;49;1017.17633756848
05;2020-09-23;0;0;0;468.146063921917;510.087601910415;59;978.233665832332
05;2020-09-23;0;0;0;340.368470050554;334.366842191253;69;674.735312241807
05;2020-09-23;0;0;0;212.598666888387;192.597753227106;79;405.196420115493
05;2020-09-23;0;0;0;148.727797095705;61.8681715431829;89;210.595968638888
05;2020-09-23;0;0;0;32.9601271090696;10.9909785719784;90;43.9511056810479
05;2020-09-23;0;0;0;3061.43020057959;2935.56979942041;0;5997
06;2020-09-23;0;0;0;42583;42380;09;84963
06;2020-09-23;0;1;1;33369;31925;19;65294
06;2020-09-23;4;1;5;21571;15080;29;36651
06;2020-09-23;4;3;7;21550;16147;39;37697
06;2020-09-23;2;3;5;14193;13939;49;28132
06;2020-09-23;0;0;0;7171;7597;59;14768
06;2020-09-23;0;0;0;3629;4117;69;7746
06;2020-09-23;0;0;0;1577;1457;79;3034
06;2020-09-23;0;0;0;531;474;89;1005
06;2020-09-23;0;0;0;88;93;90;181
06;2020-09-23;10;8;18;146262;133209;0;279471
07;2020-09-23;0;0;0;485;549;09;1034
07;2020-09-23;0;0;0;403;432;19;835
07;2020-09-23;0;0;0;764;841;29;1605
07;2020-09-23;0;0;0;824;928;39;1752
07;2020-09-23;1;0;1;788;1020;49;1808
07;2020-09-23;0;0;0;678;870;59;1548
07;2020-09-23;0;0;0;360;382;69;742
07;2020-09-23;0;0;0;231;190;79;421
07;2020-09-23;0;0;0;114;67;89;181
07;2020-09-23;0;0;0;24;11;90;35
07;2020-09-23;1;0;1;4671;5290;0;9961
08;2020-09-23;0;0;0;2715.22592983026;2997.75551488675;09;5712.98144471701
08;2020-09-23;0;1;1;2778.51901080978;3160.9156459093;19;5939.43465671908
08;2020-09-23;0;0;0;2080.8882988764;1718.16634315323;29;3799.05464202964
08;2020-09-23;1;0;1;2701.8582062647;1896.52641413317;39;4598.38462039786
08;2020-09-23;0;0;0;3151.45861023308;2460.52498233809;49;5611.98359257117
08;2020-09-23;0;1;1;2620.29868333099;2422.23566154656;59;5042.53434487755
08;2020-09-23;0;0;0;1621.44173420671;1438.58325779464;69;3060.02499200135
08;2020-09-23;1;0;1;626.575909335673;526.358467843651;79;1152.93437717932
08;2020-09-23;0;0;0;205.018522985054;140.993639349697;89;346.012162334751
08;2020-09-23;0;0;0;50.0325684687745;20.62259870351;90;70.6551671722846
08;2020-09-23;2;2;4;18551.3174743414;16782.6825256586;0;35334
11;2020-09-23;29;32;61;783071;811785;09;1594856
11;2020-09-23;198;181;385;761456;784653;19;1546109
11;2020-09-23;596;539;1136;850145;801772;29;1651917
11;2020-09-23;415;410;826;914360;843488;39;1757848
11;2020-09-23;293;270;564;845609;826202;49;1671811
11;2020-09-23;264;237;502;793566;745070;59;1538636
11;2020-09-23;135;139;274;628649;549192;69;1177841
11;2020-09-23;66;50;116;434606;358356;79;792962
11;2020-09-23;33;30;63;261425;162933;89;424358
11;2020-09-23;16;5;21;89253;32619;90;121872
11;2020-09-23;2048;1896;3958;6362140;5916070;0;12278210
24;2020-09-23;3;1;5;139720;144686;09;284406
24;2020-09-23;19;15;35;152979;161185;19;314164
24;2020-09-23;42;22;64;122237;126536;29;248773
24;2020-09-23;23;11;34;150359;142009;39;292368
24;2020-09-23;15;17;32;161829;158758;49;320587
24;2020-09-23;18;14;32;172552;168011;59;340563
24;2020-09-23;9;9;18;172509;158177;69;330686
24;2020-09-23;12;10;22;129428;110593;79;240021
24;2020-09-23;2;4;6;87342;56882;89;144224
24;2020-09-23;0;0;0;31210;12071;90;43281
24;2020-09-23;143;103;248;1320165;1238908;0;2559073
27;2020-09-23;4;2;6;143373;149679;09;293052
27;2020-09-23;14;28;42;160962;173003;19;333965
27;2020-09-23;43;43;86;133746;142254;29;276000
27;2020-09-23;25;15;40;160004;155407;39;315411
27;2020-09-23;29;12;41;172333;169564;49;341897
27;2020-09-23;26;23;49;189979;183788;59;373767
27;2020-09-23;10;9;19;192591;178206;69;370797
27;2020-09-23;6;11;17;146876;127546;79;274422
27;2020-09-23;4;5;9;96896;61575;89;158471
27;2020-09-23;3;0;3;33148;12109;90;45257
27;2020-09-23;164;149;313;1429908;1353131;0;2783039
28;2020-09-23;12;9;21;180735;186856;09;367591
28;2020-09-23;35;43;80;200125;213621;19;413746
28;2020-09-23;54;47;101;168922;173007;29;341929
28;2020-09-23;35;31;66;196628;188487;39;385115
28;2020-09-23;32;26;58;205396;201699;49;407095
28;2020-09-23;30;21;51;222002;213866;59;435868
28;2020-09-23;19;17;36;224688;203758;69;428446
28;2020-09-23;11;15;26;163192;135543;79;298735
28;2020-09-23;11;3;14;109691;65377;89;175068
28;2020-09-23;2;1;3;37222;12685;90;49907
28;2020-09-23;241;213;456;1708601;1594899;0;3303500
32;2020-09-23;26;13;40;358062;373689;09;731751
32;2020-09-23;166;164;332;387045;406742;19;793787
32;2020-09-23;271;259;533;342304;348587;29;690891
32;2020-09-23;113;92;206;382485;369972;39;752457
32;2020-09-23;117;71;189;382510;376716;49;759226
32;2020-09-23;81;74;155;386937;376527;59;763464
32;2020-09-23;59;45;104;371211;330938;69;702149
32;2020-09-23;22;27;49;250542;201459;79;452001
32;2020-09-23;20;18;38;163399;89786;89;253185
32;2020-09-23;7;3;10;48384;15367;90;63751
32;2020-09-23;882;767;1657;3072879;2889783;0;5962662
44;2020-09-23;1;4;5;291525;306839;09;598364
44;2020-09-23;41;21;63;320255;339504;19;659759
44;2020-09-23;53;46;99;302020;314428;29;616448
44;2020-09-23;28;26;54;342222;333292;39;675514
44;2020-09-23;20;23;43;349727;344491;49;694218
44;2020-09-23;26;26;52;381371;373239;59;754610
44;2020-09-23;15;15;30;367165;335850;69;703015
44;2020-09-23;5;8;13;250387;215436;79;465823
44;2020-09-23;6;3;9;170825;105192;89;276017
44;2020-09-23;5;1;6;51248;16731;90;67979
44;2020-09-23;200;173;374;2826745;2685002;0;5511747
52;2020-09-23;4;4;8;213594;223900;09;437494
52;2020-09-23;46;37;84;240818;255197;19;496015
52;2020-09-23;67;78;145;197010;200630;29;397640
52;2020-09-23;26;42;68;231204;224885;39;456089
52;2020-09-23;41;36;77;243874;243418;49;487292
52;2020-09-23;22;24;46;244100;239116;59;483216
52;2020-09-23;9;8;17;241796;221345;69;463141
52;2020-09-23;9;8;17;177805;149903;79;327708
52;2020-09-23;5;4;9;119561;75822;89;195383
52;2020-09-23;2;1;3;42559;15260;90;57819
52;2020-09-23;231;242;474;1952321;1849476;0;3801797
53;2020-09-23;4;9;14;173813;182358;09;356171
53;2020-09-23;39;30;70;202720;214740;19;417460
53;2020-09-23;63;58;121;163116;173196;29;336312
53;2020-09-23;23;13;36;190526;187674;39;378200
53;2020-09-23;22;13;35;212098;212015;49;424113
53;2020-09-23;23;20;43;223699;219176;59;442875
53;2020-09-23;11;13;24;227435;209274;69;436709
53;2020-09-23;4;6;10;169992;140910;79;310902
53;2020-09-23;6;0;6;118117;69883;89;188000
53;2020-09-23;5;1;6;37370;12267;90;49637
53;2020-09-23;200;163;365;1718886;1621493;0;3340379
75;2020-09-23;6;7;13;293104;305291;09;598395
75;2020-09-23;62;64;129;337141;357785;19;694926
75;2020-09-23;90;93;183;295024;300618;29;595642
75;2020-09-23;51;54;105;347871;331233;39;679104
75;2020-09-23;40;44;84;384742;372771;49;757513
75;2020-09-23;33;42;75;413361;390880;59;804241
75;2020-09-23;25;24;49;425623;384060;69;809683
75;2020-09-23;11;18;29;325086;276298;79;601384
75;2020-09-23;6;6;12;213986;139308;89;353294
75;2020-09-23;7;3;10;77600;28200;90;105800
75;2020-09-23;331;355;689;3113538;2886444;0;5999982
76;2020-09-23;13;14;29;305956;318589;09;624545
76;2020-09-23;99;117;218;338942;356969;19;695911
76;2020-09-23;152;164;317;316210;319570;29;635780
76;2020-09-23;77;68;145;356758;337587;39;694345
76;2020-09-23;71;58;129;376541;363812;49;740353
76;2020-09-23;77;63;140;402608;383750;59;786358
76;2020-09-23;39;37;76;394889;358997;69;753886
76;2020-09-23;26;31;58;308664;263806;79;572470
76;2020-09-23;32;16;48;195838;129272;89;325110
76;2020-09-23;31;5;36;69372;26728;90;96100
76;2020-09-23;619;573;1198;3065778;2859080;0;5924858
84;2020-09-23;16;14;30;459549;481088;09;940637
84;2020-09-23;130;125;256;487711;511905;19;999616
84;2020-09-23;236;246;482;443824;451094;29;894918
84;2020-09-23;123;100;223;512522;493262;39;1005784
84;2020-09-23;117;93;211;520248;515106;49;1035354
84;2020-09-23;105;85;190;529611;514848;59;1044459
84;2020-09-23;60;49;109;486720;439940;69;926660
84;2020-09-23;35;32;67;372151;315211;79;687362
84;2020-09-23;20;22;42;237198;150524;89;387722
84;2020-09-23;12;2;14;81185;28680;90;109865
84;2020-09-23;854;768;1624;4130719;3901658;0;8032377
93;2020-09-23;14;13;27;268834;283093;09;551927
93;2020-09-23;78;66;144;280751;296087;19;576838
93;2020-09-23;125;87;212;254404;255552;29;509956
93;2020-09-23;84;80;164;310704;288398;39;599102
93;2020-09-23;93;73;166;325559;305827;49;631386
93;2020-09-23;89;80;169;353104;325389;59;678493
93;2020-09-23;51;52;103;336327;296459;69;632786
93;2020-09-23;28;45;73;279820;229699;79;509519
93;2020-09-23;21;19;40;171274;113716;89;284990
93;2020-09-23;23;5;28;58896;21758;90;80654
93;2020-09-23;606;520;1126;2639673;2415978;0;5055651
94;2020-09-23;0;0;0;16311;17433;09;33744
94;2020-09-23;2;4;6;16679;18132;19;34811
94;2020-09-23;4;4;8;16782;16579;29;33361
94;2020-09-23;0;4;4;23044;20580;39;43624
94;2020-09-23;3;0;3;23065;22140;49;45205
94;2020-09-23;3;1;4;24549;23421;59;47970
94;2020-09-23;2;2;4;23212;21883;69;45095
94;2020-09-23;0;0;0;19544;17141;79;36685
94;2020-09-23;0;0;0;11227;8178;89;19405
94;2020-09-23;0;0;0;3332;1447;90;4779
94;2020-09-23;14;15;29;177745;166934;0;344679
01;2020-09-24;2;0;2;19979;20155;09;40134
01;2020-09-24;11;12;23;24994;25489;19;50483
01;2020-09-24;16;10;26;17868;16690;29;34558
01;2020-09-24;14;7;21;22328;14821;39;37149
01;2020-09-24;22;19;41;28652;20276;49;48928
01;2020-09-24;20;19;39;33264;27260;59;60524
01;2020-09-24;15;10;25;27135;23978;69;51113
01;2020-09-24;5;6;11;18401;14661;79;33062
01;2020-09-24;2;0;2;9633;6375;89;16008
01;2020-09-24;1;1;2;3410;1510;90;4920
01;2020-09-24;108;84;192;205664;171215;0;376879
02;2020-09-24;0;0;0;16881;17110;09;33991
02;2020-09-24;2;2;4;21410;21604;19;43014
02;2020-09-24;8;1;9;16017;15479;29;31496
02;2020-09-24;7;9;16;19825;14455;39;34280
02;2020-09-24;7;5;12;24719;18248;49;42967
02;2020-09-24;2;3;5;34361;28310;59;62671
02;2020-09-24;2;2;4;28061;24495;69;52556
02;2020-09-24;1;1;2;18231;15278;79;33509
02;2020-09-24;0;0;0;11090;7677;89;18767
02;2020-09-24;1;0;1;3992;1506;90;5498
02;2020-09-24;30;23;53;194587;164162;0;358749
03;2020-09-24;0;2;3;31123;30920;09;62043
03;2020-09-24;0;5;7;29370;29268;19;58638
03;2020-09-24;5;2;7;21458;18963;29;40421
03;2020-09-24;5;5;11;21276;18326;39;39602
03;2020-09-24;2;2;4;18164;16593;49;34757
03;2020-09-24;3;3;6;13469;13557;59;27026
03;2020-09-24;2;0;3;8776;8670;69;17446
03;2020-09-24;0;0;0;3777;3591;79;7368
03;2020-09-24;0;0;0;1649;1072;89;2721
03;2020-09-24;0;0;0;485;184;90;669
03;2020-09-24;17;19;41;149547;141144;0;290691
04;2020-09-24;1;3;4;60314;61377;09;121691
04;2020-09-24;9;8;17;66065;68387;19;134452
04;2020-09-24;7;5;12;51059;47156;29;98215
04;2020-09-24;7;4;11;58788;45780;39;104568
04;2020-09-24;9;3;12;61408;52207;49;113615
04;2020-09-24;6;2;8;64838;60759;59;125597
04;2020-09-24;0;6;6;47008;42843;69;89851
04;2020-09-24;0;1;1;25509;21184;79;46693
04;2020-09-24;1;1;2;13168;7647;89;20815
04;2020-09-24;0;0;0;3209;1253;90;4462
04;2020-09-24;40;33;73;451366;408593;0;859959
05;2020-09-24;0;0;0;362.366008612902;341.338819562748;09;703.704828175651
05;2020-09-24;0;0;0;353.376145114279;370.349735405642;19;723.725880519921
05;2020-09-24;0;0;0;218.593559489256;256.539602589476;29;475.133162078732
05;2020-09-24;0;0;0;404.225408693299;360.321910454353;39;764.547319147651
05;2020-09-24;0;0;0;520.067953604221;497.108383964256;49;1017.17633756848
05;2020-09-24;0;0;0;468.146063921917;510.087601910415;59;978.233665832332
05;2020-09-24;0;0;0;340.368470050554;334.366842191253;69;674.735312241807
05;2020-09-24;0;0;0;212.598666888387;192.597753227106;79;405.196420115493
05;2020-09-24;0;0;0;148.727797095705;61.8681715431829;89;210.595968638888
05;2020-09-24;0;0;0;32.9601271090696;10.9909785719784;90;43.9511056810479
05;2020-09-24;0;0;0;3061.43020057959;2935.56979942041;0;5997
06;2020-09-24;0;0;0;42583;42380;09;84963
06;2020-09-24;3;3;6;33369;31925;19;65294
06;2020-09-24;2;0;2;21571;15080;29;36651
06;2020-09-24;8;3;11;21550;16147;39;37697
06;2020-09-24;2;0;2;14193;13939;49;28132
06;2020-09-24;2;0;2;7171;7597;59;14768
06;2020-09-24;0;0;0;3629;4117;69;7746
06;2020-09-24;0;0;0;1577;1457;79;3034
06;2020-09-24;0;0;0;531;474;89;1005
06;2020-09-24;0;0;0;88;93;90;181
06;2020-09-24;17;6;23;146262;133209;0;279471
07;2020-09-24;0;0;0;485;549;09;1034
07;2020-09-24;1;0;1;403;432;19;835
07;2020-09-24;0;0;0;764;841;29;1605
07;2020-09-24;0;0;0;824;928;39;1752
07;2020-09-24;0;1;1;788;1020;49;1808
07;2020-09-24;0;1;1;678;870;59;1548
07;2020-09-24;0;1;1;360;382;69;742
07;2020-09-24;0;0;0;231;190;79;421
07;2020-09-24;0;0;0;114;67;89;181
07;2020-09-24;0;0;0;24;11;90;35
07;2020-09-24;1;3;4;4671;5290;0;9961
08;2020-09-24;0;0;0;2715.22592983026;2997.75551488675;09;5712.98144471701
08;2020-09-24;0;0;0;2778.51901080978;3160.9156459093;19;5939.43465671908
08;2020-09-24;2;0;2;2080.8882988764;1718.16634315323;29;3799.05464202964
08;2020-09-24;1;1;2;2701.8582062647;1896.52641413317;39;4598.38462039786
08;2020-09-24;0;0;0;3151.45861023308;2460.52498233809;49;5611.98359257117
08;2020-09-24;0;1;1;2620.29868333099;2422.23566154656;59;5042.53434487755
08;2020-09-24;1;0;1;1621.44173420671;1438.58325779464;69;3060.02499200135
08;2020-09-24;0;0;0;626.575909335673;526.358467843651;79;1152.93437717932
08;2020-09-24;0;0;0;205.018522985054;140.993639349697;89;346.012162334751
08;2020-09-24;0;0;0;50.0325684687745;20.62259870351;90;70.6551671722846
08;2020-09-24;4;2;6;18551.3174743414;16782.6825256586;0;35334
11;2020-09-24;32;44;77;783071;811785;09;1594856
11;2020-09-24;224;201;434;761456;784653;19;1546109
11;2020-09-24;598;508;1109;850145;801772;29;1651917
11;2020-09-24;368;398;766;914360;843488;39;1757848
11;2020-09-24;274;239;513;845609;826202;49;1671811
11;2020-09-24;266;235;501;793566;745070;59;1538636
11;2020-09-24;140;132;272;628649;549192;69;1177841
11;2020-09-24;58;54;112;434606;358356;79;792962
11;2020-09-24;32;30;62;261425;162933;89;424358
11;2020-09-24;13;7;20;89253;32619;90;121872
11;2020-09-24;2006;1848;3867;6362140;5916070;0;12278210
24;2020-09-24;7;2;9;139720;144686;09;284406
24;2020-09-24;10;22;32;152979;161185;19;314164
24;2020-09-24;37;35;72;122237;126536;29;248773
24;2020-09-24;24;15;39;150359;142009;39;292368
24;2020-09-24;19;14;33;161829;158758;49;320587
24;2020-09-24;15;10;25;172552;168011;59;340563
24;2020-09-24;5;11;16;172509;158177;69;330686
24;2020-09-24;11;11;22;129428;110593;79;240021
24;2020-09-24;5;5;10;87342;56882;89;144224
24;2020-09-24;3;1;4;31210;12071;90;43281
24;2020-09-24;136;126;262;1320165;1238908;0;2559073
27;2020-09-24;12;1;13;143373;149679;09;293052
27;2020-09-24;32;29;62;160962;173003;19;333965
27;2020-09-24;45;38;83;133746;142254;29;276000
27;2020-09-24;30;20;50;160004;155407;39;315411
27;2020-09-24;19;28;47;172333;169564;49;341897
27;2020-09-24;23;14;37;189979;183788;59;373767
27;2020-09-24;14;11;25;192591;178206;69;370797
27;2020-09-24;6;8;14;146876;127546;79;274422
27;2020-09-24;10;8;18;96896;61575;89;158471
27;2020-09-24;1;1;2;33148;12109;90;45257
27;2020-09-24;192;158;351;1429908;1353131;0;2783039
28;2020-09-24;10;3;13;180735;186856;09;367591
28;2020-09-24;21;20;42;200125;213621;19;413746
28;2020-09-24;48;49;97;168922;173007;29;341929
28;2020-09-24;31;37;68;196628;188487;39;385115
28;2020-09-24;28;39;67;205396;201699;49;407095
28;2020-09-24;23;23;46;222002;213866;59;435868
28;2020-09-24;19;17;36;224688;203758;69;428446
28;2020-09-24;8;10;18;163192;135543;79;298735
28;2020-09-24;8;2;10;109691;65377;89;175068
28;2020-09-24;5;5;10;37222;12685;90;49907
28;2020-09-24;201;205;407;1708601;1594899;0;3303500
32;2020-09-24;15;20;35;358062;373689;09;731751
32;2020-09-24;120;93;213;387045;406742;19;793787
32;2020-09-24;173;181;354;342304;348587;29;690891
32;2020-09-24;80;82;163;382485;369972;39;752457
32;2020-09-24;112;78;190;382510;376716;49;759226
32;2020-09-24;90;76;168;386937;376527;59;763464
32;2020-09-24;53;44;98;371211;330938;69;702149
32;2020-09-24;32;29;61;250542;201459;79;452001
32;2020-09-24;16;17;33;163399;89786;89;253185
32;2020-09-24;8;3;11;48384;15367;90;63751
32;2020-09-24;699;623;1326;3072879;2889783;0;5962662
44;2020-09-24;12;5;17;291525;306839;09;598364
44;2020-09-24;34;30;65;320255;339504;19;659759
44;2020-09-24;55;63;118;302020;314428;29;616448
44;2020-09-24;30;28;58;342222;333292;39;675514
44;2020-09-24;28;22;50;349727;344491;49;694218
44;2020-09-24;31;21;52;381371;373239;59;754610
44;2020-09-24;19;19;38;367165;335850;69;703015
44;2020-09-24;8;8;16;250387;215436;79;465823
44;2020-09-24;5;5;10;170825;105192;89;276017
44;2020-09-24;2;1;3;51248;16731;90;67979
44;2020-09-24;224;202;427;2826745;2685002;0;5511747
52;2020-09-24;1;1;2;213594;223900;09;437494
52;2020-09-24;47;44;92;240818;255197;19;496015
52;2020-09-24;59;60;119;197010;200630;29;397640
52;2020-09-24;34;19;53;231204;224885;39;456089
52;2020-09-24;25;19;44;243874;243418;49;487292
52;2020-09-24;28;23;51;244100;239116;59;483216
52;2020-09-24;13;12;25;241796;221345;69;463141
52;2020-09-24;9;7;16;177805;149903;79;327708
52;2020-09-24;4;7;11;119561;75822;89;195383
52;2020-09-24;1;0;1;42559;15260;90;57819
52;2020-09-24;221;192;414;1952321;1849476;0;3801797
53;2020-09-24;8;3;11;173813;182358;09;356171
53;2020-09-24;26;35;61;202720;214740;19;417460
53;2020-09-24;53;57;110;163116;173196;29;336312
53;2020-09-24;21;29;50;190526;187674;39;378200
53;2020-09-24;13;17;30;212098;212015;49;424113
53;2020-09-24;16;14;30;223699;219176;59;442875
53;2020-09-24;4;8;12;227435;209274;69;436709
53;2020-09-24;7;3;10;169992;140910;79;310902
53;2020-09-24;5;2;7;118117;69883;89;188000
53;2020-09-24;1;1;2;37370;12267;90;49637
53;2020-09-24;154;169;323;1718886;1621493;0;3340379
75;2020-09-24;9;8;18;293104;305291;09;598395
75;2020-09-24;49;61;110;337141;357785;19;694926
75;2020-09-24;90;94;184;295024;300618;29;595642
75;2020-09-24;48;50;98;347871;331233;39;679104
75;2020-09-24;39;35;74;384742;372771;49;757513
75;2020-09-24;46;37;83;413361;390880;59;804241
75;2020-09-24;29;32;61;425623;384060;69;809683
75;2020-09-24;11;19;30;325086;276298;79;601384
75;2020-09-24;13;10;23;213986;139308;89;353294
75;2020-09-24;9;2;11;77600;28200;90;105800
75;2020-09-24;343;348;692;3113538;2886444;0;5999982
76;2020-09-24;11;14;25;305956;318589;09;624545
76;2020-09-24;97;119;219;338942;356969;19;695911
76;2020-09-24;153;156;311;316210;319570;29;635780
76;2020-09-24;73;78;151;356758;337587;39;694345
76;2020-09-24;86;63;149;376541;363812;49;740353
76;2020-09-24;69;62;131;402608;383750;59;786358
76;2020-09-24;38;48;86;394889;358997;69;753886
76;2020-09-24;23;21;44;308664;263806;79;572470
76;2020-09-24;24;14;38;195838;129272;89;325110
76;2020-09-24;19;4;23;69372;26728;90;96100
76;2020-09-24;594;579;1178;3065778;2859080;0;5924858
84;2020-09-24;18;17;36;459549;481088;09;940637
84;2020-09-24;131;144;277;487711;511905;19;999616
84;2020-09-24;240;255;495;443824;451094;29;894918
84;2020-09-24;142;124;266;512522;493262;39;1005784
84;2020-09-24;129;108;238;520248;515106;49;1035354
84;2020-09-24;117;100;217;529611;514848;59;1044459
84;2020-09-24;72;70;142;486720;439940;69;926660
84;2020-09-24;48;47;95;372151;315211;79;687362
84;2020-09-24;29;12;41;237198;150524;89;387722
84;2020-09-24;18;5;23;81185;28680;90;109865
84;2020-09-24;944;882;1830;4130719;3901658;0;8032377
93;2020-09-24;9;15;24;268834;283093;09;551927
93;2020-09-24;68;65;134;280751;296087;19;576838
93;2020-09-24;111;100;211;254404;255552;29;509956
93;2020-09-24;99;71;170;310704;288398;39;599102
93;2020-09-24;97;76;173;325559;305827;49;631386
93;2020-09-24;81;73;155;353104;325389;59;678493
93;2020-09-24;36;50;86;336327;296459;69;632786
93;2020-09-24;26;26;53;279820;229699;79;509519
93;2020-09-24;31;16;47;171274;113716;89;284990
93;2020-09-24;13;5;18;58896;21758;90;80654
93;2020-09-24;571;498;1072;2639673;2415978;0;5055651
94;2020-09-24;0;2;2;16311;17433;09;33744
94;2020-09-24;3;4;7;16679;18132;19;34811
94;2020-09-24;9;1;10;16782;16579;29;33361
94;2020-09-24;3;3;6;23044;20580;39;43624
94;2020-09-24;2;4;6;23065;22140;49;45205
94;2020-09-24;4;3;7;24549;23421;59;47970
94;2020-09-24;2;1;3;23212;21883;69;45095
94;2020-09-24;0;2;2;19544;17141;79;36685
94;2020-09-24;0;1;1;11227;8178;89;19405
94;2020-09-24;0;1;1;3332;1447;90;4779
94;2020-09-24;23;22;45;177745;166934;0;344679
01;2020-09-25;1;2;3;19979;20155;09;40134
01;2020-09-25;5;4;9;24994;25489;19;50483
01;2020-09-25;6;5;11;17868;16690;29;34558
01;2020-09-25;9;5;14;22328;14821;39;37149
01;2020-09-25;13;6;19;28652;20276;49;48928
01;2020-09-25;8;5;13;33264;27260;59;60524
01;2020-09-25;11;15;26;27135;23978;69;51113
01;2020-09-25;2;8;10;18401;14661;79;33062
01;2020-09-25;1;2;3;9633;6375;89;16008
01;2020-09-25;1;0;1;3410;1510;90;4920
01;2020-09-25;57;52;109;205664;171215;0;376879
02;2020-09-25;3;0;3;16881;17110;09;33991
02;2020-09-25;3;6;9;21410;21604;19;43014
02;2020-09-25;6;4;10;16017;15479;29;31496
02;2020-09-25;6;2;8;19825;14455;39;34280
02;2020-09-25;6;4;10;24719;18248;49;42967
02;2020-09-25;9;6;15;34361;28310;59;62671
02;2020-09-25;4;5;10;28061;24495;69;52556
02;2020-09-25;1;2;3;18231;15278;79;33509
02;2020-09-25;0;0;1;11090;7677;89;18767
02;2020-09-25;0;0;0;3992;1506;90;5498
02;2020-09-25;38;29;69;194587;164162;0;358749
03;2020-09-25;2;0;2;31123;30920;09;62043
03;2020-09-25;4;4;8;29370;29268;19;58638
03;2020-09-25;2;1;3;21458;18963;29;40421
03;2020-09-25;4;4;8;21276;18326;39;39602
03;2020-09-25;2;1;3;18164;16593;49;34757
03;2020-09-25;2;0;2;13469;13557;59;27026
03;2020-09-25;1;0;1;8776;8670;69;17446
03;2020-09-25;0;0;0;3777;3591;79;7368
03;2020-09-25;0;0;0;1649;1072;89;2721
03;2020-09-25;0;0;0;485;184;90;669
03;2020-09-25;17;10;27;149547;141144;0;290691
04;2020-09-25;4;3;7;60314;61377;09;121691
04;2020-09-25;22;27;49;66065;68387;19;134452
04;2020-09-25;7;4;11;51059;47156;29;98215
04;2020-09-25;6;4;10;58788;45780;39;104568
04;2020-09-25;6;2;8;61408;52207;49;113615
04;2020-09-25;6;1;7;64838;60759;59;125597
04;2020-09-25;0;1;1;47008;42843;69;89851
04;2020-09-25;2;0;2;25509;21184;79;46693
04;2020-09-25;1;0;1;13168;7647;89;20815
04;2020-09-25;0;0;0;3209;1253;90;4462
04;2020-09-25;54;42;96;451366;408593;0;859959
05;2020-09-25;0;0;0;362.366008612902;341.338819562748;09;703.704828175651
05;2020-09-25;0;0;0;353.376145114279;370.349735405642;19;723.725880519921
05;2020-09-25;0;0;0;218.593559489256;256.539602589476;29;475.133162078732
05;2020-09-25;0;0;0;404.225408693299;360.321910454353;39;764.547319147651
05;2020-09-25;0;0;0;520.067953604221;497.108383964256;49;1017.17633756848
05;2020-09-25;0;0;0;468.146063921917;510.087601910415;59;978.233665832332
05;2020-09-25;0;0;0;340.368470050554;334.366842191253;69;674.735312241807
05;2020-09-25;0;0;0;212.598666888387;192.597753227106;79;405.196420115493
05;2020-09-25;0;0;0;148.727797095705;61.8681715431829;89;210.595968638888
05;2020-09-25;0;0;0;32.9601271090696;10.9909785719784;90;43.9511056810479
05;2020-09-25;0;0;0;3061.43020057959;2935.56979942041;0;5997
06;2020-09-25;0;0;0;42583;42380;09;84963
06;2020-09-25;0;3;3;33369;31925;19;65294
06;2020-09-25;4;1;5;21571;15080;29;36651
06;2020-09-25;4;3;7;21550;16147;39;37697
06;2020-09-25;1;5;6;14193;13939;49;28132
06;2020-09-25;0;2;2;7171;7597;59;14768
06;2020-09-25;0;1;1;3629;4117;69;7746
06;2020-09-25;0;0;0;1577;1457;79;3034
06;2020-09-25;0;0;0;531;474;89;1005
06;2020-09-25;0;0;0;88;93;90;181
06;2020-09-25;9;15;24;146262;133209;0;279471
07;2020-09-25;0;0;0;485;549;09;1034
07;2020-09-25;0;0;0;403;432;19;835
07;2020-09-25;1;0;1;764;841;29;1605
07;2020-09-25;0;0;0;824;928;39;1752
07;2020-09-25;0;0;0;788;1020;49;1808
07;2020-09-25;0;0;0;678;870;59;1548
07;2020-09-25;0;0;0;360;382;69;742
07;2020-09-25;0;1;1;231;190;79;421
07;2020-09-25;0;0;0;114;67;89;181
07;2020-09-25;0;0;0;24;11;90;35
07;2020-09-25;1;1;2;4671;5290;0;9961
08;2020-09-25;0;0;0;2715.22592983026;2997.75551488675;09;5712.98144471701
08;2020-09-25;0;0;0;2778.51901080978;3160.9156459093;19;5939.43465671908
08;2020-09-25;2;0;2;2080.8882988764;1718.16634315323;29;3799.05464202964
08;2020-09-25;2;0;2;2701.8582062647;1896.52641413317;39;4598.38462039786
08;2020-09-25;0;1;1;3151.45861023308;2460.52498233809;49;5611.98359257117
08;2020-09-25;1;1;2;2620.29868333099;2422.23566154656;59;5042.53434487755
08;2020-09-25;0;0;0;1621.44173420671;1438.58325779464;69;3060.02499200135
08;2020-09-25;1;0;1;626.575909335673;526.358467843651;79;1152.93437717932
08;2020-09-25;0;0;0;205.018522985054;140.993639349697;89;346.012162334751
08;2020-09-25;0;0;0;50.0325684687745;20.62259870351;90;70.6551671722846
08;2020-09-25;6;2;8;18551.3174743414;16782.6825256586;0;35334
11;2020-09-25;37;34;74;783071;811785;09;1594856
11;2020-09-25;216;240;463;761456;784653;19;1546109
11;2020-09-25;555;444;1000;850145;801772;29;1651917
11;2020-09-25;371;310;682;914360;843488;39;1757848
11;2020-09-25;264;267;531;845609;826202;49;1671811
11;2020-09-25;245;177;422;793566;745070;59;1538636
11;2020-09-25;131;116;247;628649;549192;69;1177841
11;2020-09-25;56;59;115;434606;358356;79;792962
11;2020-09-25;25;33;58;261425;162933;89;424358
11;2020-09-25;17;5;22;89253;32619;90;121872
11;2020-09-25;1918;1687;3622;6362140;5916070;0;12278210
24;2020-09-25;3;3;6;139720;144686;09;284406
24;2020-09-25;20;15;37;152979;161185;19;314164
24;2020-09-25;25;25;50;122237;126536;29;248773
24;2020-09-25;22;17;39;150359;142009;39;292368
24;2020-09-25;17;8;25;161829;158758;49;320587
24;2020-09-25;21;9;30;172552;168011;59;340563
24;2020-09-25;5;15;20;172509;158177;69;330686
24;2020-09-25;11;12;23;129428;110593;79;240021
24;2020-09-25;6;5;11;87342;56882;89;144224
24;2020-09-25;1;1;2;31210;12071;90;43281
24;2020-09-25;131;110;243;1320165;1238908;0;2559073
27;2020-09-25;3;2;5;143373;149679;09;293052
27;2020-09-25;23;18;42;160962;173003;19;333965
27;2020-09-25;26;28;54;133746;142254;29;276000
27;2020-09-25;16;14;30;160004;155407;39;315411
27;2020-09-25;16;10;26;172333;169564;49;341897
27;2020-09-25;19;25;44;189979;183788;59;373767
27;2020-09-25;16;15;31;192591;178206;69;370797
27;2020-09-25;15;10;25;146876;127546;79;274422
27;2020-09-25;6;2;8;96896;61575;89;158471
27;2020-09-25;3;2;5;33148;12109;90;45257
27;2020-09-25;143;126;270;1429908;1353131;0;2783039
28;2020-09-25;9;5;15;180735;186856;09;367591
28;2020-09-25;42;21;66;200125;213621;19;413746
28;2020-09-25;56;48;104;168922;173007;29;341929
28;2020-09-25;33;33;66;196628;188487;39;385115
28;2020-09-25;34;38;72;205396;201699;49;407095
28;2020-09-25;27;25;52;222002;213866;59;435868
28;2020-09-25;21;18;39;224688;203758;69;428446
28;2020-09-25;17;13;30;163192;135543;79;298735
28;2020-09-25;16;6;22;109691;65377;89;175068
28;2020-09-25;9;3;12;37222;12685;90;49907
28;2020-09-25;264;210;478;1708601;1594899;0;3303500
32;2020-09-25;14;38;52;358062;373689;09;731751
32;2020-09-25;133;124;257;387045;406742;19;793787
32;2020-09-25;176;189;366;342304;348587;29;690891
32;2020-09-25;97;92;190;382485;369972;39;752457
32;2020-09-25;94;83;177;382510;376716;49;759226
32;2020-09-25;71;72;144;386937;376527;59;763464
32;2020-09-25;53;47;100;371211;330938;69;702149
32;2020-09-25;31;36;67;250542;201459;79;452001
32;2020-09-25;17;14;31;163399;89786;89;253185
32;2020-09-25;5;3;8;48384;15367;90;63751
32;2020-09-25;691;699;1393;3072879;2889783;0;5962662
44;2020-09-25;7;2;9;291525;306839;09;598364
44;2020-09-25;30;20;50;320255;339504;19;659759
44;2020-09-25;47;54;101;302020;314428;29;616448
44;2020-09-25;24;30;54;342222;333292;39;675514
44;2020-09-25;18;23;41;349727;344491;49;694218
44;2020-09-25;20;17;37;381371;373239;59;754610
44;2020-09-25;18;13;31;367165;335850;69;703015
44;2020-09-25;6;8;14;250387;215436;79;465823
44;2020-09-25;10;5;15;170825;105192;89;276017
44;2020-09-25;6;2;8;51248;16731;90;67979
44;2020-09-25;186;174;360;2826745;2685002;0;5511747
52;2020-09-25;3;3;7;213594;223900;09;437494
52;2020-09-25;43;34;77;240818;255197;19;496015
52;2020-09-25;53;46;99;197010;200630;29;397640
52;2020-09-25;23;19;42;231204;224885;39;456089
52;2020-09-25;31;24;55;243874;243418;49;487292
52;2020-09-25;21;24;45;244100;239116;59;483216
52;2020-09-25;14;12;26;241796;221345;69;463141
52;2020-09-25;11;13;24;177805;149903;79;327708
52;2020-09-25;11;2;13;119561;75822;89;195383
52;2020-09-25;5;2;7;42559;15260;90;57819
52;2020-09-25;215;179;395;1952321;1849476;0;3801797
53;2020-09-25;1;4;5;173813;182358;09;356171
53;2020-09-25;31;25;56;202720;214740;19;417460
53;2020-09-25;58;60;118;163116;173196;29;336312
53;2020-09-25;11;25;36;190526;187674;39;378200
53;2020-09-25;20;18;38;212098;212015;49;424113
53;2020-09-25;15;13;28;223699;219176;59;442875
53;2020-09-25;9;7;16;227435;209274;69;436709
53;2020-09-25;6;7;13;169992;140910;79;310902
53;2020-09-25;4;5;9;118117;69883;89;188000
53;2020-09-25;0;1;1;37370;12267;90;49637
53;2020-09-25;155;165;320;1718886;1621493;0;3340379
75;2020-09-25;12;12;24;293104;305291;09;598395
75;2020-09-25;62;65;128;337141;357785;19;694926
75;2020-09-25;93;114;207;295024;300618;29;595642
75;2020-09-25;43;43;86;347871;331233;39;679104
75;2020-09-25;45;49;94;384742;372771;49;757513
75;2020-09-25;43;34;77;413361;390880;59;804241
75;2020-09-25;22;30;52;425623;384060;69;809683
75;2020-09-25;12;12;24;325086;276298;79;601384
75;2020-09-25;15;6;21;213986;139308;89;353294
75;2020-09-25;6;1;7;77600;28200;90;105800
75;2020-09-25;354;366;721;3113538;2886444;0;5999982
76;2020-09-25;8;11;19;305956;318589;09;624545
76;2020-09-25;103;94;197;338942;356969;19;695911
76;2020-09-25;156;185;342;316210;319570;29;635780
76;2020-09-25;73;86;159;356758;337587;39;694345
76;2020-09-25;86;73;159;376541;363812;49;740353
76;2020-09-25;71;62;133;402608;383750;59;786358
76;2020-09-25;38;34;72;394889;358997;69;753886
76;2020-09-25;21;29;50;308664;263806;79;572470
76;2020-09-25;13;10;23;195838;129272;89;325110
76;2020-09-25;8;4;12;69372;26728;90;96100
76;2020-09-25;577;588;1166;3065778;2859080;0;5924858
84;2020-09-25;15;18;33;459549;481088;09;940637
84;2020-09-25;140;136;279;487711;511905;19;999616
84;2020-09-25;240;267;507;443824;451094;29;894918
84;2020-09-25;124;121;245;512522;493262;39;1005784
84;2020-09-25;139;101;240;520248;515106;49;1035354
84;2020-09-25;111;106;217;529611;514848;59;1044459
84;2020-09-25;54;60;114;486720;439940;69;926660
84;2020-09-25;39;35;74;372151;315211;79;687362
84;2020-09-25;24;13;37;237198;150524;89;387722
84;2020-09-25;14;5;19;81185;28680;90;109865
84;2020-09-25;900;862;1765;4130719;3901658;0;8032377
93;2020-09-25;9;7;17;268834;283093;09;551927
93;2020-09-25;68;75;145;280751;296087;19;576838
93;2020-09-25;122;86;208;254404;255552;29;509956
93;2020-09-25;78;68;146;310704;288398;39;599102
93;2020-09-25;79;78;157;325559;305827;49;631386
93;2020-09-25;85;62;148;353104;325389;59;678493
93;2020-09-25;52;52;104;336327;296459;69;632786
93;2020-09-25;33;29;62;279820;229699;79;509519
93;2020-09-25;20;15;35;171274;113716;89;284990
93;2020-09-25;16;6;22;58896;21758;90;80654
93;2020-09-25;562;478;1044;2639673;2415978;0;5055651
94;2020-09-25;0;0;0;16311;17433;09;33744
94;2020-09-25;1;3;4;16679;18132;19;34811
94;2020-09-25;3;2;5;16782;16579;29;33361
94;2020-09-25;1;1;2;23044;20580;39;43624
94;2020-09-25;1;2;3;23065;22140;49;45205
94;2020-09-25;2;3;5;24549;23421;59;47970
94;2020-09-25;3;4;7;23212;21883;69;45095
94;2020-09-25;1;2;3;19544;17141;79;36685
94;2020-09-25;0;0;0;11227;8178;89;19405
94;2020-09-25;1;0;1;3332;1447;90;4779
94;2020-09-25;13;17;30;177745;166934;0;344679
01;2020-09-26;0;2;2;19979;20155;09;40134
01;2020-09-26;0;2;2;24994;25489;19;50483
01;2020-09-26;1;0;1;17868;16690;29;34558
01;2020-09-26;3;1;4;22328;14821;39;37149
01;2020-09-26;0;0;0;28652;20276;49;48928
01;2020-09-26;2;2;4;33264;27260;59;60524
01;2020-09-26;4;5;9;27135;23978;69;51113
01;2020-09-26;0;3;3;18401;14661;79;33062
01;2020-09-26;2;4;6;9633;6375;89;16008
01;2020-09-26;0;0;0;3410;1510;90;4920
01;2020-09-26;12;19;31;205664;171215;0;376879
02;2020-09-26;0;1;1;16881;17110;09;33991
02;2020-09-26;1;0;1;21410;21604;19;43014
02;2020-09-26;2;1;3;16017;15479;29;31496
02;2020-09-26;4;4;8;19825;14455;39;34280
02;2020-09-26;0;3;3;24719;18248;49;42967
02;2020-09-26;1;0;1;34361;28310;59;62671
02;2020-09-26;0;0;0;28061;24495;69;52556
02;2020-09-26;0;0;0;18231;15278;79;33509
02;2020-09-26;0;0;0;11090;7677;89;18767
02;2020-09-26;0;0;0;3992;1506;90;5498
02;2020-09-26;8;9;17;194587;164162;0;358749
03;2020-09-26;0;0;0;31123;30920;09;62043
03;2020-09-26;1;1;3;29370;29268;19;58638
03;2020-09-26;5;4;9;21458;18963;29;40421
03;2020-09-26;4;3;7;21276;18326;39;39602
03;2020-09-26;1;2;3;18164;16593;49;34757
03;2020-09-26;0;0;0;13469;13557;59;27026
03;2020-09-26;0;0;0;8776;8670;69;17446
03;2020-09-26;0;1;1;3777;3591;79;7368
03;2020-09-26;0;0;0;1649;1072;89;2721
03;2020-09-26;0;0;0;485;184;90;669
03;2020-09-26;11;11;23;149547;141144;0;290691
04;2020-09-26;2;1;3;60314;61377;09;121691
04;2020-09-26;3;3;6;66065;68387;19;134452
04;2020-09-26;3;3;6;51059;47156;29;98215
04;2020-09-26;1;0;1;58788;45780;39;104568
04;2020-09-26;3;2;5;61408;52207;49;113615
04;2020-09-26;2;2;4;64838;60759;59;125597
04;2020-09-26;0;0;0;47008;42843;69;89851
04;2020-09-26;0;0;0;25509;21184;79;46693
04;2020-09-26;0;1;1;13168;7647;89;20815
04;2020-09-26;0;0;0;3209;1253;90;4462
04;2020-09-26;14;12;26;451366;408593;0;859959
05;2020-09-26;0;0;0;362.366008612902;341.338819562748;09;703.704828175651
05;2020-09-26;0;0;0;353.376145114279;370.349735405642;19;723.725880519921
05;2020-09-26;0;0;0;218.593559489256;256.539602589476;29;475.133162078732
05;2020-09-26;0;0;0;404.225408693299;360.321910454353;39;764.547319147651
05;2020-09-26;0;0;0;520.067953604221;497.108383964256;49;1017.17633756848
05;2020-09-26;0;0;0;468.146063921917;510.087601910415;59;978.233665832332
05;2020-09-26;0;0;0;340.368470050554;334.366842191253;69;674.735312241807
05;2020-09-26;0;0;0;212.598666888387;192.597753227106;79;405.196420115493
05;2020-09-26;0;0;0;148.727797095705;61.8681715431829;89;210.595968638888
05;2020-09-26;0;0;0;32.9601271090696;10.9909785719784;90;43.9511056810479
05;2020-09-26;0;0;0;3061.43020057959;2935.56979942041;0;5997
06;2020-09-26;0;0;0;42583;42380;09;84963
06;2020-09-26;1;0;1;33369;31925;19;65294
06;2020-09-26;1;1;2;21571;15080;29;36651
06;2020-09-26;0;0;0;21550;16147;39;37697
06;2020-09-26;1;0;1;14193;13939;49;28132
06;2020-09-26;1;1;2;7171;7597;59;14768
06;2020-09-26;0;0;0;3629;4117;69;7746
06;2020-09-26;0;1;1;1577;1457;79;3034
06;2020-09-26;0;0;0;531;474;89;1005
06;2020-09-26;0;0;0;88;93;90;181
06;2020-09-26;4;3;7;146262;133209;0;279471
07;2020-09-26;0;0;0;485;549;09;1034
07;2020-09-26;0;0;0;403;432;19;835
07;2020-09-26;0;0;0;764;841;29;1605
07;2020-09-26;0;0;0;824;928;39;1752
07;2020-09-26;0;0;0;788;1020;49;1808
07;2020-09-26;0;0;0;678;870;59;1548
07;2020-09-26;0;0;0;360;382;69;742
07;2020-09-26;0;0;0;231;190;79;421
07;2020-09-26;0;0;0;114;67;89;181
07;2020-09-26;0;0;0;24;11;90;35
07;2020-09-26;0;0;0;4671;5290;0;9961
08;2020-09-26;0;0;0;2715.22592983026;2997.75551488675;09;5712.98144471701
08;2020-09-26;0;0;0;2778.51901080978;3160.9156459093;19;5939.43465671908
08;2020-09-26;0;0;0;2080.8882988764;1718.16634315323;29;3799.05464202964
08;2020-09-26;0;0;0;2701.8582062647;1896.52641413317;39;4598.38462039786
08;2020-09-26;0;0;0;3151.45861023308;2460.52498233809;49;5611.98359257117
08;2020-09-26;1;0;1;2620.29868333099;2422.23566154656;59;5042.53434487755
08;2020-09-26;0;1;1;1621.44173420671;1438.58325779464;69;3060.02499200135
08;2020-09-26;0;0;0;626.575909335673;526.358467843651;79;1152.93437717932
08;2020-09-26;0;0;0;205.018522985054;140.993639349697;89;346.012162334751
08;2020-09-26;0;0;0;50.0325684687745;20.62259870351;90;70.6551671722846
08;2020-09-26;1;1;2;18551.3174743414;16782.6825256586;0;35334
11;2020-09-26;13;14;29;783071;811785;09;1594856
11;2020-09-26;97;90;193;761456;784653;19;1546109
11;2020-09-26;205;167;372;850145;801772;29;1651917
11;2020-09-26;135;137;272;914360;843488;39;1757848
11;2020-09-26;95;95;190;845609;826202;49;1671811
11;2020-09-26;95;104;200;793566;745070;59;1538636
11;2020-09-26;40;58;98;628649;549192;69;1177841
11;2020-09-26;27;20;48;434606;358356;79;792962
11;2020-09-26;20;14;34;261425;162933;89;424358
11;2020-09-26;5;6;11;89253;32619;90;121872
11;2020-09-26;732;705;1447;6362140;5916070;0;12278210
24;2020-09-26;2;0;2;139720;144686;09;284406
24;2020-09-26;5;6;11;152979;161185;19;314164
24;2020-09-26;15;7;22;122237;126536;29;248773
24;2020-09-26;7;8;15;150359;142009;39;292368
24;2020-09-26;6;8;14;161829;158758;49;320587
24;2020-09-26;5;4;9;172552;168011;59;340563
24;2020-09-26;6;3;9;172509;158177;69;330686
24;2020-09-26;0;1;1;129428;110593;79;240021
24;2020-09-26;1;1;2;87342;56882;89;144224
24;2020-09-26;0;0;0;31210;12071;90;43281
24;2020-09-26;47;38;85;1320165;1238908;0;2559073
27;2020-09-26;1;8;9;143373;149679;09;293052
27;2020-09-26;9;9;18;160962;173003;19;333965
27;2020-09-26;24;16;40;133746;142254;29;276000
27;2020-09-26;10;7;17;160004;155407;39;315411
27;2020-09-26;12;7;19;172333;169564;49;341897
27;2020-09-26;17;9;26;189979;183788;59;373767
27;2020-09-26;12;6;18;192591;178206;69;370797
27;2020-09-26;5;4;9;146876;127546;79;274422
27;2020-09-26;4;2;6;96896;61575;89;158471
27;2020-09-26;1;0;1;33148;12109;90;45257
27;2020-09-26;95;68;163;1429908;1353131;0;2783039
28;2020-09-26;4;3;7;180735;186856;09;367591
28;2020-09-26;11;16;27;200125;213621;19;413746
28;2020-09-26;11;15;26;168922;173007;29;341929
28;2020-09-26;19;12;31;196628;188487;39;385115
28;2020-09-26;16;12;28;205396;201699;49;407095
28;2020-09-26;14;11;25;222002;213866;59;435868
28;2020-09-26;10;8;18;224688;203758;69;428446
28;2020-09-26;6;5;11;163192;135543;79;298735
28;2020-09-26;4;4;8;109691;65377;89;175068
28;2020-09-26;3;3;6;37222;12685;90;49907
28;2020-09-26;98;89;187;1708601;1594899;0;3303500
32;2020-09-26;9;5;14;358062;373689;09;731751
32;2020-09-26;46;51;97;387045;406742;19;793787
32;2020-09-26;66;75;141;342304;348587;29;690891
32;2020-09-26;39;35;74;382485;369972;39;752457
32;2020-09-26;36;37;74;382510;376716;49;759226
32;2020-09-26;42;38;80;386937;376527;59;763464
32;2020-09-26;32;13;45;371211;330938;69;702149
32;2020-09-26;13;14;27;250542;201459;79;452001
32;2020-09-26;10;6;16;163399;89786;89;253185
32;2020-09-26;4;5;9;48384;15367;90;63751
32;2020-09-26;297;279;577;3072879;2889783;0;5962662
44;2020-09-26;2;5;7;291525;306839;09;598364
44;2020-09-26;17;21;38;320255;339504;19;659759
44;2020-09-26;19;21;40;302020;314428;29;616448
44;2020-09-26;14;13;27;342222;333292;39;675514
44;2020-09-26;10;9;19;349727;344491;49;694218
44;2020-09-26;15;9;24;381371;373239;59;754610
44;2020-09-26;5;7;12;367165;335850;69;703015
44;2020-09-26;5;5;10;250387;215436;79;465823
44;2020-09-26;1;2;3;170825;105192;89;276017
44;2020-09-26;0;0;0;51248;16731;90;67979
44;2020-09-26;88;92;180;2826745;2685002;0;5511747
52;2020-09-26;1;3;4;213594;223900;09;437494
52;2020-09-26;15;14;29;240818;255197;19;496015
52;2020-09-26;17;18;35;197010;200630;29;397640
52;2020-09-26;5;12;17;231204;224885;39;456089
52;2020-09-26;10;9;19;243874;243418;49;487292
52;2020-09-26;12;11;23;244100;239116;59;483216
52;2020-09-26;7;3;10;241796;221345;69;463141
52;2020-09-26;4;6;10;177805;149903;79;327708
52;2020-09-26;1;2;3;119561;75822;89;195383
52;2020-09-26;0;1;1;42559;15260;90;57819
52;2020-09-26;72;79;151;1952321;1849476;0;3801797
53;2020-09-26;2;0;2;173813;182358;09;356171
53;2020-09-26;14;18;32;202720;214740;19;417460
53;2020-09-26;23;22;45;163116;173196;29;336312
53;2020-09-26;10;7;17;190526;187674;39;378200
53;2020-09-26;14;6;20;212098;212015;49;424113
53;2020-09-26;6;11;17;223699;219176;59;442875
53;2020-09-26;7;5;12;227435;209274;69;436709
53;2020-09-26;1;0;1;169992;140910;79;310902
53;2020-09-26;0;2;2;118117;69883;89;188000
53;2020-09-26;2;0;2;37370;12267;90;49637
53;2020-09-26;79;71;150;1718886;1621493;0;3340379
75;2020-09-26;4;7;11;293104;305291;09;598395
75;2020-09-26;21;22;43;337141;357785;19;694926
75;2020-09-26;47;36;83;295024;300618;29;595642
75;2020-09-26;20;20;40;347871;331233;39;679104
75;2020-09-26;21;13;34;384742;372771;49;757513
75;2020-09-26;24;17;41;413361;390880;59;804241
75;2020-09-26;10;10;20;425623;384060;69;809683
75;2020-09-26;9;5;14;325086;276298;79;601384
75;2020-09-26;5;3;8;213986;139308;89;353294
75;2020-09-26;0;1;1;77600;28200;90;105800
75;2020-09-26;161;134;295;3113538;2886444;0;5999982
76;2020-09-26;5;9;14;305956;318589;09;624545
76;2020-09-26;48;51;103;338942;356969;19;695911
76;2020-09-26;68;81;150;316210;319570;29;635780
76;2020-09-26;33;22;55;356758;337587;39;694345
76;2020-09-26;23;33;56;376541;363812;49;740353
76;2020-09-26;21;30;51;402608;383750;59;786358
76;2020-09-26;14;16;30;394889;358997;69;753886
76;2020-09-26;6;19;25;308664;263806;79;572470
76;2020-09-26;7;4;11;195838;129272;89;325110
76;2020-09-26;2;1;3;69372;26728;90;96100
76;2020-09-26;228;267;500;3065778;2859080;0;5924858
84;2020-09-26;10;6;16;459549;481088;09;940637
84;2020-09-26;47;52;99;487711;511905;19;999616
84;2020-09-26;64;70;134;443824;451094;29;894918
84;2020-09-26;45;36;81;512522;493262;39;1005784
84;2020-09-26;30;44;74;520248;515106;49;1035354
84;2020-09-26;33;30;63;529611;514848;59;1044459
84;2020-09-26;20;22;42;486720;439940;69;926660
84;2020-09-26;12;17;29;372151;315211;79;687362
84;2020-09-26;15;8;23;237198;150524;89;387722
84;2020-09-26;8;4;12;81185;28680;90;109865
84;2020-09-26;284;289;573;4130719;3901658;0;8032377
93;2020-09-26;6;3;9;268834;283093;09;551927
93;2020-09-26;19;12;31;280751;296087;19;576838
93;2020-09-26;30;32;62;254404;255552;29;509956
93;2020-09-26;23;23;46;310704;288398;39;599102
93;2020-09-26;21;18;39;325559;305827;49;631386
93;2020-09-26;19;18;37;353104;325389;59;678493
93;2020-09-26;9;17;26;336327;296459;69;632786
93;2020-09-26;7;12;19;279820;229699;79;509519
93;2020-09-26;9;4;13;171274;113716;89;284990
93;2020-09-26;3;0;3;58896;21758;90;80654
93;2020-09-26;146;139;285;2639673;2415978;0;5055651
94;2020-09-26;1;0;1;16311;17433;09;33744
94;2020-09-26;0;0;0;16679;18132;19;34811
94;2020-09-26;0;0;0;16782;16579;29;33361
94;2020-09-26;0;1;1;23044;20580;39;43624
94;2020-09-26;0;0;0;23065;22140;49;45205
94;2020-09-26;2;0;2;24549;23421;59;47970
94;2020-09-26;0;0;0;23212;21883;69;45095
94;2020-09-26;0;0;0;19544;17141;79;36685
94;2020-09-26;0;0;0;11227;8178;89;19405
94;2020-09-26;0;0;0;3332;1447;90;4779
94;2020-09-26;3;1;4;177745;166934;0;344679
01;2020-09-27;0;0;0;19979;20155;09;40134
01;2020-09-27;2;2;4;24994;25489;19;50483
01;2020-09-27;3;0;3;17868;16690;29;34558
01;2020-09-27;2;2;4;22328;14821;39;37149
01;2020-09-27;2;2;4;28652;20276;49;48928
01;2020-09-27;0;3;3;33264;27260;59;60524
01;2020-09-27;0;3;3;27135;23978;69;51113
01;2020-09-27;0;1;1;18401;14661;79;33062
01;2020-09-27;0;0;0;9633;6375;89;16008
01;2020-09-27;0;0;0;3410;1510;90;4920
01;2020-09-27;9;13;22;205664;171215;0;376879
02;2020-09-27;0;0;0;16881;17110;09;33991
02;2020-09-27;0;0;0;21410;21604;19;43014
02;2020-09-27;0;0;0;16017;15479;29;31496
02;2020-09-27;0;0;0;19825;14455;39;34280
02;2020-09-27;0;0;0;24719;18248;49;42967
02;2020-09-27;0;0;0;34361;28310;59;62671
02;2020-09-27;0;0;0;28061;24495;69;52556
02;2020-09-27;0;0;0;18231;15278;79;33509
02;2020-09-27;0;0;0;11090;7677;89;18767
02;2020-09-27;0;0;0;3992;1506;90;5498
02;2020-09-27;0;0;0;194587;164162;0;358749
03;2020-09-27;1;0;1;31123;30920;09;62043
03;2020-09-27;0;0;0;29370;29268;19;58638
03;2020-09-27;1;1;2;21458;18963;29;40421
03;2020-09-27;2;1;3;21276;18326;39;39602
03;2020-09-27;0;0;0;18164;16593;49;34757
03;2020-09-27;0;1;1;13469;13557;59;27026
03;2020-09-27;0;0;0;8776;8670;69;17446
03;2020-09-27;0;0;0;3777;3591;79;7368
03;2020-09-27;0;0;0;1649;1072;89;2721
03;2020-09-27;0;0;0;485;184;90;669
03;2020-09-27;4;3;7;149547;141144;0;290691
04;2020-09-27;1;1;2;60314;61377;09;121691
04;2020-09-27;2;1;3;66065;68387;19;134452
04;2020-09-27;4;1;5;51059;47156;29;98215
04;2020-09-27;2;2;4;58788;45780;39;104568
04;2020-09-27;3;0;3;61408;52207;49;113615
04;2020-09-27;2;2;4;64838;60759;59;125597
04;2020-09-27;1;2;3;47008;42843;69;89851
04;2020-09-27;1;1;2;25509;21184;79;46693
04;2020-09-27;0;0;0;13168;7647;89;20815
04;2020-09-27;0;0;0;3209;1253;90;4462
04;2020-09-27;16;10;26;451366;408593;0;859959
05;2020-09-27;0;0;0;362.366008612902;341.338819562748;09;703.704828175651
05;2020-09-27;0;0;0;353.376145114279;370.349735405642;19;723.725880519921
05;2020-09-27;0;0;0;218.593559489256;256.539602589476;29;475.133162078732
05;2020-09-27;0;0;0;404.225408693299;360.321910454353;39;764.547319147651
05;2020-09-27;0;0;0;520.067953604221;497.108383964256;49;1017.17633756848
05;2020-09-27;0;0;0;468.146063921917;510.087601910415;59;978.233665832332
05;2020-09-27;0;0;0;340.368470050554;334.366842191253;69;674.735312241807
05;2020-09-27;0;0;0;212.598666888387;192.597753227106;79;405.196420115493
05;2020-09-27;0;0;0;148.727797095705;61.8681715431829;89;210.595968638888
05;2020-09-27;0;0;0;32.9601271090696;10.9909785719784;90;43.9511056810479
05;2020-09-27;0;0;0;3061.43020057959;2935.56979942041;0;5997
06;2020-09-27;0;0;0;42583;42380;09;84963
06;2020-09-27;0;0;0;33369;31925;19;65294
06;2020-09-27;1;0;1;21571;15080;29;36651
06;2020-09-27;0;0;0;21550;16147;39;37697
06;2020-09-27;1;1;2;14193;13939;49;28132
06;2020-09-27;0;0;0;7171;7597;59;14768
06;2020-09-27;0;0;0;3629;4117;69;7746
06;2020-09-27;0;0;0;1577;1457;79;3034
06;2020-09-27;0;1;1;531;474;89;1005
06;2020-09-27;0;0;0;88;93;90;181
06;2020-09-27;2;2;4;146262;133209;0;279471
07;2020-09-27;0;0;0;485;549;09;1034
07;2020-09-27;0;0;0;403;432;19;835
07;2020-09-27;0;0;0;764;841;29;1605
07;2020-09-27;0;0;0;824;928;39;1752
07;2020-09-27;0;0;0;788;1020;49;1808
07;2020-09-27;0;0;0;678;870;59;1548
07;2020-09-27;0;0;0;360;382;69;742
07;2020-09-27;0;0;0;231;190;79;421
07;2020-09-27;0;0;0;114;67;89;181
07;2020-09-27;0;0;0;24;11;90;35
07;2020-09-27;0;0;0;4671;5290;0;9961
08;2020-09-27;0;0;0;2715.22592983026;2997.75551488675;09;5712.98144471701
08;2020-09-27;0;0;0;2778.51901080978;3160.9156459093;19;5939.43465671908
08;2020-09-27;0;0;0;2080.8882988764;1718.16634315323;29;3799.05464202964
08;2020-09-27;0;0;0;2701.8582062647;1896.52641413317;39;4598.38462039786
08;2020-09-27;0;0;0;3151.45861023308;2460.52498233809;49;5611.98359257117
08;2020-09-27;0;0;0;2620.29868333099;2422.23566154656;59;5042.53434487755
08;2020-09-27;0;0;0;1621.44173420671;1438.58325779464;69;3060.02499200135
08;2020-09-27;0;0;0;626.575909335673;526.358467843651;79;1152.93437717932
08;2020-09-27;0;0;0;205.018522985054;140.993639349697;89;346.012162334751
08;2020-09-27;0;0;0;50.0325684687745;20.62259870351;90;70.6551671722846
08;2020-09-27;0;0;0;18551.3174743414;16782.6825256586;0;35334
11;2020-09-27;5;4;9;783071;811785;09;1594856
11;2020-09-27;19;21;40;761456;784653;19;1546109
11;2020-09-27;48;41;89;850145;801772;29;1651917
11;2020-09-27;36;35;71;914360;843488;39;1757848
11;2020-09-27;25;27;52;845609;826202;49;1671811
11;2020-09-27;25;27;52;793566;745070;59;1538636
11;2020-09-27;21;15;36;628649;549192;69;1177841
11;2020-09-27;13;14;27;434606;358356;79;792962
11;2020-09-27;9;10;19;261425;162933;89;424358
11;2020-09-27;2;3;5;89253;32619;90;121872
11;2020-09-27;203;198;401;6362140;5916070;0;12278210
24;2020-09-27;1;0;1;139720;144686;09;284406
24;2020-09-27;0;1;1;152979;161185;19;314164
24;2020-09-27;2;0;2;122237;126536;29;248773
24;2020-09-27;4;2;6;150359;142009;39;292368
24;2020-09-27;2;0;2;161829;158758;49;320587
24;2020-09-27;3;2;5;172552;168011;59;340563
24;2020-09-27;1;0;1;172509;158177;69;330686
24;2020-09-27;0;2;2;129428;110593;79;240021
24;2020-09-27;0;1;1;87342;56882;89;144224
24;2020-09-27;0;0;0;31210;12071;90;43281
24;2020-09-27;13;8;21;1320165;1238908;0;2559073
27;2020-09-27;0;0;0;143373;149679;09;293052
27;2020-09-27;3;0;4;160962;173003;19;333965
27;2020-09-27;4;6;10;133746;142254;29;276000
27;2020-09-27;3;3;6;160004;155407;39;315411
27;2020-09-27;4;4;8;172333;169564;49;341897
27;2020-09-27;0;3;3;189979;183788;59;373767
27;2020-09-27;1;0;1;192591;178206;69;370797
27;2020-09-27;2;4;6;146876;127546;79;274422
27;2020-09-27;3;3;6;96896;61575;89;158471
27;2020-09-27;0;0;0;33148;12109;90;45257
27;2020-09-27;20;23;44;1429908;1353131;0;2783039
28;2020-09-27;2;3;5;180735;186856;09;367591
28;2020-09-27;7;7;14;200125;213621;19;413746
28;2020-09-27;13;7;20;168922;173007;29;341929
28;2020-09-27;5;10;15;196628;188487;39;385115
28;2020-09-27;9;2;11;205396;201699;49;407095
28;2020-09-27;9;1;10;222002;213866;59;435868
28;2020-09-27;2;3;5;224688;203758;69;428446
28;2020-09-27;2;3;5;163192;135543;79;298735
28;2020-09-27;6;2;8;109691;65377;89;175068
28;2020-09-27;1;0;1;37222;12685;90;49907
28;2020-09-27;56;38;94;1708601;1594899;0;3303500
32;2020-09-27;2;0;2;358062;373689;09;731751
32;2020-09-27;9;7;16;387045;406742;19;793787
32;2020-09-27;13;17;30;342304;348587;29;690891
32;2020-09-27;7;2;9;382485;369972;39;752457
32;2020-09-27;5;7;12;382510;376716;49;759226
32;2020-09-27;7;7;14;386937;376527;59;763464
32;2020-09-27;5;3;8;371211;330938;69;702149
32;2020-09-27;6;6;12;250542;201459;79;452001
32;2020-09-27;9;6;15;163399;89786;89;253185
32;2020-09-27;5;1;6;48384;15367;90;63751
32;2020-09-27;68;56;124;3072879;2889783;0;5962662
44;2020-09-27;0;0;0;291525;306839;09;598364
44;2020-09-27;1;2;3;320255;339504;19;659759
44;2020-09-27;2;2;4;302020;314428;29;616448
44;2020-09-27;1;0;1;342222;333292;39;675514
44;2020-09-27;1;1;2;349727;344491;49;694218
44;2020-09-27;1;3;4;381371;373239;59;754610
44;2020-09-27;1;2;3;367165;335850;69;703015
44;2020-09-27;1;2;3;250387;215436;79;465823
44;2020-09-27;0;1;1;170825;105192;89;276017
44;2020-09-27;1;0;1;51248;16731;90;67979
44;2020-09-27;9;13;22;2826745;2685002;0;5511747
52;2020-09-27;1;1;2;213594;223900;09;437494
52;2020-09-27;0;4;4;240818;255197;19;496015
52;2020-09-27;1;7;8;197010;200630;29;397640
52;2020-09-27;2;4;6;231204;224885;39;456089
52;2020-09-27;4;3;7;243874;243418;49;487292
52;2020-09-27;0;2;2;244100;239116;59;483216
52;2020-09-27;1;3;4;241796;221345;69;463141
52;2020-09-27;1;0;1;177805;149903;79;327708
52;2020-09-27;2;1;3;119561;75822;89;195383
52;2020-09-27;0;0;0;42559;15260;90;57819
52;2020-09-27;12;25;37;1952321;1849476;0;3801797
53;2020-09-27;1;0;1;173813;182358;09;356171
53;2020-09-27;5;3;8;202720;214740;19;417460
53;2020-09-27;10;7;17;163116;173196;29;336312
53;2020-09-27;1;1;2;190526;187674;39;378200
53;2020-09-27;2;3;5;212098;212015;49;424113
53;2020-09-27;2;1;3;223699;219176;59;442875
53;2020-09-27;2;0;2;227435;209274;69;436709
53;2020-09-27;2;0;2;169992;140910;79;310902
53;2020-09-27;0;1;1;118117;69883;89;188000
53;2020-09-27;0;0;0;37370;12267;90;49637
53;2020-09-27;25;16;41;1718886;1621493;0;3340379
75;2020-09-27;0;1;1;293104;305291;09;598395
75;2020-09-27;4;7;11;337141;357785;19;694926
75;2020-09-27;12;16;28;295024;300618;29;595642
75;2020-09-27;6;3;9;347871;331233;39;679104
75;2020-09-27;10;1;11;384742;372771;49;757513
75;2020-09-27;0;4;4;413361;390880;59;804241
75;2020-09-27;3;5;8;425623;384060;69;809683
75;2020-09-27;3;1;4;325086;276298;79;601384
75;2020-09-27;2;1;3;213986;139308;89;353294
75;2020-09-27;1;0;1;77600;28200;90;105800
75;2020-09-27;41;39;80;3113538;2886444;0;5999982
76;2020-09-27;3;3;6;305956;318589;09;624545
76;2020-09-27;18;21;39;338942;356969;19;695911
76;2020-09-27;30;35;65;316210;319570;29;635780
76;2020-09-27;15;8;23;356758;337587;39;694345
76;2020-09-27;14;9;23;376541;363812;49;740353
76;2020-09-27;6;9;15;402608;383750;59;786358
76;2020-09-27;3;3;6;394889;358997;69;753886
76;2020-09-27;3;7;10;308664;263806;79;572470
76;2020-09-27;4;3;7;195838;129272;89;325110
76;2020-09-27;1;1;2;69372;26728;90;96100
76;2020-09-27;97;99;196;3065778;2859080;0;5924858
84;2020-09-27;2;1;3;459549;481088;09;940637
84;2020-09-27;9;9;18;487711;511905;19;999616
84;2020-09-27;9;9;18;443824;451094;29;894918
84;2020-09-27;14;9;23;512522;493262;39;1005784
84;2020-09-27;13;11;24;520248;515106;49;1035354
84;2020-09-27;10;8;18;529611;514848;59;1044459
84;2020-09-27;11;4;15;486720;439940;69;926660
84;2020-09-27;4;7;11;372151;315211;79;687362
84;2020-09-27;5;5;10;237198;150524;89;387722
84;2020-09-27;5;1;6;81185;28680;90;109865
84;2020-09-27;82;64;146;4130719;3901658;0;8032377
93;2020-09-27;4;3;7;268834;283093;09;551927
93;2020-09-27;4;5;9;280751;296087;19;576838
93;2020-09-27;13;5;18;254404;255552;29;509956
93;2020-09-27;3;2;5;310704;288398;39;599102
93;2020-09-27;7;2;9;325559;305827;49;631386
93;2020-09-27;3;8;11;353104;325389;59;678493
93;2020-09-27;3;6;9;336327;296459;69;632786
93;2020-09-27;1;8;9;279820;229699;79;509519
93;2020-09-27;2;1;3;171274;113716;89;284990
93;2020-09-27;2;1;3;58896;21758;90;80654
93;2020-09-27;42;41;83;2639673;2415978;0;5055651
94;2020-09-27;0;0;0;16311;17433;09;33744
94;2020-09-27;0;0;0;16679;18132;19;34811
94;2020-09-27;0;0;0;16782;16579;29;33361
94;2020-09-27;0;0;0;23044;20580;39;43624
94;2020-09-27;0;0;0;23065;22140;49;45205
94;2020-09-27;1;0;1;24549;23421;59;47970
94;2020-09-27;0;0;0;23212;21883;69;45095
94;2020-09-27;0;0;0;19544;17141;79;36685
94;2020-09-27;0;1;1;11227;8178;89;19405
94;2020-09-27;0;0;0;3332;1447;90;4779
94;2020-09-27;1;1;2;177745;166934;0;344679
01;2020-09-28;1;2;3;19979;20155;09;40134
01;2020-09-28;14;18;32;24994;25489;19;50483
01;2020-09-28;18;5;23;17868;16690;29;34558
01;2020-09-28;25;17;42;22328;14821;39;37149
01;2020-09-28;20;20;40;28652;20276;49;48928
01;2020-09-28;24;18;42;33264;27260;59;60524
01;2020-09-28;11;11;22;27135;23978;69;51113
01;2020-09-28;6;6;12;18401;14661;79;33062
01;2020-09-28;0;0;0;9633;6375;89;16008
01;2020-09-28;1;2;3;3410;1510;90;4920
01;2020-09-28;120;99;219;205664;171215;0;376879
02;2020-09-28;1;0;1;16881;17110;09;33991
02;2020-09-28;3;4;7;21410;21604;19;43014
02;2020-09-28;3;3;6;16017;15479;29;31496
02;2020-09-28;8;3;11;19825;14455;39;34280
02;2020-09-28;7;5;13;24719;18248;49;42967
02;2020-09-28;6;6;12;34361;28310;59;62671
02;2020-09-28;1;2;3;28061;24495;69;52556
02;2020-09-28;1;4;5;18231;15278;79;33509
02;2020-09-28;1;1;2;11090;7677;89;18767
02;2020-09-28;0;0;0;3992;1506;90;5498
02;2020-09-28;31;28;60;194587;164162;0;358749
03;2020-09-28;2;0;2;31123;30920;09;62043
03;2020-09-28;6;6;12;29370;29268;19;58638
03;2020-09-28;5;2;7;21458;18963;29;40421
03;2020-09-28;1;1;3;21276;18326;39;39602
03;2020-09-28;4;2;6;18164;16593;49;34757
03;2020-09-28;4;4;8;13469;13557;59;27026
03;2020-09-28;0;2;2;8776;8670;69;17446
03;2020-09-28;1;0;1;3777;3591;79;7368
03;2020-09-28;0;0;0;1649;1072;89;2721
03;2020-09-28;0;0;0;485;184;90;669
03;2020-09-28;23;17;41;149547;141144;0;290691
04;2020-09-28;3;2;5;60314;61377;09;121691
04;2020-09-28;10;9;19;66065;68387;19;134452
04;2020-09-28;6;7;13;51059;47156;29;98215
04;2020-09-28;8;9;17;58788;45780;39;104568
04;2020-09-28;11;4;15;61408;52207;49;113615
04;2020-09-28;8;8;16;64838;60759;59;125597
04;2020-09-28;7;4;11;47008;42843;69;89851
04;2020-09-28;1;1;2;25509;21184;79;46693
04;2020-09-28;2;0;2;13168;7647;89;20815
04;2020-09-28;0;0;0;3209;1253;90;4462
04;2020-09-28;56;44;100;451366;408593;0;859959
05;2020-09-28;0;0;0;362.366008612902;341.338819562748;09;703.704828175651
05;2020-09-28;0;0;0;353.376145114279;370.349735405642;19;723.725880519921
05;2020-09-28;0;0;0;218.593559489256;256.539602589476;29;475.133162078732
05;2020-09-28;0;0;0;404.225408693299;360.321910454353;39;764.547319147651
05;2020-09-28;0;0;0;520.067953604221;497.108383964256;49;1017.17633756848
05;2020-09-28;0;0;0;468.146063921917;510.087601910415;59;978.233665832332
05;2020-09-28;0;0;0;340.368470050554;334.366842191253;69;674.735312241807
05;2020-09-28;0;0;0;212.598666888387;192.597753227106;79;405.196420115493
05;2020-09-28;0;0;0;148.727797095705;61.8681715431829;89;210.595968638888
05;2020-09-28;0;0;0;32.9601271090696;10.9909785719784;90;43.9511056810479
05;2020-09-28;0;0;0;3061.43020057959;2935.56979942041;0;5997
06;2020-09-28;0;0;0;42583;42380;09;84963
06;2020-09-28;1;0;1;33369;31925;19;65294
06;2020-09-28;2;1;3;21571;15080;29;36651
06;2020-09-28;3;1;4;21550;16147;39;37697
06;2020-09-28;7;2;9;14193;13939;49;28132
06;2020-09-28;0;3;3;7171;7597;59;14768
06;2020-09-28;0;0;0;3629;4117;69;7746
06;2020-09-28;1;0;1;1577;1457;79;3034
06;2020-09-28;0;0;0;531;474;89;1005
06;2020-09-28;0;0;0;88;93;90;181
06;2020-09-28;14;7;21;146262;133209;0;279471
07;2020-09-28;0;0;0;485;549;09;1034
07;2020-09-28;0;0;0;403;432;19;835
07;2020-09-28;1;0;1;764;841;29;1605
07;2020-09-28;0;0;0;824;928;39;1752
07;2020-09-28;2;0;2;788;1020;49;1808
07;2020-09-28;0;0;0;678;870;59;1548
07;2020-09-28;0;0;0;360;382;69;742
07;2020-09-28;0;0;0;231;190;79;421
07;2020-09-28;0;0;0;114;67;89;181
07;2020-09-28;0;0;0;24;11;90;35
07;2020-09-28;3;0;3;4671;5290;0;9961
08;2020-09-28;0;0;0;2715.22592983026;2997.75551488675;09;5712.98144471701
08;2020-09-28;0;0;0;2778.51901080978;3160.9156459093;19;5939.43465671908
08;2020-09-28;0;0;0;2080.8882988764;1718.16634315323;29;3799.05464202964
08;2020-09-28;0;0;0;2701.8582062647;1896.52641413317;39;4598.38462039786
08;2020-09-28;0;0;0;3151.45861023308;2460.52498233809;49;5611.98359257117
08;2020-09-28;2;0;2;2620.29868333099;2422.23566154656;59;5042.53434487755
08;2020-09-28;0;1;1;1621.44173420671;1438.58325779464;69;3060.02499200135
08;2020-09-28;1;0;1;626.575909335673;526.358467843651;79;1152.93437717932
08;2020-09-28;0;1;1;205.018522985054;140.993639349697;89;346.012162334751
08;2020-09-28;0;0;0;50.0325684687745;20.62259870351;90;70.6551671722846
08;2020-09-28;3;2;5;18551.3174743414;16782.6825256586;0;35334
11;2020-09-28;29;39;71;783071;811785;09;1594856
11;2020-09-28;250;245;502;761456;784653;19;1546109
11;2020-09-28;602;498;1101;850145;801772;29;1651917
11;2020-09-28;417;385;802;914360;843488;39;1757848
11;2020-09-28;339;334;673;845609;826202;49;1671811
11;2020-09-28;252;249;501;793566;745070;59;1538636
11;2020-09-28;141;119;261;628649;549192;69;1177841
11;2020-09-28;64;79;143;434606;358356;79;792962
11;2020-09-28;49;26;75;261425;162933;89;424358
11;2020-09-28;24;10;34;89253;32619;90;121872
11;2020-09-28;2170;1989;4174;6362140;5916070;0;12278210
24;2020-09-28;4;3;7;139720;144686;09;284406
24;2020-09-28;16;24;40;152979;161185;19;314164
24;2020-09-28;32;27;59;122237;126536;29;248773
24;2020-09-28;28;16;44;150359;142009;39;292368
24;2020-09-28;23;12;35;161829;158758;49;320587
24;2020-09-28;29;16;45;172552;168011;59;340563
24;2020-09-28;18;17;35;172509;158177;69;330686
24;2020-09-28;9;10;19;129428;110593;79;240021
24;2020-09-28;2;4;6;87342;56882;89;144224
24;2020-09-28;1;0;1;31210;12071;90;43281
24;2020-09-28;162;129;291;1320165;1238908;0;2559073
27;2020-09-28;8;3;11;143373;149679;09;293052
27;2020-09-28;22;25;47;160962;173003;19;333965
27;2020-09-28;44;38;82;133746;142254;29;276000
27;2020-09-28;26;16;42;160004;155407;39;315411
27;2020-09-28;23;20;43;172333;169564;49;341897
27;2020-09-28;30;13;43;189979;183788;59;373767
27;2020-09-28;20;13;33;192591;178206;69;370797
27;2020-09-28;11;9;20;146876;127546;79;274422
27;2020-09-28;7;0;7;96896;61575;89;158471
27;2020-09-28;0;0;0;33148;12109;90;45257
27;2020-09-28;191;137;328;1429908;1353131;0;2783039
28;2020-09-28;5;3;8;180735;186856;09;367591
28;2020-09-28;20;27;47;200125;213621;19;413746
28;2020-09-28;50;41;91;168922;173007;29;341929
28;2020-09-28;37;25;62;196628;188487;39;385115
28;2020-09-28;31;20;51;205396;201699;49;407095
28;2020-09-28;42;33;75;222002;213866;59;435868
28;2020-09-28;30;16;46;224688;203758;69;428446
28;2020-09-28;13;16;29;163192;135543;79;298735
28;2020-09-28;10;9;19;109691;65377;89;175068
28;2020-09-28;7;2;9;37222;12685;90;49907
28;2020-09-28;245;192;437;1708601;1594899;0;3303500
32;2020-09-28;23;17;40;358062;373689;09;731751
32;2020-09-28;117;129;247;387045;406742;19;793787
32;2020-09-28;206;171;380;342304;348587;29;690891
32;2020-09-28;116;81;198;382485;369972;39;752457
32;2020-09-28;126;107;234;382510;376716;49;759226
32;2020-09-28;106;90;199;386937;376527;59;763464
32;2020-09-28;65;70;135;371211;330938;69;702149
32;2020-09-28;33;34;68;250542;201459;79;452001
32;2020-09-28;30;17;47;163399;89786;89;253185
32;2020-09-28;10;3;13;48384;15367;90;63751
32;2020-09-28;832;719;1561;3072879;2889783;0;5962662
44;2020-09-28;5;8;13;291525;306839;09;598364
44;2020-09-28;33;26;59;320255;339504;19;659759
44;2020-09-28;46;53;100;302020;314428;29;616448
44;2020-09-28;30;30;60;342222;333292;39;675514
44;2020-09-28;28;26;54;349727;344491;49;694218
44;2020-09-28;29;32;61;381371;373239;59;754610
44;2020-09-28;21;12;33;367165;335850;69;703015
44;2020-09-28;14;16;30;250387;215436;79;465823
44;2020-09-28;2;2;4;170825;105192;89;276017
44;2020-09-28;3;0;3;51248;16731;90;67979
44;2020-09-28;211;205;417;2826745;2685002;0;5511747
52;2020-09-28;5;1;6;213594;223900;09;437494
52;2020-09-28;29;27;56;240818;255197;19;496015
52;2020-09-28;63;64;127;197010;200630;29;397640
52;2020-09-28;29;36;65;231204;224885;39;456089
52;2020-09-28;38;18;56;243874;243418;49;487292
52;2020-09-28;20;14;34;244100;239116;59;483216
52;2020-09-28;21;15;36;241796;221345;69;463141
52;2020-09-28;22;14;36;177805;149903;79;327708
52;2020-09-28;5;7;12;119561;75822;89;195383
52;2020-09-28;4;1;5;42559;15260;90;57819
52;2020-09-28;236;197;433;1952321;1849476;0;3801797
53;2020-09-28;4;7;11;173813;182358;09;356171
53;2020-09-28;27;32;59;202720;214740;19;417460
53;2020-09-28;51;51;109;163116;173196;29;336312
53;2020-09-28;24;20;44;190526;187674;39;378200
53;2020-09-28;28;14;42;212098;212015;49;424113
53;2020-09-28;13;22;35;223699;219176;59;442875
53;2020-09-28;8;14;22;227435;209274;69;436709
53;2020-09-28;5;12;17;169992;140910;79;310902
53;2020-09-28;5;1;6;118117;69883;89;188000
53;2020-09-28;3;0;3;37370;12267;90;49637
53;2020-09-28;168;173;348;1718886;1621493;0;3340379
75;2020-09-28;8;10;18;293104;305291;09;598395
75;2020-09-28;50;78;130;337141;357785;19;694926
75;2020-09-28;89;102;191;295024;300618;29;595642
75;2020-09-28;54;54;108;347871;331233;39;679104
75;2020-09-28;49;46;95;384742;372771;49;757513
75;2020-09-28;44;47;92;413361;390880;59;804241
75;2020-09-28;32;30;62;425623;384060;69;809683
75;2020-09-28;25;21;46;325086;276298;79;601384
75;2020-09-28;11;15;26;213986;139308;89;353294
75;2020-09-28;6;2;8;77600;28200;90;105800
75;2020-09-28;369;405;777;3113538;2886444;0;5999982
76;2020-09-28;9;17;26;305956;318589;09;624545
76;2020-09-28;112;105;221;338942;356969;19;695911
76;2020-09-28;136;153;289;316210;319570;29;635780
76;2020-09-28;101;72;174;356758;337587;39;694345
76;2020-09-28;85;99;184;376541;363812;49;740353
76;2020-09-28;70;68;138;402608;383750;59;786358
76;2020-09-28;52;49;101;394889;358997;69;753886
76;2020-09-28;27;31;58;308664;263806;79;572470
76;2020-09-28;25;13;38;195838;129272;89;325110
76;2020-09-28;7;5;12;69372;26728;90;96100
76;2020-09-28;625;612;1242;3065778;2859080;0;5924858
84;2020-09-28;28;26;54;459549;481088;09;940637
84;2020-09-28;144;146;290;487711;511905;19;999616
84;2020-09-28;270;249;519;443824;451094;29;894918
84;2020-09-28;139;134;273;512522;493262;39;1005784
84;2020-09-28;176;112;288;520248;515106;49;1035354
84;2020-09-28;127;125;254;529611;514848;59;1044459
84;2020-09-28;61;57;118;486720;439940;69;926660
84;2020-09-28;35;41;76;372151;315211;79;687362
84;2020-09-28;26;23;50;237198;150524;89;387722
84;2020-09-28;20;7;27;81185;28680;90;109865
84;2020-09-28;1026;920;1949;4130719;3901658;0;8032377
93;2020-09-28;11;21;32;268834;283093;09;551927
93;2020-09-28;67;61;129;280751;296087;19;576838
93;2020-09-28;112;120;232;254404;255552;29;509956
93;2020-09-28;97;84;181;310704;288398;39;599102
93;2020-09-28;85;80;165;325559;305827;49;631386
93;2020-09-28;86;76;163;353104;325389;59;678493
93;2020-09-28;57;58;116;336327;296459;69;632786
93;2020-09-28;46;45;91;279820;229699;79;509519
93;2020-09-28;19;20;39;171274;113716;89;284990
93;2020-09-28;29;9;38;58896;21758;90;80654
93;2020-09-28;609;574;1186;2639673;2415978;0;5055651
94;2020-09-28;0;0;0;16311;17433;09;33744
94;2020-09-28;1;2;3;16679;18132;19;34811
94;2020-09-28;2;2;4;16782;16579;29;33361
94;2020-09-28;1;2;3;23044;20580;39;43624
94;2020-09-28;2;0;2;23065;22140;49;45205
94;2020-09-28;2;3;5;24549;23421;59;47970
94;2020-09-28;1;1;2;23212;21883;69;45095
94;2020-09-28;2;1;3;19544;17141;79;36685
94;2020-09-28;0;1;1;11227;8178;89;19405
94;2020-09-28;1;0;1;3332;1447;90;4779
94;2020-09-28;12;12;24;177745;166934;0;344679
01;2020-09-29;1;0;1;19979;20155;09;40134
01;2020-09-29;14;8;22;24994;25489;19;50483
01;2020-09-29;11;9;20;17868;16690;29;34558
01;2020-09-29;14;6;20;22328;14821;39;37149
01;2020-09-29;18;7;25;28652;20276;49;48928
01;2020-09-29;16;14;30;33264;27260;59;60524
01;2020-09-29;12;15;27;27135;23978;69;51113
01;2020-09-29;5;3;8;18401;14661;79;33062
01;2020-09-29;1;2;3;9633;6375;89;16008
01;2020-09-29;1;0;1;3410;1510;90;4920
01;2020-09-29;93;64;157;205664;171215;0;376879
02;2020-09-29;0;0;0;16881;17110;09;33991
02;2020-09-29;6;1;7;21410;21604;19;43014
02;2020-09-29;12;8;20;16017;15479;29;31496
02;2020-09-29;12;4;16;19825;14455;39;34280
02;2020-09-29;4;6;10;24719;18248;49;42967
02;2020-09-29;7;3;10;34361;28310;59;62671
02;2020-09-29;1;3;4;28061;24495;69;52556
02;2020-09-29;3;1;4;18231;15278;79;33509
02;2020-09-29;0;0;0;11090;7677;89;18767
02;2020-09-29;0;1;1;3992;1506;90;5498
02;2020-09-29;45;27;72;194587;164162;0;358749
03;2020-09-29;0;0;0;31123;30920;09;62043
03;2020-09-29;2;5;7;29370;29268;19;58638
03;2020-09-29;1;3;4;21458;18963;29;40421
03;2020-09-29;2;1;3;21276;18326;39;39602
03;2020-09-29;1;1;2;18164;16593;49;34757
03;2020-09-29;3;0;3;13469;13557;59;27026
03;2020-09-29;0;1;1;8776;8670;69;17446
03;2020-09-29;3;0;3;3777;3591;79;7368
03;2020-09-29;0;0;0;1649;1072;89;2721
03;2020-09-29;0;0;0;485;184;90;669
03;2020-09-29;12;11;23;149547;141144;0;290691
04;2020-09-29;0;1;1;60314;61377;09;121691
04;2020-09-29;3;6;9;66065;68387;19;134452
04;2020-09-29;7;2;9;51059;47156;29;98215
04;2020-09-29;6;0;6;58788;45780;39;104568
04;2020-09-29;7;4;11;61408;52207;49;113615
04;2020-09-29;6;6;12;64838;60759;59;125597
04;2020-09-29;1;3;4;47008;42843;69;89851
04;2020-09-29;1;2;3;25509;21184;79;46693
04;2020-09-29;0;0;0;13168;7647;89;20815
04;2020-09-29;0;0;0;3209;1253;90;4462
04;2020-09-29;31;24;55;451366;408593;0;859959
05;2020-09-29;0;0;0;362.366008612902;341.338819562748;09;703.704828175651
05;2020-09-29;0;0;0;353.376145114279;370.349735405642;19;723.725880519921
05;2020-09-29;0;0;0;218.593559489256;256.539602589476;29;475.133162078732
05;2020-09-29;0;0;0;404.225408693299;360.321910454353;39;764.547319147651
05;2020-09-29;0;0;0;520.067953604221;497.108383964256;49;1017.17633756848
05;2020-09-29;0;0;0;468.146063921917;510.087601910415;59;978.233665832332
05;2020-09-29;0;0;0;340.368470050554;334.366842191253;69;674.735312241807
05;2020-09-29;0;0;0;212.598666888387;192.597753227106;79;405.196420115493
05;2020-09-29;0;0;0;148.727797095705;61.8681715431829;89;210.595968638888
05;2020-09-29;0;0;0;32.9601271090696;10.9909785719784;90;43.9511056810479
05;2020-09-29;0;0;0;3061.43020057959;2935.56979942041;0;5997
06;2020-09-29;0;0;0;42583;42380;09;84963
06;2020-09-29;0;1;2;33369;31925;19;65294
06;2020-09-29;2;1;3;21571;15080;29;36651
06;2020-09-29;2;2;4;21550;16147;39;37697
06;2020-09-29;2;3;5;14193;13939;49;28132
06;2020-09-29;2;0;2;7171;7597;59;14768
06;2020-09-29;1;0;1;3629;4117;69;7746
06;2020-09-29;0;0;0;1577;1457;79;3034
06;2020-09-29;0;0;0;531;474;89;1005
06;2020-09-29;0;0;0;88;93;90;181
06;2020-09-29;9;7;17;146262;133209;0;279471
07;2020-09-29;0;0;0;485;549;09;1034
07;2020-09-29;0;0;0;403;432;19;835
07;2020-09-29;0;1;1;764;841;29;1605
07;2020-09-29;0;0;0;824;928;39;1752
07;2020-09-29;1;0;1;788;1020;49;1808
07;2020-09-29;0;0;0;678;870;59;1548
07;2020-09-29;0;0;0;360;382;69;742
07;2020-09-29;0;1;1;231;190;79;421
07;2020-09-29;0;0;0;114;67;89;181
07;2020-09-29;0;0;0;24;11;90;35
07;2020-09-29;1;2;3;4671;5290;0;9961
08;2020-09-29;0;0;0;2715.22592983026;2997.75551488675;09;5712.98144471701
08;2020-09-29;0;0;0;2778.51901080978;3160.9156459093;19;5939.43465671908
08;2020-09-29;0;0;0;2080.8882988764;1718.16634315323;29;3799.05464202964
08;2020-09-29;1;0;1;2701.8582062647;1896.52641413317;39;4598.38462039786
08;2020-09-29;0;0;0;3151.45861023308;2460.52498233809;49;5611.98359257117
08;2020-09-29;1;1;2;2620.29868333099;2422.23566154656;59;5042.53434487755
08;2020-09-29;0;2;2;1621.44173420671;1438.58325779464;69;3060.02499200135
08;2020-09-29;0;0;0;626.575909335673;526.358467843651;79;1152.93437717932
08;2020-09-29;0;0;0;205.018522985054;140.993639349697;89;346.012162334751
08;2020-09-29;0;0;0;50.0325684687745;20.62259870351;90;70.6551671722846
08;2020-09-29;2;3;5;18551.3174743414;16782.6825256586;0;35334
11;2020-09-29;28;23;56;783071;811785;09;1594856
11;2020-09-29;224;217;448;761456;784653;19;1546109
11;2020-09-29;590;585;1176;850145;801772;29;1651917
11;2020-09-29;407;375;783;914360;843488;39;1757848
11;2020-09-29;328;304;632;845609;826202;49;1671811
11;2020-09-29;271;260;531;793566;745070;59;1538636
11;2020-09-29;146;150;298;628649;549192;69;1177841
11;2020-09-29;63;78;141;434606;358356;79;792962
11;2020-09-29;29;23;52;261425;162933;89;424358
11;2020-09-29;16;8;24;89253;32619;90;121872
11;2020-09-29;2102;2024;4142;6362140;5916070;0;12278210
24;2020-09-29;1;3;4;139720;144686;09;284406
24;2020-09-29;22;17;39;152979;161185;19;314164
24;2020-09-29;30;26;57;122237;126536;29;248773
24;2020-09-29;24;21;45;150359;142009;39;292368
24;2020-09-29;25;24;49;161829;158758;49;320587
24;2020-09-29;18;14;32;172552;168011;59;340563
24;2020-09-29;17;16;33;172509;158177;69;330686
24;2020-09-29;8;11;19;129428;110593;79;240021
24;2020-09-29;9;4;13;87342;56882;89;144224
24;2020-09-29;2;1;3;31210;12071;90;43281
24;2020-09-29;156;137;294;1320165;1238908;0;2559073
27;2020-09-29;2;3;7;143373;149679;09;293052
27;2020-09-29;22;24;46;160962;173003;19;333965
27;2020-09-29;34;18;52;133746;142254;29;276000
27;2020-09-29;12;24;36;160004;155407;39;315411
27;2020-09-29;17;24;41;172333;169564;49;341897
27;2020-09-29;24;22;46;189979;183788;59;373767
27;2020-09-29;9;12;21;192591;178206;69;370797
27;2020-09-29;10;8;18;146876;127546;79;274422
27;2020-09-29;5;4;9;96896;61575;89;158471
27;2020-09-29;2;1;3;33148;12109;90;45257
27;2020-09-29;137;140;279;1429908;1353131;0;2783039
28;2020-09-29;3;3;7;180735;186856;09;367591
28;2020-09-29;33;30;64;200125;213621;19;413746
28;2020-09-29;45;50;95;168922;173007;29;341929
28;2020-09-29;46;29;75;196628;188487;39;385115
28;2020-09-29;37;23;60;205396;201699;49;407095
28;2020-09-29;39;32;71;222002;213866;59;435868
28;2020-09-29;17;20;37;224688;203758;69;428446
28;2020-09-29;13;14;27;163192;135543;79;298735
28;2020-09-29;12;3;15;109691;65377;89;175068
28;2020-09-29;7;3;10;37222;12685;90;49907
28;2020-09-29;252;207;461;1708601;1594899;0;3303500
32;2020-09-29;15;15;30;358062;373689;09;731751
32;2020-09-29;102;98;200;387045;406742;19;793787
32;2020-09-29;173;152;325;342304;348587;29;690891
32;2020-09-29;103;97;200;382485;369972;39;752457
32;2020-09-29;106;79;185;382510;376716;49;759226
32;2020-09-29;91;84;176;386937;376527;59;763464
32;2020-09-29;52;55;107;371211;330938;69;702149
32;2020-09-29;33;30;64;250542;201459;79;452001
32;2020-09-29;25;13;39;163399;89786;89;253185
32;2020-09-29;15;4;19;48384;15367;90;63751
32;2020-09-29;715;627;1345;3072879;2889783;0;5962662
44;2020-09-29;3;5;8;291525;306839;09;598364
44;2020-09-29;22;27;49;320255;339504;19;659759
44;2020-09-29;35;56;91;302020;314428;29;616448
44;2020-09-29;28;25;53;342222;333292;39;675514
44;2020-09-29;27;17;44;349727;344491;49;694218
44;2020-09-29;17;20;37;381371;373239;59;754610
44;2020-09-29;10;18;28;367165;335850;69;703015
44;2020-09-29;9;10;20;250387;215436;79;465823
44;2020-09-29;3;5;8;170825;105192;89;276017
44;2020-09-29;1;0;1;51248;16731;90;67979
44;2020-09-29;155;183;339;2826745;2685002;0;5511747
52;2020-09-29;1;1;3;213594;223900;09;437494
52;2020-09-29;22;26;50;240818;255197;19;496015
52;2020-09-29;60;59;119;197010;200630;29;397640
52;2020-09-29;32;21;53;231204;224885;39;456089
52;2020-09-29;29;28;57;243874;243418;49;487292
52;2020-09-29;17;31;48;244100;239116;59;483216
52;2020-09-29;12;14;26;241796;221345;69;463141
52;2020-09-29;8;10;18;177805;149903;79;327708
52;2020-09-29;2;7;9;119561;75822;89;195383
52;2020-09-29;1;0;1;42559;15260;90;57819
52;2020-09-29;184;197;384;1952321;1849476;0;3801797
53;2020-09-29;2;2;4;173813;182358;09;356171
53;2020-09-29;23;32;55;202720;214740;19;417460
53;2020-09-29;49;49;100;163116;173196;29;336312
53;2020-09-29;26;19;45;190526;187674;39;378200
53;2020-09-29;17;15;32;212098;212015;49;424113
53;2020-09-29;16;18;34;223699;219176;59;442875
53;2020-09-29;6;7;13;227435;209274;69;436709
53;2020-09-29;14;11;25;169992;140910;79;310902
53;2020-09-29;7;7;14;118117;69883;89;188000
53;2020-09-29;1;6;7;37370;12267;90;49637
53;2020-09-29;161;166;329;1718886;1621493;0;3340379
75;2020-09-29;10;8;19;293104;305291;09;598395
75;2020-09-29;40;40;82;337141;357785;19;694926
75;2020-09-29;79;95;174;295024;300618;29;595642
75;2020-09-29;53;42;95;347871;331233;39;679104
75;2020-09-29;42;35;77;384742;372771;49;757513
75;2020-09-29;34;32;66;413361;390880;59;804241
75;2020-09-29;19;22;41;425623;384060;69;809683
75;2020-09-29;13;17;30;325086;276298;79;601384
75;2020-09-29;12;13;25;213986;139308;89;353294
75;2020-09-29;20;4;24;77600;28200;90;105800
75;2020-09-29;322;308;633;3113538;2886444;0;5999982
76;2020-09-29;19;18;38;305956;318589;09;624545
76;2020-09-29;81;98;181;338942;356969;19;695911
76;2020-09-29;180;138;318;316210;319570;29;635780
76;2020-09-29;95;80;175;356758;337587;39;694345
76;2020-09-29;80;61;142;376541;363812;49;740353
76;2020-09-29;79;64;143;402608;383750;59;786358
76;2020-09-29;41;35;76;394889;358997;69;753886
76;2020-09-29;29;25;54;308664;263806;79;572470
76;2020-09-29;25;13;38;195838;129272;89;325110
76;2020-09-29;26;3;29;69372;26728;90;96100
76;2020-09-29;655;535;1194;3065778;2859080;0;5924858
84;2020-09-29;13;17;30;459549;481088;09;940637
84;2020-09-29;148;149;298;487711;511905;19;999616
84;2020-09-29;269;217;487;443824;451094;29;894918
84;2020-09-29;146;105;251;512522;493262;39;1005784
84;2020-09-29;136;127;263;520248;515106;49;1035354
84;2020-09-29;136;101;237;529611;514848;59;1044459
84;2020-09-29;70;60;130;486720;439940;69;926660
84;2020-09-29;45;38;83;372151;315211;79;687362
84;2020-09-29;33;16;49;237198;150524;89;387722
84;2020-09-29;14;8;22;81185;28680;90;109865
84;2020-09-29;1010;838;1852;4130719;3901658;0;8032377
93;2020-09-29;12;9;21;268834;283093;09;551927
93;2020-09-29;69;52;121;280751;296087;19;576838
93;2020-09-29;128;105;233;254404;255552;29;509956
93;2020-09-29;99;73;172;310704;288398;39;599102
93;2020-09-29;81;71;152;325559;305827;49;631386
93;2020-09-29;80;60;140;353104;325389;59;678493
93;2020-09-29;42;49;91;336327;296459;69;632786
93;2020-09-29;22;29;52;279820;229699;79;509519
93;2020-09-29;30;14;44;171274;113716;89;284990
93;2020-09-29;22;2;24;58896;21758;90;80654
93;2020-09-29;586;464;1051;2639673;2415978;0;5055651
94;2020-09-29;0;0;0;16311;17433;09;33744
94;2020-09-29;1;0;1;16679;18132;19;34811
94;2020-09-29;1;2;3;16782;16579;29;33361
94;2020-09-29;4;1;5;23044;20580;39;43624
94;2020-09-29;0;1;1;23065;22140;49;45205
94;2020-09-29;2;3;5;24549;23421;59;47970
94;2020-09-29;3;8;11;23212;21883;69;45095
94;2020-09-29;1;1;2;19544;17141;79;36685
94;2020-09-29;0;0;0;11227;8178;89;19405
94;2020-09-29;0;0;0;3332;1447;90;4779
94;2020-09-29;12;16;28;177745;166934;0;344679
01;2020-09-30;1;0;1;19979;20155;09;40134
01;2020-09-30;6;11;17;24994;25489;19;50483
01;2020-09-30;15;9;24;17868;16690;29;34558
01;2020-09-30;8;7;15;22328;14821;39;37149
01;2020-09-30;15;14;29;28652;20276;49;48928
01;2020-09-30;22;10;32;33264;27260;59;60524
01;2020-09-30;11;14;25;27135;23978;69;51113
01;2020-09-30;6;4;10;18401;14661;79;33062
01;2020-09-30;5;2;7;9633;6375;89;16008
01;2020-09-30;0;1;1;3410;1510;90;4920
01;2020-09-30;89;72;161;205664;171215;0;376879
02;2020-09-30;1;1;2;16881;17110;09;33991
02;2020-09-30;6;8;14;21410;21604;19;43014
02;2020-09-30;7;8;15;16017;15479;29;31496
02;2020-09-30;9;4;13;19825;14455;39;34280
02;2020-09-30;7;6;13;24719;18248;49;42967
02;2020-09-30;8;8;16;34361;28310;59;62671
02;2020-09-30;2;0;2;28061;24495;69;52556
02;2020-09-30;2;3;5;18231;15278;79;33509
02;2020-09-30;0;0;0;11090;7677;89;18767
02;2020-09-30;0;0;0;3992;1506;90;5498
02;2020-09-30;42;38;80;194587;164162;0;358749
03;2020-09-30;0;0;0;31123;30920;09;62043
03;2020-09-30;4;0;4;29370;29268;19;58638
03;2020-09-30;0;0;0;21458;18963;29;40421
03;2020-09-30;0;3;3;21276;18326;39;39602
03;2020-09-30;0;0;0;18164;16593;49;34757
03;2020-09-30;1;1;2;13469;13557;59;27026
03;2020-09-30;0;1;1;8776;8670;69;17446
03;2020-09-30;0;0;0;3777;3591;79;7368
03;2020-09-30;0;0;0;1649;1072;89;2721
03;2020-09-30;0;0;0;485;184;90;669
03;2020-09-30;5;5;10;149547;141144;0;290691
04;2020-09-30;4;3;7;60314;61377;09;121691
04;2020-09-30;10;10;20;66065;68387;19;134452
04;2020-09-30;9;5;14;51059;47156;29;98215
04;2020-09-30;6;10;16;58788;45780;39;104568
04;2020-09-30;5;4;9;61408;52207;49;113615
04;2020-09-30;2;3;5;64838;60759;59;125597
04;2020-09-30;4;2;6;47008;42843;69;89851
04;2020-09-30;1;2;3;25509;21184;79;46693
04;2020-09-30;0;0;0;13168;7647;89;20815
04;2020-09-30;0;0;0;3209;1253;90;4462
04;2020-09-30;41;39;80;451366;408593;0;859959
05;2020-09-30;0;0;0;362.366008612902;341.338819562748;09;703.704828175651
05;2020-09-30;0;0;0;353.376145114279;370.349735405642;19;723.725880519921
05;2020-09-30;0;0;0;218.593559489256;256.539602589476;29;475.133162078732
05;2020-09-30;0;0;0;404.225408693299;360.321910454353;39;764.547319147651
05;2020-09-30;0;0;0;520.067953604221;497.108383964256;49;1017.17633756848
05;2020-09-30;0;0;0;468.146063921917;510.087601910415;59;978.233665832332
05;2020-09-30;0;0;0;340.368470050554;334.366842191253;69;674.735312241807
05;2020-09-30;0;0;0;212.598666888387;192.597753227106;79;405.196420115493
05;2020-09-30;0;0;0;148.727797095705;61.8681715431829;89;210.595968638888
05;2020-09-30;0;0;0;32.9601271090696;10.9909785719784;90;43.9511056810479
05;2020-09-30;0;0;0;3061.43020057959;2935.56979942041;0;5997
06;2020-09-30;0;0;0;42583;42380;09;84963
06;2020-09-30;0;0;0;33369;31925;19;65294
06;2020-09-30;2;2;4;21571;15080;29;36651
06;2020-09-30;3;2;5;21550;16147;39;37697
06;2020-09-30;4;2;6;14193;13939;49;28132
06;2020-09-30;3;3;6;7171;7597;59;14768
06;2020-09-30;0;0;0;3629;4117;69;7746
06;2020-09-30;0;0;0;1577;1457;79;3034
06;2020-09-30;0;0;0;531;474;89;1005
06;2020-09-30;0;0;0;88;93;90;181
06;2020-09-30;12;9;21;146262;133209;0;279471
07;2020-09-30;0;0;0;485;549;09;1034
07;2020-09-30;1;0;1;403;432;19;835
07;2020-09-30;0;0;0;764;841;29;1605
07;2020-09-30;0;0;0;824;928;39;1752
07;2020-09-30;0;1;1;788;1020;49;1808
07;2020-09-30;0;1;1;678;870;59;1548
07;2020-09-30;0;0;0;360;382;69;742
07;2020-09-30;0;0;0;231;190;79;421
07;2020-09-30;0;0;0;114;67;89;181
07;2020-09-30;0;0;0;24;11;90;35
07;2020-09-30;1;2;3;4671;5290;0;9961
08;2020-09-30;0;0;0;2715.22592983026;2997.75551488675;09;5712.98144471701
08;2020-09-30;0;0;0;2778.51901080978;3160.9156459093;19;5939.43465671908
08;2020-09-30;0;0;0;2080.8882988764;1718.16634315323;29;3799.05464202964
08;2020-09-30;0;0;0;2701.8582062647;1896.52641413317;39;4598.38462039786
08;2020-09-30;0;1;1;3151.45861023308;2460.52498233809;49;5611.98359257117
08;2020-09-30;3;0;3;2620.29868333099;2422.23566154656;59;5042.53434487755
08;2020-09-30;0;0;0;1621.44173420671;1438.58325779464;69;3060.02499200135
08;2020-09-30;0;0;0;626.575909335673;526.358467843651;79;1152.93437717932
08;2020-09-30;0;0;0;205.018522985054;140.993639349697;89;346.012162334751
08;2020-09-30;0;0;0;50.0325684687745;20.62259870351;90;70.6551671722846
08;2020-09-30;3;1;4;18551.3174743414;16782.6825256586;0;35334
11;2020-09-30;40;30;71;783071;811785;09;1594856
11;2020-09-30;240;213;460;761456;784653;19;1546109
11;2020-09-30;609;629;1238;850145;801772;29;1651917
11;2020-09-30;417;386;803;914360;843488;39;1757848
11;2020-09-30;319;274;594;845609;826202;49;1671811
11;2020-09-30;266;235;502;793566;745070;59;1538636
11;2020-09-30;140;140;283;628649;549192;69;1177841
11;2020-09-30;55;69;124;434606;358356;79;792962
11;2020-09-30;35;28;63;261425;162933;89;424358
11;2020-09-30;17;9;26;89253;32619;90;121872
11;2020-09-30;2140;2014;4169;6362140;5916070;0;12278210
24;2020-09-30;0;4;4;139720;144686;09;284406
24;2020-09-30;22;20;42;152979;161185;19;314164
24;2020-09-30;25;25;50;122237;126536;29;248773
24;2020-09-30;26;18;44;150359;142009;39;292368
24;2020-09-30;21;21;42;161829;158758;49;320587
24;2020-09-30;15;26;41;172552;168011;59;340563
24;2020-09-30;10;12;22;172509;158177;69;330686
24;2020-09-30;9;6;15;129428;110593;79;240021
24;2020-09-30;2;1;3;87342;56882;89;144224
24;2020-09-30;0;0;0;31210;12071;90;43281
24;2020-09-30;130;133;263;1320165;1238908;0;2559073
27;2020-09-30;4;2;6;143373;149679;09;293052
27;2020-09-30;31;31;63;160962;173003;19;333965
27;2020-09-30;34;44;78;133746;142254;29;276000
27;2020-09-30;29;19;48;160004;155407;39;315411
27;2020-09-30;31;12;43;172333;169564;49;341897
27;2020-09-30;25;20;45;189979;183788;59;373767
27;2020-09-30;25;14;39;192591;178206;69;370797
27;2020-09-30;10;8;18;146876;127546;79;274422
27;2020-09-30;13;5;18;96896;61575;89;158471
27;2020-09-30;12;0;12;33148;12109;90;45257
27;2020-09-30;214;155;370;1429908;1353131;0;2783039
28;2020-09-30;4;12;18;180735;186856;09;367591
28;2020-09-30;34;23;58;200125;213621;19;413746
28;2020-09-30;67;51;118;168922;173007;29;341929
28;2020-09-30;38;35;73;196628;188487;39;385115
28;2020-09-30;43;31;74;205396;201699;49;407095
28;2020-09-30;30;21;51;222002;213866;59;435868
28;2020-09-30;17;16;33;224688;203758;69;428446
28;2020-09-30;11;15;26;163192;135543;79;298735
28;2020-09-30;13;10;23;109691;65377;89;175068
28;2020-09-30;13;2;15;37222;12685;90;49907
28;2020-09-30;270;217;490;1708601;1594899;0;3303500
32;2020-09-30;18;18;36;358062;373689;09;731751
32;2020-09-30;122;130;252;387045;406742;19;793787
32;2020-09-30;167;180;347;342304;348587;29;690891
32;2020-09-30;96;94;190;382485;369972;39;752457
32;2020-09-30;104;87;191;382510;376716;49;759226
32;2020-09-30;94;86;180;386937;376527;59;763464
32;2020-09-30;58;58;116;371211;330938;69;702149
32;2020-09-30;45;29;74;250542;201459;79;452001
32;2020-09-30;31;19;50;163399;89786;89;253185
32;2020-09-30;18;8;26;48384;15367;90;63751
32;2020-09-30;753;709;1462;3072879;2889783;0;5962662
44;2020-09-30;6;3;9;291525;306839;09;598364
44;2020-09-30;23;28;51;320255;339504;19;659759
44;2020-09-30;49;61;110;302020;314428;29;616448
44;2020-09-30;31;28;59;342222;333292;39;675514
44;2020-09-30;33;28;61;349727;344491;49;694218
44;2020-09-30;26;24;50;381371;373239;59;754610
44;2020-09-30;26;20;46;367165;335850;69;703015
44;2020-09-30;11;14;25;250387;215436;79;465823
44;2020-09-30;12;9;21;170825;105192;89;276017
44;2020-09-30;4;2;6;51248;16731;90;67979
44;2020-09-30;221;217;438;2826745;2685002;0;5511747
52;2020-09-30;3;1;5;213594;223900;09;437494
52;2020-09-30;17;27;46;240818;255197;19;496015
52;2020-09-30;41;58;99;197010;200630;29;397640
52;2020-09-30;34;31;66;231204;224885;39;456089
52;2020-09-30;24;27;51;243874;243418;49;487292
52;2020-09-30;15;16;31;244100;239116;59;483216
52;2020-09-30;13;15;28;241796;221345;69;463141
52;2020-09-30;7;10;17;177805;149903;79;327708
52;2020-09-30;3;4;7;119561;75822;89;195383
52;2020-09-30;2;0;2;42559;15260;90;57819
52;2020-09-30;159;189;352;1952321;1849476;0;3801797
53;2020-09-30;1;7;8;173813;182358;09;356171
53;2020-09-30;18;32;50;202720;214740;19;417460
53;2020-09-30;43;43;86;163116;173196;29;336312
53;2020-09-30;29;20;49;190526;187674;39;378200
53;2020-09-30;14;19;33;212098;212015;49;424113
53;2020-09-30;16;15;31;223699;219176;59;442875
53;2020-09-30;11;6;17;227435;209274;69;436709
53;2020-09-30;4;9;13;169992;140910;79;310902
53;2020-09-30;6;2;8;118117;69883;89;188000
53;2020-09-30;6;1;8;37370;12267;90;49637
53;2020-09-30;148;154;303;1718886;1621493;0;3340379
75;2020-09-30;10;9;19;293104;305291;09;598395
75;2020-09-30;56;46;104;337141;357785;19;694926
75;2020-09-30;90;62;152;295024;300618;29;595642
75;2020-09-30;50;51;102;347871;331233;39;679104
75;2020-09-30;42;26;68;384742;372771;49;757513
75;2020-09-30;51;32;83;413361;390880;59;804241
75;2020-09-30;25;27;52;425623;384060;69;809683
75;2020-09-30;12;14;26;325086;276298;79;601384
75;2020-09-30;12;13;25;213986;139308;89;353294
75;2020-09-30;9;2;11;77600;28200;90;105800
75;2020-09-30;357;282;642;3113538;2886444;0;5999982
76;2020-09-30;7;8;17;305956;318589;09;624545
76;2020-09-30;86;97;185;338942;356969;19;695911
76;2020-09-30;144;153;298;316210;319570;29;635780
76;2020-09-30;89;70;159;356758;337587;39;694345
76;2020-09-30;77;81;158;376541;363812;49;740353
76;2020-09-30;72;64;136;402608;383750;59;786358
76;2020-09-30;31;41;72;394889;358997;69;753886
76;2020-09-30;22;24;46;308664;263806;79;572470
76;2020-09-30;29;13;42;195838;129272;89;325110
76;2020-09-30;37;9;46;69372;26728;90;96100
76;2020-09-30;595;561;1161;3065778;2859080;0;5924858
84;2020-09-30;25;17;42;459549;481088;09;940637
84;2020-09-30;159;188;348;487711;511905;19;999616
84;2020-09-30;268;275;543;443824;451094;29;894918
84;2020-09-30;139;118;257;512522;493262;39;1005784
84;2020-09-30;174;127;301;520248;515106;49;1035354
84;2020-09-30;135;124;259;529611;514848;59;1044459
84;2020-09-30;67;64;131;486720;439940;69;926660
84;2020-09-30;42;45;87;372151;315211;79;687362
84;2020-09-30;47;23;70;237198;150524;89;387722
84;2020-09-30;27;11;38;81185;28680;90;109865
84;2020-09-30;1083;992;2076;4130719;3901658;0;8032377
93;2020-09-30;11;15;26;268834;283093;09;551927
93;2020-09-30;69;69;138;280751;296087;19;576838
93;2020-09-30;128;108;236;254404;255552;29;509956
93;2020-09-30;77;61;138;310704;288398;39;599102
93;2020-09-30;75;60;135;325559;305827;49;631386
93;2020-09-30;89;66;156;353104;325389;59;678493
93;2020-09-30;48;53;101;336327;296459;69;632786
93;2020-09-30;34;39;73;279820;229699;79;509519
93;2020-09-30;23;15;38;171274;113716;89;284990
93;2020-09-30;19;4;23;58896;21758;90;80654
93;2020-09-30;573;490;1064;2639673;2415978;0;5055651
94;2020-09-30;0;0;0;16311;17433;09;33744
94;2020-09-30;0;2;2;16679;18132;19;34811
94;2020-09-30;6;1;7;16782;16579;29;33361
94;2020-09-30;3;2;5;23044;20580;39;43624
94;2020-09-30;1;2;3;23065;22140;49;45205
94;2020-09-30;0;0;0;24549;23421;59;47970
94;2020-09-30;0;0;0;23212;21883;69;45095
94;2020-09-30;1;0;1;19544;17141;79;36685
94;2020-09-30;0;0;0;11227;8178;89;19405
94;2020-09-30;0;0;0;3332;1447;90;4779
94;2020-09-30;11;7;18;177745;166934;0;344679
01;2020-10-01;0;0;0;19979;20155;09;40134
01;2020-10-01;12;8;20;24994;25489;19;50483
01;2020-10-01;8;6;14;17868;16690;29;34558
01;2020-10-01;14;9;23;22328;14821;39;37149
01;2020-10-01;17;14;31;28652;20276;49;48928
01;2020-10-01;18;9;27;33264;27260;59;60524
01;2020-10-01;8;8;16;27135;23978;69;51113
01;2020-10-01;6;8;14;18401;14661;79;33062
01;2020-10-01;1;2;3;9633;6375;89;16008
01;2020-10-01;2;0;2;3410;1510;90;4920
01;2020-10-01;86;64;150;205664;171215;0;376879
02;2020-10-01;0;0;0;16881;17110;09;33991
02;2020-10-01;2;0;2;21410;21604;19;43014
02;2020-10-01;2;3;5;16017;15479;29;31496
02;2020-10-01;5;8;13;19825;14455;39;34280
02;2020-10-01;2;3;5;24719;18248;49;42967
02;2020-10-01;10;3;13;34361;28310;59;62671
02;2020-10-01;5;1;6;28061;24495;69;52556
02;2020-10-01;2;0;2;18231;15278;79;33509
02;2020-10-01;1;0;1;11090;7677;89;18767
02;2020-10-01;0;0;0;3992;1506;90;5498
02;2020-10-01;29;18;47;194587;164162;0;358749
03;2020-10-01;0;3;3;31123;30920;09;62043
03;2020-10-01;8;3;12;29370;29268;19;58638
03;2020-10-01;3;3;8;21458;18963;29;40421
03;2020-10-01;3;0;3;21276;18326;39;39602
03;2020-10-01;0;4;4;18164;16593;49;34757
03;2020-10-01;1;2;3;13469;13557;59;27026
03;2020-10-01;0;0;0;8776;8670;69;17446
03;2020-10-01;0;0;0;3777;3591;79;7368
03;2020-10-01;0;0;0;1649;1072;89;2721
03;2020-10-01;0;0;0;485;184;90;669
03;2020-10-01;15;15;33;149547;141144;0;290691
04;2020-10-01;1;7;8;60314;61377;09;121691
04;2020-10-01;6;7;13;66065;68387;19;134452
04;2020-10-01;5;4;9;51059;47156;29;98215
04;2020-10-01;5;4;9;58788;45780;39;104568
04;2020-10-01;5;4;9;61408;52207;49;113615
04;2020-10-01;7;7;14;64838;60759;59;125597
04;2020-10-01;1;3;4;47008;42843;69;89851
04;2020-10-01;2;2;4;25509;21184;79;46693
04;2020-10-01;0;0;0;13168;7647;89;20815
04;2020-10-01;0;0;0;3209;1253;90;4462
04;2020-10-01;32;38;70;451366;408593;0;859959
05;2020-10-01;0;0;0;362.366008612902;341.338819562748;09;703.704828175651
05;2020-10-01;0;0;0;353.376145114279;370.349735405642;19;723.725880519921
05;2020-10-01;0;0;0;218.593559489256;256.539602589476;29;475.133162078732
05;2020-10-01;0;0;0;404.225408693299;360.321910454353;39;764.547319147651
05;2020-10-01;0;0;0;520.067953604221;497.108383964256;49;1017.17633756848
05;2020-10-01;0;0;0;468.146063921917;510.087601910415;59;978.233665832332
05;2020-10-01;0;0;0;340.368470050554;334.366842191253;69;674.735312241807
05;2020-10-01;0;0;0;212.598666888387;192.597753227106;79;405.196420115493
05;2020-10-01;0;0;0;148.727797095705;61.8681715431829;89;210.595968638888
05;2020-10-01;0;0;0;32.9601271090696;10.9909785719784;90;43.9511056810479
05;2020-10-01;0;0;0;3061.43020057959;2935.56979942041;0;5997
06;2020-10-01;0;0;0;42583;42380;09;84963
06;2020-10-01;1;0;1;33369;31925;19;65294
06;2020-10-01;4;3;7;21571;15080;29;36651
06;2020-10-01;6;2;8;21550;16147;39;37697
06;2020-10-01;4;1;5;14193;13939;49;28132
06;2020-10-01;0;0;0;7171;7597;59;14768
06;2020-10-01;1;0;1;3629;4117;69;7746
06;2020-10-01;0;1;1;1577;1457;79;3034
06;2020-10-01;0;0;0;531;474;89;1005
06;2020-10-01;0;0;0;88;93;90;181
06;2020-10-01;16;7;23;146262;133209;0;279471
07;2020-10-01;0;0;0;485;549;09;1034
07;2020-10-01;0;0;0;403;432;19;835
07;2020-10-01;0;0;0;764;841;29;1605
07;2020-10-01;0;0;0;824;928;39;1752
07;2020-10-01;0;0;0;788;1020;49;1808
07;2020-10-01;0;0;0;678;870;59;1548
07;2020-10-01;0;0;0;360;382;69;742
07;2020-10-01;0;0;0;231;190;79;421
07;2020-10-01;0;0;0;114;67;89;181
07;2020-10-01;0;0;0;24;11;90;35
07;2020-10-01;0;0;0;4671;5290;0;9961
08;2020-10-01;0;0;0;2715.22592983026;2997.75551488675;09;5712.98144471701
08;2020-10-01;0;0;0;2778.51901080978;3160.9156459093;19;5939.43465671908
08;2020-10-01;0;0;0;2080.8882988764;1718.16634315323;29;3799.05464202964
08;2020-10-01;1;0;1;2701.8582062647;1896.52641413317;39;4598.38462039786
08;2020-10-01;1;1;2;3151.45861023308;2460.52498233809;49;5611.98359257117
08;2020-10-01;1;2;3;2620.29868333099;2422.23566154656;59;5042.53434487755
08;2020-10-01;1;0;1;1621.44173420671;1438.58325779464;69;3060.02499200135
08;2020-10-01;0;0;0;626.575909335673;526.358467843651;79;1152.93437717932
08;2020-10-01;0;0;0;205.018522985054;140.993639349697;89;346.012162334751
08;2020-10-01;0;0;0;50.0325684687745;20.62259870351;90;70.6551671722846
08;2020-10-01;4;3;7;18551.3174743414;16782.6825256586;0;35334
11;2020-10-01;46;48;101;783071;811785;09;1594856
11;2020-10-01;257;249;528;761456;784653;19;1546109
11;2020-10-01;681;669;1353;850145;801772;29;1651917
11;2020-10-01;498;440;940;914360;843488;39;1757848
11;2020-10-01;362;304;668;845609;826202;49;1671811
11;2020-10-01;300;273;574;793566;745070;59;1538636
11;2020-10-01;155;171;327;628649;549192;69;1177841
11;2020-10-01;64;60;124;434606;358356;79;792962
11;2020-10-01;28;31;59;261425;162933;89;424358
11;2020-10-01;18;8;26;89253;32619;90;121872
11;2020-10-01;2409;2254;4705;6362140;5916070;0;12278210
24;2020-10-01;2;1;4;139720;144686;09;284406
24;2020-10-01;21;28;49;152979;161185;19;314164
24;2020-10-01;30;37;67;122237;126536;29;248773
24;2020-10-01;25;19;44;150359;142009;39;292368
24;2020-10-01;26;18;44;161829;158758;49;320587
24;2020-10-01;29;17;46;172552;168011;59;340563
24;2020-10-01;15;14;29;172509;158177;69;330686
24;2020-10-01;11;10;21;129428;110593;79;240021
24;2020-10-01;3;3;6;87342;56882;89;144224
24;2020-10-01;2;0;2;31210;12071;90;43281
24;2020-10-01;164;147;312;1320165;1238908;0;2559073
27;2020-10-01;6;3;10;143373;149679;09;293052
27;2020-10-01;19;28;47;160962;173003;19;333965
27;2020-10-01;25;24;49;133746;142254;29;276000
27;2020-10-01;28;27;55;160004;155407;39;315411
27;2020-10-01;26;20;46;172333;169564;49;341897
27;2020-10-01;26;24;50;189979;183788;59;373767
27;2020-10-01;12;15;27;192591;178206;69;370797
27;2020-10-01;17;10;27;146876;127546;79;274422
27;2020-10-01;8;3;11;96896;61575;89;158471
27;2020-10-01;2;3;5;33148;12109;90;45257
27;2020-10-01;169;157;327;1429908;1353131;0;2783039
28;2020-10-01;9;7;16;180735;186856;09;367591
28;2020-10-01;28;27;57;200125;213621;19;413746
28;2020-10-01;57;53;110;168922;173007;29;341929
28;2020-10-01;56;27;83;196628;188487;39;385115
28;2020-10-01;53;41;94;205396;201699;49;407095
28;2020-10-01;36;31;67;222002;213866;59;435868
28;2020-10-01;28;18;46;224688;203758;69;428446
28;2020-10-01;19;14;33;163192;135543;79;298735
28;2020-10-01;16;8;24;109691;65377;89;175068
28;2020-10-01;1;0;1;37222;12685;90;49907
28;2020-10-01;303;226;531;1708601;1594899;0;3303500
32;2020-10-01;14;20;34;358062;373689;09;731751
32;2020-10-01;123;122;245;387045;406742;19;793787
32;2020-10-01;187;202;390;342304;348587;29;690891
32;2020-10-01;127;104;231;382485;369972;39;752457
32;2020-10-01;145;124;269;382510;376716;49;759226
32;2020-10-01;112;92;204;386937;376527;59;763464
32;2020-10-01;59;63;122;371211;330938;69;702149
32;2020-10-01;44;35;79;250542;201459;79;452001
32;2020-10-01;25;26;51;163399;89786;89;253185
32;2020-10-01;23;5;28;48384;15367;90;63751
32;2020-10-01;859;794;1655;3072879;2889783;0;5962662
44;2020-10-01;6;2;8;291525;306839;09;598364
44;2020-10-01;34;33;67;320255;339504;19;659759
44;2020-10-01;65;62;127;302020;314428;29;616448
44;2020-10-01;34;24;58;342222;333292;39;675514
44;2020-10-01;41;44;85;349727;344491;49;694218
44;2020-10-01;35;27;62;381371;373239;59;754610
44;2020-10-01;14;23;37;367165;335850;69;703015
44;2020-10-01;14;11;25;250387;215436;79;465823
44;2020-10-01;13;2;15;170825;105192;89;276017
44;2020-10-01;13;2;15;51248;16731;90;67979
44;2020-10-01;269;230;499;2826745;2685002;0;5511747
52;2020-10-01;5;2;7;213594;223900;09;437494
52;2020-10-01;43;38;82;240818;255197;19;496015
52;2020-10-01;52;48;100;197010;200630;29;397640
52;2020-10-01;33;41;74;231204;224885;39;456089
52;2020-10-01;34;36;70;243874;243418;49;487292
52;2020-10-01;32;30;62;244100;239116;59;483216
52;2020-10-01;18;19;37;241796;221345;69;463141
52;2020-10-01;17;12;29;177805;149903;79;327708
52;2020-10-01;5;4;9;119561;75822;89;195383
52;2020-10-01;2;0;2;42559;15260;90;57819
52;2020-10-01;241;230;472;1952321;1849476;0;3801797
53;2020-10-01;3;6;9;173813;182358;09;356171
53;2020-10-01;32;39;72;202720;214740;19;417460
53;2020-10-01;49;57;109;163116;173196;29;336312
53;2020-10-01;18;23;41;190526;187674;39;378200
53;2020-10-01;13;13;26;212098;212015;49;424113
53;2020-10-01;21;19;40;223699;219176;59;442875
53;2020-10-01;10;11;21;227435;209274;69;436709
53;2020-10-01;12;6;18;169992;140910;79;310902
53;2020-10-01;5;6;11;118117;69883;89;188000
53;2020-10-01;4;6;10;37370;12267;90;49637
53;2020-10-01;167;186;357;1718886;1621493;0;3340379
75;2020-10-01;7;9;18;293104;305291;09;598395
75;2020-10-01;65;52;117;337141;357785;19;694926
75;2020-10-01;100;96;196;295024;300618;29;595642
75;2020-10-01;60;56;116;347871;331233;39;679104
75;2020-10-01;48;39;87;384742;372771;49;757513
75;2020-10-01;44;32;76;413361;390880;59;804241
75;2020-10-01;19;31;50;425623;384060;69;809683
75;2020-10-01;18;17;35;325086;276298;79;601384
75;2020-10-01;14;13;27;213986;139308;89;353294
75;2020-10-01;12;1;13;77600;28200;90;105800
75;2020-10-01;388;346;736;3113538;2886444;0;5999982
76;2020-10-01;13;11;25;305956;318589;09;624545
76;2020-10-01;98;124;228;338942;356969;19;695911
76;2020-10-01;143;147;290;316210;319570;29;635780
76;2020-10-01;106;91;198;356758;337587;39;694345
76;2020-10-01;111;85;196;376541;363812;49;740353
76;2020-10-01;79;91;170;402608;383750;59;786358
76;2020-10-01;73;42;115;394889;358997;69;753886
76;2020-10-01;28;28;56;308664;263806;79;572470
76;2020-10-01;18;11;29;195838;129272;89;325110
76;2020-10-01;8;11;19;69372;26728;90;96100
76;2020-10-01;677;642;1327;3065778;2859080;0;5924858
84;2020-10-01;24;26;50;459549;481088;09;940637
84;2020-10-01;164;155;324;487711;511905;19;999616
84;2020-10-01;261;241;502;443824;451094;29;894918
84;2020-10-01;144;180;324;512522;493262;39;1005784
84;2020-10-01;166;151;318;520248;515106;49;1035354
84;2020-10-01;128;123;251;529611;514848;59;1044459
84;2020-10-01;68;65;133;486720;439940;69;926660
84;2020-10-01;38;39;77;372151;315211;79;687362
84;2020-10-01;25;18;43;237198;150524;89;387722
84;2020-10-01;17;7;25;81185;28680;90;109865
84;2020-10-01;1036;1006;2049;4130719;3901658;0;8032377
93;2020-10-01;9;16;25;268834;283093;09;551927
93;2020-10-01;72;68;140;280751;296087;19;576838
93;2020-10-01;123;108;231;254404;255552;29;509956
93;2020-10-01;89;75;164;310704;288398;39;599102
93;2020-10-01;108;67;175;325559;305827;49;631386
93;2020-10-01;99;75;174;353104;325389;59;678493
93;2020-10-01;51;63;114;336327;296459;69;632786
93;2020-10-01;23;33;56;279820;229699;79;509519
93;2020-10-01;19;10;29;171274;113716;89;284990
93;2020-10-01;11;7;18;58896;21758;90;80654
93;2020-10-01;604;522;1127;2639673;2415978;0;5055651
94;2020-10-01;0;0;0;16311;17433;09;33744
94;2020-10-01;1;2;3;16679;18132;19;34811
94;2020-10-01;2;3;5;16782;16579;29;33361
94;2020-10-01;2;4;6;23044;20580;39;43624
94;2020-10-01;6;1;7;23065;22140;49;45205
94;2020-10-01;2;2;4;24549;23421;59;47970
94;2020-10-01;0;2;2;23212;21883;69;45095
94;2020-10-01;1;0;1;19544;17141;79;36685
94;2020-10-01;1;0;1;11227;8178;89;19405
94;2020-10-01;2;0;2;3332;1447;90;4779
94;2020-10-01;17;14;31;177745;166934;0;344679
01;2020-10-02;1;2;3;19979;20155;09;40134
01;2020-10-02;2;6;8;24994;25489;19;50483
01;2020-10-02;4;4;8;17868;16690;29;34558
01;2020-10-02;6;4;10;22328;14821;39;37149
01;2020-10-02;7;2;9;28652;20276;49;48928
01;2020-10-02;7;8;15;33264;27260;59;60524
01;2020-10-02;2;2;4;27135;23978;69;51113
01;2020-10-02;3;2;5;18401;14661;79;33062
01;2020-10-02;2;2;4;9633;6375;89;16008
01;2020-10-02;0;1;1;3410;1510;90;4920
01;2020-10-02;34;33;67;205664;171215;0;376879
02;2020-10-02;0;2;2;16881;17110;09;33991
02;2020-10-02;6;5;11;21410;21604;19;43014
02;2020-10-02;4;3;7;16017;15479;29;31496
02;2020-10-02;7;3;10;19825;14455;39;34280
02;2020-10-02;2;4;6;24719;18248;49;42967
02;2020-10-02;2;1;3;34361;28310;59;62671
02;2020-10-02;3;3;6;28061;24495;69;52556
02;2020-10-02;1;0;1;18231;15278;79;33509
02;2020-10-02;1;1;2;11090;7677;89;18767
02;2020-10-02;1;0;1;3992;1506;90;5498
02;2020-10-02;27;22;49;194587;164162;0;358749
03;2020-10-02;0;0;0;31123;30920;09;62043
03;2020-10-02;1;0;1;29370;29268;19;58638
03;2020-10-02;2;3;6;21458;18963;29;40421
03;2020-10-02;6;5;11;21276;18326;39;39602
03;2020-10-02;3;4;7;18164;16593;49;34757
03;2020-10-02;2;1;3;13469;13557;59;27026
03;2020-10-02;1;3;5;8776;8670;69;17446
03;2020-10-02;0;0;0;3777;3591;79;7368
03;2020-10-02;0;0;0;1649;1072;89;2721
03;2020-10-02;0;0;0;485;184;90;669
03;2020-10-02;15;16;33;149547;141144;0;290691
04;2020-10-02;2;4;6;60314;61377;09;121691
04;2020-10-02;6;6;12;66065;68387;19;134452
04;2020-10-02;7;8;15;51059;47156;29;98215
04;2020-10-02;5;0;5;58788;45780;39;104568
04;2020-10-02;6;1;7;61408;52207;49;113615
04;2020-10-02;3;8;11;64838;60759;59;125597
04;2020-10-02;1;0;1;47008;42843;69;89851
04;2020-10-02;1;1;2;25509;21184;79;46693
04;2020-10-02;0;2;2;13168;7647;89;20815
04;2020-10-02;0;0;0;3209;1253;90;4462
04;2020-10-02;31;30;61;451366;408593;0;859959
05;2020-10-02;0;0;0;362.366008612902;341.338819562748;09;703.704828175651
05;2020-10-02;0;0;0;353.376145114279;370.349735405642;19;723.725880519921
05;2020-10-02;0;0;0;218.593559489256;256.539602589476;29;475.133162078732
05;2020-10-02;0;0;0;404.225408693299;360.321910454353;39;764.547319147651
05;2020-10-02;0;0;0;520.067953604221;497.108383964256;49;1017.17633756848
05;2020-10-02;0;0;0;468.146063921917;510.087601910415;59;978.233665832332
05;2020-10-02;0;0;0;340.368470050554;334.366842191253;69;674.735312241807
05;2020-10-02;0;0;0;212.598666888387;192.597753227106;79;405.196420115493
05;2020-10-02;0;0;0;148.727797095705;61.8681715431829;89;210.595968638888
05;2020-10-02;0;0;0;32.9601271090696;10.9909785719784;90;43.9511056810479
05;2020-10-02;0;0;0;3061.43020057959;2935.56979942041;0;5997
06;2020-10-02;2;0;2;42583;42380;09;84963
06;2020-10-02;1;4;5;33369;31925;19;65294
06;2020-10-02;4;1;5;21571;15080;29;36651
06;2020-10-02;4;1;5;21550;16147;39;37697
06;2020-10-02;2;1;3;14193;13939;49;28132
06;2020-10-02;1;2;3;7171;7597;59;14768
06;2020-10-02;0;2;2;3629;4117;69;7746
06;2020-10-02;1;2;3;1577;1457;79;3034
06;2020-10-02;0;0;0;531;474;89;1005
06;2020-10-02;0;0;0;88;93;90;181
06;2020-10-02;15;13;28;146262;133209;0;279471
07;2020-10-02;0;0;0;485;549;09;1034
07;2020-10-02;0;0;0;403;432;19;835
07;2020-10-02;0;0;0;764;841;29;1605
07;2020-10-02;0;0;0;824;928;39;1752
07;2020-10-02;0;1;1;788;1020;49;1808
07;2020-10-02;0;0;0;678;870;59;1548
07;2020-10-02;0;0;0;360;382;69;742
07;2020-10-02;0;0;0;231;190;79;421
07;2020-10-02;0;0;0;114;67;89;181
07;2020-10-02;0;0;0;24;11;90;35
07;2020-10-02;0;1;1;4671;5290;0;9961
08;2020-10-02;0;0;0;2715.22592983026;2997.75551488675;09;5712.98144471701
08;2020-10-02;0;0;0;2778.51901080978;3160.9156459093;19;5939.43465671908
08;2020-10-02;1;0;1;2080.8882988764;1718.16634315323;29;3799.05464202964
08;2020-10-02;1;3;4;2701.8582062647;1896.52641413317;39;4598.38462039786
08;2020-10-02;1;0;1;3151.45861023308;2460.52498233809;49;5611.98359257117
08;2020-10-02;1;1;2;2620.29868333099;2422.23566154656;59;5042.53434487755
08;2020-10-02;2;0;2;1621.44173420671;1438.58325779464;69;3060.02499200135
08;2020-10-02;0;0;0;626.575909335673;526.358467843651;79;1152.93437717932
08;2020-10-02;0;0;0;205.018522985054;140.993639349697;89;346.012162334751
08;2020-10-02;0;0;0;50.0325684687745;20.62259870351;90;70.6551671722846
08;2020-10-02;6;4;10;18551.3174743414;16782.6825256586;0;35334
11;2020-10-02;51;45;105;783071;811785;09;1594856
11;2020-10-02;280;256;555;761456;784653;19;1546109
11;2020-10-02;706;619;1329;850145;801772;29;1651917
11;2020-10-02;530;469;999;914360;843488;39;1757848
11;2020-10-02;425;340;768;845609;826202;49;1671811
11;2020-10-02;347;268;617;793566;745070;59;1538636
11;2020-10-02;194;170;365;628649;549192;69;1177841
11;2020-10-02;73;79;153;434606;358356;79;792962
11;2020-10-02;60;40;100;261425;162933;89;424358
11;2020-10-02;32;13;45;89253;32619;90;121872
11;2020-10-02;2698;2300;5040;6362140;5916070;0;12278210
24;2020-10-02;2;3;5;139720;144686;09;284406
24;2020-10-02;22;18;41;152979;161185;19;314164
24;2020-10-02;41;37;78;122237;126536;29;248773
24;2020-10-02;30;21;51;150359;142009;39;292368
24;2020-10-02;24;24;48;161829;158758;49;320587
24;2020-10-02;26;23;49;172552;168011;59;340563
24;2020-10-02;16;17;33;172509;158177;69;330686
24;2020-10-02;7;6;13;129428;110593;79;240021
24;2020-10-02;9;3;12;87342;56882;89;144224
24;2020-10-02;2;0;2;31210;12071;90;43281
24;2020-10-02;179;152;332;1320165;1238908;0;2559073
27;2020-10-02;10;3;13;143373;149679;09;293052
27;2020-10-02;28;19;48;160962;173003;19;333965
27;2020-10-02;33;28;61;133746;142254;29;276000
27;2020-10-02;23;28;51;160004;155407;39;315411
27;2020-10-02;28;26;54;172333;169564;49;341897
27;2020-10-02;27;33;60;189979;183788;59;373767
27;2020-10-02;24;13;37;192591;178206;69;370797
27;2020-10-02;13;17;30;146876;127546;79;274422
27;2020-10-02;10;8;18;96896;61575;89;158471
27;2020-10-02;11;4;15;33148;12109;90;45257
27;2020-10-02;207;179;387;1429908;1353131;0;2783039
28;2020-10-02;5;9;14;180735;186856;09;367591
28;2020-10-02;45;52;98;200125;213621;19;413746
28;2020-10-02;81;61;142;168922;173007;29;341929
28;2020-10-02;48;36;84;196628;188487;39;385115
28;2020-10-02;43;34;77;205396;201699;49;407095
28;2020-10-02;45;35;80;222002;213866;59;435868
28;2020-10-02;41;37;78;224688;203758;69;428446
28;2020-10-02;20;30;50;163192;135543;79;298735
28;2020-10-02;11;7;18;109691;65377;89;175068
28;2020-10-02;8;0;8;37222;12685;90;49907
28;2020-10-02;347;301;649;1708601;1594899;0;3303500
32;2020-10-02;20;25;45;358062;373689;09;731751
32;2020-10-02;155;137;292;387045;406742;19;793787
32;2020-10-02;203;222;425;342304;348587;29;690891
32;2020-10-02;154;120;274;382485;369972;39;752457
32;2020-10-02;146;123;269;382510;376716;49;759226
32;2020-10-02;119;95;214;386937;376527;59;763464
32;2020-10-02;91;75;168;371211;330938;69;702149
32;2020-10-02;51;41;92;250542;201459;79;452001
32;2020-10-02;48;24;72;163399;89786;89;253185
32;2020-10-02;31;14;46;48384;15367;90;63751
32;2020-10-02;1019;876;1898;3072879;2889783;0;5962662
44;2020-10-02;8;4;12;291525;306839;09;598364
44;2020-10-02;36;46;82;320255;339504;19;659759
44;2020-10-02;66;62;128;302020;314428;29;616448
44;2020-10-02;45;33;78;342222;333292;39;675514
44;2020-10-02;44;26;70;349727;344491;49;694218
44;2020-10-02;36;33;69;381371;373239;59;754610
44;2020-10-02;23;18;41;367165;335850;69;703015
44;2020-10-02;12;15;27;250387;215436;79;465823
44;2020-10-02;6;3;9;170825;105192;89;276017
44;2020-10-02;4;3;7;51248;16731;90;67979
44;2020-10-02;280;243;523;2826745;2685002;0;5511747
52;2020-10-02;7;6;15;213594;223900;09;437494
52;2020-10-02;42;46;91;240818;255197;19;496015
52;2020-10-02;65;77;143;197010;200630;29;397640
52;2020-10-02;46;42;88;231204;224885;39;456089
52;2020-10-02;48;39;87;243874;243418;49;487292
52;2020-10-02;39;32;71;244100;239116;59;483216
52;2020-10-02;19;21;40;241796;221345;69;463141
52;2020-10-02;14;15;29;177805;149903;79;327708
52;2020-10-02;7;8;15;119561;75822;89;195383
52;2020-10-02;1;2;3;42559;15260;90;57819
52;2020-10-02;288;288;582;1952321;1849476;0;3801797
53;2020-10-02;4;3;8;173813;182358;09;356171
53;2020-10-02;29;24;54;202720;214740;19;417460
53;2020-10-02;45;52;98;163116;173196;29;336312
53;2020-10-02;23;25;48;190526;187674;39;378200
53;2020-10-02;15;23;38;212098;212015;49;424113
53;2020-10-02;21;19;40;223699;219176;59;442875
53;2020-10-02;15;15;30;227435;209274;69;436709
53;2020-10-02;13;11;24;169992;140910;79;310902
53;2020-10-02;8;3;11;118117;69883;89;188000
53;2020-10-02;2;1;3;37370;12267;90;49637
53;2020-10-02;175;176;354;1718886;1621493;0;3340379
75;2020-10-02;11;9;20;293104;305291;09;598395
75;2020-10-02;69;50;119;337141;357785;19;694926
75;2020-10-02;74;92;166;295024;300618;29;595642
75;2020-10-02;56;47;103;347871;331233;39;679104
75;2020-10-02;50;51;101;384742;372771;49;757513
75;2020-10-02;56;44;100;413361;390880;59;804241
75;2020-10-02;31;27;58;425623;384060;69;809683
75;2020-10-02;18;13;31;325086;276298;79;601384
75;2020-10-02;9;8;17;213986;139308;89;353294
75;2020-10-02;11;4;15;77600;28200;90;105800
75;2020-10-02;385;345;730;3113538;2886444;0;5999982
76;2020-10-02;15;12;27;305956;318589;09;624545
76;2020-10-02;94;123;220;338942;356969;19;695911
76;2020-10-02;187;144;333;316210;319570;29;635780
76;2020-10-02;96;84;181;356758;337587;39;694345
76;2020-10-02;118;93;212;376541;363812;49;740353
76;2020-10-02;121;89;210;402608;383750;59;786358
76;2020-10-02;63;69;132;394889;358997;69;753886
76;2020-10-02;38;37;75;308664;263806;79;572470
76;2020-10-02;38;13;51;195838;129272;89;325110
76;2020-10-02;34;7;42;69372;26728;90;96100
76;2020-10-02;804;671;1483;3065778;2859080;0;5924858
84;2020-10-02;39;28;67;459549;481088;09;940637
84;2020-10-02;213;171;387;487711;511905;19;999616
84;2020-10-02;308;285;594;443824;451094;29;894918
84;2020-10-02;185;179;364;512522;493262;39;1005784
84;2020-10-02;197;163;360;520248;515106;49;1035354
84;2020-10-02;145;163;308;529611;514848;59;1044459
84;2020-10-02;76;80;156;486720;439940;69;926660
84;2020-10-02;52;52;104;372151;315211;79;687362
84;2020-10-02;40;32;72;237198;150524;89;387722
84;2020-10-02;20;13;33;81185;28680;90;109865
84;2020-10-02;1276;1166;2446;4130719;3901658;0;8032377
93;2020-10-02;10;12;22;268834;283093;09;551927
93;2020-10-02;93;91;185;280751;296087;19;576838
93;2020-10-02;124;111;235;254404;255552;29;509956
93;2020-10-02;105;89;194;310704;288398;39;599102
93;2020-10-02;109;106;216;325559;305827;49;631386
93;2020-10-02;101;97;198;353104;325389;59;678493
93;2020-10-02;64;62;126;336327;296459;69;632786
93;2020-10-02;36;49;85;279820;229699;79;509519
93;2020-10-02;20;18;39;171274;113716;89;284990
93;2020-10-02;17;3;20;58896;21758;90;80654
93;2020-10-02;679;639;1321;2639673;2415978;0;5055651
94;2020-10-02;0;1;1;16311;17433;09;33744
94;2020-10-02;2;2;4;16679;18132;19;34811
94;2020-10-02;2;2;4;16782;16579;29;33361
94;2020-10-02;4;3;7;23044;20580;39;43624
94;2020-10-02;1;2;3;23065;22140;49;45205
94;2020-10-02;2;3;5;24549;23421;59;47970
94;2020-10-02;1;2;3;23212;21883;69;45095
94;2020-10-02;2;0;2;19544;17141;79;36685
94;2020-10-02;1;0;1;11227;8178;89;19405
94;2020-10-02;0;0;0;3332;1447;90;4779
94;2020-10-02;15;15;30;177745;166934;0;344679
01;2020-10-03;0;0;0;19979;20155;09;40134
01;2020-10-03;0;1;1;24994;25489;19;50483
01;2020-10-03;0;0;0;17868;16690;29;34558
01;2020-10-03;2;0;2;22328;14821;39;37149
01;2020-10-03;0;1;1;28652;20276;49;48928
01;2020-10-03;3;4;7;33264;27260;59;60524
01;2020-10-03;4;4;8;27135;23978;69;51113
01;2020-10-03;2;2;4;18401;14661;79;33062
01;2020-10-03;0;2;2;9633;6375;89;16008
01;2020-10-03;1;1;2;3410;1510;90;4920
01;2020-10-03;12;15;27;205664;171215;0;376879
02;2020-10-03;0;0;0;16881;17110;09;33991
02;2020-10-03;1;2;3;21410;21604;19;43014
02;2020-10-03;0;0;0;16017;15479;29;31496
02;2020-10-03;4;3;7;19825;14455;39;34280
02;2020-10-03;3;1;4;24719;18248;49;42967
02;2020-10-03;0;1;1;34361;28310;59;62671
02;2020-10-03;0;1;1;28061;24495;69;52556
02;2020-10-03;1;0;1;18231;15278;79;33509
02;2020-10-03;0;0;0;11090;7677;89;18767
02;2020-10-03;1;0;1;3992;1506;90;5498
02;2020-10-03;10;8;18;194587;164162;0;358749
03;2020-10-03;0;0;0;31123;30920;09;62043
03;2020-10-03;4;4;8;29370;29268;19;58638
03;2020-10-03;0;1;2;21458;18963;29;40421
03;2020-10-03;2;1;3;21276;18326;39;39602
03;2020-10-03;1;0;1;18164;16593;49;34757
03;2020-10-03;0;1;1;13469;13557;59;27026
03;2020-10-03;0;1;1;8776;8670;69;17446
03;2020-10-03;0;1;1;3777;3591;79;7368
03;2020-10-03;0;0;0;1649;1072;89;2721
03;2020-10-03;0;0;0;485;184;90;669
03;2020-10-03;7;9;17;149547;141144;0;290691
04;2020-10-03;0;2;2;60314;61377;09;121691
04;2020-10-03;4;0;4;66065;68387;19;134452
04;2020-10-03;3;1;4;51059;47156;29;98215
04;2020-10-03;3;2;5;58788;45780;39;104568
04;2020-10-03;5;2;7;61408;52207;49;113615
04;2020-10-03;0;1;1;64838;60759;59;125597
04;2020-10-03;0;2;2;47008;42843;69;89851
04;2020-10-03;0;2;2;25509;21184;79;46693
04;2020-10-03;2;1;3;13168;7647;89;20815
04;2020-10-03;0;0;0;3209;1253;90;4462
04;2020-10-03;17;13;30;451366;408593;0;859959
05;2020-10-03;0;0;0;362.366008612902;341.338819562748;09;703.704828175651
05;2020-10-03;0;0;0;353.376145114279;370.349735405642;19;723.725880519921
05;2020-10-03;0;0;0;218.593559489256;256.539602589476;29;475.133162078732
05;2020-10-03;0;0;0;404.225408693299;360.321910454353;39;764.547319147651
05;2020-10-03;0;0;0;520.067953604221;497.108383964256;49;1017.17633756848
05;2020-10-03;0;0;0;468.146063921917;510.087601910415;59;978.233665832332
05;2020-10-03;0;0;0;340.368470050554;334.366842191253;69;674.735312241807
05;2020-10-03;0;0;0;212.598666888387;192.597753227106;79;405.196420115493
05;2020-10-03;0;0;0;148.727797095705;61.8681715431829;89;210.595968638888
05;2020-10-03;0;0;0;32.9601271090696;10.9909785719784;90;43.9511056810479
05;2020-10-03;0;0;0;3061.43020057959;2935.56979942041;0;5997
06;2020-10-03;0;0;0;42583;42380;09;84963
06;2020-10-03;0;0;0;33369;31925;19;65294
06;2020-10-03;0;0;0;21571;15080;29;36651
06;2020-10-03;1;0;1;21550;16147;39;37697
06;2020-10-03;0;1;1;14193;13939;49;28132
06;2020-10-03;0;0;0;7171;7597;59;14768
06;2020-10-03;0;1;1;3629;4117;69;7746
06;2020-10-03;0;0;0;1577;1457;79;3034
06;2020-10-03;0;0;0;531;474;89;1005
06;2020-10-03;0;0;0;88;93;90;181
06;2020-10-03;1;2;3;146262;133209;0;279471
07;2020-10-03;0;0;0;485;549;09;1034
07;2020-10-03;0;0;0;403;432;19;835
07;2020-10-03;0;0;0;764;841;29;1605
07;2020-10-03;0;0;0;824;928;39;1752
07;2020-10-03;0;0;0;788;1020;49;1808
07;2020-10-03;0;0;0;678;870;59;1548
07;2020-10-03;0;0;0;360;382;69;742
07;2020-10-03;0;0;0;231;190;79;421
07;2020-10-03;0;0;0;114;67;89;181
07;2020-10-03;0;0;0;24;11;90;35
07;2020-10-03;0;0;0;4671;5290;0;9961
08;2020-10-03;0;0;0;2715.22592983026;2997.75551488675;09;5712.98144471701
08;2020-10-03;0;0;0;2778.51901080978;3160.9156459093;19;5939.43465671908
08;2020-10-03;0;1;1;2080.8882988764;1718.16634315323;29;3799.05464202964
08;2020-10-03;0;0;0;2701.8582062647;1896.52641413317;39;4598.38462039786
08;2020-10-03;0;0;0;3151.45861023308;2460.52498233809;49;5611.98359257117
08;2020-10-03;0;0;0;2620.29868333099;2422.23566154656;59;5042.53434487755
08;2020-10-03;0;1;1;1621.44173420671;1438.58325779464;69;3060.02499200135
08;2020-10-03;0;0;0;626.575909335673;526.358467843651;79;1152.93437717932
08;2020-10-03;0;0;0;205.018522985054;140.993639349697;89;346.012162334751
08;2020-10-03;0;0;0;50.0325684687745;20.62259870351;90;70.6551671722846
08;2020-10-03;0;2;2;18551.3174743414;16782.6825256586;0;35334
11;2020-10-03;19;22;48;783071;811785;09;1594856
11;2020-10-03;139;133;286;761456;784653;19;1546109
11;2020-10-03;337;279;616;850145;801772;29;1651917
11;2020-10-03;245;215;461;914360;843488;39;1757848
11;2020-10-03;152;161;314;845609;826202;49;1671811
11;2020-10-03;177;147;324;793566;745070;59;1538636
11;2020-10-03;99;88;191;628649;549192;69;1177841
11;2020-10-03;46;46;92;434606;358356;79;792962
11;2020-10-03;26;19;45;261425;162933;89;424358
11;2020-10-03;16;6;22;89253;32619;90;121872
11;2020-10-03;1257;1118;2402;6362140;5916070;0;12278210
24;2020-10-03;0;1;1;139720;144686;09;284406
24;2020-10-03;11;13;24;152979;161185;19;314164
24;2020-10-03;17;19;36;122237;126536;29;248773
24;2020-10-03;12;14;26;150359;142009;39;292368
24;2020-10-03;17;14;31;161829;158758;49;320587
24;2020-10-03;11;14;25;172552;168011;59;340563
24;2020-10-03;8;7;15;172509;158177;69;330686
24;2020-10-03;5;2;7;129428;110593;79;240021
24;2020-10-03;4;1;5;87342;56882;89;144224
24;2020-10-03;1;0;1;31210;12071;90;43281
24;2020-10-03;86;85;171;1320165;1238908;0;2559073
27;2020-10-03;1;5;6;143373;149679;09;293052
27;2020-10-03;9;12;21;160962;173003;19;333965
27;2020-10-03;18;22;40;133746;142254;29;276000
27;2020-10-03;13;13;26;160004;155407;39;315411
27;2020-10-03;19;13;32;172333;169564;49;341897
27;2020-10-03;13;17;30;189979;183788;59;373767
27;2020-10-03;16;6;22;192591;178206;69;370797
27;2020-10-03;4;13;17;146876;127546;79;274422
27;2020-10-03;4;1;5;96896;61575;89;158471
27;2020-10-03;2;2;4;33148;12109;90;45257
27;2020-10-03;99;104;203;1429908;1353131;0;2783039
28;2020-10-03;10;7;17;180735;186856;09;367591
28;2020-10-03;21;21;44;200125;213621;19;413746
28;2020-10-03;29;31;60;168922;173007;29;341929
28;2020-10-03;31;21;52;196628;188487;39;385115
28;2020-10-03;22;19;41;205396;201699;49;407095
28;2020-10-03;12;20;32;222002;213866;59;435868
28;2020-10-03;8;8;16;224688;203758;69;428446
28;2020-10-03;8;11;19;163192;135543;79;298735
28;2020-10-03;6;7;13;109691;65377;89;175068
28;2020-10-03;1;1;2;37222;12685;90;49907
28;2020-10-03;149;146;297;1708601;1594899;0;3303500
32;2020-10-03;16;10;26;358062;373689;09;731751
32;2020-10-03;72;57;129;387045;406742;19;793787
32;2020-10-03;89;89;178;342304;348587;29;690891
32;2020-10-03;63;61;124;382485;369972;39;752457
32;2020-10-03;69;57;126;382510;376716;49;759226
32;2020-10-03;49;57;106;386937;376527;59;763464
32;2020-10-03;32;33;65;371211;330938;69;702149
32;2020-10-03;16;21;37;250542;201459;79;452001
32;2020-10-03;11;11;22;163399;89786;89;253185
32;2020-10-03;6;1;7;48384;15367;90;63751
32;2020-10-03;423;397;820;3072879;2889783;0;5962662
44;2020-10-03;6;4;10;291525;306839;09;598364
44;2020-10-03;19;20;39;320255;339504;19;659759
44;2020-10-03;30;32;62;302020;314428;29;616448
44;2020-10-03;30;25;55;342222;333292;39;675514
44;2020-10-03;24;32;56;349727;344491;49;694218
44;2020-10-03;18;22;40;381371;373239;59;754610
44;2020-10-03;14;6;20;367165;335850;69;703015
44;2020-10-03;12;13;25;250387;215436;79;465823
44;2020-10-03;8;5;13;170825;105192;89;276017
44;2020-10-03;2;0;2;51248;16731;90;67979
44;2020-10-03;163;159;322;2826745;2685002;0;5511747
52;2020-10-03;4;5;9;213594;223900;09;437494
52;2020-10-03;22;26;48;240818;255197;19;496015
52;2020-10-03;28;50;78;197010;200630;29;397640
52;2020-10-03;25;28;53;231204;224885;39;456089
52;2020-10-03;20;18;38;243874;243418;49;487292
52;2020-10-03;20;21;41;244100;239116;59;483216
52;2020-10-03;10;14;24;241796;221345;69;463141
52;2020-10-03;9;8;17;177805;149903;79;327708
52;2020-10-03;8;1;9;119561;75822;89;195383
52;2020-10-03;0;0;0;42559;15260;90;57819
52;2020-10-03;146;171;317;1952321;1849476;0;3801797
53;2020-10-03;3;1;4;173813;182358;09;356171
53;2020-10-03;12;16;28;202720;214740;19;417460
53;2020-10-03;32;19;51;163116;173196;29;336312
53;2020-10-03;18;14;32;190526;187674;39;378200
53;2020-10-03;13;18;31;212098;212015;49;424113
53;2020-10-03;15;9;24;223699;219176;59;442875
53;2020-10-03;7;10;17;227435;209274;69;436709
53;2020-10-03;3;3;6;169992;140910;79;310902
53;2020-10-03;7;5;12;118117;69883;89;188000
53;2020-10-03;5;2;7;37370;12267;90;49637
53;2020-10-03;115;97;212;1718886;1621493;0;3340379
75;2020-10-03;1;1;2;293104;305291;09;598395
75;2020-10-03;23;35;58;337141;357785;19;694926
75;2020-10-03;35;48;84;295024;300618;29;595642
75;2020-10-03;21;27;48;347871;331233;39;679104
75;2020-10-03;24;23;47;384742;372771;49;757513
75;2020-10-03;23;21;45;413361;390880;59;804241
75;2020-10-03;21;11;32;425623;384060;69;809683
75;2020-10-03;5;11;16;325086;276298;79;601384
75;2020-10-03;4;5;9;213986;139308;89;353294
75;2020-10-03;4;1;5;77600;28200;90;105800
75;2020-10-03;161;183;346;3113538;2886444;0;5999982
76;2020-10-03;3;7;10;305956;318589;09;624545
76;2020-10-03;64;57;123;338942;356969;19;695911
76;2020-10-03;83;61;144;316210;319570;29;635780
76;2020-10-03;54;42;96;356758;337587;39;694345
76;2020-10-03;53;43;96;376541;363812;49;740353
76;2020-10-03;43;34;77;402608;383750;59;786358
76;2020-10-03;26;28;54;394889;358997;69;753886
76;2020-10-03;20;18;38;308664;263806;79;572470
76;2020-10-03;24;11;35;195838;129272;89;325110
76;2020-10-03;27;8;35;69372;26728;90;96100
76;2020-10-03;398;310;710;3065778;2859080;0;5924858
84;2020-10-03;17;13;30;459549;481088;09;940637
84;2020-10-03;64;58;125;487711;511905;19;999616
84;2020-10-03;83;87;170;443824;451094;29;894918
84;2020-10-03;64;69;133;512522;493262;39;1005784
84;2020-10-03;73;59;133;520248;515106;49;1035354
84;2020-10-03;60;63;123;529611;514848;59;1044459
84;2020-10-03;36;39;75;486720;439940;69;926660
84;2020-10-03;22;20;42;372151;315211;79;687362
84;2020-10-03;17;9;26;237198;150524;89;387722
84;2020-10-03;1;7;8;81185;28680;90;109865
84;2020-10-03;437;424;865;4130719;3901658;0;8032377
93;2020-10-03;3;4;7;268834;283093;09;551927
93;2020-10-03;20;19;39;280751;296087;19;576838
93;2020-10-03;44;30;74;254404;255552;29;509956
93;2020-10-03;17;17;34;310704;288398;39;599102
93;2020-10-03;21;28;49;325559;305827;49;631386
93;2020-10-03;35;31;66;353104;325389;59;678493
93;2020-10-03;18;20;38;336327;296459;69;632786
93;2020-10-03;9;10;19;279820;229699;79;509519
93;2020-10-03;8;8;16;171274;113716;89;284990
93;2020-10-03;7;2;9;58896;21758;90;80654
93;2020-10-03;182;169;351;2639673;2415978;0;5055651
94;2020-10-03;0;0;0;16311;17433;09;33744
94;2020-10-03;0;1;1;16679;18132;19;34811
94;2020-10-03;0;0;0;16782;16579;29;33361
94;2020-10-03;3;0;3;23044;20580;39;43624
94;2020-10-03;0;0;0;23065;22140;49;45205
94;2020-10-03;1;1;2;24549;23421;59;47970
94;2020-10-03;0;0;0;23212;21883;69;45095
94;2020-10-03;0;0;0;19544;17141;79;36685
94;2020-10-03;0;0;0;11227;8178;89;19405
94;2020-10-03;1;0;1;3332;1447;90;4779
94;2020-10-03;5;2;7;177745;166934;0;344679
01;2020-10-04;1;2;3;19979;20155;09;40134
01;2020-10-04;1;0;1;24994;25489;19;50483
01;2020-10-04;3;4;7;17868;16690;29;34558
01;2020-10-04;2;0;2;22328;14821;39;37149
01;2020-10-04;1;1;2;28652;20276;49;48928
01;2020-10-04;0;4;4;33264;27260;59;60524
01;2020-10-04;2;4;6;27135;23978;69;51113
01;2020-10-04;1;0;1;18401;14661;79;33062
01;2020-10-04;1;0;1;9633;6375;89;16008
01;2020-10-04;0;0;0;3410;1510;90;4920
01;2020-10-04;12;15;27;205664;171215;0;376879
02;2020-10-04;0;0;0;16881;17110;09;33991
02;2020-10-04;0;0;0;21410;21604;19;43014
02;2020-10-04;0;0;0;16017;15479;29;31496
02;2020-10-04;0;0;0;19825;14455;39;34280
02;2020-10-04;0;0;0;24719;18248;49;42967
02;2020-10-04;1;0;1;34361;28310;59;62671
02;2020-10-04;0;0;0;28061;24495;69;52556
02;2020-10-04;0;1;1;18231;15278;79;33509
02;2020-10-04;1;0;1;11090;7677;89;18767
02;2020-10-04;0;0;0;3992;1506;90;5498
02;2020-10-04;2;1;3;194587;164162;0;358749
03;2020-10-04;0;0;0;31123;30920;09;62043
03;2020-10-04;0;0;0;29370;29268;19;58638
03;2020-10-04;0;2;2;21458;18963;29;40421
03;2020-10-04;2;0;2;21276;18326;39;39602
03;2020-10-04;1;2;3;18164;16593;49;34757
03;2020-10-04;1;2;3;13469;13557;59;27026
03;2020-10-04;3;0;3;8776;8670;69;17446
03;2020-10-04;0;0;0;3777;3591;79;7368
03;2020-10-04;0;0;0;1649;1072;89;2721
03;2020-10-04;0;0;0;485;184;90;669
03;2020-10-04;7;6;13;149547;141144;0;290691
04;2020-10-04;0;1;1;60314;61377;09;121691
04;2020-10-04;2;0;2;66065;68387;19;134452
04;2020-10-04;0;0;0;51059;47156;29;98215
04;2020-10-04;0;0;0;58788;45780;39;104568
04;2020-10-04;0;0;0;61408;52207;49;113615
04;2020-10-04;1;0;1;64838;60759;59;125597
04;2020-10-04;0;0;0;47008;42843;69;89851
04;2020-10-04;0;0;0;25509;21184;79;46693
04;2020-10-04;0;0;0;13168;7647;89;20815
04;2020-10-04;0;0;0;3209;1253;90;4462
04;2020-10-04;3;1;4;451366;408593;0;859959
05;2020-10-04;0;0;0;362.366008612902;341.338819562748;09;703.704828175651
05;2020-10-04;0;0;0;353.376145114279;370.349735405642;19;723.725880519921
05;2020-10-04;0;0;0;218.593559489256;256.539602589476;29;475.133162078732
05;2020-10-04;0;0;0;404.225408693299;360.321910454353;39;764.547319147651
05;2020-10-04;0;0;0;520.067953604221;497.108383964256;49;1017.17633756848
05;2020-10-04;0;0;0;468.146063921917;510.087601910415;59;978.233665832332
05;2020-10-04;0;0;0;340.368470050554;334.366842191253;69;674.735312241807
05;2020-10-04;0;0;0;212.598666888387;192.597753227106;79;405.196420115493
05;2020-10-04;0;0;0;148.727797095705;61.8681715431829;89;210.595968638888
05;2020-10-04;0;0;0;32.9601271090696;10.9909785719784;90;43.9511056810479
05;2020-10-04;0;0;0;3061.43020057959;2935.56979942041;0;5997
06;2020-10-04;0;0;0;42583;42380;09;84963
06;2020-10-04;0;0;0;33369;31925;19;65294
06;2020-10-04;0;0;0;21571;15080;29;36651
06;2020-10-04;0;0;0;21550;16147;39;37697
06;2020-10-04;0;0;0;14193;13939;49;28132
06;2020-10-04;0;0;0;7171;7597;59;14768
06;2020-10-04;0;1;1;3629;4117;69;7746
06;2020-10-04;0;0;0;1577;1457;79;3034
06;2020-10-04;0;0;0;531;474;89;1005
06;2020-10-04;0;0;0;88;93;90;181
06;2020-10-04;0;1;1;146262;133209;0;279471
07;2020-10-04;0;0;0;485;549;09;1034
07;2020-10-04;0;0;0;403;432;19;835
07;2020-10-04;0;0;0;764;841;29;1605
07;2020-10-04;0;0;0;824;928;39;1752
07;2020-10-04;0;0;0;788;1020;49;1808
07;2020-10-04;0;0;0;678;870;59;1548
07;2020-10-04;0;0;0;360;382;69;742
07;2020-10-04;0;0;0;231;190;79;421
07;2020-10-04;0;0;0;114;67;89;181
07;2020-10-04;0;0;0;24;11;90;35
07;2020-10-04;0;0;0;4671;5290;0;9961
08;2020-10-04;0;0;0;2715.22592983026;2997.75551488675;09;5712.98144471701
08;2020-10-04;0;0;0;2778.51901080978;3160.9156459093;19;5939.43465671908
08;2020-10-04;0;0;0;2080.8882988764;1718.16634315323;29;3799.05464202964
08;2020-10-04;0;0;0;2701.8582062647;1896.52641413317;39;4598.38462039786
08;2020-10-04;0;0;0;3151.45861023308;2460.52498233809;49;5611.98359257117
08;2020-10-04;0;0;0;2620.29868333099;2422.23566154656;59;5042.53434487755
08;2020-10-04;0;0;0;1621.44173420671;1438.58325779464;69;3060.02499200135
08;2020-10-04;0;0;0;626.575909335673;526.358467843651;79;1152.93437717932
08;2020-10-04;0;0;0;205.018522985054;140.993639349697;89;346.012162334751
08;2020-10-04;0;0;0;50.0325684687745;20.62259870351;90;70.6551671722846
08;2020-10-04;0;0;0;18551.3174743414;16782.6825256586;0;35334
11;2020-10-04;4;4;8;783071;811785;09;1594856
11;2020-10-04;27;29;56;761456;784653;19;1546109
11;2020-10-04;87;71;158;850145;801772;29;1651917
11;2020-10-04;45;64;109;914360;843488;39;1757848
11;2020-10-04;41;35;76;845609;826202;49;1671811
11;2020-10-04;40;41;81;793566;745070;59;1538636
11;2020-10-04;38;31;69;628649;549192;69;1177841
11;2020-10-04;16;21;37;434606;358356;79;792962
11;2020-10-04;9;20;29;261425;162933;89;424358
11;2020-10-04;7;2;9;89253;32619;90;121872
11;2020-10-04;314;318;632;6362140;5916070;0;12278210
24;2020-10-04;1;0;1;139720;144686;09;284406
24;2020-10-04;4;4;8;152979;161185;19;314164
24;2020-10-04;5;6;11;122237;126536;29;248773
24;2020-10-04;2;0;2;150359;142009;39;292368
24;2020-10-04;5;3;8;161829;158758;49;320587
24;2020-10-04;2;1;3;172552;168011;59;340563
24;2020-10-04;2;3;5;172509;158177;69;330686
24;2020-10-04;2;1;3;129428;110593;79;240021
24;2020-10-04;1;0;1;87342;56882;89;144224
24;2020-10-04;0;0;0;31210;12071;90;43281
24;2020-10-04;24;18;42;1320165;1238908;0;2559073
27;2020-10-04;2;2;4;143373;149679;09;293052
27;2020-10-04;2;1;3;160962;173003;19;333965
27;2020-10-04;3;5;8;133746;142254;29;276000
27;2020-10-04;2;2;4;160004;155407;39;315411
27;2020-10-04;1;4;5;172333;169564;49;341897
27;2020-10-04;2;2;4;189979;183788;59;373767
27;2020-10-04;0;1;1;192591;178206;69;370797
27;2020-10-04;1;1;2;146876;127546;79;274422
27;2020-10-04;0;2;2;96896;61575;89;158471
27;2020-10-04;1;0;1;33148;12109;90;45257
27;2020-10-04;14;20;34;1429908;1353131;0;2783039
28;2020-10-04;4;3;7;180735;186856;09;367591
28;2020-10-04;8;9;17;200125;213621;19;413746
28;2020-10-04;24;16;41;168922;173007;29;341929
28;2020-10-04;8;7;15;196628;188487;39;385115
28;2020-10-04;13;8;21;205396;201699;49;407095
28;2020-10-04;14;8;22;222002;213866;59;435868
28;2020-10-04;2;3;5;224688;203758;69;428446
28;2020-10-04;2;7;9;163192;135543;79;298735
28;2020-10-04;4;1;5;109691;65377;89;175068
28;2020-10-04;4;0;4;37222;12685;90;49907
28;2020-10-04;83;62;146;1708601;1594899;0;3303500
32;2020-10-04;4;5;9;358062;373689;09;731751
32;2020-10-04;28;13;41;387045;406742;19;793787
32;2020-10-04;36;30;66;342304;348587;29;690891
32;2020-10-04;28;19;47;382485;369972;39;752457
32;2020-10-04;22;16;38;382510;376716;49;759226
32;2020-10-04;15;14;29;386937;376527;59;763464
32;2020-10-04;13;8;21;371211;330938;69;702149
32;2020-10-04;7;9;16;250542;201459;79;452001
32;2020-10-04;3;5;8;163399;89786;89;253185
32;2020-10-04;5;3;8;48384;15367;90;63751
32;2020-10-04;161;122;283;3072879;2889783;0;5962662
44;2020-10-04;1;1;2;291525;306839;09;598364
44;2020-10-04;2;0;2;320255;339504;19;659759
44;2020-10-04;4;8;12;302020;314428;29;616448
44;2020-10-04;2;3;5;342222;333292;39;675514
44;2020-10-04;4;1;5;349727;344491;49;694218
44;2020-10-04;3;5;8;381371;373239;59;754610
44;2020-10-04;0;2;3;367165;335850;69;703015
44;2020-10-04;1;0;1;250387;215436;79;465823
44;2020-10-04;1;3;4;170825;105192;89;276017
44;2020-10-04;1;0;1;51248;16731;90;67979
44;2020-10-04;19;23;43;2826745;2685002;0;5511747
52;2020-10-04;1;0;1;213594;223900;09;437494
52;2020-10-04;0;0;0;240818;255197;19;496015
52;2020-10-04;7;6;13;197010;200630;29;397640
52;2020-10-04;4;0;4;231204;224885;39;456089
52;2020-10-04;2;1;3;243874;243418;49;487292
52;2020-10-04;1;4;5;244100;239116;59;483216
52;2020-10-04;1;2;3;241796;221345;69;463141
52;2020-10-04;1;5;6;177805;149903;79;327708
52;2020-10-04;1;0;1;119561;75822;89;195383
52;2020-10-04;0;0;0;42559;15260;90;57819
52;2020-10-04;18;18;36;1952321;1849476;0;3801797
53;2020-10-04;0;1;1;173813;182358;09;356171
53;2020-10-04;1;3;4;202720;214740;19;417460
53;2020-10-04;4;6;10;163116;173196;29;336312
53;2020-10-04;3;4;7;190526;187674;39;378200
53;2020-10-04;6;6;12;212098;212015;49;424113
53;2020-10-04;2;2;4;223699;219176;59;442875
53;2020-10-04;6;3;9;227435;209274;69;436709
53;2020-10-04;0;0;0;169992;140910;79;310902
53;2020-10-04;1;1;2;118117;69883;89;188000
53;2020-10-04;2;1;3;37370;12267;90;49637
53;2020-10-04;25;27;52;1718886;1621493;0;3340379
75;2020-10-04;1;2;3;293104;305291;09;598395
75;2020-10-04;4;1;5;337141;357785;19;694926
75;2020-10-04;14;9;23;295024;300618;29;595642
75;2020-10-04;8;12;20;347871;331233;39;679104
75;2020-10-04;9;9;18;384742;372771;49;757513
75;2020-10-04;6;8;14;413361;390880;59;804241
75;2020-10-04;1;2;3;425623;384060;69;809683
75;2020-10-04;1;2;3;325086;276298;79;601384
75;2020-10-04;3;2;5;213986;139308;89;353294
75;2020-10-04;0;1;1;77600;28200;90;105800
75;2020-10-04;47;48;95;3113538;2886444;0;5999982
76;2020-10-04;2;2;4;305956;318589;09;624545
76;2020-10-04;6;12;18;338942;356969;19;695911
76;2020-10-04;28;23;51;316210;319570;29;635780
76;2020-10-04;20;15;35;356758;337587;39;694345
76;2020-10-04;12;15;27;376541;363812;49;740353
76;2020-10-04;10;12;22;402608;383750;59;786358
76;2020-10-04;7;6;13;394889;358997;69;753886
76;2020-10-04;2;4;6;308664;263806;79;572470
76;2020-10-04;9;1;10;195838;129272;89;325110
76;2020-10-04;2;1;3;69372;26728;90;96100
76;2020-10-04;98;91;189;3065778;2859080;0;5924858
84;2020-10-04;4;4;8;459549;481088;09;940637
84;2020-10-04;18;11;32;487711;511905;19;999616
84;2020-10-04;21;15;36;443824;451094;29;894918
84;2020-10-04;14;14;28;512522;493262;39;1005784
84;2020-10-04;13;15;28;520248;515106;49;1035354
84;2020-10-04;8;15;23;529611;514848;59;1044459
84;2020-10-04;8;9;17;486720;439940;69;926660
84;2020-10-04;17;7;24;372151;315211;79;687362
84;2020-10-04;5;10;15;237198;150524;89;387722
84;2020-10-04;4;2;6;81185;28680;90;109865
84;2020-10-04;112;103;218;4130719;3901658;0;8032377
93;2020-10-04;1;1;2;268834;283093;09;551927
93;2020-10-04;6;4;10;280751;296087;19;576838
93;2020-10-04;9;7;16;254404;255552;29;509956
93;2020-10-04;5;3;8;310704;288398;39;599102
93;2020-10-04;7;14;21;325559;305827;49;631386
93;2020-10-04;11;10;21;353104;325389;59;678493
93;2020-10-04;10;2;12;336327;296459;69;632786
93;2020-10-04;1;6;7;279820;229699;79;509519
93;2020-10-04;3;5;8;171274;113716;89;284990
93;2020-10-04;8;1;9;58896;21758;90;80654
93;2020-10-04;61;53;114;2639673;2415978;0;5055651
94;2020-10-04;0;0;0;16311;17433;09;33744
94;2020-10-04;1;1;2;16679;18132;19;34811
94;2020-10-04;1;2;3;16782;16579;29;33361
94;2020-10-04;1;0;1;23044;20580;39;43624
94;2020-10-04;0;0;0;23065;22140;49;45205
94;2020-10-04;0;0;0;24549;23421;59;47970
94;2020-10-04;0;0;0;23212;21883;69;45095
94;2020-10-04;0;0;0;19544;17141;79;36685
94;2020-10-04;0;0;0;11227;8178;89;19405
94;2020-10-04;0;0;0;3332;1447;90;4779
94;2020-10-04;3;3;6;177745;166934;0;344679
01;2020-10-05;0;0;0;19979;20155;09;40134
01;2020-10-05;9;10;19;24994;25489;19;50483
01;2020-10-05;8;4;12;17868;16690;29;34558
01;2020-10-05;9;3;12;22328;14821;39;37149
01;2020-10-05;18;5;23;28652;20276;49;48928
01;2020-10-05;15;14;29;33264;27260;59;60524
01;2020-10-05;12;13;25;27135;23978;69;51113
01;2020-10-05;3;5;8;18401;14661;79;33062
01;2020-10-05;0;4;4;9633;6375;89;16008
01;2020-10-05;1;0;1;3410;1510;90;4920
01;2020-10-05;75;58;133;205664;171215;0;376879
02;2020-10-05;0;1;1;16881;17110;09;33991
02;2020-10-05;6;3;9;21410;21604;19;43014
02;2020-10-05;3;8;11;16017;15479;29;31496
02;2020-10-05;8;3;11;19825;14455;39;34280
02;2020-10-05;11;12;23;24719;18248;49;42967
02;2020-10-05;7;5;12;34361;28310;59;62671
02;2020-10-05;4;4;9;28061;24495;69;52556
02;2020-10-05;2;2;4;18231;15278;79;33509
02;2020-10-05;0;1;1;11090;7677;89;18767
02;2020-10-05;0;0;0;3992;1506;90;5498
02;2020-10-05;41;39;81;194587;164162;0;358749
03;2020-10-05;0;1;1;31123;30920;09;62043
03;2020-10-05;1;0;1;29370;29268;19;58638
03;2020-10-05;3;2;5;21458;18963;29;40421
03;2020-10-05;2;1;3;21276;18326;39;39602
03;2020-10-05;1;0;1;18164;16593;49;34757
03;2020-10-05;1;4;5;13469;13557;59;27026
03;2020-10-05;1;0;1;8776;8670;69;17446
03;2020-10-05;0;0;0;3777;3591;79;7368
03;2020-10-05;0;0;0;1649;1072;89;2721
03;2020-10-05;0;0;0;485;184;90;669
03;2020-10-05;9;8;17;149547;141144;0;290691
04;2020-10-05;0;0;0;60314;61377;09;121691
04;2020-10-05;8;8;16;66065;68387;19;134452
04;2020-10-05;5;11;16;51059;47156;29;98215
04;2020-10-05;2;3;5;58788;45780;39;104568
04;2020-10-05;8;5;13;61408;52207;49;113615
04;2020-10-05;6;6;12;64838;60759;59;125597
04;2020-10-05;5;3;8;47008;42843;69;89851
04;2020-10-05;2;1;3;25509;21184;79;46693
04;2020-10-05;1;0;1;13168;7647;89;20815
04;2020-10-05;0;0;0;3209;1253;90;4462
04;2020-10-05;37;37;74;451366;408593;0;859959
05;2020-10-05;0;0;0;362.366008612902;341.338819562748;09;703.704828175651
05;2020-10-05;0;0;0;353.376145114279;370.349735405642;19;723.725880519921
05;2020-10-05;0;0;0;218.593559489256;256.539602589476;29;475.133162078732
05;2020-10-05;0;0;0;404.225408693299;360.321910454353;39;764.547319147651
05;2020-10-05;0;0;0;520.067953604221;497.108383964256;49;1017.17633756848
05;2020-10-05;0;0;0;468.146063921917;510.087601910415;59;978.233665832332
05;2020-10-05;0;0;0;340.368470050554;334.366842191253;69;674.735312241807
05;2020-10-05;0;0;0;212.598666888387;192.597753227106;79;405.196420115493
05;2020-10-05;0;0;0;148.727797095705;61.8681715431829;89;210.595968638888
05;2020-10-05;0;0;0;32.9601271090696;10.9909785719784;90;43.9511056810479
05;2020-10-05;0;0;0;3061.43020057959;2935.56979942041;0;5997
06;2020-10-05;0;0;0;42583;42380;09;84963
06;2020-10-05;0;0;0;33369;31925;19;65294
06;2020-10-05;2;3;5;21571;15080;29;36651
06;2020-10-05;0;3;3;21550;16147;39;37697
06;2020-10-05;2;4;6;14193;13939;49;28132
06;2020-10-05;0;2;2;7171;7597;59;14768
06;2020-10-05;0;1;1;3629;4117;69;7746
06;2020-10-05;0;0;0;1577;1457;79;3034
06;2020-10-05;0;0;0;531;474;89;1005
06;2020-10-05;0;0;0;88;93;90;181
06;2020-10-05;4;13;17;146262;133209;0;279471
07;2020-10-05;0;0;0;485;549;09;1034
07;2020-10-05;0;0;0;403;432;19;835
07;2020-10-05;0;0;0;764;841;29;1605
07;2020-10-05;0;0;0;824;928;39;1752
07;2020-10-05;0;0;0;788;1020;49;1808
07;2020-10-05;0;0;0;678;870;59;1548
07;2020-10-05;0;0;0;360;382;69;742
07;2020-10-05;0;0;0;231;190;79;421
07;2020-10-05;0;0;0;114;67;89;181
07;2020-10-05;0;0;0;24;11;90;35
07;2020-10-05;0;0;0;4671;5290;0;9961
08;2020-10-05;1;0;1;2715.22592983026;2997.75551488675;09;5712.98144471701
08;2020-10-05;0;1;1;2778.51901080978;3160.9156459093;19;5939.43465671908
08;2020-10-05;1;2;3;2080.8882988764;1718.16634315323;29;3799.05464202964
08;2020-10-05;3;2;5;2701.8582062647;1896.52641413317;39;4598.38462039786
08;2020-10-05;0;2;2;3151.45861023308;2460.52498233809;49;5611.98359257117
08;2020-10-05;2;1;3;2620.29868333099;2422.23566154656;59;5042.53434487755
08;2020-10-05;1;0;1;1621.44173420671;1438.58325779464;69;3060.02499200135
08;2020-10-05;0;0;0;626.575909335673;526.358467843651;79;1152.93437717932
08;2020-10-05;0;0;0;205.018522985054;140.993639349697;89;346.012162334751
08;2020-10-05;0;0;0;50.0325684687745;20.62259870351;90;70.6551671722846
08;2020-10-05;8;8;16;18551.3174743414;16782.6825256586;0;35334
11;2020-10-05;61;65;133;783071;811785;09;1594856
11;2020-10-05;389;362;770;761456;784653;19;1546109
11;2020-10-05;959;827;1791;850145;801772;29;1651917
11;2020-10-05;723;632;1355;914360;843488;39;1757848
11;2020-10-05;582;509;1091;845609;826202;49;1671811
11;2020-10-05;502;423;925;793566;745070;59;1538636
11;2020-10-05;281;264;548;628649;549192;69;1177841
11;2020-10-05;107;113;221;434606;358356;79;792962
11;2020-10-05;63;49;113;261425;162933;89;424358
11;2020-10-05;34;9;43;89253;32619;90;121872
11;2020-10-05;3703;3256;6998;6362140;5916070;0;12278210
24;2020-10-05;5;14;19;139720;144686;09;284406
24;2020-10-05;31;30;62;152979;161185;19;314164
24;2020-10-05;43;31;74;122237;126536;29;248773
24;2020-10-05;50;23;73;150359;142009;39;292368
24;2020-10-05;36;30;66;161829;158758;49;320587
24;2020-10-05;33;36;69;172552;168011;59;340563
24;2020-10-05;24;25;49;172509;158177;69;330686
24;2020-10-05;10;14;24;129428;110593;79;240021
24;2020-10-05;12;6;18;87342;56882;89;144224
24;2020-10-05;4;1;5;31210;12071;90;43281
24;2020-10-05;248;210;459;1320165;1238908;0;2559073
27;2020-10-05;7;1;8;143373;149679;09;293052
27;2020-10-05;33;26;59;160962;173003;19;333965
27;2020-10-05;42;40;82;133746;142254;29;276000
27;2020-10-05;40;37;77;160004;155407;39;315411
27;2020-10-05;44;42;86;172333;169564;49;341897
27;2020-10-05;38;35;73;189979;183788;59;373767
27;2020-10-05;33;20;53;192591;178206;69;370797
27;2020-10-05;14;23;37;146876;127546;79;274422
27;2020-10-05;2;3;5;96896;61575;89;158471
27;2020-10-05;4;3;7;33148;12109;90;45257
27;2020-10-05;257;230;487;1429908;1353131;0;2783039
28;2020-10-05;8;16;24;180735;186856;09;367591
28;2020-10-05;51;51;103;200125;213621;19;413746
28;2020-10-05;89;74;163;168922;173007;29;341929
28;2020-10-05;50;40;90;196628;188487;39;385115
28;2020-10-05;57;44;101;205396;201699;49;407095
28;2020-10-05;50;65;115;222002;213866;59;435868
28;2020-10-05;36;32;68;224688;203758;69;428446
28;2020-10-05;31;25;56;163192;135543;79;298735
28;2020-10-05;18;13;31;109691;65377;89;175068
28;2020-10-05;27;5;32;37222;12685;90;49907
28;2020-10-05;417;365;783;1708601;1594899;0;3303500
32;2020-10-05;29;22;51;358062;373689;09;731751
32;2020-10-05;151;127;278;387045;406742;19;793787
32;2020-10-05;236;200;437;342304;348587;29;690891
32;2020-10-05;175;162;337;382485;369972;39;752457
32;2020-10-05;182;171;353;382510;376716;49;759226
32;2020-10-05;169;141;310;386937;376527;59;763464
32;2020-10-05;104;85;189;371211;330938;69;702149
32;2020-10-05;54;48;102;250542;201459;79;452001
32;2020-10-05;45;28;73;163399;89786;89;253185
32;2020-10-05;21;9;30;48384;15367;90;63751
32;2020-10-05;1166;993;2160;3072879;2889783;0;5962662
44;2020-10-05;13;9;22;291525;306839;09;598364
44;2020-10-05;51;54;105;320255;339504;19;659759
44;2020-10-05;91;102;193;302020;314428;29;616448
44;2020-10-05;60;62;122;342222;333292;39;675514
44;2020-10-05;68;63;131;349727;344491;49;694218
44;2020-10-05;68;57;126;381371;373239;59;754610
44;2020-10-05;40;39;79;367165;335850;69;703015
44;2020-10-05;24;16;40;250387;215436;79;465823
44;2020-10-05;13;11;24;170825;105192;89;276017
44;2020-10-05;12;4;16;51248;16731;90;67979
44;2020-10-05;440;418;860;2826745;2685002;0;5511747
52;2020-10-05;8;8;21;213594;223900;09;437494
52;2020-10-05;46;61;107;240818;255197;19;496015
52;2020-10-05;96;89;185;197010;200630;29;397640
52;2020-10-05;65;51;116;231204;224885;39;456089
52;2020-10-05;43;50;93;243874;243418;49;487292
52;2020-10-05;38;56;94;244100;239116;59;483216
52;2020-10-05;25;32;57;241796;221345;69;463141
52;2020-10-05;24;17;41;177805;149903;79;327708
52;2020-10-05;12;6;18;119561;75822;89;195383
52;2020-10-05;3;1;4;42559;15260;90;57819
52;2020-10-05;360;371;736;1952321;1849476;0;3801797
53;2020-10-05;7;6;13;173813;182358;09;356171
53;2020-10-05;30;30;60;202720;214740;19;417460
53;2020-10-05;49;61;115;163116;173196;29;336312
53;2020-10-05;38;31;69;190526;187674;39;378200
53;2020-10-05;34;34;68;212098;212015;49;424113
53;2020-10-05;26;22;48;223699;219176;59;442875
53;2020-10-05;26;19;45;227435;209274;69;436709
53;2020-10-05;5;11;16;169992;140910;79;310902
53;2020-10-05;16;9;25;118117;69883;89;188000
53;2020-10-05;2;3;5;37370;12267;90;49637
53;2020-10-05;233;226;464;1718886;1621493;0;3340379
75;2020-10-05;15;11;27;293104;305291;09;598395
75;2020-10-05;43;69;115;337141;357785;19;694926
75;2020-10-05;94;111;205;295024;300618;29;595642
75;2020-10-05;69;97;166;347871;331233;39;679104
75;2020-10-05;71;75;146;384742;372771;49;757513
75;2020-10-05;76;56;132;413361;390880;59;804241
75;2020-10-05;29;50;79;425623;384060;69;809683
75;2020-10-05;29;19;48;325086;276298;79;601384
75;2020-10-05;18;9;27;213986;139308;89;353294
75;2020-10-05;13;6;19;77600;28200;90;105800
75;2020-10-05;457;503;964;3113538;2886444;0;5999982
76;2020-10-05;19;26;46;305956;318589;09;624545
76;2020-10-05;135;109;248;338942;356969;19;695911
76;2020-10-05;210;168;379;316210;319570;29;635780
76;2020-10-05;148;120;268;356758;337587;39;694345
76;2020-10-05;170;126;297;376541;363812;49;740353
76;2020-10-05;142;121;263;402608;383750;59;786358
76;2020-10-05;97;76;173;394889;358997;69;753886
76;2020-10-05;44;54;98;308664;263806;79;572470
76;2020-10-05;39;28;67;195838;129272;89;325110
76;2020-10-05;30;6;36;69372;26728;90;96100
76;2020-10-05;1035;835;1877;3065778;2859080;0;5924858
84;2020-10-05;51;43;94;459549;481088;09;940637
84;2020-10-05;215;234;450;487711;511905;19;999616
84;2020-10-05;346;343;689;443824;451094;29;894918
84;2020-10-05;280;255;535;512522;493262;39;1005784
84;2020-10-05;254;245;499;520248;515106;49;1035354
84;2020-10-05;223;227;450;529611;514848;59;1044459
84;2020-10-05;131;130;261;486720;439940;69;926660
84;2020-10-05;93;86;179;372151;315211;79;687362
84;2020-10-05;58;33;91;237198;150524;89;387722
84;2020-10-05;70;19;89;81185;28680;90;109865
84;2020-10-05;1721;1615;3337;4130719;3901658;0;8032377
93;2020-10-05;21;18;40;268834;283093;09;551927
93;2020-10-05;102;91;193;280751;296087;19;576838
93;2020-10-05;195;157;352;254404;255552;29;509956
93;2020-10-05;137;121;259;310704;288398;39;599102
93;2020-10-05;154;101;255;325559;305827;49;631386
93;2020-10-05;140;115;255;353104;325389;59;678493
93;2020-10-05;74;84;158;336327;296459;69;632786
93;2020-10-05;49;60;109;279820;229699;79;509519
93;2020-10-05;40;23;63;171274;113716;89;284990
93;2020-10-05;18;7;25;58896;21758;90;80654
93;2020-10-05;930;778;1710;2639673;2415978;0;5055651
94;2020-10-05;0;1;1;16311;17433;09;33744
94;2020-10-05;0;2;2;16679;18132;19;34811
94;2020-10-05;5;4;9;16782;16579;29;33361
94;2020-10-05;7;6;13;23044;20580;39;43624
94;2020-10-05;2;0;2;23065;22140;49;45205
94;2020-10-05;0;4;4;24549;23421;59;47970
94;2020-10-05;4;2;6;23212;21883;69;45095
94;2020-10-05;2;3;5;19544;17141;79;36685
94;2020-10-05;0;0;0;11227;8178;89;19405
94;2020-10-05;0;1;1;3332;1447;90;4779
94;2020-10-05;20;23;43;177745;166934;0;344679
01;2020-10-06;0;1;1;19979;20155;09;40134
01;2020-10-06;11;9;20;24994;25489;19;50483
01;2020-10-06;8;3;11;17868;16690;29;34558
01;2020-10-06;10;3;13;22328;14821;39;37149
01;2020-10-06;12;4;16;28652;20276;49;48928
01;2020-10-06;10;17;27;33264;27260;59;60524
01;2020-10-06;12;7;19;27135;23978;69;51113
01;2020-10-06;6;5;11;18401;14661;79;33062
01;2020-10-06;2;2;4;9633;6375;89;16008
01;2020-10-06;0;0;0;3410;1510;90;4920
01;2020-10-06;71;51;122;205664;171215;0;376879
02;2020-10-06;1;1;2;16881;17110;09;33991
02;2020-10-06;5;5;10;21410;21604;19;43014
02;2020-10-06;6;6;12;16017;15479;29;31496
02;2020-10-06;14;5;19;19825;14455;39;34280
02;2020-10-06;5;5;10;24719;18248;49;42967
02;2020-10-06;11;6;17;34361;28310;59;62671
02;2020-10-06;7;4;11;28061;24495;69;52556
02;2020-10-06;0;1;1;18231;15278;79;33509
02;2020-10-06;0;0;0;11090;7677;89;18767
02;2020-10-06;0;0;0;3992;1506;90;5498
02;2020-10-06;49;33;82;194587;164162;0;358749
03;2020-10-06;1;1;2;31123;30920;09;62043
03;2020-10-06;2;0;2;29370;29268;19;58638
03;2020-10-06;4;3;8;21458;18963;29;40421
03;2020-10-06;4;3;7;21276;18326;39;39602
03;2020-10-06;3;1;4;18164;16593;49;34757
03;2020-10-06;4;2;6;13469;13557;59;27026
03;2020-10-06;1;1;2;8776;8670;69;17446
03;2020-10-06;0;0;0;3777;3591;79;7368
03;2020-10-06;0;0;0;1649;1072;89;2721
03;2020-10-06;0;0;0;485;184;90;669
03;2020-10-06;19;11;31;149547;141144;0;290691
04;2020-10-06;1;0;1;60314;61377;09;121691
04;2020-10-06;6;8;14;66065;68387;19;134452
04;2020-10-06;3;3;6;51059;47156;29;98215
04;2020-10-06;3;5;8;58788;45780;39;104568
04;2020-10-06;2;5;7;61408;52207;49;113615
04;2020-10-06;2;3;5;64838;60759;59;125597
04;2020-10-06;0;1;1;47008;42843;69;89851
04;2020-10-06;2;0;2;25509;21184;79;46693
04;2020-10-06;0;0;0;13168;7647;89;20815
04;2020-10-06;1;0;1;3209;1253;90;4462
04;2020-10-06;20;25;45;451366;408593;0;859959
05;2020-10-06;0;0;0;362.366008612902;341.338819562748;09;703.704828175651
05;2020-10-06;0;0;0;353.376145114279;370.349735405642;19;723.725880519921
05;2020-10-06;0;0;0;218.593559489256;256.539602589476;29;475.133162078732
05;2020-10-06;0;0;0;404.225408693299;360.321910454353;39;764.547319147651
05;2020-10-06;0;0;0;520.067953604221;497.108383964256;49;1017.17633756848
05;2020-10-06;0;0;0;468.146063921917;510.087601910415;59;978.233665832332
05;2020-10-06;0;0;0;340.368470050554;334.366842191253;69;674.735312241807
05;2020-10-06;0;0;0;212.598666888387;192.597753227106;79;405.196420115493
05;2020-10-06;0;0;0;148.727797095705;61.8681715431829;89;210.595968638888
05;2020-10-06;0;0;0;32.9601271090696;10.9909785719784;90;43.9511056810479
05;2020-10-06;0;0;0;3061.43020057959;2935.56979942041;0;5997
06;2020-10-06;0;0;0;42583;42380;09;84963
06;2020-10-06;2;0;2;33369;31925;19;65294
06;2020-10-06;4;2;6;21571;15080;29;36651
06;2020-10-06;1;1;2;21550;16147;39;37697
06;2020-10-06;4;0;4;14193;13939;49;28132
06;2020-10-06;1;3;4;7171;7597;59;14768
06;2020-10-06;0;1;1;3629;4117;69;7746
06;2020-10-06;0;1;1;1577;1457;79;3034
06;2020-10-06;0;0;0;531;474;89;1005
06;2020-10-06;0;0;0;88;93;90;181
06;2020-10-06;12;8;21;146262;133209;0;279471
07;2020-10-06;0;0;0;485;549;09;1034
07;2020-10-06;0;0;0;403;432;19;835
07;2020-10-06;0;0;0;764;841;29;1605
07;2020-10-06;0;0;0;824;928;39;1752
07;2020-10-06;0;1;1;788;1020;49;1808
07;2020-10-06;0;0;0;678;870;59;1548
07;2020-10-06;0;0;0;360;382;69;742
07;2020-10-06;0;0;0;231;190;79;421
07;2020-10-06;0;0;0;114;67;89;181
07;2020-10-06;0;0;0;24;11;90;35
07;2020-10-06;0;1;1;4671;5290;0;9961
08;2020-10-06;0;0;0;2715.22592983026;2997.75551488675;09;5712.98144471701
08;2020-10-06;0;0;0;2778.51901080978;3160.9156459093;19;5939.43465671908
08;2020-10-06;0;1;1;2080.8882988764;1718.16634315323;29;3799.05464202964
08;2020-10-06;3;5;8;2701.8582062647;1896.52641413317;39;4598.38462039786
08;2020-10-06;0;1;1;3151.45861023308;2460.52498233809;49;5611.98359257117
08;2020-10-06;2;0;2;2620.29868333099;2422.23566154656;59;5042.53434487755
08;2020-10-06;1;0;1;1621.44173420671;1438.58325779464;69;3060.02499200135
08;2020-10-06;1;1;2;626.575909335673;526.358467843651;79;1152.93437717932
08;2020-10-06;0;0;0;205.018522985054;140.993639349697;89;346.012162334751
08;2020-10-06;0;0;0;50.0325684687745;20.62259870351;90;70.6551671722846
08;2020-10-06;7;8;15;18551.3174743414;16782.6825256586;0;35334
11;2020-10-06;36;56;101;783071;811785;09;1594856
11;2020-10-06;336;370;728;761456;784653;19;1546109
11;2020-10-06;862;757;1624;850145;801772;29;1651917
11;2020-10-06;665;606;1276;914360;843488;39;1757848
11;2020-10-06;511;429;944;845609;826202;49;1671811
11;2020-10-06;436;398;837;793566;745070;59;1538636
11;2020-10-06;249;259;511;628649;549192;69;1177841
11;2020-10-06;101;92;193;434606;358356;79;792962
11;2020-10-06;69;42;111;261425;162933;89;424358
11;2020-10-06;22;14;36;89253;32619;90;121872
11;2020-10-06;3288;3024;6364;6362140;5916070;0;12278210
24;2020-10-06;2;2;4;139720;144686;09;284406
24;2020-10-06;34;35;70;152979;161185;19;314164
24;2020-10-06;53;46;99;122237;126536;29;248773
24;2020-10-06;52;38;90;150359;142009;39;292368
24;2020-10-06;25;30;55;161829;158758;49;320587
24;2020-10-06;36;24;60;172552;168011;59;340563
24;2020-10-06;26;21;47;172509;158177;69;330686
24;2020-10-06;6;9;15;129428;110593;79;240021
24;2020-10-06;8;1;9;87342;56882;89;144224
24;2020-10-06;2;0;2;31210;12071;90;43281
24;2020-10-06;244;206;451;1320165;1238908;0;2559073
27;2020-10-06;3;4;7;143373;149679;09;293052
27;2020-10-06;23;29;52;160962;173003;19;333965
27;2020-10-06;34;35;69;133746;142254;29;276000
27;2020-10-06;34;25;59;160004;155407;39;315411
27;2020-10-06;26;34;60;172333;169564;49;341897
27;2020-10-06;26;36;62;189979;183788;59;373767
27;2020-10-06;23;16;39;192591;178206;69;370797
27;2020-10-06;7;12;19;146876;127546;79;274422
27;2020-10-06;9;6;15;96896;61575;89;158471
27;2020-10-06;5;2;7;33148;12109;90;45257
27;2020-10-06;190;199;391;1429908;1353131;0;2783039
28;2020-10-06;8;8;18;180735;186856;09;367591
28;2020-10-06;52;48;101;200125;213621;19;413746
28;2020-10-06;99;79;178;168922;173007;29;341929
28;2020-10-06;63;44;107;196628;188487;39;385115
28;2020-10-06;56;47;103;205396;201699;49;407095
28;2020-10-06;36;34;70;222002;213866;59;435868
28;2020-10-06;42;30;72;224688;203758;69;428446
28;2020-10-06;22;21;43;163192;135543;79;298735
28;2020-10-06;39;19;58;109691;65377;89;175068
28;2020-10-06;27;5;32;37222;12685;90;49907
28;2020-10-06;444;335;782;1708601;1594899;0;3303500
32;2020-10-06;22;17;39;358062;373689;09;731751
32;2020-10-06;134;156;290;387045;406742;19;793787
32;2020-10-06;222;199;421;342304;348587;29;690891
32;2020-10-06;183;154;337;382485;369972;39;752457
32;2020-10-06;173;152;325;382510;376716;49;759226
32;2020-10-06;135;136;271;386937;376527;59;763464
32;2020-10-06;103;78;181;371211;330938;69;702149
32;2020-10-06;64;58;122;250542;201459;79;452001
32;2020-10-06;54;27;82;163399;89786;89;253185
32;2020-10-06;31;7;38;48384;15367;90;63751
32;2020-10-06;1121;984;2106;3072879;2889783;0;5962662
44;2020-10-06;6;9;15;291525;306839;09;598364
44;2020-10-06;49;62;112;320255;339504;19;659759
44;2020-10-06;91;99;190;302020;314428;29;616448
44;2020-10-06;63;66;129;342222;333292;39;675514
44;2020-10-06;59;57;116;349727;344491;49;694218
44;2020-10-06;48;56;104;381371;373239;59;754610
44;2020-10-06;42;39;81;367165;335850;69;703015
44;2020-10-06;20;22;42;250387;215436;79;465823
44;2020-10-06;6;5;11;170825;105192;89;276017
44;2020-10-06;6;1;7;51248;16731;90;67979
44;2020-10-06;390;417;808;2826745;2685002;0;5511747
52;2020-10-06;5;3;9;213594;223900;09;437494
52;2020-10-06;38;39;77;240818;255197;19;496015
52;2020-10-06;63;50;113;197010;200630;29;397640
52;2020-10-06;47;48;95;231204;224885;39;456089
52;2020-10-06;27;39;66;243874;243418;49;487292
52;2020-10-06;44;38;82;244100;239116;59;483216
52;2020-10-06;30;22;52;241796;221345;69;463141
52;2020-10-06;16;24;40;177805;149903;79;327708
52;2020-10-06;7;12;19;119561;75822;89;195383
52;2020-10-06;2;2;4;42559;15260;90;57819
52;2020-10-06;279;277;557;1952321;1849476;0;3801797
53;2020-10-06;2;7;9;173813;182358;09;356171
53;2020-10-06;33;25;59;202720;214740;19;417460
53;2020-10-06;59;65;125;163116;173196;29;336312
53;2020-10-06;26;24;50;190526;187674;39;378200
53;2020-10-06;26;20;46;212098;212015;49;424113
53;2020-10-06;32;21;53;223699;219176;59;442875
53;2020-10-06;21;26;47;227435;209274;69;436709
53;2020-10-06;11;6;17;169992;140910;79;310902
53;2020-10-06;9;2;11;118117;69883;89;188000
53;2020-10-06;1;1;2;37370;12267;90;49637
53;2020-10-06;220;197;419;1718886;1621493;0;3340379
75;2020-10-06;7;8;15;293104;305291;09;598395
75;2020-10-06;48;66;114;337141;357785;19;694926
75;2020-10-06;113;99;212;295024;300618;29;595642
75;2020-10-06;60;45;106;347871;331233;39;679104
75;2020-10-06;67;53;120;384742;372771;49;757513
75;2020-10-06;61;49;110;413361;390880;59;804241
75;2020-10-06;30;29;59;425623;384060;69;809683
75;2020-10-06;17;20;37;325086;276298;79;601384
75;2020-10-06;20;15;35;213986;139308;89;353294
75;2020-10-06;25;1;26;77600;28200;90;105800
75;2020-10-06;448;386;835;3113538;2886444;0;5999982
76;2020-10-06;10;13;24;305956;318589;09;624545
76;2020-10-06;95;125;221;338942;356969;19;695911
76;2020-10-06;164;153;318;316210;319570;29;635780
76;2020-10-06;141;111;253;356758;337587;39;694345
76;2020-10-06;138;119;257;376541;363812;49;740353
76;2020-10-06;154;117;271;402608;383750;59;786358
76;2020-10-06;91;81;172;394889;358997;69;753886
76;2020-10-06;46;48;94;308664;263806;79;572470
76;2020-10-06;33;21;54;195838;129272;89;325110
76;2020-10-06;27;7;34;69372;26728;90;96100
76;2020-10-06;900;795;1699;3065778;2859080;0;5924858
84;2020-10-06;29;31;60;459549;481088;09;940637
84;2020-10-06;220;266;487;487711;511905;19;999616
84;2020-10-06;389;295;686;443824;451094;29;894918
84;2020-10-06;246;231;477;512522;493262;39;1005784
84;2020-10-06;274;237;511;520248;515106;49;1035354
84;2020-10-06;256;217;473;529611;514848;59;1044459
84;2020-10-06;113;120;233;486720;439940;69;926660
84;2020-10-06;81;72;153;372151;315211;79;687362
84;2020-10-06;80;42;122;237198;150524;89;387722
84;2020-10-06;47;15;62;81185;28680;90;109865
84;2020-10-06;1736;1526;3265;4130719;3901658;0;8032377
93;2020-10-06;12;19;31;268834;283093;09;551927
93;2020-10-06;82;86;169;280751;296087;19;576838
93;2020-10-06;134;126;261;254404;255552;29;509956
93;2020-10-06;111;113;224;310704;288398;39;599102
93;2020-10-06;116;91;207;325559;305827;49;631386
93;2020-10-06;113;103;216;353104;325389;59;678493
93;2020-10-06;55;68;123;336327;296459;69;632786
93;2020-10-06;46;45;91;279820;229699;79;509519
93;2020-10-06;48;30;78;171274;113716;89;284990
93;2020-10-06;31;11;42;58896;21758;90;80654
93;2020-10-06;748;693;1443;2639673;2415978;0;5055651
94;2020-10-06;0;1;1;16311;17433;09;33744
94;2020-10-06;1;0;1;16679;18132;19;34811
94;2020-10-06;6;5;11;16782;16579;29;33361
94;2020-10-06;5;3;8;23044;20580;39;43624
94;2020-10-06;1;3;4;23065;22140;49;45205
94;2020-10-06;5;2;7;24549;23421;59;47970
94;2020-10-06;3;4;7;23212;21883;69;45095
94;2020-10-06;3;2;5;19544;17141;79;36685
94;2020-10-06;3;0;3;11227;8178;89;19405
94;2020-10-06;0;0;0;3332;1447;90;4779
94;2020-10-06;27;21;48;177745;166934;0;344679
01;2020-10-07;0;1;1;19979;20155;09;40134
01;2020-10-07;3;4;7;24994;25489;19;50483
01;2020-10-07;8;0;8;17868;16690;29;34558
01;2020-10-07;7;1;8;22328;14821;39;37149
01;2020-10-07;5;10;15;28652;20276;49;48928
01;2020-10-07;7;4;11;33264;27260;59;60524
01;2020-10-07;7;6;13;27135;23978;69;51113
01;2020-10-07;4;7;11;18401;14661;79;33062
01;2020-10-07;4;6;10;9633;6375;89;16008
01;2020-10-07;0;1;1;3410;1510;90;4920
01;2020-10-07;45;40;85;205664;171215;0;376879
02;2020-10-07;2;0;2;16881;17110;09;33991
02;2020-10-07;5;6;11;21410;21604;19;43014
02;2020-10-07;3;5;8;16017;15479;29;31496
02;2020-10-07;7;3;10;19825;14455;39;34280
02;2020-10-07;7;9;16;24719;18248;49;42967
02;2020-10-07;7;4;11;34361;28310;59;62671
02;2020-10-07;5;7;12;28061;24495;69;52556
02;2020-10-07;3;3;6;18231;15278;79;33509
02;2020-10-07;1;0;1;11090;7677;89;18767
02;2020-10-07;0;0;0;3992;1506;90;5498
02;2020-10-07;40;37;77;194587;164162;0;358749
03;2020-10-07;1;0;1;31123;30920;09;62043
03;2020-10-07;3;2;5;29370;29268;19;58638
03;2020-10-07;6;2;8;21458;18963;29;40421
03;2020-10-07;0;2;2;21276;18326;39;39602
03;2020-10-07;6;3;9;18164;16593;49;34757
03;2020-10-07;2;1;3;13469;13557;59;27026
03;2020-10-07;0;0;0;8776;8670;69;17446
03;2020-10-07;0;0;0;3777;3591;79;7368
03;2020-10-07;0;0;0;1649;1072;89;2721
03;2020-10-07;0;0;0;485;184;90;669
03;2020-10-07;18;10;28;149547;141144;0;290691
04;2020-10-07;0;2;2;60314;61377;09;121691
04;2020-10-07;5;5;10;66065;68387;19;134452
04;2020-10-07;5;6;11;51059;47156;29;98215
04;2020-10-07;6;6;12;58788;45780;39;104568
04;2020-10-07;4;7;11;61408;52207;49;113615
04;2020-10-07;2;5;7;64838;60759;59;125597
04;2020-10-07;2;1;3;47008;42843;69;89851
04;2020-10-07;0;3;3;25509;21184;79;46693
04;2020-10-07;1;0;1;13168;7647;89;20815
04;2020-10-07;0;0;0;3209;1253;90;4462
04;2020-10-07;25;35;60;451366;408593;0;859959
05;2020-10-07;0;0;0;362.366008612902;341.338819562748;09;703.704828175651
05;2020-10-07;0;0;0;353.376145114279;370.349735405642;19;723.725880519921
05;2020-10-07;0;0;0;218.593559489256;256.539602589476;29;475.133162078732
05;2020-10-07;0;0;0;404.225408693299;360.321910454353;39;764.547319147651
05;2020-10-07;0;0;0;520.067953604221;497.108383964256;49;1017.17633756848
05;2020-10-07;1;1;2;468.146063921917;510.087601910415;59;978.233665832332
05;2020-10-07;0;0;0;340.368470050554;334.366842191253;69;674.735312241807
05;2020-10-07;0;0;0;212.598666888387;192.597753227106;79;405.196420115493
05;2020-10-07;0;0;0;148.727797095705;61.8681715431829;89;210.595968638888
05;2020-10-07;0;0;0;32.9601271090696;10.9909785719784;90;43.9511056810479
05;2020-10-07;1;1;2;3061.43020057959;2935.56979942041;0;5997
06;2020-10-07;0;0;0;42583;42380;09;84963
06;2020-10-07;0;0;0;33369;31925;19;65294
06;2020-10-07;3;2;5;21571;15080;29;36651
06;2020-10-07;0;5;5;21550;16147;39;37697
06;2020-10-07;2;7;9;14193;13939;49;28132
06;2020-10-07;2;1;3;7171;7597;59;14768
06;2020-10-07;2;2;4;3629;4117;69;7746
06;2020-10-07;0;0;0;1577;1457;79;3034
06;2020-10-07;0;0;0;531;474;89;1005
06;2020-10-07;0;0;0;88;93;90;181
06;2020-10-07;9;17;26;146262;133209;0;279471
07;2020-10-07;0;0;0;485;549;09;1034
07;2020-10-07;0;0;0;403;432;19;835
07;2020-10-07;0;0;0;764;841;29;1605
07;2020-10-07;0;0;0;824;928;39;1752
07;2020-10-07;0;0;0;788;1020;49;1808
07;2020-10-07;0;0;0;678;870;59;1548
07;2020-10-07;0;0;0;360;382;69;742
07;2020-10-07;0;0;0;231;190;79;421
07;2020-10-07;0;0;0;114;67;89;181
07;2020-10-07;0;0;0;24;11;90;35
07;2020-10-07;0;0;0;4671;5290;0;9961
08;2020-10-07;0;0;0;2715.22592983026;2997.75551488675;09;5712.98144471701
08;2020-10-07;1;0;1;2778.51901080978;3160.9156459093;19;5939.43465671908
08;2020-10-07;2;0;2;2080.8882988764;1718.16634315323;29;3799.05464202964
08;2020-10-07;4;1;5;2701.8582062647;1896.52641413317;39;4598.38462039786
08;2020-10-07;2;0;2;3151.45861023308;2460.52498233809;49;5611.98359257117
08;2020-10-07;2;0;2;2620.29868333099;2422.23566154656;59;5042.53434487755
08;2020-10-07;0;1;1;1621.44173420671;1438.58325779464;69;3060.02499200135
08;2020-10-07;0;0;0;626.575909335673;526.358467843651;79;1152.93437717932
08;2020-10-07;0;0;0;205.018522985054;140.993639349697;89;346.012162334751
08;2020-10-07;0;0;0;50.0325684687745;20.62259870351;90;70.6551671722846
08;2020-10-07;11;2;13;18551.3174743414;16782.6825256586;0;35334
11;2020-10-07;56;64;133;783071;811785;09;1594856
11;2020-10-07;391;333;748;761456;784653;19;1546109
11;2020-10-07;911;808;1724;850145;801772;29;1651917
11;2020-10-07;661;575;1241;914360;843488;39;1757848
11;2020-10-07;542;484;1030;845609;826202;49;1671811
11;2020-10-07;430;412;844;793566;745070;59;1538636
11;2020-10-07;263;262;529;628649;549192;69;1177841
11;2020-10-07;99;114;213;434606;358356;79;792962
11;2020-10-07;49;39;88;261425;162933;89;424358
11;2020-10-07;22;11;33;89253;32619;90;121872
11;2020-10-07;3424;3104;6587;6362140;5916070;0;12278210
24;2020-10-07;1;4;5;139720;144686;09;284406
24;2020-10-07;23;18;42;152979;161185;19;314164
24;2020-10-07;34;30;64;122237;126536;29;248773
24;2020-10-07;34;32;66;150359;142009;39;292368
24;2020-10-07;31;25;56;161829;158758;49;320587
24;2020-10-07;37;23;60;172552;168011;59;340563
24;2020-10-07;23;13;36;172509;158177;69;330686
24;2020-10-07;8;12;20;129428;110593;79;240021
24;2020-10-07;1;4;5;87342;56882;89;144224
24;2020-10-07;0;0;0;31210;12071;90;43281
24;2020-10-07;192;161;354;1320165;1238908;0;2559073
27;2020-10-07;11;8;19;143373;149679;09;293052
27;2020-10-07;25;44;70;160962;173003;19;333965
27;2020-10-07;43;61;104;133746;142254;29;276000
27;2020-10-07;36;37;73;160004;155407;39;315411
27;2020-10-07;42;45;87;172333;169564;49;341897
27;2020-10-07;48;41;89;189979;183788;59;373767
27;2020-10-07;41;32;73;192591;178206;69;370797
27;2020-10-07;19;23;42;146876;127546;79;274422
27;2020-10-07;11;9;20;96896;61575;89;158471
27;2020-10-07;2;0;2;33148;12109;90;45257
27;2020-10-07;278;300;579;1429908;1353131;0;2783039
28;2020-10-07;11;11;22;180735;186856;09;367591
28;2020-10-07;47;56;104;200125;213621;19;413746
28;2020-10-07;108;90;198;168922;173007;29;341929
28;2020-10-07;55;60;115;196628;188487;39;385115
28;2020-10-07;52;44;96;205396;201699;49;407095
28;2020-10-07;49;35;84;222002;213866;59;435868
28;2020-10-07;39;46;85;224688;203758;69;428446
28;2020-10-07;22;30;52;163192;135543;79;298735
28;2020-10-07;15;12;27;109691;65377;89;175068
28;2020-10-07;12;4;16;37222;12685;90;49907
28;2020-10-07;410;388;799;1708601;1594899;0;3303500
32;2020-10-07;31;30;61;358062;373689;09;731751
32;2020-10-07;170;164;335;387045;406742;19;793787
32;2020-10-07;269;223;492;342304;348587;29;690891
32;2020-10-07;204;177;381;382485;369972;39;752457
32;2020-10-07;190;166;356;382510;376716;49;759226
32;2020-10-07;173;140;313;386937;376527;59;763464
32;2020-10-07;81;72;153;371211;330938;69;702149
32;2020-10-07;59;52;112;250542;201459;79;452001
32;2020-10-07;46;33;79;163399;89786;89;253185
32;2020-10-07;20;11;31;48384;15367;90;63751
32;2020-10-07;1243;1069;2314;3072879;2889783;0;5962662
44;2020-10-07;9;7;16;291525;306839;09;598364
44;2020-10-07;59;52;111;320255;339504;19;659759
44;2020-10-07;107;106;213;302020;314428;29;616448
44;2020-10-07;66;73;139;342222;333292;39;675514
44;2020-10-07;72;54;126;349727;344491;49;694218
44;2020-10-07;51;47;98;381371;373239;59;754610
44;2020-10-07;36;41;77;367165;335850;69;703015
44;2020-10-07;18;19;37;250387;215436;79;465823
44;2020-10-07;11;13;24;170825;105192;89;276017
44;2020-10-07;5;4;9;51248;16731;90;67979
44;2020-10-07;434;416;850;2826745;2685002;0;5511747
52;2020-10-07;6;9;15;213594;223900;09;437494
52;2020-10-07;39;40;79;240818;255197;19;496015
52;2020-10-07;66;85;152;197010;200630;29;397640
52;2020-10-07;52;42;94;231204;224885;39;456089
52;2020-10-07;53;43;97;243874;243418;49;487292
52;2020-10-07;51;36;87;244100;239116;59;483216
52;2020-10-07;42;25;67;241796;221345;69;463141
52;2020-10-07;22;13;35;177805;149903;79;327708
52;2020-10-07;6;5;11;119561;75822;89;195383
52;2020-10-07;2;3;5;42559;15260;90;57819
52;2020-10-07;339;301;642;1952321;1849476;0;3801797
53;2020-10-07;7;6;13;173813;182358;09;356171
53;2020-10-07;39;27;67;202720;214740;19;417460
53;2020-10-07;45;54;100;163116;173196;29;336312
53;2020-10-07;16;14;30;190526;187674;39;378200
53;2020-10-07;29;19;48;212098;212015;49;424113
53;2020-10-07;29;20;49;223699;219176;59;442875
53;2020-10-07;19;14;33;227435;209274;69;436709
53;2020-10-07;6;7;13;169992;140910;79;310902
53;2020-10-07;7;2;9;118117;69883;89;188000
53;2020-10-07;2;2;4;37370;12267;90;49637
53;2020-10-07;199;165;366;1718886;1621493;0;3340379
75;2020-10-07;7;6;14;293104;305291;09;598395
75;2020-10-07;56;75;132;337141;357785;19;694926
75;2020-10-07;108;107;215;295024;300618;29;595642
75;2020-10-07;63;69;132;347871;331233;39;679104
75;2020-10-07;57;54;111;384742;372771;49;757513
75;2020-10-07;61;59;120;413361;390880;59;804241
75;2020-10-07;30;19;49;425623;384060;69;809683
75;2020-10-07;18;12;30;325086;276298;79;601384
75;2020-10-07;14;15;29;213986;139308;89;353294
75;2020-10-07;16;2;18;77600;28200;90;105800
75;2020-10-07;430;419;851;3113538;2886444;0;5999982
76;2020-10-07;21;24;45;305956;318589;09;624545
76;2020-10-07;100;151;254;338942;356969;19;695911
76;2020-10-07;214;163;379;316210;319570;29;635780
76;2020-10-07;143;152;295;356758;337587;39;694345
76;2020-10-07;156;136;293;376541;363812;49;740353
76;2020-10-07;138;148;286;402608;383750;59;786358
76;2020-10-07;77;72;149;394889;358997;69;753886
76;2020-10-07;42;47;89;308664;263806;79;572470
76;2020-10-07;60;36;96;195838;129272;89;325110
76;2020-10-07;41;6;47;69372;26728;90;96100
76;2020-10-07;992;935;1933;3065778;2859080;0;5924858
84;2020-10-07;42;43;85;459549;481088;09;940637
84;2020-10-07;260;256;518;487711;511905;19;999616
84;2020-10-07;365;350;715;443824;451094;29;894918
84;2020-10-07;284;247;533;512522;493262;39;1005784
84;2020-10-07;291;258;549;520248;515106;49;1035354
84;2020-10-07;250;228;478;529611;514848;59;1044459
84;2020-10-07;129;134;263;486720;439940;69;926660
84;2020-10-07;83;74;157;372151;315211;79;687362
84;2020-10-07;55;42;97;237198;150524;89;387722
84;2020-10-07;37;11;48;81185;28680;90;109865
84;2020-10-07;1796;1644;3444;4130719;3901658;0;8032377
93;2020-10-07;23;16;39;268834;283093;09;551927
93;2020-10-07;101;96;197;280751;296087;19;576838
93;2020-10-07;128;135;263;254404;255552;29;509956
93;2020-10-07;105;92;197;310704;288398;39;599102
93;2020-10-07;111;105;217;325559;305827;49;631386
93;2020-10-07;112;81;194;353104;325389;59;678493
93;2020-10-07;65;71;136;336327;296459;69;632786
93;2020-10-07;39;38;78;279820;229699;79;509519
93;2020-10-07;39;26;65;171274;113716;89;284990
93;2020-10-07;21;4;25;58896;21758;90;80654
93;2020-10-07;744;666;1415;2639673;2415978;0;5055651
94;2020-10-07;1;0;1;16311;17433;09;33744
94;2020-10-07;4;3;8;16679;18132;19;34811
94;2020-10-07;4;3;7;16782;16579;29;33361
94;2020-10-07;4;2;6;23044;20580;39;43624
94;2020-10-07;2;6;8;23065;22140;49;45205
94;2020-10-07;3;5;8;24549;23421;59;47970
94;2020-10-07;2;3;5;23212;21883;69;45095
94;2020-10-07;2;3;5;19544;17141;79;36685
94;2020-10-07;2;0;2;11227;8178;89;19405
94;2020-10-07;0;1;1;3332;1447;90;4779
94;2020-10-07;24;26;51;177745;166934;0;344679
01;2020-10-08;2;1;3;19979;20155;09;40134
01;2020-10-08;9;2;11;24994;25489;19;50483
01;2020-10-08;7;5;12;17868;16690;29;34558
01;2020-10-08;17;4;21;22328;14821;39;37149
01;2020-10-08;14;11;25;28652;20276;49;48928
01;2020-10-08;12;17;29;33264;27260;59;60524
01;2020-10-08;8;11;19;27135;23978;69;51113
01;2020-10-08;3;7;10;18401;14661;79;33062
01;2020-10-08;1;2;3;9633;6375;89;16008
01;2020-10-08;1;0;1;3410;1510;90;4920
01;2020-10-08;74;60;134;205664;171215;0;376879
02;2020-10-08;0;0;0;16881;17110;09;33991
02;2020-10-08;6;2;8;21410;21604;19;43014
02;2020-10-08;10;3;13;16017;15479;29;31496
02;2020-10-08;9;6;15;19825;14455;39;34280
02;2020-10-08;9;5;15;24719;18248;49;42967
02;2020-10-08;8;8;16;34361;28310;59;62671
02;2020-10-08;9;5;14;28061;24495;69;52556
02;2020-10-08;4;5;9;18231;15278;79;33509
02;2020-10-08;2;1;3;11090;7677;89;18767
02;2020-10-08;0;1;1;3992;1506;90;5498
02;2020-10-08;57;36;94;194587;164162;0;358749
03;2020-10-08;1;0;1;31123;30920;09;62043
03;2020-10-08;3;0;3;29370;29268;19;58638
03;2020-10-08;2;1;3;21458;18963;29;40421
03;2020-10-08;0;0;0;21276;18326;39;39602
03;2020-10-08;2;3;5;18164;16593;49;34757
03;2020-10-08;5;0;5;13469;13557;59;27026
03;2020-10-08;2;0;2;8776;8670;69;17446
03;2020-10-08;0;0;0;3777;3591;79;7368
03;2020-10-08;0;0;0;1649;1072;89;2721
03;2020-10-08;0;0;0;485;184;90;669
03;2020-10-08;15;4;19;149547;141144;0;290691
04;2020-10-08;1;0;1;60314;61377;09;121691
04;2020-10-08;4;4;8;66065;68387;19;134452
04;2020-10-08;9;9;18;51059;47156;29;98215
04;2020-10-08;0;5;5;58788;45780;39;104568
04;2020-10-08;1;1;2;61408;52207;49;113615
04;2020-10-08;7;5;12;64838;60759;59;125597
04;2020-10-08;2;1;3;47008;42843;69;89851
04;2020-10-08;0;0;0;25509;21184;79;46693
04;2020-10-08;0;0;0;13168;7647;89;20815
04;2020-10-08;0;0;0;3209;1253;90;4462
04;2020-10-08;24;25;49;451366;408593;0;859959
05;2020-10-08;0;0;0;362.366008612902;341.338819562748;09;703.704828175651
05;2020-10-08;0;0;0;353.376145114279;370.349735405642;19;723.725880519921
05;2020-10-08;0;0;0;218.593559489256;256.539602589476;29;475.133162078732
05;2020-10-08;0;0;0;404.225408693299;360.321910454353;39;764.547319147651
05;2020-10-08;0;0;0;520.067953604221;497.108383964256;49;1017.17633756848
05;2020-10-08;0;0;0;468.146063921917;510.087601910415;59;978.233665832332
05;2020-10-08;0;0;0;340.368470050554;334.366842191253;69;674.735312241807
05;2020-10-08;0;0;0;212.598666888387;192.597753227106;79;405.196420115493
05;2020-10-08;1;0;1;148.727797095705;61.8681715431829;89;210.595968638888
05;2020-10-08;0;0;0;32.9601271090696;10.9909785719784;90;43.9511056810479
05;2020-10-08;1;0;1;3061.43020057959;2935.56979942041;0;5997
06;2020-10-08;0;0;0;42583;42380;09;84963
06;2020-10-08;0;3;3;33369;31925;19;65294
06;2020-10-08;4;1;5;21571;15080;29;36651
06;2020-10-08;3;2;5;21550;16147;39;37697
06;2020-10-08;3;1;4;14193;13939;49;28132
06;2020-10-08;1;0;1;7171;7597;59;14768
06;2020-10-08;0;1;1;3629;4117;69;7746
06;2020-10-08;0;0;0;1577;1457;79;3034
06;2020-10-08;0;0;0;531;474;89;1005
06;2020-10-08;0;0;0;88;93;90;181
06;2020-10-08;11;8;19;146262;133209;0;279471
07;2020-10-08;0;0;0;485;549;09;1034
07;2020-10-08;0;0;0;403;432;19;835
07;2020-10-08;0;1;1;764;841;29;1605
07;2020-10-08;0;0;0;824;928;39;1752
07;2020-10-08;0;0;0;788;1020;49;1808
07;2020-10-08;0;0;0;678;870;59;1548
07;2020-10-08;0;0;0;360;382;69;742
07;2020-10-08;0;0;0;231;190;79;421
07;2020-10-08;0;0;0;114;67;89;181
07;2020-10-08;0;0;0;24;11;90;35
07;2020-10-08;0;1;1;4671;5290;0;9961
08;2020-10-08;0;0;0;2715.22592983026;2997.75551488675;09;5712.98144471701
08;2020-10-08;0;0;0;2778.51901080978;3160.9156459093;19;5939.43465671908
08;2020-10-08;2;1;3;2080.8882988764;1718.16634315323;29;3799.05464202964
08;2020-10-08;0;0;0;2701.8582062647;1896.52641413317;39;4598.38462039786
08;2020-10-08;2;1;3;3151.45861023308;2460.52498233809;49;5611.98359257117
08;2020-10-08;2;0;2;2620.29868333099;2422.23566154656;59;5042.53434487755
08;2020-10-08;1;0;1;1621.44173420671;1438.58325779464;69;3060.02499200135
08;2020-10-08;0;0;0;626.575909335673;526.358467843651;79;1152.93437717932
08;2020-10-08;0;0;0;205.018522985054;140.993639349697;89;346.012162334751
08;2020-10-08;0;0;0;50.0325684687745;20.62259870351;90;70.6551671722846
08;2020-10-08;7;2;9;18551.3174743414;16782.6825256586;0;35334
11;2020-10-08;69;68;147;783071;811785;09;1594856
11;2020-10-08;383;406;817;761456;784653;19;1546109
11;2020-10-08;970;816;1792;850145;801772;29;1651917
11;2020-10-08;674;649;1324;914360;843488;39;1757848
11;2020-10-08;643;493;1137;845609;826202;49;1671811
11;2020-10-08;481;464;949;793566;745070;59;1538636
11;2020-10-08;274;270;548;628649;549192;69;1177841
11;2020-10-08;113;116;229;434606;358356;79;792962
11;2020-10-08;70;62;132;261425;162933;89;424358
11;2020-10-08;38;10;48;89253;32619;90;121872
11;2020-10-08;3718;3355;7135;6362140;5916070;0;12278210
24;2020-10-08;8;2;10;139720;144686;09;284406
24;2020-10-08;30;33;63;152979;161185;19;314164
24;2020-10-08;54;48;102;122237;126536;29;248773
24;2020-10-08;65;40;105;150359;142009;39;292368
24;2020-10-08;45;34;79;161829;158758;49;320587
24;2020-10-08;30;33;63;172552;168011;59;340563
24;2020-10-08;24;16;40;172509;158177;69;330686
24;2020-10-08;14;13;27;129428;110593;79;240021
24;2020-10-08;6;6;12;87342;56882;89;144224
24;2020-10-08;2;3;5;31210;12071;90;43281
24;2020-10-08;278;229;507;1320165;1238908;0;2559073
27;2020-10-08;2;10;12;143373;149679;09;293052
27;2020-10-08;26;39;65;160962;173003;19;333965
27;2020-10-08;40;50;90;133746;142254;29;276000
27;2020-10-08;45;41;86;160004;155407;39;315411
27;2020-10-08;40;37;77;172333;169564;49;341897
27;2020-10-08;40;34;74;189979;183788;59;373767
27;2020-10-08;28;29;57;192591;178206;69;370797
27;2020-10-08;12;16;28;146876;127546;79;274422
27;2020-10-08;18;9;27;96896;61575;89;158471
27;2020-10-08;8;4;12;33148;12109;90;45257
27;2020-10-08;259;269;528;1429908;1353131;0;2783039
28;2020-10-08;5;8;14;180735;186856;09;367591
28;2020-10-08;52;47;99;200125;213621;19;413746
28;2020-10-08;96;99;195;168922;173007;29;341929
28;2020-10-08;60;58;118;196628;188487;39;385115
28;2020-10-08;53;61;114;205396;201699;49;407095
28;2020-10-08;45;63;108;222002;213866;59;435868
28;2020-10-08;40;35;75;224688;203758;69;428446
28;2020-10-08;24;15;39;163192;135543;79;298735
28;2020-10-08;14;7;21;109691;65377;89;175068
28;2020-10-08;6;3;9;37222;12685;90;49907
28;2020-10-08;395;396;792;1708601;1594899;0;3303500
32;2020-10-08;32;39;72;358062;373689;09;731751
32;2020-10-08;182;170;352;387045;406742;19;793787
32;2020-10-08;280;270;551;342304;348587;29;690891
32;2020-10-08;198;200;400;382485;369972;39;752457
32;2020-10-08;199;178;377;382510;376716;49;759226
32;2020-10-08;160;170;330;386937;376527;59;763464
32;2020-10-08;98;119;217;371211;330938;69;702149
32;2020-10-08;59;55;114;250542;201459;79;452001
32;2020-10-08;62;40;102;163399;89786;89;253185
32;2020-10-08;29;9;38;48384;15367;90;63751
32;2020-10-08;1300;1250;2554;3072879;2889783;0;5962662
44;2020-10-08;10;10;20;291525;306839;09;598364
44;2020-10-08;57;70;128;320255;339504;19;659759
44;2020-10-08;105;89;194;302020;314428;29;616448
44;2020-10-08;77;75;152;342222;333292;39;675514
44;2020-10-08;72;73;145;349727;344491;49;694218
44;2020-10-08;57;66;123;381371;373239;59;754610
44;2020-10-08;47;42;89;367165;335850;69;703015
44;2020-10-08;32;37;69;250387;215436;79;465823
44;2020-10-08;14;7;21;170825;105192;89;276017
44;2020-10-08;11;3;14;51248;16731;90;67979
44;2020-10-08;482;472;955;2826745;2685002;0;5511747
52;2020-10-08;3;8;11;213594;223900;09;437494
52;2020-10-08;54;41;97;240818;255197;19;496015
52;2020-10-08;99;81;180;197010;200630;29;397640
52;2020-10-08;51;58;109;231204;224885;39;456089
52;2020-10-08;49;64;113;243874;243418;49;487292
52;2020-10-08;45;43;88;244100;239116;59;483216
52;2020-10-08;39;32;71;241796;221345;69;463141
52;2020-10-08;26;32;58;177805;149903;79;327708
52;2020-10-08;8;11;19;119561;75822;89;195383
52;2020-10-08;5;0;5;42559;15260;90;57819
52;2020-10-08;380;370;752;1952321;1849476;0;3801797
53;2020-10-08;3;4;8;173813;182358;09;356171
53;2020-10-08;45;25;70;202720;214740;19;417460
53;2020-10-08;60;38;99;163116;173196;29;336312
53;2020-10-08;35;22;57;190526;187674;39;378200
53;2020-10-08;41;30;71;212098;212015;49;424113
53;2020-10-08;21;30;51;223699;219176;59;442875
53;2020-10-08;19;20;39;227435;209274;69;436709
53;2020-10-08;8;9;17;169992;140910;79;310902
53;2020-10-08;9;4;13;118117;69883;89;188000
53;2020-10-08;6;1;7;37370;12267;90;49637
53;2020-10-08;247;183;432;1718886;1621493;0;3340379
75;2020-10-08;11;11;22;293104;305291;09;598395
75;2020-10-08;68;60;128;337141;357785;19;694926
75;2020-10-08;110;112;222;295024;300618;29;595642
75;2020-10-08;78;70;148;347871;331233;39;679104
75;2020-10-08;82;62;145;384742;372771;49;757513
75;2020-10-08;81;69;150;413361;390880;59;804241
75;2020-10-08;30;45;75;425623;384060;69;809683
75;2020-10-08;22;22;44;325086;276298;79;601384
75;2020-10-08;10;6;16;213986;139308;89;353294
75;2020-10-08;9;4;13;77600;28200;90;105800
75;2020-10-08;501;462;964;3113538;2886444;0;5999982
76;2020-10-08;18;15;34;305956;318589;09;624545
76;2020-10-08;110;138;253;338942;356969;19;695911
76;2020-10-08;212;174;386;316210;319570;29;635780
76;2020-10-08;160;145;305;356758;337587;39;694345
76;2020-10-08;156;119;275;376541;363812;49;740353
76;2020-10-08;149;146;295;402608;383750;59;786358
76;2020-10-08;87;82;169;394889;358997;69;753886
76;2020-10-08;54;59;113;308664;263806;79;572470
76;2020-10-08;34;33;67;195838;129272;89;325110
76;2020-10-08;16;5;21;69372;26728;90;96100
76;2020-10-08;996;916;1918;3065778;2859080;0;5924858
84;2020-10-08;46;47;93;459549;481088;09;940637
84;2020-10-08;264;304;570;487711;511905;19;999616
84;2020-10-08;397;395;793;443824;451094;29;894918
84;2020-10-08;364;273;637;512522;493262;39;1005784
84;2020-10-08;358;277;635;520248;515106;49;1035354
84;2020-10-08;259;262;521;529611;514848;59;1044459
84;2020-10-08;163;130;293;486720;439940;69;926660
84;2020-10-08;102;67;169;372151;315211;79;687362
84;2020-10-08;72;44;116;237198;150524;89;387722
84;2020-10-08;47;12;59;81185;28680;90;109865
84;2020-10-08;2072;1811;3886;4130719;3901658;0;8032377
93;2020-10-08;26;26;52;268834;283093;09;551927
93;2020-10-08;95;95;190;280751;296087;19;576838
93;2020-10-08;159;129;290;254404;255552;29;509956
93;2020-10-08;124;93;217;310704;288398;39;599102
93;2020-10-08;107;103;211;325559;305827;49;631386
93;2020-10-08;110;113;223;353104;325389;59;678493
93;2020-10-08;81;66;147;336327;296459;69;632786
93;2020-10-08;46;40;86;279820;229699;79;509519
93;2020-10-08;18;17;35;171274;113716;89;284990
93;2020-10-08;19;7;26;58896;21758;90;80654
93;2020-10-08;786;689;1478;2639673;2415978;0;5055651
94;2020-10-08;0;1;1;16311;17433;09;33744
94;2020-10-08;4;0;4;16679;18132;19;34811
94;2020-10-08;7;6;13;16782;16579;29;33361
94;2020-10-08;6;5;11;23044;20580;39;43624
94;2020-10-08;4;9;13;23065;22140;49;45205
94;2020-10-08;5;2;7;24549;23421;59;47970
94;2020-10-08;2;3;5;23212;21883;69;45095
94;2020-10-08;4;2;6;19544;17141;79;36685
94;2020-10-08;2;0;2;11227;8178;89;19405
94;2020-10-08;1;0;1;3332;1447;90;4779
94;2020-10-08;35;28;63;177745;166934;0;344679
01;2020-10-09;0;2;2;19979;20155;09;40134
01;2020-10-09;3;5;8;24994;25489;19;50483
01;2020-10-09;6;1;7;17868;16690;29;34558
01;2020-10-09;9;3;12;22328;14821;39;37149
01;2020-10-09;7;5;12;28652;20276;49;48928
01;2020-10-09;5;9;14;33264;27260;59;60524
01;2020-10-09;6;5;11;27135;23978;69;51113
01;2020-10-09;3;0;3;18401;14661;79;33062
01;2020-10-09;2;0;2;9633;6375;89;16008
01;2020-10-09;0;0;0;3410;1510;90;4920
01;2020-10-09;41;30;71;205664;171215;0;376879
02;2020-10-09;0;1;1;16881;17110;09;33991
02;2020-10-09;6;4;10;21410;21604;19;43014
02;2020-10-09;6;4;10;16017;15479;29;31496
02;2020-10-09;7;13;20;19825;14455;39;34280
02;2020-10-09;11;8;19;24719;18248;49;42967
02;2020-10-09;10;10;20;34361;28310;59;62671
02;2020-10-09;8;6;14;28061;24495;69;52556
02;2020-10-09;3;0;3;18231;15278;79;33509
02;2020-10-09;2;1;3;11090;7677;89;18767
02;2020-10-09;1;0;1;3992;1506;90;5498
02;2020-10-09;54;47;101;194587;164162;0;358749
03;2020-10-09;1;0;1;31123;30920;09;62043
03;2020-10-09;2;0;2;29370;29268;19;58638
03;2020-10-09;5;2;7;21458;18963;29;40421
03;2020-10-09;3;0;3;21276;18326;39;39602
03;2020-10-09;0;2;2;18164;16593;49;34757
03;2020-10-09;2;1;3;13469;13557;59;27026
03;2020-10-09;1;1;2;8776;8670;69;17446
03;2020-10-09;0;0;0;3777;3591;79;7368
03;2020-10-09;0;0;0;1649;1072;89;2721
03;2020-10-09;0;0;0;485;184;90;669
03;2020-10-09;14;6;20;149547;141144;0;290691
04;2020-10-09;1;2;3;60314;61377;09;121691
04;2020-10-09;10;12;22;66065;68387;19;134452
04;2020-10-09;6;7;13;51059;47156;29;98215
04;2020-10-09;8;0;8;58788;45780;39;104568
04;2020-10-09;8;6;14;61408;52207;49;113615
04;2020-10-09;4;1;5;64838;60759;59;125597
04;2020-10-09;3;0;3;47008;42843;69;89851
04;2020-10-09;0;0;0;25509;21184;79;46693
04;2020-10-09;0;0;0;13168;7647;89;20815
04;2020-10-09;0;0;0;3209;1253;90;4462
04;2020-10-09;40;28;68;451366;408593;0;859959
05;2020-10-09;0;0;0;362.366008612902;341.338819562748;09;703.704828175651
05;2020-10-09;0;0;0;353.376145114279;370.349735405642;19;723.725880519921
05;2020-10-09;0;0;0;218.593559489256;256.539602589476;29;475.133162078732
05;2020-10-09;0;0;0;404.225408693299;360.321910454353;39;764.547319147651
05;2020-10-09;0;0;0;520.067953604221;497.108383964256;49;1017.17633756848
05;2020-10-09;0;0;0;468.146063921917;510.087601910415;59;978.233665832332
05;2020-10-09;0;0;0;340.368470050554;334.366842191253;69;674.735312241807
05;2020-10-09;0;0;0;212.598666888387;192.597753227106;79;405.196420115493
05;2020-10-09;0;0;0;148.727797095705;61.8681715431829;89;210.595968638888
05;2020-10-09;0;0;0;32.9601271090696;10.9909785719784;90;43.9511056810479
05;2020-10-09;0;0;0;3061.43020057959;2935.56979942041;0;5997
06;2020-10-09;0;1;1;42583;42380;09;84963
06;2020-10-09;3;4;7;33369;31925;19;65294
06;2020-10-09;5;3;8;21571;15080;29;36651
06;2020-10-09;4;1;5;21550;16147;39;37697
06;2020-10-09;5;4;9;14193;13939;49;28132
06;2020-10-09;3;0;3;7171;7597;59;14768
06;2020-10-09;0;1;1;3629;4117;69;7746
06;2020-10-09;0;0;0;1577;1457;79;3034
06;2020-10-09;0;1;1;531;474;89;1005
06;2020-10-09;0;0;0;88;93;90;181
06;2020-10-09;20;15;35;146262;133209;0;279471
07;2020-10-09;0;0;0;485;549;09;1034
07;2020-10-09;0;0;0;403;432;19;835
07;2020-10-09;0;0;0;764;841;29;1605
07;2020-10-09;0;0;0;824;928;39;1752
07;2020-10-09;0;0;0;788;1020;49;1808
07;2020-10-09;0;0;0;678;870;59;1548
07;2020-10-09;0;1;1;360;382;69;742
07;2020-10-09;0;0;0;231;190;79;421
07;2020-10-09;0;0;0;114;67;89;181
07;2020-10-09;0;0;0;24;11;90;35
07;2020-10-09;0;1;1;4671;5290;0;9961
08;2020-10-09;0;0;0;2715.22592983026;2997.75551488675;09;5712.98144471701
08;2020-10-09;1;0;1;2778.51901080978;3160.9156459093;19;5939.43465671908
08;2020-10-09;0;1;1;2080.8882988764;1718.16634315323;29;3799.05464202964
08;2020-10-09;0;0;0;2701.8582062647;1896.52641413317;39;4598.38462039786
08;2020-10-09;2;2;4;3151.45861023308;2460.52498233809;49;5611.98359257117
08;2020-10-09;2;0;2;2620.29868333099;2422.23566154656;59;5042.53434487755
08;2020-10-09;0;0;0;1621.44173420671;1438.58325779464;69;3060.02499200135
08;2020-10-09;0;0;0;626.575909335673;526.358467843651;79;1152.93437717932
08;2020-10-09;0;0;0;205.018522985054;140.993639349697;89;346.012162334751
08;2020-10-09;0;0;0;50.0325684687745;20.62259870351;90;70.6551671722846
08;2020-10-09;5;3;8;18551.3174743414;16782.6825256586;0;35334
11;2020-10-09;63;79;152;783071;811785;09;1594856
11;2020-10-09;402;396;814;761456;784653;19;1546109
11;2020-10-09;901;809;1716;850145;801772;29;1651917
11;2020-10-09;708;616;1330;914360;843488;39;1757848
11;2020-10-09;611;503;1120;845609;826202;49;1671811
11;2020-10-09;491;402;901;793566;745070;59;1538636
11;2020-10-09;285;253;547;628649;549192;69;1177841
11;2020-10-09;102;118;220;434606;358356;79;792962
11;2020-10-09;61;55;116;261425;162933;89;424358
11;2020-10-09;41;9;51;89253;32619;90;121872
11;2020-10-09;3665;3240;6968;6362140;5916070;0;12278210
24;2020-10-09;10;5;15;139720;144686;09;284406
24;2020-10-09;32;27;59;152979;161185;19;314164
24;2020-10-09;50;40;90;122237;126536;29;248773
24;2020-10-09;48;53;101;150359;142009;39;292368
24;2020-10-09;37;38;75;161829;158758;49;320587
24;2020-10-09;40;45;85;172552;168011;59;340563
24;2020-10-09;26;28;54;172509;158177;69;330686
24;2020-10-09;10;18;28;129428;110593;79;240021
24;2020-10-09;6;8;14;87342;56882;89;144224
24;2020-10-09;5;1;6;31210;12071;90;43281
24;2020-10-09;264;263;527;1320165;1238908;0;2559073
27;2020-10-09;5;10;15;143373;149679;09;293052
27;2020-10-09;43;49;92;160962;173003;19;333965
27;2020-10-09;73;45;118;133746;142254;29;276000
27;2020-10-09;51;53;104;160004;155407;39;315411
27;2020-10-09;55;49;104;172333;169564;49;341897
27;2020-10-09;63;39;102;189979;183788;59;373767
27;2020-10-09;32;35;67;192591;178206;69;370797
27;2020-10-09;21;22;43;146876;127546;79;274422
27;2020-10-09;17;19;36;96896;61575;89;158471
27;2020-10-09;23;8;31;33148;12109;90;45257
27;2020-10-09;383;329;712;1429908;1353131;0;2783039
28;2020-10-09;12;10;23;180735;186856;09;367591
28;2020-10-09;60;50;113;200125;213621;19;413746
28;2020-10-09;78;84;162;168922;173007;29;341929
28;2020-10-09;61;51;113;196628;188487;39;385115
28;2020-10-09;64;56;120;205396;201699;49;407095
28;2020-10-09;60;42;102;222002;213866;59;435868
28;2020-10-09;47;38;85;224688;203758;69;428446
28;2020-10-09;30;33;63;163192;135543;79;298735
28;2020-10-09;22;11;33;109691;65377;89;175068
28;2020-10-09;12;3;15;37222;12685;90;49907
28;2020-10-09;446;378;829;1708601;1594899;0;3303500
32;2020-10-09;34;46;80;358062;373689;09;731751
32;2020-10-09;200;220;421;387045;406742;19;793787
32;2020-10-09;254;252;506;342304;348587;29;690891
32;2020-10-09;244;209;453;382485;369972;39;752457
32;2020-10-09;208;190;398;382510;376716;49;759226
32;2020-10-09;198;151;349;386937;376527;59;763464
32;2020-10-09;122;108;230;371211;330938;69;702149
32;2020-10-09;89;61;150;250542;201459;79;452001
32;2020-10-09;48;45;93;163399;89786;89;253185
32;2020-10-09;24;8;32;48384;15367;90;63751
32;2020-10-09;1421;1290;2712;3072879;2889783;0;5962662
44;2020-10-09;13;13;26;291525;306839;09;598364
44;2020-10-09;75;94;169;320255;339504;19;659759
44;2020-10-09;103;106;209;302020;314428;29;616448
44;2020-10-09;92;80;172;342222;333292;39;675514
44;2020-10-09;77;77;154;349727;344491;49;694218
44;2020-10-09;94;83;177;381371;373239;59;754610
44;2020-10-09;42;50;92;367165;335850;69;703015
44;2020-10-09;26;27;53;250387;215436;79;465823
44;2020-10-09;24;14;38;170825;105192;89;276017
44;2020-10-09;10;1;11;51248;16731;90;67979
44;2020-10-09;556;545;1101;2826745;2685002;0;5511747
52;2020-10-09;8;8;16;213594;223900;09;437494
52;2020-10-09;52;42;96;240818;255197;19;496015
52;2020-10-09;73;80;153;197010;200630;29;397640
52;2020-10-09;59;62;122;231204;224885;39;456089
52;2020-10-09;50;59;109;243874;243418;49;487292
52;2020-10-09;49;52;101;244100;239116;59;483216
52;2020-10-09;38;37;76;241796;221345;69;463141
52;2020-10-09;24;20;44;177805;149903;79;327708
52;2020-10-09;9;6;15;119561;75822;89;195383
52;2020-10-09;1;2;3;42559;15260;90;57819
52;2020-10-09;363;368;735;1952321;1849476;0;3801797
53;2020-10-09;8;5;13;173813;182358;09;356171
53;2020-10-09;39;44;83;202720;214740;19;417460
53;2020-10-09;55;56;111;163116;173196;29;336312
53;2020-10-09;36;29;65;190526;187674;39;378200
53;2020-10-09;38;24;62;212098;212015;49;424113
53;2020-10-09;28;37;65;223699;219176;59;442875
53;2020-10-09;18;27;45;227435;209274;69;436709
53;2020-10-09;15;12;27;169992;140910;79;310902
53;2020-10-09;7;6;13;118117;69883;89;188000
53;2020-10-09;8;7;15;37370;12267;90;49637
53;2020-10-09;252;247;499;1718886;1621493;0;3340379
75;2020-10-09;10;16;26;293104;305291;09;598395
75;2020-10-09;69;59;128;337141;357785;19;694926
75;2020-10-09;120;128;248;295024;300618;29;595642
75;2020-10-09;77;74;151;347871;331233;39;679104
75;2020-10-09;70;67;137;384742;372771;49;757513
75;2020-10-09;66;55;121;413361;390880;59;804241
75;2020-10-09;44;32;76;425623;384060;69;809683
75;2020-10-09;19;27;46;325086;276298;79;601384
75;2020-10-09;13;13;26;213986;139308;89;353294
75;2020-10-09;4;3;7;77600;28200;90;105800
75;2020-10-09;492;474;966;3113538;2886444;0;5999982
76;2020-10-09;20;26;47;305956;318589;09;624545
76;2020-10-09;141;150;297;338942;356969;19;695911
76;2020-10-09;239;196;435;316210;319570;29;635780
76;2020-10-09;166;154;320;356758;337587;39;694345
76;2020-10-09;190;159;349;376541;363812;49;740353
76;2020-10-09;194;157;351;402608;383750;59;786358
76;2020-10-09;121;103;224;394889;358997;69;753886
76;2020-10-09;84;65;149;308664;263806;79;572470
76;2020-10-09;61;37;98;195838;129272;89;325110
76;2020-10-09;64;15;79;69372;26728;90;96100
76;2020-10-09;1281;1064;2352;3065778;2859080;0;5924858
84;2020-10-09;47;47;94;459549;481088;09;940637
84;2020-10-09;323;319;646;487711;511905;19;999616
84;2020-10-09;419;379;798;443824;451094;29;894918
84;2020-10-09;365;340;706;512522;493262;39;1005784
84;2020-10-09;413;286;699;520248;515106;49;1035354
84;2020-10-09;316;277;593;529611;514848;59;1044459
84;2020-10-09;155;172;327;486720;439940;69;926660
84;2020-10-09;108;114;222;372151;315211;79;687362
84;2020-10-09;91;57;148;237198;150524;89;387722
84;2020-10-09;66;14;80;81185;28680;90;109865
84;2020-10-09;2303;2005;4313;4130719;3901658;0;8032377
93;2020-10-09;18;26;44;268834;283093;09;551927
93;2020-10-09;99;127;228;280751;296087;19;576838
93;2020-10-09;152;157;309;254404;255552;29;509956
93;2020-10-09;132;123;255;310704;288398;39;599102
93;2020-10-09;153;126;279;325559;305827;49;631386
93;2020-10-09;123;115;239;353104;325389;59;678493
93;2020-10-09;78;90;168;336327;296459;69;632786
93;2020-10-09;55;34;89;279820;229699;79;509519
93;2020-10-09;46;27;73;171274;113716;89;284990
93;2020-10-09;34;6;40;58896;21758;90;80654
93;2020-10-09;890;831;1724;2639673;2415978;0;5055651
94;2020-10-09;1;0;1;16311;17433;09;33744
94;2020-10-09;4;3;7;16679;18132;19;34811
94;2020-10-09;7;13;20;16782;16579;29;33361
94;2020-10-09;7;4;11;23044;20580;39;43624
94;2020-10-09;5;5;10;23065;22140;49;45205
94;2020-10-09;4;5;9;24549;23421;59;47970
94;2020-10-09;4;3;7;23212;21883;69;45095
94;2020-10-09;1;5;6;19544;17141;79;36685
94;2020-10-09;0;1;1;11227;8178;89;19405
94;2020-10-09;0;0;0;3332;1447;90;4779
94;2020-10-09;33;39;72;177745;166934;0;344679
01;2020-10-10;1;1;2;19979;20155;09;40134
01;2020-10-10;1;1;2;24994;25489;19;50483
01;2020-10-10;1;0;1;17868;16690;29;34558
01;2020-10-10;2;3;5;22328;14821;39;37149
01;2020-10-10;3;2;5;28652;20276;49;48928
01;2020-10-10;4;3;7;33264;27260;59;60524
01;2020-10-10;2;4;6;27135;23978;69;51113
01;2020-10-10;1;0;1;18401;14661;79;33062
01;2020-10-10;0;3;3;9633;6375;89;16008
01;2020-10-10;0;1;1;3410;1510;90;4920
01;2020-10-10;15;18;33;205664;171215;0;376879
02;2020-10-10;0;1;1;16881;17110;09;33991
02;2020-10-10;1;1;2;21410;21604;19;43014
02;2020-10-10;1;2;3;16017;15479;29;31496
02;2020-10-10;2;2;4;19825;14455;39;34280
02;2020-10-10;2;2;4;24719;18248;49;42967
02;2020-10-10;10;1;11;34361;28310;59;62671
02;2020-10-10;4;1;5;28061;24495;69;52556
02;2020-10-10;2;2;4;18231;15278;79;33509
02;2020-10-10;7;0;7;11090;7677;89;18767
02;2020-10-10;0;0;0;3992;1506;90;5498
02;2020-10-10;29;12;41;194587;164162;0;358749
03;2020-10-10;0;1;1;31123;30920;09;62043
03;2020-10-10;0;2;2;29370;29268;19;58638
03;2020-10-10;1;1;2;21458;18963;29;40421
03;2020-10-10;0;0;0;21276;18326;39;39602
03;2020-10-10;0;0;0;18164;16593;49;34757
03;2020-10-10;1;1;2;13469;13557;59;27026
03;2020-10-10;0;0;0;8776;8670;69;17446
03;2020-10-10;0;0;0;3777;3591;79;7368
03;2020-10-10;0;0;0;1649;1072;89;2721
03;2020-10-10;0;0;0;485;184;90;669
03;2020-10-10;2;5;7;149547;141144;0;290691
04;2020-10-10;1;0;1;60314;61377;09;121691
04;2020-10-10;3;2;5;66065;68387;19;134452
04;2020-10-10;3;3;6;51059;47156;29;98215
04;2020-10-10;2;2;4;58788;45780;39;104568
04;2020-10-10;1;2;3;61408;52207;49;113615
04;2020-10-10;2;2;4;64838;60759;59;125597
04;2020-10-10;2;1;3;47008;42843;69;89851
04;2020-10-10;1;0;1;25509;21184;79;46693
04;2020-10-10;0;0;0;13168;7647;89;20815
04;2020-10-10;0;0;0;3209;1253;90;4462
04;2020-10-10;15;12;27;451366;408593;0;859959
05;2020-10-10;0;0;0;362.366008612902;341.338819562748;09;703.704828175651
05;2020-10-10;0;0;0;353.376145114279;370.349735405642;19;723.725880519921
05;2020-10-10;0;0;0;218.593559489256;256.539602589476;29;475.133162078732
05;2020-10-10;0;0;0;404.225408693299;360.321910454353;39;764.547319147651
05;2020-10-10;0;0;0;520.067953604221;497.108383964256;49;1017.17633756848
05;2020-10-10;0;0;0;468.146063921917;510.087601910415;59;978.233665832332
05;2020-10-10;0;0;0;340.368470050554;334.366842191253;69;674.735312241807
05;2020-10-10;0;0;0;212.598666888387;192.597753227106;79;405.196420115493
05;2020-10-10;0;0;0;148.727797095705;61.8681715431829;89;210.595968638888
05;2020-10-10;0;0;0;32.9601271090696;10.9909785719784;90;43.9511056810479
05;2020-10-10;0;0;0;3061.43020057959;2935.56979942041;0;5997
06;2020-10-10;0;0;0;42583;42380;09;84963
06;2020-10-10;1;1;2;33369;31925;19;65294
06;2020-10-10;1;0;1;21571;15080;29;36651
06;2020-10-10;0;0;0;21550;16147;39;37697
06;2020-10-10;0;0;0;14193;13939;49;28132
06;2020-10-10;0;0;0;7171;7597;59;14768
06;2020-10-10;0;0;0;3629;4117;69;7746
06;2020-10-10;0;0;0;1577;1457;79;3034
06;2020-10-10;0;0;0;531;474;89;1005
06;2020-10-10;0;0;0;88;93;90;181
06;2020-10-10;2;1;3;146262;133209;0;279471
07;2020-10-10;0;0;0;485;549;09;1034
07;2020-10-10;0;0;0;403;432;19;835
07;2020-10-10;0;0;0;764;841;29;1605
07;2020-10-10;0;0;0;824;928;39;1752
07;2020-10-10;0;0;0;788;1020;49;1808
07;2020-10-10;0;0;0;678;870;59;1548
07;2020-10-10;0;0;0;360;382;69;742
07;2020-10-10;0;0;0;231;190;79;421
07;2020-10-10;0;0;0;114;67;89;181
07;2020-10-10;0;0;0;24;11;90;35
07;2020-10-10;0;0;0;4671;5290;0;9961
08;2020-10-10;0;0;0;2715.22592983026;2997.75551488675;09;5712.98144471701
08;2020-10-10;0;0;0;2778.51901080978;3160.9156459093;19;5939.43465671908
08;2020-10-10;0;0;0;2080.8882988764;1718.16634315323;29;3799.05464202964
08;2020-10-10;0;0;0;2701.8582062647;1896.52641413317;39;4598.38462039786
08;2020-10-10;0;0;0;3151.45861023308;2460.52498233809;49;5611.98359257117
08;2020-10-10;0;1;1;2620.29868333099;2422.23566154656;59;5042.53434487755
08;2020-10-10;0;0;0;1621.44173420671;1438.58325779464;69;3060.02499200135
08;2020-10-10;0;0;0;626.575909335673;526.358467843651;79;1152.93437717932
08;2020-10-10;0;0;0;205.018522985054;140.993639349697;89;346.012162334751
08;2020-10-10;0;0;0;50.0325684687745;20.62259870351;90;70.6551671722846
08;2020-10-10;0;1;1;18551.3174743414;16782.6825256586;0;35334
11;2020-10-10;25;28;62;783071;811785;09;1594856
11;2020-10-10;195;184;393;761456;784653;19;1546109
11;2020-10-10;396;327;724;850145;801772;29;1651917
11;2020-10-10;294;262;560;914360;843488;39;1757848
11;2020-10-10;261;242;504;845609;826202;49;1671811
11;2020-10-10;203;189;394;793566;745070;59;1538636
11;2020-10-10;145;121;268;628649;549192;69;1177841
11;2020-10-10;69;72;141;434606;358356;79;792962
11;2020-10-10;27;32;59;261425;162933;89;424358
11;2020-10-10;16;7;23;89253;32619;90;121872
11;2020-10-10;1632;1465;3130;6362140;5916070;0;12278210
24;2020-10-10;8;3;11;139720;144686;09;284406
24;2020-10-10;17;27;46;152979;161185;19;314164
24;2020-10-10;23;21;44;122237;126536;29;248773
24;2020-10-10;27;27;54;150359;142009;39;292368
24;2020-10-10;29;27;56;161829;158758;49;320587
24;2020-10-10;23;19;42;172552;168011;59;340563
24;2020-10-10;24;16;40;172509;158177;69;330686
24;2020-10-10;6;8;14;129428;110593;79;240021
24;2020-10-10;4;4;8;87342;56882;89;144224
24;2020-10-10;0;2;2;31210;12071;90;43281
24;2020-10-10;161;154;317;1320165;1238908;0;2559073
27;2020-10-10;6;6;12;143373;149679;09;293052
27;2020-10-10;18;25;43;160962;173003;19;333965
27;2020-10-10;30;16;46;133746;142254;29;276000
27;2020-10-10;30;16;46;160004;155407;39;315411
27;2020-10-10;30;23;53;172333;169564;49;341897
27;2020-10-10;23;16;39;189979;183788;59;373767
27;2020-10-10;17;20;37;192591;178206;69;370797
27;2020-10-10;14;15;29;146876;127546;79;274422
27;2020-10-10;10;8;18;96896;61575;89;158471
27;2020-10-10;3;3;6;33148;12109;90;45257
27;2020-10-10;181;148;329;1429908;1353131;0;2783039
28;2020-10-10;8;17;25;180735;186856;09;367591
28;2020-10-10;26;28;54;200125;213621;19;413746
28;2020-10-10;44;40;84;168922;173007;29;341929
28;2020-10-10;41;35;76;196628;188487;39;385115
28;2020-10-10;43;40;83;205396;201699;49;407095
28;2020-10-10;30;23;53;222002;213866;59;435868
28;2020-10-10;21;16;37;224688;203758;69;428446
28;2020-10-10;18;12;30;163192;135543;79;298735
28;2020-10-10;13;5;18;109691;65377;89;175068
28;2020-10-10;3;2;5;37222;12685;90;49907
28;2020-10-10;247;218;465;1708601;1594899;0;3303500
32;2020-10-10;22;21;43;358062;373689;09;731751
32;2020-10-10;131;98;231;387045;406742;19;793787
32;2020-10-10;163;139;302;342304;348587;29;690891
32;2020-10-10;146;128;274;382485;369972;39;752457
32;2020-10-10;132;104;237;382510;376716;49;759226
32;2020-10-10;116;105;223;386937;376527;59;763464
32;2020-10-10;65;73;138;371211;330938;69;702149
32;2020-10-10;49;35;84;250542;201459;79;452001
32;2020-10-10;41;19;60;163399;89786;89;253185
32;2020-10-10;10;9;19;48384;15367;90;63751
32;2020-10-10;875;731;1611;3072879;2889783;0;5962662
44;2020-10-10;5;8;13;291525;306839;09;598364
44;2020-10-10;43;33;76;320255;339504;19;659759
44;2020-10-10;51;59;110;302020;314428;29;616448
44;2020-10-10;48;28;76;342222;333292;39;675514
44;2020-10-10;36;35;71;349727;344491;49;694218
44;2020-10-10;46;29;75;381371;373239;59;754610
44;2020-10-10;26;27;53;367165;335850;69;703015
44;2020-10-10;18;8;26;250387;215436;79;465823
44;2020-10-10;6;4;10;170825;105192;89;276017
44;2020-10-10;4;2;6;51248;16731;90;67979
44;2020-10-10;283;233;516;2826745;2685002;0;5511747
52;2020-10-10;8;3;11;213594;223900;09;437494
52;2020-10-10;34;26;64;240818;255197;19;496015
52;2020-10-10;39;43;82;197010;200630;29;397640
52;2020-10-10;35;32;68;231204;224885;39;456089
52;2020-10-10;33;34;68;243874;243418;49;487292
52;2020-10-10;31;41;72;244100;239116;59;483216
52;2020-10-10;9;9;18;241796;221345;69;463141
52;2020-10-10;7;13;20;177805;149903;79;327708
52;2020-10-10;16;7;23;119561;75822;89;195383
52;2020-10-10;7;0;7;42559;15260;90;57819
52;2020-10-10;219;208;433;1952321;1849476;0;3801797
53;2020-10-10;1;3;4;173813;182358;09;356171
53;2020-10-10;23;34;57;202720;214740;19;417460
53;2020-10-10;40;43;83;163116;173196;29;336312
53;2020-10-10;24;22;46;190526;187674;39;378200
53;2020-10-10;29;24;53;212098;212015;49;424113
53;2020-10-10;25;25;50;223699;219176;59;442875
53;2020-10-10;12;18;30;227435;209274;69;436709
53;2020-10-10;9;8;17;169992;140910;79;310902
53;2020-10-10;6;6;12;118117;69883;89;188000
53;2020-10-10;4;1;5;37370;12267;90;49637
53;2020-10-10;173;184;357;1718886;1621493;0;3340379
75;2020-10-10;7;11;18;293104;305291;09;598395
75;2020-10-10;33;36;70;337141;357785;19;694926
75;2020-10-10;52;74;126;295024;300618;29;595642
75;2020-10-10;42;41;83;347871;331233;39;679104
75;2020-10-10;33;38;71;384742;372771;49;757513
75;2020-10-10;31;51;82;413361;390880;59;804241
75;2020-10-10;22;16;39;425623;384060;69;809683
75;2020-10-10;12;17;29;325086;276298;79;601384
75;2020-10-10;16;9;25;213986;139308;89;353294
75;2020-10-10;3;1;4;77600;28200;90;105800
75;2020-10-10;251;294;547;3113538;2886444;0;5999982
76;2020-10-10;20;19;39;305956;318589;09;624545
76;2020-10-10;101;75;177;338942;356969;19;695911
76;2020-10-10;135;87;222;316210;319570;29;635780
76;2020-10-10;98;91;189;356758;337587;39;694345
76;2020-10-10;111;72;183;376541;363812;49;740353
76;2020-10-10;72;70;142;402608;383750;59;786358
76;2020-10-10;45;43;88;394889;358997;69;753886
76;2020-10-10;21;28;49;308664;263806;79;572470
76;2020-10-10;24;13;37;195838;129272;89;325110
76;2020-10-10;12;1;13;69372;26728;90;96100
76;2020-10-10;640;499;1140;3065778;2859080;0;5924858
84;2020-10-10;21;16;37;459549;481088;09;940637
84;2020-10-10;108;96;208;487711;511905;19;999616
84;2020-10-10;132;153;285;443824;451094;29;894918
84;2020-10-10;115;103;218;512522;493262;39;1005784
84;2020-10-10;142;115;257;520248;515106;49;1035354
84;2020-10-10;121;118;239;529611;514848;59;1044459
84;2020-10-10;62;56;118;486720;439940;69;926660
84;2020-10-10;47;45;92;372151;315211;79;687362
84;2020-10-10;47;40;87;237198;150524;89;387722
84;2020-10-10;26;9;35;81185;28680;90;109865
84;2020-10-10;821;751;1576;4130719;3901658;0;8032377
93;2020-10-10;7;5;12;268834;283093;09;551927
93;2020-10-10;38;26;64;280751;296087;19;576838
93;2020-10-10;58;36;94;254404;255552;29;509956
93;2020-10-10;45;34;79;310704;288398;39;599102
93;2020-10-10;51;45;97;325559;305827;49;631386
93;2020-10-10;38;46;84;353104;325389;59;678493
93;2020-10-10;33;29;62;336327;296459;69;632786
93;2020-10-10;15;19;34;279820;229699;79;509519
93;2020-10-10;22;12;34;171274;113716;89;284990
93;2020-10-10;6;0;6;58896;21758;90;80654
93;2020-10-10;313;252;566;2639673;2415978;0;5055651
94;2020-10-10;0;0;0;16311;17433;09;33744
94;2020-10-10;0;0;0;16679;18132;19;34811
94;2020-10-10;3;5;8;16782;16579;29;33361
94;2020-10-10;4;1;5;23044;20580;39;43624
94;2020-10-10;1;2;3;23065;22140;49;45205
94;2020-10-10;2;2;4;24549;23421;59;47970
94;2020-10-10;1;1;2;23212;21883;69;45095
94;2020-10-10;0;1;1;19544;17141;79;36685
94;2020-10-10;1;0;1;11227;8178;89;19405
94;2020-10-10;0;0;0;3332;1447;90;4779
94;2020-10-10;12;12;24;177745;166934;0;344679
01;2020-10-11;1;1;2;19979;20155;09;40134
01;2020-10-11;0;2;2;24994;25489;19;50483
01;2020-10-11;0;0;0;17868;16690;29;34558
01;2020-10-11;1;0;1;22328;14821;39;37149
01;2020-10-11;1;1;2;28652;20276;49;48928
01;2020-10-11;2;0;2;33264;27260;59;60524
01;2020-10-11;2;1;3;27135;23978;69;51113
01;2020-10-11;1;0;1;18401;14661;79;33062
01;2020-10-11;2;0;2;9633;6375;89;16008
01;2020-10-11;0;0;0;3410;1510;90;4920
01;2020-10-11;10;5;15;205664;171215;0;376879
02;2020-10-11;0;0;0;16881;17110;09;33991
02;2020-10-11;0;0;0;21410;21604;19;43014
02;2020-10-11;0;0;0;16017;15479;29;31496
02;2020-10-11;0;0;0;19825;14455;39;34280
02;2020-10-11;0;0;0;24719;18248;49;42967
02;2020-10-11;1;1;2;34361;28310;59;62671
02;2020-10-11;0;2;2;28061;24495;69;52556
02;2020-10-11;0;1;1;18231;15278;79;33509
02;2020-10-11;0;0;0;11090;7677;89;18767
02;2020-10-11;1;0;1;3992;1506;90;5498
02;2020-10-11;2;4;6;194587;164162;0;358749
03;2020-10-11;0;0;0;31123;30920;09;62043
03;2020-10-11;0;0;0;29370;29268;19;58638
03;2020-10-11;0;0;0;21458;18963;29;40421
03;2020-10-11;1;0;1;21276;18326;39;39602
03;2020-10-11;0;0;0;18164;16593;49;34757
03;2020-10-11;1;0;1;13469;13557;59;27026
03;2020-10-11;0;0;0;8776;8670;69;17446
03;2020-10-11;0;0;0;3777;3591;79;7368
03;2020-10-11;0;0;0;1649;1072;89;2721
03;2020-10-11;0;0;0;485;184;90;669
03;2020-10-11;2;0;2;149547;141144;0;290691
04;2020-10-11;0;0;0;60314;61377;09;121691
04;2020-10-11;0;0;0;66065;68387;19;134452
04;2020-10-11;2;0;2;51059;47156;29;98215
04;2020-10-11;0;1;1;58788;45780;39;104568
04;2020-10-11;0;0;0;61408;52207;49;113615
04;2020-10-11;0;0;0;64838;60759;59;125597
04;2020-10-11;1;0;1;47008;42843;69;89851
04;2020-10-11;0;1;1;25509;21184;79;46693
04;2020-10-11;0;0;0;13168;7647;89;20815
04;2020-10-11;0;0;0;3209;1253;90;4462
04;2020-10-11;3;2;5;451366;408593;0;859959
05;2020-10-11;0;0;0;362.366008612902;341.338819562748;09;703.704828175651
05;2020-10-11;0;0;0;353.376145114279;370.349735405642;19;723.725880519921
05;2020-10-11;0;0;0;218.593559489256;256.539602589476;29;475.133162078732
05;2020-10-11;0;0;0;404.225408693299;360.321910454353;39;764.547319147651
05;2020-10-11;0;0;0;520.067953604221;497.108383964256;49;1017.17633756848
05;2020-10-11;0;0;0;468.146063921917;510.087601910415;59;978.233665832332
05;2020-10-11;0;0;0;340.368470050554;334.366842191253;69;674.735312241807
05;2020-10-11;0;0;0;212.598666888387;192.597753227106;79;405.196420115493
05;2020-10-11;0;0;0;148.727797095705;61.8681715431829;89;210.595968638888
05;2020-10-11;0;0;0;32.9601271090696;10.9909785719784;90;43.9511056810479
05;2020-10-11;0;0;0;3061.43020057959;2935.56979942041;0;5997
06;2020-10-11;0;0;0;42583;42380;09;84963
06;2020-10-11;0;0;0;33369;31925;19;65294
06;2020-10-11;0;0;0;21571;15080;29;36651
06;2020-10-11;0;0;0;21550;16147;39;37697
06;2020-10-11;0;0;0;14193;13939;49;28132
06;2020-10-11;0;0;0;7171;7597;59;14768
06;2020-10-11;0;0;0;3629;4117;69;7746
06;2020-10-11;0;0;0;1577;1457;79;3034
06;2020-10-11;0;0;0;531;474;89;1005
06;2020-10-11;0;0;0;88;93;90;181
06;2020-10-11;0;0;0;146262;133209;0;279471
07;2020-10-11;0;0;0;485;549;09;1034
07;2020-10-11;0;0;0;403;432;19;835
07;2020-10-11;0;0;0;764;841;29;1605
07;2020-10-11;0;0;0;824;928;39;1752
07;2020-10-11;0;0;0;788;1020;49;1808
07;2020-10-11;0;0;0;678;870;59;1548
07;2020-10-11;0;0;0;360;382;69;742
07;2020-10-11;0;0;0;231;190;79;421
07;2020-10-11;0;0;0;114;67;89;181
07;2020-10-11;0;0;0;24;11;90;35
07;2020-10-11;0;0;0;4671;5290;0;9961
08;2020-10-11;0;1;1;2715.22592983026;2997.75551488675;09;5712.98144471701
08;2020-10-11;0;0;0;2778.51901080978;3160.9156459093;19;5939.43465671908
08;2020-10-11;0;0;0;2080.8882988764;1718.16634315323;29;3799.05464202964
08;2020-10-11;2;0;2;2701.8582062647;1896.52641413317;39;4598.38462039786
08;2020-10-11;0;0;0;3151.45861023308;2460.52498233809;49;5611.98359257117
08;2020-10-11;0;0;0;2620.29868333099;2422.23566154656;59;5042.53434487755
08;2020-10-11;0;0;0;1621.44173420671;1438.58325779464;69;3060.02499200135
08;2020-10-11;0;0;0;626.575909335673;526.358467843651;79;1152.93437717932
08;2020-10-11;0;0;0;205.018522985054;140.993639349697;89;346.012162334751
08;2020-10-11;0;0;0;50.0325684687745;20.62259870351;90;70.6551671722846
08;2020-10-11;2;1;3;18551.3174743414;16782.6825256586;0;35334
11;2020-10-11;16;8;25;783071;811785;09;1594856
11;2020-10-11;32;39;71;761456;784653;19;1546109
11;2020-10-11;93;81;174;850145;801772;29;1651917
11;2020-10-11;74;90;164;914360;843488;39;1757848
11;2020-10-11;55;55;110;845609;826202;49;1671811
11;2020-10-11;39;58;97;793566;745070;59;1538636
11;2020-10-11;34;46;80;628649;549192;69;1177841
11;2020-10-11;13;29;42;434606;358356;79;792962
11;2020-10-11;20;15;35;261425;162933;89;424358
11;2020-10-11;16;3;19;89253;32619;90;121872
11;2020-10-11;392;425;818;6362140;5916070;0;12278210
24;2020-10-11;1;1;2;139720;144686;09;284406
24;2020-10-11;6;9;15;152979;161185;19;314164
24;2020-10-11;14;12;26;122237;126536;29;248773
24;2020-10-11;16;11;27;150359;142009;39;292368
24;2020-10-11;15;9;24;161829;158758;49;320587
24;2020-10-11;6;7;13;172552;168011;59;340563
24;2020-10-11;6;4;10;172509;158177;69;330686
24;2020-10-11;2;6;8;129428;110593;79;240021
24;2020-10-11;2;1;3;87342;56882;89;144224
24;2020-10-11;2;0;2;31210;12071;90;43281
24;2020-10-11;70;60;130;1320165;1238908;0;2559073
27;2020-10-11;0;2;2;143373;149679;09;293052
27;2020-10-11;3;3;6;160962;173003;19;333965
27;2020-10-11;4;5;9;133746;142254;29;276000
27;2020-10-11;4;2;6;160004;155407;39;315411
27;2020-10-11;4;7;11;172333;169564;49;341897
27;2020-10-11;7;7;14;189979;183788;59;373767
27;2020-10-11;4;6;10;192591;178206;69;370797
27;2020-10-11;1;2;3;146876;127546;79;274422
27;2020-10-11;2;2;4;96896;61575;89;158471
27;2020-10-11;1;1;2;33148;12109;90;45257
27;2020-10-11;30;37;67;1429908;1353131;0;2783039
28;2020-10-11;5;2;7;180735;186856;09;367591
28;2020-10-11;16;14;30;200125;213621;19;413746
28;2020-10-11;30;26;56;168922;173007;29;341929
28;2020-10-11;24;22;46;196628;188487;39;385115
28;2020-10-11;14;9;23;205396;201699;49;407095
28;2020-10-11;23;12;35;222002;213866;59;435868
28;2020-10-11;5;12;17;224688;203758;69;428446
28;2020-10-11;5;5;10;163192;135543;79;298735
28;2020-10-11;6;1;7;109691;65377;89;175068
28;2020-10-11;10;3;13;37222;12685;90;49907
28;2020-10-11;138;106;244;1708601;1594899;0;3303500
32;2020-10-11;8;16;24;358062;373689;09;731751
32;2020-10-11;41;35;76;387045;406742;19;793787
32;2020-10-11;73;49;122;342304;348587;29;690891
32;2020-10-11;57;51;108;382485;369972;39;752457
32;2020-10-11;43;48;92;382510;376716;49;759226
32;2020-10-11;29;29;58;386937;376527;59;763464
32;2020-10-11;23;26;49;371211;330938;69;702149
32;2020-10-11;9;19;28;250542;201459;79;452001
32;2020-10-11;12;6;18;163399;89786;89;253185
32;2020-10-11;2;4;6;48384;15367;90;63751
32;2020-10-11;297;283;581;3072879;2889783;0;5962662
44;2020-10-11;1;0;1;291525;306839;09;598364
44;2020-10-11;4;4;8;320255;339504;19;659759
44;2020-10-11;8;9;17;302020;314428;29;616448
44;2020-10-11;6;4;10;342222;333292;39;675514
44;2020-10-11;5;3;8;349727;344491;49;694218
44;2020-10-11;6;2;8;381371;373239;59;754610
44;2020-10-11;5;5;10;367165;335850;69;703015
44;2020-10-11;2;3;5;250387;215436;79;465823
44;2020-10-11;2;2;4;170825;105192;89;276017
44;2020-10-11;4;0;4;51248;16731;90;67979
44;2020-10-11;43;32;75;2826745;2685002;0;5511747
52;2020-10-11;3;2;5;213594;223900;09;437494
52;2020-10-11;4;10;14;240818;255197;19;496015
52;2020-10-11;12;7;19;197010;200630;29;397640
52;2020-10-11;9;2;11;231204;224885;39;456089
52;2020-10-11;5;3;9;243874;243418;49;487292
52;2020-10-11;3;8;11;244100;239116;59;483216
52;2020-10-11;3;2;5;241796;221345;69;463141
52;2020-10-11;0;5;5;177805;149903;79;327708
52;2020-10-11;4;1;5;119561;75822;89;195383
52;2020-10-11;3;0;3;42559;15260;90;57819
52;2020-10-11;46;40;87;1952321;1849476;0;3801797
53;2020-10-11;2;1;3;173813;182358;09;356171
53;2020-10-11;12;5;18;202720;214740;19;417460
53;2020-10-11;11;7;18;163116;173196;29;336312
53;2020-10-11;3;6;9;190526;187674;39;378200
53;2020-10-11;3;7;10;212098;212015;49;424113
53;2020-10-11;4;6;10;223699;219176;59;442875
53;2020-10-11;5;4;9;227435;209274;69;436709
53;2020-10-11;3;3;6;169992;140910;79;310902
53;2020-10-11;3;0;3;118117;69883;89;188000
53;2020-10-11;1;0;1;37370;12267;90;49637
53;2020-10-11;47;39;87;1718886;1621493;0;3340379
75;2020-10-11;1;1;2;293104;305291;09;598395
75;2020-10-11;4;5;9;337141;357785;19;694926
75;2020-10-11;9;15;24;295024;300618;29;595642
75;2020-10-11;6;6;12;347871;331233;39;679104
75;2020-10-11;9;7;16;384742;372771;49;757513
75;2020-10-11;4;6;10;413361;390880;59;804241
75;2020-10-11;1;1;2;425623;384060;69;809683
75;2020-10-11;4;2;6;325086;276298;79;601384
75;2020-10-11;3;5;8;213986;139308;89;353294
75;2020-10-11;7;2;9;77600;28200;90;105800
75;2020-10-11;48;50;98;3113538;2886444;0;5999982
76;2020-10-11;6;3;9;305956;318589;09;624545
76;2020-10-11;14;18;33;338942;356969;19;695911
76;2020-10-11;43;29;72;316210;319570;29;635780
76;2020-10-11;36;35;71;356758;337587;39;694345
76;2020-10-11;25;29;54;376541;363812;49;740353
76;2020-10-11;17;15;32;402608;383750;59;786358
76;2020-10-11;10;7;17;394889;358997;69;753886
76;2020-10-11;6;9;15;308664;263806;79;572470
76;2020-10-11;9;5;14;195838;129272;89;325110
76;2020-10-11;3;2;5;69372;26728;90;96100
76;2020-10-11;169;153;323;3065778;2859080;0;5924858
84;2020-10-11;4;10;14;459549;481088;09;940637
84;2020-10-11;13;27;40;487711;511905;19;999616
84;2020-10-11;23;24;47;443824;451094;29;894918
84;2020-10-11;23;26;49;512522;493262;39;1005784
84;2020-10-11;31;25;56;520248;515106;49;1035354
84;2020-10-11;21;25;46;529611;514848;59;1044459
84;2020-10-11;20;22;42;486720;439940;69;926660
84;2020-10-11;13;18;31;372151;315211;79;687362
84;2020-10-11;30;21;51;237198;150524;89;387722
84;2020-10-11;40;10;50;81185;28680;90;109865
84;2020-10-11;218;208;426;4130719;3901658;0;8032377
93;2020-10-11;1;2;3;268834;283093;09;551927
93;2020-10-11;6;6;12;280751;296087;19;576838
93;2020-10-11;12;14;26;254404;255552;29;509956
93;2020-10-11;11;13;24;310704;288398;39;599102
93;2020-10-11;12;6;18;325559;305827;49;631386
93;2020-10-11;14;13;27;353104;325389;59;678493
93;2020-10-11;5;12;17;336327;296459;69;632786
93;2020-10-11;7;12;19;279820;229699;79;509519
93;2020-10-11;6;8;14;171274;113716;89;284990
93;2020-10-11;9;2;11;58896;21758;90;80654
93;2020-10-11;83;88;171;2639673;2415978;0;5055651
94;2020-10-11;0;0;0;16311;17433;09;33744
94;2020-10-11;0;1;1;16679;18132;19;34811
94;2020-10-11;0;0;0;16782;16579;29;33361
94;2020-10-11;1;0;1;23044;20580;39;43624
94;2020-10-11;0;0;0;23065;22140;49;45205
94;2020-10-11;0;0;0;24549;23421;59;47970
94;2020-10-11;0;1;1;23212;21883;69;45095
94;2020-10-11;0;0;0;19544;17141;79;36685
94;2020-10-11;1;0;1;11227;8178;89;19405
94;2020-10-11;0;0;0;3332;1447;90;4779
94;2020-10-11;2;2;4;177745;166934;0;344679
01;2020-10-12;0;0;0;19979;20155;09;40134
01;2020-10-12;9;5;14;24994;25489;19;50483
01;2020-10-12;3;1;4;17868;16690;29;34558
01;2020-10-12;12;6;18;22328;14821;39;37149
01;2020-10-12;9;6;15;28652;20276;49;48928
01;2020-10-12;13;6;19;33264;27260;59;60524
01;2020-10-12;5;6;11;27135;23978;69;51113
01;2020-10-12;5;7;12;18401;14661;79;33062
01;2020-10-12;0;2;2;9633;6375;89;16008
01;2020-10-12;0;1;1;3410;1510;90;4920
01;2020-10-12;56;40;96;205664;171215;0;376879
02;2020-10-12;1;0;1;16881;17110;09;33991
02;2020-10-12;9;3;12;21410;21604;19;43014
02;2020-10-12;6;3;9;16017;15479;29;31496
02;2020-10-12;10;6;16;19825;14455;39;34280
02;2020-10-12;15;6;21;24719;18248;49;42967
02;2020-10-12;10;11;21;34361;28310;59;62671
02;2020-10-12;7;4;11;28061;24495;69;52556
02;2020-10-12;6;2;8;18231;15278;79;33509
02;2020-10-12;0;1;1;11090;7677;89;18767
02;2020-10-12;2;0;2;3992;1506;90;5498
02;2020-10-12;66;36;102;194587;164162;0;358749
03;2020-10-12;0;2;2;31123;30920;09;62043
03;2020-10-12;1;1;2;29370;29268;19;58638
03;2020-10-12;0;3;3;21458;18963;29;40421
03;2020-10-12;3;2;5;21276;18326;39;39602
03;2020-10-12;0;0;0;18164;16593;49;34757
03;2020-10-12;1;2;4;13469;13557;59;27026
03;2020-10-12;0;2;2;8776;8670;69;17446
03;2020-10-12;0;0;0;3777;3591;79;7368
03;2020-10-12;0;0;0;1649;1072;89;2721
03;2020-10-12;0;0;0;485;184;90;669
03;2020-10-12;5;12;18;149547;141144;0;290691
04;2020-10-12;1;1;2;60314;61377;09;121691
04;2020-10-12;4;7;11;66065;68387;19;134452
04;2020-10-12;5;8;13;51059;47156;29;98215
04;2020-10-12;3;2;5;58788;45780;39;104568
04;2020-10-12;6;4;10;61408;52207;49;113615
04;2020-10-12;1;2;3;64838;60759;59;125597
04;2020-10-12;4;4;8;47008;42843;69;89851
04;2020-10-12;0;0;0;25509;21184;79;46693
04;2020-10-12;1;0;1;13168;7647;89;20815
04;2020-10-12;1;0;1;3209;1253;90;4462
04;2020-10-12;26;28;54;451366;408593;0;859959
05;2020-10-12;0;0;0;362.366008612902;341.338819562748;09;703.704828175651
05;2020-10-12;0;0;0;353.376145114279;370.349735405642;19;723.725880519921
05;2020-10-12;0;0;0;218.593559489256;256.539602589476;29;475.133162078732
05;2020-10-12;0;0;0;404.225408693299;360.321910454353;39;764.547319147651
05;2020-10-12;0;0;0;520.067953604221;497.108383964256;49;1017.17633756848
05;2020-10-12;0;0;0;468.146063921917;510.087601910415;59;978.233665832332
05;2020-10-12;0;0;0;340.368470050554;334.366842191253;69;674.735312241807
05;2020-10-12;0;0;0;212.598666888387;192.597753227106;79;405.196420115493
05;2020-10-12;0;0;0;148.727797095705;61.8681715431829;89;210.595968638888
05;2020-10-12;0;0;0;32.9601271090696;10.9909785719784;90;43.9511056810479
05;2020-10-12;0;0;0;3061.43020057959;2935.56979942041;0;5997
06;2020-10-12;0;1;1;42583;42380;09;84963
06;2020-10-12;3;1;4;33369;31925;19;65294
06;2020-10-12;5;5;10;21571;15080;29;36651
06;2020-10-12;7;5;12;21550;16147;39;37697
06;2020-10-12;4;5;9;14193;13939;49;28132
06;2020-10-12;4;3;7;7171;7597;59;14768
06;2020-10-12;1;1;2;3629;4117;69;7746
06;2020-10-12;0;0;0;1577;1457;79;3034
06;2020-10-12;1;0;1;531;474;89;1005
06;2020-10-12;0;0;0;88;93;90;181
06;2020-10-12;25;21;46;146262;133209;0;279471
07;2020-10-12;0;0;0;485;549;09;1034
07;2020-10-12;0;0;0;403;432;19;835
07;2020-10-12;0;0;0;764;841;29;1605
07;2020-10-12;0;0;0;824;928;39;1752
07;2020-10-12;0;0;0;788;1020;49;1808
07;2020-10-12;0;1;1;678;870;59;1548
07;2020-10-12;0;0;0;360;382;69;742
07;2020-10-12;0;0;0;231;190;79;421
07;2020-10-12;0;0;0;114;67;89;181
07;2020-10-12;0;0;0;24;11;90;35
07;2020-10-12;0;1;1;4671;5290;0;9961
08;2020-10-12;0;0;0;2715.22592983026;2997.75551488675;09;5712.98144471701
08;2020-10-12;3;0;3;2778.51901080978;3160.9156459093;19;5939.43465671908
08;2020-10-12;1;0;1;2080.8882988764;1718.16634315323;29;3799.05464202964
08;2020-10-12;4;3;7;2701.8582062647;1896.52641413317;39;4598.38462039786
08;2020-10-12;3;1;4;3151.45861023308;2460.52498233809;49;5611.98359257117
08;2020-10-12;0;1;1;2620.29868333099;2422.23566154656;59;5042.53434487755
08;2020-10-12;1;3;4;1621.44173420671;1438.58325779464;69;3060.02499200135
08;2020-10-12;0;2;2;626.575909335673;526.358467843651;79;1152.93437717932
08;2020-10-12;0;0;0;205.018522985054;140.993639349697;89;346.012162334751
08;2020-10-12;0;0;0;50.0325684687745;20.62259870351;90;70.6551671722846
08;2020-10-12;12;10;22;18551.3174743414;16782.6825256586;0;35334
11;2020-10-12;78;108;200;783071;811785;09;1594856
11;2020-10-12;527;532;1099;761456;784653;19;1546109
11;2020-10-12;1096;908;2005;850145;801772;29;1651917
11;2020-10-12;906;779;1691;914360;843488;39;1757848
11;2020-10-12;772;665;1443;845609;826202;49;1671811
11;2020-10-12;649;573;1224;793566;745070;59;1538636
11;2020-10-12;403;374;787;628649;549192;69;1177841
11;2020-10-12;138;173;311;434606;358356;79;792962
11;2020-10-12;87;65;152;261425;162933;89;424358
11;2020-10-12;64;20;84;89253;32619;90;121872
11;2020-10-12;4722;4200;9003;6362140;5916070;0;12278210
24;2020-10-12;3;2;5;139720;144686;09;284406
24;2020-10-12;36;41;80;152979;161185;19;314164
24;2020-10-12;57;52;109;122237;126536;29;248773
24;2020-10-12;44;38;82;150359;142009;39;292368
24;2020-10-12;52;54;106;161829;158758;49;320587
24;2020-10-12;42;43;85;172552;168011;59;340563
24;2020-10-12;26;39;65;172509;158177;69;330686
24;2020-10-12;19;17;36;129428;110593;79;240021
24;2020-10-12;12;11;23;87342;56882;89;144224
24;2020-10-12;7;5;12;31210;12071;90;43281
24;2020-10-12;298;302;603;1320165;1238908;0;2559073
27;2020-10-12;13;10;23;143373;149679;09;293052
27;2020-10-12;58;64;123;160962;173003;19;333965
27;2020-10-12;77;104;181;133746;142254;29;276000
27;2020-10-12;77;59;136;160004;155407;39;315411
27;2020-10-12;75;52;127;172333;169564;49;341897
27;2020-10-12;71;64;135;189979;183788;59;373767
27;2020-10-12;63;66;129;192591;178206;69;370797
27;2020-10-12;35;23;58;146876;127546;79;274422
27;2020-10-12;19;13;32;96896;61575;89;158471
27;2020-10-12;14;3;17;33148;12109;90;45257
27;2020-10-12;502;458;961;1429908;1353131;0;2783039
28;2020-10-12;8;15;26;180735;186856;09;367591
28;2020-10-12;67;51;119;200125;213621;19;413746
28;2020-10-12;104;84;189;168922;173007;29;341929
28;2020-10-12;79;83;162;196628;188487;39;385115
28;2020-10-12;77;57;134;205396;201699;49;407095
28;2020-10-12;63;71;134;222002;213866;59;435868
28;2020-10-12;59;43;102;224688;203758;69;428446
28;2020-10-12;27;40;67;163192;135543;79;298735
28;2020-10-12;30;17;47;109691;65377;89;175068
28;2020-10-12;29;6;35;37222;12685;90;49907
28;2020-10-12;543;467;1015;1708601;1594899;0;3303500
32;2020-10-12;54;54;108;358062;373689;09;731751
32;2020-10-12;243;222;466;387045;406742;19;793787
32;2020-10-12;327;281;610;342304;348587;29;690891
32;2020-10-12;306;278;585;382485;369972;39;752457
32;2020-10-12;282;267;551;382510;376716;49;759226
32;2020-10-12;248;234;484;386937;376527;59;763464
32;2020-10-12;160;164;325;371211;330938;69;702149
32;2020-10-12;114;108;222;250542;201459;79;452001
32;2020-10-12;84;43;127;163399;89786;89;253185
32;2020-10-12;62;11;73;48384;15367;90;63751
32;2020-10-12;1881;1662;3552;3072879;2889783;0;5962662
44;2020-10-12;24;19;43;291525;306839;09;598364
44;2020-10-12;88;103;191;320255;339504;19;659759
44;2020-10-12;149;155;304;302020;314428;29;616448
44;2020-10-12;134;108;242;342222;333292;39;675514
44;2020-10-12;133;119;252;349727;344491;49;694218
44;2020-10-12;113;121;234;381371;373239;59;754610
44;2020-10-12;71;77;148;367165;335850;69;703015
44;2020-10-12;42;44;86;250387;215436;79;465823
44;2020-10-12;41;23;64;170825;105192;89;276017
44;2020-10-12;8;2;10;51248;16731;90;67979
44;2020-10-12;803;771;1574;2826745;2685002;0;5511747
52;2020-10-12;10;17;27;213594;223900;09;437494
52;2020-10-12;77;72;150;240818;255197;19;496015
52;2020-10-12;85;94;179;197010;200630;29;397640
52;2020-10-12;83;82;165;231204;224885;39;456089
52;2020-10-12;98;57;155;243874;243418;49;487292
52;2020-10-12;72;65;137;244100;239116;59;483216
52;2020-10-12;58;52;110;241796;221345;69;463141
52;2020-10-12;40;36;76;177805;149903;79;327708
52;2020-10-12;16;9;25;119561;75822;89;195383
52;2020-10-12;17;9;26;42559;15260;90;57819
52;2020-10-12;556;493;1050;1952321;1849476;0;3801797
53;2020-10-12;8;15;24;173813;182358;09;356171
53;2020-10-12;51;69;120;202720;214740;19;417460
53;2020-10-12;62;71;133;163116;173196;29;336312
53;2020-10-12;52;62;114;190526;187674;39;378200
53;2020-10-12;47;47;94;212098;212015;49;424113
53;2020-10-12;52;54;106;223699;219176;59;442875
53;2020-10-12;38;34;72;227435;209274;69;436709
53;2020-10-12;25;26;51;169992;140910;79;310902
53;2020-10-12;12;8;20;118117;69883;89;188000
53;2020-10-12;3;2;5;37370;12267;90;49637
53;2020-10-12;350;388;739;1718886;1621493;0;3340379
75;2020-10-12;13;20;34;293104;305291;09;598395
75;2020-10-12;82;100;183;337141;357785;19;694926
75;2020-10-12;163;163;327;295024;300618;29;595642
75;2020-10-12;109;94;204;347871;331233;39;679104
75;2020-10-12;116;102;218;384742;372771;49;757513
75;2020-10-12;89;112;201;413361;390880;59;804241
75;2020-10-12;66;63;129;425623;384060;69;809683
75;2020-10-12;32;39;71;325086;276298;79;601384
75;2020-10-12;28;19;47;213986;139308;89;353294
75;2020-10-12;18;9;27;77600;28200;90;105800
75;2020-10-12;716;721;1441;3113538;2886444;0;5999982
76;2020-10-12;38;22;65;305956;318589;09;624545
76;2020-10-12;171;163;336;338942;356969;19;695911
76;2020-10-12;253;250;504;316210;319570;29;635780
76;2020-10-12;243;182;425;356758;337587;39;694345
76;2020-10-12;239;187;426;376541;363812;49;740353
76;2020-10-12;227;204;432;402608;383750;59;786358
76;2020-10-12;162;129;291;394889;358997;69;753886
76;2020-10-12;81;96;177;308664;263806;79;572470
76;2020-10-12;81;46;127;195838;129272;89;325110
76;2020-10-12;73;19;92;69372;26728;90;96100
76;2020-10-12;1568;1298;2875;3065778;2859080;0;5924858
84;2020-10-12;73;72;145;459549;481088;09;940637
84;2020-10-12;385;416;804;487711;511905;19;999616
84;2020-10-12;550;470;1020;443824;451094;29;894918
84;2020-10-12;470;391;861;512522;493262;39;1005784
84;2020-10-12;489;424;914;520248;515106;49;1035354
84;2020-10-12;411;416;827;529611;514848;59;1044459
84;2020-10-12;255;230;485;486720;439940;69;926660
84;2020-10-12;146;159;305;372151;315211;79;687362
84;2020-10-12;150;92;242;237198;150524;89;387722
84;2020-10-12;113;29;142;81185;28680;90;109865
84;2020-10-12;3043;2699;5746;4130719;3901658;0;8032377
93;2020-10-12;21;23;45;268834;283093;09;551927
93;2020-10-12;113;111;224;280751;296087;19;576838
93;2020-10-12;210;171;381;254404;255552;29;509956
93;2020-10-12;190;159;351;310704;288398;39;599102
93;2020-10-12;212;175;388;325559;305827;49;631386
93;2020-10-12;213;201;414;353104;325389;59;678493
93;2020-10-12;131;109;240;336327;296459;69;632786
93;2020-10-12;90;70;160;279820;229699;79;509519
93;2020-10-12;65;48;113;171274;113716;89;284990
93;2020-10-12;54;12;66;58896;21758;90;80654
93;2020-10-12;1299;1080;2383;2639673;2415978;0;5055651
94;2020-10-12;0;2;2;16311;17433;09;33744
94;2020-10-12;9;6;15;16679;18132;19;34811
94;2020-10-12;15;9;24;16782;16579;29;33361
94;2020-10-12;14;7;21;23044;20580;39;43624
94;2020-10-12;9;11;20;23065;22140;49;45205
94;2020-10-12;10;6;16;24549;23421;59;47970
94;2020-10-12;6;10;16;23212;21883;69;45095
94;2020-10-12;4;3;7;19544;17141;79;36685
94;2020-10-12;3;4;7;11227;8178;89;19405
94;2020-10-12;1;1;2;3332;1447;90;4779
94;2020-10-12;71;59;130;177745;166934;0;344679
01;2020-10-13;0;0;0;19979;20155;09;40134
01;2020-10-13;5;3;8;24994;25489;19;50483
01;2020-10-13;2;2;4;17868;16690;29;34558
01;2020-10-13;7;7;14;22328;14821;39;37149
01;2020-10-13;11;8;19;28652;20276;49;48928
01;2020-10-13;20;11;31;33264;27260;59;60524
01;2020-10-13;4;5;9;27135;23978;69;51113
01;2020-10-13;1;5;6;18401;14661;79;33062
01;2020-10-13;0;0;0;9633;6375;89;16008
01;2020-10-13;0;0;0;3410;1510;90;4920
01;2020-10-13;50;41;91;205664;171215;0;376879
02;2020-10-13;1;0;1;16881;17110;09;33991
02;2020-10-13;9;9;19;21410;21604;19;43014
02;2020-10-13;9;5;14;16017;15479;29;31496
02;2020-10-13;8;7;15;19825;14455;39;34280
02;2020-10-13;12;5;17;24719;18248;49;42967
02;2020-10-13;12;8;20;34361;28310;59;62671
02;2020-10-13;8;3;11;28061;24495;69;52556
02;2020-10-13;4;3;7;18231;15278;79;33509
02;2020-10-13;3;0;3;11090;7677;89;18767
02;2020-10-13;0;0;0;3992;1506;90;5498
02;2020-10-13;66;40;107;194587;164162;0;358749
03;2020-10-13;0;1;1;31123;30920;09;62043
03;2020-10-13;1;0;1;29370;29268;19;58638
03;2020-10-13;5;1;6;21458;18963;29;40421
03;2020-10-13;3;0;3;21276;18326;39;39602
03;2020-10-13;3;3;6;18164;16593;49;34757
03;2020-10-13;0;2;2;13469;13557;59;27026
03;2020-10-13;2;0;2;8776;8670;69;17446
03;2020-10-13;0;1;1;3777;3591;79;7368
03;2020-10-13;0;0;0;1649;1072;89;2721
03;2020-10-13;1;0;1;485;184;90;669
03;2020-10-13;15;8;23;149547;141144;0;290691
04;2020-10-13;4;0;4;60314;61377;09;121691
04;2020-10-13;5;3;8;66065;68387;19;134452
04;2020-10-13;4;5;9;51059;47156;29;98215
04;2020-10-13;3;3;6;58788;45780;39;104568
04;2020-10-13;4;5;9;61408;52207;49;113615
04;2020-10-13;4;4;9;64838;60759;59;125597
04;2020-10-13;2;5;7;47008;42843;69;89851
04;2020-10-13;1;0;1;25509;21184;79;46693
04;2020-10-13;0;0;0;13168;7647;89;20815
04;2020-10-13;0;1;1;3209;1253;90;4462
04;2020-10-13;27;26;54;451366;408593;0;859959
05;2020-10-13;0;0;0;362.366008612902;341.338819562748;09;703.704828175651
05;2020-10-13;0;0;0;353.376145114279;370.349735405642;19;723.725880519921
05;2020-10-13;0;0;0;218.593559489256;256.539602589476;29;475.133162078732
05;2020-10-13;0;0;0;404.225408693299;360.321910454353;39;764.547319147651
05;2020-10-13;0;0;0;520.067953604221;497.108383964256;49;1017.17633756848
05;2020-10-13;0;0;0;468.146063921917;510.087601910415;59;978.233665832332
05;2020-10-13;0;0;0;340.368470050554;334.366842191253;69;674.735312241807
05;2020-10-13;0;0;0;212.598666888387;192.597753227106;79;405.196420115493
05;2020-10-13;0;0;0;148.727797095705;61.8681715431829;89;210.595968638888
05;2020-10-13;0;0;0;32.9601271090696;10.9909785719784;90;43.9511056810479
05;2020-10-13;0;0;0;3061.43020057959;2935.56979942041;0;5997
06;2020-10-13;0;0;0;42583;42380;09;84963
06;2020-10-13;0;1;1;33369;31925;19;65294
06;2020-10-13;6;2;8;21571;15080;29;36651
06;2020-10-13;3;4;7;21550;16147;39;37697
06;2020-10-13;1;6;7;14193;13939;49;28132
06;2020-10-13;1;3;4;7171;7597;59;14768
06;2020-10-13;0;0;0;3629;4117;69;7746
06;2020-10-13;0;0;0;1577;1457;79;3034
06;2020-10-13;0;0;0;531;474;89;1005
06;2020-10-13;0;0;0;88;93;90;181
06;2020-10-13;11;16;27;146262;133209;0;279471
07;2020-10-13;0;0;0;485;549;09;1034
07;2020-10-13;1;0;1;403;432;19;835
07;2020-10-13;0;0;0;764;841;29;1605
07;2020-10-13;0;1;1;824;928;39;1752
07;2020-10-13;0;0;0;788;1020;49;1808
07;2020-10-13;1;0;1;678;870;59;1548
07;2020-10-13;0;0;0;360;382;69;742
07;2020-10-13;0;0;0;231;190;79;421
07;2020-10-13;0;0;0;114;67;89;181
07;2020-10-13;0;0;0;24;11;90;35
07;2020-10-13;2;1;3;4671;5290;0;9961
08;2020-10-13;0;0;0;2715.22592983026;2997.75551488675;09;5712.98144471701
08;2020-10-13;0;0;0;2778.51901080978;3160.9156459093;19;5939.43465671908
08;2020-10-13;0;1;1;2080.8882988764;1718.16634315323;29;3799.05464202964
08;2020-10-13;0;0;0;2701.8582062647;1896.52641413317;39;4598.38462039786
08;2020-10-13;0;0;0;3151.45861023308;2460.52498233809;49;5611.98359257117
08;2020-10-13;1;2;3;2620.29868333099;2422.23566154656;59;5042.53434487755
08;2020-10-13;0;0;0;1621.44173420671;1438.58325779464;69;3060.02499200135
08;2020-10-13;0;0;0;626.575909335673;526.358467843651;79;1152.93437717932
08;2020-10-13;0;0;0;205.018522985054;140.993639349697;89;346.012162334751
08;2020-10-13;0;0;0;50.0325684687745;20.62259870351;90;70.6551671722846
08;2020-10-13;1;3;4;18551.3174743414;16782.6825256586;0;35334
11;2020-10-13;74;78;160;783071;811785;09;1594856
11;2020-10-13;462;455;943;761456;784653;19;1546109
11;2020-10-13;972;826;1803;850145;801772;29;1651917
11;2020-10-13;809;697;1514;914360;843488;39;1757848
11;2020-10-13;714;605;1326;845609;826202;49;1671811
11;2020-10-13;604;536;1143;793566;745070;59;1538636
11;2020-10-13;380;357;747;628649;549192;69;1177841
11;2020-10-13;157;151;308;434606;358356;79;792962
11;2020-10-13;100;65;165;261425;162933;89;424358
11;2020-10-13;48;20;68;89253;32619;90;121872
11;2020-10-13;4320;3791;8179;6362140;5916070;0;12278210
24;2020-10-13;9;6;16;139720;144686;09;284406
24;2020-10-13;38;40;79;152979;161185;19;314164
24;2020-10-13;59;56;115;122237;126536;29;248773
24;2020-10-13;62;35;97;150359;142009;39;292368
24;2020-10-13;53;63;116;161829;158758;49;320587
24;2020-10-13;53;43;96;172552;168011;59;340563
24;2020-10-13;33;31;64;172509;158177;69;330686
24;2020-10-13;13;22;35;129428;110593;79;240021
24;2020-10-13;36;15;51;87342;56882;89;144224
24;2020-10-13;20;8;28;31210;12071;90;43281
24;2020-10-13;376;319;697;1320165;1238908;0;2559073
27;2020-10-13;5;17;22;143373;149679;09;293052
27;2020-10-13;46;55;101;160962;173003;19;333965
27;2020-10-13;85;61;146;133746;142254;29;276000
27;2020-10-13;56;68;124;160004;155407;39;315411
27;2020-10-13;73;40;113;172333;169564;49;341897
27;2020-10-13;77;56;133;189979;183788;59;373767
27;2020-10-13;58;59;117;192591;178206;69;370797
27;2020-10-13;33;22;55;146876;127546;79;274422
27;2020-10-13;35;27;62;96896;61575;89;158471
27;2020-10-13;30;8;38;33148;12109;90;45257
27;2020-10-13;498;413;911;1429908;1353131;0;2783039
28;2020-10-13;12;7;19;180735;186856;09;367591
28;2020-10-13;63;54;118;200125;213621;19;413746
28;2020-10-13;116;91;207;168922;173007;29;341929
28;2020-10-13;94;63;158;196628;188487;39;385115
28;2020-10-13;79;65;144;205396;201699;49;407095
28;2020-10-13;69;57;126;222002;213866;59;435868
28;2020-10-13;53;46;99;224688;203758;69;428446
28;2020-10-13;35;32;67;163192;135543;79;298735
28;2020-10-13;17;10;27;109691;65377;89;175068
28;2020-10-13;15;2;17;37222;12685;90;49907
28;2020-10-13;553;427;982;1708601;1594899;0;3303500
32;2020-10-13;53;40;93;358062;373689;09;731751
32;2020-10-13;216;244;460;387045;406742;19;793787
32;2020-10-13;292;269;561;342304;348587;29;690891
32;2020-10-13;266;231;497;382485;369972;39;752457
32;2020-10-13;257;223;480;382510;376716;49;759226
32;2020-10-13;218;196;414;386937;376527;59;763464
32;2020-10-13;116;141;257;371211;330938;69;702149
32;2020-10-13;121;81;202;250542;201459;79;452001
32;2020-10-13;69;49;118;163399;89786;89;253185
32;2020-10-13;38;14;52;48384;15367;90;63751
32;2020-10-13;1646;1489;3135;3072879;2889783;0;5962662
44;2020-10-13;19;8;27;291525;306839;09;598364
44;2020-10-13;68;73;143;320255;339504;19;659759
44;2020-10-13;130;122;252;302020;314428;29;616448
44;2020-10-13;111;94;205;342222;333292;39;675514
44;2020-10-13;105;79;184;349727;344491;49;694218
44;2020-10-13;99;85;184;381371;373239;59;754610
44;2020-10-13;69;59;128;367165;335850;69;703015
44;2020-10-13;28;36;64;250387;215436;79;465823
44;2020-10-13;25;13;38;170825;105192;89;276017
44;2020-10-13;10;1;11;51248;16731;90;67979
44;2020-10-13;664;570;1236;2826745;2685002;0;5511747
52;2020-10-13;6;14;20;213594;223900;09;437494
52;2020-10-13;55;48;105;240818;255197;19;496015
52;2020-10-13;82;78;160;197010;200630;29;397640
52;2020-10-13;59;62;122;231204;224885;39;456089
52;2020-10-13;68;77;145;243874;243418;49;487292
52;2020-10-13;65;58;123;244100;239116;59;483216
52;2020-10-13;42;42;84;241796;221345;69;463141
52;2020-10-13;29;27;56;177805;149903;79;327708
52;2020-10-13;19;9;28;119561;75822;89;195383
52;2020-10-13;20;1;21;42559;15260;90;57819
52;2020-10-13;445;416;864;1952321;1849476;0;3801797
53;2020-10-13;7;4;11;173813;182358;09;356171
53;2020-10-13;36;41;79;202720;214740;19;417460
53;2020-10-13;44;46;90;163116;173196;29;336312
53;2020-10-13;41;35;76;190526;187674;39;378200
53;2020-10-13;34;37;71;212098;212015;49;424113
53;2020-10-13;37;34;71;223699;219176;59;442875
53;2020-10-13;33;28;61;227435;209274;69;436709
53;2020-10-13;13;10;23;169992;140910;79;310902
53;2020-10-13;6;4;10;118117;69883;89;188000
53;2020-10-13;5;1;6;37370;12267;90;49637
53;2020-10-13;256;240;498;1718886;1621493;0;3340379
75;2020-10-13;18;9;28;293104;305291;09;598395
75;2020-10-13;67;63;132;337141;357785;19;694926
75;2020-10-13;117;114;231;295024;300618;29;595642
75;2020-10-13;75;74;149;347871;331233;39;679104
75;2020-10-13;105;82;187;384742;372771;49;757513
75;2020-10-13;80;65;145;413361;390880;59;804241
75;2020-10-13;54;54;108;425623;384060;69;809683
75;2020-10-13;35;40;75;325086;276298;79;601384
75;2020-10-13;33;20;53;213986;139308;89;353294
75;2020-10-13;20;9;29;77600;28200;90;105800
75;2020-10-13;604;530;1137;3113538;2886444;0;5999982
76;2020-10-13;13;16;29;305956;318589;09;624545
76;2020-10-13;163;180;345;338942;356969;19;695911
76;2020-10-13;227;200;427;316210;319570;29;635780
76;2020-10-13;214;185;399;356758;337587;39;694345
76;2020-10-13;221;195;416;376541;363812;49;740353
76;2020-10-13;201;174;375;402608;383750;59;786358
76;2020-10-13;108;145;253;394889;358997;69;753886
76;2020-10-13;70;74;144;308664;263806;79;572470
76;2020-10-13;66;27;93;195838;129272;89;325110
76;2020-10-13;47;15;62;69372;26728;90;96100
76;2020-10-13;1332;1214;2548;3065778;2859080;0;5924858
84;2020-10-13;61;47;108;459549;481088;09;940637
84;2020-10-13;348;386;735;487711;511905;19;999616
84;2020-10-13;588;452;1040;443824;451094;29;894918
84;2020-10-13;475;428;905;512522;493262;39;1005784
84;2020-10-13;480;401;881;520248;515106;49;1035354
84;2020-10-13;440;382;823;529611;514848;59;1044459
84;2020-10-13;253;236;489;486720;439940;69;926660
84;2020-10-13;154;185;340;372151;315211;79;687362
84;2020-10-13;128;76;204;237198;150524;89;387722
84;2020-10-13;113;23;136;81185;28680;90;109865
84;2020-10-13;3041;2616;5662;4130719;3901658;0;8032377
93;2020-10-13;20;19;39;268834;283093;09;551927
93;2020-10-13;126;129;255;280751;296087;19;576838
93;2020-10-13;190;142;332;254404;255552;29;509956
93;2020-10-13;205;131;336;310704;288398;39;599102
93;2020-10-13;161;146;307;325559;305827;49;631386
93;2020-10-13;177;144;322;353104;325389;59;678493
93;2020-10-13;124;110;234;336327;296459;69;632786
93;2020-10-13;44;51;95;279820;229699;79;509519
93;2020-10-13;57;39;96;171274;113716;89;284990
93;2020-10-13;30;15;45;58896;21758;90;80654
93;2020-10-13;1135;929;2065;2639673;2415978;0;5055651
94;2020-10-13;0;1;1;16311;17433;09;33744
94;2020-10-13;6;6;12;16679;18132;19;34811
94;2020-10-13;10;12;22;16782;16579;29;33361
94;2020-10-13;9;13;22;23044;20580;39;43624
94;2020-10-13;10;5;15;23065;22140;49;45205
94;2020-10-13;18;12;30;24549;23421;59;47970
94;2020-10-13;8;7;15;23212;21883;69;45095
94;2020-10-13;8;6;14;19544;17141;79;36685
94;2020-10-13;0;1;1;11227;8178;89;19405
94;2020-10-13;0;0;0;3332;1447;90;4779
94;2020-10-13;69;63;132;177745;166934;0;344679
01;2020-10-14;2;0;2;19979;20155;09;40134
01;2020-10-14;4;2;6;24994;25489;19;50483
01;2020-10-14;8;1;9;17868;16690;29;34558
01;2020-10-14;2;6;8;22328;14821;39;37149
01;2020-10-14;9;6;15;28652;20276;49;48928
01;2020-10-14;5;2;7;33264;27260;59;60524
01;2020-10-14;2;3;5;27135;23978;69;51113
01;2020-10-14;2;3;5;18401;14661;79;33062
01;2020-10-14;4;4;8;9633;6375;89;16008
01;2020-10-14;0;0;0;3410;1510;90;4920
01;2020-10-14;38;27;65;205664;171215;0;376879
02;2020-10-14;1;1;2;16881;17110;09;33991
02;2020-10-14;9;3;12;21410;21604;19;43014
02;2020-10-14;10;5;15;16017;15479;29;31496
02;2020-10-14;10;2;12;19825;14455;39;34280
02;2020-10-14;6;5;12;24719;18248;49;42967
02;2020-10-14;12;15;27;34361;28310;59;62671
02;2020-10-14;6;9;16;28061;24495;69;52556
02;2020-10-14;1;1;2;18231;15278;79;33509
02;2020-10-14;0;0;0;11090;7677;89;18767
02;2020-10-14;0;0;0;3992;1506;90;5498
02;2020-10-14;55;41;98;194587;164162;0;358749
03;2020-10-14;1;0;1;31123;30920;09;62043
03;2020-10-14;1;1;2;29370;29268;19;58638
03;2020-10-14;3;0;3;21458;18963;29;40421
03;2020-10-14;0;1;1;21276;18326;39;39602
03;2020-10-14;1;0;1;18164;16593;49;34757
03;2020-10-14;3;0;3;13469;13557;59;27026
03;2020-10-14;3;0;3;8776;8670;69;17446
03;2020-10-14;0;0;0;3777;3591;79;7368
03;2020-10-14;0;2;2;1649;1072;89;2721
03;2020-10-14;0;0;0;485;184;90;669
03;2020-10-14;12;4;16;149547;141144;0;290691
04;2020-10-14;1;1;2;60314;61377;09;121691
04;2020-10-14;5;7;12;66065;68387;19;134452
04;2020-10-14;7;8;15;51059;47156;29;98215
04;2020-10-14;3;4;7;58788;45780;39;104568
04;2020-10-14;3;2;5;61408;52207;49;113615
04;2020-10-14;3;4;7;64838;60759;59;125597
04;2020-10-14;2;2;4;47008;42843;69;89851
04;2020-10-14;0;1;1;25509;21184;79;46693
04;2020-10-14;0;1;1;13168;7647;89;20815
04;2020-10-14;0;0;0;3209;1253;90;4462
04;2020-10-14;24;30;54;451366;408593;0;859959
05;2020-10-14;0;0;0;362.366008612902;341.338819562748;09;703.704828175651
05;2020-10-14;0;0;0;353.376145114279;370.349735405642;19;723.725880519921
05;2020-10-14;0;0;0;218.593559489256;256.539602589476;29;475.133162078732
05;2020-10-14;0;0;0;404.225408693299;360.321910454353;39;764.547319147651
05;2020-10-14;0;0;0;520.067953604221;497.108383964256;49;1017.17633756848
05;2020-10-14;0;0;0;468.146063921917;510.087601910415;59;978.233665832332
05;2020-10-14;0;0;0;340.368470050554;334.366842191253;69;674.735312241807
05;2020-10-14;0;0;0;212.598666888387;192.597753227106;79;405.196420115493
05;2020-10-14;0;0;0;148.727797095705;61.8681715431829;89;210.595968638888
05;2020-10-14;0;0;0;32.9601271090696;10.9909785719784;90;43.9511056810479
05;2020-10-14;0;0;0;3061.43020057959;2935.56979942041;0;5997
06;2020-10-14;0;0;0;42583;42380;09;84963
06;2020-10-14;0;1;1;33369;31925;19;65294
06;2020-10-14;4;1;5;21571;15080;29;36651
06;2020-10-14;2;5;7;21550;16147;39;37697
06;2020-10-14;3;4;7;14193;13939;49;28132
06;2020-10-14;0;1;1;7171;7597;59;14768
06;2020-10-14;0;1;1;3629;4117;69;7746
06;2020-10-14;0;0;0;1577;1457;79;3034
06;2020-10-14;0;0;0;531;474;89;1005
06;2020-10-14;0;0;0;88;93;90;181
06;2020-10-14;9;13;22;146262;133209;0;279471
07;2020-10-14;0;0;0;485;549;09;1034
07;2020-10-14;0;0;0;403;432;19;835
07;2020-10-14;0;0;0;764;841;29;1605
07;2020-10-14;0;0;0;824;928;39;1752
07;2020-10-14;0;0;0;788;1020;49;1808
07;2020-10-14;0;1;1;678;870;59;1548
07;2020-10-14;0;0;0;360;382;69;742
07;2020-10-14;0;0;0;231;190;79;421
07;2020-10-14;0;0;0;114;67;89;181
07;2020-10-14;0;0;0;24;11;90;35
07;2020-10-14;0;1;1;4671;5290;0;9961
08;2020-10-14;0;0;0;2715.22592983026;2997.75551488675;09;5712.98144471701
08;2020-10-14;0;0;0;2778.51901080978;3160.9156459093;19;5939.43465671908
08;2020-10-14;0;2;2;2080.8882988764;1718.16634315323;29;3799.05464202964
08;2020-10-14;0;1;1;2701.8582062647;1896.52641413317;39;4598.38462039786
08;2020-10-14;1;0;1;3151.45861023308;2460.52498233809;49;5611.98359257117
08;2020-10-14;0;2;2;2620.29868333099;2422.23566154656;59;5042.53434487755
08;2020-10-14;0;0;0;1621.44173420671;1438.58325779464;69;3060.02499200135
08;2020-10-14;1;0;1;626.575909335673;526.358467843651;79;1152.93437717932
08;2020-10-14;0;0;0;205.018522985054;140.993639349697;89;346.012162334751
08;2020-10-14;0;0;0;50.0325684687745;20.62259870351;90;70.6551671722846
08;2020-10-14;2;5;7;18551.3174743414;16782.6825256586;0;35334
11;2020-10-14;66;73;149;783071;811785;09;1594856
11;2020-10-14;467;473;971;761456;784653;19;1546109
11;2020-10-14;918;770;1693;850145;801772;29;1651917
11;2020-10-14;815;623;1443;914360;843488;39;1757848
11;2020-10-14;717;590;1312;845609;826202;49;1671811
11;2020-10-14;546;478;1031;793566;745070;59;1538636
11;2020-10-14;303;328;639;628649;549192;69;1177841
11;2020-10-14;147;133;280;434606;358356;79;792962
11;2020-10-14;69;55;124;261425;162933;89;424358
11;2020-10-14;52;10;63;89253;32619;90;121872
11;2020-10-14;4100;3535;7711;6362140;5916070;0;12278210
24;2020-10-14;1;9;10;139720;144686;09;284406
24;2020-10-14;65;41;106;152979;161185;19;314164
24;2020-10-14;57;61;118;122237;126536;29;248773
24;2020-10-14;48;44;92;150359;142009;39;292368
24;2020-10-14;68;49;117;161829;158758;49;320587
24;2020-10-14;54;50;104;172552;168011;59;340563
24;2020-10-14;42;26;68;172509;158177;69;330686
24;2020-10-14;22;14;36;129428;110593;79;240021
24;2020-10-14;11;9;20;87342;56882;89;144224
24;2020-10-14;6;3;9;31210;12071;90;43281
24;2020-10-14;374;306;680;1320165;1238908;0;2559073
27;2020-10-14;6;7;13;143373;149679;09;293052
27;2020-10-14;59;60;120;160962;173003;19;333965
27;2020-10-14;84;77;161;133746;142254;29;276000
27;2020-10-14;70;61;131;160004;155407;39;315411
27;2020-10-14;68;58;126;172333;169564;49;341897
27;2020-10-14;82;76;158;189979;183788;59;373767
27;2020-10-14;42;50;92;192591;178206;69;370797
27;2020-10-14;30;35;65;146876;127546;79;274422
27;2020-10-14;30;16;46;96896;61575;89;158471
27;2020-10-14;16;5;21;33148;12109;90;45257
27;2020-10-14;487;445;933;1429908;1353131;0;2783039
28;2020-10-14;12;11;24;180735;186856;09;367591
28;2020-10-14;77;65;144;200125;213621;19;413746
28;2020-10-14;96;83;179;168922;173007;29;341929
28;2020-10-14;86;77;163;196628;188487;39;385115
28;2020-10-14;101;64;165;205396;201699;49;407095
28;2020-10-14;72;76;148;222002;213866;59;435868
28;2020-10-14;49;60;109;224688;203758;69;428446
28;2020-10-14;29;31;60;163192;135543;79;298735
28;2020-10-14;26;22;48;109691;65377;89;175068
28;2020-10-14;22;7;29;37222;12685;90;49907
28;2020-10-14;570;496;1069;1708601;1594899;0;3303500
32;2020-10-14;47;51;98;358062;373689;09;731751
32;2020-10-14;272;251;524;387045;406742;19;793787
32;2020-10-14;368;289;657;342304;348587;29;690891
32;2020-10-14;292;246;539;382485;369972;39;752457
32;2020-10-14;293;263;556;382510;376716;49;759226
32;2020-10-14;247;206;454;386937;376527;59;763464
32;2020-10-14;138;142;281;371211;330938;69;702149
32;2020-10-14;89;79;168;250542;201459;79;452001
32;2020-10-14;73;43;116;163399;89786;89;253185
32;2020-10-14;42;8;50;48384;15367;90;63751
32;2020-10-14;1861;1578;3443;3072879;2889783;0;5962662
44;2020-10-14;25;17;47;291525;306839;09;598364
44;2020-10-14;94;100;194;320255;339504;19;659759
44;2020-10-14;184;151;335;302020;314428;29;616448
44;2020-10-14;129;102;231;342222;333292;39;675514
44;2020-10-14;105;111;216;349727;344491;49;694218
44;2020-10-14;108;98;206;381371;373239;59;754610
44;2020-10-14;66;66;132;367165;335850;69;703015
44;2020-10-14;46;39;85;250387;215436;79;465823
44;2020-10-14;25;17;42;170825;105192;89;276017
44;2020-10-14;17;7;24;51248;16731;90;67979
44;2020-10-14;799;708;1512;2826745;2685002;0;5511747
52;2020-10-14;11;9;21;213594;223900;09;437494
52;2020-10-14;73;53;126;240818;255197;19;496015
52;2020-10-14;112;90;202;197010;200630;29;397640
52;2020-10-14;77;58;135;231204;224885;39;456089
52;2020-10-14;84;57;141;243874;243418;49;487292
52;2020-10-14;52;56;108;244100;239116;59;483216
52;2020-10-14;49;49;98;241796;221345;69;463141
52;2020-10-14;35;23;58;177805;149903;79;327708
52;2020-10-14;18;12;30;119561;75822;89;195383
52;2020-10-14;6;5;11;42559;15260;90;57819
52;2020-10-14;517;412;930;1952321;1849476;0;3801797
53;2020-10-14;11;10;21;173813;182358;09;356171
53;2020-10-14;35;45;82;202720;214740;19;417460
53;2020-10-14;63;54;122;163116;173196;29;336312
53;2020-10-14;61;42;103;190526;187674;39;378200
53;2020-10-14;28;51;80;212098;212015;49;424113
53;2020-10-14;37;43;80;223699;219176;59;442875
53;2020-10-14;30;30;60;227435;209274;69;436709
53;2020-10-14;12;16;28;169992;140910;79;310902
53;2020-10-14;7;9;16;118117;69883;89;188000
53;2020-10-14;3;2;5;37370;12267;90;49637
53;2020-10-14;287;302;597;1718886;1621493;0;3340379
75;2020-10-14;13;10;24;293104;305291;09;598395
75;2020-10-14;75;80;157;337141;357785;19;694926
75;2020-10-14;133;140;274;295024;300618;29;595642
75;2020-10-14;83;83;166;347871;331233;39;679104
75;2020-10-14;100;77;177;384742;372771;49;757513
75;2020-10-14;76;65;141;413361;390880;59;804241
75;2020-10-14;63;62;125;425623;384060;69;809683
75;2020-10-14;32;26;58;325086;276298;79;601384
75;2020-10-14;17;17;34;213986;139308;89;353294
75;2020-10-14;11;1;12;77600;28200;90;105800
75;2020-10-14;603;563;1170;3113538;2886444;0;5999982
76;2020-10-14;24;26;51;305956;318589;09;624545
76;2020-10-14;181;156;344;338942;356969;19;695911
76;2020-10-14;241;212;454;316210;319570;29;635780
76;2020-10-14;187;168;355;356758;337587;39;694345
76;2020-10-14;201;176;377;376541;363812;49;740353
76;2020-10-14;184;148;332;402608;383750;59;786358
76;2020-10-14;121;111;232;394889;358997;69;753886
76;2020-10-14;62;65;127;308664;263806;79;572470
76;2020-10-14;56;38;94;195838;129272;89;325110
76;2020-10-14;34;9;43;69372;26728;90;96100
76;2020-10-14;1292;1110;2411;3065778;2859080;0;5924858
84;2020-10-14;58;62;120;459549;481088;09;940637
84;2020-10-14;364;404;774;487711;511905;19;999616
84;2020-10-14;541;457;999;443824;451094;29;894918
84;2020-10-14;475;389;864;512522;493262;39;1005784
84;2020-10-14;493;384;878;520248;515106;49;1035354
84;2020-10-14;421;346;768;529611;514848;59;1044459
84;2020-10-14;281;213;495;486720;439940;69;926660
84;2020-10-14;156;163;319;372151;315211;79;687362
84;2020-10-14;132;88;220;237198;150524;89;387722
84;2020-10-14;106;37;143;81185;28680;90;109865
84;2020-10-14;3027;2543;5580;4130719;3901658;0;8032377
93;2020-10-14;27;27;54;268834;283093;09;551927
93;2020-10-14;149;128;281;280751;296087;19;576838
93;2020-10-14;167;163;330;254404;255552;29;509956
93;2020-10-14;195;124;319;310704;288398;39;599102
93;2020-10-14;174;168;342;325559;305827;49;631386
93;2020-10-14;185;148;333;353104;325389;59;678493
93;2020-10-14;100;100;200;336327;296459;69;632786
93;2020-10-14;58;59;117;279820;229699;79;509519
93;2020-10-14;60;36;96;171274;113716;89;284990
93;2020-10-14;51;9;60;58896;21758;90;80654
93;2020-10-14;1168;962;2134;2639673;2415978;0;5055651
94;2020-10-14;2;1;3;16311;17433;09;33744
94;2020-10-14;4;4;8;16679;18132;19;34811
94;2020-10-14;9;13;22;16782;16579;29;33361
94;2020-10-14;11;15;26;23044;20580;39;43624
94;2020-10-14;9;13;22;23065;22140;49;45205
94;2020-10-14;10;8;18;24549;23421;59;47970
94;2020-10-14;7;9;16;23212;21883;69;45095
94;2020-10-14;3;4;7;19544;17141;79;36685
94;2020-10-14;1;0;1;11227;8178;89;19405
94;2020-10-14;0;0;0;3332;1447;90;4779
94;2020-10-14;56;67;123;177745;166934;0;344679
01;2020-10-15;0;0;0;19979;20155;09;40134
01;2020-10-15;8;6;14;24994;25489;19;50483
01;2020-10-15;4;3;7;17868;16690;29;34558
01;2020-10-15;9;1;10;22328;14821;39;37149
01;2020-10-15;12;3;15;28652;20276;49;48928
01;2020-10-15;6;6;12;33264;27260;59;60524
01;2020-10-15;6;7;13;27135;23978;69;51113
01;2020-10-15;2;2;4;18401;14661;79;33062
01;2020-10-15;0;3;3;9633;6375;89;16008
01;2020-10-15;3;0;3;3410;1510;90;4920
01;2020-10-15;50;31;81;205664;171215;0;376879
02;2020-10-15;2;0;2;16881;17110;09;33991
02;2020-10-15;10;10;20;21410;21604;19;43014
02;2020-10-15;8;4;12;16017;15479;29;31496
02;2020-10-15;8;5;13;19825;14455;39;34280
02;2020-10-15;10;5;15;24719;18248;49;42967
02;2020-10-15;16;8;24;34361;28310;59;62671
02;2020-10-15;2;5;7;28061;24495;69;52556
02;2020-10-15;3;1;4;18231;15278;79;33509
02;2020-10-15;0;0;0;11090;7677;89;18767
02;2020-10-15;0;0;0;3992;1506;90;5498
02;2020-10-15;59;38;97;194587;164162;0;358749
03;2020-10-15;0;1;1;31123;30920;09;62043
03;2020-10-15;0;0;0;29370;29268;19;58638
03;2020-10-15;2;1;3;21458;18963;29;40421
03;2020-10-15;0;0;0;21276;18326;39;39602
03;2020-10-15;0;1;1;18164;16593;49;34757
03;2020-10-15;1;0;1;13469;13557;59;27026
03;2020-10-15;1;0;1;8776;8670;69;17446
03;2020-10-15;1;0;1;3777;3591;79;7368
03;2020-10-15;0;0;0;1649;1072;89;2721
03;2020-10-15;0;0;0;485;184;90;669
03;2020-10-15;5;3;8;149547;141144;0;290691
04;2020-10-15;1;2;3;60314;61377;09;121691
04;2020-10-15;5;4;9;66065;68387;19;134452
04;2020-10-15;4;7;11;51059;47156;29;98215
04;2020-10-15;4;2;6;58788;45780;39;104568
04;2020-10-15;4;5;9;61408;52207;49;113615
04;2020-10-15;3;4;7;64838;60759;59;125597
04;2020-10-15;2;2;4;47008;42843;69;89851
04;2020-10-15;0;1;1;25509;21184;79;46693
04;2020-10-15;0;0;0;13168;7647;89;20815
04;2020-10-15;0;0;0;3209;1253;90;4462
04;2020-10-15;23;27;50;451366;408593;0;859959
05;2020-10-15;0;0;0;362.366008612902;341.338819562748;09;703.704828175651
05;2020-10-15;0;0;0;353.376145114279;370.349735405642;19;723.725880519921
05;2020-10-15;0;0;0;218.593559489256;256.539602589476;29;475.133162078732
05;2020-10-15;0;0;0;404.225408693299;360.321910454353;39;764.547319147651
05;2020-10-15;0;0;0;520.067953604221;497.108383964256;49;1017.17633756848
05;2020-10-15;0;0;0;468.146063921917;510.087601910415;59;978.233665832332
05;2020-10-15;0;0;0;340.368470050554;334.366842191253;69;674.735312241807
05;2020-10-15;0;0;0;212.598666888387;192.597753227106;79;405.196420115493
05;2020-10-15;1;0;1;148.727797095705;61.8681715431829;89;210.595968638888
05;2020-10-15;0;0;0;32.9601271090696;10.9909785719784;90;43.9511056810479
05;2020-10-15;1;0;1;3061.43020057959;2935.56979942041;0;5997
06;2020-10-15;0;0;0;42583;42380;09;84963
06;2020-10-15;5;2;7;33369;31925;19;65294
06;2020-10-15;2;5;7;21571;15080;29;36651
06;2020-10-15;2;3;5;21550;16147;39;37697
06;2020-10-15;6;3;9;14193;13939;49;28132
06;2020-10-15;2;0;2;7171;7597;59;14768
06;2020-10-15;0;0;0;3629;4117;69;7746
06;2020-10-15;0;0;0;1577;1457;79;3034
06;2020-10-15;0;0;0;531;474;89;1005
06;2020-10-15;0;0;0;88;93;90;181
06;2020-10-15;17;13;30;146262;133209;0;279471
07;2020-10-15;0;0;0;485;549;09;1034
07;2020-10-15;0;0;0;403;432;19;835
07;2020-10-15;0;1;1;764;841;29;1605
07;2020-10-15;0;0;0;824;928;39;1752
07;2020-10-15;0;1;1;788;1020;49;1808
07;2020-10-15;0;0;0;678;870;59;1548
07;2020-10-15;0;0;0;360;382;69;742
07;2020-10-15;0;0;0;231;190;79;421
07;2020-10-15;0;0;0;114;67;89;181
07;2020-10-15;0;0;0;24;11;90;35
07;2020-10-15;0;2;2;4671;5290;0;9961
08;2020-10-15;0;0;0;2715.22592983026;2997.75551488675;09;5712.98144471701
08;2020-10-15;0;0;0;2778.51901080978;3160.9156459093;19;5939.43465671908
08;2020-10-15;0;0;0;2080.8882988764;1718.16634315323;29;3799.05464202964
08;2020-10-15;0;0;0;2701.8582062647;1896.52641413317;39;4598.38462039786
08;2020-10-15;2;0;2;3151.45861023308;2460.52498233809;49;5611.98359257117
08;2020-10-15;0;0;0;2620.29868333099;2422.23566154656;59;5042.53434487755
08;2020-10-15;1;0;1;1621.44173420671;1438.58325779464;69;3060.02499200135
08;2020-10-15;0;0;0;626.575909335673;526.358467843651;79;1152.93437717932
08;2020-10-15;0;0;0;205.018522985054;140.993639349697;89;346.012162334751
08;2020-10-15;0;0;0;50.0325684687745;20.62259870351;90;70.6551671722846
08;2020-10-15;3;0;3;18551.3174743414;16782.6825256586;0;35334
11;2020-10-15;83;75;172;783071;811785;09;1594856
11;2020-10-15;477;466;969;761456;784653;19;1546109
11;2020-10-15;1044;816;1863;850145;801772;29;1651917
11;2020-10-15;848;781;1636;914360;843488;39;1757848
11;2020-10-15;785;651;1441;845609;826202;49;1671811
11;2020-10-15;578;504;1083;793566;745070;59;1538636
11;2020-10-15;385;350;741;628649;549192;69;1177841
11;2020-10-15;150;144;295;434606;358356;79;792962
11;2020-10-15;85;62;147;261425;162933;89;424358
11;2020-10-15;47;18;65;89253;32619;90;121872
11;2020-10-15;4483;3868;8416;6362140;5916070;0;12278210
24;2020-10-15;5;5;10;139720;144686;09;284406
24;2020-10-15;32;35;69;152979;161185;19;314164
24;2020-10-15;73;80;153;122237;126536;29;248773
24;2020-10-15;72;41;113;150359;142009;39;292368
24;2020-10-15;65;51;116;161829;158758;49;320587
24;2020-10-15;59;59;118;172552;168011;59;340563
24;2020-10-15;33;29;62;172509;158177;69;330686
24;2020-10-15;16;19;35;129428;110593;79;240021
24;2020-10-15;7;14;21;87342;56882;89;144224
24;2020-10-15;9;6;15;31210;12071;90;43281
24;2020-10-15;371;339;712;1320165;1238908;0;2559073
27;2020-10-15;7;9;16;143373;149679;09;293052
27;2020-10-15;55;62;117;160962;173003;19;333965
27;2020-10-15;82;75;157;133746;142254;29;276000
27;2020-10-15;85;78;163;160004;155407;39;315411
27;2020-10-15;88;69;157;172333;169564;49;341897
27;2020-10-15;80;73;153;189979;183788;59;373767
27;2020-10-15;56;59;115;192591;178206;69;370797
27;2020-10-15;34;38;72;146876;127546;79;274422
27;2020-10-15;36;23;59;96896;61575;89;158471
27;2020-10-15;24;8;32;33148;12109;90;45257
27;2020-10-15;547;494;1041;1429908;1353131;0;2783039
28;2020-10-15;7;15;22;180735;186856;09;367591
28;2020-10-15;69;61;130;200125;213621;19;413746
28;2020-10-15;105;79;184;168922;173007;29;341929
28;2020-10-15;84;88;172;196628;188487;39;385115
28;2020-10-15;86;69;155;205396;201699;49;407095
28;2020-10-15;86;59;145;222002;213866;59;435868
28;2020-10-15;62;48;110;224688;203758;69;428446
28;2020-10-15;37;43;80;163192;135543;79;298735
28;2020-10-15;25;23;48;109691;65377;89;175068
28;2020-10-15;15;3;18;37222;12685;90;49907
28;2020-10-15;576;488;1064;1708601;1594899;0;3303500
32;2020-10-15;63;54;118;358062;373689;09;731751
32;2020-10-15;299;272;573;387045;406742;19;793787
32;2020-10-15;364;306;671;342304;348587;29;690891
32;2020-10-15;336;278;616;382485;369972;39;752457
32;2020-10-15;322;264;586;382510;376716;49;759226
32;2020-10-15;276;229;508;386937;376527;59;763464
32;2020-10-15;146;155;301;371211;330938;69;702149
32;2020-10-15;112;96;209;250542;201459;79;452001
32;2020-10-15;90;53;143;163399;89786;89;253185
32;2020-10-15;66;16;82;48384;15367;90;63751
32;2020-10-15;2074;1724;3808;3072879;2889783;0;5962662
44;2020-10-15;17;20;38;291525;306839;09;598364
44;2020-10-15;91;85;178;320255;339504;19;659759
44;2020-10-15;180;180;360;302020;314428;29;616448
44;2020-10-15;137;125;262;342222;333292;39;675514
44;2020-10-15;126;116;242;349727;344491;49;694218
44;2020-10-15;138;121;259;381371;373239;59;754610
44;2020-10-15;78;78;156;367165;335850;69;703015
44;2020-10-15;50;43;93;250387;215436;79;465823
44;2020-10-15;34;22;57;170825;105192;89;276017
44;2020-10-15;9;2;11;51248;16731;90;67979
44;2020-10-15;860;792;1656;2826745;2685002;0;5511747
52;2020-10-15;9;18;28;213594;223900;09;437494
52;2020-10-15;69;67;138;240818;255197;19;496015
52;2020-10-15;111;110;221;197010;200630;29;397640
52;2020-10-15;81;90;171;231204;224885;39;456089
52;2020-10-15;85;65;150;243874;243418;49;487292
52;2020-10-15;69;70;139;244100;239116;59;483216
52;2020-10-15;60;62;122;241796;221345;69;463141
52;2020-10-15;29;29;58;177805;149903;79;327708
52;2020-10-15;20;16;36;119561;75822;89;195383
52;2020-10-15;23;8;31;42559;15260;90;57819
52;2020-10-15;556;535;1094;1952321;1849476;0;3801797
53;2020-10-15;12;11;23;173813;182358;09;356171
53;2020-10-15;52;40;92;202720;214740;19;417460
53;2020-10-15;61;78;142;163116;173196;29;336312
53;2020-10-15;62;46;109;190526;187674;39;378200
53;2020-10-15;45;42;87;212098;212015;49;424113
53;2020-10-15;58;34;92;223699;219176;59;442875
53;2020-10-15;39;45;84;227435;209274;69;436709
53;2020-10-15;17;20;37;169992;140910;79;310902
53;2020-10-15;12;5;17;118117;69883;89;188000
53;2020-10-15;4;3;7;37370;12267;90;49637
53;2020-10-15;362;324;691;1718886;1621493;0;3340379
75;2020-10-15;10;14;26;293104;305291;09;598395
75;2020-10-15;87;83;172;337141;357785;19;694926
75;2020-10-15;154;136;290;295024;300618;29;595642
75;2020-10-15;100;87;187;347871;331233;39;679104
75;2020-10-15;104;70;174;384742;372771;49;757513
75;2020-10-15;117;91;208;413361;390880;59;804241
75;2020-10-15;51;54;105;425623;384060;69;809683
75;2020-10-15;36;26;62;325086;276298;79;601384
75;2020-10-15;24;23;47;213986;139308;89;353294
75;2020-10-15;18;5;23;77600;28200;90;105800
75;2020-10-15;702;589;1295;3113538;2886444;0;5999982
76;2020-10-15;24;26;51;305956;318589;09;624545
76;2020-10-15;174;166;343;338942;356969;19;695911
76;2020-10-15;292;247;540;316210;319570;29;635780
76;2020-10-15;234;162;396;356758;337587;39;694345
76;2020-10-15;231;181;412;376541;363812;49;740353
76;2020-10-15;192;180;372;402608;383750;59;786358
76;2020-10-15;134;117;251;394889;358997;69;753886
76;2020-10-15;71;72;143;308664;263806;79;572470
76;2020-10-15;61;33;94;195838;129272;89;325110
76;2020-10-15;53;19;72;69372;26728;90;96100
76;2020-10-15;1468;1204;2677;3065778;2859080;0;5924858
84;2020-10-15;50;67;119;459549;481088;09;940637
84;2020-10-15;400;396;800;487711;511905;19;999616
84;2020-10-15;645;576;1223;443824;451094;29;894918
84;2020-10-15;607;472;1080;512522;493262;39;1005784
84;2020-10-15;524;460;985;520248;515106;49;1035354
84;2020-10-15;474;401;876;529611;514848;59;1044459
84;2020-10-15;287;264;551;486720;439940;69;926660
84;2020-10-15;177;160;337;372151;315211;79;687362
84;2020-10-15;173;99;272;237198;150524;89;387722
84;2020-10-15;148;41;189;81185;28680;90;109865
84;2020-10-15;3485;2936;6432;4130719;3901658;0;8032377
93;2020-10-15;22;29;51;268834;283093;09;551927
93;2020-10-15;128;128;257;280751;296087;19;576838
93;2020-10-15;191;182;374;254404;255552;29;509956
93;2020-10-15;193;147;340;310704;288398;39;599102
93;2020-10-15;213;178;392;325559;305827;49;631386
93;2020-10-15;201;158;359;353104;325389;59;678493
93;2020-10-15;121;124;245;336327;296459;69;632786
93;2020-10-15;102;91;193;279820;229699;79;509519
93;2020-10-15;93;61;154;171274;113716;89;284990
93;2020-10-15;71;20;91;58896;21758;90;80654
93;2020-10-15;1337;1118;2458;2639673;2415978;0;5055651
94;2020-10-15;0;2;2;16311;17433;09;33744
94;2020-10-15;7;5;12;16679;18132;19;34811
94;2020-10-15;17;10;27;16782;16579;29;33361
94;2020-10-15;18;11;29;23044;20580;39;43624
94;2020-10-15;5;12;17;23065;22140;49;45205
94;2020-10-15;18;15;33;24549;23421;59;47970
94;2020-10-15;8;10;18;23212;21883;69;45095
94;2020-10-15;4;7;11;19544;17141;79;36685
94;2020-10-15;2;1;3;11227;8178;89;19405
94;2020-10-15;0;0;0;3332;1447;90;4779
94;2020-10-15;79;73;152;177745;166934;0;344679
01;2020-10-16;0;1;1;19979;20155;09;40134
01;2020-10-16;2;2;4;24994;25489;19;50483
01;2020-10-16;1;0;1;17868;16690;29;34558
01;2020-10-16;5;4;9;22328;14821;39;37149
01;2020-10-16;3;4;7;28652;20276;49;48928
01;2020-10-16;2;5;7;33264;27260;59;60524
01;2020-10-16;3;3;6;27135;23978;69;51113
01;2020-10-16;1;0;1;18401;14661;79;33062
01;2020-10-16;1;0;1;9633;6375;89;16008
01;2020-10-16;0;0;0;3410;1510;90;4920
01;2020-10-16;18;19;38;205664;171215;0;376879
02;2020-10-16;2;0;2;16881;17110;09;33991
02;2020-10-16;9;12;21;21410;21604;19;43014
02;2020-10-16;11;6;17;16017;15479;29;31496
02;2020-10-16;12;9;21;19825;14455;39;34280
02;2020-10-16;15;9;24;24719;18248;49;42967
02;2020-10-16;11;14;25;34361;28310;59;62671
02;2020-10-16;9;7;16;28061;24495;69;52556
02;2020-10-16;1;2;3;18231;15278;79;33509
02;2020-10-16;3;0;3;11090;7677;89;18767
02;2020-10-16;0;0;0;3992;1506;90;5498
02;2020-10-16;73;59;132;194587;164162;0;358749
03;2020-10-16;0;0;0;31123;30920;09;62043
03;2020-10-16;0;4;4;29370;29268;19;58638
03;2020-10-16;2;0;2;21458;18963;29;40421
03;2020-10-16;3;1;4;21276;18326;39;39602
03;2020-10-16;3;2;5;18164;16593;49;34757
03;2020-10-16;2;1;3;13469;13557;59;27026
03;2020-10-16;1;2;3;8776;8670;69;17446
03;2020-10-16;0;0;0;3777;3591;79;7368
03;2020-10-16;0;0;0;1649;1072;89;2721
03;2020-10-16;0;0;0;485;184;90;669
03;2020-10-16;11;10;21;149547;141144;0;290691
04;2020-10-16;3;1;4;60314;61377;09;121691
04;2020-10-16;3;5;8;66065;68387;19;134452
04;2020-10-16;5;3;8;51059;47156;29;98215
04;2020-10-16;4;3;7;58788;45780;39;104568
04;2020-10-16;9;5;14;61408;52207;49;113615
04;2020-10-16;4;2;6;64838;60759;59;125597
04;2020-10-16;2;2;4;47008;42843;69;89851
04;2020-10-16;2;2;4;25509;21184;79;46693
04;2020-10-16;1;0;1;13168;7647;89;20815
04;2020-10-16;0;0;0;3209;1253;90;4462
04;2020-10-16;33;23;56;451366;408593;0;859959
05;2020-10-16;0;0;0;362.366008612902;341.338819562748;09;703.704828175651
05;2020-10-16;0;0;0;353.376145114279;370.349735405642;19;723.725880519921
05;2020-10-16;0;0;0;218.593559489256;256.539602589476;29;475.133162078732
05;2020-10-16;0;0;0;404.225408693299;360.321910454353;39;764.547319147651
05;2020-10-16;0;0;0;520.067953604221;497.108383964256;49;1017.17633756848
05;2020-10-16;0;0;0;468.146063921917;510.087601910415;59;978.233665832332
05;2020-10-16;0;0;0;340.368470050554;334.366842191253;69;674.735312241807
05;2020-10-16;0;0;0;212.598666888387;192.597753227106;79;405.196420115493
05;2020-10-16;0;0;0;148.727797095705;61.8681715431829;89;210.595968638888
05;2020-10-16;0;0;0;32.9601271090696;10.9909785719784;90;43.9511056810479
05;2020-10-16;0;0;0;3061.43020057959;2935.56979942041;0;5997
06;2020-10-16;1;0;1;42583;42380;09;84963
06;2020-10-16;1;1;2;33369;31925;19;65294
06;2020-10-16;2;4;6;21571;15080;29;36651
06;2020-10-16;3;0;3;21550;16147;39;37697
06;2020-10-16;2;1;3;14193;13939;49;28132
06;2020-10-16;1;2;3;7171;7597;59;14768
06;2020-10-16;0;1;1;3629;4117;69;7746
06;2020-10-16;0;0;0;1577;1457;79;3034
06;2020-10-16;0;0;0;531;474;89;1005
06;2020-10-16;0;0;0;88;93;90;181
06;2020-10-16;10;9;19;146262;133209;0;279471
07;2020-10-16;0;0;0;485;549;09;1034
07;2020-10-16;0;0;0;403;432;19;835
07;2020-10-16;0;0;0;764;841;29;1605
07;2020-10-16;0;2;2;824;928;39;1752
07;2020-10-16;0;1;1;788;1020;49;1808
07;2020-10-16;0;0;0;678;870;59;1548
07;2020-10-16;0;0;0;360;382;69;742
07;2020-10-16;0;0;0;231;190;79;421
07;2020-10-16;0;0;0;114;67;89;181
07;2020-10-16;0;0;0;24;11;90;35
07;2020-10-16;0;3;3;4671;5290;0;9961
08;2020-10-16;0;0;0;2715.22592983026;2997.75551488675;09;5712.98144471701
08;2020-10-16;0;0;0;2778.51901080978;3160.9156459093;19;5939.43465671908
08;2020-10-16;0;0;0;2080.8882988764;1718.16634315323;29;3799.05464202964
08;2020-10-16;0;0;0;2701.8582062647;1896.52641413317;39;4598.38462039786
08;2020-10-16;0;0;0;3151.45861023308;2460.52498233809;49;5611.98359257117
08;2020-10-16;0;0;0;2620.29868333099;2422.23566154656;59;5042.53434487755
08;2020-10-16;0;0;0;1621.44173420671;1438.58325779464;69;3060.02499200135
08;2020-10-16;0;0;0;626.575909335673;526.358467843651;79;1152.93437717932
08;2020-10-16;0;0;0;205.018522985054;140.993639349697;89;346.012162334751
08;2020-10-16;0;0;0;50.0325684687745;20.62259870351;90;70.6551671722846
08;2020-10-16;0;0;0;18551.3174743414;16782.6825256586;0;35334
11;2020-10-16;63;83;157;783071;811785;09;1594856
11;2020-10-16;483;452;960;761456;784653;19;1546109
11;2020-10-16;1008;803;1814;850145;801772;29;1651917
11;2020-10-16;873;724;1600;914360;843488;39;1757848
11;2020-10-16;711;608;1321;845609;826202;49;1671811
11;2020-10-16;600;577;1178;793566;745070;59;1538636
11;2020-10-16;375;357;736;628649;549192;69;1177841
11;2020-10-16;150;188;338;434606;358356;79;792962
11;2020-10-16;104;90;194;261425;162933;89;424358
11;2020-10-16;60;19;79;89253;32619;90;121872
11;2020-10-16;4429;3901;8383;6362140;5916070;0;12278210
24;2020-10-16;4;5;9;139720;144686;09;284406
24;2020-10-16;51;46;97;152979;161185;19;314164
24;2020-10-16;90;74;164;122237;126536;29;248773
24;2020-10-16;55;50;105;150359;142009;39;292368
24;2020-10-16;82;59;141;161829;158758;49;320587
24;2020-10-16;73;59;132;172552;168011;59;340563
24;2020-10-16;38;47;87;172509;158177;69;330686
24;2020-10-16;26;24;50;129428;110593;79;240021
24;2020-10-16;18;12;30;87342;56882;89;144224
24;2020-10-16;9;3;12;31210;12071;90;43281
24;2020-10-16;446;379;827;1320165;1238908;0;2559073
27;2020-10-16;18;8;26;143373;149679;09;293052
27;2020-10-16;60;76;137;160962;173003;19;333965
27;2020-10-16;110;93;203;133746;142254;29;276000
27;2020-10-16;77;77;154;160004;155407;39;315411
27;2020-10-16;88;83;171;172333;169564;49;341897
27;2020-10-16;97;86;183;189979;183788;59;373767
27;2020-10-16;71;61;132;192591;178206;69;370797
27;2020-10-16;44;48;92;146876;127546;79;274422
27;2020-10-16;39;28;67;96896;61575;89;158471
27;2020-10-16;28;9;37;33148;12109;90;45257
27;2020-10-16;632;569;1202;1429908;1353131;0;2783039
28;2020-10-16;21;16;38;180735;186856;09;367591
28;2020-10-16;63;65;129;200125;213621;19;413746
28;2020-10-16;108;106;214;168922;173007;29;341929
28;2020-10-16;112;81;193;196628;188487;39;385115
28;2020-10-16;114;79;193;205396;201699;49;407095
28;2020-10-16;86;85;172;222002;213866;59;435868
28;2020-10-16;78;67;145;224688;203758;69;428446
28;2020-10-16;44;43;87;163192;135543;79;298735
28;2020-10-16;42;20;62;109691;65377;89;175068
28;2020-10-16;32;7;39;37222;12685;90;49907
28;2020-10-16;700;569;1272;1708601;1594899;0;3303500
32;2020-10-16;48;73;122;358062;373689;09;731751
32;2020-10-16;264;240;504;387045;406742;19;793787
32;2020-10-16;365;317;682;342304;348587;29;690891
32;2020-10-16;349;290;639;382485;369972;39;752457
32;2020-10-16;307;283;591;382510;376716;49;759226
32;2020-10-16;263;231;494;386937;376527;59;763464
32;2020-10-16;181;153;334;371211;330938;69;702149
32;2020-10-16;100;101;201;250542;201459;79;452001
32;2020-10-16;86;47;133;163399;89786;89;253185
32;2020-10-16;42;13;55;48384;15367;90;63751
32;2020-10-16;2006;1748;3756;3072879;2889783;0;5962662
44;2020-10-16;14;19;33;291525;306839;09;598364
44;2020-10-16;102;119;222;320255;339504;19;659759
44;2020-10-16;189;171;360;302020;314428;29;616448
44;2020-10-16;152;133;285;342222;333292;39;675514
44;2020-10-16;138;124;262;349727;344491;49;694218
44;2020-10-16;122;133;255;381371;373239;59;754610
44;2020-10-16;83;84;167;367165;335850;69;703015
44;2020-10-16;49;62;111;250387;215436;79;465823
44;2020-10-16;36;20;56;170825;105192;89;276017
44;2020-10-16;17;5;22;51248;16731;90;67979
44;2020-10-16;902;870;1773;2826745;2685002;0;5511747
52;2020-10-16;12;13;25;213594;223900;09;437494
52;2020-10-16;85;53;140;240818;255197;19;496015
52;2020-10-16;113;104;217;197010;200630;29;397640
52;2020-10-16;92;88;180;231204;224885;39;456089
52;2020-10-16;88;81;169;243874;243418;49;487292
52;2020-10-16;66;74;140;244100;239116;59;483216
52;2020-10-16;69;72;141;241796;221345;69;463141
52;2020-10-16;30;43;73;177805;149903;79;327708
52;2020-10-16;22;18;40;119561;75822;89;195383
52;2020-10-16;17;3;20;42559;15260;90;57819
52;2020-10-16;594;549;1145;1952321;1849476;0;3801797
53;2020-10-16;11;10;21;173813;182358;09;356171
53;2020-10-16;40;60;102;202720;214740;19;417460
53;2020-10-16;85;75;160;163116;173196;29;336312
53;2020-10-16;48;56;104;190526;187674;39;378200
53;2020-10-16;58;48;106;212098;212015;49;424113
53;2020-10-16;51;49;100;223699;219176;59;442875
53;2020-10-16;40;31;71;227435;209274;69;436709
53;2020-10-16;24;15;39;169992;140910;79;310902
53;2020-10-16;18;12;30;118117;69883;89;188000
53;2020-10-16;1;2;3;37370;12267;90;49637
53;2020-10-16;377;358;737;1718886;1621493;0;3340379
75;2020-10-16;17;11;28;293104;305291;09;598395
75;2020-10-16;90;97;190;337141;357785;19;694926
75;2020-10-16;169;176;346;295024;300618;29;595642
75;2020-10-16;111;96;207;347871;331233;39;679104
75;2020-10-16;103;107;210;384742;372771;49;757513
75;2020-10-16;94;102;196;413361;390880;59;804241
75;2020-10-16;57;58;115;425623;384060;69;809683
75;2020-10-16;33;38;71;325086;276298;79;601384
75;2020-10-16;24;15;39;213986;139308;89;353294
75;2020-10-16;23;6;29;77600;28200;90;105800
75;2020-10-16;721;706;1431;3113538;2886444;0;5999982
76;2020-10-16;16;19;37;305956;318589;09;624545
76;2020-10-16;160;149;316;338942;356969;19;695911
76;2020-10-16;252;247;499;316210;319570;29;635780
76;2020-10-16;222;188;410;356758;337587;39;694345
76;2020-10-16;263;188;451;376541;363812;49;740353
76;2020-10-16;230;194;424;402608;383750;59;786358
76;2020-10-16;125;119;244;394889;358997;69;753886
76;2020-10-16;84;72;156;308664;263806;79;572470
76;2020-10-16;54;42;96;195838;129272;89;325110
76;2020-10-16;33;10;43;69372;26728;90;96100
76;2020-10-16;1441;1228;2678;3065778;2859080;0;5924858
84;2020-10-16;61;65;127;459549;481088;09;940637
84;2020-10-16;432;468;904;487711;511905;19;999616
84;2020-10-16;708;600;1308;443824;451094;29;894918
84;2020-10-16;643;535;1179;512522;493262;39;1005784
84;2020-10-16;591;524;1117;520248;515106;49;1035354
84;2020-10-16;510;464;974;529611;514848;59;1044459
84;2020-10-16;332;308;641;486720;439940;69;926660
84;2020-10-16;193;209;402;372151;315211;79;687362
84;2020-10-16;173;114;287;237198;150524;89;387722
84;2020-10-16;103;42;145;81185;28680;90;109865
84;2020-10-16;3746;3330;7085;4130719;3901658;0;8032377
93;2020-10-16;27;27;54;268834;283093;09;551927
93;2020-10-16;140;152;294;280751;296087;19;576838
93;2020-10-16;217;156;373;254404;255552;29;509956
93;2020-10-16;220;163;383;310704;288398;39;599102
93;2020-10-16;215;185;400;325559;305827;49;631386
93;2020-10-16;232;179;411;353104;325389;59;678493
93;2020-10-16;152;132;284;336327;296459;69;632786
93;2020-10-16;97;82;179;279820;229699;79;509519
93;2020-10-16;75;42;117;171274;113716;89;284990
93;2020-10-16;60;16;76;58896;21758;90;80654
93;2020-10-16;1437;1136;2575;2639673;2415978;0;5055651
94;2020-10-16;0;1;1;16311;17433;09;33744
94;2020-10-16;3;9;12;16679;18132;19;34811
94;2020-10-16;13;13;26;16782;16579;29;33361
94;2020-10-16;12;6;18;23044;20580;39;43624
94;2020-10-16;9;12;21;23065;22140;49;45205
94;2020-10-16;6;7;13;24549;23421;59;47970
94;2020-10-16;5;8;13;23212;21883;69;45095
94;2020-10-16;4;4;8;19544;17141;79;36685
94;2020-10-16;5;2;7;11227;8178;89;19405
94;2020-10-16;2;0;2;3332;1447;90;4779
94;2020-10-16;59;62;121;177745;166934;0;344679
01;2020-10-17;0;0;0;19979;20155;09;40134
01;2020-10-17;0;1;1;24994;25489;19;50483
01;2020-10-17;1;1;2;17868;16690;29;34558
01;2020-10-17;1;1;2;22328;14821;39;37149
01;2020-10-17;0;1;1;28652;20276;49;48928
01;2020-10-17;1;0;1;33264;27260;59;60524
01;2020-10-17;1;2;3;27135;23978;69;51113
01;2020-10-17;0;3;3;18401;14661;79;33062
01;2020-10-17;0;1;1;9633;6375;89;16008
01;2020-10-17;0;0;0;3410;1510;90;4920
01;2020-10-17;5;10;15;205664;171215;0;376879
02;2020-10-17;1;0;1;16881;17110;09;33991
02;2020-10-17;4;1;5;21410;21604;19;43014
02;2020-10-17;3;2;5;16017;15479;29;31496
02;2020-10-17;0;2;2;19825;14455;39;34280
02;2020-10-17;1;2;3;24719;18248;49;42967
02;2020-10-17;2;2;4;34361;28310;59;62671
02;2020-10-17;0;3;3;28061;24495;69;52556
02;2020-10-17;0;0;0;18231;15278;79;33509
02;2020-10-17;0;0;0;11090;7677;89;18767
02;2020-10-17;0;0;0;3992;1506;90;5498
02;2020-10-17;11;12;23;194587;164162;0;358749
03;2020-10-17;0;1;1;31123;30920;09;62043
03;2020-10-17;1;0;1;29370;29268;19;58638
03;2020-10-17;0;1;1;21458;18963;29;40421
03;2020-10-17;2;2;4;21276;18326;39;39602
03;2020-10-17;0;2;2;18164;16593;49;34757
03;2020-10-17;1;1;2;13469;13557;59;27026
03;2020-10-17;0;1;1;8776;8670;69;17446
03;2020-10-17;0;0;0;3777;3591;79;7368
03;2020-10-17;0;0;0;1649;1072;89;2721
03;2020-10-17;0;0;0;485;184;90;669
03;2020-10-17;4;8;12;149547;141144;0;290691
04;2020-10-17;0;0;0;60314;61377;09;121691
04;2020-10-17;7;3;10;66065;68387;19;134452
04;2020-10-17;5;3;8;51059;47156;29;98215
04;2020-10-17;3;1;4;58788;45780;39;104568
04;2020-10-17;4;4;8;61408;52207;49;113615
04;2020-10-17;1;2;3;64838;60759;59;125597
04;2020-10-17;1;0;1;47008;42843;69;89851
04;2020-10-17;1;0;1;25509;21184;79;46693
04;2020-10-17;0;0;0;13168;7647;89;20815
04;2020-10-17;0;0;0;3209;1253;90;4462
04;2020-10-17;22;13;35;451366;408593;0;859959
05;2020-10-17;0;0;0;362.366008612902;341.338819562748;09;703.704828175651
05;2020-10-17;0;0;0;353.376145114279;370.349735405642;19;723.725880519921
05;2020-10-17;0;0;0;218.593559489256;256.539602589476;29;475.133162078732
05;2020-10-17;0;0;0;404.225408693299;360.321910454353;39;764.547319147651
05;2020-10-17;0;0;0;520.067953604221;497.108383964256;49;1017.17633756848
05;2020-10-17;0;0;0;468.146063921917;510.087601910415;59;978.233665832332
05;2020-10-17;0;0;0;340.368470050554;334.366842191253;69;674.735312241807
05;2020-10-17;0;0;0;212.598666888387;192.597753227106;79;405.196420115493
05;2020-10-17;0;0;0;148.727797095705;61.8681715431829;89;210.595968638888
05;2020-10-17;0;0;0;32.9601271090696;10.9909785719784;90;43.9511056810479
05;2020-10-17;0;0;0;3061.43020057959;2935.56979942041;0;5997
06;2020-10-17;0;0;0;42583;42380;09;84963
06;2020-10-17;0;0;0;33369;31925;19;65294
06;2020-10-17;2;0;2;21571;15080;29;36651
06;2020-10-17;0;0;0;21550;16147;39;37697
06;2020-10-17;1;1;2;14193;13939;49;28132
06;2020-10-17;0;0;0;7171;7597;59;14768
06;2020-10-17;0;0;0;3629;4117;69;7746
06;2020-10-17;0;0;0;1577;1457;79;3034
06;2020-10-17;0;0;0;531;474;89;1005
06;2020-10-17;0;0;0;88;93;90;181
06;2020-10-17;3;1;4;146262;133209;0;279471
07;2020-10-17;0;0;0;485;549;09;1034
07;2020-10-17;0;0;0;403;432;19;835
07;2020-10-17;0;0;0;764;841;29;1605
07;2020-10-17;0;0;0;824;928;39;1752
07;2020-10-17;0;0;0;788;1020;49;1808
07;2020-10-17;0;0;0;678;870;59;1548
07;2020-10-17;0;0;0;360;382;69;742
07;2020-10-17;0;0;0;231;190;79;421
07;2020-10-17;0;0;0;114;67;89;181
07;2020-10-17;0;0;0;24;11;90;35
07;2020-10-17;0;0;0;4671;5290;0;9961
08;2020-10-17;0;0;0;2715.22592983026;2997.75551488675;09;5712.98144471701
08;2020-10-17;0;0;0;2778.51901080978;3160.9156459093;19;5939.43465671908
08;2020-10-17;0;0;0;2080.8882988764;1718.16634315323;29;3799.05464202964
08;2020-10-17;1;0;1;2701.8582062647;1896.52641413317;39;4598.38462039786
08;2020-10-17;0;0;0;3151.45861023308;2460.52498233809;49;5611.98359257117
08;2020-10-17;0;0;0;2620.29868333099;2422.23566154656;59;5042.53434487755
08;2020-10-17;0;0;0;1621.44173420671;1438.58325779464;69;3060.02499200135
08;2020-10-17;0;0;0;626.575909335673;526.358467843651;79;1152.93437717932
08;2020-10-17;0;0;0;205.018522985054;140.993639349697;89;346.012162334751
08;2020-10-17;0;0;0;50.0325684687745;20.62259870351;90;70.6551671722846
08;2020-10-17;1;0;1;18551.3174743414;16782.6825256586;0;35334
11;2020-10-17;36;38;82;783071;811785;09;1594856
11;2020-10-17;223;184;434;761456;784653;19;1546109
11;2020-10-17;473;327;801;850145;801772;29;1651917
11;2020-10-17;373;335;711;914360;843488;39;1757848
11;2020-10-17;316;285;602;845609;826202;49;1671811
11;2020-10-17;258;244;502;793566;745070;59;1538636
11;2020-10-17;176;192;378;628649;549192;69;1177841
11;2020-10-17;68;76;144;434606;358356;79;792962
11;2020-10-17;52;40;92;261425;162933;89;424358
11;2020-10-17;24;8;32;89253;32619;90;121872
11;2020-10-17;2001;1729;3780;6362140;5916070;0;12278210
24;2020-10-17;2;5;7;139720;144686;09;284406
24;2020-10-17;23;22;45;152979;161185;19;314164
24;2020-10-17;42;31;73;122237;126536;29;248773
24;2020-10-17;46;37;83;150359;142009;39;292368
24;2020-10-17;36;25;61;161829;158758;49;320587
24;2020-10-17;37;29;66;172552;168011;59;340563
24;2020-10-17;22;29;51;172509;158177;69;330686
24;2020-10-17;15;21;36;129428;110593;79;240021
24;2020-10-17;20;11;31;87342;56882;89;144224
24;2020-10-17;14;5;19;31210;12071;90;43281
24;2020-10-17;257;215;472;1320165;1238908;0;2559073
27;2020-10-17;8;7;15;143373;149679;09;293052
27;2020-10-17;39;46;85;160962;173003;19;333965
27;2020-10-17;66;47;113;133746;142254;29;276000
27;2020-10-17;57;52;109;160004;155407;39;315411
27;2020-10-17;56;60;116;172333;169564;49;341897
27;2020-10-17;65;44;109;189979;183788;59;373767
27;2020-10-17;40;37;77;192591;178206;69;370797
27;2020-10-17;23;16;39;146876;127546;79;274422
27;2020-10-17;15;9;24;96896;61575;89;158471
27;2020-10-17;8;3;11;33148;12109;90;45257
27;2020-10-17;377;321;698;1429908;1353131;0;2783039
28;2020-10-17;4;5;9;180735;186856;09;367591
28;2020-10-17;33;23;56;200125;213621;19;413746
28;2020-10-17;46;56;102;168922;173007;29;341929
28;2020-10-17;54;34;88;196628;188487;39;385115
28;2020-10-17;46;25;71;205396;201699;49;407095
28;2020-10-17;52;46;98;222002;213866;59;435868
28;2020-10-17;20;34;55;224688;203758;69;428446
28;2020-10-17;14;19;33;163192;135543;79;298735
28;2020-10-17;14;9;23;109691;65377;89;175068
28;2020-10-17;5;1;6;37222;12685;90;49907
28;2020-10-17;288;252;541;1708601;1594899;0;3303500
32;2020-10-17;36;36;72;358062;373689;09;731751
32;2020-10-17;153;123;276;387045;406742;19;793787
32;2020-10-17;198;185;383;342304;348587;29;690891
32;2020-10-17;168;140;308;382485;369972;39;752457
32;2020-10-17;162;163;325;382510;376716;49;759226
32;2020-10-17;161;116;277;386937;376527;59;763464
32;2020-10-17;93;86;179;371211;330938;69;702149
32;2020-10-17;62;50;112;250542;201459;79;452001
32;2020-10-17;44;30;74;163399;89786;89;253185
32;2020-10-17;18;6;24;48384;15367;90;63751
32;2020-10-17;1095;935;2030;3072879;2889783;0;5962662
44;2020-10-17;8;11;19;291525;306839;09;598364
44;2020-10-17;40;56;96;320255;339504;19;659759
44;2020-10-17;70;80;150;302020;314428;29;616448
44;2020-10-17;68;71;139;342222;333292;39;675514
44;2020-10-17;71;74;145;349727;344491;49;694218
44;2020-10-17;80;73;153;381371;373239;59;754610
44;2020-10-17;51;55;106;367165;335850;69;703015
44;2020-10-17;25;28;53;250387;215436;79;465823
44;2020-10-17;22;12;34;170825;105192;89;276017
44;2020-10-17;12;2;14;51248;16731;90;67979
44;2020-10-17;447;462;909;2826745;2685002;0;5511747
52;2020-10-17;8;7;16;213594;223900;09;437494
52;2020-10-17;30;39;70;240818;255197;19;496015
52;2020-10-17;62;72;134;197010;200630;29;397640
52;2020-10-17;39;41;80;231204;224885;39;456089
52;2020-10-17;56;39;95;243874;243418;49;487292
52;2020-10-17;45;47;92;244100;239116;59;483216
52;2020-10-17;31;44;75;241796;221345;69;463141
52;2020-10-17;27;23;50;177805;149903;79;327708
52;2020-10-17;7;6;13;119561;75822;89;195383
52;2020-10-17;3;1;4;42559;15260;90;57819
52;2020-10-17;308;319;629;1952321;1849476;0;3801797
53;2020-10-17;7;4;11;173813;182358;09;356171
53;2020-10-17;15;23;38;202720;214740;19;417460
53;2020-10-17;48;36;84;163116;173196;29;336312
53;2020-10-17;43;34;77;190526;187674;39;378200
53;2020-10-17;37;24;61;212098;212015;49;424113
53;2020-10-17;23;31;54;223699;219176;59;442875
53;2020-10-17;21;27;48;227435;209274;69;436709
53;2020-10-17;14;18;32;169992;140910;79;310902
53;2020-10-17;9;6;15;118117;69883;89;188000
53;2020-10-17;4;0;4;37370;12267;90;49637
53;2020-10-17;221;203;424;1718886;1621493;0;3340379
75;2020-10-17;9;12;21;293104;305291;09;598395
75;2020-10-17;51;33;84;337141;357785;19;694926
75;2020-10-17;65;77;143;295024;300618;29;595642
75;2020-10-17;65;51;116;347871;331233;39;679104
75;2020-10-17;45;48;93;384742;372771;49;757513
75;2020-10-17;48;50;98;413361;390880;59;804241
75;2020-10-17;36;30;66;425623;384060;69;809683
75;2020-10-17;18;18;36;325086;276298;79;601384
75;2020-10-17;21;10;31;213986;139308;89;353294
75;2020-10-17;8;4;12;77600;28200;90;105800
75;2020-10-17;366;333;700;3113538;2886444;0;5999982
76;2020-10-17;15;8;24;305956;318589;09;624545
76;2020-10-17;88;59;149;338942;356969;19;695911
76;2020-10-17;114;92;206;316210;319570;29;635780
76;2020-10-17;85;90;175;356758;337587;39;694345
76;2020-10-17;97;86;183;376541;363812;49;740353
76;2020-10-17;99;90;190;402608;383750;59;786358
76;2020-10-17;38;48;86;394889;358997;69;753886
76;2020-10-17;34;38;72;308664;263806;79;572470
76;2020-10-17;52;32;84;195838;129272;89;325110
76;2020-10-17;34;7;41;69372;26728;90;96100
76;2020-10-17;658;553;1215;3065778;2859080;0;5924858
84;2020-10-17;33;37;71;459549;481088;09;940637
84;2020-10-17;166;165;346;487711;511905;19;999616
84;2020-10-17;228;205;433;443824;451094;29;894918
84;2020-10-17;214;219;433;512522;493262;39;1005784
84;2020-10-17;238;199;437;520248;515106;49;1035354
84;2020-10-17;190;196;386;529611;514848;59;1044459
84;2020-10-17;118;155;273;486720;439940;69;926660
84;2020-10-17;90;90;181;372151;315211;79;687362
84;2020-10-17;67;57;124;237198;150524;89;387722
84;2020-10-17;29;21;50;81185;28680;90;109865
84;2020-10-17;1373;1346;2736;4130719;3901658;0;8032377
93;2020-10-17;8;10;18;268834;283093;09;551927
93;2020-10-17;36;44;80;280751;296087;19;576838
93;2020-10-17;51;60;112;254404;255552;29;509956
93;2020-10-17;76;58;134;310704;288398;39;599102
93;2020-10-17;81;56;137;325559;305827;49;631386
93;2020-10-17;63;62;125;353104;325389;59;678493
93;2020-10-17;58;40;98;336327;296459;69;632786
93;2020-10-17;27;31;58;279820;229699;79;509519
93;2020-10-17;36;18;54;171274;113716;89;284990
93;2020-10-17;29;6;35;58896;21758;90;80654
93;2020-10-17;465;385;851;2639673;2415978;0;5055651
94;2020-10-17;0;0;0;16311;17433;09;33744
94;2020-10-17;0;3;3;16679;18132;19;34811
94;2020-10-17;3;4;7;16782;16579;29;33361
94;2020-10-17;1;4;5;23044;20580;39;43624
94;2020-10-17;4;3;7;23065;22140;49;45205
94;2020-10-17;3;3;6;24549;23421;59;47970
94;2020-10-17;2;3;5;23212;21883;69;45095
94;2020-10-17;1;1;2;19544;17141;79;36685
94;2020-10-17;3;1;4;11227;8178;89;19405
94;2020-10-17;1;0;1;3332;1447;90;4779
94;2020-10-17;18;22;40;177745;166934;0;344679
01;2020-10-18;0;0;0;19979;20155;09;40134
01;2020-10-18;0;1;1;24994;25489;19;50483
01;2020-10-18;0;2;2;17868;16690;29;34558
01;2020-10-18;2;1;3;22328;14821;39;37149
01;2020-10-18;1;1;2;28652;20276;49;48928
01;2020-10-18;0;0;0;33264;27260;59;60524
01;2020-10-18;0;2;2;27135;23978;69;51113
01;2020-10-18;0;0;0;18401;14661;79;33062
01;2020-10-18;0;0;0;9633;6375;89;16008
01;2020-10-18;0;0;0;3410;1510;90;4920
01;2020-10-18;3;7;10;205664;171215;0;376879
02;2020-10-18;0;0;0;16881;17110;09;33991
02;2020-10-18;0;0;0;21410;21604;19;43014
02;2020-10-18;0;1;1;16017;15479;29;31496
02;2020-10-18;0;1;1;19825;14455;39;34280
02;2020-10-18;0;0;0;24719;18248;49;42967
02;2020-10-18;0;0;0;34361;28310;59;62671
02;2020-10-18;1;2;3;28061;24495;69;52556
02;2020-10-18;1;0;1;18231;15278;79;33509
02;2020-10-18;0;0;0;11090;7677;89;18767
02;2020-10-18;0;0;0;3992;1506;90;5498
02;2020-10-18;2;4;6;194587;164162;0;358749
03;2020-10-18;0;1;1;31123;30920;09;62043
03;2020-10-18;0;1;1;29370;29268;19;58638
03;2020-10-18;2;0;2;21458;18963;29;40421
03;2020-10-18;2;5;7;21276;18326;39;39602
03;2020-10-18;0;1;1;18164;16593;49;34757
03;2020-10-18;0;0;0;13469;13557;59;27026
03;2020-10-18;0;0;0;8776;8670;69;17446
03;2020-10-18;0;0;0;3777;3591;79;7368
03;2020-10-18;0;0;0;1649;1072;89;2721
03;2020-10-18;0;0;0;485;184;90;669
03;2020-10-18;4;8;12;149547;141144;0;290691
04;2020-10-18;0;0;0;60314;61377;09;121691
04;2020-10-18;1;1;2;66065;68387;19;134452
04;2020-10-18;1;1;2;51059;47156;29;98215
04;2020-10-18;1;0;1;58788;45780;39;104568
04;2020-10-18;3;1;4;61408;52207;49;113615
04;2020-10-18;1;1;2;64838;60759;59;125597
04;2020-10-18;3;1;4;47008;42843;69;89851
04;2020-10-18;1;2;3;25509;21184;79;46693
04;2020-10-18;1;1;2;13168;7647;89;20815
04;2020-10-18;1;0;1;3209;1253;90;4462
04;2020-10-18;13;8;21;451366;408593;0;859959
05;2020-10-18;0;0;0;362.366008612902;341.338819562748;09;703.704828175651
05;2020-10-18;0;0;0;353.376145114279;370.349735405642;19;723.725880519921
05;2020-10-18;0;0;0;218.593559489256;256.539602589476;29;475.133162078732
05;2020-10-18;0;0;0;404.225408693299;360.321910454353;39;764.547319147651
05;2020-10-18;0;0;0;520.067953604221;497.108383964256;49;1017.17633756848
05;2020-10-18;0;0;0;468.146063921917;510.087601910415;59;978.233665832332
05;2020-10-18;0;0;0;340.368470050554;334.366842191253;69;674.735312241807
05;2020-10-18;0;0;0;212.598666888387;192.597753227106;79;405.196420115493
05;2020-10-18;0;0;0;148.727797095705;61.8681715431829;89;210.595968638888
05;2020-10-18;0;0;0;32.9601271090696;10.9909785719784;90;43.9511056810479
05;2020-10-18;0;0;0;3061.43020057959;2935.56979942041;0;5997
06;2020-10-18;0;0;0;42583;42380;09;84963
06;2020-10-18;0;0;0;33369;31925;19;65294
06;2020-10-18;1;0;1;21571;15080;29;36651
06;2020-10-18;1;1;2;21550;16147;39;37697
06;2020-10-18;0;0;0;14193;13939;49;28132
06;2020-10-18;1;0;1;7171;7597;59;14768
06;2020-10-18;0;0;0;3629;4117;69;7746
06;2020-10-18;0;1;1;1577;1457;79;3034
06;2020-10-18;0;0;0;531;474;89;1005
06;2020-10-18;0;0;0;88;93;90;181
06;2020-10-18;3;2;5;146262;133209;0;279471
07;2020-10-18;0;0;0;485;549;09;1034
07;2020-10-18;0;0;0;403;432;19;835
07;2020-10-18;0;0;0;764;841;29;1605
07;2020-10-18;0;0;0;824;928;39;1752
07;2020-10-18;0;0;0;788;1020;49;1808
07;2020-10-18;0;0;0;678;870;59;1548
07;2020-10-18;0;0;0;360;382;69;742
07;2020-10-18;0;0;0;231;190;79;421
07;2020-10-18;0;0;0;114;67;89;181
07;2020-10-18;0;0;0;24;11;90;35
07;2020-10-18;0;0;0;4671;5290;0;9961
08;2020-10-18;0;0;0;2715.22592983026;2997.75551488675;09;5712.98144471701
08;2020-10-18;0;0;0;2778.51901080978;3160.9156459093;19;5939.43465671908
08;2020-10-18;0;0;0;2080.8882988764;1718.16634315323;29;3799.05464202964
08;2020-10-18;0;0;0;2701.8582062647;1896.52641413317;39;4598.38462039786
08;2020-10-18;0;0;0;3151.45861023308;2460.52498233809;49;5611.98359257117
08;2020-10-18;0;0;0;2620.29868333099;2422.23566154656;59;5042.53434487755
08;2020-10-18;0;0;0;1621.44173420671;1438.58325779464;69;3060.02499200135
08;2020-10-18;0;0;0;626.575909335673;526.358467843651;79;1152.93437717932
08;2020-10-18;0;0;0;205.018522985054;140.993639349697;89;346.012162334751
08;2020-10-18;0;0;0;50.0325684687745;20.62259870351;90;70.6551671722846
08;2020-10-18;0;0;0;18551.3174743414;16782.6825256586;0;35334
11;2020-10-18;10;17;29;783071;811785;09;1594856
11;2020-10-18;31;38;71;761456;784653;19;1546109
11;2020-10-18;94;80;174;850145;801772;29;1651917
11;2020-10-18;85;97;182;914360;843488;39;1757848
11;2020-10-18;68;81;150;845609;826202;49;1671811
11;2020-10-18;66;65;131;793566;745070;59;1538636
11;2020-10-18;51;43;95;628649;549192;69;1177841
11;2020-10-18;21;32;53;434606;358356;79;792962
11;2020-10-18;26;32;58;261425;162933;89;424358
11;2020-10-18;29;7;36;89253;32619;90;121872
11;2020-10-18;481;493;980;6362140;5916070;0;12278210
24;2020-10-18;1;1;2;139720;144686;09;284406
24;2020-10-18;17;6;23;152979;161185;19;314164
24;2020-10-18;28;23;51;122237;126536;29;248773
24;2020-10-18;23;16;39;150359;142009;39;292368
24;2020-10-18;24;15;39;161829;158758;49;320587
24;2020-10-18;13;17;30;172552;168011;59;340563
24;2020-10-18;8;10;18;172509;158177;69;330686
24;2020-10-18;2;3;5;129428;110593;79;240021
24;2020-10-18;12;4;16;87342;56882;89;144224
24;2020-10-18;3;1;4;31210;12071;90;43281
24;2020-10-18;131;96;227;1320165;1238908;0;2559073
27;2020-10-18;2;1;3;143373;149679;09;293052
27;2020-10-18;8;5;13;160962;173003;19;333965
27;2020-10-18;15;15;30;133746;142254;29;276000
27;2020-10-18;9;4;13;160004;155407;39;315411
27;2020-10-18;7;12;19;172333;169564;49;341897
27;2020-10-18;8;4;12;189979;183788;59;373767
27;2020-10-18;5;12;17;192591;178206;69;370797
27;2020-10-18;5;4;9;146876;127546;79;274422
27;2020-10-18;4;2;6;96896;61575;89;158471
27;2020-10-18;3;2;5;33148;12109;90;45257
27;2020-10-18;66;61;127;1429908;1353131;0;2783039
28;2020-10-18;2;5;7;180735;186856;09;367591
28;2020-10-18;12;12;24;200125;213621;19;413746
28;2020-10-18;29;21;50;168922;173007;29;341929
28;2020-10-18;14;12;26;196628;188487;39;385115
28;2020-10-18;19;20;39;205396;201699;49;407095
28;2020-10-18;24;15;39;222002;213866;59;435868
28;2020-10-18;13;11;24;224688;203758;69;428446
28;2020-10-18;5;8;13;163192;135543;79;298735
28;2020-10-18;16;9;25;109691;65377;89;175068
28;2020-10-18;10;2;12;37222;12685;90;49907
28;2020-10-18;144;115;259;1708601;1594899;0;3303500
32;2020-10-18;21;19;40;358062;373689;09;731751
32;2020-10-18;65;71;136;387045;406742;19;793787
32;2020-10-18;129;85;214;342304;348587;29;690891
32;2020-10-18;114;89;203;382485;369972;39;752457
32;2020-10-18;72;80;152;382510;376716;49;759226
32;2020-10-18;68;60;128;386937;376527;59;763464
32;2020-10-18;36;33;69;371211;330938;69;702149
32;2020-10-18;17;22;39;250542;201459;79;452001
32;2020-10-18;21;12;33;163399;89786;89;253185
32;2020-10-18;8;5;13;48384;15367;90;63751
32;2020-10-18;551;476;1027;3072879;2889783;0;5962662
44;2020-10-18;1;2;3;291525;306839;09;598364
44;2020-10-18;7;4;11;320255;339504;19;659759
44;2020-10-18;7;7;14;302020;314428;29;616448
44;2020-10-18;12;11;23;342222;333292;39;675514
44;2020-10-18;11;8;19;349727;344491;49;694218
44;2020-10-18;7;5;12;381371;373239;59;754610
44;2020-10-18;3;5;8;367165;335850;69;703015
44;2020-10-18;9;15;24;250387;215436;79;465823
44;2020-10-18;11;6;17;170825;105192;89;276017
44;2020-10-18;4;3;7;51248;16731;90;67979
44;2020-10-18;72;66;138;2826745;2685002;0;5511747
52;2020-10-18;1;4;5;213594;223900;09;437494
52;2020-10-18;9;10;19;240818;255197;19;496015
52;2020-10-18;12;12;24;197010;200630;29;397640
52;2020-10-18;7;14;21;231204;224885;39;456089
52;2020-10-18;10;13;23;243874;243418;49;487292
52;2020-10-18;5;12;17;244100;239116;59;483216
52;2020-10-18;4;2;6;241796;221345;69;463141
52;2020-10-18;2;6;8;177805;149903;79;327708
52;2020-10-18;4;5;9;119561;75822;89;195383
52;2020-10-18;2;1;3;42559;15260;90;57819
52;2020-10-18;56;79;135;1952321;1849476;0;3801797
53;2020-10-18;4;2;6;173813;182358;09;356171
53;2020-10-18;12;3;15;202720;214740;19;417460
53;2020-10-18;19;12;31;163116;173196;29;336312
53;2020-10-18;8;13;21;190526;187674;39;378200
53;2020-10-18;5;11;16;212098;212015;49;424113
53;2020-10-18;11;9;20;223699;219176;59;442875
53;2020-10-18;5;8;13;227435;209274;69;436709
53;2020-10-18;5;4;9;169992;140910;79;310902
53;2020-10-18;2;1;3;118117;69883;89;188000
53;2020-10-18;0;0;0;37370;12267;90;49637
53;2020-10-18;71;63;134;1718886;1621493;0;3340379
75;2020-10-18;0;1;1;293104;305291;09;598395
75;2020-10-18;7;6;13;337141;357785;19;694926
75;2020-10-18;15;14;29;295024;300618;29;595642
75;2020-10-18;8;6;14;347871;331233;39;679104
75;2020-10-18;8;4;12;384742;372771;49;757513
75;2020-10-18;8;7;15;413361;390880;59;804241
75;2020-10-18;3;5;8;425623;384060;69;809683
75;2020-10-18;6;2;8;325086;276298;79;601384
75;2020-10-18;12;15;27;213986;139308;89;353294
75;2020-10-18;14;4;18;77600;28200;90;105800
75;2020-10-18;81;64;145;3113538;2886444;0;5999982
76;2020-10-18;9;8;17;305956;318589;09;624545
76;2020-10-18;24;21;45;338942;356969;19;695911
76;2020-10-18;60;40;100;316210;319570;29;635780
76;2020-10-18;36;22;58;356758;337587;39;694345
76;2020-10-18;28;32;60;376541;363812;49;740353
76;2020-10-18;24;30;54;402608;383750;59;786358
76;2020-10-18;19;22;41;394889;358997;69;753886
76;2020-10-18;8;13;21;308664;263806;79;572470
76;2020-10-18;8;10;18;195838;129272;89;325110
76;2020-10-18;6;3;9;69372;26728;90;96100
76;2020-10-18;222;201;423;3065778;2859080;0;5924858
84;2020-10-18;7;6;13;459549;481088;09;940637
84;2020-10-18;28;32;60;487711;511905;19;999616
84;2020-10-18;39;40;79;443824;451094;29;894918
84;2020-10-18;66;39;105;512522;493262;39;1005784
84;2020-10-18;56;36;92;520248;515106;49;1035354
84;2020-10-18;36;38;74;529611;514848;59;1044459
84;2020-10-18;26;37;63;486720;439940;69;926660
84;2020-10-18;32;38;70;372151;315211;79;687362
84;2020-10-18;52;45;97;237198;150524;89;387722
84;2020-10-18;36;15;51;81185;28680;90;109865
84;2020-10-18;378;326;704;4130719;3901658;0;8032377
93;2020-10-18;3;3;6;268834;283093;09;551927
93;2020-10-18;9;2;11;280751;296087;19;576838
93;2020-10-18;20;14;34;254404;255552;29;509956
93;2020-10-18;18;20;39;310704;288398;39;599102
93;2020-10-18;17;23;40;325559;305827;49;631386
93;2020-10-18;10;13;23;353104;325389;59;678493
93;2020-10-18;12;14;26;336327;296459;69;632786
93;2020-10-18;9;11;20;279820;229699;79;509519
93;2020-10-18;20;9;29;171274;113716;89;284990
93;2020-10-18;9;3;12;58896;21758;90;80654
93;2020-10-18;127;112;240;2639673;2415978;0;5055651
94;2020-10-18;0;0;0;16311;17433;09;33744
94;2020-10-18;0;0;0;16679;18132;19;34811
94;2020-10-18;1;0;1;16782;16579;29;33361
94;2020-10-18;1;2;3;23044;20580;39;43624
94;2020-10-18;0;0;0;23065;22140;49;45205
94;2020-10-18;2;2;4;24549;23421;59;47970
94;2020-10-18;0;0;0;23212;21883;69;45095
94;2020-10-18;0;1;1;19544;17141;79;36685
94;2020-10-18;0;0;0;11227;8178;89;19405
94;2020-10-18;1;0;1;3332;1447;90;4779
94;2020-10-18;5;5;10;177745;166934;0;344679
01;2020-10-19;0;0;0;19979;20155;09;40134
01;2020-10-19;7;5;12;24994;25489;19;50483
01;2020-10-19;4;3;7;17868;16690;29;34558
01;2020-10-19;8;4;12;22328;14821;39;37149
01;2020-10-19;9;7;16;28652;20276;49;48928
01;2020-10-19;4;5;9;33264;27260;59;60524
01;2020-10-19;9;3;12;27135;23978;69;51113
01;2020-10-19;2;1;3;18401;14661;79;33062
01;2020-10-19;0;0;0;9633;6375;89;16008
01;2020-10-19;1;0;1;3410;1510;90;4920
01;2020-10-19;44;28;72;205664;171215;0;376879
02;2020-10-19;3;2;5;16881;17110;09;33991
02;2020-10-19;12;11;23;21410;21604;19;43014
02;2020-10-19;5;15;20;16017;15479;29;31496
02;2020-10-19;12;2;14;19825;14455;39;34280
02;2020-10-19;21;12;34;24719;18248;49;42967
02;2020-10-19;14;18;32;34361;28310;59;62671
02;2020-10-19;6;6;12;28061;24495;69;52556
02;2020-10-19;3;0;3;18231;15278;79;33509
02;2020-10-19;1;1;2;11090;7677;89;18767
02;2020-10-19;2;0;2;3992;1506;90;5498
02;2020-10-19;79;67;147;194587;164162;0;358749
03;2020-10-19;1;0;1;31123;30920;09;62043
03;2020-10-19;1;1;2;29370;29268;19;58638
03;2020-10-19;7;0;7;21458;18963;29;40421
03;2020-10-19;3;5;8;21276;18326;39;39602
03;2020-10-19;2;0;2;18164;16593;49;34757
03;2020-10-19;1;0;1;13469;13557;59;27026
03;2020-10-19;1;2;3;8776;8670;69;17446
03;2020-10-19;0;0;0;3777;3591;79;7368
03;2020-10-19;0;0;0;1649;1072;89;2721
03;2020-10-19;0;0;0;485;184;90;669
03;2020-10-19;16;8;24;149547;141144;0;290691
04;2020-10-19;2;0;2;60314;61377;09;121691
04;2020-10-19;7;5;12;66065;68387;19;134452
04;2020-10-19;11;4;15;51059;47156;29;98215
04;2020-10-19;9;7;16;58788;45780;39;104568
04;2020-10-19;11;4;15;61408;52207;49;113615
04;2020-10-19;10;8;18;64838;60759;59;125597
04;2020-10-19;5;4;9;47008;42843;69;89851
04;2020-10-19;1;1;2;25509;21184;79;46693
04;2020-10-19;0;0;0;13168;7647;89;20815
04;2020-10-19;0;0;0;3209;1253;90;4462
04;2020-10-19;56;33;89;451366;408593;0;859959
05;2020-10-19;0;0;0;362.366008612902;341.338819562748;09;703.704828175651
05;2020-10-19;0;0;0;353.376145114279;370.349735405642;19;723.725880519921
05;2020-10-19;0;0;0;218.593559489256;256.539602589476;29;475.133162078732
05;2020-10-19;0;0;0;404.225408693299;360.321910454353;39;764.547319147651
05;2020-10-19;0;0;0;520.067953604221;497.108383964256;49;1017.17633756848
05;2020-10-19;0;0;0;468.146063921917;510.087601910415;59;978.233665832332
05;2020-10-19;0;0;0;340.368470050554;334.366842191253;69;674.735312241807
05;2020-10-19;0;0;0;212.598666888387;192.597753227106;79;405.196420115493
05;2020-10-19;0;0;0;148.727797095705;61.8681715431829;89;210.595968638888
05;2020-10-19;0;0;0;32.9601271090696;10.9909785719784;90;43.9511056810479
05;2020-10-19;0;0;0;3061.43020057959;2935.56979942041;0;5997
06;2020-10-19;0;0;0;42583;42380;09;84963
06;2020-10-19;2;1;3;33369;31925;19;65294
06;2020-10-19;9;2;11;21571;15080;29;36651
06;2020-10-19;4;4;8;21550;16147;39;37697
06;2020-10-19;3;6;9;14193;13939;49;28132
06;2020-10-19;3;2;5;7171;7597;59;14768
06;2020-10-19;0;0;0;3629;4117;69;7746
06;2020-10-19;0;1;1;1577;1457;79;3034
06;2020-10-19;1;0;1;531;474;89;1005
06;2020-10-19;0;0;0;88;93;90;181
06;2020-10-19;22;16;38;146262;133209;0;279471
07;2020-10-19;0;0;0;485;549;09;1034
07;2020-10-19;0;0;0;403;432;19;835
07;2020-10-19;1;1;2;764;841;29;1605
07;2020-10-19;0;1;1;824;928;39;1752
07;2020-10-19;0;0;0;788;1020;49;1808
07;2020-10-19;1;0;1;678;870;59;1548
07;2020-10-19;0;0;0;360;382;69;742
07;2020-10-19;0;0;0;231;190;79;421
07;2020-10-19;0;0;0;114;67;89;181
07;2020-10-19;0;0;0;24;11;90;35
07;2020-10-19;2;2;4;4671;5290;0;9961
08;2020-10-19;0;0;0;2715.22592983026;2997.75551488675;09;5712.98144471701
08;2020-10-19;0;0;0;2778.51901080978;3160.9156459093;19;5939.43465671908
08;2020-10-19;1;1;2;2080.8882988764;1718.16634315323;29;3799.05464202964
08;2020-10-19;0;0;0;2701.8582062647;1896.52641413317;39;4598.38462039786
08;2020-10-19;0;0;0;3151.45861023308;2460.52498233809;49;5611.98359257117
08;2020-10-19;0;2;2;2620.29868333099;2422.23566154656;59;5042.53434487755
08;2020-10-19;0;0;0;1621.44173420671;1438.58325779464;69;3060.02499200135
08;2020-10-19;0;0;0;626.575909335673;526.358467843651;79;1152.93437717932
08;2020-10-19;0;0;0;205.018522985054;140.993639349697;89;346.012162334751
08;2020-10-19;0;0;0;50.0325684687745;20.62259870351;90;70.6551671722846
08;2020-10-19;1;3;4;18551.3174743414;16782.6825256586;0;35334
11;2020-10-19;105;135;250;783071;811785;09;1594856
11;2020-10-19;552;536;1122;761456;784653;19;1546109
11;2020-10-19;1224;973;2205;850145;801772;29;1651917
11;2020-10-19;1075;1012;2089;914360;843488;39;1757848
11;2020-10-19;918;793;1713;845609;826202;49;1671811
11;2020-10-19;815;702;1522;793566;745070;59;1538636
11;2020-10-19;468;503;973;628649;549192;69;1177841
11;2020-10-19;203;226;429;434606;358356;79;792962
11;2020-10-19;132;99;231;261425;162933;89;424358
11;2020-10-19;80;31;112;89253;32619;90;121872
11;2020-10-19;5575;5012;10652;6362140;5916070;0;12278210
24;2020-10-19;9;5;14;139720;144686;09;284406
24;2020-10-19;58;45;104;152979;161185;19;314164
24;2020-10-19;89;73;162;122237;126536;29;248773
24;2020-10-19;95;66;161;150359;142009;39;292368
24;2020-10-19;85;68;153;161829;158758;49;320587
24;2020-10-19;98;72;170;172552;168011;59;340563
24;2020-10-19;58;57;115;172509;158177;69;330686
24;2020-10-19;42;33;75;129428;110593;79;240021
24;2020-10-19;30;16;46;87342;56882;89;144224
24;2020-10-19;24;9;33;31210;12071;90;43281
24;2020-10-19;588;444;1033;1320165;1238908;0;2559073
27;2020-10-19;22;18;40;143373;149679;09;293052
27;2020-10-19;102;83;185;160962;173003;19;333965
27;2020-10-19;124;95;220;133746;142254;29;276000
27;2020-10-19;127;96;223;160004;155407;39;315411
27;2020-10-19;123;105;228;172333;169564;49;341897
27;2020-10-19;122;110;232;189979;183788;59;373767
27;2020-10-19;115;101;216;192591;178206;69;370797
27;2020-10-19;59;71;130;146876;127546;79;274422
27;2020-10-19;43;33;76;96896;61575;89;158471
27;2020-10-19;20;7;27;33148;12109;90;45257
27;2020-10-19;857;719;1577;1429908;1353131;0;2783039
28;2020-10-19;20;23;43;180735;186856;09;367591
28;2020-10-19;89;73;165;200125;213621;19;413746
28;2020-10-19;140;111;252;168922;173007;29;341929
28;2020-10-19;153;90;243;196628;188487;39;385115
28;2020-10-19;131;109;240;205396;201699;49;407095
28;2020-10-19;115;82;197;222002;213866;59;435868
28;2020-10-19;94;79;173;224688;203758;69;428446
28;2020-10-19;54;53;107;163192;135543;79;298735
28;2020-10-19;56;24;80;109691;65377;89;175068
28;2020-10-19;40;12;52;37222;12685;90;49907
28;2020-10-19;892;656;1552;1708601;1594899;0;3303500
32;2020-10-19;66;65;132;358062;373689;09;731751
32;2020-10-19;277;262;539;387045;406742;19;793787
32;2020-10-19;414;394;810;342304;348587;29;690891
32;2020-10-19;422;391;813;382485;369972;39;752457
32;2020-10-19;443;390;833;382510;376716;49;759226
32;2020-10-19;349;318;667;386937;376527;59;763464
32;2020-10-19;237;207;444;371211;330938;69;702149
32;2020-10-19;151;120;272;250542;201459;79;452001
32;2020-10-19;131;74;205;163399;89786;89;253185
32;2020-10-19;79;12;91;48384;15367;90;63751
32;2020-10-19;2569;2233;4806;3072879;2889783;0;5962662
44;2020-10-19;25;27;52;291525;306839;09;598364
44;2020-10-19;145;144;290;320255;339504;19;659759
44;2020-10-19;347;288;635;302020;314428;29;616448
44;2020-10-19;260;226;486;342222;333292;39;675514
44;2020-10-19;207;201;408;349727;344491;49;694218
44;2020-10-19;225;224;449;381371;373239;59;754610
44;2020-10-19;149;164;313;367165;335850;69;703015
44;2020-10-19;99;96;195;250387;215436;79;465823
44;2020-10-19;53;45;98;170825;105192;89;276017
44;2020-10-19;50;14;64;51248;16731;90;67979
44;2020-10-19;1560;1429;2990;2826745;2685002;0;5511747
52;2020-10-19;15;11;27;213594;223900;09;437494
52;2020-10-19;91;102;196;240818;255197;19;496015
52;2020-10-19;164;150;314;197010;200630;29;397640
52;2020-10-19;102;121;223;231204;224885;39;456089
52;2020-10-19;116;130;246;243874;243418;49;487292
52;2020-10-19;121;122;243;244100;239116;59;483216
52;2020-10-19;68;100;168;241796;221345;69;463141
52;2020-10-19;48;43;91;177805;149903;79;327708
52;2020-10-19;38;19;57;119561;75822;89;195383
52;2020-10-19;41;19;60;42559;15260;90;57819
52;2020-10-19;804;817;1625;1952321;1849476;0;3801797
53;2020-10-19;16;9;27;173813;182358;09;356171
53;2020-10-19;47;80;130;202720;214740;19;417460
53;2020-10-19;94;82;178;163116;173196;29;336312
53;2020-10-19;79;48;127;190526;187674;39;378200
53;2020-10-19;74;81;155;212098;212015;49;424113
53;2020-10-19;83;59;142;223699;219176;59;442875
53;2020-10-19;54;41;95;227435;209274;69;436709
53;2020-10-19;47;27;74;169992;140910;79;310902
53;2020-10-19;22;15;37;118117;69883;89;188000
53;2020-10-19;4;8;12;37370;12267;90;49637
53;2020-10-19;520;450;977;1718886;1621493;0;3340379
75;2020-10-19;9;17;27;293104;305291;09;598395
75;2020-10-19;113;139;255;337141;357785;19;694926
75;2020-10-19;216;221;439;295024;300618;29;595642
75;2020-10-19;155;145;300;347871;331233;39;679104
75;2020-10-19;181;150;332;384742;372771;49;757513
75;2020-10-19;156;141;298;413361;390880;59;804241
75;2020-10-19;103;106;209;425623;384060;69;809683
75;2020-10-19;63;74;137;325086;276298;79;601384
75;2020-10-19;66;37;103;213986;139308;89;353294
75;2020-10-19;38;12;50;77600;28200;90;105800
75;2020-10-19;1100;1042;2150;3113538;2886444;0;5999982
76;2020-10-19;30;39;73;305956;318589;09;624545
76;2020-10-19;200;171;385;338942;356969;19;695911
76;2020-10-19;344;296;642;316210;319570;29;635780
76;2020-10-19;318;225;543;356758;337587;39;694345
76;2020-10-19;321;241;563;376541;363812;49;740353
76;2020-10-19;281;244;525;402608;383750;59;786358
76;2020-10-19;184;156;340;394889;358997;69;753886
76;2020-10-19;115;100;215;308664;263806;79;572470
76;2020-10-19;102;69;171;195838;129272;89;325110
76;2020-10-19;85;25;110;69372;26728;90;96100
76;2020-10-19;1982;1567;3570;3065778;2859080;0;5924858
84;2020-10-19;88;97;185;459549;481088;09;940637
84;2020-10-19;500;502;1011;487711;511905;19;999616
84;2020-10-19;899;711;1612;443824;451094;29;894918
84;2020-10-19;856;639;1498;512522;493262;39;1005784
84;2020-10-19;825;671;1497;520248;515106;49;1035354
84;2020-10-19;746;671;1417;529611;514848;59;1044459
84;2020-10-19;439;436;876;486720;439940;69;926660
84;2020-10-19;306;279;585;372151;315211;79;687362
84;2020-10-19;306;189;495;237198;150524;89;387722
84;2020-10-19;233;72;305;81185;28680;90;109865
84;2020-10-19;5198;4268;9482;4130719;3901658;0;8032377
93;2020-10-19;41;26;67;268834;283093;09;551927
93;2020-10-19;161;176;339;280751;296087;19;576838
93;2020-10-19;312;247;560;254404;255552;29;509956
93;2020-10-19;355;287;642;310704;288398;39;599102
93;2020-10-19;322;255;577;325559;305827;49;631386
93;2020-10-19;314;255;569;353104;325389;59;678493
93;2020-10-19;201;221;422;336327;296459;69;632786
93;2020-10-19;153;146;299;279820;229699;79;509519
93;2020-10-19;135;81;216;171274;113716;89;284990
93;2020-10-19;132;36;168;58896;21758;90;80654
93;2020-10-19;2126;1730;3859;2639673;2415978;0;5055651
94;2020-10-19;1;5;6;16311;17433;09;33744
94;2020-10-19;7;8;15;16679;18132;19;34811
94;2020-10-19;12;12;24;16782;16579;29;33361
94;2020-10-19;16;10;26;23044;20580;39;43624
94;2020-10-19;10;15;25;23065;22140;49;45205
94;2020-10-19;13;12;25;24549;23421;59;47970
94;2020-10-19;11;9;20;23212;21883;69;45095
94;2020-10-19;6;3;9;19544;17141;79;36685
94;2020-10-19;4;1;5;11227;8178;89;19405
94;2020-10-19;0;2;2;3332;1447;90;4779
94;2020-10-19;81;77;158;177745;166934;0;344679
01;2020-10-20;0;1;1;19979;20155;09;40134
01;2020-10-20;4;1;5;24994;25489;19;50483
01;2020-10-20;6;3;9;17868;16690;29;34558
01;2020-10-20;7;2;9;22328;14821;39;37149
01;2020-10-20;5;5;10;28652;20276;49;48928
01;2020-10-20;7;1;8;33264;27260;59;60524
01;2020-10-20;2;3;5;27135;23978;69;51113
01;2020-10-20;3;1;4;18401;14661;79;33062
01;2020-10-20;0;0;0;9633;6375;89;16008
01;2020-10-20;0;0;0;3410;1510;90;4920
01;2020-10-20;34;17;51;205664;171215;0;376879
02;2020-10-20;2;3;5;16881;17110;09;33991
02;2020-10-20;6;5;11;21410;21604;19;43014
02;2020-10-20;6;10;16;16017;15479;29;31496
02;2020-10-20;19;7;26;19825;14455;39;34280
02;2020-10-20;13;14;28;24719;18248;49;42967
02;2020-10-20;13;9;22;34361;28310;59;62671
02;2020-10-20;12;3;15;28061;24495;69;52556
02;2020-10-20;4;7;11;18231;15278;79;33509
02;2020-10-20;1;3;4;11090;7677;89;18767
02;2020-10-20;0;0;0;3992;1506;90;5498
02;2020-10-20;76;61;138;194587;164162;0;358749
03;2020-10-20;1;0;1;31123;30920;09;62043
03;2020-10-20;0;1;1;29370;29268;19;58638
03;2020-10-20;2;1;3;21458;18963;29;40421
03;2020-10-20;3;1;4;21276;18326;39;39602
03;2020-10-20;1;2;3;18164;16593;49;34757
03;2020-10-20;1;2;3;13469;13557;59;27026
03;2020-10-20;2;1;3;8776;8670;69;17446
03;2020-10-20;1;0;1;3777;3591;79;7368
03;2020-10-20;0;0;0;1649;1072;89;2721
03;2020-10-20;0;0;0;485;184;90;669
03;2020-10-20;11;8;19;149547;141144;0;290691
04;2020-10-20;0;2;2;60314;61377;09;121691
04;2020-10-20;3;3;6;66065;68387;19;134452
04;2020-10-20;9;7;16;51059;47156;29;98215
04;2020-10-20;1;1;2;58788;45780;39;104568
04;2020-10-20;11;5;16;61408;52207;49;113615
04;2020-10-20;8;4;12;64838;60759;59;125597
04;2020-10-20;3;3;6;47008;42843;69;89851
04;2020-10-20;3;3;6;25509;21184;79;46693
04;2020-10-20;1;1;2;13168;7647;89;20815
04;2020-10-20;0;0;0;3209;1253;90;4462
04;2020-10-20;39;29;68;451366;408593;0;859959
05;2020-10-20;0;0;0;362.366008612902;341.338819562748;09;703.704828175651
05;2020-10-20;0;0;0;353.376145114279;370.349735405642;19;723.725880519921
05;2020-10-20;0;0;0;218.593559489256;256.539602589476;29;475.133162078732
05;2020-10-20;0;0;0;404.225408693299;360.321910454353;39;764.547319147651
05;2020-10-20;0;0;0;520.067953604221;497.108383964256;49;1017.17633756848
05;2020-10-20;0;0;0;468.146063921917;510.087601910415;59;978.233665832332
05;2020-10-20;0;0;0;340.368470050554;334.366842191253;69;674.735312241807
05;2020-10-20;0;0;0;212.598666888387;192.597753227106;79;405.196420115493
05;2020-10-20;0;0;0;148.727797095705;61.8681715431829;89;210.595968638888
05;2020-10-20;0;0;0;32.9601271090696;10.9909785719784;90;43.9511056810479
05;2020-10-20;0;0;0;3061.43020057959;2935.56979942041;0;5997
06;2020-10-20;1;0;1;42583;42380;09;84963
06;2020-10-20;1;8;9;33369;31925;19;65294
06;2020-10-20;3;10;13;21571;15080;29;36651
06;2020-10-20;4;3;7;21550;16147;39;37697
06;2020-10-20;3;2;5;14193;13939;49;28132
06;2020-10-20;2;1;3;7171;7597;59;14768
06;2020-10-20;1;1;2;3629;4117;69;7746
06;2020-10-20;0;0;0;1577;1457;79;3034
06;2020-10-20;0;0;0;531;474;89;1005
06;2020-10-20;0;0;0;88;93;90;181
06;2020-10-20;15;25;40;146262;133209;0;279471
07;2020-10-20;0;0;0;485;549;09;1034
07;2020-10-20;0;0;0;403;432;19;835
07;2020-10-20;0;0;0;764;841;29;1605
07;2020-10-20;1;0;1;824;928;39;1752
07;2020-10-20;0;0;0;788;1020;49;1808
07;2020-10-20;0;0;0;678;870;59;1548
07;2020-10-20;0;0;0;360;382;69;742
07;2020-10-20;0;0;0;231;190;79;421
07;2020-10-20;0;0;0;114;67;89;181
07;2020-10-20;0;0;0;24;11;90;35
07;2020-10-20;1;0;1;4671;5290;0;9961
08;2020-10-20;0;0;0;2715.22592983026;2997.75551488675;09;5712.98144471701
08;2020-10-20;0;0;0;2778.51901080978;3160.9156459093;19;5939.43465671908
08;2020-10-20;0;0;0;2080.8882988764;1718.16634315323;29;3799.05464202964
08;2020-10-20;0;0;0;2701.8582062647;1896.52641413317;39;4598.38462039786
08;2020-10-20;1;0;1;3151.45861023308;2460.52498233809;49;5611.98359257117
08;2020-10-20;1;0;1;2620.29868333099;2422.23566154656;59;5042.53434487755
08;2020-10-20;0;0;0;1621.44173420671;1438.58325779464;69;3060.02499200135
08;2020-10-20;0;0;0;626.575909335673;526.358467843651;79;1152.93437717932
08;2020-10-20;0;0;0;205.018522985054;140.993639349697;89;346.012162334751
08;2020-10-20;0;0;0;50.0325684687745;20.62259870351;90;70.6551671722846
08;2020-10-20;2;0;2;18551.3174743414;16782.6825256586;0;35334
11;2020-10-20;97;96;209;783071;811785;09;1594856
11;2020-10-20;495;487;1015;761456;784653;19;1546109
11;2020-10-20;1234;1019;2262;850145;801772;29;1651917
11;2020-10-20;1100;928;2031;914360;843488;39;1757848
11;2020-10-20;916;867;1787;845609;826202;49;1671811
11;2020-10-20;819;747;1567;793566;745070;59;1538636
11;2020-10-20;464;453;924;628649;549192;69;1177841
11;2020-10-20;207;221;428;434606;358356;79;792962
11;2020-10-20;133;108;241;261425;162933;89;424358
11;2020-10-20;101;30;132;89253;32619;90;121872
11;2020-10-20;5569;4962;10609;6362140;5916070;0;12278210
24;2020-10-20;3;8;12;139720;144686;09;284406
24;2020-10-20;45;58;105;152979;161185;19;314164
24;2020-10-20;108;99;207;122237;126536;29;248773
24;2020-10-20;122;96;218;150359;142009;39;292368
24;2020-10-20;101;90;192;161829;158758;49;320587
24;2020-10-20;101;95;196;172552;168011;59;340563
24;2020-10-20;69;57;126;172509;158177;69;330686
24;2020-10-20;42;46;88;129428;110593;79;240021
24;2020-10-20;23;25;48;87342;56882;89;144224
24;2020-10-20;20;12;32;31210;12071;90;43281
24;2020-10-20;634;586;1224;1320165;1238908;0;2559073
27;2020-10-20;12;11;23;143373;149679;09;293052
27;2020-10-20;85;85;170;160962;173003;19;333965
27;2020-10-20;164;128;292;133746;142254;29;276000
27;2020-10-20;143;103;246;160004;155407;39;315411
27;2020-10-20;149;117;266;172333;169564;49;341897
27;2020-10-20;117;118;235;189979;183788;59;373767
27;2020-10-20;127;87;214;192591;178206;69;370797
27;2020-10-20;75;64;139;146876;127546;79;274422
27;2020-10-20;74;46;120;96896;61575;89;158471
27;2020-10-20;52;20;72;33148;12109;90;45257
27;2020-10-20;998;779;1777;1429908;1353131;0;2783039
28;2020-10-20;12;7;19;180735;186856;09;367591
28;2020-10-20;72;54;130;200125;213621;19;413746
28;2020-10-20;123;111;234;168922;173007;29;341929
28;2020-10-20;124;96;220;196628;188487;39;385115
28;2020-10-20;112;119;231;205396;201699;49;407095
28;2020-10-20;131;110;241;222002;213866;59;435868
28;2020-10-20;92;88;180;224688;203758;69;428446
28;2020-10-20;50;42;92;163192;135543;79;298735
28;2020-10-20;50;14;64;109691;65377;89;175068
28;2020-10-20;28;9;37;37222;12685;90;49907
28;2020-10-20;794;650;1448;1708601;1594899;0;3303500
32;2020-10-20;47;43;90;358062;373689;09;731751
32;2020-10-20;249;233;482;387045;406742;19;793787
32;2020-10-20;434;371;805;342304;348587;29;690891
32;2020-10-20;435;390;825;382485;369972;39;752457
32;2020-10-20;390;350;740;382510;376716;49;759226
32;2020-10-20;297;333;630;386937;376527;59;763464
32;2020-10-20;205;194;400;371211;330938;69;702149
32;2020-10-20;167;144;312;250542;201459;79;452001
32;2020-10-20;145;69;214;163399;89786;89;253185
32;2020-10-20;88;36;124;48384;15367;90;63751
32;2020-10-20;2459;2163;4624;3072879;2889783;0;5962662
44;2020-10-20;27;16;43;291525;306839;09;598364
44;2020-10-20;127;146;274;320255;339504;19;659759
44;2020-10-20;311;280;591;302020;314428;29;616448
44;2020-10-20;227;199;426;342222;333292;39;675514
44;2020-10-20;192;184;376;349727;344491;49;694218
44;2020-10-20;209;190;399;381371;373239;59;754610
44;2020-10-20;135;113;248;367165;335850;69;703015
44;2020-10-20;99;82;181;250387;215436;79;465823
44;2020-10-20;52;31;83;170825;105192;89;276017
44;2020-10-20;22;8;30;51248;16731;90;67979
44;2020-10-20;1401;1249;2651;2826745;2685002;0;5511747
52;2020-10-20;12;15;28;213594;223900;09;437494
52;2020-10-20;85;99;186;240818;255197;19;496015
52;2020-10-20;146;139;287;197010;200630;29;397640
52;2020-10-20;113;99;212;231204;224885;39;456089
52;2020-10-20;116;120;236;243874;243418;49;487292
52;2020-10-20;98;91;189;244100;239116;59;483216
52;2020-10-20;91;83;174;241796;221345;69;463141
52;2020-10-20;54;53;107;177805;149903;79;327708
52;2020-10-20;40;26;66;119561;75822;89;195383
52;2020-10-20;15;6;21;42559;15260;90;57819
52;2020-10-20;770;731;1506;1952321;1849476;0;3801797
53;2020-10-20;11;7;18;173813;182358;09;356171
53;2020-10-20;44;50;97;202720;214740;19;417460
53;2020-10-20;95;96;191;163116;173196;29;336312
53;2020-10-20;85;57;142;190526;187674;39;378200
53;2020-10-20;77;76;153;212098;212015;49;424113
53;2020-10-20;81;72;153;223699;219176;59;442875
53;2020-10-20;59;52;111;227435;209274;69;436709
53;2020-10-20;23;28;51;169992;140910;79;310902
53;2020-10-20;25;23;48;118117;69883;89;188000
53;2020-10-20;22;6;28;37370;12267;90;49637
53;2020-10-20;522;467;992;1718886;1621493;0;3340379
75;2020-10-20;11;17;28;293104;305291;09;598395
75;2020-10-20;83;98;183;337141;357785;19;694926
75;2020-10-20;196;192;389;295024;300618;29;595642
75;2020-10-20;165;129;295;347871;331233;39;679104
75;2020-10-20;152;139;292;384742;372771;49;757513
75;2020-10-20;165;139;304;413361;390880;59;804241
75;2020-10-20;88;80;168;425623;384060;69;809683
75;2020-10-20;65;56;121;325086;276298;79;601384
75;2020-10-20;78;28;106;213986;139308;89;353294
75;2020-10-20;61;7;68;77600;28200;90;105800
75;2020-10-20;1064;885;1954;3113538;2886444;0;5999982
76;2020-10-20;29;23;54;305956;318589;09;624545
76;2020-10-20;183;179;367;338942;356969;19;695911
76;2020-10-20;342;286;628;316210;319570;29;635780
76;2020-10-20;315;280;595;356758;337587;39;694345
76;2020-10-20;302;264;566;376541;363812;49;740353
76;2020-10-20;281;232;514;402608;383750;59;786358
76;2020-10-20;181;208;389;394889;358997;69;753886
76;2020-10-20;119;108;227;308664;263806;79;572470
76;2020-10-20;85;72;157;195838;129272;89;325110
76;2020-10-20;56;25;81;69372;26728;90;96100
76;2020-10-20;1897;1679;3584;3065778;2859080;0;5924858
84;2020-10-20;74;78;152;459549;481088;09;940637
84;2020-10-20;480;478;966;487711;511905;19;999616
84;2020-10-20;854;795;1651;443824;451094;29;894918
84;2020-10-20;884;693;1578;512522;493262;39;1005784
84;2020-10-20;840;715;1555;520248;515106;49;1035354
84;2020-10-20;780;702;1483;529611;514848;59;1044459
84;2020-10-20;489;403;893;486720;439940;69;926660
84;2020-10-20;302;293;595;372151;315211;79;687362
84;2020-10-20;299;156;455;237198;150524;89;387722
84;2020-10-20;202;68;270;81185;28680;90;109865
84;2020-10-20;5204;4382;9600;4130719;3901658;0;8032377
93;2020-10-20;31;33;64;268834;283093;09;551927
93;2020-10-20;127;131;258;280751;296087;19;576838
93;2020-10-20;319;224;545;254404;255552;29;509956
93;2020-10-20;292;238;531;310704;288398;39;599102
93;2020-10-20;311;246;558;325559;305827;49;631386
93;2020-10-20;299;253;554;353104;325389;59;678493
93;2020-10-20;218;192;410;336327;296459;69;632786
93;2020-10-20;126;128;254;279820;229699;79;509519
93;2020-10-20;145;72;217;171274;113716;89;284990
93;2020-10-20;104;29;133;58896;21758;90;80654
93;2020-10-20;1974;1547;3527;2639673;2415978;0;5055651
94;2020-10-20;2;1;4;16311;17433;09;33744
94;2020-10-20;3;6;10;16679;18132;19;34811
94;2020-10-20;25;13;38;16782;16579;29;33361
94;2020-10-20;12;17;29;23044;20580;39;43624
94;2020-10-20;11;19;30;23065;22140;49;45205
94;2020-10-20;12;9;21;24549;23421;59;47970
94;2020-10-20;8;11;19;23212;21883;69;45095
94;2020-10-20;5;7;12;19544;17141;79;36685
94;2020-10-20;5;6;11;11227;8178;89;19405
94;2020-10-20;1;0;1;3332;1447;90;4779
94;2020-10-20;84;89;175;177745;166934;0;344679
01;2020-10-21;0;0;0;19979;20155;09;40134
01;2020-10-21;4;0;4;24994;25489;19;50483
01;2020-10-21;2;5;7;17868;16690;29;34558
01;2020-10-21;5;3;8;22328;14821;39;37149
01;2020-10-21;2;7;9;28652;20276;49;48928
01;2020-10-21;2;4;6;33264;27260;59;60524
01;2020-10-21;3;3;6;27135;23978;69;51113
01;2020-10-21;3;2;5;18401;14661;79;33062
01;2020-10-21;1;1;2;9633;6375;89;16008
01;2020-10-21;0;0;0;3410;1510;90;4920
01;2020-10-21;22;25;47;205664;171215;0;376879
02;2020-10-21;4;2;6;16881;17110;09;33991
02;2020-10-21;6;11;17;21410;21604;19;43014
02;2020-10-21;9;15;24;16017;15479;29;31496
02;2020-10-21;12;8;20;19825;14455;39;34280
02;2020-10-21;14;7;21;24719;18248;49;42967
02;2020-10-21;21;11;33;34361;28310;59;62671
02;2020-10-21;7;6;13;28061;24495;69;52556
02;2020-10-21;3;6;9;18231;15278;79;33509
02;2020-10-21;0;0;0;11090;7677;89;18767
02;2020-10-21;0;0;0;3992;1506;90;5498
02;2020-10-21;76;66;143;194587;164162;0;358749
03;2020-10-21;0;0;0;31123;30920;09;62043
03;2020-10-21;1;1;2;29370;29268;19;58638
03;2020-10-21;5;3;8;21458;18963;29;40421
03;2020-10-21;4;3;7;21276;18326;39;39602
03;2020-10-21;6;4;10;18164;16593;49;34757
03;2020-10-21;0;0;0;13469;13557;59;27026
03;2020-10-21;0;2;2;8776;8670;69;17446
03;2020-10-21;0;0;0;3777;3591;79;7368
03;2020-10-21;0;0;0;1649;1072;89;2721
03;2020-10-21;0;0;0;485;184;90;669
03;2020-10-21;16;13;29;149547;141144;0;290691
04;2020-10-21;1;2;3;60314;61377;09;121691
04;2020-10-21;10;11;21;66065;68387;19;134452
04;2020-10-21;7;2;9;51059;47156;29;98215
04;2020-10-21;5;6;11;58788;45780;39;104568
04;2020-10-21;11;8;19;61408;52207;49;113615
04;2020-10-21;4;5;9;64838;60759;59;125597
04;2020-10-21;3;4;7;47008;42843;69;89851
04;2020-10-21;0;2;2;25509;21184;79;46693
04;2020-10-21;1;0;1;13168;7647;89;20815
04;2020-10-21;0;0;0;3209;1253;90;4462
04;2020-10-21;42;40;82;451366;408593;0;859959
05;2020-10-21;0;0;0;362.366008612902;341.338819562748;09;703.704828175651
05;2020-10-21;0;0;0;353.376145114279;370.349735405642;19;723.725880519921
05;2020-10-21;0;0;0;218.593559489256;256.539602589476;29;475.133162078732
05;2020-10-21;0;0;0;404.225408693299;360.321910454353;39;764.547319147651
05;2020-10-21;0;0;0;520.067953604221;497.108383964256;49;1017.17633756848
05;2020-10-21;0;0;0;468.146063921917;510.087601910415;59;978.233665832332
05;2020-10-21;0;0;0;340.368470050554;334.366842191253;69;674.735312241807
05;2020-10-21;0;0;0;212.598666888387;192.597753227106;79;405.196420115493
05;2020-10-21;0;0;0;148.727797095705;61.8681715431829;89;210.595968638888
05;2020-10-21;0;0;0;32.9601271090696;10.9909785719784;90;43.9511056810479
05;2020-10-21;0;0;0;3061.43020057959;2935.56979942041;0;5997
06;2020-10-21;0;0;0;42583;42380;09;84963
06;2020-10-21;2;0;2;33369;31925;19;65294
06;2020-10-21;1;3;4;21571;15080;29;36651
06;2020-10-21;2;3;5;21550;16147;39;37697
06;2020-10-21;2;0;2;14193;13939;49;28132
06;2020-10-21;3;1;4;7171;7597;59;14768
06;2020-10-21;0;0;0;3629;4117;69;7746
06;2020-10-21;0;0;0;1577;1457;79;3034
06;2020-10-21;0;0;0;531;474;89;1005
06;2020-10-21;0;0;0;88;93;90;181
06;2020-10-21;10;7;17;146262;133209;0;279471
07;2020-10-21;0;0;0;485;549;09;1034
07;2020-10-21;0;0;0;403;432;19;835
07;2020-10-21;0;0;0;764;841;29;1605
07;2020-10-21;0;0;0;824;928;39;1752
07;2020-10-21;0;0;0;788;1020;49;1808
07;2020-10-21;0;0;0;678;870;59;1548
07;2020-10-21;0;0;0;360;382;69;742
07;2020-10-21;0;0;0;231;190;79;421
07;2020-10-21;0;0;0;114;67;89;181
07;2020-10-21;0;0;0;24;11;90;35
07;2020-10-21;0;0;0;4671;5290;0;9961
08;2020-10-21;0;0;0;2715.22592983026;2997.75551488675;09;5712.98144471701
08;2020-10-21;0;0;0;2778.51901080978;3160.9156459093;19;5939.43465671908
08;2020-10-21;0;0;0;2080.8882988764;1718.16634315323;29;3799.05464202964
08;2020-10-21;1;2;3;2701.8582062647;1896.52641413317;39;4598.38462039786
08;2020-10-21;3;1;4;3151.45861023308;2460.52498233809;49;5611.98359257117
08;2020-10-21;2;0;2;2620.29868333099;2422.23566154656;59;5042.53434487755
08;2020-10-21;2;0;2;1621.44173420671;1438.58325779464;69;3060.02499200135
08;2020-10-21;0;0;0;626.575909335673;526.358467843651;79;1152.93437717932
08;2020-10-21;0;0;0;205.018522985054;140.993639349697;89;346.012162334751
08;2020-10-21;0;0;0;50.0325684687745;20.62259870351;90;70.6551671722846
08;2020-10-21;8;3;11;18551.3174743414;16782.6825256586;0;35334
11;2020-10-21;86;85;185;783071;811785;09;1594856
11;2020-10-21;467;423;918;761456;784653;19;1546109
11;2020-10-21;1223;994;2226;850145;801772;29;1651917
11;2020-10-21;1059;930;1995;914360;843488;39;1757848
11;2020-10-21;912;824;1738;845609;826202;49;1671811
11;2020-10-21;820;737;1557;793566;745070;59;1538636
11;2020-10-21;458;462;924;628649;549192;69;1177841
11;2020-10-21;211;222;434;434606;358356;79;792962
11;2020-10-21;167;117;284;261425;162933;89;424358
11;2020-10-21;96;36;132;89253;32619;90;121872
11;2020-10-21;5499;4832;10397;6362140;5916070;0;12278210
24;2020-10-21;9;10;19;139720;144686;09;284406
24;2020-10-21;51;69;125;152979;161185;19;314164
24;2020-10-21;123;92;215;122237;126536;29;248773
24;2020-10-21;134;98;232;150359;142009;39;292368
24;2020-10-21;127;104;231;161829;158758;49;320587
24;2020-10-21;106;85;191;172552;168011;59;340563
24;2020-10-21;84;53;137;172509;158177;69;330686
24;2020-10-21;41;53;94;129428;110593;79;240021
24;2020-10-21;28;15;43;87342;56882;89;144224
24;2020-10-21;24;5;29;31210;12071;90;43281
24;2020-10-21;727;584;1316;1320165;1238908;0;2559073
27;2020-10-21;11;21;32;143373;149679;09;293052
27;2020-10-21;99;81;180;160962;173003;19;333965
27;2020-10-21;137;195;332;133746;142254;29;276000
27;2020-10-21;152;124;276;160004;155407;39;315411
27;2020-10-21;159;130;289;172333;169564;49;341897
27;2020-10-21;162;131;293;189979;183788;59;373767
27;2020-10-21;104;119;223;192591;178206;69;370797
27;2020-10-21;81;77;158;146876;127546;79;274422
27;2020-10-21;67;59;126;96896;61575;89;158471
27;2020-10-21;54;19;73;33148;12109;90;45257
27;2020-10-21;1027;956;1983;1429908;1353131;0;2783039
28;2020-10-21;20;9;30;180735;186856;09;367591
28;2020-10-21;66;65;133;200125;213621;19;413746
28;2020-10-21;145;111;256;168922;173007;29;341929
28;2020-10-21;111;112;223;196628;188487;39;385115
28;2020-10-21;122;105;227;205396;201699;49;407095
28;2020-10-21;134;104;239;222002;213866;59;435868
28;2020-10-21;101;103;204;224688;203758;69;428446
28;2020-10-21;58;53;111;163192;135543;79;298735
28;2020-10-21;55;37;92;109691;65377;89;175068
28;2020-10-21;32;9;41;37222;12685;90;49907
28;2020-10-21;844;708;1556;1708601;1594899;0;3303500
32;2020-10-21;62;53;115;358062;373689;09;731751
32;2020-10-21;257;240;499;387045;406742;19;793787
32;2020-10-21;500;426;927;342304;348587;29;690891
32;2020-10-21;528;422;950;382485;369972;39;752457
32;2020-10-21;446;392;838;382510;376716;49;759226
32;2020-10-21;379;358;738;386937;376527;59;763464
32;2020-10-21;232;246;478;371211;330938;69;702149
32;2020-10-21;142;134;276;250542;201459;79;452001
32;2020-10-21;146;77;223;163399;89786;89;253185
32;2020-10-21;115;37;152;48384;15367;90;63751
32;2020-10-21;2807;2385;5196;3072879;2889783;0;5962662
44;2020-10-21;20;27;49;291525;306839;09;598364
44;2020-10-21;128;134;262;320255;339504;19;659759
44;2020-10-21;318;301;619;302020;314428;29;616448
44;2020-10-21;250;230;480;342222;333292;39;675514
44;2020-10-21;216;184;400;349727;344491;49;694218
44;2020-10-21;235;193;428;381371;373239;59;754610
44;2020-10-21;148;133;281;367165;335850;69;703015
44;2020-10-21;75;71;146;250387;215436;79;465823
44;2020-10-21;64;42;106;170825;105192;89;276017
44;2020-10-21;24;13;37;51248;16731;90;67979
44;2020-10-21;1478;1328;2808;2826745;2685002;0;5511747
52;2020-10-21;19;14;33;213594;223900;09;437494
52;2020-10-21;88;89;180;240818;255197;19;496015
52;2020-10-21;173;159;332;197010;200630;29;397640
52;2020-10-21;140;120;260;231204;224885;39;456089
52;2020-10-21;129;121;250;243874;243418;49;487292
52;2020-10-21;118;144;262;244100;239116;59;483216
52;2020-10-21;92;88;180;241796;221345;69;463141
52;2020-10-21;50;55;105;177805;149903;79;327708
52;2020-10-21;44;30;74;119561;75822;89;195383
52;2020-10-21;28;11;39;42559;15260;90;57819
52;2020-10-21;881;831;1715;1952321;1849476;0;3801797
53;2020-10-21;12;10;22;173813;182358;09;356171
53;2020-10-21;57;43;103;202720;214740;19;417460
53;2020-10-21;90;92;186;163116;173196;29;336312
53;2020-10-21;66;73;139;190526;187674;39;378200
53;2020-10-21;74;67;141;212098;212015;49;424113
53;2020-10-21;68;71;140;223699;219176;59;442875
53;2020-10-21;52;48;100;227435;209274;69;436709
53;2020-10-21;30;31;61;169992;140910;79;310902
53;2020-10-21;24;15;39;118117;69883;89;188000
53;2020-10-21;9;2;11;37370;12267;90;49637
53;2020-10-21;482;452;942;1718886;1621493;0;3340379
75;2020-10-21;16;23;39;293104;305291;09;598395
75;2020-10-21;118;115;234;337141;357785;19;694926
75;2020-10-21;232;236;469;295024;300618;29;595642
75;2020-10-21;186;152;338;347871;331233;39;679104
75;2020-10-21;167;142;309;384742;372771;49;757513
75;2020-10-21;178;163;341;413361;390880;59;804241
75;2020-10-21;107;110;217;425623;384060;69;809683
75;2020-10-21;74;65;140;325086;276298;79;601384
75;2020-10-21;59;39;98;213986;139308;89;353294
75;2020-10-21;60;15;75;77600;28200;90;105800
75;2020-10-21;1197;1060;2260;3113538;2886444;0;5999982
76;2020-10-21;29;25;58;305956;318589;09;624545
76;2020-10-21;168;169;346;338942;356969;19;695911
76;2020-10-21;420;294;714;316210;319570;29;635780
76;2020-10-21;337;282;620;356758;337587;39;694345
76;2020-10-21;342;326;668;376541;363812;49;740353
76;2020-10-21;336;275;612;402608;383750;59;786358
76;2020-10-21;185;156;341;394889;358997;69;753886
76;2020-10-21;106;110;217;308664;263806;79;572470
76;2020-10-21;99;58;157;195838;129272;89;325110
76;2020-10-21;90;26;116;69372;26728;90;96100
76;2020-10-21;2113;1726;3855;3065778;2859080;0;5924858
84;2020-10-21;69;89;160;459549;481088;09;940637
84;2020-10-21;492;468;967;487711;511905;19;999616
84;2020-10-21;1019;793;1814;443824;451094;29;894918
84;2020-10-21;844;726;1571;512522;493262;39;1005784
84;2020-10-21;922;751;1673;520248;515106;49;1035354
84;2020-10-21;790;684;1474;529611;514848;59;1044459
84;2020-10-21;491;446;937;486720;439940;69;926660
84;2020-10-21;320;308;628;372151;315211;79;687362
84;2020-10-21;317;190;507;237198;150524;89;387722
84;2020-10-21;223;71;294;81185;28680;90;109865
84;2020-10-21;5488;4526;10026;4130719;3901658;0;8032377
93;2020-10-21;30;45;76;268834;283093;09;551927
93;2020-10-21;162;148;312;280751;296087;19;576838
93;2020-10-21;327;251;578;254404;255552;29;509956
93;2020-10-21;352;267;619;310704;288398;39;599102
93;2020-10-21;352;262;615;325559;305827;49;631386
93;2020-10-21;351;290;641;353104;325389;59;678493
93;2020-10-21;196;217;413;336327;296459;69;632786
93;2020-10-21;143;119;262;279820;229699;79;509519
93;2020-10-21;123;74;197;171274;113716;89;284990
93;2020-10-21;88;27;115;58896;21758;90;80654
93;2020-10-21;2127;1702;3833;2639673;2415978;0;5055651
94;2020-10-21;0;2;2;16311;17433;09;33744
94;2020-10-21;9;6;15;16679;18132;19;34811
94;2020-10-21;11;13;24;16782;16579;29;33361
94;2020-10-21;10;12;22;23044;20580;39;43624
94;2020-10-21;11;16;27;23065;22140;49;45205
94;2020-10-21;9;10;19;24549;23421;59;47970
94;2020-10-21;15;12;27;23212;21883;69;45095
94;2020-10-21;4;8;12;19544;17141;79;36685
94;2020-10-21;6;3;9;11227;8178;89;19405
94;2020-10-21;0;0;0;3332;1447;90;4779
94;2020-10-21;75;82;157;177745;166934;0;344679
01;2020-10-22;2;1;3;19979;20155;09;40134
01;2020-10-22;1;2;3;24994;25489;19;50483
01;2020-10-22;2;0;2;17868;16690;29;34558
01;2020-10-22;7;2;9;22328;14821;39;37149
01;2020-10-22;4;2;6;28652;20276;49;48928
01;2020-10-22;7;7;14;33264;27260;59;60524
01;2020-10-22;2;5;7;27135;23978;69;51113
01;2020-10-22;1;1;2;18401;14661;79;33062
01;2020-10-22;1;1;2;9633;6375;89;16008
01;2020-10-22;1;0;1;3410;1510;90;4920
01;2020-10-22;28;21;49;205664;171215;0;376879
02;2020-10-22;1;1;2;16881;17110;09;33991
02;2020-10-22;10;10;20;21410;21604;19;43014
02;2020-10-22;12;10;22;16017;15479;29;31496
02;2020-10-22;17;11;28;19825;14455;39;34280
02;2020-10-22;10;8;18;24719;18248;49;42967
02;2020-10-22;17;10;27;34361;28310;59;62671
02;2020-10-22;12;11;23;28061;24495;69;52556
02;2020-10-22;8;5;13;18231;15278;79;33509
02;2020-10-22;4;3;7;11090;7677;89;18767
02;2020-10-22;3;0;3;3992;1506;90;5498
02;2020-10-22;94;69;163;194587;164162;0;358749
03;2020-10-22;1;0;1;31123;30920;09;62043
03;2020-10-22;3;2;5;29370;29268;19;58638
03;2020-10-22;3;4;8;21458;18963;29;40421
03;2020-10-22;5;5;10;21276;18326;39;39602
03;2020-10-22;3;5;8;18164;16593;49;34757
03;2020-10-22;4;2;6;13469;13557;59;27026
03;2020-10-22;1;2;3;8776;8670;69;17446
03;2020-10-22;0;0;0;3777;3591;79;7368
03;2020-10-22;0;0;0;1649;1072;89;2721
03;2020-10-22;0;0;0;485;184;90;669
03;2020-10-22;20;20;41;149547;141144;0;290691
04;2020-10-22;0;1;1;60314;61377;09;121691
04;2020-10-22;4;6;10;66065;68387;19;134452
04;2020-10-22;11;8;19;51059;47156;29;98215
04;2020-10-22;4;4;8;58788;45780;39;104568
04;2020-10-22;6;7;13;61408;52207;49;113615
04;2020-10-22;12;8;20;64838;60759;59;125597
04;2020-10-22;1;5;6;47008;42843;69;89851
04;2020-10-22;6;2;8;25509;21184;79;46693
04;2020-10-22;3;0;3;13168;7647;89;20815
04;2020-10-22;1;0;1;3209;1253;90;4462
04;2020-10-22;48;41;89;451366;408593;0;859959
05;2020-10-22;0;0;0;362.366008612902;341.338819562748;09;703.704828175651
05;2020-10-22;0;0;0;353.376145114279;370.349735405642;19;723.725880519921
05;2020-10-22;0;0;0;218.593559489256;256.539602589476;29;475.133162078732
05;2020-10-22;0;0;0;404.225408693299;360.321910454353;39;764.547319147651
05;2020-10-22;0;0;0;520.067953604221;497.108383964256;49;1017.17633756848
05;2020-10-22;0;0;0;468.146063921917;510.087601910415;59;978.233665832332
05;2020-10-22;0;0;0;340.368470050554;334.366842191253;69;674.735312241807
05;2020-10-22;0;0;0;212.598666888387;192.597753227106;79;405.196420115493
05;2020-10-22;0;0;0;148.727797095705;61.8681715431829;89;210.595968638888
05;2020-10-22;0;0;0;32.9601271090696;10.9909785719784;90;43.9511056810479
05;2020-10-22;0;0;0;3061.43020057959;2935.56979942041;0;5997
06;2020-10-22;0;0;0;42583;42380;09;84963
06;2020-10-22;3;1;4;33369;31925;19;65294
06;2020-10-22;4;2;6;21571;15080;29;36651
06;2020-10-22;5;2;7;21550;16147;39;37697
06;2020-10-22;3;5;8;14193;13939;49;28132
06;2020-10-22;1;2;3;7171;7597;59;14768
06;2020-10-22;0;3;3;3629;4117;69;7746
06;2020-10-22;0;0;0;1577;1457;79;3034
06;2020-10-22;0;0;0;531;474;89;1005
06;2020-10-22;0;0;0;88;93;90;181
06;2020-10-22;16;15;31;146262;133209;0;279471
07;2020-10-22;0;0;0;485;549;09;1034
07;2020-10-22;0;0;0;403;432;19;835
07;2020-10-22;0;0;0;764;841;29;1605
07;2020-10-22;0;0;0;824;928;39;1752
07;2020-10-22;0;0;0;788;1020;49;1808
07;2020-10-22;0;0;0;678;870;59;1548
07;2020-10-22;0;0;0;360;382;69;742
07;2020-10-22;0;0;0;231;190;79;421
07;2020-10-22;0;0;0;114;67;89;181
07;2020-10-22;0;0;0;24;11;90;35
07;2020-10-22;0;0;0;4671;5290;0;9961
08;2020-10-22;0;0;0;2715.22592983026;2997.75551488675;09;5712.98144471701
08;2020-10-22;0;0;0;2778.51901080978;3160.9156459093;19;5939.43465671908
08;2020-10-22;0;0;0;2080.8882988764;1718.16634315323;29;3799.05464202964
08;2020-10-22;0;0;0;2701.8582062647;1896.52641413317;39;4598.38462039786
08;2020-10-22;0;0;0;3151.45861023308;2460.52498233809;49;5611.98359257117
08;2020-10-22;1;1;2;2620.29868333099;2422.23566154656;59;5042.53434487755
08;2020-10-22;1;1;2;1621.44173420671;1438.58325779464;69;3060.02499200135
08;2020-10-22;0;0;0;626.575909335673;526.358467843651;79;1152.93437717932
08;2020-10-22;0;0;0;205.018522985054;140.993639349697;89;346.012162334751
08;2020-10-22;0;0;0;50.0325684687745;20.62259870351;90;70.6551671722846
08;2020-10-22;2;2;4;18551.3174743414;16782.6825256586;0;35334
11;2020-10-22;106;92;207;783071;811785;09;1594856
11;2020-10-22;548;537;1124;761456;784653;19;1546109
11;2020-10-22;1262;1155;2426;850145;801772;29;1651917
11;2020-10-22;1096;1011;2112;914360;843488;39;1757848
11;2020-10-22;1047;885;1938;845609;826202;49;1671811
11;2020-10-22;827;738;1567;793566;745070;59;1538636
11;2020-10-22;482;492;980;628649;549192;69;1177841
11;2020-10-22;228;234;462;434606;358356;79;792962
11;2020-10-22;166;111;277;261425;162933;89;424358
11;2020-10-22;146;48;194;89253;32619;90;121872
11;2020-10-22;5909;5305;11294;6362140;5916070;0;12278210
24;2020-10-22;7;8;16;139720;144686;09;284406
24;2020-10-22;75;69;147;152979;161185;19;314164
24;2020-10-22;117;111;229;122237;126536;29;248773
24;2020-10-22;128;94;222;150359;142009;39;292368
24;2020-10-22;143;117;260;161829;158758;49;320587
24;2020-10-22;102;97;199;172552;168011;59;340563
24;2020-10-22;64;79;143;172509;158177;69;330686
24;2020-10-22;53;37;90;129428;110593;79;240021
24;2020-10-22;46;21;67;87342;56882;89;144224
24;2020-10-22;23;11;34;31210;12071;90;43281
24;2020-10-22;758;644;1407;1320165;1238908;0;2559073
27;2020-10-22;19;15;35;143373;149679;09;293052
27;2020-10-22;109;107;217;160962;173003;19;333965
27;2020-10-22;176;158;334;133746;142254;29;276000
27;2020-10-22;153;128;281;160004;155407;39;315411
27;2020-10-22;181;147;328;172333;169564;49;341897
27;2020-10-22;173;129;302;189979;183788;59;373767
27;2020-10-22;122;134;256;192591;178206;69;370797
27;2020-10-22;76;86;162;146876;127546;79;274422
27;2020-10-22;56;50;106;96896;61575;89;158471
27;2020-10-22;51;8;59;33148;12109;90;45257
27;2020-10-22;1116;962;2080;1429908;1353131;0;2783039
28;2020-10-22;12;9;25;180735;186856;09;367591
28;2020-10-22;66;75;142;200125;213621;19;413746
28;2020-10-22;150;133;283;168922;173007;29;341929
28;2020-10-22;139;125;265;196628;188487;39;385115
28;2020-10-22;135;121;257;205396;201699;49;407095
28;2020-10-22;156;137;293;222002;213866;59;435868
28;2020-10-22;108;101;209;224688;203758;69;428446
28;2020-10-22;57;62;119;163192;135543;79;298735
28;2020-10-22;45;30;76;109691;65377;89;175068
28;2020-10-22;33;3;36;37222;12685;90;49907
28;2020-10-22;901;796;1705;1708601;1594899;0;3303500
32;2020-10-22;74;80;154;358062;373689;09;731751
32;2020-10-22;306;296;604;387045;406742;19;793787
32;2020-10-22;553;397;951;342304;348587;29;690891
32;2020-10-22;495;436;931;382485;369972;39;752457
32;2020-10-22;466;427;893;382510;376716;49;759226
32;2020-10-22;410;359;770;386937;376527;59;763464
32;2020-10-22;280;249;529;371211;330938;69;702149
32;2020-10-22;187;154;341;250542;201459;79;452001
32;2020-10-22;157;92;250;163399;89786;89;253185
32;2020-10-22;124;28;152;48384;15367;90;63751
32;2020-10-22;3053;2519;5577;3072879;2889783;0;5962662
44;2020-10-22;35;36;71;291525;306839;09;598364
44;2020-10-22;174;191;367;320255;339504;19;659759
44;2020-10-22;362;381;743;302020;314428;29;616448
44;2020-10-22;294;269;564;342222;333292;39;675514
44;2020-10-22;262;229;491;349727;344491;49;694218
44;2020-10-22;244;223;467;381371;373239;59;754610
44;2020-10-22;172;147;320;367165;335850;69;703015
44;2020-10-22;92;93;185;250387;215436;79;465823
44;2020-10-22;100;52;153;170825;105192;89;276017
44;2020-10-22;71;20;91;51248;16731;90;67979
44;2020-10-22;1806;1641;3452;2826745;2685002;0;5511747
52;2020-10-22;13;9;22;213594;223900;09;437494
52;2020-10-22;111;90;203;240818;255197;19;496015
52;2020-10-22;177;189;366;197010;200630;29;397640
52;2020-10-22;149;129;278;231204;224885;39;456089
52;2020-10-22;144;133;277;243874;243418;49;487292
52;2020-10-22;134;105;239;244100;239116;59;483216
52;2020-10-22;89;95;184;241796;221345;69;463141
52;2020-10-22;60;71;131;177805;149903;79;327708
52;2020-10-22;64;41;105;119561;75822;89;195383
52;2020-10-22;47;8;55;42559;15260;90;57819
52;2020-10-22;988;870;1860;1952321;1849476;0;3801797
53;2020-10-22;19;8;30;173813;182358;09;356171
53;2020-10-22;57;42;101;202720;214740;19;417460
53;2020-10-22;96;103;203;163116;173196;29;336312
53;2020-10-22;73;71;144;190526;187674;39;378200
53;2020-10-22;72;65;138;212098;212015;49;424113
53;2020-10-22;74;65;139;223699;219176;59;442875
53;2020-10-22;39;67;106;227435;209274;69;436709
53;2020-10-22;26;18;44;169992;140910;79;310902
53;2020-10-22;23;12;35;118117;69883;89;188000
53;2020-10-22;16;9;26;37370;12267;90;49637
53;2020-10-22;495;460;966;1718886;1621493;0;3340379
75;2020-10-22;27;12;40;293104;305291;09;598395
75;2020-10-22;144;134;280;337141;357785;19;694926
75;2020-10-22;259;226;485;295024;300618;29;595642
75;2020-10-22;205;158;364;347871;331233;39;679104
75;2020-10-22;235;182;417;384742;372771;49;757513
75;2020-10-22;194;156;350;413361;390880;59;804241
75;2020-10-22;111;126;238;425623;384060;69;809683
75;2020-10-22;78;77;155;325086;276298;79;601384
75;2020-10-22;75;53;128;213986;139308;89;353294
75;2020-10-22;72;28;100;77600;28200;90;105800
75;2020-10-22;1400;1153;2558;3113538;2886444;0;5999982
76;2020-10-22;29;34;65;305956;318589;09;624545
76;2020-10-22;175;181;363;338942;356969;19;695911
76;2020-10-22;331;342;673;316210;319570;29;635780
76;2020-10-22;391;283;674;356758;337587;39;694345
76;2020-10-22;391;269;660;376541;363812;49;740353
76;2020-10-22;365;296;661;402608;383750;59;786358
76;2020-10-22;206;192;398;394889;358997;69;753886
76;2020-10-22;149;115;264;308664;263806;79;572470
76;2020-10-22;133;91;224;195838;129272;89;325110
76;2020-10-22;133;31;164;69372;26728;90;96100
76;2020-10-22;2306;1836;4151;3065778;2859080;0;5924858
84;2020-10-22;80;92;173;459549;481088;09;940637
84;2020-10-22;527;522;1059;487711;511905;19;999616
84;2020-10-22;1057;876;1934;443824;451094;29;894918
84;2020-10-22;952;802;1755;512522;493262;39;1005784
84;2020-10-22;960;827;1788;520248;515106;49;1035354
84;2020-10-22;874;805;1680;529611;514848;59;1044459
84;2020-10-22;570;520;1090;486720;439940;69;926660
84;2020-10-22;342;337;679;372151;315211;79;687362
84;2020-10-22;301;153;454;237198;150524;89;387722
84;2020-10-22;221;44;265;81185;28680;90;109865
84;2020-10-22;5885;4980;10881;4130719;3901658;0;8032377
93;2020-10-22;32;27;60;268834;283093;09;551927
93;2020-10-22;180;189;370;280751;296087;19;576838
93;2020-10-22;384;290;674;254404;255552;29;509956
93;2020-10-22;385;322;707;310704;288398;39;599102
93;2020-10-22;373;327;701;325559;305827;49;631386
93;2020-10-22;383;281;665;353104;325389;59;678493
93;2020-10-22;238;228;467;336327;296459;69;632786
93;2020-10-22;173;136;309;279820;229699;79;509519
93;2020-10-22;140;81;221;171274;113716;89;284990
93;2020-10-22;98;41;140;58896;21758;90;80654
93;2020-10-22;2387;1923;4316;2639673;2415978;0;5055651
94;2020-10-22;3;0;3;16311;17433;09;33744
94;2020-10-22;6;5;11;16679;18132;19;34811
94;2020-10-22;14;12;26;16782;16579;29;33361
94;2020-10-22;12;12;24;23044;20580;39;43624
94;2020-10-22;16;12;28;23065;22140;49;45205
94;2020-10-22;14;10;24;24549;23421;59;47970
94;2020-10-22;10;10;20;23212;21883;69;45095
94;2020-10-22;4;5;9;19544;17141;79;36685
94;2020-10-22;3;3;6;11227;8178;89;19405
94;2020-10-22;5;0;5;3332;1447;90;4779
94;2020-10-22;87;69;156;177745;166934;0;344679
01;2020-10-23;0;1;1;19979;20155;09;40134
01;2020-10-23;0;1;1;24994;25489;19;50483
01;2020-10-23;3;0;3;17868;16690;29;34558
01;2020-10-23;3;3;6;22328;14821;39;37149
01;2020-10-23;1;4;5;28652;20276;49;48928
01;2020-10-23;2;0;2;33264;27260;59;60524
01;2020-10-23;2;4;6;27135;23978;69;51113
01;2020-10-23;1;4;5;18401;14661;79;33062
01;2020-10-23;0;1;1;9633;6375;89;16008
01;2020-10-23;0;1;1;3410;1510;90;4920
01;2020-10-23;12;19;31;205664;171215;0;376879
02;2020-10-23;1;1;2;16881;17110;09;33991
02;2020-10-23;12;16;28;21410;21604;19;43014
02;2020-10-23;9;7;16;16017;15479;29;31496
02;2020-10-23;11;13;24;19825;14455;39;34280
02;2020-10-23;13;11;24;24719;18248;49;42967
02;2020-10-23;18;16;35;34361;28310;59;62671
02;2020-10-23;6;11;17;28061;24495;69;52556
02;2020-10-23;3;0;3;18231;15278;79;33509
02;2020-10-23;2;0;2;11090;7677;89;18767
02;2020-10-23;0;1;1;3992;1506;90;5498
02;2020-10-23;75;76;152;194587;164162;0;358749
03;2020-10-23;0;0;0;31123;30920;09;62043
03;2020-10-23;4;0;4;29370;29268;19;58638
03;2020-10-23;2;2;4;21458;18963;29;40421
03;2020-10-23;5;4;9;21276;18326;39;39602
03;2020-10-23;0;2;2;18164;16593;49;34757
03;2020-10-23;0;1;1;13469;13557;59;27026
03;2020-10-23;0;1;1;8776;8670;69;17446
03;2020-10-23;0;0;0;3777;3591;79;7368
03;2020-10-23;1;0;1;1649;1072;89;2721
03;2020-10-23;1;0;1;485;184;90;669
03;2020-10-23;13;10;23;149547;141144;0;290691
04;2020-10-23;2;0;2;60314;61377;09;121691
04;2020-10-23;5;12;17;66065;68387;19;134452
04;2020-10-23;9;5;14;51059;47156;29;98215
04;2020-10-23;8;6;14;58788;45780;39;104568
04;2020-10-23;3;3;6;61408;52207;49;113615
04;2020-10-23;8;3;11;64838;60759;59;125597
04;2020-10-23;5;2;7;47008;42843;69;89851
04;2020-10-23;3;2;5;25509;21184;79;46693
04;2020-10-23;0;1;1;13168;7647;89;20815
04;2020-10-23;0;0;0;3209;1253;90;4462
04;2020-10-23;43;34;77;451366;408593;0;859959
05;2020-10-23;0;0;0;362.366008612902;341.338819562748;09;703.704828175651
05;2020-10-23;0;0;0;353.376145114279;370.349735405642;19;723.725880519921
05;2020-10-23;0;0;0;218.593559489256;256.539602589476;29;475.133162078732
05;2020-10-23;0;0;0;404.225408693299;360.321910454353;39;764.547319147651
05;2020-10-23;0;0;0;520.067953604221;497.108383964256;49;1017.17633756848
05;2020-10-23;0;0;0;468.146063921917;510.087601910415;59;978.233665832332
05;2020-10-23;0;0;0;340.368470050554;334.366842191253;69;674.735312241807
05;2020-10-23;0;0;0;212.598666888387;192.597753227106;79;405.196420115493
05;2020-10-23;0;0;0;148.727797095705;61.8681715431829;89;210.595968638888
05;2020-10-23;0;0;0;32.9601271090696;10.9909785719784;90;43.9511056810479
05;2020-10-23;0;0;0;3061.43020057959;2935.56979942041;0;5997
06;2020-10-23;0;2;2;42583;42380;09;84963
06;2020-10-23;1;4;5;33369;31925;19;65294
06;2020-10-23;3;4;7;21571;15080;29;36651
06;2020-10-23;2;2;4;21550;16147;39;37697
06;2020-10-23;1;1;2;14193;13939;49;28132
06;2020-10-23;0;1;1;7171;7597;59;14768
06;2020-10-23;0;1;1;3629;4117;69;7746
06;2020-10-23;0;1;1;1577;1457;79;3034
06;2020-10-23;0;0;0;531;474;89;1005
06;2020-10-23;0;0;0;88;93;90;181
06;2020-10-23;7;16;23;146262;133209;0;279471
07;2020-10-23;0;0;0;485;549;09;1034
07;2020-10-23;0;0;0;403;432;19;835
07;2020-10-23;1;0;1;764;841;29;1605
07;2020-10-23;0;0;0;824;928;39;1752
07;2020-10-23;0;0;0;788;1020;49;1808
07;2020-10-23;0;0;0;678;870;59;1548
07;2020-10-23;0;0;0;360;382;69;742
07;2020-10-23;0;0;0;231;190;79;421
07;2020-10-23;0;0;0;114;67;89;181
07;2020-10-23;0;0;0;24;11;90;35
07;2020-10-23;1;0;1;4671;5290;0;9961
08;2020-10-23;0;0;0;2715.22592983026;2997.75551488675;09;5712.98144471701
08;2020-10-23;0;0;0;2778.51901080978;3160.9156459093;19;5939.43465671908
08;2020-10-23;0;0;0;2080.8882988764;1718.16634315323;29;3799.05464202964
08;2020-10-23;1;0;1;2701.8582062647;1896.52641413317;39;4598.38462039786
08;2020-10-23;1;0;1;3151.45861023308;2460.52498233809;49;5611.98359257117
08;2020-10-23;1;1;2;2620.29868333099;2422.23566154656;59;5042.53434487755
08;2020-10-23;0;1;1;1621.44173420671;1438.58325779464;69;3060.02499200135
08;2020-10-23;0;0;0;626.575909335673;526.358467843651;79;1152.93437717932
08;2020-10-23;0;0;0;205.018522985054;140.993639349697;89;346.012162334751
08;2020-10-23;0;0;0;50.0325684687745;20.62259870351;90;70.6551671722846
08;2020-10-23;3;2;5;18551.3174743414;16782.6825256586;0;35334
11;2020-10-23;113;102;223;783071;811785;09;1594856
11;2020-10-23;576;537;1149;761456;784653;19;1546109
11;2020-10-23;1327;1057;2391;850145;801772;29;1651917
11;2020-10-23;1212;1032;2245;914360;843488;39;1757848
11;2020-10-23;1001;869;1875;845609;826202;49;1671811
11;2020-10-23;836;759;1598;793566;745070;59;1538636
11;2020-10-23;487;495;997;628649;549192;69;1177841
11;2020-10-23;232;245;480;434606;358356;79;792962
11;2020-10-23;156;111;271;261425;162933;89;424358
11;2020-10-23;99;29;131;89253;32619;90;121872
11;2020-10-23;6040;5242;11367;6362140;5916070;0;12278210
24;2020-10-23;12;12;24;139720;144686;09;284406
24;2020-10-23;87;84;172;152979;161185;19;314164
24;2020-10-23;134;115;249;122237;126536;29;248773
24;2020-10-23;148;119;267;150359;142009;39;292368
24;2020-10-23;157;149;307;161829;158758;49;320587
24;2020-10-23;147;104;251;172552;168011;59;340563
24;2020-10-23;84;71;155;172509;158177;69;330686
24;2020-10-23;51;61;112;129428;110593;79;240021
24;2020-10-23;46;20;66;87342;56882;89;144224
24;2020-10-23;39;16;55;31210;12071;90;43281
24;2020-10-23;906;752;1660;1320165;1238908;0;2559073
27;2020-10-23;10;23;33;143373;149679;09;293052
27;2020-10-23;116;126;242;160962;173003;19;333965
27;2020-10-23;187;177;364;133746;142254;29;276000
27;2020-10-23;161;154;315;160004;155407;39;315411
27;2020-10-23;196;149;345;172333;169564;49;341897
27;2020-10-23;198;147;345;189979;183788;59;373767
27;2020-10-23;128;143;272;192591;178206;69;370797
27;2020-10-23;81;109;190;146876;127546;79;274422
27;2020-10-23;100;70;170;96896;61575;89;158471
27;2020-10-23;52;27;79;33148;12109;90;45257
27;2020-10-23;1229;1125;2355;1429908;1353131;0;2783039
28;2020-10-23;16;17;34;180735;186856;09;367591
28;2020-10-23;98;94;195;200125;213621;19;413746
28;2020-10-23;146;144;290;168922;173007;29;341929
28;2020-10-23;180;120;300;196628;188487;39;385115
28;2020-10-23;173;135;308;205396;201699;49;407095
28;2020-10-23;160;128;288;222002;213866;59;435868
28;2020-10-23;111;109;220;224688;203758;69;428446
28;2020-10-23;79;80;159;163192;135543;79;298735
28;2020-10-23;75;42;117;109691;65377;89;175068
28;2020-10-23;38;21;60;37222;12685;90;49907
28;2020-10-23;1076;890;1971;1708601;1594899;0;3303500
32;2020-10-23;77;81;159;358062;373689;09;731751
32;2020-10-23;364;330;694;387045;406742;19;793787
32;2020-10-23;562;470;1032;342304;348587;29;690891
32;2020-10-23;535;483;1018;382485;369972;39;752457
32;2020-10-23;504;456;960;382510;376716;49;759226
32;2020-10-23;454;406;862;386937;376527;59;763464
32;2020-10-23;295;296;591;371211;330938;69;702149
32;2020-10-23;209;192;401;250542;201459;79;452001
32;2020-10-23;187;93;280;163399;89786;89;253185
32;2020-10-23;102;30;132;48384;15367;90;63751
32;2020-10-23;3289;2837;6129;3072879;2889783;0;5962662
44;2020-10-23;46;31;77;291525;306839;09;598364
44;2020-10-23;187;201;389;320255;339504;19;659759
44;2020-10-23;411;338;749;302020;314428;29;616448
44;2020-10-23;307;269;576;342222;333292;39;675514
44;2020-10-23;297;269;566;349727;344491;49;694218
44;2020-10-23;292;263;555;381371;373239;59;754610
44;2020-10-23;213;182;395;367165;335850;69;703015
44;2020-10-23;115;127;242;250387;215436;79;465823
44;2020-10-23;113;57;170;170825;105192;89;276017
44;2020-10-23;68;14;83;51248;16731;90;67979
44;2020-10-23;2050;1751;3803;2826745;2685002;0;5511747
52;2020-10-23;24;16;41;213594;223900;09;437494
52;2020-10-23;109;124;236;240818;255197;19;496015
52;2020-10-23;172;178;350;197010;200630;29;397640
52;2020-10-23;187;127;314;231204;224885;39;456089
52;2020-10-23;179;127;306;243874;243418;49;487292
52;2020-10-23;157;132;289;244100;239116;59;483216
52;2020-10-23;114;113;227;241796;221345;69;463141
52;2020-10-23;69;66;135;177805;149903;79;327708
52;2020-10-23;62;45;107;119561;75822;89;195383
52;2020-10-23;52;16;68;42559;15260;90;57819
52;2020-10-23;1125;944;2073;1952321;1849476;0;3801797
53;2020-10-23;14;12;27;173813;182358;09;356171
53;2020-10-23;62;60;122;202720;214740;19;417460
53;2020-10-23;100;128;230;163116;173196;29;336312
53;2020-10-23;102;74;176;190526;187674;39;378200
53;2020-10-23;98;79;177;212098;212015;49;424113
53;2020-10-23;97;97;194;223699;219176;59;442875
53;2020-10-23;72;56;128;227435;209274;69;436709
53;2020-10-23;33;37;70;169992;140910;79;310902
53;2020-10-23;34;27;61;118117;69883;89;188000
53;2020-10-23;18;9;27;37370;12267;90;49637
53;2020-10-23;630;579;1212;1718886;1621493;0;3340379
75;2020-10-23;40;26;67;293104;305291;09;598395
75;2020-10-23;149;164;315;337141;357785;19;694926
75;2020-10-23;271;255;527;295024;300618;29;595642
75;2020-10-23;196;173;369;347871;331233;39;679104
75;2020-10-23;222;215;438;384742;372771;49;757513
75;2020-10-23;224;181;405;413361;390880;59;804241
75;2020-10-23;141;152;293;425623;384060;69;809683
75;2020-10-23;86;72;158;325086;276298;79;601384
75;2020-10-23;93;57;150;213986;139308;89;353294
75;2020-10-23;60;25;85;77600;28200;90;105800
75;2020-10-23;1482;1321;2808;3113538;2886444;0;5999982
76;2020-10-23;41;46;89;305956;318589;09;624545
76;2020-10-23;236;196;441;338942;356969;19;695911
76;2020-10-23;455;391;846;316210;319570;29;635780
76;2020-10-23;381;308;690;356758;337587;39;694345
76;2020-10-23;411;326;738;376541;363812;49;740353
76;2020-10-23;399;340;739;402608;383750;59;786358
76;2020-10-23;275;234;509;394889;358997;69;753886
76;2020-10-23;164;143;307;308664;263806;79;572470
76;2020-10-23;147;86;233;195838;129272;89;325110
76;2020-10-23;102;31;133;69372;26728;90;96100
76;2020-10-23;2615;2103;4731;3065778;2859080;0;5924858
84;2020-10-23;98;109;207;459549;481088;09;940637
84;2020-10-23;639;591;1240;487711;511905;19;999616
84;2020-10-23;1030;916;1951;443824;451094;29;894918
84;2020-10-23;1029;867;1897;512522;493262;39;1005784
84;2020-10-23;1009;859;1868;520248;515106;49;1035354
84;2020-10-23;939;890;1831;529611;514848;59;1044459
84;2020-10-23;596;559;1155;486720;439940;69;926660
84;2020-10-23;365;360;725;372151;315211;79;687362
84;2020-10-23;339;211;550;237198;150524;89;387722
84;2020-10-23;215;72;287;81185;28680;90;109865
84;2020-10-23;6259;5436;11713;4130719;3901658;0;8032377
93;2020-10-23;38;49;87;268834;283093;09;551927
93;2020-10-23;197;201;398;280751;296087;19;576838
93;2020-10-23;397;305;703;254404;255552;29;509956
93;2020-10-23;386;343;729;310704;288398;39;599102
93;2020-10-23;395;339;734;325559;305827;49;631386
93;2020-10-23;370;332;702;353104;325389;59;678493
93;2020-10-23;237;257;494;336327;296459;69;632786
93;2020-10-23;163;183;346;279820;229699;79;509519
93;2020-10-23;132;78;210;171274;113716;89;284990
93;2020-10-23;101;29;130;58896;21758;90;80654
93;2020-10-23;2419;2117;4537;2639673;2415978;0;5055651
94;2020-10-23;0;1;1;16311;17433;09;33744
94;2020-10-23;9;3;12;16679;18132;19;34811
94;2020-10-23;20;17;37;16782;16579;29;33361
94;2020-10-23;12;16;28;23044;20580;39;43624
94;2020-10-23;13;9;22;23065;22140;49;45205
94;2020-10-23;15;17;32;24549;23421;59;47970
94;2020-10-23;24;19;43;23212;21883;69;45095
94;2020-10-23;8;11;19;19544;17141;79;36685
94;2020-10-23;4;4;8;11227;8178;89;19405
94;2020-10-23;1;1;2;3332;1447;90;4779
94;2020-10-23;106;98;204;177745;166934;0;344679
01;2020-10-24;0;0;0;19979;20155;09;40134
01;2020-10-24;1;0;1;24994;25489;19;50483
01;2020-10-24;0;0;0;17868;16690;29;34558
01;2020-10-24;1;1;2;22328;14821;39;37149
01;2020-10-24;1;2;3;28652;20276;49;48928
01;2020-10-24;2;1;3;33264;27260;59;60524
01;2020-10-24;3;0;3;27135;23978;69;51113
01;2020-10-24;0;0;0;18401;14661;79;33062
01;2020-10-24;0;0;0;9633;6375;89;16008
01;2020-10-24;0;0;0;3410;1510;90;4920
01;2020-10-24;8;4;12;205664;171215;0;376879
02;2020-10-24;0;1;1;16881;17110;09;33991
02;2020-10-24;0;4;4;21410;21604;19;43014
02;2020-10-24;3;3;6;16017;15479;29;31496
02;2020-10-24;3;4;7;19825;14455;39;34280
02;2020-10-24;1;4;5;24719;18248;49;42967
02;2020-10-24;3;1;4;34361;28310;59;62671
02;2020-10-24;3;2;5;28061;24495;69;52556
02;2020-10-24;2;0;2;18231;15278;79;33509
02;2020-10-24;0;1;1;11090;7677;89;18767
02;2020-10-24;0;0;0;3992;1506;90;5498
02;2020-10-24;15;20;35;194587;164162;0;358749
03;2020-10-24;0;0;0;31123;30920;09;62043
03;2020-10-24;0;1;1;29370;29268;19;58638
03;2020-10-24;0;1;1;21458;18963;29;40421
03;2020-10-24;1;0;1;21276;18326;39;39602
03;2020-10-24;0;0;0;18164;16593;49;34757
03;2020-10-24;1;1;2;13469;13557;59;27026
03;2020-10-24;1;0;1;8776;8670;69;17446
03;2020-10-24;0;0;0;3777;3591;79;7368
03;2020-10-24;0;0;0;1649;1072;89;2721
03;2020-10-24;0;0;0;485;184;90;669
03;2020-10-24;3;3;6;149547;141144;0;290691
04;2020-10-24;1;1;2;60314;61377;09;121691
04;2020-10-24;8;6;14;66065;68387;19;134452
04;2020-10-24;8;4;12;51059;47156;29;98215
04;2020-10-24;8;2;10;58788;45780;39;104568
04;2020-10-24;9;5;14;61408;52207;49;113615
04;2020-10-24;6;5;11;64838;60759;59;125597
04;2020-10-24;2;0;2;47008;42843;69;89851
04;2020-10-24;1;0;1;25509;21184;79;46693
04;2020-10-24;1;1;2;13168;7647;89;20815
04;2020-10-24;0;0;0;3209;1253;90;4462
04;2020-10-24;44;24;68;451366;408593;0;859959
05;2020-10-24;0;0;0;362.366008612902;341.338819562748;09;703.704828175651
05;2020-10-24;0;0;0;353.376145114279;370.349735405642;19;723.725880519921
05;2020-10-24;0;0;0;218.593559489256;256.539602589476;29;475.133162078732
05;2020-10-24;0;0;0;404.225408693299;360.321910454353;39;764.547319147651
05;2020-10-24;0;0;0;520.067953604221;497.108383964256;49;1017.17633756848
05;2020-10-24;0;0;0;468.146063921917;510.087601910415;59;978.233665832332
05;2020-10-24;0;0;0;340.368470050554;334.366842191253;69;674.735312241807
05;2020-10-24;0;0;0;212.598666888387;192.597753227106;79;405.196420115493
05;2020-10-24;0;0;0;148.727797095705;61.8681715431829;89;210.595968638888
05;2020-10-24;0;0;0;32.9601271090696;10.9909785719784;90;43.9511056810479
05;2020-10-24;0;0;0;3061.43020057959;2935.56979942041;0;5997
06;2020-10-24;0;1;1;42583;42380;09;84963
06;2020-10-24;0;0;0;33369;31925;19;65294
06;2020-10-24;0;0;0;21571;15080;29;36651
06;2020-10-24;2;1;3;21550;16147;39;37697
06;2020-10-24;1;1;2;14193;13939;49;28132
06;2020-10-24;0;0;0;7171;7597;59;14768
06;2020-10-24;1;2;3;3629;4117;69;7746
06;2020-10-24;0;0;0;1577;1457;79;3034
06;2020-10-24;0;0;0;531;474;89;1005
06;2020-10-24;0;0;0;88;93;90;181
06;2020-10-24;4;5;9;146262;133209;0;279471
07;2020-10-24;0;0;0;485;549;09;1034
07;2020-10-24;0;0;0;403;432;19;835
07;2020-10-24;0;0;0;764;841;29;1605
07;2020-10-24;0;0;0;824;928;39;1752
07;2020-10-24;0;0;0;788;1020;49;1808
07;2020-10-24;0;0;0;678;870;59;1548
07;2020-10-24;0;0;0;360;382;69;742
07;2020-10-24;0;0;0;231;190;79;421
07;2020-10-24;0;0;0;114;67;89;181
07;2020-10-24;0;0;0;24;11;90;35
07;2020-10-24;0;0;0;4671;5290;0;9961
08;2020-10-24;0;0;0;2715.22592983026;2997.75551488675;09;5712.98144471701
08;2020-10-24;0;0;0;2778.51901080978;3160.9156459093;19;5939.43465671908
08;2020-10-24;1;0;1;2080.8882988764;1718.16634315323;29;3799.05464202964
08;2020-10-24;0;0;0;2701.8582062647;1896.52641413317;39;4598.38462039786
08;2020-10-24;0;0;0;3151.45861023308;2460.52498233809;49;5611.98359257117
08;2020-10-24;0;1;1;2620.29868333099;2422.23566154656;59;5042.53434487755
08;2020-10-24;0;0;0;1621.44173420671;1438.58325779464;69;3060.02499200135
08;2020-10-24;0;0;0;626.575909335673;526.358467843651;79;1152.93437717932
08;2020-10-24;0;0;0;205.018522985054;140.993639349697;89;346.012162334751
08;2020-10-24;0;0;0;50.0325684687745;20.62259870351;90;70.6551671722846
08;2020-10-24;1;1;2;18551.3174743414;16782.6825256586;0;35334
11;2020-10-24;46;52;102;783071;811785;09;1594856
11;2020-10-24;229;220;477;761456;784653;19;1546109
11;2020-10-24;596;433;1029;850145;801772;29;1651917
11;2020-10-24;522;440;963;914360;843488;39;1757848
11;2020-10-24;425;414;841;845609;826202;49;1671811
11;2020-10-24;382;377;761;793566;745070;59;1538636
11;2020-10-24;271;258;536;628649;549192;69;1177841
11;2020-10-24;108;105;213;434606;358356;79;792962
11;2020-10-24;90;58;148;261425;162933;89;424358
11;2020-10-24;42;26;68;89253;32619;90;121872
11;2020-10-24;2712;2387;5143;6362140;5916070;0;12278210
24;2020-10-24;6;6;12;139720;144686;09;284406
24;2020-10-24;49;46;95;152979;161185;19;314164
24;2020-10-24;103;64;167;122237;126536;29;248773
24;2020-10-24;88;53;141;150359;142009;39;292368
24;2020-10-24;83;59;142;161829;158758;49;320587
24;2020-10-24;72;66;138;172552;168011;59;340563
24;2020-10-24;49;41;90;172509;158177;69;330686
24;2020-10-24;21;22;43;129428;110593;79;240021
24;2020-10-24;30;18;48;87342;56882;89;144224
24;2020-10-24;19;8;27;31210;12071;90;43281
24;2020-10-24;520;383;903;1320165;1238908;0;2559073
27;2020-10-24;10;23;33;143373;149679;09;293052
27;2020-10-24;61;63;124;160962;173003;19;333965
27;2020-10-24;103;89;192;133746;142254;29;276000
27;2020-10-24;110;64;174;160004;155407;39;315411
27;2020-10-24;114;75;189;172333;169564;49;341897
27;2020-10-24;103;74;177;189979;183788;59;373767
27;2020-10-24;72;68;140;192591;178206;69;370797
27;2020-10-24;39;60;99;146876;127546;79;274422
27;2020-10-24;45;38;83;96896;61575;89;158471
27;2020-10-24;24;8;32;33148;12109;90;45257
27;2020-10-24;681;563;1244;1429908;1353131;0;2783039
28;2020-10-24;11;7;18;180735;186856;09;367591
28;2020-10-24;53;40;94;200125;213621;19;413746
28;2020-10-24;61;64;125;168922;173007;29;341929
28;2020-10-24;76;73;149;196628;188487;39;385115
28;2020-10-24;67;72;139;205396;201699;49;407095
28;2020-10-24;60;59;119;222002;213866;59;435868
28;2020-10-24;63;55;118;224688;203758;69;428446
28;2020-10-24;36;32;68;163192;135543;79;298735
28;2020-10-24;26;13;39;109691;65377;89;175068
28;2020-10-24;9;5;14;37222;12685;90;49907
28;2020-10-24;462;420;883;1708601;1594899;0;3303500
32;2020-10-24;40;52;92;358062;373689;09;731751
32;2020-10-24;216;186;403;387045;406742;19;793787
32;2020-10-24;308;284;593;342304;348587;29;690891
32;2020-10-24;294;258;553;382485;369972;39;752457
32;2020-10-24;299;247;547;382510;376716;49;759226
32;2020-10-24;230;245;475;386937;376527;59;763464
32;2020-10-24;176;141;317;371211;330938;69;702149
32;2020-10-24;93;95;188;250542;201459;79;452001
32;2020-10-24;90;41;131;163399;89786;89;253185
32;2020-10-24;37;10;47;48384;15367;90;63751
32;2020-10-24;1783;1560;3347;3072879;2889783;0;5962662
44;2020-10-24;20;19;39;291525;306839;09;598364
44;2020-10-24;98;100;199;320255;339504;19;659759
44;2020-10-24;194;163;357;302020;314428;29;616448
44;2020-10-24;178;151;329;342222;333292;39;675514
44;2020-10-24;147;152;299;349727;344491;49;694218
44;2020-10-24;152;152;305;381371;373239;59;754610
44;2020-10-24;132;101;233;367165;335850;69;703015
44;2020-10-24;52;52;104;250387;215436;79;465823
44;2020-10-24;36;27;63;170825;105192;89;276017
44;2020-10-24;18;6;24;51248;16731;90;67979
44;2020-10-24;1027;924;1953;2826745;2685002;0;5511747
52;2020-10-24;9;8;17;213594;223900;09;437494
52;2020-10-24;55;60;116;240818;255197;19;496015
52;2020-10-24;100;86;186;197010;200630;29;397640
52;2020-10-24;92;70;162;231204;224885;39;456089
52;2020-10-24;86;67;153;243874;243418;49;487292
52;2020-10-24;83;71;154;244100;239116;59;483216
52;2020-10-24;48;51;99;241796;221345;69;463141
52;2020-10-24;28;28;56;177805;149903;79;327708
52;2020-10-24;34;12;46;119561;75822;89;195383
52;2020-10-24;10;4;14;42559;15260;90;57819
52;2020-10-24;545;457;1003;1952321;1849476;0;3801797
53;2020-10-24;7;10;17;173813;182358;09;356171
53;2020-10-24;32;38;70;202720;214740;19;417460
53;2020-10-24;71;53;125;163116;173196;29;336312
53;2020-10-24;38;52;90;190526;187674;39;378200
53;2020-10-24;46;43;89;212098;212015;49;424113
53;2020-10-24;50;51;101;223699;219176;59;442875
53;2020-10-24;32;34;66;227435;209274;69;436709
53;2020-10-24;21;25;46;169992;140910;79;310902
53;2020-10-24;17;8;25;118117;69883;89;188000
53;2020-10-24;7;2;9;37370;12267;90;49637
53;2020-10-24;321;316;638;1718886;1621493;0;3340379
75;2020-10-24;17;15;32;293104;305291;09;598395
75;2020-10-24;67;65;132;337141;357785;19;694926
75;2020-10-24;133;96;230;295024;300618;29;595642
75;2020-10-24;116;81;197;347871;331233;39;679104
75;2020-10-24;79;78;157;384742;372771;49;757513
75;2020-10-24;91;78;170;413361;390880;59;804241
75;2020-10-24;51;72;123;425623;384060;69;809683
75;2020-10-24;35;42;77;325086;276298;79;601384
75;2020-10-24;24;22;46;213986;139308;89;353294
75;2020-10-24;15;6;21;77600;28200;90;105800
75;2020-10-24;628;556;1186;3113538;2886444;0;5999982
76;2020-10-24;14;17;31;305956;318589;09;624545
76;2020-10-24;117;114;233;338942;356969;19;695911
76;2020-10-24;229;173;402;316210;319570;29;635780
76;2020-10-24;187;122;309;356758;337587;39;694345
76;2020-10-24;165;150;315;376541;363812;49;740353
76;2020-10-24;158;143;301;402608;383750;59;786358
76;2020-10-24;84;85;169;394889;358997;69;753886
76;2020-10-24;56;53;109;308664;263806;79;572470
76;2020-10-24;43;37;80;195838;129272;89;325110
76;2020-10-24;17;6;23;69372;26728;90;96100
76;2020-10-24;1073;900;1975;3065778;2859080;0;5924858
84;2020-10-24;48;45;97;459549;481088;09;940637
84;2020-10-24;259;226;490;487711;511905;19;999616
84;2020-10-24;465;399;864;443824;451094;29;894918
84;2020-10-24;431;372;803;512522;493262;39;1005784
84;2020-10-24;407;361;768;520248;515106;49;1035354
84;2020-10-24;383;405;788;529611;514848;59;1044459
84;2020-10-24;245;240;486;486720;439940;69;926660
84;2020-10-24;159;161;320;372151;315211;79;687362
84;2020-10-24;140;118;258;237198;150524;89;387722
84;2020-10-24;86;37;123;81185;28680;90;109865
84;2020-10-24;2623;2365;4998;4130719;3901658;0;8032377
93;2020-10-24;11;14;25;268834;283093;09;551927
93;2020-10-24;65;60;125;280751;296087;19;576838
93;2020-10-24;123;95;218;254404;255552;29;509956
93;2020-10-24;141;117;258;310704;288398;39;599102
93;2020-10-24;119;128;247;325559;305827;49;631386
93;2020-10-24;132;121;253;353104;325389;59;678493
93;2020-10-24;72;76;148;336327;296459;69;632786
93;2020-10-24;48;54;102;279820;229699;79;509519
93;2020-10-24;53;48;101;171274;113716;89;284990
93;2020-10-24;45;11;56;58896;21758;90;80654
93;2020-10-24;809;724;1533;2639673;2415978;0;5055651
94;2020-10-24;1;2;3;16311;17433;09;33744
94;2020-10-24;2;5;7;16679;18132;19;34811
94;2020-10-24;5;5;10;16782;16579;29;33361
94;2020-10-24;3;4;7;23044;20580;39;43624
94;2020-10-24;7;6;13;23065;22140;49;45205
94;2020-10-24;4;6;10;24549;23421;59;47970
94;2020-10-24;3;1;4;23212;21883;69;45095
94;2020-10-24;1;2;3;19544;17141;79;36685
94;2020-10-24;0;2;2;11227;8178;89;19405
94;2020-10-24;1;0;1;3332;1447;90;4779
94;2020-10-24;27;33;60;177745;166934;0;344679
01;2020-10-25;0;0;0;19979;20155;09;40134
01;2020-10-25;2;1;3;24994;25489;19;50483
01;2020-10-25;3;0;3;17868;16690;29;34558
01;2020-10-25;1;0;1;22328;14821;39;37149
01;2020-10-25;0;0;0;28652;20276;49;48928
01;2020-10-25;0;1;1;33264;27260;59;60524
01;2020-10-25;1;1;2;27135;23978;69;51113
01;2020-10-25;1;0;1;18401;14661;79;33062
01;2020-10-25;0;1;1;9633;6375;89;16008
01;2020-10-25;0;0;0;3410;1510;90;4920
01;2020-10-25;8;4;12;205664;171215;0;376879
02;2020-10-25;0;1;1;16881;17110;09;33991
02;2020-10-25;0;0;0;21410;21604;19;43014
02;2020-10-25;2;1;3;16017;15479;29;31496
02;2020-10-25;0;0;0;19825;14455;39;34280
02;2020-10-25;1;0;1;24719;18248;49;42967
02;2020-10-25;1;1;2;34361;28310;59;62671
02;2020-10-25;1;1;2;28061;24495;69;52556
02;2020-10-25;0;1;1;18231;15278;79;33509
02;2020-10-25;0;0;0;11090;7677;89;18767
02;2020-10-25;0;0;0;3992;1506;90;5498
02;2020-10-25;5;5;10;194587;164162;0;358749
03;2020-10-25;0;0;0;31123;30920;09;62043
03;2020-10-25;0;0;0;29370;29268;19;58638
03;2020-10-25;0;2;2;21458;18963;29;40421
03;2020-10-25;0;0;0;21276;18326;39;39602
03;2020-10-25;0;0;0;18164;16593;49;34757
03;2020-10-25;0;0;0;13469;13557;59;27026
03;2020-10-25;0;0;0;8776;8670;69;17446
03;2020-10-25;0;0;0;3777;3591;79;7368
03;2020-10-25;0;0;0;1649;1072;89;2721
03;2020-10-25;0;0;0;485;184;90;669
03;2020-10-25;0;2;2;149547;141144;0;290691
04;2020-10-25;0;0;0;60314;61377;09;121691
04;2020-10-25;2;2;4;66065;68387;19;134452
04;2020-10-25;1;1;2;51059;47156;29;98215
04;2020-10-25;1;2;3;58788;45780;39;104568
04;2020-10-25;3;2;5;61408;52207;49;113615
04;2020-10-25;3;2;5;64838;60759;59;125597
04;2020-10-25;0;1;1;47008;42843;69;89851
04;2020-10-25;0;0;0;25509;21184;79;46693
04;2020-10-25;0;0;0;13168;7647;89;20815
04;2020-10-25;0;0;0;3209;1253;90;4462
04;2020-10-25;10;10;20;451366;408593;0;859959
05;2020-10-25;0;0;0;362.366008612902;341.338819562748;09;703.704828175651
05;2020-10-25;0;0;0;353.376145114279;370.349735405642;19;723.725880519921
05;2020-10-25;0;0;0;218.593559489256;256.539602589476;29;475.133162078732
05;2020-10-25;0;0;0;404.225408693299;360.321910454353;39;764.547319147651
05;2020-10-25;0;0;0;520.067953604221;497.108383964256;49;1017.17633756848
05;2020-10-25;0;0;0;468.146063921917;510.087601910415;59;978.233665832332
05;2020-10-25;0;0;0;340.368470050554;334.366842191253;69;674.735312241807
05;2020-10-25;0;0;0;212.598666888387;192.597753227106;79;405.196420115493
05;2020-10-25;0;0;0;148.727797095705;61.8681715431829;89;210.595968638888
05;2020-10-25;0;0;0;32.9601271090696;10.9909785719784;90;43.9511056810479
05;2020-10-25;0;0;0;3061.43020057959;2935.56979942041;0;5997
06;2020-10-25;0;0;0;42583;42380;09;84963
06;2020-10-25;0;0;0;33369;31925;19;65294
06;2020-10-25;0;0;0;21571;15080;29;36651
06;2020-10-25;0;0;0;21550;16147;39;37697
06;2020-10-25;0;1;1;14193;13939;49;28132
06;2020-10-25;1;0;1;7171;7597;59;14768
06;2020-10-25;0;0;0;3629;4117;69;7746
06;2020-10-25;1;0;1;1577;1457;79;3034
06;2020-10-25;0;0;0;531;474;89;1005
06;2020-10-25;0;0;0;88;93;90;181
06;2020-10-25;2;1;3;146262;133209;0;279471
07;2020-10-25;0;0;0;485;549;09;1034
07;2020-10-25;0;0;0;403;432;19;835
07;2020-10-25;0;0;0;764;841;29;1605
07;2020-10-25;0;0;0;824;928;39;1752
07;2020-10-25;0;0;0;788;1020;49;1808
07;2020-10-25;0;0;0;678;870;59;1548
07;2020-10-25;0;0;0;360;382;69;742
07;2020-10-25;0;0;0;231;190;79;421
07;2020-10-25;0;0;0;114;67;89;181
07;2020-10-25;0;0;0;24;11;90;35
07;2020-10-25;0;0;0;4671;5290;0;9961
08;2020-10-25;0;0;0;2715.22592983026;2997.75551488675;09;5712.98144471701
08;2020-10-25;0;0;0;2778.51901080978;3160.9156459093;19;5939.43465671908
08;2020-10-25;0;0;0;2080.8882988764;1718.16634315323;29;3799.05464202964
08;2020-10-25;0;0;0;2701.8582062647;1896.52641413317;39;4598.38462039786
08;2020-10-25;0;0;0;3151.45861023308;2460.52498233809;49;5611.98359257117
08;2020-10-25;0;0;0;2620.29868333099;2422.23566154656;59;5042.53434487755
08;2020-10-25;0;1;1;1621.44173420671;1438.58325779464;69;3060.02499200135
08;2020-10-25;0;0;0;626.575909335673;526.358467843651;79;1152.93437717932
08;2020-10-25;0;0;0;205.018522985054;140.993639349697;89;346.012162334751
08;2020-10-25;0;0;0;50.0325684687745;20.62259870351;90;70.6551671722846
08;2020-10-25;0;1;1;18551.3174743414;16782.6825256586;0;35334
11;2020-10-25;6;15;22;783071;811785;09;1594856
11;2020-10-25;45;43;88;761456;784653;19;1546109
11;2020-10-25;147;85;233;850145;801772;29;1651917
11;2020-10-25;96;124;220;914360;843488;39;1757848
11;2020-10-25;106;114;220;845609;826202;49;1671811
11;2020-10-25;88;88;176;793566;745070;59;1538636
11;2020-10-25;64;77;142;628649;549192;69;1177841
11;2020-10-25;36;41;77;434606;358356;79;792962
11;2020-10-25;28;36;64;261425;162933;89;424358
11;2020-10-25;21;12;33;89253;32619;90;121872
11;2020-10-25;637;635;1275;6362140;5916070;0;12278210
24;2020-10-25;2;6;8;139720;144686;09;284406
24;2020-10-25;13;16;29;152979;161185;19;314164
24;2020-10-25;39;38;77;122237;126536;29;248773
24;2020-10-25;27;26;53;150359;142009;39;292368
24;2020-10-25;19;22;41;161829;158758;49;320587
24;2020-10-25;17;29;46;172552;168011;59;340563
24;2020-10-25;15;15;30;172509;158177;69;330686
24;2020-10-25;5;14;19;129428;110593;79;240021
24;2020-10-25;8;9;17;87342;56882;89;144224
24;2020-10-25;2;4;6;31210;12071;90;43281
24;2020-10-25;147;179;327;1320165;1238908;0;2559073
27;2020-10-25;1;1;2;143373;149679;09;293052
27;2020-10-25;10;13;23;160962;173003;19;333965
27;2020-10-25;10;23;33;133746;142254;29;276000
27;2020-10-25;25;21;46;160004;155407;39;315411
27;2020-10-25;39;25;64;172333;169564;49;341897
27;2020-10-25;17;25;42;189979;183788;59;373767
27;2020-10-25;15;23;38;192591;178206;69;370797
27;2020-10-25;11;14;25;146876;127546;79;274422
27;2020-10-25;18;13;31;96896;61575;89;158471
27;2020-10-25;17;11;28;33148;12109;90;45257
27;2020-10-25;163;169;332;1429908;1353131;0;2783039
28;2020-10-25;5;1;6;180735;186856;09;367591
28;2020-10-25;19;14;33;200125;213621;19;413746
28;2020-10-25;32;25;57;168922;173007;29;341929
28;2020-10-25;32;35;67;196628;188487;39;385115
28;2020-10-25;29;29;58;205396;201699;49;407095
28;2020-10-25;23;18;42;222002;213866;59;435868
28;2020-10-25;18;18;36;224688;203758;69;428446
28;2020-10-25;17;11;28;163192;135543;79;298735
28;2020-10-25;14;11;25;109691;65377;89;175068
28;2020-10-25;11;3;14;37222;12685;90;49907
28;2020-10-25;200;165;366;1708601;1594899;0;3303500
32;2020-10-25;27;25;53;358062;373689;09;731751
32;2020-10-25;119;88;212;387045;406742;19;793787
32;2020-10-25;166;127;304;342304;348587;29;690891
32;2020-10-25;149;125;278;382485;369972;39;752457
32;2020-10-25;116;107;232;382510;376716;49;759226
32;2020-10-25;84;92;180;386937;376527;59;763464
32;2020-10-25;42;47;93;371211;330938;69;702149
32;2020-10-25;30;33;64;250542;201459;79;452001
32;2020-10-25;38;18;58;163399;89786;89;253185
32;2020-10-25;15;6;21;48384;15367;90;63751
32;2020-10-25;786;668;1495;3072879;2889783;0;5962662
44;2020-10-25;3;1;4;291525;306839;09;598364
44;2020-10-25;11;5;16;320255;339504;19;659759
44;2020-10-25;27;26;53;302020;314428;29;616448
44;2020-10-25;19;18;37;342222;333292;39;675514
44;2020-10-25;26;17;43;349727;344491;49;694218
44;2020-10-25;23;18;41;381371;373239;59;754610
44;2020-10-25;11;19;30;367165;335850;69;703015
44;2020-10-25;17;15;32;250387;215436;79;465823
44;2020-10-25;16;16;32;170825;105192;89;276017
44;2020-10-25;14;7;21;51248;16731;90;67979
44;2020-10-25;167;142;309;2826745;2685002;0;5511747
52;2020-10-25;1;0;1;213594;223900;09;437494
52;2020-10-25;6;7;13;240818;255197;19;496015
52;2020-10-25;21;21;42;197010;200630;29;397640
52;2020-10-25;18;14;32;231204;224885;39;456089
52;2020-10-25;16;8;24;243874;243418;49;487292
52;2020-10-25;21;16;37;244100;239116;59;483216
52;2020-10-25;5;11;16;241796;221345;69;463141
52;2020-10-25;5;4;9;177805;149903;79;327708
52;2020-10-25;16;11;27;119561;75822;89;195383
52;2020-10-25;5;5;10;42559;15260;90;57819
52;2020-10-25;114;97;211;1952321;1849476;0;3801797
53;2020-10-25;2;5;7;173813;182358;09;356171
53;2020-10-25;8;9;17;202720;214740;19;417460
53;2020-10-25;23;19;42;163116;173196;29;336312
53;2020-10-25;20;18;38;190526;187674;39;378200
53;2020-10-25;13;10;23;212098;212015;49;424113
53;2020-10-25;19;13;32;223699;219176;59;442875
53;2020-10-25;9;7;16;227435;209274;69;436709
53;2020-10-25;6;7;13;169992;140910;79;310902
53;2020-10-25;7;2;9;118117;69883;89;188000
53;2020-10-25;3;0;3;37370;12267;90;49637
53;2020-10-25;110;90;200;1718886;1621493;0;3340379
75;2020-10-25;7;7;14;293104;305291;09;598395
75;2020-10-25;11;14;25;337141;357785;19;694926
75;2020-10-25;37;22;59;295024;300618;29;595642
75;2020-10-25;22;15;37;347871;331233;39;679104
75;2020-10-25;22;15;37;384742;372771;49;757513
75;2020-10-25;19;16;35;413361;390880;59;804241
75;2020-10-25;6;8;14;425623;384060;69;809683
75;2020-10-25;4;5;9;325086;276298;79;601384
75;2020-10-25;12;11;23;213986;139308;89;353294
75;2020-10-25;7;3;10;77600;28200;90;105800
75;2020-10-25;147;116;263;3113538;2886444;0;5999982
76;2020-10-25;8;6;15;305956;318589;09;624545
76;2020-10-25;32;36;68;338942;356969;19;695911
76;2020-10-25;81;61;142;316210;319570;29;635780
76;2020-10-25;66;46;113;356758;337587;39;694345
76;2020-10-25;42;47;90;376541;363812;49;740353
76;2020-10-25;45;41;86;402608;383750;59;786358
76;2020-10-25;24;31;55;394889;358997;69;753886
76;2020-10-25;18;24;42;308664;263806;79;572470
76;2020-10-25;23;22;45;195838;129272;89;325110
76;2020-10-25;22;6;28;69372;26728;90;96100
76;2020-10-25;361;320;684;3065778;2859080;0;5924858
84;2020-10-25;12;15;27;459549;481088;09;940637
84;2020-10-25;46;35;81;487711;511905;19;999616
84;2020-10-25;109;60;169;443824;451094;29;894918
84;2020-10-25;105;78;185;512522;493262;39;1005784
84;2020-10-25;92;82;174;520248;515106;49;1035354
84;2020-10-25;91;83;174;529611;514848;59;1044459
84;2020-10-25;62;59;121;486720;439940;69;926660
84;2020-10-25;60;77;137;372151;315211;79;687362
84;2020-10-25;80;56;136;237198;150524;89;387722
84;2020-10-25;45;21;66;81185;28680;90;109865
84;2020-10-25;702;566;1270;4130719;3901658;0;8032377
93;2020-10-25;4;4;8;268834;283093;09;551927
93;2020-10-25;13;11;24;280751;296087;19;576838
93;2020-10-25;38;20;58;254404;255552;29;509956
93;2020-10-25;27;24;51;310704;288398;39;599102
93;2020-10-25;33;13;46;325559;305827;49;631386
93;2020-10-25;30;30;61;353104;325389;59;678493
93;2020-10-25;15;20;35;336327;296459;69;632786
93;2020-10-25;18;17;35;279820;229699;79;509519
93;2020-10-25;30;18;48;171274;113716;89;284990
93;2020-10-25;13;5;18;58896;21758;90;80654
93;2020-10-25;222;162;385;2639673;2415978;0;5055651
94;2020-10-25;0;0;0;16311;17433;09;33744
94;2020-10-25;0;1;1;16679;18132;19;34811
94;2020-10-25;1;1;2;16782;16579;29;33361
94;2020-10-25;0;2;2;23044;20580;39;43624
94;2020-10-25;0;0;0;23065;22140;49;45205
94;2020-10-25;0;2;2;24549;23421;59;47970
94;2020-10-25;0;1;1;23212;21883;69;45095
94;2020-10-25;1;1;2;19544;17141;79;36685
94;2020-10-25;1;1;2;11227;8178;89;19405
94;2020-10-25;0;0;0;3332;1447;90;4779
94;2020-10-25;3;9;12;177745;166934;0;344679
01;2020-10-26;0;1;1;19979;20155;09;40134
01;2020-10-26;2;2;4;24994;25489;19;50483
01;2020-10-26;5;3;8;17868;16690;29;34558
01;2020-10-26;5;2;7;22328;14821;39;37149
01;2020-10-26;4;1;5;28652;20276;49;48928
01;2020-10-26;10;10;20;33264;27260;59;60524
01;2020-10-26;7;9;16;27135;23978;69;51113
01;2020-10-26;1;1;2;18401;14661;79;33062
01;2020-10-26;0;0;0;9633;6375;89;16008
01;2020-10-26;0;1;1;3410;1510;90;4920
01;2020-10-26;34;30;64;205664;171215;0;376879
02;2020-10-26;1;1;2;16881;17110;09;33991
02;2020-10-26;10;7;17;21410;21604;19;43014
02;2020-10-26;13;9;22;16017;15479;29;31496
02;2020-10-26;16;12;28;19825;14455;39;34280
02;2020-10-26;14;10;24;24719;18248;49;42967
02;2020-10-26;10;15;25;34361;28310;59;62671
02;2020-10-26;8;10;18;28061;24495;69;52556
02;2020-10-26;2;3;5;18231;15278;79;33509
02;2020-10-26;1;0;1;11090;7677;89;18767
02;2020-10-26;0;0;0;3992;1506;90;5498
02;2020-10-26;75;67;142;194587;164162;0;358749
03;2020-10-26;0;0;0;31123;30920;09;62043
03;2020-10-26;0;2;2;29370;29268;19;58638
03;2020-10-26;3;1;4;21458;18963;29;40421
03;2020-10-26;2;2;4;21276;18326;39;39602
03;2020-10-26;4;1;5;18164;16593;49;34757
03;2020-10-26;1;0;1;13469;13557;59;27026
03;2020-10-26;0;2;2;8776;8670;69;17446
03;2020-10-26;0;0;0;3777;3591;79;7368
03;2020-10-26;0;0;0;1649;1072;89;2721
03;2020-10-26;0;0;0;485;184;90;669
03;2020-10-26;10;8;18;149547;141144;0;290691
04;2020-10-26;4;3;7;60314;61377;09;121691
04;2020-10-26;11;7;18;66065;68387;19;134452
04;2020-10-26;15;9;24;51059;47156;29;98215
04;2020-10-26;13;7;20;58788;45780;39;104568
04;2020-10-26;13;9;22;61408;52207;49;113615
04;2020-10-26;8;10;18;64838;60759;59;125597
04;2020-10-26;8;5;13;47008;42843;69;89851
04;2020-10-26;1;0;1;25509;21184;79;46693
04;2020-10-26;3;2;5;13168;7647;89;20815
04;2020-10-26;3;0;3;3209;1253;90;4462
04;2020-10-26;79;52;131;451366;408593;0;859959
05;2020-10-26;0;0;0;362.366008612902;341.338819562748;09;703.704828175651
05;2020-10-26;0;0;0;353.376145114279;370.349735405642;19;723.725880519921
05;2020-10-26;0;0;0;218.593559489256;256.539602589476;29;475.133162078732
05;2020-10-26;0;0;0;404.225408693299;360.321910454353;39;764.547319147651
05;2020-10-26;0;0;0;520.067953604221;497.108383964256;49;1017.17633756848
05;2020-10-26;1;0;1;468.146063921917;510.087601910415;59;978.233665832332
05;2020-10-26;0;0;0;340.368470050554;334.366842191253;69;674.735312241807
05;2020-10-26;0;0;0;212.598666888387;192.597753227106;79;405.196420115493
05;2020-10-26;0;0;0;148.727797095705;61.8681715431829;89;210.595968638888
05;2020-10-26;0;0;0;32.9601271090696;10.9909785719784;90;43.9511056810479
05;2020-10-26;1;0;1;3061.43020057959;2935.56979942041;0;5997
06;2020-10-26;0;0;0;42583;42380;09;84963
06;2020-10-26;8;6;14;33369;31925;19;65294
06;2020-10-26;8;5;13;21571;15080;29;36651
06;2020-10-26;8;3;11;21550;16147;39;37697
06;2020-10-26;4;1;5;14193;13939;49;28132
06;2020-10-26;0;3;3;7171;7597;59;14768
06;2020-10-26;0;2;2;3629;4117;69;7746
06;2020-10-26;0;0;0;1577;1457;79;3034
06;2020-10-26;0;0;0;531;474;89;1005
06;2020-10-26;0;0;0;88;93;90;181
06;2020-10-26;28;20;48;146262;133209;0;279471
07;2020-10-26;0;0;0;485;549;09;1034
07;2020-10-26;0;0;0;403;432;19;835
07;2020-10-26;0;0;0;764;841;29;1605
07;2020-10-26;0;1;1;824;928;39;1752
07;2020-10-26;0;1;1;788;1020;49;1808
07;2020-10-26;0;0;0;678;870;59;1548
07;2020-10-26;0;0;0;360;382;69;742
07;2020-10-26;0;1;1;231;190;79;421
07;2020-10-26;0;0;0;114;67;89;181
07;2020-10-26;0;0;0;24;11;90;35
07;2020-10-26;0;3;3;4671;5290;0;9961
08;2020-10-26;0;0;0;2715.22592983026;2997.75551488675;09;5712.98144471701
08;2020-10-26;2;2;4;2778.51901080978;3160.9156459093;19;5939.43465671908
08;2020-10-26;2;0;2;2080.8882988764;1718.16634315323;29;3799.05464202964
08;2020-10-26;1;0;1;2701.8582062647;1896.52641413317;39;4598.38462039786
08;2020-10-26;0;0;0;3151.45861023308;2460.52498233809;49;5611.98359257117
08;2020-10-26;3;1;4;2620.29868333099;2422.23566154656;59;5042.53434487755
08;2020-10-26;0;0;0;1621.44173420671;1438.58325779464;69;3060.02499200135
08;2020-10-26;0;0;0;626.575909335673;526.358467843651;79;1152.93437717932
08;2020-10-26;0;0;0;205.018522985054;140.993639349697;89;346.012162334751
08;2020-10-26;0;0;0;50.0325684687745;20.62259870351;90;70.6551671722846
08;2020-10-26;8;3;11;18551.3174743414;16782.6825256586;0;35334
11;2020-10-26;133;121;279;783071;811785;09;1594856
11;2020-10-26;683;646;1388;761456;784653;19;1546109
11;2020-10-26;1524;1250;2780;850145;801772;29;1651917
11;2020-10-26;1483;1213;2707;914360;843488;39;1757848
11;2020-10-26;1274;1164;2443;845609;826202;49;1671811
11;2020-10-26;1108;982;2096;793566;745070;59;1538636
11;2020-10-26;739;673;1424;628649;549192;69;1177841
11;2020-10-26;321;284;610;434606;358356;79;792962
11;2020-10-26;223;164;387;261425;162933;89;424358
11;2020-10-26;101;33;134;89253;32619;90;121872
11;2020-10-26;7594;6538;14263;6362140;5916070;0;12278210
24;2020-10-26;11;5;16;139720;144686;09;284406
24;2020-10-26;83;90;174;152979;161185;19;314164
24;2020-10-26;168;132;300;122237;126536;29;248773
24;2020-10-26;157;145;302;150359;142009;39;292368
24;2020-10-26;153;136;289;161829;158758;49;320587
24;2020-10-26;134;136;270;172552;168011;59;340563
24;2020-10-26;111;117;228;172509;158177;69;330686
24;2020-10-26;61;77;138;129428;110593;79;240021
24;2020-10-26;48;24;72;87342;56882;89;144224
24;2020-10-26;30;14;44;31210;12071;90;43281
24;2020-10-26;956;877;1834;1320165;1238908;0;2559073
27;2020-10-26;27;29;57;143373;149679;09;293052
27;2020-10-26;137;144;283;160962;173003;19;333965
27;2020-10-26;242;226;468;133746;142254;29;276000
27;2020-10-26;265;192;457;160004;155407;39;315411
27;2020-10-26;253;213;466;172333;169564;49;341897
27;2020-10-26;258;199;457;189979;183788;59;373767
27;2020-10-26;199;218;417;192591;178206;69;370797
27;2020-10-26;124;142;266;146876;127546;79;274422
27;2020-10-26;99;69;168;96896;61575;89;158471
27;2020-10-26;76;23;99;33148;12109;90;45257
27;2020-10-26;1680;1455;3138;1429908;1353131;0;2783039
28;2020-10-26;27;22;50;180735;186856;09;367591
28;2020-10-26;135;100;239;200125;213621;19;413746
28;2020-10-26;193;144;337;168922;173007;29;341929
28;2020-10-26;191;146;337;196628;188487;39;385115
28;2020-10-26;179;158;337;205396;201699;49;407095
28;2020-10-26;205;178;383;222002;213866;59;435868
28;2020-10-26;171;115;286;224688;203758;69;428446
28;2020-10-26;76;81;157;163192;135543;79;298735
28;2020-10-26;78;36;114;109691;65377;89;175068
28;2020-10-26;33;13;46;37222;12685;90;49907
28;2020-10-26;1288;993;2286;1708601;1594899;0;3303500
32;2020-10-26;96;100;196;358062;373689;09;731751
32;2020-10-26;397;473;870;387045;406742;19;793787
32;2020-10-26;630;514;1145;342304;348587;29;690891
32;2020-10-26;688;583;1271;382485;369972;39;752457
32;2020-10-26;678;592;1272;382510;376716;49;759226
32;2020-10-26;532;470;1003;386937;376527;59;763464
32;2020-10-26;332;358;690;371211;330938;69;702149
32;2020-10-26;243;206;449;250542;201459;79;452001
32;2020-10-26;195;94;289;163399;89786;89;253185
32;2020-10-26;118;32;150;48384;15367;90;63751
32;2020-10-26;3910;3422;7336;3072879;2889783;0;5962662
44;2020-10-26;49;51;100;291525;306839;09;598364
44;2020-10-26;233;263;496;320255;339504;19;659759
44;2020-10-26;520;488;1008;302020;314428;29;616448
44;2020-10-26;448;435;884;342222;333292;39;675514
44;2020-10-26;409;380;789;349727;344491;49;694218
44;2020-10-26;406;379;785;381371;373239;59;754610
44;2020-10-26;296;253;549;367165;335850;69;703015
44;2020-10-26;170;154;324;250387;215436;79;465823
44;2020-10-26;142;92;234;170825;105192;89;276017
44;2020-10-26;79;17;96;51248;16731;90;67979
44;2020-10-26;2752;2512;5265;2826745;2685002;0;5511747
52;2020-10-26;22;16;39;213594;223900;09;437494
52;2020-10-26;153;143;301;240818;255197;19;496015
52;2020-10-26;225;221;446;197010;200630;29;397640
52;2020-10-26;206;177;386;231204;224885;39;456089
52;2020-10-26;235;188;423;243874;243418;49;487292
52;2020-10-26;184;172;357;244100;239116;59;483216
52;2020-10-26;140;127;267;241796;221345;69;463141
52;2020-10-26;97;90;187;177805;149903;79;327708
52;2020-10-26;95;59;154;119561;75822;89;195383
52;2020-10-26;80;27;107;42559;15260;90;57819
52;2020-10-26;1437;1220;2667;1952321;1849476;0;3801797
53;2020-10-26;19;26;45;173813;182358;09;356171
53;2020-10-26;78;87;166;202720;214740;19;417460
53;2020-10-26;172;115;292;163116;173196;29;336312
53;2020-10-26;130;102;232;190526;187674;39;378200
53;2020-10-26;134;95;229;212098;212015;49;424113
53;2020-10-26;113;101;214;223699;219176;59;442875
53;2020-10-26;78;86;164;227435;209274;69;436709
53;2020-10-26;58;45;103;169992;140910;79;310902
53;2020-10-26;42;17;59;118117;69883;89;188000
53;2020-10-26;13;4;17;37370;12267;90;49637
53;2020-10-26;837;678;1521;1718886;1621493;0;3340379
75;2020-10-26;36;35;74;293104;305291;09;598395
75;2020-10-26;165;160;329;337141;357785;19;694926
75;2020-10-26;406;295;703;295024;300618;29;595642
75;2020-10-26;288;221;510;347871;331233;39;679104
75;2020-10-26;279;241;520;384742;372771;49;757513
75;2020-10-26;261;252;514;413361;390880;59;804241
75;2020-10-26;178;180;359;425623;384060;69;809683
75;2020-10-26;134;98;232;325086;276298;79;601384
75;2020-10-26;109;71;180;213986;139308;89;353294
75;2020-10-26;90;25;115;77600;28200;90;105800
75;2020-10-26;1947;1580;3539;3113538;2886444;0;5999982
76;2020-10-26;29;38;75;305956;318589;09;624545
76;2020-10-26;279;238;528;338942;356969;19;695911
76;2020-10-26;442;370;812;316210;319570;29;635780
76;2020-10-26;440;353;794;356758;337587;39;694345
76;2020-10-26;472;367;840;376541;363812;49;740353
76;2020-10-26;425;359;785;402608;383750;59;786358
76;2020-10-26;288;274;562;394889;358997;69;753886
76;2020-10-26;194;185;379;308664;263806;79;572470
76;2020-10-26;164;109;273;195838;129272;89;325110
76;2020-10-26;132;51;183;69372;26728;90;96100
76;2020-10-26;2870;2347;5239;3065778;2859080;0;5924858
84;2020-10-26;113;110;225;459549;481088;09;940637
84;2020-10-26;713;717;1433;487711;511905;19;999616
84;2020-10-26;1336;1040;2379;443824;451094;29;894918
84;2020-10-26;1183;1031;2214;512522;493262;39;1005784
84;2020-10-26;1278;1079;2357;520248;515106;49;1035354
84;2020-10-26;1191;1068;2261;529611;514848;59;1044459
84;2020-10-26;750;664;1414;486720;439940;69;926660
84;2020-10-26;517;484;1002;372151;315211;79;687362
84;2020-10-26;482;263;745;237198;150524;89;387722
84;2020-10-26;354;112;466;81185;28680;90;109865
84;2020-10-26;7918;6570;14500;4130719;3901658;0;8032377
93;2020-10-26;58;59;118;268834;283093;09;551927
93;2020-10-26;293;261;554;280751;296087;19;576838
93;2020-10-26;473;364;838;254404;255552;29;509956
93;2020-10-26;522;420;946;310704;288398;39;599102
93;2020-10-26;502;427;931;325559;305827;49;631386
93;2020-10-26;559;453;1012;353104;325389;59;678493
93;2020-10-26;338;312;651;336327;296459;69;632786
93;2020-10-26;240;205;445;279820;229699;79;509519
93;2020-10-26;234;121;355;171274;113716;89;284990
93;2020-10-26;165;51;216;58896;21758;90;80654
93;2020-10-26;3385;2675;6069;2639673;2415978;0;5055651
94;2020-10-26;3;2;5;16311;17433;09;33744
94;2020-10-26;9;8;18;16679;18132;19;34811
94;2020-10-26;24;21;45;16782;16579;29;33361
94;2020-10-26;30;18;48;23044;20580;39;43624
94;2020-10-26;30;25;55;23065;22140;49;45205
94;2020-10-26;20;28;48;24549;23421;59;47970
94;2020-10-26;15;19;34;23212;21883;69;45095
94;2020-10-26;11;5;16;19544;17141;79;36685
94;2020-10-26;2;5;7;11227;8178;89;19405
94;2020-10-26;2;1;3;3332;1447;90;4779
94;2020-10-26;146;132;279;177745;166934;0;344679
01;2020-10-27;1;0;1;19979;20155;09;40134
01;2020-10-27;2;0;2;24994;25489;19;50483
01;2020-10-27;3;1;4;17868;16690;29;34558
01;2020-10-27;5;3;8;22328;14821;39;37149
01;2020-10-27;12;2;14;28652;20276;49;48928
01;2020-10-27;3;5;8;33264;27260;59;60524
01;2020-10-27;3;2;6;27135;23978;69;51113
01;2020-10-27;4;2;6;18401;14661;79;33062
01;2020-10-27;1;2;3;9633;6375;89;16008
01;2020-10-27;0;0;0;3410;1510;90;4920
01;2020-10-27;34;17;52;205664;171215;0;376879
02;2020-10-27;1;1;2;16881;17110;09;33991
02;2020-10-27;13;1;14;21410;21604;19;43014
02;2020-10-27;17;12;29;16017;15479;29;31496
02;2020-10-27;10;7;17;19825;14455;39;34280
02;2020-10-27;21;7;28;24719;18248;49;42967
02;2020-10-27;15;13;28;34361;28310;59;62671
02;2020-10-27;11;8;19;28061;24495;69;52556
02;2020-10-27;4;3;7;18231;15278;79;33509
02;2020-10-27;1;0;1;11090;7677;89;18767
02;2020-10-27;0;0;0;3992;1506;90;5498
02;2020-10-27;93;52;145;194587;164162;0;358749
03;2020-10-27;0;0;0;31123;30920;09;62043
03;2020-10-27;2;3;5;29370;29268;19;58638
03;2020-10-27;3;6;9;21458;18963;29;40421
03;2020-10-27;6;3;9;21276;18326;39;39602
03;2020-10-27;0;1;1;18164;16593;49;34757
03;2020-10-27;2;1;3;13469;13557;59;27026
03;2020-10-27;0;1;1;8776;8670;69;17446
03;2020-10-27;0;0;0;3777;3591;79;7368
03;2020-10-27;0;0;0;1649;1072;89;2721
03;2020-10-27;0;0;0;485;184;90;669
03;2020-10-27;13;15;28;149547;141144;0;290691
04;2020-10-27;2;1;3;60314;61377;09;121691
04;2020-10-27;8;7;15;66065;68387;19;134452
04;2020-10-27;7;9;16;51059;47156;29;98215
04;2020-10-27;14;8;22;58788;45780;39;104568
04;2020-10-27;9;6;15;61408;52207;49;113615
04;2020-10-27;9;11;20;64838;60759;59;125597
04;2020-10-27;3;4;7;47008;42843;69;89851
04;2020-10-27;4;3;7;25509;21184;79;46693
04;2020-10-27;1;1;2;13168;7647;89;20815
04;2020-10-27;0;1;1;3209;1253;90;4462
04;2020-10-27;57;51;108;451366;408593;0;859959
05;2020-10-27;0;0;0;362.366008612902;341.338819562748;09;703.704828175651
05;2020-10-27;0;0;0;353.376145114279;370.349735405642;19;723.725880519921
05;2020-10-27;0;0;0;218.593559489256;256.539602589476;29;475.133162078732
05;2020-10-27;0;0;0;404.225408693299;360.321910454353;39;764.547319147651
05;2020-10-27;0;0;0;520.067953604221;497.108383964256;49;1017.17633756848
05;2020-10-27;0;0;0;468.146063921917;510.087601910415;59;978.233665832332
05;2020-10-27;0;0;0;340.368470050554;334.366842191253;69;674.735312241807
05;2020-10-27;0;0;0;212.598666888387;192.597753227106;79;405.196420115493
05;2020-10-27;0;0;0;148.727797095705;61.8681715431829;89;210.595968638888
05;2020-10-27;0;0;0;32.9601271090696;10.9909785719784;90;43.9511056810479
05;2020-10-27;0;0;0;3061.43020057959;2935.56979942041;0;5997
06;2020-10-27;0;0;0;42583;42380;09;84963
06;2020-10-27;0;1;1;33369;31925;19;65294
06;2020-10-27;3;2;5;21571;15080;29;36651
06;2020-10-27;3;0;3;21550;16147;39;37697
06;2020-10-27;2;1;3;14193;13939;49;28132
06;2020-10-27;1;2;3;7171;7597;59;14768
06;2020-10-27;0;2;2;3629;4117;69;7746
06;2020-10-27;0;1;1;1577;1457;79;3034
06;2020-10-27;0;0;0;531;474;89;1005
06;2020-10-27;0;0;0;88;93;90;181
06;2020-10-27;9;9;18;146262;133209;0;279471
07;2020-10-27;0;0;0;485;549;09;1034
07;2020-10-27;0;0;0;403;432;19;835
07;2020-10-27;0;0;0;764;841;29;1605
07;2020-10-27;0;0;0;824;928;39;1752
07;2020-10-27;1;0;1;788;1020;49;1808
07;2020-10-27;1;0;1;678;870;59;1548
07;2020-10-27;0;0;0;360;382;69;742
07;2020-10-27;1;0;1;231;190;79;421
07;2020-10-27;0;0;0;114;67;89;181
07;2020-10-27;0;0;0;24;11;90;35
07;2020-10-27;3;0;3;4671;5290;0;9961
08;2020-10-27;0;0;0;2715.22592983026;2997.75551488675;09;5712.98144471701
08;2020-10-27;0;1;1;2778.51901080978;3160.9156459093;19;5939.43465671908
08;2020-10-27;1;2;3;2080.8882988764;1718.16634315323;29;3799.05464202964
08;2020-10-27;0;0;0;2701.8582062647;1896.52641413317;39;4598.38462039786
08;2020-10-27;1;1;2;3151.45861023308;2460.52498233809;49;5611.98359257117
08;2020-10-27;0;1;1;2620.29868333099;2422.23566154656;59;5042.53434487755
08;2020-10-27;3;2;5;1621.44173420671;1438.58325779464;69;3060.02499200135
08;2020-10-27;0;0;0;626.575909335673;526.358467843651;79;1152.93437717932
08;2020-10-27;0;0;0;205.018522985054;140.993639349697;89;346.012162334751
08;2020-10-27;0;0;0;50.0325684687745;20.62259870351;90;70.6551671722846
08;2020-10-27;5;7;12;18551.3174743414;16782.6825256586;0;35334
11;2020-10-27;95;113;216;783071;811785;09;1594856
11;2020-10-27;603;531;1167;761456;784653;19;1546109
11;2020-10-27;1402;1125;2540;850145;801772;29;1651917
11;2020-10-27;1229;1129;2365;914360;843488;39;1757848
11;2020-10-27;1185;914;2111;845609;826202;49;1671811
11;2020-10-27;981;882;1872;793566;745070;59;1538636
11;2020-10-27;639;628;1273;628649;549192;69;1177841
11;2020-10-27;262;276;541;434606;358356;79;792962
11;2020-10-27;186;124;310;261425;162933;89;424358
11;2020-10-27;94;34;129;89253;32619;90;121872
11;2020-10-27;6679;5759;12571;6362140;5916070;0;12278210
24;2020-10-27;9;17;26;139720;144686;09;284406
24;2020-10-27;88;104;199;152979;161185;19;314164
24;2020-10-27;177;144;321;122237;126536;29;248773
24;2020-10-27;151;134;285;150359;142009;39;292368
24;2020-10-27;191;141;332;161829;158758;49;320587
24;2020-10-27;153;134;287;172552;168011;59;340563
24;2020-10-27;121;107;228;172509;158177;69;330686
24;2020-10-27;69;73;142;129428;110593;79;240021
24;2020-10-27;44;20;64;87342;56882;89;144224
24;2020-10-27;30;9;39;31210;12071;90;43281
24;2020-10-27;1033;883;1923;1320165;1238908;0;2559073
27;2020-10-27;17;22;39;143373;149679;09;293052
27;2020-10-27;146;124;270;160962;173003;19;333965
27;2020-10-27;222;193;415;133746;142254;29;276000
27;2020-10-27;241;190;431;160004;155407;39;315411
27;2020-10-27;249;225;474;172333;169564;49;341897
27;2020-10-27;249;210;459;189979;183788;59;373767
27;2020-10-27;195;138;333;192591;178206;69;370797
27;2020-10-27;119;113;232;146876;127546;79;274422
27;2020-10-27;109;58;167;96896;61575;89;158471
27;2020-10-27;76;17;93;33148;12109;90;45257
27;2020-10-27;1623;1290;2913;1429908;1353131;0;2783039
28;2020-10-27;32;21;54;180735;186856;09;367591
28;2020-10-27;113;91;209;200125;213621;19;413746
28;2020-10-27;175;139;315;168922;173007;29;341929
28;2020-10-27;186;168;355;196628;188487;39;385115
28;2020-10-27;207;145;352;205396;201699;49;407095
28;2020-10-27;204;153;357;222002;213866;59;435868
28;2020-10-27;153;119;272;224688;203758;69;428446
28;2020-10-27;82;92;174;163192;135543;79;298735
28;2020-10-27;80;36;116;109691;65377;89;175068
28;2020-10-27;45;9;54;37222;12685;90;49907
28;2020-10-27;1277;973;2258;1708601;1594899;0;3303500
32;2020-10-27;66;86;152;358062;373689;09;731751
32;2020-10-27;317;318;635;387045;406742;19;793787
32;2020-10-27;574;461;1035;342304;348587;29;690891
32;2020-10-27;574;469;1043;382485;369972;39;752457
32;2020-10-27;525;462;988;382510;376716;49;759226
32;2020-10-27;497;451;948;386937;376527;59;763464
32;2020-10-27;354;317;671;371211;330938;69;702149
32;2020-10-27;236;201;437;250542;201459;79;452001
32;2020-10-27;151;91;242;163399;89786;89;253185
32;2020-10-27;93;33;126;48384;15367;90;63751
32;2020-10-27;3388;2890;6279;3072879;2889783;0;5962662
44;2020-10-27;27;30;57;291525;306839;09;598364
44;2020-10-27;202;234;437;320255;339504;19;659759
44;2020-10-27;429;389;818;302020;314428;29;616448
44;2020-10-27;364;309;673;342222;333292;39;675514
44;2020-10-27;362;304;666;349727;344491;49;694218
44;2020-10-27;317;316;633;381371;373239;59;754610
44;2020-10-27;237;228;466;367165;335850;69;703015
44;2020-10-27;147;144;293;250387;215436;79;465823
44;2020-10-27;97;65;162;170825;105192;89;276017
44;2020-10-27;35;11;46;51248;16731;90;67979
44;2020-10-27;2217;2030;4251;2826745;2685002;0;5511747
52;2020-10-27;12;14;27;213594;223900;09;437494
52;2020-10-27;122;107;236;240818;255197;19;496015
52;2020-10-27;237;181;418;197010;200630;29;397640
52;2020-10-27;221;158;379;231204;224885;39;456089
52;2020-10-27;206;154;360;243874;243418;49;487292
52;2020-10-27;187;165;352;244100;239116;59;483216
52;2020-10-27;139;112;251;241796;221345;69;463141
52;2020-10-27;89;101;190;177805;149903;79;327708
52;2020-10-27;97;50;147;119561;75822;89;195383
52;2020-10-27;58;25;83;42559;15260;90;57819
52;2020-10-27;1368;1067;2443;1952321;1849476;0;3801797
53;2020-10-27;9;13;22;173813;182358;09;356171
53;2020-10-27;69;66;136;202720;214740;19;417460
53;2020-10-27;121;102;227;163116;173196;29;336312
53;2020-10-27;105;101;206;190526;187674;39;378200
53;2020-10-27;98;97;195;212098;212015;49;424113
53;2020-10-27;116;82;198;223699;219176;59;442875
53;2020-10-27;55;78;133;227435;209274;69;436709
53;2020-10-27;61;43;104;169992;140910;79;310902
53;2020-10-27;35;15;50;118117;69883;89;188000
53;2020-10-27;14;8;22;37370;12267;90;49637
53;2020-10-27;683;605;1293;1718886;1621493;0;3340379
75;2020-10-27;18;36;57;293104;305291;09;598395
75;2020-10-27;167;142;312;337141;357785;19;694926
75;2020-10-27;294;269;563;295024;300618;29;595642
75;2020-10-27;274;248;523;347871;331233;39;679104
75;2020-10-27;273;221;494;384742;372771;49;757513
75;2020-10-27;269;239;508;413361;390880;59;804241
75;2020-10-27;181;164;346;425623;384060;69;809683
75;2020-10-27;96;109;205;325086;276298;79;601384
75;2020-10-27;121;72;193;213986;139308;89;353294
75;2020-10-27;82;20;102;77600;28200;90;105800
75;2020-10-27;1775;1520;3303;3113538;2886444;0;5999982
76;2020-10-27;32;33;66;305956;318589;09;624545
76;2020-10-27;221;196;425;338942;356969;19;695911
76;2020-10-27;425;330;756;316210;319570;29;635780
76;2020-10-27;386;303;689;356758;337587;39;694345
76;2020-10-27;403;370;775;376541;363812;49;740353
76;2020-10-27;414;353;769;402608;383750;59;786358
76;2020-10-27;257;248;506;394889;358997;69;753886
76;2020-10-27;191;181;372;308664;263806;79;572470
76;2020-10-27;110;93;203;195838;129272;89;325110
76;2020-10-27;78;32;110;69372;26728;90;96100
76;2020-10-27;2519;2143;4677;3065778;2859080;0;5924858
84;2020-10-27;96;98;200;459549;481088;09;940637
84;2020-10-27;645;636;1291;487711;511905;19;999616
84;2020-10-27;1161;1001;2162;443824;451094;29;894918
84;2020-10-27;1189;972;2164;512522;493262;39;1005784
84;2020-10-27;1199;981;2182;520248;515106;49;1035354
84;2020-10-27;1142;993;2135;529611;514848;59;1044459
84;2020-10-27;678;671;1350;486720;439940;69;926660
84;2020-10-27;483;436;919;372151;315211;79;687362
84;2020-10-27;374;262;636;237198;150524;89;387722
84;2020-10-27;270;85;355;81185;28680;90;109865
84;2020-10-27;7237;6136;13395;4130719;3901658;0;8032377
93;2020-10-27;38;49;88;268834;283093;09;551927
93;2020-10-27;251;229;480;280751;296087;19;576838
93;2020-10-27;416;324;740;254404;255552;29;509956
93;2020-10-27;440;360;800;310704;288398;39;599102
93;2020-10-27;485;351;838;325559;305827;49;631386
93;2020-10-27;455;417;874;353104;325389;59;678493
93;2020-10-27;303;286;590;336327;296459;69;632786
93;2020-10-27;197;202;399;279820;229699;79;509519
93;2020-10-27;146;101;247;171274;113716;89;284990
93;2020-10-27;78;25;103;58896;21758;90;80654
93;2020-10-27;2812;2344;5162;2639673;2415978;0;5055651
94;2020-10-27;1;4;5;16311;17433;09;33744
94;2020-10-27;11;16;27;16679;18132;19;34811
94;2020-10-27;21;20;41;16782;16579;29;33361
94;2020-10-27;26;20;46;23044;20580;39;43624
94;2020-10-27;22;20;42;23065;22140;49;45205
94;2020-10-27;21;19;40;24549;23421;59;47970
94;2020-10-27;11;15;26;23212;21883;69;45095
94;2020-10-27;6;7;13;19544;17141;79;36685
94;2020-10-27;4;2;6;11227;8178;89;19405
94;2020-10-27;2;0;2;3332;1447;90;4779
94;2020-10-27;126;123;249;177745;166934;0;344679
01;2020-10-28;0;0;0;19979;20155;09;40134
01;2020-10-28;1;1;2;24994;25489;19;50483
01;2020-10-28;3;0;3;17868;16690;29;34558
01;2020-10-28;3;3;6;22328;14821;39;37149
01;2020-10-28;4;4;8;28652;20276;49;48928
01;2020-10-28;9;7;16;33264;27260;59;60524
01;2020-10-28;3;5;8;27135;23978;69;51113
01;2020-10-28;2;2;4;18401;14661;79;33062
01;2020-10-28;1;0;1;9633;6375;89;16008
01;2020-10-28;0;1;1;3410;1510;90;4920
01;2020-10-28;26;23;49;205664;171215;0;376879
02;2020-10-28;2;0;2;16881;17110;09;33991
02;2020-10-28;9;9;18;21410;21604;19;43014
02;2020-10-28;7;10;17;16017;15479;29;31496
02;2020-10-28;9;12;21;19825;14455;39;34280
02;2020-10-28;10;9;20;24719;18248;49;42967
02;2020-10-28;23;7;30;34361;28310;59;62671
02;2020-10-28;8;8;16;28061;24495;69;52556
02;2020-10-28;5;4;9;18231;15278;79;33509
02;2020-10-28;1;2;3;11090;7677;89;18767
02;2020-10-28;5;1;6;3992;1506;90;5498
02;2020-10-28;79;62;142;194587;164162;0;358749
03;2020-10-28;0;0;0;31123;30920;09;62043
03;2020-10-28;2;0;2;29370;29268;19;58638
03;2020-10-28;1;1;2;21458;18963;29;40421
03;2020-10-28;2;3;5;21276;18326;39;39602
03;2020-10-28;1;2;3;18164;16593;49;34757
03;2020-10-28;2;1;4;13469;13557;59;27026
03;2020-10-28;0;0;0;8776;8670;69;17446
03;2020-10-28;1;0;1;3777;3591;79;7368
03;2020-10-28;0;0;0;1649;1072;89;2721
03;2020-10-28;0;0;0;485;184;90;669
03;2020-10-28;9;7;17;149547;141144;0;290691
04;2020-10-28;4;0;4;60314;61377;09;121691
04;2020-10-28;8;4;12;66065;68387;19;134452
04;2020-10-28;9;5;14;51059;47156;29;98215
04;2020-10-28;8;1;9;58788;45780;39;104568
04;2020-10-28;5;4;9;61408;52207;49;113615
04;2020-10-28;14;10;24;64838;60759;59;125597
04;2020-10-28;1;4;5;47008;42843;69;89851
04;2020-10-28;3;1;4;25509;21184;79;46693
04;2020-10-28;2;4;6;13168;7647;89;20815
04;2020-10-28;0;0;0;3209;1253;90;4462
04;2020-10-28;54;33;87;451366;408593;0;859959
05;2020-10-28;0;0;0;362.366008612902;341.338819562748;09;703.704828175651
05;2020-10-28;0;0;0;353.376145114279;370.349735405642;19;723.725880519921
05;2020-10-28;0;0;0;218.593559489256;256.539602589476;29;475.133162078732
05;2020-10-28;0;0;0;404.225408693299;360.321910454353;39;764.547319147651
05;2020-10-28;0;0;0;520.067953604221;497.108383964256;49;1017.17633756848
05;2020-10-28;0;0;0;468.146063921917;510.087601910415;59;978.233665832332
05;2020-10-28;0;0;0;340.368470050554;334.366842191253;69;674.735312241807
05;2020-10-28;0;0;0;212.598666888387;192.597753227106;79;405.196420115493
05;2020-10-28;0;0;0;148.727797095705;61.8681715431829;89;210.595968638888
05;2020-10-28;0;0;0;32.9601271090696;10.9909785719784;90;43.9511056810479
05;2020-10-28;0;0;0;3061.43020057959;2935.56979942041;0;5997
06;2020-10-28;1;0;1;42583;42380;09;84963
06;2020-10-28;6;4;10;33369;31925;19;65294
06;2020-10-28;4;4;8;21571;15080;29;36651
06;2020-10-28;4;1;5;21550;16147;39;37697
06;2020-10-28;3;2;5;14193;13939;49;28132
06;2020-10-28;2;0;2;7171;7597;59;14768
06;2020-10-28;2;0;2;3629;4117;69;7746
06;2020-10-28;0;1;1;1577;1457;79;3034
06;2020-10-28;1;1;2;531;474;89;1005
06;2020-10-28;0;0;0;88;93;90;181
06;2020-10-28;23;13;36;146262;133209;0;279471
07;2020-10-28;0;0;0;485;549;09;1034
07;2020-10-28;0;0;0;403;432;19;835
07;2020-10-28;0;0;0;764;841;29;1605
07;2020-10-28;0;0;0;824;928;39;1752
07;2020-10-28;0;0;0;788;1020;49;1808
07;2020-10-28;0;0;0;678;870;59;1548
07;2020-10-28;0;0;0;360;382;69;742
07;2020-10-28;0;0;0;231;190;79;421
07;2020-10-28;0;0;0;114;67;89;181
07;2020-10-28;0;0;0;24;11;90;35
07;2020-10-28;0;0;0;4671;5290;0;9961
08;2020-10-28;0;0;0;2715.22592983026;2997.75551488675;09;5712.98144471701
08;2020-10-28;0;0;0;2778.51901080978;3160.9156459093;19;5939.43465671908
08;2020-10-28;0;0;0;2080.8882988764;1718.16634315323;29;3799.05464202964
08;2020-10-28;0;1;1;2701.8582062647;1896.52641413317;39;4598.38462039786
08;2020-10-28;2;0;2;3151.45861023308;2460.52498233809;49;5611.98359257117
08;2020-10-28;1;3;4;2620.29868333099;2422.23566154656;59;5042.53434487755
08;2020-10-28;0;0;0;1621.44173420671;1438.58325779464;69;3060.02499200135
08;2020-10-28;0;0;0;626.575909335673;526.358467843651;79;1152.93437717932
08;2020-10-28;0;0;0;205.018522985054;140.993639349697;89;346.012162334751
08;2020-10-28;0;0;0;50.0325684687745;20.62259870351;90;70.6551671722846
08;2020-10-28;3;4;7;18551.3174743414;16782.6825256586;0;35334
11;2020-10-28;120;111;242;783071;811785;09;1594856
11;2020-10-28;573;496;1102;761456;784653;19;1546109
11;2020-10-28;1189;931;2126;850145;801772;29;1651917
11;2020-10-28;1136;884;2030;914360;843488;39;1757848
11;2020-10-28;957;824;1785;845609;826202;49;1671811
11;2020-10-28;831;749;1583;793566;745070;59;1538636
11;2020-10-28;562;523;1095;628649;549192;69;1177841
11;2020-10-28;243;283;528;434606;358356;79;792962
11;2020-10-28;177;107;286;261425;162933;89;424358
11;2020-10-28;100;31;131;89253;32619;90;121872
11;2020-10-28;5888;4940;10910;6362140;5916070;0;12278210
24;2020-10-28;5;6;11;139720;144686;09;284406
24;2020-10-28;76;71;149;152979;161185;19;314164
24;2020-10-28;154;121;275;122237;126536;29;248773
24;2020-10-28;178;128;306;150359;142009;39;292368
24;2020-10-28;170;116;286;161829;158758;49;320587
24;2020-10-28;156;150;306;172552;168011;59;340563
24;2020-10-28;97;86;183;172509;158177;69;330686
24;2020-10-28;47;62;109;129428;110593;79;240021
24;2020-10-28;47;37;84;87342;56882;89;144224
24;2020-10-28;28;14;42;31210;12071;90;43281
24;2020-10-28;960;792;1754;1320165;1238908;0;2559073
27;2020-10-28;17;15;32;143373;149679;09;293052
27;2020-10-28;112;116;228;160962;173003;19;333965
27;2020-10-28;236;202;438;133746;142254;29;276000
27;2020-10-28;203;168;371;160004;155407;39;315411
27;2020-10-28;227;185;412;172333;169564;49;341897
27;2020-10-28;231;169;400;189979;183788;59;373767
27;2020-10-28;160;150;310;192591;178206;69;370797
27;2020-10-28;112;89;201;146876;127546;79;274422
27;2020-10-28;92;61;153;96896;61575;89;158471
27;2020-10-28;65;18;83;33148;12109;90;45257
27;2020-10-28;1457;1173;2630;1429908;1353131;0;2783039
28;2020-10-28;21;19;44;180735;186856;09;367591
28;2020-10-28;115;99;220;200125;213621;19;413746
28;2020-10-28;169;127;296;168922;173007;29;341929
28;2020-10-28;208;139;347;196628;188487;39;385115
28;2020-10-28;175;134;310;205396;201699;49;407095
28;2020-10-28;163;171;334;222002;213866;59;435868
28;2020-10-28;135;123;258;224688;203758;69;428446
28;2020-10-28;89;78;167;163192;135543;79;298735
28;2020-10-28;83;44;127;109691;65377;89;175068
28;2020-10-28;50;12;62;37222;12685;90;49907
28;2020-10-28;1208;946;2165;1708601;1594899;0;3303500
32;2020-10-28;79;63;142;358062;373689;09;731751
32;2020-10-28;357;312;669;387045;406742;19;793787
32;2020-10-28;533;434;968;342304;348587;29;690891
32;2020-10-28;534;448;982;382485;369972;39;752457
32;2020-10-28;463;438;901;382510;376716;49;759226
32;2020-10-28;461;437;898;386937;376527;59;763464
32;2020-10-28;333;260;593;371211;330938;69;702149
32;2020-10-28;183;191;374;250542;201459;79;452001
32;2020-10-28;182;103;285;163399;89786;89;253185
32;2020-10-28;126;29;155;48384;15367;90;63751
32;2020-10-28;3252;2715;5968;3072879;2889783;0;5962662
44;2020-10-28;51;47;98;291525;306839;09;598364
44;2020-10-28;206;212;422;320255;339504;19;659759
44;2020-10-28;408;375;783;302020;314428;29;616448
44;2020-10-28;347;327;675;342222;333292;39;675514
44;2020-10-28;351;294;646;349727;344491;49;694218
44;2020-10-28;345;347;693;381371;373239;59;754610
44;2020-10-28;230;248;478;367165;335850;69;703015
44;2020-10-28;131;143;274;250387;215436;79;465823
44;2020-10-28;92;56;148;170825;105192;89;276017
44;2020-10-28;44;17;61;51248;16731;90;67979
44;2020-10-28;2205;2066;4278;2826745;2685002;0;5511747
52;2020-10-28;28;15;47;213594;223900;09;437494
52;2020-10-28;132;130;266;240818;255197;19;496015
52;2020-10-28;219;191;410;197010;200630;29;397640
52;2020-10-28;186;184;370;231204;224885;39;456089
52;2020-10-28;177;157;334;243874;243418;49;487292
52;2020-10-28;176;149;325;244100;239116;59;483216
52;2020-10-28;105;121;226;241796;221345;69;463141
52;2020-10-28;114;79;193;177805;149903;79;327708
52;2020-10-28;88;55;143;119561;75822;89;195383
52;2020-10-28;80;21;101;42559;15260;90;57819
52;2020-10-28;1305;1102;2415;1952321;1849476;0;3801797
53;2020-10-28;16;14;31;173813;182358;09;356171
53;2020-10-28;73;77;153;202720;214740;19;417460
53;2020-10-28;120;101;229;163116;173196;29;336312
53;2020-10-28;101;81;182;190526;187674;39;378200
53;2020-10-28;108;85;193;212098;212015;49;424113
53;2020-10-28;91;92;183;223699;219176;59;442875
53;2020-10-28;70;60;130;227435;209274;69;436709
53;2020-10-28;29;31;60;169992;140910;79;310902
53;2020-10-28;34;25;59;118117;69883;89;188000
53;2020-10-28;16;8;24;37370;12267;90;49637
53;2020-10-28;658;574;1244;1718886;1621493;0;3340379
75;2020-10-28;29;28;58;293104;305291;09;598395
75;2020-10-28;150;139;292;337141;357785;19;694926
75;2020-10-28;253;233;489;295024;300618;29;595642
75;2020-10-28;263;201;466;347871;331233;39;679104
75;2020-10-28;271;210;481;384742;372771;49;757513
75;2020-10-28;228;196;424;413361;390880;59;804241
75;2020-10-28;173;133;306;425623;384060;69;809683
75;2020-10-28;110;106;218;325086;276298;79;601384
75;2020-10-28;109;89;198;213986;139308;89;353294
75;2020-10-28;84;20;104;77600;28200;90;105800
75;2020-10-28;1670;1357;3038;3113538;2886444;0;5999982
76;2020-10-28;45;49;98;305956;318589;09;624545
76;2020-10-28;231;201;442;338942;356969;19;695911
76;2020-10-28;361;301;663;316210;319570;29;635780
76;2020-10-28;412;303;716;356758;337587;39;694345
76;2020-10-28;409;310;720;376541;363812;49;740353
76;2020-10-28;344;320;664;402608;383750;59;786358
76;2020-10-28;246;236;483;394889;358997;69;753886
76;2020-10-28;156;159;316;308664;263806;79;572470
76;2020-10-28;141;78;219;195838;129272;89;325110
76;2020-10-28;114;24;139;69372;26728;90;96100
76;2020-10-28;2460;1983;4463;3065778;2859080;0;5924858
84;2020-10-28;92;95;191;459549;481088;09;940637
84;2020-10-28;609;575;1193;487711;511905;19;999616
84;2020-10-28;1054;869;1925;443824;451094;29;894918
84;2020-10-28;1109;888;1998;512522;493262;39;1005784
84;2020-10-28;1101;857;1959;520248;515106;49;1035354
84;2020-10-28;1052;877;1930;529611;514848;59;1044459
84;2020-10-28;670;576;1246;486720;439940;69;926660
84;2020-10-28;440;411;851;372151;315211;79;687362
84;2020-10-28;410;274;684;237198;150524;89;387722
84;2020-10-28;355;88;443;81185;28680;90;109865
84;2020-10-28;6892;5510;12421;4130719;3901658;0;8032377
93;2020-10-28;40;52;92;268834;283093;09;551927
93;2020-10-28;222;177;400;280751;296087;19;576838
93;2020-10-28;421;301;722;254404;255552;29;509956
93;2020-10-28;440;303;743;310704;288398;39;599102
93;2020-10-28;424;316;741;325559;305827;49;631386
93;2020-10-28;427;346;773;353104;325389;59;678493
93;2020-10-28;241;252;493;336327;296459;69;632786
93;2020-10-28;182;192;374;279820;229699;79;509519
93;2020-10-28;134;101;235;171274;113716;89;284990
93;2020-10-28;94;23;117;58896;21758;90;80654
93;2020-10-28;2626;2066;4694;2639673;2415978;0;5055651
94;2020-10-28;3;4;7;16311;17433;09;33744
94;2020-10-28;11;9;20;16679;18132;19;34811
94;2020-10-28;26;17;43;16782;16579;29;33361
94;2020-10-28;20;16;36;23044;20580;39;43624
94;2020-10-28;14;13;27;23065;22140;49;45205
94;2020-10-28;16;21;37;24549;23421;59;47970
94;2020-10-28;11;16;27;23212;21883;69;45095
94;2020-10-28;7;6;13;19544;17141;79;36685
94;2020-10-28;4;2;6;11227;8178;89;19405
94;2020-10-28;2;0;2;3332;1447;90;4779
94;2020-10-28;115;105;220;177745;166934;0;344679
01;2020-10-29;1;1;2;19979;20155;09;40134
01;2020-10-29;0;4;4;24994;25489;19;50483
01;2020-10-29;4;1;5;17868;16690;29;34558
01;2020-10-29;5;7;12;22328;14821;39;37149
01;2020-10-29;8;2;10;28652;20276;49;48928
01;2020-10-29;4;3;7;33264;27260;59;60524
01;2020-10-29;5;5;10;27135;23978;69;51113
01;2020-10-29;2;0;2;18401;14661;79;33062
01;2020-10-29;2;0;2;9633;6375;89;16008
01;2020-10-29;1;0;1;3410;1510;90;4920
01;2020-10-29;32;23;55;205664;171215;0;376879
02;2020-10-29;2;1;3;16881;17110;09;33991
02;2020-10-29;6;9;15;21410;21604;19;43014
02;2020-10-29;9;11;20;16017;15479;29;31496
02;2020-10-29;17;6;23;19825;14455;39;34280
02;2020-10-29;10;8;18;24719;18248;49;42967
02;2020-10-29;10;10;20;34361;28310;59;62671
02;2020-10-29;10;8;18;28061;24495;69;52556
02;2020-10-29;7;2;10;18231;15278;79;33509
02;2020-10-29;3;1;4;11090;7677;89;18767
02;2020-10-29;2;0;2;3992;1506;90;5498
02;2020-10-29;76;56;133;194587;164162;0;358749
03;2020-10-29;1;0;1;31123;30920;09;62043
03;2020-10-29;0;2;2;29370;29268;19;58638
03;2020-10-29;3;2;5;21458;18963;29;40421
03;2020-10-29;1;3;4;21276;18326;39;39602
03;2020-10-29;0;0;0;18164;16593;49;34757
03;2020-10-29;2;2;4;13469;13557;59;27026
03;2020-10-29;0;1;1;8776;8670;69;17446
03;2020-10-29;0;0;0;3777;3591;79;7368
03;2020-10-29;0;0;0;1649;1072;89;2721
03;2020-10-29;0;0;0;485;184;90;669
03;2020-10-29;7;10;17;149547;141144;0;290691
04;2020-10-29;3;3;6;60314;61377;09;121691
04;2020-10-29;10;4;14;66065;68387;19;134452
04;2020-10-29;9;8;17;51059;47156;29;98215
04;2020-10-29;10;6;16;58788;45780;39;104568
04;2020-10-29;6;3;9;61408;52207;49;113615
04;2020-10-29;6;6;12;64838;60759;59;125597
04;2020-10-29;6;6;12;47008;42843;69;89851
04;2020-10-29;3;3;6;25509;21184;79;46693
04;2020-10-29;1;2;3;13168;7647;89;20815
04;2020-10-29;0;0;0;3209;1253;90;4462
04;2020-10-29;54;41;95;451366;408593;0;859959
05;2020-10-29;0;0;0;362.366008612902;341.338819562748;09;703.704828175651
05;2020-10-29;0;0;0;353.376145114279;370.349735405642;19;723.725880519921
05;2020-10-29;0;0;0;218.593559489256;256.539602589476;29;475.133162078732
05;2020-10-29;1;0;1;404.225408693299;360.321910454353;39;764.547319147651
05;2020-10-29;0;0;0;520.067953604221;497.108383964256;49;1017.17633756848
05;2020-10-29;0;0;0;468.146063921917;510.087601910415;59;978.233665832332
05;2020-10-29;0;0;0;340.368470050554;334.366842191253;69;674.735312241807
05;2020-10-29;0;0;0;212.598666888387;192.597753227106;79;405.196420115493
05;2020-10-29;0;0;0;148.727797095705;61.8681715431829;89;210.595968638888
05;2020-10-29;0;0;0;32.9601271090696;10.9909785719784;90;43.9511056810479
05;2020-10-29;1;0;1;3061.43020057959;2935.56979942041;0;5997
06;2020-10-29;0;0;1;42583;42380;09;84963
06;2020-10-29;3;1;4;33369;31925;19;65294
06;2020-10-29;1;0;1;21571;15080;29;36651
06;2020-10-29;2;0;2;21550;16147;39;37697
06;2020-10-29;1;2;3;14193;13939;49;28132
06;2020-10-29;0;0;0;7171;7597;59;14768
06;2020-10-29;1;0;1;3629;4117;69;7746
06;2020-10-29;1;0;1;1577;1457;79;3034
06;2020-10-29;0;0;0;531;474;89;1005
06;2020-10-29;0;0;0;88;93;90;181
06;2020-10-29;9;3;13;146262;133209;0;279471
07;2020-10-29;0;0;0;485;549;09;1034
07;2020-10-29;0;0;0;403;432;19;835
07;2020-10-29;0;1;1;764;841;29;1605
07;2020-10-29;0;1;1;824;928;39;1752
07;2020-10-29;0;0;0;788;1020;49;1808
07;2020-10-29;0;1;1;678;870;59;1548
07;2020-10-29;0;0;0;360;382;69;742
07;2020-10-29;0;0;0;231;190;79;421
07;2020-10-29;0;0;0;114;67;89;181
07;2020-10-29;0;0;0;24;11;90;35
07;2020-10-29;0;3;3;4671;5290;0;9961
08;2020-10-29;0;0;0;2715.22592983026;2997.75551488675;09;5712.98144471701
08;2020-10-29;0;0;0;2778.51901080978;3160.9156459093;19;5939.43465671908
08;2020-10-29;0;0;0;2080.8882988764;1718.16634315323;29;3799.05464202964
08;2020-10-29;0;0;0;2701.8582062647;1896.52641413317;39;4598.38462039786
08;2020-10-29;1;0;1;3151.45861023308;2460.52498233809;49;5611.98359257117
08;2020-10-29;0;1;1;2620.29868333099;2422.23566154656;59;5042.53434487755
08;2020-10-29;1;0;1;1621.44173420671;1438.58325779464;69;3060.02499200135
08;2020-10-29;0;1;1;626.575909335673;526.358467843651;79;1152.93437717932
08;2020-10-29;0;0;0;205.018522985054;140.993639349697;89;346.012162334751
08;2020-10-29;0;0;0;50.0325684687745;20.62259870351;90;70.6551671722846
08;2020-10-29;2;2;4;18551.3174743414;16782.6825256586;0;35334
11;2020-10-29;111;123;250;783071;811785;09;1594856
11;2020-10-29;556;541;1131;761456;784653;19;1546109
11;2020-10-29;1045;811;1860;850145;801772;29;1651917
11;2020-10-29;996;820;1819;914360;843488;39;1757848
11;2020-10-29;914;752;1675;845609;826202;49;1671811
11;2020-10-29;854;698;1555;793566;745070;59;1538636
11;2020-10-29;588;522;1120;628649;549192;69;1177841
11;2020-10-29;298;240;539;434606;358356;79;792962
11;2020-10-29;184;115;303;261425;162933;89;424358
11;2020-10-29;111;41;152;89253;32619;90;121872
11;2020-10-29;5662;4670;10419;6362140;5916070;0;12278210
24;2020-10-29;16;10;27;139720;144686;09;284406
24;2020-10-29;83;82;168;152979;161185;19;314164
24;2020-10-29;162;101;263;122237;126536;29;248773
24;2020-10-29;125;135;261;150359;142009;39;292368
24;2020-10-29;158;128;286;161829;158758;49;320587
24;2020-10-29;122;110;232;172552;168011;59;340563
24;2020-10-29;108;83;191;172509;158177;69;330686
24;2020-10-29;55;38;93;129428;110593;79;240021
24;2020-10-29;36;29;65;87342;56882;89;144224
24;2020-10-29;36;11;47;31210;12071;90;43281
24;2020-10-29;901;727;1633;1320165;1238908;0;2559073
27;2020-10-29;18;20;38;143373;149679;09;293052
27;2020-10-29;139;123;263;160962;173003;19;333965
27;2020-10-29;226;204;430;133746;142254;29;276000
27;2020-10-29;189;178;367;160004;155407;39;315411
27;2020-10-29;249;192;441;172333;169564;49;341897
27;2020-10-29;221;213;434;189979;183788;59;373767
27;2020-10-29;154;150;304;192591;178206;69;370797
27;2020-10-29;75;90;165;146876;127546;79;274422
27;2020-10-29;70;49;119;96896;61575;89;158471
27;2020-10-29;36;23;59;33148;12109;90;45257
27;2020-10-29;1377;1242;2620;1429908;1353131;0;2783039
28;2020-10-29;18;25;45;180735;186856;09;367591
28;2020-10-29;96;99;200;200125;213621;19;413746
28;2020-10-29;158;136;294;168922;173007;29;341929
28;2020-10-29;172;118;290;196628;188487;39;385115
28;2020-10-29;163;114;277;205396;201699;49;407095
28;2020-10-29;159;124;283;222002;213866;59;435868
28;2020-10-29;152;103;256;224688;203758;69;428446
28;2020-10-29;73;87;160;163192;135543;79;298735
28;2020-10-29;67;40;107;109691;65377;89;175068
28;2020-10-29;49;12;61;37222;12685;90;49907
28;2020-10-29;1107;858;1973;1708601;1594899;0;3303500
32;2020-10-29;75;92;167;358062;373689;09;731751
32;2020-10-29;416;369;788;387045;406742;19;793787
32;2020-10-29;555;467;1023;342304;348587;29;690891
32;2020-10-29;512;446;958;382485;369972;39;752457
32;2020-10-29;491;431;922;382510;376716;49;759226
32;2020-10-29;465;438;903;386937;376527;59;763464
32;2020-10-29;325;311;636;371211;330938;69;702149
32;2020-10-29;211;181;393;250542;201459;79;452001
32;2020-10-29;149;80;229;163399;89786;89;253185
32;2020-10-29;76;25;101;48384;15367;90;63751
32;2020-10-29;3276;2843;6124;3072879;2889783;0;5962662
44;2020-10-29;53;62;117;291525;306839;09;598364
44;2020-10-29;243;236;480;320255;339504;19;659759
44;2020-10-29;367;354;723;302020;314428;29;616448
44;2020-10-29;341;327;670;342222;333292;39;675514
44;2020-10-29;333;293;627;349727;344491;49;694218
44;2020-10-29;343;285;629;381371;373239;59;754610
44;2020-10-29;218;225;444;367165;335850;69;703015
44;2020-10-29;119;122;241;250387;215436;79;465823
44;2020-10-29;101;74;175;170825;105192;89;276017
44;2020-10-29;50;19;69;51248;16731;90;67979
44;2020-10-29;2168;1997;4175;2826745;2685002;0;5511747
52;2020-10-29;25;28;54;213594;223900;09;437494
52;2020-10-29;152;126;283;240818;255197;19;496015
52;2020-10-29;200;157;358;197010;200630;29;397640
52;2020-10-29;188;179;367;231204;224885;39;456089
52;2020-10-29;184;152;336;243874;243418;49;487292
52;2020-10-29;177;146;323;244100;239116;59;483216
52;2020-10-29;137;105;242;241796;221345;69;463141
52;2020-10-29;72;71;143;177805;149903;79;327708
52;2020-10-29;69;45;114;119561;75822;89;195383
52;2020-10-29;40;16;56;42559;15260;90;57819
52;2020-10-29;1244;1025;2276;1952321;1849476;0;3801797
53;2020-10-29;23;24;48;173813;182358;09;356171
53;2020-10-29;66;85;154;202720;214740;19;417460
53;2020-10-29;141;91;234;163116;173196;29;336312
53;2020-10-29;90;76;166;190526;187674;39;378200
53;2020-10-29;102;82;184;212098;212015;49;424113
53;2020-10-29;95;72;167;223699;219176;59;442875
53;2020-10-29;74;76;150;227435;209274;69;436709
53;2020-10-29;32;45;77;169992;140910;79;310902
53;2020-10-29;36;14;50;118117;69883;89;188000
53;2020-10-29;14;9;24;37370;12267;90;49637
53;2020-10-29;673;574;1254;1718886;1621493;0;3340379
75;2020-10-29;37;34;75;293104;305291;09;598395
75;2020-10-29;168;173;348;337141;357785;19;694926
75;2020-10-29;284;246;532;295024;300618;29;595642
75;2020-10-29;252;195;447;347871;331233;39;679104
75;2020-10-29;267;204;471;384742;372771;49;757513
75;2020-10-29;239;217;456;413361;390880;59;804241
75;2020-10-29;158;165;326;425623;384060;69;809683
75;2020-10-29;93;86;180;325086;276298;79;601384
75;2020-10-29;88;76;164;213986;139308;89;353294
75;2020-10-29;84;31;115;77600;28200;90;105800
75;2020-10-29;1670;1427;3114;3113538;2886444;0;5999982
76;2020-10-29;52;43;98;305956;318589;09;624545
76;2020-10-29;241;212;460;338942;356969;19;695911
76;2020-10-29;357;332;690;316210;319570;29;635780
76;2020-10-29;347;261;608;356758;337587;39;694345
76;2020-10-29;390;297;687;376541;363812;49;740353
76;2020-10-29;362;328;691;402608;383750;59;786358
76;2020-10-29;262;241;503;394889;358997;69;753886
76;2020-10-29;160;143;304;308664;263806;79;572470
76;2020-10-29;129;98;228;195838;129272;89;325110
76;2020-10-29;98;42;140;69372;26728;90;96100
76;2020-10-29;2398;1998;4410;3065778;2859080;0;5924858
84;2020-10-29;121;129;254;459549;481088;09;940637
84;2020-10-29;652;600;1271;487711;511905;19;999616
84;2020-10-29;1047;846;1897;443824;451094;29;894918
84;2020-10-29;1080;886;1969;512522;493262;39;1005784
84;2020-10-29;1064;878;1942;520248;515106;49;1035354
84;2020-10-29;1048;884;1932;529611;514848;59;1044459
84;2020-10-29;640;613;1254;486720;439940;69;926660
84;2020-10-29;444;405;849;372151;315211;79;687362
84;2020-10-29;419;260;679;237198;150524;89;387722
84;2020-10-29;343;94;437;81185;28680;90;109865
84;2020-10-29;6858;5595;12484;4130719;3901658;0;8032377
93;2020-10-29;54;55;109;268834;283093;09;551927
93;2020-10-29;207;237;445;280751;296087;19;576838
93;2020-10-29;343;286;630;254404;255552;29;509956
93;2020-10-29;429;316;745;310704;288398;39;599102
93;2020-10-29;459;344;804;325559;305827;49;631386
93;2020-10-29;410;353;763;353104;325389;59;678493
93;2020-10-29;281;257;538;336327;296459;69;632786
93;2020-10-29;173;184;358;279820;229699;79;509519
93;2020-10-29;163;91;254;171274;113716;89;284990
93;2020-10-29;104;31;135;58896;21758;90;80654
93;2020-10-29;2625;2155;4784;2639673;2415978;0;5055651
94;2020-10-29;4;3;7;16311;17433;09;33744
94;2020-10-29;16;14;30;16679;18132;19;34811
94;2020-10-29;12;13;25;16782;16579;29;33361
94;2020-10-29;19;23;42;23044;20580;39;43624
94;2020-10-29;13;21;34;23065;22140;49;45205
94;2020-10-29;20;16;36;24549;23421;59;47970
94;2020-10-29;16;11;27;23212;21883;69;45095
94;2020-10-29;14;9;23;19544;17141;79;36685
94;2020-10-29;6;4;10;11227;8178;89;19405
94;2020-10-29;3;2;5;3332;1447;90;4779
94;2020-10-29;124;116;240;177745;166934;0;344679
01;2020-10-30;0;0;0;19979;20155;09;40134
01;2020-10-30;2;2;4;24994;25489;19;50483
01;2020-10-30;6;7;13;17868;16690;29;34558
01;2020-10-30;4;1;5;22328;14821;39;37149
01;2020-10-30;6;4;10;28652;20276;49;48928
01;2020-10-30;6;10;16;33264;27260;59;60524
01;2020-10-30;3;3;6;27135;23978;69;51113
01;2020-10-30;0;1;1;18401;14661;79;33062
01;2020-10-30;0;2;2;9633;6375;89;16008
01;2020-10-30;0;0;0;3410;1510;90;4920
01;2020-10-30;27;30;57;205664;171215;0;376879
02;2020-10-30;2;0;2;16881;17110;09;33991
02;2020-10-30;11;12;24;21410;21604;19;43014
02;2020-10-30;12;6;18;16017;15479;29;31496
02;2020-10-30;12;11;23;19825;14455;39;34280
02;2020-10-30;13;9;22;24719;18248;49;42967
02;2020-10-30;15;13;29;34361;28310;59;62671
02;2020-10-30;11;7;18;28061;24495;69;52556
02;2020-10-30;3;0;3;18231;15278;79;33509
02;2020-10-30;3;1;4;11090;7677;89;18767
02;2020-10-30;1;0;1;3992;1506;90;5498
02;2020-10-30;83;59;144;194587;164162;0;358749
03;2020-10-30;0;0;0;31123;30920;09;62043
03;2020-10-30;1;0;1;29370;29268;19;58638
03;2020-10-30;5;5;10;21458;18963;29;40421
03;2020-10-30;0;4;4;21276;18326;39;39602
03;2020-10-30;3;1;4;18164;16593;49;34757
03;2020-10-30;2;2;4;13469;13557;59;27026
03;2020-10-30;0;1;1;8776;8670;69;17446
03;2020-10-30;0;0;0;3777;3591;79;7368
03;2020-10-30;0;0;0;1649;1072;89;2721
03;2020-10-30;0;0;0;485;184;90;669
03;2020-10-30;11;13;24;149547;141144;0;290691
04;2020-10-30;2;2;4;60314;61377;09;121691
04;2020-10-30;16;6;22;66065;68387;19;134452
04;2020-10-30;10;9;19;51059;47156;29;98215
04;2020-10-30;8;6;14;58788;45780;39;104568
04;2020-10-30;8;11;19;61408;52207;49;113615
04;2020-10-30;8;9;17;64838;60759;59;125597
04;2020-10-30;7;4;11;47008;42843;69;89851
04;2020-10-30;1;1;2;25509;21184;79;46693
04;2020-10-30;0;0;0;13168;7647;89;20815
04;2020-10-30;0;0;0;3209;1253;90;4462
04;2020-10-30;60;48;108;451366;408593;0;859959
05;2020-10-30;0;0;0;362.366008612902;341.338819562748;09;703.704828175651
05;2020-10-30;0;0;0;353.376145114279;370.349735405642;19;723.725880519921
05;2020-10-30;0;0;0;218.593559489256;256.539602589476;29;475.133162078732
05;2020-10-30;0;0;0;404.225408693299;360.321910454353;39;764.547319147651
05;2020-10-30;0;0;0;520.067953604221;497.108383964256;49;1017.17633756848
05;2020-10-30;0;0;0;468.146063921917;510.087601910415;59;978.233665832332
05;2020-10-30;0;0;0;340.368470050554;334.366842191253;69;674.735312241807
05;2020-10-30;0;0;0;212.598666888387;192.597753227106;79;405.196420115493
05;2020-10-30;0;0;0;148.727797095705;61.8681715431829;89;210.595968638888
05;2020-10-30;0;0;0;32.9601271090696;10.9909785719784;90;43.9511056810479
05;2020-10-30;0;0;0;3061.43020057959;2935.56979942041;0;5997
06;2020-10-30;0;0;0;42583;42380;09;84963
06;2020-10-30;2;6;8;33369;31925;19;65294
06;2020-10-30;3;4;7;21571;15080;29;36651
06;2020-10-30;7;4;11;21550;16147;39;37697
06;2020-10-30;8;7;15;14193;13939;49;28132
06;2020-10-30;4;1;5;7171;7597;59;14768
06;2020-10-30;0;2;2;3629;4117;69;7746
06;2020-10-30;0;2;2;1577;1457;79;3034
06;2020-10-30;0;0;0;531;474;89;1005
06;2020-10-30;0;0;0;88;93;90;181
06;2020-10-30;24;26;50;146262;133209;0;279471
07;2020-10-30;0;0;0;485;549;09;1034
07;2020-10-30;0;0;0;403;432;19;835
07;2020-10-30;0;1;1;764;841;29;1605
07;2020-10-30;0;0;0;824;928;39;1752
07;2020-10-30;1;0;1;788;1020;49;1808
07;2020-10-30;0;0;0;678;870;59;1548
07;2020-10-30;0;0;0;360;382;69;742
07;2020-10-30;0;0;0;231;190;79;421
07;2020-10-30;0;0;0;114;67;89;181
07;2020-10-30;0;0;0;24;11;90;35
07;2020-10-30;1;1;2;4671;5290;0;9961
08;2020-10-30;0;0;0;2715.22592983026;2997.75551488675;09;5712.98144471701
08;2020-10-30;3;0;3;2778.51901080978;3160.9156459093;19;5939.43465671908
08;2020-10-30;0;0;0;2080.8882988764;1718.16634315323;29;3799.05464202964
08;2020-10-30;1;1;2;2701.8582062647;1896.52641413317;39;4598.38462039786
08;2020-10-30;2;1;3;3151.45861023308;2460.52498233809;49;5611.98359257117
08;2020-10-30;0;1;1;2620.29868333099;2422.23566154656;59;5042.53434487755
08;2020-10-30;0;2;2;1621.44173420671;1438.58325779464;69;3060.02499200135
08;2020-10-30;0;0;0;626.575909335673;526.358467843651;79;1152.93437717932
08;2020-10-30;0;0;0;205.018522985054;140.993639349697;89;346.012162334751
08;2020-10-30;0;0;0;50.0325684687745;20.62259870351;90;70.6551671722846
08;2020-10-30;6;5;11;18551.3174743414;16782.6825256586;0;35334
11;2020-10-30;152;164;339;783071;811785;09;1594856
11;2020-10-30;672;615;1326;761456;784653;19;1546109
11;2020-10-30;1011;823;1839;850145;801772;29;1651917
11;2020-10-30;991;784;1775;914360;843488;39;1757848
11;2020-10-30;917;766;1689;845609;826202;49;1671811
11;2020-10-30;796;753;1550;793566;745070;59;1538636
11;2020-10-30;522;535;1070;628649;549192;69;1177841
11;2020-10-30;246;244;491;434606;358356;79;792962
11;2020-10-30;159;147;306;261425;162933;89;424358
11;2020-10-30;101;39;143;89253;32619;90;121872
11;2020-10-30;5572;4872;10542;6362140;5916070;0;12278210
24;2020-10-30;21;20;43;139720;144686;09;284406
24;2020-10-30;109;117;227;152979;161185;19;314164
24;2020-10-30;148;105;253;122237;126536;29;248773
24;2020-10-30;159;107;266;150359;142009;39;292368
24;2020-10-30;166;103;269;161829;158758;49;320587
24;2020-10-30;149;126;275;172552;168011;59;340563
24;2020-10-30;95;102;197;172509;158177;69;330686
24;2020-10-30;52;61;113;129428;110593;79;240021
24;2020-10-30;46;23;69;87342;56882;89;144224
24;2020-10-30;26;6;32;31210;12071;90;43281
24;2020-10-30;971;770;1744;1320165;1238908;0;2559073
27;2020-10-30;36;29;65;143373;149679;09;293052
27;2020-10-30;149;153;305;160962;173003;19;333965
27;2020-10-30;217;178;395;133746;142254;29;276000
27;2020-10-30;206;165;371;160004;155407;39;315411
27;2020-10-30;255;211;466;172333;169564;49;341897
27;2020-10-30;245;217;462;189979;183788;59;373767
27;2020-10-30;178;150;328;192591;178206;69;370797
27;2020-10-30;117;120;237;146876;127546;79;274422
27;2020-10-30;84;66;150;96896;61575;89;158471
27;2020-10-30;43;18;61;33148;12109;90;45257
27;2020-10-30;1530;1307;2840;1429908;1353131;0;2783039
28;2020-10-30;33;36;72;180735;186856;09;367591
28;2020-10-30;123;135;263;200125;213621;19;413746
28;2020-10-30;171;121;292;168922;173007;29;341929
28;2020-10-30;169;113;282;196628;188487;39;385115
28;2020-10-30;173;121;294;205396;201699;49;407095
28;2020-10-30;154;132;287;222002;213866;59;435868
28;2020-10-30;128;116;244;224688;203758;69;428446
28;2020-10-30;72;84;156;163192;135543;79;298735
28;2020-10-30;90;34;124;109691;65377;89;175068
28;2020-10-30;48;10;58;37222;12685;90;49907
28;2020-10-30;1161;903;2073;1708601;1594899;0;3303500
32;2020-10-30;115;129;244;358062;373689;09;731751
32;2020-10-30;461;395;856;387045;406742;19;793787
32;2020-10-30;514;441;957;342304;348587;29;690891
32;2020-10-30;487;425;917;382485;369972;39;752457
32;2020-10-30;531;439;971;382510;376716;49;759226
32;2020-10-30;425;404;830;386937;376527;59;763464
32;2020-10-30;315;284;600;371211;330938;69;702149
32;2020-10-30;213;186;400;250542;201459;79;452001
32;2020-10-30;168;87;255;163399;89786;89;253185
32;2020-10-30;83;23;106;48384;15367;90;63751
32;2020-10-30;3312;2814;6138;3072879;2889783;0;5962662
44;2020-10-30;55;72;128;291525;306839;09;598364
44;2020-10-30;286;307;595;320255;339504;19;659759
44;2020-10-30;411;361;773;302020;314428;29;616448
44;2020-10-30;395;317;713;342222;333292;39;675514
44;2020-10-30;355;282;638;349727;344491;49;694218
44;2020-10-30;343;344;690;381371;373239;59;754610
44;2020-10-30;249;238;492;367165;335850;69;703015
44;2020-10-30;142;168;311;250387;215436;79;465823
44;2020-10-30;127;82;209;170825;105192;89;276017
44;2020-10-30;87;26;114;51248;16731;90;67979
44;2020-10-30;2450;2198;4664;2826745;2685002;0;5511747
52;2020-10-30;25;31;62;213594;223900;09;437494
52;2020-10-30;158;138;304;240818;255197;19;496015
52;2020-10-30;194;193;387;197010;200630;29;397640
52;2020-10-30;178;161;340;231204;224885;39;456089
52;2020-10-30;220;189;409;243874;243418;49;487292
52;2020-10-30;180;166;346;244100;239116;59;483216
52;2020-10-30;132;115;247;241796;221345;69;463141
52;2020-10-30;74;84;158;177805;149903;79;327708
52;2020-10-30;70;63;133;119561;75822;89;195383
52;2020-10-30;48;21;69;42559;15260;90;57819
52;2020-10-30;1279;1161;2455;1952321;1849476;0;3801797
53;2020-10-30;25;26;56;173813;182358;09;356171
53;2020-10-30;104;90;196;202720;214740;19;417460
53;2020-10-30;135;114;250;163116;173196;29;336312
53;2020-10-30;138;104;242;190526;187674;39;378200
53;2020-10-30;129;111;241;212098;212015;49;424113
53;2020-10-30;113;108;221;223699;219176;59;442875
53;2020-10-30;82;79;161;227435;209274;69;436709
53;2020-10-30;50;55;105;169992;140910;79;310902
53;2020-10-30;32;24;56;118117;69883;89;188000
53;2020-10-30;18;3;22;37370;12267;90;49637
53;2020-10-30;826;714;1550;1718886;1621493;0;3340379
75;2020-10-30;44;54;100;293104;305291;09;598395
75;2020-10-30;193;199;397;337141;357785;19;694926
75;2020-10-30;294;243;537;295024;300618;29;595642
75;2020-10-30;250;224;474;347871;331233;39;679104
75;2020-10-30;284;260;545;384742;372771;49;757513
75;2020-10-30;249;236;485;413361;390880;59;804241
75;2020-10-30;178;169;347;425623;384060;69;809683
75;2020-10-30;131;121;252;325086;276298;79;601384
75;2020-10-30;96;79;175;213986;139308;89;353294
75;2020-10-30;71;26;98;77600;28200;90;105800
75;2020-10-30;1790;1612;3411;3113538;2886444;0;5999982
76;2020-10-30;69;48;120;305956;318589;09;624545
76;2020-10-30;238;262;516;338942;356969;19;695911
76;2020-10-30;362;280;643;316210;319570;29;635780
76;2020-10-30;344;278;623;356758;337587;39;694345
76;2020-10-30;406;326;732;376541;363812;49;740353
76;2020-10-30;332;314;648;402608;383750;59;786358
76;2020-10-30;236;239;475;394889;358997;69;753886
76;2020-10-30;169;159;328;308664;263806;79;572470
76;2020-10-30;120;93;213;195838;129272;89;325110
76;2020-10-30;74;30;104;69372;26728;90;96100
76;2020-10-30;2354;2030;4407;3065778;2859080;0;5924858
84;2020-10-30;163;160;324;459549;481088;09;940637
84;2020-10-30;716;716;1450;487711;511905;19;999616
84;2020-10-30;1052;878;1934;443824;451094;29;894918
84;2020-10-30;1117;881;1999;512522;493262;39;1005784
84;2020-10-30;1138;872;2012;520248;515106;49;1035354
84;2020-10-30;1059;945;2006;529611;514848;59;1044459
84;2020-10-30;651;597;1248;486720;439940;69;926660
84;2020-10-30;438;461;900;372151;315211;79;687362
84;2020-10-30;392;285;677;237198;150524;89;387722
84;2020-10-30;264;77;341;81185;28680;90;109865
84;2020-10-30;6991;5873;12893;4130719;3901658;0;8032377
93;2020-10-30;54;73;128;268834;283093;09;551927
93;2020-10-30;264;247;515;280751;296087;19;576838
93;2020-10-30;348;274;623;254404;255552;29;509956
93;2020-10-30;382;304;686;310704;288398;39;599102
93;2020-10-30;451;335;787;325559;305827;49;631386
93;2020-10-30;377;341;718;353104;325389;59;678493
93;2020-10-30;288;249;538;336327;296459;69;632786
93;2020-10-30;194;169;363;279820;229699;79;509519
93;2020-10-30;141;95;236;171274;113716;89;284990
93;2020-10-30;112;38;150;58896;21758;90;80654
93;2020-10-30;2612;2127;4747;2639673;2415978;0;5055651
94;2020-10-30;5;5;10;16311;17433;09;33744
94;2020-10-30;19;14;33;16679;18132;19;34811
94;2020-10-30;31;20;51;16782;16579;29;33361
94;2020-10-30;30;35;65;23044;20580;39;43624
94;2020-10-30;29;22;51;23065;22140;49;45205
94;2020-10-30;29;23;52;24549;23421;59;47970
94;2020-10-30;16;22;38;23212;21883;69;45095
94;2020-10-30;18;13;31;19544;17141;79;36685
94;2020-10-30;5;4;9;11227;8178;89;19405
94;2020-10-30;2;2;4;3332;1447;90;4779
94;2020-10-30;185;160;345;177745;166934;0;344679
01;2020-10-31;0;0;0;19979;20155;09;40134
01;2020-10-31;0;0;0;24994;25489;19;50483
01;2020-10-31;2;1;3;17868;16690;29;34558
01;2020-10-31;1;1;2;22328;14821;39;37149
01;2020-10-31;0;0;0;28652;20276;49;48928
01;2020-10-31;1;1;2;33264;27260;59;60524
01;2020-10-31;0;3;3;27135;23978;69;51113
01;2020-10-31;0;1;1;18401;14661;79;33062
01;2020-10-31;0;0;0;9633;6375;89;16008
01;2020-10-31;0;0;0;3410;1510;90;4920
01;2020-10-31;4;7;11;205664;171215;0;376879
02;2020-10-31;0;0;0;16881;17110;09;33991
02;2020-10-31;4;0;4;21410;21604;19;43014
02;2020-10-31;3;1;4;16017;15479;29;31496
02;2020-10-31;6;1;7;19825;14455;39;34280
02;2020-10-31;4;0;4;24719;18248;49;42967
02;2020-10-31;1;7;8;34361;28310;59;62671
02;2020-10-31;2;6;8;28061;24495;69;52556
02;2020-10-31;0;2;2;18231;15278;79;33509
02;2020-10-31;1;0;1;11090;7677;89;18767
02;2020-10-31;0;0;0;3992;1506;90;5498
02;2020-10-31;21;17;38;194587;164162;0;358749
03;2020-10-31;0;0;0;31123;30920;09;62043
03;2020-10-31;0;0;0;29370;29268;19;58638
03;2020-10-31;2;2;4;21458;18963;29;40421
03;2020-10-31;1;2;3;21276;18326;39;39602
03;2020-10-31;0;3;3;18164;16593;49;34757
03;2020-10-31;0;1;1;13469;13557;59;27026
03;2020-10-31;1;3;4;8776;8670;69;17446
03;2020-10-31;0;0;0;3777;3591;79;7368
03;2020-10-31;0;0;0;1649;1072;89;2721
03;2020-10-31;0;0;0;485;184;90;669
03;2020-10-31;4;11;15;149547;141144;0;290691
04;2020-10-31;1;0;1;60314;61377;09;121691
04;2020-10-31;4;4;8;66065;68387;19;134452
04;2020-10-31;4;2;6;51059;47156;29;98215
04;2020-10-31;8;5;13;58788;45780;39;104568
04;2020-10-31;8;5;13;61408;52207;49;113615
04;2020-10-31;4;2;6;64838;60759;59;125597
04;2020-10-31;1;3;4;47008;42843;69;89851
04;2020-10-31;0;2;2;25509;21184;79;46693
04;2020-10-31;1;1;2;13168;7647;89;20815
04;2020-10-31;0;0;0;3209;1253;90;4462
04;2020-10-31;31;24;55;451366;408593;0;859959
05;2020-10-31;0;0;0;362.366008612902;341.338819562748;09;703.704828175651
05;2020-10-31;0;0;0;353.376145114279;370.349735405642;19;723.725880519921
05;2020-10-31;0;0;0;218.593559489256;256.539602589476;29;475.133162078732
05;2020-10-31;0;0;0;404.225408693299;360.321910454353;39;764.547319147651
05;2020-10-31;0;0;0;520.067953604221;497.108383964256;49;1017.17633756848
05;2020-10-31;0;0;0;468.146063921917;510.087601910415;59;978.233665832332
05;2020-10-31;0;0;0;340.368470050554;334.366842191253;69;674.735312241807
05;2020-10-31;0;0;0;212.598666888387;192.597753227106;79;405.196420115493
05;2020-10-31;0;0;0;148.727797095705;61.8681715431829;89;210.595968638888
05;2020-10-31;0;0;0;32.9601271090696;10.9909785719784;90;43.9511056810479
05;2020-10-31;0;0;0;3061.43020057959;2935.56979942041;0;5997
06;2020-10-31;0;0;0;42583;42380;09;84963
06;2020-10-31;1;0;1;33369;31925;19;65294
06;2020-10-31;0;0;0;21571;15080;29;36651
06;2020-10-31;2;0;2;21550;16147;39;37697
06;2020-10-31;1;1;2;14193;13939;49;28132
06;2020-10-31;0;0;0;7171;7597;59;14768
06;2020-10-31;1;0;1;3629;4117;69;7746
06;2020-10-31;0;2;2;1577;1457;79;3034
06;2020-10-31;0;0;0;531;474;89;1005
06;2020-10-31;0;0;0;88;93;90;181
06;2020-10-31;5;3;8;146262;133209;0;279471
07;2020-10-31;0;0;0;485;549;09;1034
07;2020-10-31;0;0;0;403;432;19;835
07;2020-10-31;0;0;0;764;841;29;1605
07;2020-10-31;0;0;0;824;928;39;1752
07;2020-10-31;0;0;0;788;1020;49;1808
07;2020-10-31;0;0;0;678;870;59;1548
07;2020-10-31;0;0;0;360;382;69;742
07;2020-10-31;0;0;0;231;190;79;421
07;2020-10-31;0;0;0;114;67;89;181
07;2020-10-31;0;0;0;24;11;90;35
07;2020-10-31;0;0;0;4671;5290;0;9961
08;2020-10-31;0;0;0;2715.22592983026;2997.75551488675;09;5712.98144471701
08;2020-10-31;0;0;0;2778.51901080978;3160.9156459093;19;5939.43465671908
08;2020-10-31;0;0;0;2080.8882988764;1718.16634315323;29;3799.05464202964
08;2020-10-31;0;0;0;2701.8582062647;1896.52641413317;39;4598.38462039786
08;2020-10-31;1;0;1;3151.45861023308;2460.52498233809;49;5611.98359257117
08;2020-10-31;1;0;1;2620.29868333099;2422.23566154656;59;5042.53434487755
08;2020-10-31;0;0;0;1621.44173420671;1438.58325779464;69;3060.02499200135
08;2020-10-31;0;0;0;626.575909335673;526.358467843651;79;1152.93437717932
08;2020-10-31;0;0;0;205.018522985054;140.993639349697;89;346.012162334751
08;2020-10-31;0;0;0;50.0325684687745;20.62259870351;90;70.6551671722846
08;2020-10-31;2;0;2;18551.3174743414;16782.6825256586;0;35334
11;2020-10-31;44;56;112;783071;811785;09;1594856
11;2020-10-31;290;241;562;761456;784653;19;1546109
11;2020-10-31;447;341;789;850145;801772;29;1651917
11;2020-10-31;408;344;753;914360;843488;39;1757848
11;2020-10-31;379;319;701;845609;826202;49;1671811
11;2020-10-31;330;310;640;793566;745070;59;1538636
11;2020-10-31;299;271;573;628649;549192;69;1177841
11;2020-10-31;109;141;250;434606;358356;79;792962
11;2020-10-31;86;68;154;261425;162933;89;424358
11;2020-10-31;43;22;65;89253;32619;90;121872
11;2020-10-31;2437;2114;4602;6362140;5916070;0;12278210
24;2020-10-31;8;10;18;139720;144686;09;284406
24;2020-10-31;56;52;108;152979;161185;19;314164
24;2020-10-31;74;59;133;122237;126536;29;248773
24;2020-10-31;84;67;151;150359;142009;39;292368
24;2020-10-31;85;70;155;161829;158758;49;320587
24;2020-10-31;75;65;140;172552;168011;59;340563
24;2020-10-31;53;57;110;172509;158177;69;330686
24;2020-10-31;37;36;73;129428;110593;79;240021
24;2020-10-31;27;17;44;87342;56882;89;144224
24;2020-10-31;16;1;17;31210;12071;90;43281
24;2020-10-31;516;435;951;1320165;1238908;0;2559073
27;2020-10-31;26;22;48;143373;149679;09;293052
27;2020-10-31;106;96;202;160962;173003;19;333965
27;2020-10-31;157;107;264;133746;142254;29;276000
27;2020-10-31;147;112;259;160004;155407;39;315411
27;2020-10-31;129;118;247;172333;169564;49;341897
27;2020-10-31;142;121;263;189979;183788;59;373767
27;2020-10-31;81;89;170;192591;178206;69;370797
27;2020-10-31;57;67;124;146876;127546;79;274422
27;2020-10-31;44;35;79;96896;61575;89;158471
27;2020-10-31;21;10;31;33148;12109;90;45257
27;2020-10-31;910;778;1688;1429908;1353131;0;2783039
28;2020-10-31;15;13;29;180735;186856;09;367591
28;2020-10-31;52;40;94;200125;213621;19;413746
28;2020-10-31;73;81;155;168922;173007;29;341929
28;2020-10-31;87;67;154;196628;188487;39;385115
28;2020-10-31;71;75;146;205396;201699;49;407095
28;2020-10-31;75;64;139;222002;213866;59;435868
28;2020-10-31;49;48;97;224688;203758;69;428446
28;2020-10-31;40;19;59;163192;135543;79;298735
28;2020-10-31;38;23;61;109691;65377;89;175068
28;2020-10-31;29;8;37;37222;12685;90;49907
28;2020-10-31;529;438;971;1708601;1594899;0;3303500
32;2020-10-31;54;56;111;358062;373689;09;731751
32;2020-10-31;242;209;451;387045;406742;19;793787
32;2020-10-31;295;241;536;342304;348587;29;690891
32;2020-10-31;287;245;532;382485;369972;39;752457
32;2020-10-31;289;252;541;382510;376716;49;759226
32;2020-10-31;258;232;490;386937;376527;59;763464
32;2020-10-31;155;154;309;371211;330938;69;702149
32;2020-10-31;122;91;213;250542;201459;79;452001
32;2020-10-31;85;46;131;163399;89786;89;253185
32;2020-10-31;30;21;51;48384;15367;90;63751
32;2020-10-31;1818;1547;3366;3072879;2889783;0;5962662
44;2020-10-31;33;35;69;291525;306839;09;598364
44;2020-10-31;129;141;272;320255;339504;19;659759
44;2020-10-31;226;191;417;302020;314428;29;616448
44;2020-10-31;172;170;344;342222;333292;39;675514
44;2020-10-31;181;138;319;349727;344491;49;694218
44;2020-10-31;177;197;375;381371;373239;59;754610
44;2020-10-31;97;137;234;367165;335850;69;703015
44;2020-10-31;93;77;170;250387;215436;79;465823
44;2020-10-31;73;42;115;170825;105192;89;276017
44;2020-10-31;18;8;26;51248;16731;90;67979
44;2020-10-31;1199;1136;2341;2826745;2685002;0;5511747
52;2020-10-31;19;10;29;213594;223900;09;437494
52;2020-10-31;90;83;177;240818;255197;19;496015
52;2020-10-31;99;97;197;197010;200630;29;397640
52;2020-10-31;95;79;174;231204;224885;39;456089
52;2020-10-31;82;92;174;243874;243418;49;487292
52;2020-10-31;86;68;154;244100;239116;59;483216
52;2020-10-31;67;67;135;241796;221345;69;463141
52;2020-10-31;45;38;83;177805;149903;79;327708
52;2020-10-31;20;17;37;119561;75822;89;195383
52;2020-10-31;7;7;14;42559;15260;90;57819
52;2020-10-31;610;558;1174;1952321;1849476;0;3801797
53;2020-10-31;14;14;30;173813;182358;09;356171
53;2020-10-31;55;32;88;202720;214740;19;417460
53;2020-10-31;78;64;142;163116;173196;29;336312
53;2020-10-31;43;47;90;190526;187674;39;378200
53;2020-10-31;60;41;101;212098;212015;49;424113
53;2020-10-31;55;50;105;223699;219176;59;442875
53;2020-10-31;34;36;70;227435;209274;69;436709
53;2020-10-31;19;16;35;169992;140910;79;310902
53;2020-10-31;13;6;19;118117;69883;89;188000
53;2020-10-31;13;7;20;37370;12267;90;49637
53;2020-10-31;384;313;700;1718886;1621493;0;3340379
75;2020-10-31;16;21;37;293104;305291;09;598395
75;2020-10-31;63;63;128;337141;357785;19;694926
75;2020-10-31;111;76;187;295024;300618;29;595642
75;2020-10-31;94;97;191;347871;331233;39;679104
75;2020-10-31;97;90;187;384742;372771;49;757513
75;2020-10-31;91;88;179;413361;390880;59;804241
75;2020-10-31;69;61;131;425623;384060;69;809683
75;2020-10-31;43;51;94;325086;276298;79;601384
75;2020-10-31;33;25;59;213986;139308;89;353294
75;2020-10-31;24;9;33;77600;28200;90;105800
75;2020-10-31;641;581;1226;3113538;2886444;0;5999982
76;2020-10-31;19;21;43;305956;318589;09;624545
76;2020-10-31;119;109;233;338942;356969;19;695911
76;2020-10-31;154;132;286;316210;319570;29;635780
76;2020-10-31;150;140;291;356758;337587;39;694345
76;2020-10-31;147;130;277;376541;363812;49;740353
76;2020-10-31;133;117;250;402608;383750;59;786358
76;2020-10-31;97;100;197;394889;358997;69;753886
76;2020-10-31;37;65;102;308664;263806;79;572470
76;2020-10-31;46;25;71;195838;129272;89;325110
76;2020-10-31;32;8;40;69372;26728;90;96100
76;2020-10-31;934;847;1790;3065778;2859080;0;5924858
84;2020-10-31;66;78;147;459549;481088;09;940637
84;2020-10-31;342;331;678;487711;511905;19;999616
84;2020-10-31;421;382;805;443824;451094;29;894918
84;2020-10-31;458;356;815;512522;493262;39;1005784
84;2020-10-31;466;379;845;520248;515106;49;1035354
84;2020-10-31;469;403;872;529611;514848;59;1044459
84;2020-10-31;287;252;540;486720;439940;69;926660
84;2020-10-31;182;210;392;372151;315211;79;687362
84;2020-10-31;166;121;287;237198;150524;89;387722
84;2020-10-31;80;32;112;81185;28680;90;109865
84;2020-10-31;2937;2544;5493;4130719;3901658;0;8032377
93;2020-10-31;15;13;28;268834;283093;09;551927
93;2020-10-31;93;70;163;280751;296087;19;576838
93;2020-10-31;123;106;229;254404;255552;29;509956
93;2020-10-31;149;121;271;310704;288398;39;599102
93;2020-10-31;134;107;241;325559;305827;49;631386
93;2020-10-31;119;129;248;353104;325389;59;678493
93;2020-10-31;89;86;175;336327;296459;69;632786
93;2020-10-31;72;64;136;279820;229699;79;509519
93;2020-10-31;45;40;85;171274;113716;89;284990
93;2020-10-31;26;18;44;58896;21758;90;80654
93;2020-10-31;865;755;1621;2639673;2415978;0;5055651
94;2020-10-31;0;0;0;16311;17433;09;33744
94;2020-10-31;1;2;3;16679;18132;19;34811
94;2020-10-31;7;10;17;16782;16579;29;33361
94;2020-10-31;3;2;5;23044;20580;39;43624
94;2020-10-31;6;4;10;23065;22140;49;45205
94;2020-10-31;8;10;18;24549;23421;59;47970
94;2020-10-31;4;5;9;23212;21883;69;45095
94;2020-10-31;4;1;5;19544;17141;79;36685
94;2020-10-31;2;1;3;11227;8178;89;19405
94;2020-10-31;0;0;0;3332;1447;90;4779
94;2020-10-31;35;35;70;177745;166934;0;344679
01;2020-11-01;0;0;0;19979;20155;09;40134
01;2020-11-01;0;0;0;24994;25489;19;50483
01;2020-11-01;0;0;0;17868;16690;29;34558
01;2020-11-01;0;0;0;22328;14821;39;37149
01;2020-11-01;0;2;2;28652;20276;49;48928
01;2020-11-01;0;0;0;33264;27260;59;60524
01;2020-11-01;0;1;1;27135;23978;69;51113
01;2020-11-01;0;0;0;18401;14661;79;33062
01;2020-11-01;2;0;2;9633;6375;89;16008
01;2020-11-01;0;0;0;3410;1510;90;4920
01;2020-11-01;2;3;5;205664;171215;0;376879
02;2020-11-01;0;0;0;16881;17110;09;33991
02;2020-11-01;0;0;0;21410;21604;19;43014
02;2020-11-01;0;0;0;16017;15479;29;31496
02;2020-11-01;0;0;0;19825;14455;39;34280
02;2020-11-01;1;0;1;24719;18248;49;42967
02;2020-11-01;3;1;4;34361;28310;59;62671
02;2020-11-01;1;0;1;28061;24495;69;52556
02;2020-11-01;0;0;0;18231;15278;79;33509
02;2020-11-01;0;2;2;11090;7677;89;18767
02;2020-11-01;0;0;0;3992;1506;90;5498
02;2020-11-01;5;3;8;194587;164162;0;358749
03;2020-11-01;0;0;0;31123;30920;09;62043
03;2020-11-01;0;0;0;29370;29268;19;58638
03;2020-11-01;0;0;0;21458;18963;29;40421
03;2020-11-01;0;1;1;21276;18326;39;39602
03;2020-11-01;0;0;0;18164;16593;49;34757
03;2020-11-01;0;1;1;13469;13557;59;27026
03;2020-11-01;0;1;1;8776;8670;69;17446
03;2020-11-01;1;1;2;3777;3591;79;7368
03;2020-11-01;0;0;0;1649;1072;89;2721
03;2020-11-01;0;0;0;485;184;90;669
03;2020-11-01;1;4;5;149547;141144;0;290691
04;2020-11-01;0;0;0;60314;61377;09;121691
04;2020-11-01;3;3;6;66065;68387;19;134452
04;2020-11-01;1;0;1;51059;47156;29;98215
04;2020-11-01;2;2;4;58788;45780;39;104568
04;2020-11-01;1;1;2;61408;52207;49;113615
04;2020-11-01;1;0;1;64838;60759;59;125597
04;2020-11-01;2;0;2;47008;42843;69;89851
04;2020-11-01;0;0;0;25509;21184;79;46693
04;2020-11-01;0;0;0;13168;7647;89;20815
04;2020-11-01;0;0;0;3209;1253;90;4462
04;2020-11-01;10;6;16;451366;408593;0;859959
05;2020-11-01;0;0;0;362.366008612902;341.338819562748;09;703.704828175651
05;2020-11-01;0;0;0;353.376145114279;370.349735405642;19;723.725880519921
05;2020-11-01;0;0;0;218.593559489256;256.539602589476;29;475.133162078732
05;2020-11-01;0;0;0;404.225408693299;360.321910454353;39;764.547319147651
05;2020-11-01;0;0;0;520.067953604221;497.108383964256;49;1017.17633756848
05;2020-11-01;0;0;0;468.146063921917;510.087601910415;59;978.233665832332
05;2020-11-01;0;0;0;340.368470050554;334.366842191253;69;674.735312241807
05;2020-11-01;0;0;0;212.598666888387;192.597753227106;79;405.196420115493
05;2020-11-01;0;0;0;148.727797095705;61.8681715431829;89;210.595968638888
05;2020-11-01;0;0;0;32.9601271090696;10.9909785719784;90;43.9511056810479
05;2020-11-01;0;0;0;3061.43020057959;2935.56979942041;0;5997
06;2020-11-01;0;0;0;42583;42380;09;84963
06;2020-11-01;2;0;2;33369;31925;19;65294
06;2020-11-01;2;1;3;21571;15080;29;36651
06;2020-11-01;0;0;0;21550;16147;39;37697
06;2020-11-01;2;2;4;14193;13939;49;28132
06;2020-11-01;2;0;2;7171;7597;59;14768
06;2020-11-01;1;0;1;3629;4117;69;7746
06;2020-11-01;0;0;0;1577;1457;79;3034
06;2020-11-01;1;0;1;531;474;89;1005
06;2020-11-01;0;0;0;88;93;90;181
06;2020-11-01;10;3;13;146262;133209;0;279471
07;2020-11-01;0;0;0;485;549;09;1034
07;2020-11-01;0;0;0;403;432;19;835
07;2020-11-01;0;0;0;764;841;29;1605
07;2020-11-01;0;0;0;824;928;39;1752
07;2020-11-01;0;0;0;788;1020;49;1808
07;2020-11-01;0;0;0;678;870;59;1548
07;2020-11-01;0;0;0;360;382;69;742
07;2020-11-01;0;0;0;231;190;79;421
07;2020-11-01;0;0;0;114;67;89;181
07;2020-11-01;0;0;0;24;11;90;35
07;2020-11-01;0;0;0;4671;5290;0;9961
08;2020-11-01;0;0;0;2715.22592983026;2997.75551488675;09;5712.98144471701
08;2020-11-01;0;0;0;2778.51901080978;3160.9156459093;19;5939.43465671908
08;2020-11-01;0;0;0;2080.8882988764;1718.16634315323;29;3799.05464202964
08;2020-11-01;0;0;0;2701.8582062647;1896.52641413317;39;4598.38462039786
08;2020-11-01;0;0;0;3151.45861023308;2460.52498233809;49;5611.98359257117
08;2020-11-01;0;0;0;2620.29868333099;2422.23566154656;59;5042.53434487755
08;2020-11-01;0;0;0;1621.44173420671;1438.58325779464;69;3060.02499200135
08;2020-11-01;0;0;0;626.575909335673;526.358467843651;79;1152.93437717932
08;2020-11-01;0;0;0;205.018522985054;140.993639349697;89;346.012162334751
08;2020-11-01;0;0;0;50.0325684687745;20.62259870351;90;70.6551671722846
08;2020-11-01;0;0;0;18551.3174743414;16782.6825256586;0;35334
11;2020-11-01;13;20;34;783071;811785;09;1594856
11;2020-11-01;60;53;118;761456;784653;19;1546109
11;2020-11-01;89;90;179;850145;801772;29;1651917
11;2020-11-01;108;89;197;914360;843488;39;1757848
11;2020-11-01;87;99;186;845609;826202;49;1671811
11;2020-11-01;66;82;148;793566;745070;59;1538636
11;2020-11-01;63;64;127;628649;549192;69;1177841
11;2020-11-01;45;54;99;434606;358356;79;792962
11;2020-11-01;31;32;63;261425;162933;89;424358
11;2020-11-01;19;10;29;89253;32619;90;121872
11;2020-11-01;581;593;1180;6362140;5916070;0;12278210
24;2020-11-01;5;5;10;139720;144686;09;284406
24;2020-11-01;13;14;28;152979;161185;19;314164
24;2020-11-01;16;15;31;122237;126536;29;248773
24;2020-11-01;22;8;30;150359;142009;39;292368
24;2020-11-01;19;21;40;161829;158758;49;320587
24;2020-11-01;14;16;30;172552;168011;59;340563
24;2020-11-01;13;15;28;172509;158177;69;330686
24;2020-11-01;8;11;19;129428;110593;79;240021
24;2020-11-01;19;11;30;87342;56882;89;144224
24;2020-11-01;8;3;11;31210;12071;90;43281
24;2020-11-01;137;119;257;1320165;1238908;0;2559073
27;2020-11-01;5;6;11;143373;149679;09;293052
27;2020-11-01;17;9;26;160962;173003;19;333965
27;2020-11-01;16;7;23;133746;142254;29;276000
27;2020-11-01;20;20;40;160004;155407;39;315411
27;2020-11-01;34;18;52;172333;169564;49;341897
27;2020-11-01;26;19;45;189979;183788;59;373767
27;2020-11-01;13;21;34;192591;178206;69;370797
27;2020-11-01;12;13;25;146876;127546;79;274422
27;2020-11-01;20;11;31;96896;61575;89;158471
27;2020-11-01;19;2;21;33148;12109;90;45257
27;2020-11-01;182;126;308;1429908;1353131;0;2783039
28;2020-11-01;6;5;11;180735;186856;09;367591
28;2020-11-01;18;20;39;200125;213621;19;413746
28;2020-11-01;28;17;45;168922;173007;29;341929
28;2020-11-01;40;22;62;196628;188487;39;385115
28;2020-11-01;28;24;52;205396;201699;49;407095
28;2020-11-01;27;18;45;222002;213866;59;435868
28;2020-11-01;25;17;42;224688;203758;69;428446
28;2020-11-01;14;18;32;163192;135543;79;298735
28;2020-11-01;29;17;46;109691;65377;89;175068
28;2020-11-01;21;4;25;37222;12685;90;49907
28;2020-11-01;236;162;399;1708601;1594899;0;3303500
32;2020-11-01;32;16;48;358062;373689;09;731751
32;2020-11-01;95;99;198;387045;406742;19;793787
32;2020-11-01;126;98;227;342304;348587;29;690891
32;2020-11-01;119;107;228;382485;369972;39;752457
32;2020-11-01;126;96;222;382510;376716;49;759226
32;2020-11-01;78;96;175;386937;376527;59;763464
32;2020-11-01;39;41;81;371211;330938;69;702149
32;2020-11-01;24;31;56;250542;201459;79;452001
32;2020-11-01;24;19;43;163399;89786;89;253185
32;2020-11-01;18;8;26;48384;15367;90;63751
32;2020-11-01;681;611;1304;3072879;2889783;0;5962662
44;2020-11-01;7;8;15;291525;306839;09;598364
44;2020-11-01;13;15;28;320255;339504;19;659759
44;2020-11-01;26;21;48;302020;314428;29;616448
44;2020-11-01;31;17;48;342222;333292;39;675514
44;2020-11-01;27;19;46;349727;344491;49;694218
44;2020-11-01;26;26;52;381371;373239;59;754610
44;2020-11-01;14;18;32;367165;335850;69;703015
44;2020-11-01;12;15;27;250387;215436;79;465823
44;2020-11-01;20;19;39;170825;105192;89;276017
44;2020-11-01;14;8;22;51248;16731;90;67979
44;2020-11-01;190;166;357;2826745;2685002;0;5511747
52;2020-11-01;2;2;4;213594;223900;09;437494
52;2020-11-01;17;16;35;240818;255197;19;496015
52;2020-11-01;18;13;31;197010;200630;29;397640
52;2020-11-01;31;22;53;231204;224885;39;456089
52;2020-11-01;21;19;40;243874;243418;49;487292
52;2020-11-01;23;17;40;244100;239116;59;483216
52;2020-11-01;11;13;24;241796;221345;69;463141
52;2020-11-01;14;10;24;177805;149903;79;327708
52;2020-11-01;9;7;16;119561;75822;89;195383
52;2020-11-01;7;4;11;42559;15260;90;57819
52;2020-11-01;153;123;278;1952321;1849476;0;3801797
53;2020-11-01;2;2;4;173813;182358;09;356171
53;2020-11-01;8;12;20;202720;214740;19;417460
53;2020-11-01;6;19;25;163116;173196;29;336312
53;2020-11-01;18;8;26;190526;187674;39;378200
53;2020-11-01;17;15;32;212098;212015;49;424113
53;2020-11-01;10;11;21;223699;219176;59;442875
53;2020-11-01;11;16;27;227435;209274;69;436709
53;2020-11-01;5;3;8;169992;140910;79;310902
53;2020-11-01;2;2;4;118117;69883;89;188000
53;2020-11-01;0;4;4;37370;12267;90;49637
53;2020-11-01;79;92;171;1718886;1621493;0;3340379
75;2020-11-01;1;4;5;293104;305291;09;598395
75;2020-11-01;12;5;17;337141;357785;19;694926
75;2020-11-01;20;15;35;295024;300618;29;595642
75;2020-11-01;22;12;34;347871;331233;39;679104
75;2020-11-01;12;16;28;384742;372771;49;757513
75;2020-11-01;11;9;20;413361;390880;59;804241
75;2020-11-01;8;11;19;425623;384060;69;809683
75;2020-11-01;11;12;23;325086;276298;79;601384
75;2020-11-01;13;13;26;213986;139308;89;353294
75;2020-11-01;21;2;23;77600;28200;90;105800
75;2020-11-01;131;99;230;3113538;2886444;0;5999982
76;2020-11-01;16;11;27;305956;318589;09;624545
76;2020-11-01;35;45;80;338942;356969;19;695911
76;2020-11-01;58;37;95;316210;319570;29;635780
76;2020-11-01;48;47;95;356758;337587;39;694345
76;2020-11-01;43;48;91;376541;363812;49;740353
76;2020-11-01;41;40;81;402608;383750;59;786358
76;2020-11-01;31;29;62;394889;358997;69;753886
76;2020-11-01;16;14;30;308664;263806;79;572470
76;2020-11-01;21;21;42;195838;129272;89;325110
76;2020-11-01;12;6;18;69372;26728;90;96100
76;2020-11-01;321;298;621;3065778;2859080;0;5924858
84;2020-11-01;13;9;22;459549;481088;09;940637
84;2020-11-01;56;47;103;487711;511905;19;999616
84;2020-11-01;91;58;149;443824;451094;29;894918
84;2020-11-01;93;80;173;512522;493262;39;1005784
84;2020-11-01;97;82;179;520248;515106;49;1035354
84;2020-11-01;94;80;174;529611;514848;59;1044459
84;2020-11-01;49;67;116;486720;439940;69;926660
84;2020-11-01;39;66;105;372151;315211;79;687362
84;2020-11-01;79;59;138;237198;150524;89;387722
84;2020-11-01;56;19;75;81185;28680;90;109865
84;2020-11-01;668;567;1235;4130719;3901658;0;8032377
93;2020-11-01;7;5;12;268834;283093;09;551927
93;2020-11-01;15;15;30;280751;296087;19;576838
93;2020-11-01;31;22;53;254404;255552;29;509956
93;2020-11-01;44;21;65;310704;288398;39;599102
93;2020-11-01;37;31;68;325559;305827;49;631386
93;2020-11-01;26;25;51;353104;325389;59;678493
93;2020-11-01;23;23;46;336327;296459;69;632786
93;2020-11-01;12;29;41;279820;229699;79;509519
93;2020-11-01;31;20;51;171274;113716;89;284990
93;2020-11-01;18;9;27;58896;21758;90;80654
93;2020-11-01;244;200;444;2639673;2415978;0;5055651
94;2020-11-01;0;1;1;16311;17433;09;33744
94;2020-11-01;0;0;0;16679;18132;19;34811
94;2020-11-01;0;1;1;16782;16579;29;33361
94;2020-11-01;0;0;0;23044;20580;39;43624
94;2020-11-01;1;2;3;23065;22140;49;45205
94;2020-11-01;3;0;3;24549;23421;59;47970
94;2020-11-01;1;1;2;23212;21883;69;45095
94;2020-11-01;1;2;3;19544;17141;79;36685
94;2020-11-01;2;0;2;11227;8178;89;19405
94;2020-11-01;1;0;1;3332;1447;90;4779
94;2020-11-01;9;7;16;177745;166934;0;344679
01;2020-11-02;0;0;0;19979;20155;09;40134
01;2020-11-02;1;0;1;24994;25489;19;50483
01;2020-11-02;1;0;1;17868;16690;29;34558
01;2020-11-02;2;0;2;22328;14821;39;37149
01;2020-11-02;2;0;2;28652;20276;49;48928
01;2020-11-02;1;1;2;33264;27260;59;60524
01;2020-11-02;1;1;2;27135;23978;69;51113
01;2020-11-02;1;0;1;18401;14661;79;33062
01;2020-11-02;0;1;1;9633;6375;89;16008
01;2020-11-02;0;0;0;3410;1510;90;4920
01;2020-11-02;9;3;12;205664;171215;0;376879
02;2020-11-02;0;0;0;16881;17110;09;33991
02;2020-11-02;1;1;2;21410;21604;19;43014
02;2020-11-02;3;1;4;16017;15479;29;31496
02;2020-11-02;0;0;0;19825;14455;39;34280
02;2020-11-02;0;1;1;24719;18248;49;42967
02;2020-11-02;0;0;0;34361;28310;59;62671
02;2020-11-02;1;1;2;28061;24495;69;52556
02;2020-11-02;0;0;0;18231;15278;79;33509
02;2020-11-02;1;3;4;11090;7677;89;18767
02;2020-11-02;1;0;1;3992;1506;90;5498
02;2020-11-02;7;7;14;194587;164162;0;358749
03;2020-11-02;2;0;2;31123;30920;09;62043
03;2020-11-02;0;1;1;29370;29268;19;58638
03;2020-11-02;3;2;5;21458;18963;29;40421
03;2020-11-02;1;5;6;21276;18326;39;39602
03;2020-11-02;3;2;5;18164;16593;49;34757
03;2020-11-02;1;3;4;13469;13557;59;27026
03;2020-11-02;1;0;1;8776;8670;69;17446
03;2020-11-02;0;0;1;3777;3591;79;7368
03;2020-11-02;0;0;0;1649;1072;89;2721
03;2020-11-02;0;0;0;485;184;90;669
03;2020-11-02;11;13;25;149547;141144;0;290691
04;2020-11-02;6;3;9;60314;61377;09;121691
04;2020-11-02;23;11;34;66065;68387;19;134452
04;2020-11-02;9;8;17;51059;47156;29;98215
04;2020-11-02;10;7;17;58788;45780;39;104568
04;2020-11-02;11;11;22;61408;52207;49;113615
04;2020-11-02;8;9;17;64838;60759;59;125597
04;2020-11-02;6;6;12;47008;42843;69;89851
04;2020-11-02;2;3;5;25509;21184;79;46693
04;2020-11-02;3;1;4;13168;7647;89;20815
04;2020-11-02;0;0;0;3209;1253;90;4462
04;2020-11-02;78;59;137;451366;408593;0;859959
05;2020-11-02;0;0;0;362.366008612902;341.338819562748;09;703.704828175651
05;2020-11-02;0;0;0;353.376145114279;370.349735405642;19;723.725880519921
05;2020-11-02;0;0;0;218.593559489256;256.539602589476;29;475.133162078732
05;2020-11-02;0;0;0;404.225408693299;360.321910454353;39;764.547319147651
05;2020-11-02;0;0;0;520.067953604221;497.108383964256;49;1017.17633756848
05;2020-11-02;0;0;0;468.146063921917;510.087601910415;59;978.233665832332
05;2020-11-02;0;0;0;340.368470050554;334.366842191253;69;674.735312241807
05;2020-11-02;0;0;0;212.598666888387;192.597753227106;79;405.196420115493
05;2020-11-02;0;0;0;148.727797095705;61.8681715431829;89;210.595968638888
05;2020-11-02;0;0;0;32.9601271090696;10.9909785719784;90;43.9511056810479
05;2020-11-02;0;0;0;3061.43020057959;2935.56979942041;0;5997
06;2020-11-02;0;0;0;42583;42380;09;84963
06;2020-11-02;5;4;9;33369;31925;19;65294
06;2020-11-02;8;1;9;21571;15080;29;36651
06;2020-11-02;14;4;18;21550;16147;39;37697
06;2020-11-02;16;14;30;14193;13939;49;28132
06;2020-11-02;4;4;8;7171;7597;59;14768
06;2020-11-02;1;0;1;3629;4117;69;7746
06;2020-11-02;2;1;3;1577;1457;79;3034
06;2020-11-02;0;0;0;531;474;89;1005
06;2020-11-02;0;0;0;88;93;90;181
06;2020-11-02;50;28;78;146262;133209;0;279471
07;2020-11-02;0;0;0;485;549;09;1034
07;2020-11-02;1;0;1;403;432;19;835
07;2020-11-02;0;0;0;764;841;29;1605
07;2020-11-02;0;1;1;824;928;39;1752
07;2020-11-02;0;0;0;788;1020;49;1808
07;2020-11-02;0;1;1;678;870;59;1548
07;2020-11-02;0;0;0;360;382;69;742
07;2020-11-02;0;0;0;231;190;79;421
07;2020-11-02;0;0;0;114;67;89;181
07;2020-11-02;0;0;0;24;11;90;35
07;2020-11-02;1;2;3;4671;5290;0;9961
08;2020-11-02;0;0;0;2715.22592983026;2997.75551488675;09;5712.98144471701
08;2020-11-02;0;0;0;2778.51901080978;3160.9156459093;19;5939.43465671908
08;2020-11-02;0;0;0;2080.8882988764;1718.16634315323;29;3799.05464202964
08;2020-11-02;0;0;0;2701.8582062647;1896.52641413317;39;4598.38462039786
08;2020-11-02;1;0;1;3151.45861023308;2460.52498233809;49;5611.98359257117
08;2020-11-02;0;1;1;2620.29868333099;2422.23566154656;59;5042.53434487755
08;2020-11-02;1;0;1;1621.44173420671;1438.58325779464;69;3060.02499200135
08;2020-11-02;0;0;0;626.575909335673;526.358467843651;79;1152.93437717932
08;2020-11-02;0;0;0;205.018522985054;140.993639349697;89;346.012162334751
08;2020-11-02;0;0;0;50.0325684687745;20.62259870351;90;70.6551671722846
08;2020-11-02;2;1;3;18551.3174743414;16782.6825256586;0;35334
11;2020-11-02;161;175;354;783071;811785;09;1594856
11;2020-11-02;704;664;1425;761456;784653;19;1546109
11;2020-11-02;1077;876;1961;850145;801772;29;1651917
11;2020-11-02;1154;981;2144;914360;843488;39;1757848
11;2020-11-02;1070;925;2002;845609;826202;49;1671811
11;2020-11-02;938;808;1756;793566;745070;59;1538636
11;2020-11-02;642;671;1321;628649;549192;69;1177841
11;2020-11-02;269;258;528;434606;358356;79;792962
11;2020-11-02;194;120;314;261425;162933;89;424358
11;2020-11-02;113;23;136;89253;32619;90;121872
11;2020-11-02;6323;5505;11948;6362140;5916070;0;12278210
24;2020-11-02;25;25;50;139720;144686;09;284406
24;2020-11-02;117;124;244;152979;161185;19;314164
24;2020-11-02;154;123;279;122237;126536;29;248773
24;2020-11-02;177;129;306;150359;142009;39;292368
24;2020-11-02;159;136;295;161829;158758;49;320587
24;2020-11-02;161;132;293;172552;168011;59;340563
24;2020-11-02;99;93;192;172509;158177;69;330686
24;2020-11-02;74;63;137;129428;110593;79;240021
24;2020-11-02;59;43;102;87342;56882;89;144224
24;2020-11-02;40;6;46;31210;12071;90;43281
24;2020-11-02;1065;874;1944;1320165;1238908;0;2559073
27;2020-11-02;54;43;98;143373;149679;09;293052
27;2020-11-02;243;227;473;160962;173003;19;333965
27;2020-11-02;293;263;556;133746;142254;29;276000
27;2020-11-02;273;239;512;160004;155407;39;315411
27;2020-11-02;312;263;575;172333;169564;49;341897
27;2020-11-02;316;292;608;189979;183788;59;373767
27;2020-11-02;192;205;397;192591;178206;69;370797
27;2020-11-02;138;128;266;146876;127546;79;274422
27;2020-11-02;136;77;213;96896;61575;89;158471
27;2020-11-02;84;34;118;33148;12109;90;45257
27;2020-11-02;2042;1772;3818;1429908;1353131;0;2783039
28;2020-11-02;42;45;90;180735;186856;09;367591
28;2020-11-02;148;139;287;200125;213621;19;413746
28;2020-11-02;191;154;345;168922;173007;29;341929
28;2020-11-02;198;163;361;196628;188487;39;385115
28;2020-11-02;212;152;365;205396;201699;49;407095
28;2020-11-02;211;158;369;222002;213866;59;435868
28;2020-11-02;156;147;303;224688;203758;69;428446
28;2020-11-02;91;88;179;163192;135543;79;298735
28;2020-11-02;71;56;127;109691;65377;89;175068
28;2020-11-02;43;14;57;37222;12685;90;49907
28;2020-11-02;1363;1116;2483;1708601;1594899;0;3303500
32;2020-11-02;122;141;263;358062;373689;09;731751
32;2020-11-02;497;507;1006;387045;406742;19;793787
32;2020-11-02;609;480;1090;342304;348587;29;690891
32;2020-11-02;619;514;1134;382485;369972;39;752457
32;2020-11-02;570;509;1079;382510;376716;49;759226
32;2020-11-02;554;533;1087;386937;376527;59;763464
32;2020-11-02;423;399;822;371211;330938;69;702149
32;2020-11-02;284;244;528;250542;201459;79;452001
32;2020-11-02;173;136;309;163399;89786;89;253185
32;2020-11-02;100;28;128;48384;15367;90;63751
32;2020-11-02;3951;3491;7446;3072879;2889783;0;5962662
44;2020-11-02;76;84;161;291525;306839;09;598364
44;2020-11-02;356;347;707;320255;339504;19;659759
44;2020-11-02;502;453;959;302020;314428;29;616448
44;2020-11-02;538;420;959;342222;333292;39;675514
44;2020-11-02;505;423;929;349727;344491;49;694218
44;2020-11-02;501;443;946;381371;373239;59;754610
44;2020-11-02;309;278;588;367165;335850;69;703015
44;2020-11-02;212;216;429;250387;215436;79;465823
44;2020-11-02;188;117;306;170825;105192;89;276017
44;2020-11-02;95;27;122;51248;16731;90;67979
44;2020-11-02;3283;2809;6108;2826745;2685002;0;5511747
52;2020-11-02;32;39;76;213594;223900;09;437494
52;2020-11-02;190;176;375;240818;255197;19;496015
52;2020-11-02;238;215;455;197010;200630;29;397640
52;2020-11-02;209;180;389;231204;224885;39;456089
52;2020-11-02;227;200;427;243874;243418;49;487292
52;2020-11-02;198;189;388;244100;239116;59;483216
52;2020-11-02;141;137;278;241796;221345;69;463141
52;2020-11-02;93;96;189;177805;149903;79;327708
52;2020-11-02;61;50;111;119561;75822;89;195383
52;2020-11-02;43;15;58;42559;15260;90;57819
52;2020-11-02;1432;1297;2746;1952321;1849476;0;3801797
53;2020-11-02;28;24;58;173813;182358;09;356171
53;2020-11-02;99;109;214;202720;214740;19;417460
53;2020-11-02;158;148;309;163116;173196;29;336312
53;2020-11-02;151;123;274;190526;187674;39;378200
53;2020-11-02;122;118;240;212098;212015;49;424113
53;2020-11-02;149;144;293;223699;219176;59;442875
53;2020-11-02;85;96;181;227435;209274;69;436709
53;2020-11-02;60;62;122;169992;140910;79;310902
53;2020-11-02;36;28;64;118117;69883;89;188000
53;2020-11-02;27;7;35;37370;12267;90;49637
53;2020-11-02;915;859;1790;1718886;1621493;0;3340379
75;2020-11-02;54;42;101;293104;305291;09;598395
75;2020-11-02;226;205;434;337141;357785;19;694926
75;2020-11-02;324;269;595;295024;300618;29;595642
75;2020-11-02;366;289;656;347871;331233;39;679104
75;2020-11-02;347;309;656;384742;372771;49;757513
75;2020-11-02;286;292;579;413361;390880;59;804241
75;2020-11-02;246;209;455;425623;384060;69;809683
75;2020-11-02;137;146;283;325086;276298;79;601384
75;2020-11-02;129;83;212;213986;139308;89;353294
75;2020-11-02;113;45;158;77600;28200;90;105800
75;2020-11-02;2230;1890;4132;3113538;2886444;0;5999982
76;2020-11-02;47;54;106;305956;318589;09;624545
76;2020-11-02;259;278;547;338942;356969;19;695911
76;2020-11-02;383;301;684;316210;319570;29;635780
76;2020-11-02;434;373;807;356758;337587;39;694345
76;2020-11-02;454;375;831;376541;363812;49;740353
76;2020-11-02;447;356;803;402608;383750;59;786358
76;2020-11-02;269;296;565;394889;358997;69;753886
76;2020-11-02;163;176;339;308664;263806;79;572470
76;2020-11-02;173;110;283;195838;129272;89;325110
76;2020-11-02;107;42;149;69372;26728;90;96100
76;2020-11-02;2738;2364;5119;3065778;2859080;0;5924858
84;2020-11-02;183;171;358;459549;481088;09;940637
84;2020-11-02;868;892;1769;487711;511905;19;999616
84;2020-11-02;1286;1021;2307;443824;451094;29;894918
84;2020-11-02;1330;1067;2398;512522;493262;39;1005784
84;2020-11-02;1400;1114;2517;520248;515106;49;1035354
84;2020-11-02;1328;1150;2478;529611;514848;59;1044459
84;2020-11-02;792;712;1504;486720;439940;69;926660
84;2020-11-02;594;478;1072;372151;315211;79;687362
84;2020-11-02;482;299;781;237198;150524;89;387722
84;2020-11-02;337;108;445;81185;28680;90;109865
84;2020-11-02;8601;7012;15630;4130719;3901658;0;8032377
93;2020-11-02;65;65;131;268834;283093;09;551927
93;2020-11-02;310;317;628;280751;296087;19;576838
93;2020-11-02;451;362;813;254404;255552;29;509956
93;2020-11-02;541;362;903;310704;288398;39;599102
93;2020-11-02;523;438;962;325559;305827;49;631386
93;2020-11-02;512;455;967;353104;325389;59;678493
93;2020-11-02;331;318;649;336327;296459;69;632786
93;2020-11-02;250;225;475;279820;229699;79;509519
93;2020-11-02;191;128;319;171274;113716;89;284990
93;2020-11-02;149;38;187;58896;21758;90;80654
93;2020-11-02;3325;2709;6039;2639673;2415978;0;5055651
94;2020-11-02;4;6;10;16311;17433;09;33744
94;2020-11-02;12;8;20;16679;18132;19;34811
94;2020-11-02;27;25;52;16782;16579;29;33361
94;2020-11-02;23;23;46;23044;20580;39;43624
94;2020-11-02;27;23;50;23065;22140;49;45205
94;2020-11-02;33;24;57;24549;23421;59;47970
94;2020-11-02;12;14;26;23212;21883;69;45095
94;2020-11-02;9;6;15;19544;17141;79;36685
94;2020-11-02;7;5;12;11227;8178;89;19405
94;2020-11-02;0;4;4;3332;1447;90;4779
94;2020-11-02;154;138;292;177745;166934;0;344679
01;2020-11-03;0;0;0;19979;20155;09;40134
01;2020-11-03;6;2;8;24994;25489;19;50483
01;2020-11-03;3;2;5;17868;16690;29;34558
01;2020-11-03;8;5;13;22328;14821;39;37149
01;2020-11-03;4;2;6;28652;20276;49;48928
01;2020-11-03;9;8;17;33264;27260;59;60524
01;2020-11-03;3;6;9;27135;23978;69;51113
01;2020-11-03;2;3;5;18401;14661;79;33062
01;2020-11-03;0;0;0;9633;6375;89;16008
01;2020-11-03;0;0;0;3410;1510;90;4920
01;2020-11-03;35;28;63;205664;171215;0;376879
02;2020-11-03;1;2;3;16881;17110;09;33991
02;2020-11-03;11;5;16;21410;21604;19;43014
02;2020-11-03;9;4;13;16017;15479;29;31496
02;2020-11-03;4;9;13;19825;14455;39;34280
02;2020-11-03;12;4;16;24719;18248;49;42967
02;2020-11-03;20;9;29;34361;28310;59;62671
02;2020-11-03;15;11;26;28061;24495;69;52556
02;2020-11-03;2;3;5;18231;15278;79;33509
02;2020-11-03;3;3;6;11090;7677;89;18767
02;2020-11-03;2;0;2;3992;1506;90;5498
02;2020-11-03;79;50;129;194587;164162;0;358749
03;2020-11-03;0;0;0;31123;30920;09;62043
03;2020-11-03;4;1;5;29370;29268;19;58638
03;2020-11-03;3;1;4;21458;18963;29;40421
03;2020-11-03;7;4;11;21276;18326;39;39602
03;2020-11-03;3;1;4;18164;16593;49;34757
03;2020-11-03;1;1;2;13469;13557;59;27026
03;2020-11-03;0;1;1;8776;8670;69;17446
03;2020-11-03;0;1;1;3777;3591;79;7368
03;2020-11-03;0;0;0;1649;1072;89;2721
03;2020-11-03;0;0;0;485;184;90;669
03;2020-11-03;18;10;28;149547;141144;0;290691
04;2020-11-03;5;2;7;60314;61377;09;121691
04;2020-11-03;21;12;33;66065;68387;19;134452
04;2020-11-03;8;6;14;51059;47156;29;98215
04;2020-11-03;10;16;26;58788;45780;39;104568
04;2020-11-03;8;6;14;61408;52207;49;113615
04;2020-11-03;8;6;14;64838;60759;59;125597
04;2020-11-03;7;6;13;47008;42843;69;89851
04;2020-11-03;1;1;2;25509;21184;79;46693
04;2020-11-03;1;2;3;13168;7647;89;20815
04;2020-11-03;0;0;0;3209;1253;90;4462
04;2020-11-03;69;57;126;451366;408593;0;859959
05;2020-11-03;0;0;0;362.366008612902;341.338819562748;09;703.704828175651
05;2020-11-03;0;0;0;353.376145114279;370.349735405642;19;723.725880519921
05;2020-11-03;0;0;0;218.593559489256;256.539602589476;29;475.133162078732
05;2020-11-03;0;0;0;404.225408693299;360.321910454353;39;764.547319147651
05;2020-11-03;0;0;0;520.067953604221;497.108383964256;49;1017.17633756848
05;2020-11-03;0;0;0;468.146063921917;510.087601910415;59;978.233665832332
05;2020-11-03;0;0;0;340.368470050554;334.366842191253;69;674.735312241807
05;2020-11-03;0;0;0;212.598666888387;192.597753227106;79;405.196420115493
05;2020-11-03;0;0;0;148.727797095705;61.8681715431829;89;210.595968638888
05;2020-11-03;0;0;0;32.9601271090696;10.9909785719784;90;43.9511056810479
05;2020-11-03;0;0;0;3061.43020057959;2935.56979942041;0;5997
06;2020-11-03;1;0;1;42583;42380;09;84963
06;2020-11-03;2;1;3;33369;31925;19;65294
06;2020-11-03;6;2;8;21571;15080;29;36651
06;2020-11-03;4;4;8;21550;16147;39;37697
06;2020-11-03;2;2;4;14193;13939;49;28132
06;2020-11-03;2;1;3;7171;7597;59;14768
06;2020-11-03;0;1;1;3629;4117;69;7746
06;2020-11-03;0;0;0;1577;1457;79;3034
06;2020-11-03;0;0;0;531;474;89;1005
06;2020-11-03;0;0;0;88;93;90;181
06;2020-11-03;17;11;28;146262;133209;0;279471
07;2020-11-03;0;0;0;485;549;09;1034
07;2020-11-03;0;0;0;403;432;19;835
07;2020-11-03;0;0;0;764;841;29;1605
07;2020-11-03;0;0;0;824;928;39;1752
07;2020-11-03;0;0;0;788;1020;49;1808
07;2020-11-03;0;0;0;678;870;59;1548
07;2020-11-03;0;0;0;360;382;69;742
07;2020-11-03;0;0;0;231;190;79;421
07;2020-11-03;0;0;0;114;67;89;181
07;2020-11-03;0;0;0;24;11;90;35
07;2020-11-03;0;0;0;4671;5290;0;9961
08;2020-11-03;0;0;0;2715.22592983026;2997.75551488675;09;5712.98144471701
08;2020-11-03;0;1;1;2778.51901080978;3160.9156459093;19;5939.43465671908
08;2020-11-03;0;0;0;2080.8882988764;1718.16634315323;29;3799.05464202964
08;2020-11-03;2;1;3;2701.8582062647;1896.52641413317;39;4598.38462039786
08;2020-11-03;1;0;1;3151.45861023308;2460.52498233809;49;5611.98359257117
08;2020-11-03;0;1;1;2620.29868333099;2422.23566154656;59;5042.53434487755
08;2020-11-03;0;1;1;1621.44173420671;1438.58325779464;69;3060.02499200135
08;2020-11-03;0;0;0;626.575909335673;526.358467843651;79;1152.93437717932
08;2020-11-03;0;0;0;205.018522985054;140.993639349697;89;346.012162334751
08;2020-11-03;0;0;0;50.0325684687745;20.62259870351;90;70.6551671722846
08;2020-11-03;3;4;7;18551.3174743414;16782.6825256586;0;35334
11;2020-11-03;108;113;235;783071;811785;09;1594856
11;2020-11-03;554;559;1157;761456;784653;19;1546109
11;2020-11-03;812;661;1477;850145;801772;29;1651917
11;2020-11-03;917;691;1613;914360;843488;39;1757848
11;2020-11-03;829;696;1530;845609;826202;49;1671811
11;2020-11-03;728;673;1404;793566;745070;59;1538636
11;2020-11-03;503;552;1062;628649;549192;69;1177841
11;2020-11-03;242;245;490;434606;358356;79;792962
11;2020-11-03;200;106;307;261425;162933;89;424358
11;2020-11-03;114;28;142;89253;32619;90;121872
11;2020-11-03;5012;4326;9426;6362140;5916070;0;12278210
24;2020-11-03;13;23;36;139720;144686;09;284406
24;2020-11-03;98;115;214;152979;161185;19;314164
24;2020-11-03;141;106;248;122237;126536;29;248773
24;2020-11-03;142;126;268;150359;142009;39;292368
24;2020-11-03;144;121;266;161829;158758;49;320587
24;2020-11-03;155;150;305;172552;168011;59;340563
24;2020-11-03;113;109;222;172509;158177;69;330686
24;2020-11-03;60;75;135;129428;110593;79;240021
24;2020-11-03;50;36;86;87342;56882;89;144224
24;2020-11-03;33;11;44;31210;12071;90;43281
24;2020-11-03;949;872;1824;1320165;1238908;0;2559073
27;2020-11-03;39;41;80;143373;149679;09;293052
27;2020-11-03;201;181;382;160962;173003;19;333965
27;2020-11-03;224;221;445;133746;142254;29;276000
27;2020-11-03;231;189;420;160004;155407;39;315411
27;2020-11-03;274;239;513;172333;169564;49;341897
27;2020-11-03;284;238;522;189979;183788;59;373767
27;2020-11-03;192;191;383;192591;178206;69;370797
27;2020-11-03;143;148;291;146876;127546;79;274422
27;2020-11-03;106;81;187;96896;61575;89;158471
27;2020-11-03;70;26;96;33148;12109;90;45257
27;2020-11-03;1764;1556;3320;1429908;1353131;0;2783039
28;2020-11-03;25;32;59;180735;186856;09;367591
28;2020-11-03;144;114;261;200125;213621;19;413746
28;2020-11-03;146;132;280;168922;173007;29;341929
28;2020-11-03;167;138;306;196628;188487;39;385115
28;2020-11-03;150;138;288;205396;201699;49;407095
28;2020-11-03;154;155;309;222002;213866;59;435868
28;2020-11-03;161;138;299;224688;203758;69;428446
28;2020-11-03;85;80;166;163192;135543;79;298735
28;2020-11-03;72;46;118;109691;65377;89;175068
28;2020-11-03;36;11;47;37222;12685;90;49907
28;2020-11-03;1140;984;2133;1708601;1594899;0;3303500
32;2020-11-03;104;121;226;358062;373689;09;731751
32;2020-11-03;339;365;704;387045;406742;19;793787
32;2020-11-03;443;375;818;342304;348587;29;690891
32;2020-11-03;515;411;927;382485;369972;39;752457
32;2020-11-03;493;393;886;382510;376716;49;759226
32;2020-11-03;460;424;884;386937;376527;59;763464
32;2020-11-03;323;327;650;371211;330938;69;702149
32;2020-11-03;220;207;427;250542;201459;79;452001
32;2020-11-03;181;104;285;163399;89786;89;253185
32;2020-11-03;88;35;123;48384;15367;90;63751
32;2020-11-03;3167;2762;5931;3072879;2889783;0;5962662
44;2020-11-03;62;72;136;291525;306839;09;598364
44;2020-11-03;262;262;526;320255;339504;19;659759
44;2020-11-03;383;336;719;302020;314428;29;616448
44;2020-11-03;365;318;683;342222;333292;39;675514
44;2020-11-03;341;314;658;349727;344491;49;694218
44;2020-11-03;348;373;723;381371;373239;59;754610
44;2020-11-03;261;247;512;367165;335850;69;703015
44;2020-11-03;181;189;371;250387;215436;79;465823
44;2020-11-03;133;112;249;170825;105192;89;276017
44;2020-11-03;86;22;108;51248;16731;90;67979
44;2020-11-03;2422;2246;4686;2826745;2685002;0;5511747
52;2020-11-03;28;29;58;213594;223900;09;437494
52;2020-11-03;175;119;297;240818;255197;19;496015
52;2020-11-03;214;194;409;197010;200630;29;397640
52;2020-11-03;187;156;343;231204;224885;39;456089
52;2020-11-03;212;171;383;243874;243418;49;487292
52;2020-11-03;207;179;387;244100;239116;59;483216
52;2020-11-03;130;129;259;241796;221345;69;463141
52;2020-11-03;116;83;199;177805;149903;79;327708
52;2020-11-03;68;36;104;119561;75822;89;195383
52;2020-11-03;43;14;57;42559;15260;90;57819
52;2020-11-03;1380;1110;2496;1952321;1849476;0;3801797
53;2020-11-03;24;18;44;173813;182358;09;356171
53;2020-11-03;79;95;175;202720;214740;19;417460
53;2020-11-03;129;117;248;163116;173196;29;336312
53;2020-11-03;121;91;213;190526;187674;39;378200
53;2020-11-03;97;93;190;212098;212015;49;424113
53;2020-11-03;116;86;202;223699;219176;59;442875
53;2020-11-03;86;68;154;227435;209274;69;436709
53;2020-11-03;68;54;122;169992;140910;79;310902
53;2020-11-03;55;25;80;118117;69883;89;188000
53;2020-11-03;32;10;42;37370;12267;90;49637
53;2020-11-03;808;657;1471;1718886;1621493;0;3340379
75;2020-11-03;43;39;83;293104;305291;09;598395
75;2020-11-03;175;168;350;337141;357785;19;694926
75;2020-11-03;297;242;540;295024;300618;29;595642
75;2020-11-03;272;196;469;347871;331233;39;679104
75;2020-11-03;284;237;523;384742;372771;49;757513
75;2020-11-03;263;224;487;413361;390880;59;804241
75;2020-11-03;192;191;383;425623;384060;69;809683
75;2020-11-03;139;120;259;325086;276298;79;601384
75;2020-11-03;97;68;165;213986;139308;89;353294
75;2020-11-03;88;25;113;77600;28200;90;105800
75;2020-11-03;1851;1510;3373;3113538;2886444;0;5999982
76;2020-11-03;59;46;107;305956;318589;09;624545
76;2020-11-03;230;265;504;338942;356969;19;695911
76;2020-11-03;308;254;562;316210;319570;29;635780
76;2020-11-03;360;270;631;356758;337587;39;694345
76;2020-11-03;322;278;600;376541;363812;49;740353
76;2020-11-03;326;273;599;402608;383750;59;786358
76;2020-11-03;254;238;492;394889;358997;69;753886
76;2020-11-03;193;152;345;308664;263806;79;572470
76;2020-11-03;157;107;264;195838;129272;89;325110
76;2020-11-03;96;41;137;69372;26728;90;96100
76;2020-11-03;2310;1927;4249;3065778;2859080;0;5924858
84;2020-11-03;171;162;337;459549;481088;09;940637
84;2020-11-03;813;866;1693;487711;511905;19;999616
84;2020-11-03;1069;901;1973;443824;451094;29;894918
84;2020-11-03;1161;947;2110;512522;493262;39;1005784
84;2020-11-03;1180;966;2146;520248;515106;49;1035354
84;2020-11-03;1113;1075;2188;529611;514848;59;1044459
84;2020-11-03;734;667;1401;486720;439940;69;926660
84;2020-11-03;546;507;1053;372151;315211;79;687362
84;2020-11-03;537;275;812;237198;150524;89;387722
84;2020-11-03;362;109;471;81185;28680;90;109865
84;2020-11-03;7687;6480;14190;4130719;3901658;0;8032377
93;2020-11-03;43;60;103;268834;283093;09;551927
93;2020-11-03;256;247;504;280751;296087;19;576838
93;2020-11-03;375;309;684;254404;255552;29;509956
93;2020-11-03;443;316;760;310704;288398;39;599102
93;2020-11-03;417;353;770;325559;305827;49;631386
93;2020-11-03;450;377;827;353104;325389;59;678493
93;2020-11-03;303;280;584;336327;296459;69;632786
93;2020-11-03;214;191;405;279820;229699;79;509519
93;2020-11-03;170;88;258;171274;113716;89;284990
93;2020-11-03;111;43;154;58896;21758;90;80654
93;2020-11-03;2786;2267;5073;2639673;2415978;0;5055651
94;2020-11-03;0;6;6;16311;17433;09;33744
94;2020-11-03;15;19;34;16679;18132;19;34811
94;2020-11-03;9;17;26;16782;16579;29;33361
94;2020-11-03;13;12;25;23044;20580;39;43624
94;2020-11-03;12;14;26;23065;22140;49;45205
94;2020-11-03;21;20;41;24549;23421;59;47970
94;2020-11-03;16;15;31;23212;21883;69;45095
94;2020-11-03;8;5;13;19544;17141;79;36685
94;2020-11-03;2;4;6;11227;8178;89;19405
94;2020-11-03;0;2;2;3332;1447;90;4779
94;2020-11-03;96;114;210;177745;166934;0;344679
01;2020-11-04;0;0;0;19979;20155;09;40134
01;2020-11-04;1;1;2;24994;25489;19;50483
01;2020-11-04;1;2;3;17868;16690;29;34558
01;2020-11-04;3;2;5;22328;14821;39;37149
01;2020-11-04;4;0;4;28652;20276;49;48928
01;2020-11-04;1;8;9;33264;27260;59;60524
01;2020-11-04;2;5;7;27135;23978;69;51113
01;2020-11-04;1;1;2;18401;14661;79;33062
01;2020-11-04;0;2;2;9633;6375;89;16008
01;2020-11-04;1;0;1;3410;1510;90;4920
01;2020-11-04;14;21;35;205664;171215;0;376879
02;2020-11-04;0;2;2;16881;17110;09;33991
02;2020-11-04;7;5;13;21410;21604;19;43014
02;2020-11-04;6;5;12;16017;15479;29;31496
02;2020-11-04;11;8;19;19825;14455;39;34280
02;2020-11-04;11;7;18;24719;18248;49;42967
02;2020-11-04;27;10;37;34361;28310;59;62671
02;2020-11-04;7;10;17;28061;24495;69;52556
02;2020-11-04;2;2;4;18231;15278;79;33509
02;2020-11-04;3;0;3;11090;7677;89;18767
02;2020-11-04;1;0;1;3992;1506;90;5498
02;2020-11-04;75;49;126;194587;164162;0;358749
03;2020-11-04;0;0;0;31123;30920;09;62043
03;2020-11-04;0;1;1;29370;29268;19;58638
03;2020-11-04;1;1;2;21458;18963;29;40421
03;2020-11-04;2;3;5;21276;18326;39;39602
03;2020-11-04;2;2;4;18164;16593;49;34757
03;2020-11-04;0;3;3;13469;13557;59;27026
03;2020-11-04;2;1;3;8776;8670;69;17446
03;2020-11-04;1;0;1;3777;3591;79;7368
03;2020-11-04;0;0;0;1649;1072;89;2721
03;2020-11-04;0;0;0;485;184;90;669
03;2020-11-04;8;11;19;149547;141144;0;290691
04;2020-11-04;0;0;0;60314;61377;09;121691
04;2020-11-04;12;18;30;66065;68387;19;134452
04;2020-11-04;9;6;15;51059;47156;29;98215
04;2020-11-04;13;7;20;58788;45780;39;104568
04;2020-11-04;6;4;10;61408;52207;49;113615
04;2020-11-04;15;10;25;64838;60759;59;125597
04;2020-11-04;5;4;9;47008;42843;69;89851
04;2020-11-04;2;3;5;25509;21184;79;46693
04;2020-11-04;0;0;0;13168;7647;89;20815
04;2020-11-04;0;1;1;3209;1253;90;4462
04;2020-11-04;62;53;115;451366;408593;0;859959
05;2020-11-04;0;0;0;362.366008612902;341.338819562748;09;703.704828175651
05;2020-11-04;0;0;0;353.376145114279;370.349735405642;19;723.725880519921
05;2020-11-04;0;0;0;218.593559489256;256.539602589476;29;475.133162078732
05;2020-11-04;0;0;0;404.225408693299;360.321910454353;39;764.547319147651
05;2020-11-04;0;0;0;520.067953604221;497.108383964256;49;1017.17633756848
05;2020-11-04;0;0;0;468.146063921917;510.087601910415;59;978.233665832332
05;2020-11-04;0;0;0;340.368470050554;334.366842191253;69;674.735312241807
05;2020-11-04;0;0;0;212.598666888387;192.597753227106;79;405.196420115493
05;2020-11-04;0;0;0;148.727797095705;61.8681715431829;89;210.595968638888
05;2020-11-04;0;0;0;32.9601271090696;10.9909785719784;90;43.9511056810479
05;2020-11-04;0;0;0;3061.43020057959;2935.56979942041;0;5997
06;2020-11-04;1;1;2;42583;42380;09;84963
06;2020-11-04;7;1;8;33369;31925;19;65294
06;2020-11-04;7;2;9;21571;15080;29;36651
06;2020-11-04;12;5;17;21550;16147;39;37697
06;2020-11-04;7;2;9;14193;13939;49;28132
06;2020-11-04;2;4;6;7171;7597;59;14768
06;2020-11-04;0;1;1;3629;4117;69;7746
06;2020-11-04;0;0;0;1577;1457;79;3034
06;2020-11-04;0;0;0;531;474;89;1005
06;2020-11-04;0;0;0;88;93;90;181
06;2020-11-04;36;16;52;146262;133209;0;279471
07;2020-11-04;0;0;0;485;549;09;1034
07;2020-11-04;0;0;0;403;432;19;835
07;2020-11-04;0;0;0;764;841;29;1605
07;2020-11-04;0;1;1;824;928;39;1752
07;2020-11-04;0;0;0;788;1020;49;1808
07;2020-11-04;0;0;0;678;870;59;1548
07;2020-11-04;0;1;1;360;382;69;742
07;2020-11-04;0;1;1;231;190;79;421
07;2020-11-04;0;0;0;114;67;89;181
07;2020-11-04;0;0;0;24;11;90;35
07;2020-11-04;0;3;3;4671;5290;0;9961
08;2020-11-04;0;0;0;2715.22592983026;2997.75551488675;09;5712.98144471701
08;2020-11-04;0;1;1;2778.51901080978;3160.9156459093;19;5939.43465671908
08;2020-11-04;2;0;2;2080.8882988764;1718.16634315323;29;3799.05464202964
08;2020-11-04;1;0;1;2701.8582062647;1896.52641413317;39;4598.38462039786
08;2020-11-04;2;1;3;3151.45861023308;2460.52498233809;49;5611.98359257117
08;2020-11-04;1;0;1;2620.29868333099;2422.23566154656;59;5042.53434487755
08;2020-11-04;0;1;1;1621.44173420671;1438.58325779464;69;3060.02499200135
08;2020-11-04;1;0;1;626.575909335673;526.358467843651;79;1152.93437717932
08;2020-11-04;0;0;0;205.018522985054;140.993639349697;89;346.012162334751
08;2020-11-04;0;0;0;50.0325684687745;20.62259870351;90;70.6551671722846
08;2020-11-04;7;3;10;18551.3174743414;16782.6825256586;0;35334
11;2020-11-04;111;136;263;783071;811785;09;1594856
11;2020-11-04;518;473;1030;761456;784653;19;1546109
11;2020-11-04;671;530;1207;850145;801772;29;1651917
11;2020-11-04;691;577;1271;914360;843488;39;1757848
11;2020-11-04;645;532;1183;845609;826202;49;1671811
11;2020-11-04;553;559;1122;793566;745070;59;1538636
11;2020-11-04;425;424;860;628649;549192;69;1177841
11;2020-11-04;212;209;422;434606;358356;79;792962
11;2020-11-04;139;91;231;261425;162933;89;424358
11;2020-11-04;108;31;139;89253;32619;90;121872
11;2020-11-04;4075;3564;7734;6362140;5916070;0;12278210
24;2020-11-04;15;24;40;139720;144686;09;284406
24;2020-11-04;119;103;224;152979;161185;19;314164
24;2020-11-04;168;114;282;122237;126536;29;248773
24;2020-11-04;130;101;232;150359;142009;39;292368
24;2020-11-04;150;108;258;161829;158758;49;320587
24;2020-11-04;143;106;249;172552;168011;59;340563
24;2020-11-04;86;86;172;172509;158177;69;330686
24;2020-11-04;69;55;124;129428;110593;79;240021
24;2020-11-04;51;31;82;87342;56882;89;144224
24;2020-11-04;35;8;43;31210;12071;90;43281
24;2020-11-04;967;736;1707;1320165;1238908;0;2559073
27;2020-11-04;43;45;88;143373;149679;09;293052
27;2020-11-04;208;183;393;160962;173003;19;333965
27;2020-11-04;220;187;407;133746;142254;29;276000
27;2020-11-04;213;155;368;160004;155407;39;315411
27;2020-11-04;230;180;410;172333;169564;49;341897
27;2020-11-04;241;192;433;189979;183788;59;373767
27;2020-11-04;180;156;336;192591;178206;69;370797
27;2020-11-04;119;123;242;146876;127546;79;274422
27;2020-11-04;105;71;176;96896;61575;89;158471
27;2020-11-04;55;19;74;33148;12109;90;45257
27;2020-11-04;1614;1312;2928;1429908;1353131;0;2783039
28;2020-11-04;28;37;65;180735;186856;09;367591
28;2020-11-04;97;96;194;200125;213621;19;413746
28;2020-11-04;122;96;218;168922;173007;29;341929
28;2020-11-04;162;111;273;196628;188487;39;385115
28;2020-11-04;138;91;229;205396;201699;49;407095
28;2020-11-04;149;99;248;222002;213866;59;435868
28;2020-11-04;109;103;212;224688;203758;69;428446
28;2020-11-04;78;82;160;163192;135543;79;298735
28;2020-11-04;61;29;90;109691;65377;89;175068
28;2020-11-04;45;13;58;37222;12685;90;49907
28;2020-11-04;989;757;1747;1708601;1594899;0;3303500
32;2020-11-04;107;88;195;358062;373689;09;731751
32;2020-11-04;337;334;671;387045;406742;19;793787
32;2020-11-04;384;322;706;342304;348587;29;690891
32;2020-11-04;392;312;704;382485;369972;39;752457
32;2020-11-04;396;352;748;382510;376716;49;759226
32;2020-11-04;415;341;756;386937;376527;59;763464
32;2020-11-04;299;270;569;371211;330938;69;702149
32;2020-11-04;175;152;327;250542;201459;79;452001
32;2020-11-04;160;80;240;163399;89786;89;253185
32;2020-11-04;81;39;120;48384;15367;90;63751
32;2020-11-04;2746;2291;5037;3072879;2889783;0;5962662
44;2020-11-04;58;84;143;291525;306839;09;598364
44;2020-11-04;231;245;481;320255;339504;19;659759
44;2020-11-04;321;270;592;302020;314428;29;616448
44;2020-11-04;295;272;567;342222;333292;39;675514
44;2020-11-04;341;250;593;349727;344491;49;694218
44;2020-11-04;329;275;608;381371;373239;59;754610
44;2020-11-04;223;211;435;367165;335850;69;703015
44;2020-11-04;151;127;278;250387;215436;79;465823
44;2020-11-04;117;91;208;170825;105192;89;276017
44;2020-11-04;69;17;86;51248;16731;90;67979
44;2020-11-04;2135;1843;3992;2826745;2685002;0;5511747
52;2020-11-04;38;21;61;213594;223900;09;437494
52;2020-11-04;131;136;268;240818;255197;19;496015
52;2020-11-04;193;155;349;197010;200630;29;397640
52;2020-11-04;157;119;276;231204;224885;39;456089
52;2020-11-04;160;132;292;243874;243418;49;487292
52;2020-11-04;156;147;303;244100;239116;59;483216
52;2020-11-04;125;117;242;241796;221345;69;463141
52;2020-11-04;71;66;137;177805;149903;79;327708
52;2020-11-04;81;42;123;119561;75822;89;195383
52;2020-11-04;58;18;76;42559;15260;90;57819
52;2020-11-04;1170;953;2127;1952321;1849476;0;3801797
53;2020-11-04;16;22;38;173813;182358;09;356171
53;2020-11-04;89;74;165;202720;214740;19;417460
53;2020-11-04;96;135;233;163116;173196;29;336312
53;2020-11-04;96;67;163;190526;187674;39;378200
53;2020-11-04;89;83;172;212098;212015;49;424113
53;2020-11-04;81;81;162;223699;219176;59;442875
53;2020-11-04;73;61;134;227435;209274;69;436709
53;2020-11-04;48;45;93;169992;140910;79;310902
53;2020-11-04;40;19;59;118117;69883;89;188000
53;2020-11-04;23;6;29;37370;12267;90;49637
53;2020-11-04;651;593;1248;1718886;1621493;0;3340379
75;2020-11-04;36;46;84;293104;305291;09;598395
75;2020-11-04;185;173;361;337141;357785;19;694926
75;2020-11-04;214;182;397;295024;300618;29;595642
75;2020-11-04;207;189;397;347871;331233;39;679104
75;2020-11-04;245;201;447;384742;372771;49;757513
75;2020-11-04;212;189;401;413361;390880;59;804241
75;2020-11-04;148;115;263;425623;384060;69;809683
75;2020-11-04;89;89;178;325086;276298;79;601384
75;2020-11-04;85;49;134;213986;139308;89;353294
75;2020-11-04;57;25;82;77600;28200;90;105800
75;2020-11-04;1479;1259;2746;3113538;2886444;0;5999982
76;2020-11-04;54;48;103;305956;318589;09;624545
76;2020-11-04;218;240;466;338942;356969;19;695911
76;2020-11-04;293;233;528;316210;319570;29;635780
76;2020-11-04;276;233;509;356758;337587;39;694345
76;2020-11-04;290;240;530;376541;363812;49;740353
76;2020-11-04;297;266;563;402608;383750;59;786358
76;2020-11-04;210;193;403;394889;358997;69;753886
76;2020-11-04;164;166;330;308664;263806;79;572470
76;2020-11-04;124;77;201;195838;129272;89;325110
76;2020-11-04;94;24;119;69372;26728;90;96100
76;2020-11-04;2021;1721;3754;3065778;2859080;0;5924858
84;2020-11-04;169;176;347;459549;481088;09;940637
84;2020-11-04;764;758;1531;487711;511905;19;999616
84;2020-11-04;946;749;1696;443824;451094;29;894918
84;2020-11-04;954;747;1703;512522;493262;39;1005784
84;2020-11-04;991;761;1753;520248;515106;49;1035354
84;2020-11-04;887;850;1739;529611;514848;59;1044459
84;2020-11-04;612;564;1178;486720;439940;69;926660
84;2020-11-04;435;442;878;372151;315211;79;687362
84;2020-11-04;449;289;738;237198;150524;89;387722
84;2020-11-04;347;109;456;81185;28680;90;109865
84;2020-11-04;6554;5446;12020;4130719;3901658;0;8032377
93;2020-11-04;51;50;101;268834;283093;09;551927
93;2020-11-04;256;242;499;280751;296087;19;576838
93;2020-11-04;335;236;571;254404;255552;29;509956
93;2020-11-04;332;260;594;310704;288398;39;599102
93;2020-11-04;358;269;627;325559;305827;49;631386
93;2020-11-04;352;269;621;353104;325389;59;678493
93;2020-11-04;257;223;480;336327;296459;69;632786
93;2020-11-04;177;182;359;279820;229699;79;509519
93;2020-11-04;182;106;288;171274;113716;89;284990
93;2020-11-04;128;33;161;58896;21758;90;80654
93;2020-11-04;2428;1872;4303;2639673;2415978;0;5055651
94;2020-11-04;1;1;2;16311;17433;09;33744
94;2020-11-04;11;11;22;16679;18132;19;34811
94;2020-11-04;11;10;21;16782;16579;29;33361
94;2020-11-04;16;13;29;23044;20580;39;43624
94;2020-11-04;13;6;19;23065;22140;49;45205
94;2020-11-04;11;17;28;24549;23421;59;47970
94;2020-11-04;9;8;17;23212;21883;69;45095
94;2020-11-04;5;5;10;19544;17141;79;36685
94;2020-11-04;2;5;7;11227;8178;89;19405
94;2020-11-04;4;2;6;3332;1447;90;4779
94;2020-11-04;83;78;161;177745;166934;0;344679
01;2020-11-05;0;1;1;19979;20155;09;40134
01;2020-11-05;3;0;3;24994;25489;19;50483
01;2020-11-05;1;0;1;17868;16690;29;34558
01;2020-11-05;1;4;5;22328;14821;39;37149
01;2020-11-05;5;2;7;28652;20276;49;48928
01;2020-11-05;5;1;6;33264;27260;59;60524
01;2020-11-05;5;4;9;27135;23978;69;51113
01;2020-11-05;1;3;4;18401;14661;79;33062
01;2020-11-05;1;1;2;9633;6375;89;16008
01;2020-11-05;1;0;1;3410;1510;90;4920
01;2020-11-05;23;16;39;205664;171215;0;376879
02;2020-11-05;1;0;1;16881;17110;09;33991
02;2020-11-05;6;5;11;21410;21604;19;43014
02;2020-11-05;7;6;13;16017;15479;29;31496
02;2020-11-05;8;8;16;19825;14455;39;34280
02;2020-11-05;11;12;23;24719;18248;49;42967
02;2020-11-05;14;10;24;34361;28310;59;62671
02;2020-11-05;5;7;13;28061;24495;69;52556
02;2020-11-05;7;3;10;18231;15278;79;33509
02;2020-11-05;0;0;0;11090;7677;89;18767
02;2020-11-05;0;0;0;3992;1506;90;5498
02;2020-11-05;59;51;111;194587;164162;0;358749
03;2020-11-05;1;1;2;31123;30920;09;62043
03;2020-11-05;0;0;0;29370;29268;19;58638
03;2020-11-05;3;1;4;21458;18963;29;40421
03;2020-11-05;3;4;7;21276;18326;39;39602
03;2020-11-05;3;4;7;18164;16593;49;34757
03;2020-11-05;4;2;6;13469;13557;59;27026
03;2020-11-05;0;3;3;8776;8670;69;17446
03;2020-11-05;0;0;0;3777;3591;79;7368
03;2020-11-05;1;0;1;1649;1072;89;2721
03;2020-11-05;0;0;0;485;184;90;669
03;2020-11-05;15;15;30;149547;141144;0;290691
04;2020-11-05;1;3;4;60314;61377;09;121691
04;2020-11-05;15;6;21;66065;68387;19;134452
04;2020-11-05;8;7;15;51059;47156;29;98215
04;2020-11-05;13;4;17;58788;45780;39;104568
04;2020-11-05;17;6;23;61408;52207;49;113615
04;2020-11-05;13;9;22;64838;60759;59;125597
04;2020-11-05;9;9;18;47008;42843;69;89851
04;2020-11-05;0;2;2;25509;21184;79;46693
04;2020-11-05;0;3;3;13168;7647;89;20815
04;2020-11-05;0;0;0;3209;1253;90;4462
04;2020-11-05;76;49;125;451366;408593;0;859959
05;2020-11-05;0;0;0;362.366008612902;341.338819562748;09;703.704828175651
05;2020-11-05;0;0;0;353.376145114279;370.349735405642;19;723.725880519921
05;2020-11-05;0;0;0;218.593559489256;256.539602589476;29;475.133162078732
05;2020-11-05;0;0;0;404.225408693299;360.321910454353;39;764.547319147651
05;2020-11-05;0;0;0;520.067953604221;497.108383964256;49;1017.17633756848
05;2020-11-05;0;0;0;468.146063921917;510.087601910415;59;978.233665832332
05;2020-11-05;0;0;0;340.368470050554;334.366842191253;69;674.735312241807
05;2020-11-05;0;0;0;212.598666888387;192.597753227106;79;405.196420115493
05;2020-11-05;0;0;0;148.727797095705;61.8681715431829;89;210.595968638888
05;2020-11-05;0;0;0;32.9601271090696;10.9909785719784;90;43.9511056810479
05;2020-11-05;0;0;0;3061.43020057959;2935.56979942041;0;5997
06;2020-11-05;0;0;0;42583;42380;09;84963
06;2020-11-05;4;4;8;33369;31925;19;65294
06;2020-11-05;3;4;7;21571;15080;29;36651
06;2020-11-05;12;4;16;21550;16147;39;37697
06;2020-11-05;7;5;12;14193;13939;49;28132
06;2020-11-05;2;2;4;7171;7597;59;14768
06;2020-11-05;2;2;4;3629;4117;69;7746
06;2020-11-05;0;1;1;1577;1457;79;3034
06;2020-11-05;1;0;1;531;474;89;1005
06;2020-11-05;0;0;0;88;93;90;181
06;2020-11-05;31;22;53;146262;133209;0;279471
07;2020-11-05;0;0;0;485;549;09;1034
07;2020-11-05;0;0;0;403;432;19;835
07;2020-11-05;0;0;0;764;841;29;1605
07;2020-11-05;2;0;2;824;928;39;1752
07;2020-11-05;0;0;0;788;1020;49;1808
07;2020-11-05;0;0;0;678;870;59;1548
07;2020-11-05;0;0;0;360;382;69;742
07;2020-11-05;0;0;0;231;190;79;421
07;2020-11-05;0;0;0;114;67;89;181
07;2020-11-05;0;0;0;24;11;90;35
07;2020-11-05;2;0;2;4671;5290;0;9961
08;2020-11-05;0;0;0;2715.22592983026;2997.75551488675;09;5712.98144471701
08;2020-11-05;0;0;0;2778.51901080978;3160.9156459093;19;5939.43465671908
08;2020-11-05;0;0;0;2080.8882988764;1718.16634315323;29;3799.05464202964
08;2020-11-05;0;4;4;2701.8582062647;1896.52641413317;39;4598.38462039786
08;2020-11-05;3;1;4;3151.45861023308;2460.52498233809;49;5611.98359257117
08;2020-11-05;0;0;0;2620.29868333099;2422.23566154656;59;5042.53434487755
08;2020-11-05;1;0;1;1621.44173420671;1438.58325779464;69;3060.02499200135
08;2020-11-05;0;1;1;626.575909335673;526.358467843651;79;1152.93437717932
08;2020-11-05;0;0;0;205.018522985054;140.993639349697;89;346.012162334751
08;2020-11-05;0;0;0;50.0325684687745;20.62259870351;90;70.6551671722846
08;2020-11-05;4;6;10;18551.3174743414;16782.6825256586;0;35334
11;2020-11-05;109;110;238;783071;811785;09;1594856
11;2020-11-05;474;437;963;761456;784653;19;1546109
11;2020-11-05;647;544;1198;850145;801772;29;1651917
11;2020-11-05;674;523;1204;914360;843488;39;1757848
11;2020-11-05;625;528;1160;845609;826202;49;1671811
11;2020-11-05;549;513;1066;793566;745070;59;1538636
11;2020-11-05;428;379;816;628649;549192;69;1177841
11;2020-11-05;184;175;363;434606;358356;79;792962
11;2020-11-05;138;92;232;261425;162933;89;424358
11;2020-11-05;83;40;123;89253;32619;90;121872
11;2020-11-05;3911;3344;7369;6362140;5916070;0;12278210
24;2020-11-05;20;21;42;139720;144686;09;284406
24;2020-11-05;86;99;187;152979;161185;19;314164
24;2020-11-05;101;94;196;122237;126536;29;248773
24;2020-11-05;106;82;188;150359;142009;39;292368
24;2020-11-05;126;87;213;161829;158758;49;320587
24;2020-11-05;121;112;233;172552;168011;59;340563
24;2020-11-05;86;63;149;172509;158177;69;330686
24;2020-11-05;80;60;140;129428;110593;79;240021
24;2020-11-05;56;44;101;87342;56882;89;144224
24;2020-11-05;55;18;73;31210;12071;90;43281
24;2020-11-05;841;682;1528;1320165;1238908;0;2559073
27;2020-11-05;40;33;73;143373;149679;09;293052
27;2020-11-05;179;164;343;160962;173003;19;333965
27;2020-11-05;214;169;383;133746;142254;29;276000
27;2020-11-05;216;126;342;160004;155407;39;315411
27;2020-11-05;213;150;363;172333;169564;49;341897
27;2020-11-05;226;181;407;189979;183788;59;373767
27;2020-11-05;166;147;313;192591;178206;69;370797
27;2020-11-05;121;113;234;146876;127546;79;274422
27;2020-11-05;101;61;162;96896;61575;89;158471
27;2020-11-05;57;23;80;33148;12109;90;45257
27;2020-11-05;1533;1167;2700;1429908;1353131;0;2783039
28;2020-11-05;31;31;63;180735;186856;09;367591
28;2020-11-05;127;94;224;200125;213621;19;413746
28;2020-11-05;128;108;236;168922;173007;29;341929
28;2020-11-05;124;81;205;196628;188487;39;385115
28;2020-11-05;127;110;237;205396;201699;49;407095
28;2020-11-05;97;127;224;222002;213866;59;435868
28;2020-11-05;121;98;220;224688;203758;69;428446
28;2020-11-05;72;68;140;163192;135543;79;298735
28;2020-11-05;55;41;96;109691;65377;89;175068
28;2020-11-05;42;11;53;37222;12685;90;49907
28;2020-11-05;924;769;1698;1708601;1594899;0;3303500
32;2020-11-05;89;81;171;358062;373689;09;731751
32;2020-11-05;344;311;656;387045;406742;19;793787
32;2020-11-05;389;264;654;342304;348587;29;690891
32;2020-11-05;393;304;698;382485;369972;39;752457
32;2020-11-05;379;312;692;382510;376716;49;759226
32;2020-11-05;336;387;724;386937;376527;59;763464
32;2020-11-05;265;209;474;371211;330938;69;702149
32;2020-11-05;201;137;338;250542;201459;79;452001
32;2020-11-05;151;76;227;163399;89786;89;253185
32;2020-11-05;113;25;138;48384;15367;90;63751
32;2020-11-05;2660;2106;4772;3072879;2889783;0;5962662
44;2020-11-05;66;77;144;291525;306839;09;598364
44;2020-11-05;249;222;472;320255;339504;19;659759
44;2020-11-05;306;273;579;302020;314428;29;616448
44;2020-11-05;296;219;517;342222;333292;39;675514
44;2020-11-05;285;227;512;349727;344491;49;694218
44;2020-11-05;300;271;572;381371;373239;59;754610
44;2020-11-05;196;170;370;367165;335850;69;703015
44;2020-11-05;116;122;238;250387;215436;79;465823
44;2020-11-05;114;68;182;170825;105192;89;276017
44;2020-11-05;48;18;66;51248;16731;90;67979
44;2020-11-05;1976;1668;3653;2826745;2685002;0;5511747
52;2020-11-05;27;41;68;213594;223900;09;437494
52;2020-11-05;133;136;274;240818;255197;19;496015
52;2020-11-05;168;128;297;197010;200630;29;397640
52;2020-11-05;179;126;305;231204;224885;39;456089
52;2020-11-05;163;121;284;243874;243418;49;487292
52;2020-11-05;147;153;300;244100;239116;59;483216
52;2020-11-05;97;95;192;241796;221345;69;463141
52;2020-11-05;68;68;136;177805;149903;79;327708
52;2020-11-05;61;39;100;119561;75822;89;195383
52;2020-11-05;54;14;68;42559;15260;90;57819
52;2020-11-05;1098;921;2025;1952321;1849476;0;3801797
53;2020-11-05;13;23;38;173813;182358;09;356171
53;2020-11-05;76;65;143;202720;214740;19;417460
53;2020-11-05;74;70;147;163116;173196;29;336312
53;2020-11-05;74;65;139;190526;187674;39;378200
53;2020-11-05;67;53;120;212098;212015;49;424113
53;2020-11-05;93;84;177;223699;219176;59;442875
53;2020-11-05;48;69;117;227435;209274;69;436709
53;2020-11-05;38;32;70;169992;140910;79;310902
53;2020-11-05;40;16;56;118117;69883;89;188000
53;2020-11-05;26;11;37;37370;12267;90;49637
53;2020-11-05;549;488;1044;1718886;1621493;0;3340379
75;2020-11-05;45;47;93;293104;305291;09;598395
75;2020-11-05;156;192;349;337141;357785;19;694926
75;2020-11-05;207;182;390;295024;300618;29;595642
75;2020-11-05;238;182;420;347871;331233;39;679104
75;2020-11-05;246;180;426;384742;372771;49;757513
75;2020-11-05;199;179;378;413361;390880;59;804241
75;2020-11-05;163;146;310;425623;384060;69;809683
75;2020-11-05;93;93;186;325086;276298;79;601384
75;2020-11-05;75;53;128;213986;139308;89;353294
75;2020-11-05;61;18;79;77600;28200;90;105800
75;2020-11-05;1483;1273;2760;3113538;2886444;0;5999982
76;2020-11-05;38;44;85;305956;318589;09;624545
76;2020-11-05;227;223;454;338942;356969;19;695911
76;2020-11-05;273;218;491;316210;319570;29;635780
76;2020-11-05;301;214;516;356758;337587;39;694345
76;2020-11-05;284;246;530;376541;363812;49;740353
76;2020-11-05;284;259;544;402608;383750;59;786358
76;2020-11-05;213;177;391;394889;358997;69;753886
76;2020-11-05;132;141;273;308664;263806;79;572470
76;2020-11-05;138;91;230;195838;129272;89;325110
76;2020-11-05;108;31;139;69372;26728;90;96100
76;2020-11-05;2000;1646;3657;3065778;2859080;0;5924858
84;2020-11-05;131;138;271;459549;481088;09;940637
84;2020-11-05;673;723;1413;487711;511905;19;999616
84;2020-11-05;868;690;1560;443824;451094;29;894918
84;2020-11-05;820;670;1490;512522;493262;39;1005784
84;2020-11-05;843;710;1555;520248;515106;49;1035354
84;2020-11-05;891;828;1719;529611;514848;59;1044459
84;2020-11-05;566;552;1118;486720;439940;69;926660
84;2020-11-05;426;377;803;372151;315211;79;687362
84;2020-11-05;389;237;626;237198;150524;89;387722
84;2020-11-05;283;99;382;81185;28680;90;109865
84;2020-11-05;5890;5024;10938;4130719;3901658;0;8032377
93;2020-11-05;61;54;115;268834;283093;09;551927
93;2020-11-05;244;259;505;280751;296087;19;576838
93;2020-11-05;312;249;561;254404;255552;29;509956
93;2020-11-05;306;253;560;310704;288398;39;599102
93;2020-11-05;334;261;596;325559;305827;49;631386
93;2020-11-05;292;280;572;353104;325389;59;678493
93;2020-11-05;238;242;480;336327;296459;69;632786
93;2020-11-05;175;159;335;279820;229699;79;509519
93;2020-11-05;127;86;213;171274;113716;89;284990
93;2020-11-05;92;28;120;58896;21758;90;80654
93;2020-11-05;2182;1871;4058;2639673;2415978;0;5055651
94;2020-11-05;1;1;2;16311;17433;09;33744
94;2020-11-05;16;10;26;16679;18132;19;34811
94;2020-11-05;16;18;34;16782;16579;29;33361
94;2020-11-05;13;12;25;23044;20580;39;43624
94;2020-11-05;11;15;26;23065;22140;49;45205
94;2020-11-05;12;16;28;24549;23421;59;47970
94;2020-11-05;12;9;21;23212;21883;69;45095
94;2020-11-05;10;10;20;19544;17141;79;36685
94;2020-11-05;2;0;2;11227;8178;89;19405
94;2020-11-05;1;1;2;3332;1447;90;4779
94;2020-11-05;94;92;186;177745;166934;0;344679
01;2020-11-06;0;1;1;19979;20155;09;40134
01;2020-11-06;0;1;1;24994;25489;19;50483
01;2020-11-06;1;1;2;17868;16690;29;34558
01;2020-11-06;2;0;2;22328;14821;39;37149
01;2020-11-06;6;1;7;28652;20276;49;48928
01;2020-11-06;3;4;7;33264;27260;59;60524
01;2020-11-06;3;1;4;27135;23978;69;51113
01;2020-11-06;3;0;3;18401;14661;79;33062
01;2020-11-06;2;0;2;9633;6375;89;16008
01;2020-11-06;0;0;0;3410;1510;90;4920
01;2020-11-06;20;9;29;205664;171215;0;376879
02;2020-11-06;1;3;4;16881;17110;09;33991
02;2020-11-06;11;5;16;21410;21604;19;43014
02;2020-11-06;17;8;25;16017;15479;29;31496
02;2020-11-06;7;6;14;19825;14455;39;34280
02;2020-11-06;12;7;20;24719;18248;49;42967
02;2020-11-06;17;12;29;34361;28310;59;62671
02;2020-11-06;7;4;11;28061;24495;69;52556
02;2020-11-06;2;4;6;18231;15278;79;33509
02;2020-11-06;0;1;2;11090;7677;89;18767
02;2020-11-06;0;0;0;3992;1506;90;5498
02;2020-11-06;74;50;127;194587;164162;0;358749
03;2020-11-06;1;0;1;31123;30920;09;62043
03;2020-11-06;1;0;2;29370;29268;19;58638
03;2020-11-06;4;2;6;21458;18963;29;40421
03;2020-11-06;2;3;5;21276;18326;39;39602
03;2020-11-06;3;0;3;18164;16593;49;34757
03;2020-11-06;1;1;2;13469;13557;59;27026
03;2020-11-06;0;3;3;8776;8670;69;17446
03;2020-11-06;1;0;1;3777;3591;79;7368
03;2020-11-06;0;0;0;1649;1072;89;2721
03;2020-11-06;0;0;0;485;184;90;669
03;2020-11-06;13;9;23;149547;141144;0;290691
04;2020-11-06;4;3;7;60314;61377;09;121691
04;2020-11-06;13;12;26;66065;68387;19;134452
04;2020-11-06;10;7;17;51059;47156;29;98215
04;2020-11-06;17;8;25;58788;45780;39;104568
04;2020-11-06;6;2;8;61408;52207;49;113615
04;2020-11-06;5;7;12;64838;60759;59;125597
04;2020-11-06;6;1;7;47008;42843;69;89851
04;2020-11-06;0;4;4;25509;21184;79;46693
04;2020-11-06;0;1;1;13168;7647;89;20815
04;2020-11-06;1;0;1;3209;1253;90;4462
04;2020-11-06;62;45;108;451366;408593;0;859959
05;2020-11-06;0;0;0;362.366008612902;341.338819562748;09;703.704828175651
05;2020-11-06;0;0;0;353.376145114279;370.349735405642;19;723.725880519921
05;2020-11-06;0;0;0;218.593559489256;256.539602589476;29;475.133162078732
05;2020-11-06;0;0;0;404.225408693299;360.321910454353;39;764.547319147651
05;2020-11-06;0;0;0;520.067953604221;497.108383964256;49;1017.17633756848
05;2020-11-06;0;0;0;468.146063921917;510.087601910415;59;978.233665832332
05;2020-11-06;0;0;0;340.368470050554;334.366842191253;69;674.735312241807
05;2020-11-06;0;0;0;212.598666888387;192.597753227106;79;405.196420115493
05;2020-11-06;0;0;0;148.727797095705;61.8681715431829;89;210.595968638888
05;2020-11-06;0;0;0;32.9601271090696;10.9909785719784;90;43.9511056810479
05;2020-11-06;0;0;0;3061.43020057959;2935.56979942041;0;5997
06;2020-11-06;0;0;0;42583;42380;09;84963
06;2020-11-06;2;5;8;33369;31925;19;65294
06;2020-11-06;8;5;13;21571;15080;29;36651
06;2020-11-06;6;4;10;21550;16147;39;37697
06;2020-11-06;7;2;9;14193;13939;49;28132
06;2020-11-06;2;1;3;7171;7597;59;14768
06;2020-11-06;0;8;8;3629;4117;69;7746
06;2020-11-06;1;1;2;1577;1457;79;3034
06;2020-11-06;0;1;1;531;474;89;1005
06;2020-11-06;0;0;0;88;93;90;181
06;2020-11-06;26;27;54;146262;133209;0;279471
07;2020-11-06;0;0;0;485;549;09;1034
07;2020-11-06;0;1;1;403;432;19;835
07;2020-11-06;0;1;1;764;841;29;1605
07;2020-11-06;1;0;1;824;928;39;1752
07;2020-11-06;0;0;0;788;1020;49;1808
07;2020-11-06;0;0;0;678;870;59;1548
07;2020-11-06;0;0;0;360;382;69;742
07;2020-11-06;0;1;1;231;190;79;421
07;2020-11-06;0;0;0;114;67;89;181
07;2020-11-06;0;0;0;24;11;90;35
07;2020-11-06;1;3;4;4671;5290;0;9961
08;2020-11-06;0;0;0;2715.22592983026;2997.75551488675;09;5712.98144471701
08;2020-11-06;0;1;1;2778.51901080978;3160.9156459093;19;5939.43465671908
08;2020-11-06;0;0;0;2080.8882988764;1718.16634315323;29;3799.05464202964
08;2020-11-06;2;1;3;2701.8582062647;1896.52641413317;39;4598.38462039786
08;2020-11-06;0;0;0;3151.45861023308;2460.52498233809;49;5611.98359257117
08;2020-11-06;2;3;5;2620.29868333099;2422.23566154656;59;5042.53434487755
08;2020-11-06;0;2;2;1621.44173420671;1438.58325779464;69;3060.02499200135
08;2020-11-06;0;0;0;626.575909335673;526.358467843651;79;1152.93437717932
08;2020-11-06;0;0;0;205.018522985054;140.993639349697;89;346.012162334751
08;2020-11-06;0;0;0;50.0325684687745;20.62259870351;90;70.6551671722846
08;2020-11-06;4;7;11;18551.3174743414;16782.6825256586;0;35334
11;2020-11-06;125;109;262;783071;811785;09;1594856
11;2020-11-06;458;425;926;761456;784653;19;1546109
11;2020-11-06;573;435;1016;850145;801772;29;1651917
11;2020-11-06;610;491;1108;914360;843488;39;1757848
11;2020-11-06;583;492;1084;845609;826202;49;1671811
11;2020-11-06;515;428;946;793566;745070;59;1538636
11;2020-11-06;383;394;783;628649;549192;69;1177841
11;2020-11-06;155;186;342;434606;358356;79;792962
11;2020-11-06;135;94;230;261425;162933;89;424358
11;2020-11-06;77;29;106;89253;32619;90;121872
11;2020-11-06;3615;3086;6827;6362140;5916070;0;12278210
24;2020-11-06;10;29;39;139720;144686;09;284406
24;2020-11-06;95;93;188;152979;161185;19;314164
24;2020-11-06;92;61;153;122237;126536;29;248773
24;2020-11-06;99;73;172;150359;142009;39;292368
24;2020-11-06;121;93;214;161829;158758;49;320587
24;2020-11-06;84;94;178;172552;168011;59;340563
24;2020-11-06;78;66;144;172509;158177;69;330686
24;2020-11-06;61;53;115;129428;110593;79;240021
24;2020-11-06;34;34;68;87342;56882;89;144224
24;2020-11-06;34;13;47;31210;12071;90;43281
24;2020-11-06;710;611;1322;1320165;1238908;0;2559073
27;2020-11-06;32;41;74;143373;149679;09;293052
27;2020-11-06;178;170;353;160962;173003;19;333965
27;2020-11-06;184;163;347;133746;142254;29;276000
27;2020-11-06;207;143;350;160004;155407;39;315411
27;2020-11-06;191;147;338;172333;169564;49;341897
27;2020-11-06;200;191;391;189979;183788;59;373767
27;2020-11-06;148;105;254;192591;178206;69;370797
27;2020-11-06;107;97;204;146876;127546;79;274422
27;2020-11-06;112;63;175;96896;61575;89;158471
27;2020-11-06;61;24;85;33148;12109;90;45257
27;2020-11-06;1420;1144;2571;1429908;1353131;0;2783039
28;2020-11-06;25;33;61;180735;186856;09;367591
28;2020-11-06;101;104;207;200125;213621;19;413746
28;2020-11-06;105;92;197;168922;173007;29;341929
28;2020-11-06;97;84;181;196628;188487;39;385115
28;2020-11-06;119;92;211;205396;201699;49;407095
28;2020-11-06;139;128;267;222002;213866;59;435868
28;2020-11-06;110;101;211;224688;203758;69;428446
28;2020-11-06;79;59;138;163192;135543;79;298735
28;2020-11-06;72;38;110;109691;65377;89;175068
28;2020-11-06;60;15;75;37222;12685;90;49907
28;2020-11-06;907;746;1658;1708601;1594899;0;3303500
32;2020-11-06;112;111;223;358062;373689;09;731751
32;2020-11-06;338;339;678;387045;406742;19;793787
32;2020-11-06;334;305;640;342304;348587;29;690891
32;2020-11-06;347;273;620;382485;369972;39;752457
32;2020-11-06;334;307;641;382510;376716;49;759226
32;2020-11-06;338;270;608;386937;376527;59;763464
32;2020-11-06;242;219;461;371211;330938;69;702149
32;2020-11-06;172;140;312;250542;201459;79;452001
32;2020-11-06;167;66;233;163399;89786;89;253185
32;2020-11-06;101;22;123;48384;15367;90;63751
32;2020-11-06;2486;2052;4540;3072879;2889783;0;5962662
44;2020-11-06;62;71;133;291525;306839;09;598364
44;2020-11-06;225;241;471;320255;339504;19;659759
44;2020-11-06;275;236;511;302020;314428;29;616448
44;2020-11-06;296;206;502;342222;333292;39;675514
44;2020-11-06;279;237;516;349727;344491;49;694218
44;2020-11-06;305;243;548;381371;373239;59;754610
44;2020-11-06;202;175;377;367165;335850;69;703015
44;2020-11-06;113;133;247;250387;215436;79;465823
44;2020-11-06;119;77;199;170825;105192;89;276017
44;2020-11-06;42;20;63;51248;16731;90;67979
44;2020-11-06;1918;1639;3567;2826745;2685002;0;5511747
52;2020-11-06;34;35;73;213594;223900;09;437494
52;2020-11-06;161;135;297;240818;255197;19;496015
52;2020-11-06;170;137;308;197010;200630;29;397640
52;2020-11-06;127;122;249;231204;224885;39;456089
52;2020-11-06;145;132;277;243874;243418;49;487292
52;2020-11-06;154;134;288;244100;239116;59;483216
52;2020-11-06;95;106;201;241796;221345;69;463141
52;2020-11-06;65;95;160;177805;149903;79;327708
52;2020-11-06;63;43;106;119561;75822;89;195383
52;2020-11-06;50;17;67;42559;15260;90;57819
52;2020-11-06;1064;956;2026;1952321;1849476;0;3801797
53;2020-11-06;26;29;55;173813;182358;09;356171
53;2020-11-06;82;79;161;202720;214740;19;417460
53;2020-11-06;98;76;175;163116;173196;29;336312
53;2020-11-06;66;64;130;190526;187674;39;378200
53;2020-11-06;77;66;143;212098;212015;49;424113
53;2020-11-06;83;76;159;223699;219176;59;442875
53;2020-11-06;76;65;141;227435;209274;69;436709
53;2020-11-06;48;50;98;169992;140910;79;310902
53;2020-11-06;36;24;60;118117;69883;89;188000
53;2020-11-06;38;9;47;37370;12267;90;49637
53;2020-11-06;630;538;1169;1718886;1621493;0;3340379
75;2020-11-06;42;46;90;293104;305291;09;598395
75;2020-11-06;158;167;330;337141;357785;19;694926
75;2020-11-06;198;167;366;295024;300618;29;595642
75;2020-11-06;229;165;394;347871;331233;39;679104
75;2020-11-06;210;185;396;384742;372771;49;757513
75;2020-11-06;190;185;375;413361;390880;59;804241
75;2020-11-06;139;144;283;425623;384060;69;809683
75;2020-11-06;106;103;209;325086;276298;79;601384
75;2020-11-06;108;79;188;213986;139308;89;353294
75;2020-11-06;84;27;111;77600;28200;90;105800
75;2020-11-06;1464;1268;2742;3113538;2886444;0;5999982
76;2020-11-06;54;71;133;305956;318589;09;624545
76;2020-11-06;226;209;442;338942;356969;19;695911
76;2020-11-06;242;197;439;316210;319570;29;635780
76;2020-11-06;283;183;466;356758;337587;39;694345
76;2020-11-06;284;228;513;376541;363812;49;740353
76;2020-11-06;259;254;513;402608;383750;59;786358
76;2020-11-06;196;194;390;394889;358997;69;753886
76;2020-11-06;140;149;289;308664;263806;79;572470
76;2020-11-06;110;82;192;195838;129272;89;325110
76;2020-11-06;115;41;156;69372;26728;90;96100
76;2020-11-06;1913;1611;3540;3065778;2859080;0;5924858
84;2020-11-06;185;197;386;459549;481088;09;940637
84;2020-11-06;730;699;1440;487711;511905;19;999616
84;2020-11-06;782;670;1452;443824;451094;29;894918
84;2020-11-06;810;596;1407;512522;493262;39;1005784
84;2020-11-06;788;768;1556;520248;515106;49;1035354
84;2020-11-06;731;722;1454;529611;514848;59;1044459
84;2020-11-06;525;555;1080;486720;439940;69;926660
84;2020-11-06;403;371;775;372151;315211;79;687362
84;2020-11-06;411;253;664;237198;150524;89;387722
84;2020-11-06;265;98;363;81185;28680;90;109865
84;2020-11-06;5631;4931;10581;4130719;3901658;0;8032377
93;2020-11-06;65;69;134;268834;283093;09;551927
93;2020-11-06;221;241;465;280751;296087;19;576838
93;2020-11-06;278;205;483;254404;255552;29;509956
93;2020-11-06;261;214;476;310704;288398;39;599102
93;2020-11-06;309;235;544;325559;305827;49;631386
93;2020-11-06;316;278;594;353104;325389;59;678493
93;2020-11-06;241;220;462;336327;296459;69;632786
93;2020-11-06;181;149;330;279820;229699;79;509519
93;2020-11-06;127;103;230;171274;113716;89;284990
93;2020-11-06;110;31;141;58896;21758;90;80654
93;2020-11-06;2110;1746;3861;2639673;2415978;0;5055651
94;2020-11-06;1;0;1;16311;17433;09;33744
94;2020-11-06;4;15;19;16679;18132;19;34811
94;2020-11-06;8;7;15;16782;16579;29;33361
94;2020-11-06;5;6;11;23044;20580;39;43624
94;2020-11-06;9;7;16;23065;22140;49;45205
94;2020-11-06;11;9;20;24549;23421;59;47970
94;2020-11-06;7;5;12;23212;21883;69;45095
94;2020-11-06;4;4;8;19544;17141;79;36685
94;2020-11-06;4;2;6;11227;8178;89;19405
94;2020-11-06;0;1;1;3332;1447;90;4779
94;2020-11-06;53;56;109;177745;166934;0;344679
01;2020-11-07;0;0;0;19979;20155;09;40134
01;2020-11-07;0;2;2;24994;25489;19;50483
01;2020-11-07;1;1;2;17868;16690;29;34558
01;2020-11-07;0;0;0;22328;14821;39;37149
01;2020-11-07;0;0;0;28652;20276;49;48928
01;2020-11-07;0;1;1;33264;27260;59;60524
01;2020-11-07;1;2;3;27135;23978;69;51113
01;2020-11-07;0;1;1;18401;14661;79;33062
01;2020-11-07;0;0;0;9633;6375;89;16008
01;2020-11-07;0;0;0;3410;1510;90;4920
01;2020-11-07;2;7;9;205664;171215;0;376879
02;2020-11-07;0;1;1;16881;17110;09;33991
02;2020-11-07;4;1;5;21410;21604;19;43014
02;2020-11-07;1;2;3;16017;15479;29;31496
02;2020-11-07;2;0;2;19825;14455;39;34280
02;2020-11-07;5;3;8;24719;18248;49;42967
02;2020-11-07;4;4;8;34361;28310;59;62671
02;2020-11-07;1;1;2;28061;24495;69;52556
02;2020-11-07;0;0;0;18231;15278;79;33509
02;2020-11-07;0;1;1;11090;7677;89;18767
02;2020-11-07;0;0;0;3992;1506;90;5498
02;2020-11-07;17;13;30;194587;164162;0;358749
03;2020-11-07;0;0;0;31123;30920;09;62043
03;2020-11-07;1;1;2;29370;29268;19;58638
03;2020-11-07;0;2;2;21458;18963;29;40421
03;2020-11-07;0;2;2;21276;18326;39;39602
03;2020-11-07;0;0;0;18164;16593;49;34757
03;2020-11-07;0;1;1;13469;13557;59;27026
03;2020-11-07;0;1;1;8776;8670;69;17446
03;2020-11-07;0;0;0;3777;3591;79;7368
03;2020-11-07;0;0;0;1649;1072;89;2721
03;2020-11-07;0;0;0;485;184;90;669
03;2020-11-07;1;7;8;149547;141144;0;290691
04;2020-11-07;0;3;3;60314;61377;09;121691
04;2020-11-07;9;8;17;66065;68387;19;134452
04;2020-11-07;9;4;13;51059;47156;29;98215
04;2020-11-07;4;5;9;58788;45780;39;104568
04;2020-11-07;6;1;7;61408;52207;49;113615
04;2020-11-07;7;6;13;64838;60759;59;125597
04;2020-11-07;3;3;6;47008;42843;69;89851
04;2020-11-07;0;3;3;25509;21184;79;46693
04;2020-11-07;0;4;4;13168;7647;89;20815
04;2020-11-07;0;0;0;3209;1253;90;4462
04;2020-11-07;38;37;75;451366;408593;0;859959
05;2020-11-07;0;0;0;362.366008612902;341.338819562748;09;703.704828175651
05;2020-11-07;0;0;0;353.376145114279;370.349735405642;19;723.725880519921
05;2020-11-07;0;0;0;218.593559489256;256.539602589476;29;475.133162078732
05;2020-11-07;0;0;0;404.225408693299;360.321910454353;39;764.547319147651
05;2020-11-07;0;0;0;520.067953604221;497.108383964256;49;1017.17633756848
05;2020-11-07;0;0;0;468.146063921917;510.087601910415;59;978.233665832332
05;2020-11-07;0;0;0;340.368470050554;334.366842191253;69;674.735312241807
05;2020-11-07;0;0;0;212.598666888387;192.597753227106;79;405.196420115493
05;2020-11-07;0;0;0;148.727797095705;61.8681715431829;89;210.595968638888
05;2020-11-07;0;0;0;32.9601271090696;10.9909785719784;90;43.9511056810479
05;2020-11-07;0;0;0;3061.43020057959;2935.56979942041;0;5997
06;2020-11-07;0;0;0;42583;42380;09;84963
06;2020-11-07;0;1;1;33369;31925;19;65294
06;2020-11-07;2;1;3;21571;15080;29;36651
06;2020-11-07;3;0;3;21550;16147;39;37697
06;2020-11-07;1;0;1;14193;13939;49;28132
06;2020-11-07;1;0;1;7171;7597;59;14768
06;2020-11-07;1;2;3;3629;4117;69;7746
06;2020-11-07;1;0;1;1577;1457;79;3034
06;2020-11-07;0;0;0;531;474;89;1005
06;2020-11-07;0;0;0;88;93;90;181
06;2020-11-07;9;4;13;146262;133209;0;279471
07;2020-11-07;0;0;0;485;549;09;1034
07;2020-11-07;0;0;0;403;432;19;835
07;2020-11-07;0;0;0;764;841;29;1605
07;2020-11-07;0;0;0;824;928;39;1752
07;2020-11-07;0;0;0;788;1020;49;1808
07;2020-11-07;0;0;0;678;870;59;1548
07;2020-11-07;0;0;0;360;382;69;742
07;2020-11-07;0;0;0;231;190;79;421
07;2020-11-07;0;0;0;114;67;89;181
07;2020-11-07;0;0;0;24;11;90;35
07;2020-11-07;0;0;0;4671;5290;0;9961
08;2020-11-07;0;0;0;2715.22592983026;2997.75551488675;09;5712.98144471701
08;2020-11-07;0;0;0;2778.51901080978;3160.9156459093;19;5939.43465671908
08;2020-11-07;0;0;0;2080.8882988764;1718.16634315323;29;3799.05464202964
08;2020-11-07;2;0;2;2701.8582062647;1896.52641413317;39;4598.38462039786
08;2020-11-07;0;0;0;3151.45861023308;2460.52498233809;49;5611.98359257117
08;2020-11-07;0;0;0;2620.29868333099;2422.23566154656;59;5042.53434487755
08;2020-11-07;0;0;0;1621.44173420671;1438.58325779464;69;3060.02499200135
08;2020-11-07;0;0;0;626.575909335673;526.358467843651;79;1152.93437717932
08;2020-11-07;0;0;0;205.018522985054;140.993639349697;89;346.012162334751
08;2020-11-07;0;0;0;50.0325684687745;20.62259870351;90;70.6551671722846
08;2020-11-07;2;0;2;18551.3174743414;16782.6825256586;0;35334
11;2020-11-07;48;73;133;783071;811785;09;1594856
11;2020-11-07;147;166;347;761456;784653;19;1546109
11;2020-11-07;215;169;385;850145;801772;29;1651917
11;2020-11-07;233;190;426;914360;843488;39;1757848
11;2020-11-07;218;175;394;845609;826202;49;1671811
11;2020-11-07;167;179;347;793566;745070;59;1538636
11;2020-11-07;161;168;338;628649;549192;69;1177841
11;2020-11-07;78;71;150;434606;358356;79;792962
11;2020-11-07;53;44;97;261425;162933;89;424358
11;2020-11-07;34;12;46;89253;32619;90;121872
11;2020-11-07;1355;1249;2666;6362140;5916070;0;12278210
24;2020-11-07;8;8;16;139720;144686;09;284406
24;2020-11-07;38;33;73;152979;161185;19;314164
24;2020-11-07;46;34;80;122237;126536;29;248773
24;2020-11-07;51;33;84;150359;142009;39;292368
24;2020-11-07;51;37;88;161829;158758;49;320587
24;2020-11-07;45;40;85;172552;168011;59;340563
24;2020-11-07;31;31;62;172509;158177;69;330686
24;2020-11-07;26;35;61;129428;110593;79;240021
24;2020-11-07;15;15;30;87342;56882;89;144224
24;2020-11-07;20;6;26;31210;12071;90;43281
24;2020-11-07;331;272;605;1320165;1238908;0;2559073
27;2020-11-07;20;24;44;143373;149679;09;293052
27;2020-11-07;94;81;175;160962;173003;19;333965
27;2020-11-07;93;73;166;133746;142254;29;276000
27;2020-11-07;90;54;144;160004;155407;39;315411
27;2020-11-07;109;76;185;172333;169564;49;341897
27;2020-11-07;83;68;151;189979;183788;59;373767
27;2020-11-07;75;77;152;192591;178206;69;370797
27;2020-11-07;39;42;81;146876;127546;79;274422
27;2020-11-07;48;37;85;96896;61575;89;158471
27;2020-11-07;19;10;29;33148;12109;90;45257
27;2020-11-07;671;542;1214;1429908;1353131;0;2783039
28;2020-11-07;16;8;24;180735;186856;09;367591
28;2020-11-07;45;39;85;200125;213621;19;413746
28;2020-11-07;44;29;73;168922;173007;29;341929
28;2020-11-07;44;16;60;196628;188487;39;385115
28;2020-11-07;60;56;116;205396;201699;49;407095
28;2020-11-07;64;48;112;222002;213866;59;435868
28;2020-11-07;37;29;66;224688;203758;69;428446
28;2020-11-07;35;34;69;163192;135543;79;298735
28;2020-11-07;28;22;50;109691;65377;89;175068
28;2020-11-07;17;6;23;37222;12685;90;49907
28;2020-11-07;390;287;678;1708601;1594899;0;3303500
32;2020-11-07;45;55;100;358062;373689;09;731751
32;2020-11-07;167;166;333;387045;406742;19;793787
32;2020-11-07;159;133;292;342304;348587;29;690891
32;2020-11-07;186;157;343;382485;369972;39;752457
32;2020-11-07;163;162;325;382510;376716;49;759226
32;2020-11-07;148;172;320;386937;376527;59;763464
32;2020-11-07;102;105;207;371211;330938;69;702149
32;2020-11-07;73;76;149;250542;201459;79;452001
32;2020-11-07;76;55;131;163399;89786;89;253185
32;2020-11-07;34;9;43;48384;15367;90;63751
32;2020-11-07;1153;1090;2243;3072879;2889783;0;5962662
44;2020-11-07;28;25;53;291525;306839;09;598364
44;2020-11-07;89;90;181;320255;339504;19;659759
44;2020-11-07;108;97;205;302020;314428;29;616448
44;2020-11-07;97;93;190;342222;333292;39;675514
44;2020-11-07;117;109;226;349727;344491;49;694218
44;2020-11-07;117;122;239;381371;373239;59;754610
44;2020-11-07;75;79;154;367165;335850;69;703015
44;2020-11-07;56;59;115;250387;215436;79;465823
44;2020-11-07;47;36;83;170825;105192;89;276017
44;2020-11-07;21;11;32;51248;16731;90;67979
44;2020-11-07;755;722;1479;2826745;2685002;0;5511747
52;2020-11-07;13;16;29;213594;223900;09;437494
52;2020-11-07;78;65;146;240818;255197;19;496015
52;2020-11-07;65;61;126;197010;200630;29;397640
52;2020-11-07;58;68;126;231204;224885;39;456089
52;2020-11-07;69;63;132;243874;243418;49;487292
52;2020-11-07;70;70;140;244100;239116;59;483216
52;2020-11-07;46;41;87;241796;221345;69;463141
52;2020-11-07;34;23;57;177805;149903;79;327708
52;2020-11-07;31;18;49;119561;75822;89;195383
52;2020-11-07;14;7;21;42559;15260;90;57819
52;2020-11-07;478;432;913;1952321;1849476;0;3801797
53;2020-11-07;15;16;32;173813;182358;09;356171
53;2020-11-07;48;45;93;202720;214740;19;417460
53;2020-11-07;46;45;91;163116;173196;29;336312
53;2020-11-07;41;48;89;190526;187674;39;378200
53;2020-11-07;54;30;84;212098;212015;49;424113
53;2020-11-07;37;50;87;223699;219176;59;442875
53;2020-11-07;25;30;55;227435;209274;69;436709
53;2020-11-07;19;26;45;169992;140910;79;310902
53;2020-11-07;24;10;34;118117;69883;89;188000
53;2020-11-07;12;4;16;37370;12267;90;49637
53;2020-11-07;321;304;626;1718886;1621493;0;3340379
75;2020-11-07;14;22;37;293104;305291;09;598395
75;2020-11-07;80;86;167;337141;357785;19;694926
75;2020-11-07;78;70;148;295024;300618;29;595642
75;2020-11-07;100;65;165;347871;331233;39;679104
75;2020-11-07;90;72;162;384742;372771;49;757513
75;2020-11-07;74;72;146;413361;390880;59;804241
75;2020-11-07;47;60;108;425623;384060;69;809683
75;2020-11-07;39;36;75;325086;276298;79;601384
75;2020-11-07;29;25;54;213986;139308;89;353294
75;2020-11-07;20;3;23;77600;28200;90;105800
75;2020-11-07;572;511;1086;3113538;2886444;0;5999982
76;2020-11-07;19;21;41;305956;318589;09;624545
76;2020-11-07;77;81;159;338942;356969;19;695911
76;2020-11-07;109;79;188;316210;319570;29;635780
76;2020-11-07;104;72;176;356758;337587;39;694345
76;2020-11-07;110;81;191;376541;363812;49;740353
76;2020-11-07;87;81;168;402608;383750;59;786358
76;2020-11-07;74;58;132;394889;358997;69;753886
76;2020-11-07;53;56;109;308664;263806;79;572470
76;2020-11-07;78;38;116;195838;129272;89;325110
76;2020-11-07;36;9;45;69372;26728;90;96100
76;2020-11-07;747;577;1326;3065778;2859080;0;5924858
84;2020-11-07;53;77;134;459549;481088;09;940637
84;2020-11-07;272;283;561;487711;511905;19;999616
84;2020-11-07;264;241;505;443824;451094;29;894918
84;2020-11-07;249;221;471;512522;493262;39;1005784
84;2020-11-07;328;265;593;520248;515106;49;1035354
84;2020-11-07;260;270;530;529611;514848;59;1044459
84;2020-11-07;194;175;371;486720;439940;69;926660
84;2020-11-07;144;154;298;372151;315211;79;687362
84;2020-11-07;144;91;235;237198;150524;89;387722
84;2020-11-07;59;20;79;81185;28680;90;109865
84;2020-11-07;1967;1797;3777;4130719;3901658;0;8032377
93;2020-11-07;15;23;38;268834;283093;09;551927
93;2020-11-07;70;55;127;280751;296087;19;576838
93;2020-11-07;66;48;114;254404;255552;29;509956
93;2020-11-07;79;55;134;310704;288398;39;599102
93;2020-11-07;94;53;147;325559;305827;49;631386
93;2020-11-07;67;81;148;353104;325389;59;678493
93;2020-11-07;68;56;125;336327;296459;69;632786
93;2020-11-07;39;48;87;279820;229699;79;509519
93;2020-11-07;49;38;87;171274;113716;89;284990
93;2020-11-07;29;10;39;58896;21758;90;80654
93;2020-11-07;576;468;1047;2639673;2415978;0;5055651
94;2020-11-07;1;1;2;16311;17433;09;33744
94;2020-11-07;1;2;3;16679;18132;19;34811
94;2020-11-07;4;3;7;16782;16579;29;33361
94;2020-11-07;4;2;6;23044;20580;39;43624
94;2020-11-07;1;5;6;23065;22140;49;45205
94;2020-11-07;1;3;4;24549;23421;59;47970
94;2020-11-07;4;3;7;23212;21883;69;45095
94;2020-11-07;2;1;3;19544;17141;79;36685
94;2020-11-07;1;0;1;11227;8178;89;19405
94;2020-11-07;0;0;0;3332;1447;90;4779
94;2020-11-07;19;20;39;177745;166934;0;344679
01;2020-11-08;0;0;0;19979;20155;09;40134
01;2020-11-08;0;0;0;24994;25489;19;50483
01;2020-11-08;0;0;0;17868;16690;29;34558
01;2020-11-08;1;0;1;22328;14821;39;37149
01;2020-11-08;0;0;0;28652;20276;49;48928
01;2020-11-08;0;1;1;33264;27260;59;60524
01;2020-11-08;0;1;1;27135;23978;69;51113
01;2020-11-08;0;3;3;18401;14661;79;33062
01;2020-11-08;0;0;0;9633;6375;89;16008
01;2020-11-08;0;0;0;3410;1510;90;4920
01;2020-11-08;1;5;6;205664;171215;0;376879
02;2020-11-08;0;0;0;16881;17110;09;33991
02;2020-11-08;0;0;0;21410;21604;19;43014
02;2020-11-08;0;0;0;16017;15479;29;31496
02;2020-11-08;0;0;0;19825;14455;39;34280
02;2020-11-08;0;1;1;24719;18248;49;42967
02;2020-11-08;0;0;0;34361;28310;59;62671
02;2020-11-08;0;1;1;28061;24495;69;52556
02;2020-11-08;0;0;0;18231;15278;79;33509
02;2020-11-08;1;0;1;11090;7677;89;18767
02;2020-11-08;0;0;0;3992;1506;90;5498
02;2020-11-08;1;2;3;194587;164162;0;358749
03;2020-11-08;0;0;0;31123;30920;09;62043
03;2020-11-08;0;0;0;29370;29268;19;58638
03;2020-11-08;0;0;0;21458;18963;29;40421
03;2020-11-08;1;1;2;21276;18326;39;39602
03;2020-11-08;0;1;1;18164;16593;49;34757
03;2020-11-08;2;0;2;13469;13557;59;27026
03;2020-11-08;0;0;0;8776;8670;69;17446
03;2020-11-08;0;1;1;3777;3591;79;7368
03;2020-11-08;0;0;0;1649;1072;89;2721
03;2020-11-08;0;0;0;485;184;90;669
03;2020-11-08;3;3;6;149547;141144;0;290691
04;2020-11-08;0;1;1;60314;61377;09;121691
04;2020-11-08;1;0;1;66065;68387;19;134452
04;2020-11-08;1;1;2;51059;47156;29;98215
04;2020-11-08;4;0;4;58788;45780;39;104568
04;2020-11-08;0;1;1;61408;52207;49;113615
04;2020-11-08;1;1;2;64838;60759;59;125597
04;2020-11-08;0;1;1;47008;42843;69;89851
04;2020-11-08;1;0;1;25509;21184;79;46693
04;2020-11-08;0;0;0;13168;7647;89;20815
04;2020-11-08;0;0;0;3209;1253;90;4462
04;2020-11-08;8;5;13;451366;408593;0;859959
05;2020-11-08;0;0;0;362.366008612902;341.338819562748;09;703.704828175651
05;2020-11-08;0;0;0;353.376145114279;370.349735405642;19;723.725880519921
05;2020-11-08;0;0;0;218.593559489256;256.539602589476;29;475.133162078732
05;2020-11-08;0;0;0;404.225408693299;360.321910454353;39;764.547319147651
05;2020-11-08;0;0;0;520.067953604221;497.108383964256;49;1017.17633756848
05;2020-11-08;0;0;0;468.146063921917;510.087601910415;59;978.233665832332
05;2020-11-08;0;0;0;340.368470050554;334.366842191253;69;674.735312241807
05;2020-11-08;0;0;0;212.598666888387;192.597753227106;79;405.196420115493
05;2020-11-08;0;0;0;148.727797095705;61.8681715431829;89;210.595968638888
05;2020-11-08;0;0;0;32.9601271090696;10.9909785719784;90;43.9511056810479
05;2020-11-08;0;0;0;3061.43020057959;2935.56979942041;0;5997
06;2020-11-08;0;1;1;42583;42380;09;84963
06;2020-11-08;0;0;0;33369;31925;19;65294
06;2020-11-08;1;2;3;21571;15080;29;36651
06;2020-11-08;2;0;2;21550;16147;39;37697
06;2020-11-08;2;2;4;14193;13939;49;28132
06;2020-11-08;0;0;0;7171;7597;59;14768
06;2020-11-08;0;0;0;3629;4117;69;7746
06;2020-11-08;0;0;0;1577;1457;79;3034
06;2020-11-08;0;1;1;531;474;89;1005
06;2020-11-08;0;0;0;88;93;90;181
06;2020-11-08;5;6;11;146262;133209;0;279471
07;2020-11-08;0;0;0;485;549;09;1034
07;2020-11-08;0;0;0;403;432;19;835
07;2020-11-08;0;0;0;764;841;29;1605
07;2020-11-08;0;0;0;824;928;39;1752
07;2020-11-08;0;1;1;788;1020;49;1808
07;2020-11-08;0;0;0;678;870;59;1548
07;2020-11-08;0;0;0;360;382;69;742
07;2020-11-08;0;0;0;231;190;79;421
07;2020-11-08;0;0;0;114;67;89;181
07;2020-11-08;0;0;0;24;11;90;35
07;2020-11-08;0;1;1;4671;5290;0;9961
08;2020-11-08;0;0;0;2715.22592983026;2997.75551488675;09;5712.98144471701
08;2020-11-08;0;0;0;2778.51901080978;3160.9156459093;19;5939.43465671908
08;2020-11-08;0;0;0;2080.8882988764;1718.16634315323;29;3799.05464202964
08;2020-11-08;0;0;0;2701.8582062647;1896.52641413317;39;4598.38462039786
08;2020-11-08;0;0;0;3151.45861023308;2460.52498233809;49;5611.98359257117
08;2020-11-08;0;0;0;2620.29868333099;2422.23566154656;59;5042.53434487755
08;2020-11-08;0;0;0;1621.44173420671;1438.58325779464;69;3060.02499200135
08;2020-11-08;1;0;1;626.575909335673;526.358467843651;79;1152.93437717932
08;2020-11-08;0;0;0;205.018522985054;140.993639349697;89;346.012162334751
08;2020-11-08;0;0;0;50.0325684687745;20.62259870351;90;70.6551671722846
08;2020-11-08;1;0;1;18551.3174743414;16782.6825256586;0;35334
11;2020-11-08;12;17;29;783071;811785;09;1594856
11;2020-11-08;22;32;55;761456;784653;19;1546109
11;2020-11-08;52;36;88;850145;801772;29;1651917
11;2020-11-08;46;49;95;914360;843488;39;1757848
11;2020-11-08;39;36;75;845609;826202;49;1671811
11;2020-11-08;43;29;72;793566;745070;59;1538636
11;2020-11-08;39;42;81;628649;549192;69;1177841
11;2020-11-08;18;30;48;434606;358356;79;792962
11;2020-11-08;37;26;63;261425;162933;89;424358
11;2020-11-08;17;11;28;89253;32619;90;121872
11;2020-11-08;325;308;634;6362140;5916070;0;12278210
24;2020-11-08;4;4;8;139720;144686;09;284406
24;2020-11-08;13;10;23;152979;161185;19;314164
24;2020-11-08;16;16;32;122237;126536;29;248773
24;2020-11-08;10;16;27;150359;142009;39;292368
24;2020-11-08;17;18;35;161829;158758;49;320587
24;2020-11-08;12;13;25;172552;168011;59;340563
24;2020-11-08;7;5;12;172509;158177;69;330686
24;2020-11-08;8;11;19;129428;110593;79;240021
24;2020-11-08;8;8;16;87342;56882;89;144224
24;2020-11-08;8;5;13;31210;12071;90;43281
24;2020-11-08;103;106;210;1320165;1238908;0;2559073
27;2020-11-08;1;4;5;143373;149679;09;293052
27;2020-11-08;15;17;32;160962;173003;19;333965
27;2020-11-08;13;16;29;133746;142254;29;276000
27;2020-11-08;20;16;36;160004;155407;39;315411
27;2020-11-08;9;13;22;172333;169564;49;341897
27;2020-11-08;17;16;33;189979;183788;59;373767
27;2020-11-08;12;13;25;192591;178206;69;370797
27;2020-11-08;13;17;30;146876;127546;79;274422
27;2020-11-08;17;21;38;96896;61575;89;158471
27;2020-11-08;14;6;20;33148;12109;90;45257
27;2020-11-08;131;139;270;1429908;1353131;0;2783039
28;2020-11-08;2;5;7;180735;186856;09;367591
28;2020-11-08;11;14;25;200125;213621;19;413746
28;2020-11-08;27;6;33;168922;173007;29;341929
28;2020-11-08;24;13;37;196628;188487;39;385115
28;2020-11-08;17;18;35;205396;201699;49;407095
28;2020-11-08;21;14;35;222002;213866;59;435868
28;2020-11-08;13;21;34;224688;203758;69;428446
28;2020-11-08;6;9;15;163192;135543;79;298735
28;2020-11-08;11;8;19;109691;65377;89;175068
28;2020-11-08;8;3;11;37222;12685;90;49907
28;2020-11-08;140;111;251;1708601;1594899;0;3303500
32;2020-11-08;14;14;28;358062;373689;09;731751
32;2020-11-08;28;46;74;387045;406742;19;793787
32;2020-11-08;48;46;94;342304;348587;29;690891
32;2020-11-08;52;36;88;382485;369972;39;752457
32;2020-11-08;47;39;86;382510;376716;49;759226
32;2020-11-08;44;43;87;386937;376527;59;763464
32;2020-11-08;14;24;38;371211;330938;69;702149
32;2020-11-08;18;15;33;250542;201459;79;452001
32;2020-11-08;17;9;26;163399;89786;89;253185
32;2020-11-08;13;4;17;48384;15367;90;63751
32;2020-11-08;295;276;571;3072879;2889783;0;5962662
44;2020-11-08;1;1;2;291525;306839;09;598364
44;2020-11-08;9;8;18;320255;339504;19;659759
44;2020-11-08;14;11;25;302020;314428;29;616448
44;2020-11-08;16;12;28;342222;333292;39;675514
44;2020-11-08;17;13;30;349727;344491;49;694218
44;2020-11-08;14;13;27;381371;373239;59;754610
44;2020-11-08;7;11;18;367165;335850;69;703015
44;2020-11-08;10;12;22;250387;215436;79;465823
44;2020-11-08;20;18;38;170825;105192;89;276017
44;2020-11-08;13;8;21;51248;16731;90;67979
44;2020-11-08;121;107;229;2826745;2685002;0;5511747
52;2020-11-08;9;6;15;213594;223900;09;437494
52;2020-11-08;9;7;17;240818;255197;19;496015
52;2020-11-08;16;9;25;197010;200630;29;397640
52;2020-11-08;22;13;35;231204;224885;39;456089
52;2020-11-08;12;14;26;243874;243418;49;487292
52;2020-11-08;14;9;23;244100;239116;59;483216
52;2020-11-08;9;7;16;241796;221345;69;463141
52;2020-11-08;5;9;14;177805;149903;79;327708
52;2020-11-08;9;8;17;119561;75822;89;195383
52;2020-11-08;8;4;12;42559;15260;90;57819
52;2020-11-08;113;86;200;1952321;1849476;0;3801797
53;2020-11-08;3;3;6;173813;182358;09;356171
53;2020-11-08;7;8;16;202720;214740;19;417460
53;2020-11-08;13;9;23;163116;173196;29;336312
53;2020-11-08;12;0;12;190526;187674;39;378200
53;2020-11-08;12;7;19;212098;212015;49;424113
53;2020-11-08;3;7;10;223699;219176;59;442875
53;2020-11-08;8;4;12;227435;209274;69;436709
53;2020-11-08;4;9;13;169992;140910;79;310902
53;2020-11-08;3;2;5;118117;69883;89;188000
53;2020-11-08;4;7;11;37370;12267;90;49637
53;2020-11-08;69;56;127;1718886;1621493;0;3340379
75;2020-11-08;3;4;7;293104;305291;09;598395
75;2020-11-08;10;9;19;337141;357785;19;694926
75;2020-11-08;22;8;30;295024;300618;29;595642
75;2020-11-08;7;11;18;347871;331233;39;679104
75;2020-11-08;9;12;21;384742;372771;49;757513
75;2020-11-08;10;8;18;413361;390880;59;804241
75;2020-11-08;5;10;15;425623;384060;69;809683
75;2020-11-08;11;15;26;325086;276298;79;601384
75;2020-11-08;26;18;44;213986;139308;89;353294
75;2020-11-08;14;2;16;77600;28200;90;105800
75;2020-11-08;117;97;214;3113538;2886444;0;5999982
76;2020-11-08;3;0;3;305956;318589;09;624545
76;2020-11-08;21;21;42;338942;356969;19;695911
76;2020-11-08;16;17;33;316210;319570;29;635780
76;2020-11-08;27;18;45;356758;337587;39;694345
76;2020-11-08;23;24;47;376541;363812;49;740353
76;2020-11-08;21;29;50;402608;383750;59;786358
76;2020-11-08;19;15;34;394889;358997;69;753886
76;2020-11-08;17;31;48;308664;263806;79;572470
76;2020-11-08;29;16;45;195838;129272;89;325110
76;2020-11-08;32;6;38;69372;26728;90;96100
76;2020-11-08;208;177;385;3065778;2859080;0;5924858
84;2020-11-08;9;10;19;459549;481088;09;940637
84;2020-11-08;35;42;77;487711;511905;19;999616
84;2020-11-08;51;37;88;443824;451094;29;894918
84;2020-11-08;50;42;92;512522;493262;39;1005784
84;2020-11-08;56;46;102;520248;515106;49;1035354
84;2020-11-08;47;48;95;529611;514848;59;1044459
84;2020-11-08;34;52;86;486720;439940;69;926660
84;2020-11-08;50;57;107;372151;315211;79;687362
84;2020-11-08;68;51;119;237198;150524;89;387722
84;2020-11-08;52;23;75;81185;28680;90;109865
84;2020-11-08;452;408;860;4130719;3901658;0;8032377
93;2020-11-08;4;7;11;268834;283093;09;551927
93;2020-11-08;9;11;20;280751;296087;19;576838
93;2020-11-08;18;8;26;254404;255552;29;509956
93;2020-11-08;28;14;42;310704;288398;39;599102
93;2020-11-08;20;18;38;325559;305827;49;631386
93;2020-11-08;24;17;41;353104;325389;59;678493
93;2020-11-08;10;24;34;336327;296459;69;632786
93;2020-11-08;14;14;28;279820;229699;79;509519
93;2020-11-08;24;17;41;171274;113716;89;284990
93;2020-11-08;16;9;25;58896;21758;90;80654
93;2020-11-08;167;139;306;2639673;2415978;0;5055651
94;2020-11-08;0;0;0;16311;17433;09;33744
94;2020-11-08;0;0;0;16679;18132;19;34811
94;2020-11-08;2;1;3;16782;16579;29;33361
94;2020-11-08;0;0;0;23044;20580;39;43624
94;2020-11-08;1;0;1;23065;22140;49;45205
94;2020-11-08;1;0;1;24549;23421;59;47970
94;2020-11-08;0;1;1;23212;21883;69;45095
94;2020-11-08;1;1;2;19544;17141;79;36685
94;2020-11-08;0;0;0;11227;8178;89;19405
94;2020-11-08;0;0;0;3332;1447;90;4779
94;2020-11-08;5;3;8;177745;166934;0;344679
01;2020-11-09;0;1;1;19979;20155;09;40134
01;2020-11-09;0;4;4;24994;25489;19;50483
01;2020-11-09;3;0;3;17868;16690;29;34558
01;2020-11-09;4;2;6;22328;14821;39;37149
01;2020-11-09;7;1;8;28652;20276;49;48928
01;2020-11-09;4;0;4;33264;27260;59;60524
01;2020-11-09;1;1;2;27135;23978;69;51113
01;2020-11-09;2;1;3;18401;14661;79;33062
01;2020-11-09;0;0;0;9633;6375;89;16008
01;2020-11-09;0;1;1;3410;1510;90;4920
01;2020-11-09;21;11;32;205664;171215;0;376879
02;2020-11-09;0;1;1;16881;17110;09;33991
02;2020-11-09;8;14;22;21410;21604;19;43014
02;2020-11-09;5;3;8;16017;15479;29;31496
02;2020-11-09;12;5;17;19825;14455;39;34280
02;2020-11-09;20;10;31;24719;18248;49;42967
02;2020-11-09;11;8;19;34361;28310;59;62671
02;2020-11-09;5;3;9;28061;24495;69;52556
02;2020-11-09;3;1;4;18231;15278;79;33509
02;2020-11-09;3;4;7;11090;7677;89;18767
02;2020-11-09;0;1;1;3992;1506;90;5498
02;2020-11-09;67;50;119;194587;164162;0;358749
03;2020-11-09;1;2;3;31123;30920;09;62043
03;2020-11-09;1;0;1;29370;29268;19;58638
03;2020-11-09;2;3;5;21458;18963;29;40421
03;2020-11-09;7;5;12;21276;18326;39;39602
03;2020-11-09;2;4;6;18164;16593;49;34757
03;2020-11-09;3;5;8;13469;13557;59;27026
03;2020-11-09;2;0;2;8776;8670;69;17446
03;2020-11-09;0;2;2;3777;3591;79;7368
03;2020-11-09;0;0;0;1649;1072;89;2721
03;2020-11-09;0;0;0;485;184;90;669
03;2020-11-09;18;21;39;149547;141144;0;290691
04;2020-11-09;4;1;5;60314;61377;09;121691
04;2020-11-09;13;16;29;66065;68387;19;134452
04;2020-11-09;8;4;12;51059;47156;29;98215
04;2020-11-09;10;9;19;58788;45780;39;104568
04;2020-11-09;13;14;27;61408;52207;49;113615
04;2020-11-09;15;16;31;64838;60759;59;125597
04;2020-11-09;4;5;9;47008;42843;69;89851
04;2020-11-09;5;1;6;25509;21184;79;46693
04;2020-11-09;1;0;1;13168;7647;89;20815
04;2020-11-09;0;0;0;3209;1253;90;4462
04;2020-11-09;73;66;139;451366;408593;0;859959
05;2020-11-09;0;0;0;362.366008612902;341.338819562748;09;703.704828175651
05;2020-11-09;0;0;0;353.376145114279;370.349735405642;19;723.725880519921
05;2020-11-09;0;0;0;218.593559489256;256.539602589476;29;475.133162078732
05;2020-11-09;0;0;0;404.225408693299;360.321910454353;39;764.547319147651
05;2020-11-09;0;0;0;520.067953604221;497.108383964256;49;1017.17633756848
05;2020-11-09;0;0;0;468.146063921917;510.087601910415;59;978.233665832332
05;2020-11-09;0;0;0;340.368470050554;334.366842191253;69;674.735312241807
05;2020-11-09;0;0;0;212.598666888387;192.597753227106;79;405.196420115493
05;2020-11-09;0;0;0;148.727797095705;61.8681715431829;89;210.595968638888
05;2020-11-09;0;0;0;32.9601271090696;10.9909785719784;90;43.9511056810479
05;2020-11-09;0;0;0;3061.43020057959;2935.56979942041;0;5997
06;2020-11-09;1;1;2;42583;42380;09;84963
06;2020-11-09;3;2;5;33369;31925;19;65294
06;2020-11-09;8;5;13;21571;15080;29;36651
06;2020-11-09;4;6;10;21550;16147;39;37697
06;2020-11-09;12;4;16;14193;13939;49;28132
06;2020-11-09;2;5;7;7171;7597;59;14768
06;2020-11-09;1;1;2;3629;4117;69;7746
06;2020-11-09;1;1;2;1577;1457;79;3034
06;2020-11-09;0;0;0;531;474;89;1005
06;2020-11-09;0;0;0;88;93;90;181
06;2020-11-09;32;25;57;146262;133209;0;279471
07;2020-11-09;0;0;0;485;549;09;1034
07;2020-11-09;0;0;0;403;432;19;835
07;2020-11-09;1;0;1;764;841;29;1605
07;2020-11-09;0;2;2;824;928;39;1752
07;2020-11-09;0;0;0;788;1020;49;1808
07;2020-11-09;0;1;1;678;870;59;1548
07;2020-11-09;0;0;0;360;382;69;742
07;2020-11-09;0;0;0;231;190;79;421
07;2020-11-09;0;0;0;114;67;89;181
07;2020-11-09;0;0;0;24;11;90;35
07;2020-11-09;1;3;4;4671;5290;0;9961
08;2020-11-09;0;0;0;2715.22592983026;2997.75551488675;09;5712.98144471701
08;2020-11-09;0;1;1;2778.51901080978;3160.9156459093;19;5939.43465671908
08;2020-11-09;0;0;0;2080.8882988764;1718.16634315323;29;3799.05464202964
08;2020-11-09;2;1;3;2701.8582062647;1896.52641413317;39;4598.38462039786
08;2020-11-09;1;0;1;3151.45861023308;2460.52498233809;49;5611.98359257117
08;2020-11-09;0;0;0;2620.29868333099;2422.23566154656;59;5042.53434487755
08;2020-11-09;0;1;1;1621.44173420671;1438.58325779464;69;3060.02499200135
08;2020-11-09;0;0;0;626.575909335673;526.358467843651;79;1152.93437717932
08;2020-11-09;0;1;1;205.018522985054;140.993639349697;89;346.012162334751
08;2020-11-09;0;0;0;50.0325684687745;20.62259870351;90;70.6551671722846
08;2020-11-09;3;4;7;18551.3174743414;16782.6825256586;0;35334
11;2020-11-09;108;113;232;783071;811785;09;1594856
11;2020-11-09;479;431;941;761456;784653;19;1546109
11;2020-11-09;630;464;1100;850145;801772;29;1651917
11;2020-11-09;647;531;1181;914360;843488;39;1757848
11;2020-11-09;639;518;1161;845609;826202;49;1671811
11;2020-11-09;532;482;1014;793566;745070;59;1538636
11;2020-11-09;385;401;791;628649;549192;69;1177841
11;2020-11-09;194;192;389;434606;358356;79;792962
11;2020-11-09;172;108;281;261425;162933;89;424358
11;2020-11-09;131;37;168;89253;32619;90;121872
11;2020-11-09;3919;3279;7263;6362140;5916070;0;12278210
24;2020-11-09;13;11;27;139720;144686;09;284406
24;2020-11-09;94;84;181;152979;161185;19;314164
24;2020-11-09;82;77;159;122237;126536;29;248773
24;2020-11-09;115;78;193;150359;142009;39;292368
24;2020-11-09;108;85;193;161829;158758;49;320587
24;2020-11-09;105;92;197;172552;168011;59;340563
24;2020-11-09;80;55;135;172509;158177;69;330686
24;2020-11-09;40;56;96;129428;110593;79;240021
24;2020-11-09;60;42;102;87342;56882;89;144224
24;2020-11-09;56;16;72;31210;12071;90;43281
24;2020-11-09;754;596;1356;1320165;1238908;0;2559073
27;2020-11-09;50;44;94;143373;149679;09;293052
27;2020-11-09;179;178;359;160962;173003;19;333965
27;2020-11-09;174;129;303;133746;142254;29;276000
27;2020-11-09;201;141;342;160004;155407;39;315411
27;2020-11-09;224;180;404;172333;169564;49;341897
27;2020-11-09;219;161;380;189979;183788;59;373767
27;2020-11-09;170;152;322;192591;178206;69;370797
27;2020-11-09;98;123;221;146876;127546;79;274422
27;2020-11-09;114;70;184;96896;61575;89;158471
27;2020-11-09;88;18;106;33148;12109;90;45257
27;2020-11-09;1518;1196;2716;1429908;1353131;0;2783039
28;2020-11-09;32;27;60;180735;186856;09;367591
28;2020-11-09;92;83;179;200125;213621;19;413746
28;2020-11-09;115;81;196;168922;173007;29;341929
28;2020-11-09;111;101;212;196628;188487;39;385115
28;2020-11-09;129;91;220;205396;201699;49;407095
28;2020-11-09;119;138;257;222002;213866;59;435868
28;2020-11-09;96;85;181;224688;203758;69;428446
28;2020-11-09;63;55;118;163192;135543;79;298735
28;2020-11-09;79;33;112;109691;65377;89;175068
28;2020-11-09;45;14;59;37222;12685;90;49907
28;2020-11-09;881;708;1594;1708601;1594899;0;3303500
32;2020-11-09;87;89;176;358062;373689;09;731751
32;2020-11-09;303;289;593;387045;406742;19;793787
32;2020-11-09;338;263;602;342304;348587;29;690891
32;2020-11-09;366;312;678;382485;369972;39;752457
32;2020-11-09;376;303;679;382510;376716;49;759226
32;2020-11-09;350;284;634;386937;376527;59;763464
32;2020-11-09;222;226;448;371211;330938;69;702149
32;2020-11-09;183;165;348;250542;201459;79;452001
32;2020-11-09;166;96;262;163399;89786;89;253185
32;2020-11-09;111;19;130;48384;15367;90;63751
32;2020-11-09;2503;2048;4553;3072879;2889783;0;5962662
44;2020-11-09;67;85;154;291525;306839;09;598364
44;2020-11-09;257;299;558;320255;339504;19;659759
44;2020-11-09;270;225;496;302020;314428;29;616448
44;2020-11-09;288;224;513;342222;333292;39;675514
44;2020-11-09;306;244;552;349727;344491;49;694218
44;2020-11-09;353;283;638;381371;373239;59;754610
44;2020-11-09;181;192;378;367165;335850;69;703015
44;2020-11-09;160;131;292;250387;215436;79;465823
44;2020-11-09;182;88;271;170825;105192;89;276017
44;2020-11-09;118;27;147;51248;16731;90;67979
44;2020-11-09;2182;1798;4006;2826745;2685002;0;5511747
52;2020-11-09;36;32;70;213594;223900;09;437494
52;2020-11-09;134;142;284;240818;255197;19;496015
52;2020-11-09;155;140;295;197010;200630;29;397640
52;2020-11-09;169;148;317;231204;224885;39;456089
52;2020-11-09;210;129;339;243874;243418;49;487292
52;2020-11-09;171;154;325;244100;239116;59;483216
52;2020-11-09;105;105;210;241796;221345;69;463141
52;2020-11-09;80;64;144;177805;149903;79;327708
52;2020-11-09;74;52;126;119561;75822;89;195383
52;2020-11-09;77;29;106;42559;15260;90;57819
52;2020-11-09;1211;995;2216;1952321;1849476;0;3801797
53;2020-11-09;20;33;55;173813;182358;09;356171
53;2020-11-09;99;65;165;202720;214740;19;417460
53;2020-11-09;92;91;186;163116;173196;29;336312
53;2020-11-09;87;78;165;190526;187674;39;378200
53;2020-11-09;78;57;135;212098;212015;49;424113
53;2020-11-09;82;62;144;223699;219176;59;442875
53;2020-11-09;47;58;105;227435;209274;69;436709
53;2020-11-09;34;40;74;169992;140910;79;310902
53;2020-11-09;58;36;94;118117;69883;89;188000
53;2020-11-09;27;10;38;37370;12267;90;49637
53;2020-11-09;624;530;1161;1718886;1621493;0;3340379
75;2020-11-09;56;51;112;293104;305291;09;598395
75;2020-11-09;175;151;328;337141;357785;19;694926
75;2020-11-09;214;171;387;295024;300618;29;595642
75;2020-11-09;231;160;391;347871;331233;39;679104
75;2020-11-09;218;222;440;384742;372771;49;757513
75;2020-11-09;244;229;473;413361;390880;59;804241
75;2020-11-09;162;150;312;425623;384060;69;809683
75;2020-11-09;135;120;255;325086;276298;79;601384
75;2020-11-09;139;81;220;213986;139308;89;353294
75;2020-11-09;136;29;165;77600;28200;90;105800
75;2020-11-09;1710;1364;3083;3113538;2886444;0;5999982
76;2020-11-09;59;59;123;305956;318589;09;624545
76;2020-11-09;220;230;459;338942;356969;19;695911
76;2020-11-09;263;215;478;316210;319570;29;635780
76;2020-11-09;295;205;501;356758;337587;39;694345
76;2020-11-09;299;230;530;376541;363812;49;740353
76;2020-11-09;322;243;565;402608;383750;59;786358
76;2020-11-09;212;183;396;394889;358997;69;753886
76;2020-11-09;160;153;313;308664;263806;79;572470
76;2020-11-09;183;94;278;195838;129272;89;325110
76;2020-11-09;156;36;192;69372;26728;90;96100
76;2020-11-09;2173;1649;3840;3065778;2859080;0;5924858
84;2020-11-09;162;153;315;459549;481088;09;940637
84;2020-11-09;693;671;1375;487711;511905;19;999616
84;2020-11-09;834;662;1498;443824;451094;29;894918
84;2020-11-09;799;637;1436;512522;493262;39;1005784
84;2020-11-09;859;704;1563;520248;515106;49;1035354
84;2020-11-09;901;751;1654;529611;514848;59;1044459
84;2020-11-09;550;564;1117;486720;439940;69;926660
84;2020-11-09;443;400;844;372151;315211;79;687362
84;2020-11-09;441;232;673;237198;150524;89;387722
84;2020-11-09;330;102;432;81185;28680;90;109865
84;2020-11-09;6012;4876;10907;4130719;3901658;0;8032377
93;2020-11-09;50;57;108;268834;283093;09;551927
93;2020-11-09;232;238;470;280751;296087;19;576838
93;2020-11-09;294;244;539;254404;255552;29;509956
93;2020-11-09;329;227;556;310704;288398;39;599102
93;2020-11-09;316;254;571;325559;305827;49;631386
93;2020-11-09;387;274;662;353104;325389;59;678493
93;2020-11-09;260;233;494;336327;296459;69;632786
93;2020-11-09;178;163;341;279820;229699;79;509519
93;2020-11-09;196;99;295;171274;113716;89;284990
93;2020-11-09;156;42;198;58896;21758;90;80654
93;2020-11-09;2400;1833;4238;2639673;2415978;0;5055651
94;2020-11-09;3;0;3;16311;17433;09;33744
94;2020-11-09;6;9;15;16679;18132;19;34811
94;2020-11-09;6;5;11;16782;16579;29;33361
94;2020-11-09;5;14;19;23044;20580;39;43624
94;2020-11-09;13;11;24;23065;22140;49;45205
94;2020-11-09;12;10;22;24549;23421;59;47970
94;2020-11-09;6;8;14;23212;21883;69;45095
94;2020-11-09;3;4;7;19544;17141;79;36685
94;2020-11-09;3;5;8;11227;8178;89;19405
94;2020-11-09;0;0;0;3332;1447;90;4779
94;2020-11-09;57;66;123;177745;166934;0;344679
01;2020-11-10;1;1;2;19979;20155;09;40134
01;2020-11-10;0;1;1;24994;25489;19;50483
01;2020-11-10;1;1;2;17868;16690;29;34558
01;2020-11-10;7;1;8;22328;14821;39;37149
01;2020-11-10;4;6;10;28652;20276;49;48928
01;2020-11-10;3;1;4;33264;27260;59;60524
01;2020-11-10;4;0;4;27135;23978;69;51113
01;2020-11-10;1;3;4;18401;14661;79;33062
01;2020-11-10;1;0;1;9633;6375;89;16008
01;2020-11-10;0;0;0;3410;1510;90;4920
01;2020-11-10;22;14;36;205664;171215;0;376879
02;2020-11-10;1;3;4;16881;17110;09;33991
02;2020-11-10;7;4;11;21410;21604;19;43014
02;2020-11-10;2;5;7;16017;15479;29;31496
02;2020-11-10;15;4;19;19825;14455;39;34280
02;2020-11-10;5;7;12;24719;18248;49;42967
02;2020-11-10;14;8;22;34361;28310;59;62671
02;2020-11-10;4;6;11;28061;24495;69;52556
02;2020-11-10;4;3;7;18231;15278;79;33509
02;2020-11-10;1;0;1;11090;7677;89;18767
02;2020-11-10;1;0;1;3992;1506;90;5498
02;2020-11-10;54;40;95;194587;164162;0;358749
03;2020-11-10;0;0;0;31123;30920;09;62043
03;2020-11-10;0;0;0;29370;29268;19;58638
03;2020-11-10;2;0;2;21458;18963;29;40421
03;2020-11-10;4;3;7;21276;18326;39;39602
03;2020-11-10;3;1;4;18164;16593;49;34757
03;2020-11-10;2;3;5;13469;13557;59;27026
03;2020-11-10;0;3;3;8776;8670;69;17446
03;2020-11-10;0;0;0;3777;3591;79;7368
03;2020-11-10;0;0;0;1649;1072;89;2721
03;2020-11-10;0;0;0;485;184;90;669
03;2020-11-10;11;10;21;149547;141144;0;290691
04;2020-11-10;2;4;6;60314;61377;09;121691
04;2020-11-10;8;12;20;66065;68387;19;134452
04;2020-11-10;14;13;27;51059;47156;29;98215
04;2020-11-10;9;4;13;58788;45780;39;104568
04;2020-11-10;12;8;20;61408;52207;49;113615
04;2020-11-10;9;7;16;64838;60759;59;125597
04;2020-11-10;2;8;10;47008;42843;69;89851
04;2020-11-10;4;3;7;25509;21184;79;46693
04;2020-11-10;2;2;4;13168;7647;89;20815
04;2020-11-10;0;1;1;3209;1253;90;4462
04;2020-11-10;62;62;124;451366;408593;0;859959
05;2020-11-10;0;0;0;362.366008612902;341.338819562748;09;703.704828175651
05;2020-11-10;0;0;0;353.376145114279;370.349735405642;19;723.725880519921
05;2020-11-10;0;0;0;218.593559489256;256.539602589476;29;475.133162078732
05;2020-11-10;0;0;0;404.225408693299;360.321910454353;39;764.547319147651
05;2020-11-10;0;0;0;520.067953604221;497.108383964256;49;1017.17633756848
05;2020-11-10;0;0;0;468.146063921917;510.087601910415;59;978.233665832332
05;2020-11-10;0;0;0;340.368470050554;334.366842191253;69;674.735312241807
05;2020-11-10;0;0;0;212.598666888387;192.597753227106;79;405.196420115493
05;2020-11-10;0;0;0;148.727797095705;61.8681715431829;89;210.595968638888
05;2020-11-10;0;0;0;32.9601271090696;10.9909785719784;90;43.9511056810479
05;2020-11-10;0;0;0;3061.43020057959;2935.56979942041;0;5997
06;2020-11-10;0;1;1;42583;42380;09;84963
06;2020-11-10;4;1;5;33369;31925;19;65294
06;2020-11-10;7;4;11;21571;15080;29;36651
06;2020-11-10;6;3;9;21550;16147;39;37697
06;2020-11-10;6;2;8;14193;13939;49;28132
06;2020-11-10;4;2;6;7171;7597;59;14768
06;2020-11-10;2;1;3;3629;4117;69;7746
06;2020-11-10;2;0;2;1577;1457;79;3034
06;2020-11-10;0;0;0;531;474;89;1005
06;2020-11-10;0;0;0;88;93;90;181
06;2020-11-10;31;14;45;146262;133209;0;279471
07;2020-11-10;0;0;0;485;549;09;1034
07;2020-11-10;1;0;1;403;432;19;835
07;2020-11-10;2;0;2;764;841;29;1605
07;2020-11-10;2;0;2;824;928;39;1752
07;2020-11-10;0;0;0;788;1020;49;1808
07;2020-11-10;0;0;0;678;870;59;1548
07;2020-11-10;0;0;0;360;382;69;742
07;2020-11-10;0;0;0;231;190;79;421
07;2020-11-10;0;0;0;114;67;89;181
07;2020-11-10;0;0;0;24;11;90;35
07;2020-11-10;5;0;5;4671;5290;0;9961
08;2020-11-10;0;0;0;2715.22592983026;2997.75551488675;09;5712.98144471701
08;2020-11-10;2;0;2;2778.51901080978;3160.9156459093;19;5939.43465671908
08;2020-11-10;1;1;2;2080.8882988764;1718.16634315323;29;3799.05464202964
08;2020-11-10;0;0;0;2701.8582062647;1896.52641413317;39;4598.38462039786
08;2020-11-10;0;0;0;3151.45861023308;2460.52498233809;49;5611.98359257117
08;2020-11-10;1;1;2;2620.29868333099;2422.23566154656;59;5042.53434487755
08;2020-11-10;1;2;3;1621.44173420671;1438.58325779464;69;3060.02499200135
08;2020-11-10;0;0;0;626.575909335673;526.358467843651;79;1152.93437717932
08;2020-11-10;0;0;0;205.018522985054;140.993639349697;89;346.012162334751
08;2020-11-10;0;0;0;50.0325684687745;20.62259870351;90;70.6551671722846
08;2020-11-10;5;4;9;18551.3174743414;16782.6825256586;0;35334
11;2020-11-10;72;76;169;783071;811785;09;1594856
11;2020-11-10;333;320;676;761456;784653;19;1546109
11;2020-11-10;474;373;852;850145;801772;29;1651917
11;2020-11-10;465;385;853;914360;843488;39;1757848
11;2020-11-10;503;411;917;845609;826202;49;1671811
11;2020-11-10;421;409;835;793566;745070;59;1538636
11;2020-11-10;332;265;603;628649;549192;69;1177841
11;2020-11-10;164;178;342;434606;358356;79;792962
11;2020-11-10;154;100;254;261425;162933;89;424358
11;2020-11-10;109;43;152;89253;32619;90;121872
11;2020-11-10;3028;2563;5660;6362140;5916070;0;12278210
24;2020-11-10;14;24;40;139720;144686;09;284406
24;2020-11-10;70;88;161;152979;161185;19;314164
24;2020-11-10;79;82;161;122237;126536;29;248773
24;2020-11-10;109;73;182;150359;142009;39;292368
24;2020-11-10;117;77;195;161829;158758;49;320587
24;2020-11-10;113;80;193;172552;168011;59;340563
24;2020-11-10;78;60;138;172509;158177;69;330686
24;2020-11-10;54;46;100;129428;110593;79;240021
24;2020-11-10;59;43;102;87342;56882;89;144224
24;2020-11-10;60;12;72;31210;12071;90;43281
24;2020-11-10;754;586;1346;1320165;1238908;0;2559073
27;2020-11-10;45;37;84;143373;149679;09;293052
27;2020-11-10;142;155;298;160962;173003;19;333965
27;2020-11-10;157;147;304;133746;142254;29;276000
27;2020-11-10;157;136;293;160004;155407;39;315411
27;2020-11-10;222;140;362;172333;169564;49;341897
27;2020-11-10;201;167;368;189979;183788;59;373767
27;2020-11-10;139;119;258;192591;178206;69;370797
27;2020-11-10;109;113;222;146876;127546;79;274422
27;2020-11-10;105;62;167;96896;61575;89;158471
27;2020-11-10;79;23;102;33148;12109;90;45257
27;2020-11-10;1356;1100;2459;1429908;1353131;0;2783039
28;2020-11-10;23;26;51;180735;186856;09;367591
28;2020-11-10;82;68;151;200125;213621;19;413746
28;2020-11-10;103;68;171;168922;173007;29;341929
28;2020-11-10;112;74;186;196628;188487;39;385115
28;2020-11-10;110;82;192;205396;201699;49;407095
28;2020-11-10;107;103;210;222002;213866;59;435868
28;2020-11-10;89;79;168;224688;203758;69;428446
28;2020-11-10;63;61;124;163192;135543;79;298735
28;2020-11-10;83;44;127;109691;65377;89;175068
28;2020-11-10;48;27;75;37222;12685;90;49907
28;2020-11-10;820;632;1458;1708601;1594899;0;3303500
32;2020-11-10;58;68;126;358062;373689;09;731751
32;2020-11-10;250;233;484;387045;406742;19;793787
32;2020-11-10;276;208;486;342304;348587;29;690891
32;2020-11-10;247;231;482;382485;369972;39;752457
32;2020-11-10;261;237;502;382510;376716;49;759226
32;2020-11-10;265;244;513;386937;376527;59;763464
32;2020-11-10;222;168;391;371211;330938;69;702149
32;2020-11-10;136;150;286;250542;201459;79;452001
32;2020-11-10;156;64;220;163399;89786;89;253185
32;2020-11-10;88;19;107;48384;15367;90;63751
32;2020-11-10;1959;1622;3597;3072879;2889783;0;5962662
44;2020-11-10;44;58;102;291525;306839;09;598364
44;2020-11-10;167;198;367;320255;339504;19;659759
44;2020-11-10;214;169;383;302020;314428;29;616448
44;2020-11-10;230;167;398;342222;333292;39;675514
44;2020-11-10;244;171;417;349727;344491;49;694218
44;2020-11-10;227;215;445;381371;373239;59;754610
44;2020-11-10;187;165;353;367165;335850;69;703015
44;2020-11-10;120;119;239;250387;215436;79;465823
44;2020-11-10;147;90;237;170825;105192;89;276017
44;2020-11-10;93;37;130;51248;16731;90;67979
44;2020-11-10;1673;1389;3072;2826745;2685002;0;5511747
52;2020-11-10;30;33;64;213594;223900;09;437494
52;2020-11-10;115;101;222;240818;255197;19;496015
52;2020-11-10;105;95;200;197010;200630;29;397640
52;2020-11-10;119;96;215;231204;224885;39;456089
52;2020-11-10;118;98;216;243874;243418;49;487292
52;2020-11-10;105;107;212;244100;239116;59;483216
52;2020-11-10;89;98;187;241796;221345;69;463141
52;2020-11-10;56;68;124;177805;149903;79;327708
52;2020-11-10;77;45;122;119561;75822;89;195383
52;2020-11-10;41;14;55;42559;15260;90;57819
52;2020-11-10;855;755;1617;1952321;1849476;0;3801797
53;2020-11-10;22;20;43;173813;182358;09;356171
53;2020-11-10;56;64;121;202720;214740;19;417460
53;2020-11-10;74;71;147;163116;173196;29;336312
53;2020-11-10;69;62;131;190526;187674;39;378200
53;2020-11-10;68;54;122;212098;212015;49;424113
53;2020-11-10;68;53;121;223699;219176;59;442875
53;2020-11-10;37;53;90;227435;209274;69;436709
53;2020-11-10;30;27;57;169992;140910;79;310902
53;2020-11-10;43;27;70;118117;69883;89;188000
53;2020-11-10;40;11;52;37370;12267;90;49637
53;2020-11-10;507;442;954;1718886;1621493;0;3340379
75;2020-11-10;24;40;67;293104;305291;09;598395
75;2020-11-10;110;134;244;337141;357785;19;694926
75;2020-11-10;166;141;307;295024;300618;29;595642
75;2020-11-10;140;125;266;347871;331233;39;679104
75;2020-11-10;175;147;323;384742;372771;49;757513
75;2020-11-10;179;174;353;413361;390880;59;804241
75;2020-11-10;127;126;253;425623;384060;69;809683
75;2020-11-10;88;95;183;325086;276298;79;601384
75;2020-11-10;124;66;190;213986;139308;89;353294
75;2020-11-10;102;29;131;77600;28200;90;105800
75;2020-11-10;1237;1077;2319;3113538;2886444;0;5999982
76;2020-11-10;43;40;84;305956;318589;09;624545
76;2020-11-10;159;155;318;338942;356969;19;695911
76;2020-11-10;212;135;347;316210;319570;29;635780
76;2020-11-10;198;150;348;356758;337587;39;694345
76;2020-11-10;193;171;364;376541;363812;49;740353
76;2020-11-10;196;158;354;402608;383750;59;786358
76;2020-11-10;152;166;318;394889;358997;69;753886
76;2020-11-10;121;123;244;308664;263806;79;572470
76;2020-11-10;152;91;243;195838;129272;89;325110
76;2020-11-10;120;45;165;69372;26728;90;96100
76;2020-11-10;1550;1236;2791;3065778;2859080;0;5924858
84;2020-11-10;129;126;255;459549;481088;09;940637
84;2020-11-10;513;559;1079;487711;511905;19;999616
84;2020-11-10;550;429;979;443824;451094;29;894918
84;2020-11-10;611;418;1030;512522;493262;39;1005784
84;2020-11-10;652;518;1170;520248;515106;49;1035354
84;2020-11-10;661;548;1210;529611;514848;59;1044459
84;2020-11-10;433;444;877;486720;439940;69;926660
84;2020-11-10;351;342;693;372151;315211;79;687362
84;2020-11-10;343;230;574;237198;150524;89;387722
84;2020-11-10;294;92;386;81185;28680;90;109865
84;2020-11-10;4539;3706;8256;4130719;3901658;0;8032377
93;2020-11-10;35;42;77;268834;283093;09;551927
93;2020-11-10;175;162;340;280751;296087;19;576838
93;2020-11-10;205;187;392;254404;255552;29;509956
93;2020-11-10;267;192;459;310704;288398;39;599102
93;2020-11-10;259;214;473;325559;305827;49;631386
93;2020-11-10;285;212;497;353104;325389;59;678493
93;2020-11-10;182;180;362;336327;296459;69;632786
93;2020-11-10;148;168;316;279820;229699;79;509519
93;2020-11-10;143;94;237;171274;113716;89;284990
93;2020-11-10;105;36;141;58896;21758;90;80654
93;2020-11-10;1807;1488;3298;2639673;2415978;0;5055651
94;2020-11-10;1;1;2;16311;17433;09;33744
94;2020-11-10;0;4;4;16679;18132;19;34811
94;2020-11-10;3;3;6;16782;16579;29;33361
94;2020-11-10;5;7;12;23044;20580;39;43624
94;2020-11-10;10;6;16;23065;22140;49;45205
94;2020-11-10;7;4;11;24549;23421;59;47970
94;2020-11-10;6;10;16;23212;21883;69;45095
94;2020-11-10;7;8;15;19544;17141;79;36685
94;2020-11-10;3;2;5;11227;8178;89;19405
94;2020-11-10;1;1;2;3332;1447;90;4779
94;2020-11-10;43;46;89;177745;166934;0;344679
01;2020-11-11;0;0;0;19979;20155;09;40134
01;2020-11-11;0;0;0;24994;25489;19;50483
01;2020-11-11;0;1;1;17868;16690;29;34558
01;2020-11-11;2;0;2;22328;14821;39;37149
01;2020-11-11;0;1;1;28652;20276;49;48928
01;2020-11-11;1;0;1;33264;27260;59;60524
01;2020-11-11;1;0;1;27135;23978;69;51113
01;2020-11-11;2;0;2;18401;14661;79;33062
01;2020-11-11;0;0;0;9633;6375;89;16008
01;2020-11-11;0;0;0;3410;1510;90;4920
01;2020-11-11;6;2;8;205664;171215;0;376879
02;2020-11-11;0;0;0;16881;17110;09;33991
02;2020-11-11;0;1;1;21410;21604;19;43014
02;2020-11-11;0;0;0;16017;15479;29;31496
02;2020-11-11;0;1;1;19825;14455;39;34280
02;2020-11-11;0;1;1;24719;18248;49;42967
02;2020-11-11;0;0;0;34361;28310;59;62671
02;2020-11-11;1;0;1;28061;24495;69;52556
02;2020-11-11;0;2;2;18231;15278;79;33509
02;2020-11-11;0;0;0;11090;7677;89;18767
02;2020-11-11;0;0;0;3992;1506;90;5498
02;2020-11-11;1;5;6;194587;164162;0;358749
03;2020-11-11;1;0;1;31123;30920;09;62043
03;2020-11-11;3;0;3;29370;29268;19;58638
03;2020-11-11;0;0;0;21458;18963;29;40421
03;2020-11-11;0;0;0;21276;18326;39;39602
03;2020-11-11;1;1;2;18164;16593;49;34757
03;2020-11-11;1;0;1;13469;13557;59;27026
03;2020-11-11;0;0;0;8776;8670;69;17446
03;2020-11-11;0;0;0;3777;3591;79;7368
03;2020-11-11;0;0;0;1649;1072;89;2721
03;2020-11-11;0;0;0;485;184;90;669
03;2020-11-11;6;1;7;149547;141144;0;290691
04;2020-11-11;0;0;0;60314;61377;09;121691
04;2020-11-11;2;1;3;66065;68387;19;134452
04;2020-11-11;5;2;7;51059;47156;29;98215
04;2020-11-11;3;0;3;58788;45780;39;104568
04;2020-11-11;1;1;2;61408;52207;49;113615
04;2020-11-11;1;3;4;64838;60759;59;125597
04;2020-11-11;0;0;0;47008;42843;69;89851
04;2020-11-11;2;1;3;25509;21184;79;46693
04;2020-11-11;0;1;1;13168;7647;89;20815
04;2020-11-11;0;0;0;3209;1253;90;4462
04;2020-11-11;14;9;23;451366;408593;0;859959
05;2020-11-11;0;0;0;362.366008612902;341.338819562748;09;703.704828175651
05;2020-11-11;0;0;0;353.376145114279;370.349735405642;19;723.725880519921
05;2020-11-11;0;0;0;218.593559489256;256.539602589476;29;475.133162078732
05;2020-11-11;0;0;0;404.225408693299;360.321910454353;39;764.547319147651
05;2020-11-11;0;0;0;520.067953604221;497.108383964256;49;1017.17633756848
05;2020-11-11;0;0;0;468.146063921917;510.087601910415;59;978.233665832332
05;2020-11-11;0;0;0;340.368470050554;334.366842191253;69;674.735312241807
05;2020-11-11;0;0;0;212.598666888387;192.597753227106;79;405.196420115493
05;2020-11-11;0;0;0;148.727797095705;61.8681715431829;89;210.595968638888
05;2020-11-11;0;0;0;32.9601271090696;10.9909785719784;90;43.9511056810479
05;2020-11-11;0;0;0;3061.43020057959;2935.56979942041;0;5997
06;2020-11-11;0;0;0;42583;42380;09;84963
06;2020-11-11;1;0;1;33369;31925;19;65294
06;2020-11-11;1;3;4;21571;15080;29;36651
06;2020-11-11;3;3;6;21550;16147;39;37697
06;2020-11-11;2;2;4;14193;13939;49;28132
06;2020-11-11;2;0;2;7171;7597;59;14768
06;2020-11-11;0;0;0;3629;4117;69;7746
06;2020-11-11;0;0;0;1577;1457;79;3034
06;2020-11-11;0;0;0;531;474;89;1005
06;2020-11-11;0;0;0;88;93;90;181
06;2020-11-11;9;8;17;146262;133209;0;279471
07;2020-11-11;0;0;0;485;549;09;1034
07;2020-11-11;0;0;0;403;432;19;835
07;2020-11-11;0;0;0;764;841;29;1605
07;2020-11-11;0;0;0;824;928;39;1752
07;2020-11-11;0;0;0;788;1020;49;1808
07;2020-11-11;0;0;0;678;870;59;1548
07;2020-11-11;0;0;0;360;382;69;742
07;2020-11-11;0;0;0;231;190;79;421
07;2020-11-11;0;0;0;114;67;89;181
07;2020-11-11;0;0;0;24;11;90;35
07;2020-11-11;0;0;0;4671;5290;0;9961
08;2020-11-11;0;0;0;2715.22592983026;2997.75551488675;09;5712.98144471701
08;2020-11-11;0;0;0;2778.51901080978;3160.9156459093;19;5939.43465671908
08;2020-11-11;0;0;0;2080.8882988764;1718.16634315323;29;3799.05464202964
08;2020-11-11;0;0;0;2701.8582062647;1896.52641413317;39;4598.38462039786
08;2020-11-11;0;0;0;3151.45861023308;2460.52498233809;49;5611.98359257117
08;2020-11-11;0;0;0;2620.29868333099;2422.23566154656;59;5042.53434487755
08;2020-11-11;0;0;0;1621.44173420671;1438.58325779464;69;3060.02499200135
08;2020-11-11;0;0;0;626.575909335673;526.358467843651;79;1152.93437717932
08;2020-11-11;0;0;0;205.018522985054;140.993639349697;89;346.012162334751
08;2020-11-11;0;0;0;50.0325684687745;20.62259870351;90;70.6551671722846
08;2020-11-11;0;0;0;18551.3174743414;16782.6825256586;0;35334
11;2020-11-11;13;5;22;783071;811785;09;1594856
11;2020-11-11;65;59;125;761456;784653;19;1546109
11;2020-11-11;71;68;140;850145;801772;29;1651917
11;2020-11-11;75;72;147;914360;843488;39;1757848
11;2020-11-11;91;54;145;845609;826202;49;1671811
11;2020-11-11;62;61;123;793566;745070;59;1538636
11;2020-11-11;48;55;103;628649;549192;69;1177841
11;2020-11-11;36;38;74;434606;358356;79;792962
11;2020-11-11;33;37;70;261425;162933;89;424358
11;2020-11-11;25;16;41;89253;32619;90;121872
11;2020-11-11;519;465;990;6362140;5916070;0;12278210
24;2020-11-11;1;1;2;139720;144686;09;284406
24;2020-11-11;15;12;27;152979;161185;19;314164
24;2020-11-11;21;15;36;122237;126536;29;248773
24;2020-11-11;21;16;37;150359;142009;39;292368
24;2020-11-11;36;16;52;161829;158758;49;320587
24;2020-11-11;23;15;38;172552;168011;59;340563
24;2020-11-11;14;13;28;172509;158177;69;330686
24;2020-11-11;22;12;34;129428;110593;79;240021
24;2020-11-11;18;6;24;87342;56882;89;144224
24;2020-11-11;16;6;22;31210;12071;90;43281
24;2020-11-11;187;113;301;1320165;1238908;0;2559073
27;2020-11-11;3;2;5;143373;149679;09;293052
27;2020-11-11;7;12;19;160962;173003;19;333965
27;2020-11-11;19;14;33;133746;142254;29;276000
27;2020-11-11;11;15;26;160004;155407;39;315411
27;2020-11-11;12;11;23;172333;169564;49;341897
27;2020-11-11;12;21;33;189979;183788;59;373767
27;2020-11-11;19;9;28;192591;178206;69;370797
27;2020-11-11;12;12;24;146876;127546;79;274422
27;2020-11-11;18;13;31;96896;61575;89;158471
27;2020-11-11;12;8;20;33148;12109;90;45257
27;2020-11-11;125;117;242;1429908;1353131;0;2783039
28;2020-11-11;5;8;13;180735;186856;09;367591
28;2020-11-11;12;17;29;200125;213621;19;413746
28;2020-11-11;20;20;40;168922;173007;29;341929
28;2020-11-11;14;9;23;196628;188487;39;385115
28;2020-11-11;18;19;37;205396;201699;49;407095
28;2020-11-11;18;18;36;222002;213866;59;435868
28;2020-11-11;11;12;23;224688;203758;69;428446
28;2020-11-11;6;14;20;163192;135543;79;298735
28;2020-11-11;17;14;31;109691;65377;89;175068
28;2020-11-11;17;1;18;37222;12685;90;49907
28;2020-11-11;138;132;270;1708601;1594899;0;3303500
32;2020-11-11;23;11;34;358062;373689;09;731751
32;2020-11-11;54;50;104;387045;406742;19;793787
32;2020-11-11;70;61;132;342304;348587;29;690891
32;2020-11-11;65;40;105;382485;369972;39;752457
32;2020-11-11;65;64;130;382510;376716;49;759226
32;2020-11-11;45;43;89;386937;376527;59;763464
32;2020-11-11;40;18;58;371211;330938;69;702149
32;2020-11-11;17;28;45;250542;201459;79;452001
32;2020-11-11;28;16;47;163399;89786;89;253185
32;2020-11-11;15;5;21;48384;15367;90;63751
32;2020-11-11;422;336;765;3072879;2889783;0;5962662
44;2020-11-11;2;4;6;291525;306839;09;598364
44;2020-11-11;10;6;16;320255;339504;19;659759
44;2020-11-11;13;13;26;302020;314428;29;616448
44;2020-11-11;13;11;24;342222;333292;39;675514
44;2020-11-11;16;12;28;349727;344491;49;694218
44;2020-11-11;11;9;20;381371;373239;59;754610
44;2020-11-11;16;6;22;367165;335850;69;703015
44;2020-11-11;13;9;22;250387;215436;79;465823
44;2020-11-11;24;15;40;170825;105192;89;276017
44;2020-11-11;13;4;17;51248;16731;90;67979
44;2020-11-11;131;89;221;2826745;2685002;0;5511747
52;2020-11-11;7;5;12;213594;223900;09;437494
52;2020-11-11;12;13;26;240818;255197;19;496015
52;2020-11-11;30;15;45;197010;200630;29;397640
52;2020-11-11;30;21;51;231204;224885;39;456089
52;2020-11-11;26;17;43;243874;243418;49;487292
52;2020-11-11;20;24;44;244100;239116;59;483216
52;2020-11-11;10;10;20;241796;221345;69;463141
52;2020-11-11;9;8;17;177805;149903;79;327708
52;2020-11-11;10;7;17;119561;75822;89;195383
52;2020-11-11;6;3;9;42559;15260;90;57819
52;2020-11-11;160;123;284;1952321;1849476;0;3801797
53;2020-11-11;2;0;2;173813;182358;09;356171
53;2020-11-11;8;5;13;202720;214740;19;417460
53;2020-11-11;14;12;26;163116;173196;29;336312
53;2020-11-11;11;14;25;190526;187674;39;378200
53;2020-11-11;17;11;28;212098;212015;49;424113
53;2020-11-11;8;12;20;223699;219176;59;442875
53;2020-11-11;6;4;10;227435;209274;69;436709
53;2020-11-11;7;4;11;169992;140910;79;310902
53;2020-11-11;6;10;16;118117;69883;89;188000
53;2020-11-11;2;3;5;37370;12267;90;49637
53;2020-11-11;81;75;156;1718886;1621493;0;3340379
75;2020-11-11;5;4;9;293104;305291;09;598395
75;2020-11-11;18;12;30;337141;357785;19;694926
75;2020-11-11;34;17;51;295024;300618;29;595642
75;2020-11-11;20;16;36;347871;331233;39;679104
75;2020-11-11;21;15;36;384742;372771;49;757513
75;2020-11-11;12;16;28;413361;390880;59;804241
75;2020-11-11;12;8;20;425623;384060;69;809683
75;2020-11-11;9;13;22;325086;276298;79;601384
75;2020-11-11;13;12;25;213986;139308;89;353294
75;2020-11-11;9;3;12;77600;28200;90;105800
75;2020-11-11;153;116;269;3113538;2886444;0;5999982
76;2020-11-11;7;8;16;305956;318589;09;624545
76;2020-11-11;14;26;41;338942;356969;19;695911
76;2020-11-11;28;20;49;316210;319570;29;635780
76;2020-11-11;22;13;35;356758;337587;39;694345
76;2020-11-11;23;17;40;376541;363812;49;740353
76;2020-11-11;21;23;44;402608;383750;59;786358
76;2020-11-11;14;19;33;394889;358997;69;753886
76;2020-11-11;14;13;27;308664;263806;79;572470
76;2020-11-11;24;8;32;195838;129272;89;325110
76;2020-11-11;12;9;21;69372;26728;90;96100
76;2020-11-11;179;156;338;3065778;2859080;0;5924858
84;2020-11-11;17;14;31;459549;481088;09;940637
84;2020-11-11;51;50;105;487711;511905;19;999616
84;2020-11-11;66;58;124;443824;451094;29;894918
84;2020-11-11;83;62;145;512522;493262;39;1005784
84;2020-11-11;58;72;130;520248;515106;49;1035354
84;2020-11-11;50;58;109;529611;514848;59;1044459
84;2020-11-11;51;56;107;486720;439940;69;926660
84;2020-11-11;50;53;104;372151;315211;79;687362
84;2020-11-11;101;44;145;237198;150524;89;387722
84;2020-11-11;53;33;86;81185;28680;90;109865
84;2020-11-11;580;500;1086;4130719;3901658;0;8032377
93;2020-11-11;8;3;11;268834;283093;09;551927
93;2020-11-11;14;22;36;280751;296087;19;576838
93;2020-11-11;21;19;40;254404;255552;29;509956
93;2020-11-11;27;24;51;310704;288398;39;599102
93;2020-11-11;22;24;46;325559;305827;49;631386
93;2020-11-11;25;19;44;353104;325389;59;678493
93;2020-11-11;15;17;32;336327;296459;69;632786
93;2020-11-11;20;24;44;279820;229699;79;509519
93;2020-11-11;21;21;42;171274;113716;89;284990
93;2020-11-11;14;14;28;58896;21758;90;80654
93;2020-11-11;187;187;374;2639673;2415978;0;5055651
94;2020-11-11;0;0;0;16311;17433;09;33744
94;2020-11-11;0;0;0;16679;18132;19;34811
94;2020-11-11;0;0;0;16782;16579;29;33361
94;2020-11-11;1;0;1;23044;20580;39;43624
94;2020-11-11;0;0;0;23065;22140;49;45205
94;2020-11-11;0;1;1;24549;23421;59;47970
94;2020-11-11;0;1;1;23212;21883;69;45095
94;2020-11-11;0;0;0;19544;17141;79;36685
94;2020-11-11;1;2;3;11227;8178;89;19405
94;2020-11-11;0;0;0;3332;1447;90;4779
94;2020-11-11;2;4;6;177745;166934;0;344679
01;2020-11-12;0;0;0;19979;20155;09;40134
01;2020-11-12;5;1;6;24994;25489;19;50483
01;2020-11-12;0;2;2;17868;16690;29;34558
01;2020-11-12;2;2;4;22328;14821;39;37149
01;2020-11-12;1;2;3;28652;20276;49;48928
01;2020-11-12;4;0;4;33264;27260;59;60524
01;2020-11-12;3;4;7;27135;23978;69;51113
01;2020-11-12;1;1;2;18401;14661;79;33062
01;2020-11-12;0;0;0;9633;6375;89;16008
01;2020-11-12;0;0;0;3410;1510;90;4920
01;2020-11-12;16;12;28;205664;171215;0;376879
02;2020-11-12;1;1;2;16881;17110;09;33991
02;2020-11-12;9;5;14;21410;21604;19;43014
02;2020-11-12;9;3;12;16017;15479;29;31496
02;2020-11-12;2;5;7;19825;14455;39;34280
02;2020-11-12;10;4;14;24719;18248;49;42967
02;2020-11-12;5;8;13;34361;28310;59;62671
02;2020-11-12;5;3;8;28061;24495;69;52556
02;2020-11-12;2;2;4;18231;15278;79;33509
02;2020-11-12;0;2;2;11090;7677;89;18767
02;2020-11-12;0;0;0;3992;1506;90;5498
02;2020-11-12;43;33;76;194587;164162;0;358749
03;2020-11-12;0;3;3;31123;30920;09;62043
03;2020-11-12;2;4;6;29370;29268;19;58638
03;2020-11-12;8;0;8;21458;18963;29;40421
03;2020-11-12;5;9;14;21276;18326;39;39602
03;2020-11-12;1;6;7;18164;16593;49;34757
03;2020-11-12;2;3;5;13469;13557;59;27026
03;2020-11-12;1;0;1;8776;8670;69;17446
03;2020-11-12;0;1;1;3777;3591;79;7368
03;2020-11-12;0;0;0;1649;1072;89;2721
03;2020-11-12;0;0;0;485;184;90;669
03;2020-11-12;19;26;45;149547;141144;0;290691
04;2020-11-12;0;2;2;60314;61377;09;121691
04;2020-11-12;11;13;24;66065;68387;19;134452
04;2020-11-12;8;11;19;51059;47156;29;98215
04;2020-11-12;7;10;17;58788;45780;39;104568
04;2020-11-12;15;5;20;61408;52207;49;113615
04;2020-11-12;13;10;23;64838;60759;59;125597
04;2020-11-12;9;5;14;47008;42843;69;89851
04;2020-11-12;1;2;3;25509;21184;79;46693
04;2020-11-12;0;0;0;13168;7647;89;20815
04;2020-11-12;0;0;0;3209;1253;90;4462
04;2020-11-12;64;58;122;451366;408593;0;859959
05;2020-11-12;0;0;0;362.366008612902;341.338819562748;09;703.704828175651
05;2020-11-12;0;0;0;353.376145114279;370.349735405642;19;723.725880519921
05;2020-11-12;0;0;0;218.593559489256;256.539602589476;29;475.133162078732
05;2020-11-12;0;0;0;404.225408693299;360.321910454353;39;764.547319147651
05;2020-11-12;0;0;0;520.067953604221;497.108383964256;49;1017.17633756848
05;2020-11-12;0;0;0;468.146063921917;510.087601910415;59;978.233665832332
05;2020-11-12;0;0;0;340.368470050554;334.366842191253;69;674.735312241807
05;2020-11-12;0;0;0;212.598666888387;192.597753227106;79;405.196420115493
05;2020-11-12;0;0;0;148.727797095705;61.8681715431829;89;210.595968638888
05;2020-11-12;0;0;0;32.9601271090696;10.9909785719784;90;43.9511056810479
05;2020-11-12;0;0;0;3061.43020057959;2935.56979942041;0;5997
06;2020-11-12;0;0;0;42583;42380;09;84963
06;2020-11-12;0;1;1;33369;31925;19;65294
06;2020-11-12;7;7;14;21571;15080;29;36651
06;2020-11-12;5;4;9;21550;16147;39;37697
06;2020-11-12;4;3;7;14193;13939;49;28132
06;2020-11-12;2;4;6;7171;7597;59;14768
06;2020-11-12;1;0;1;3629;4117;69;7746
06;2020-11-12;0;0;0;1577;1457;79;3034
06;2020-11-12;0;0;0;531;474;89;1005
06;2020-11-12;0;0;0;88;93;90;181
06;2020-11-12;19;19;38;146262;133209;0;279471
07;2020-11-12;0;0;0;485;549;09;1034
07;2020-11-12;0;0;0;403;432;19;835
07;2020-11-12;0;0;0;764;841;29;1605
07;2020-11-12;1;1;2;824;928;39;1752
07;2020-11-12;0;1;1;788;1020;49;1808
07;2020-11-12;0;0;0;678;870;59;1548
07;2020-11-12;0;1;1;360;382;69;742
07;2020-11-12;0;0;0;231;190;79;421
07;2020-11-12;0;0;0;114;67;89;181
07;2020-11-12;0;0;0;24;11;90;35
07;2020-11-12;1;3;4;4671;5290;0;9961
08;2020-11-12;0;0;0;2715.22592983026;2997.75551488675;09;5712.98144471701
08;2020-11-12;2;0;2;2778.51901080978;3160.9156459093;19;5939.43465671908
08;2020-11-12;1;1;2;2080.8882988764;1718.16634315323;29;3799.05464202964
08;2020-11-12;2;0;2;2701.8582062647;1896.52641413317;39;4598.38462039786
08;2020-11-12;0;0;0;3151.45861023308;2460.52498233809;49;5611.98359257117
08;2020-11-12;1;2;3;2620.29868333099;2422.23566154656;59;5042.53434487755
08;2020-11-12;0;0;0;1621.44173420671;1438.58325779464;69;3060.02499200135
08;2020-11-12;0;0;0;626.575909335673;526.358467843651;79;1152.93437717932
08;2020-11-12;0;0;0;205.018522985054;140.993639349697;89;346.012162334751
08;2020-11-12;0;0;0;50.0325684687745;20.62259870351;90;70.6551671722846
08;2020-11-12;6;3;9;18551.3174743414;16782.6825256586;0;35334
11;2020-11-12;104;95;210;783071;811785;09;1594856
11;2020-11-12;374;325;723;761456;784653;19;1546109
11;2020-11-12;485;347;833;850145;801772;29;1651917
11;2020-11-12;489;405;895;914360;843488;39;1757848
11;2020-11-12;454;391;847;845609;826202;49;1671811
11;2020-11-12;444;377;828;793566;745070;59;1538636
11;2020-11-12;309;272;589;628649;549192;69;1177841
11;2020-11-12;149;169;318;434606;358356;79;792962
11;2020-11-12;143;70;214;261425;162933;89;424358
11;2020-11-12;108;24;132;89253;32619;90;121872
11;2020-11-12;3061;2479;5597;6362140;5916070;0;12278210
24;2020-11-12;10;9;19;139720;144686;09;284406
24;2020-11-12;79;104;183;152979;161185;19;314164
24;2020-11-12;88;62;150;122237;126536;29;248773
24;2020-11-12;86;64;150;150359;142009;39;292368
24;2020-11-12;101;59;160;161829;158758;49;320587
24;2020-11-12;86;78;164;172552;168011;59;340563
24;2020-11-12;77;56;133;172509;158177;69;330686
24;2020-11-12;35;42;77;129428;110593;79;240021
24;2020-11-12;69;32;101;87342;56882;89;144224
24;2020-11-12;58;16;74;31210;12071;90;43281
24;2020-11-12;690;522;1212;1320165;1238908;0;2559073
27;2020-11-12;45;42;87;143373;149679;09;293052
27;2020-11-12;157;154;312;160962;173003;19;333965
27;2020-11-12;139;122;261;133746;142254;29;276000
27;2020-11-12;159;131;290;160004;155407;39;315411
27;2020-11-12;151;144;295;172333;169564;49;341897
27;2020-11-12;167;148;315;189979;183788;59;373767
27;2020-11-12;124;102;226;192591;178206;69;370797
27;2020-11-12;92;81;173;146876;127546;79;274422
27;2020-11-12;88;67;155;96896;61575;89;158471
27;2020-11-12;75;22;97;33148;12109;90;45257
27;2020-11-12;1198;1013;2212;1429908;1353131;0;2783039
28;2020-11-12;21;32;55;180735;186856;09;367591
28;2020-11-12;86;62;153;200125;213621;19;413746
28;2020-11-12;104;69;173;168922;173007;29;341929
28;2020-11-12;101;64;165;196628;188487;39;385115
28;2020-11-12;118;85;203;205396;201699;49;407095
28;2020-11-12;98;83;181;222002;213866;59;435868
28;2020-11-12;70;76;147;224688;203758;69;428446
28;2020-11-12;53;60;113;163192;135543;79;298735
28;2020-11-12;72;35;108;109691;65377;89;175068
28;2020-11-12;44;17;61;37222;12685;90;49907
28;2020-11-12;767;583;1359;1708601;1594899;0;3303500
32;2020-11-12;77;91;170;358062;373689;09;731751
32;2020-11-12;291;264;555;387045;406742;19;793787
32;2020-11-12;294;226;520;342304;348587;29;690891
32;2020-11-12;305;217;523;382485;369972;39;752457
32;2020-11-12;296;231;528;382510;376716;49;759226
32;2020-11-12;300;239;540;386937;376527;59;763464
32;2020-11-12;184;196;380;371211;330938;69;702149
32;2020-11-12;128;111;239;250542;201459;79;452001
32;2020-11-12;151;70;221;163399;89786;89;253185
32;2020-11-12;75;18;93;48384;15367;90;63751
32;2020-11-12;2101;1664;3770;3072879;2889783;0;5962662
44;2020-11-12;62;62;124;291525;306839;09;598364
44;2020-11-12;243;200;444;320255;339504;19;659759
44;2020-11-12;237;192;432;302020;314428;29;616448
44;2020-11-12;248;183;432;342222;333292;39;675514
44;2020-11-12;300;201;502;349727;344491;49;694218
44;2020-11-12;259;222;482;381371;373239;59;754610
44;2020-11-12;144;139;287;367165;335850;69;703015
44;2020-11-12;112;121;234;250387;215436;79;465823
44;2020-11-12;174;96;271;170825;105192;89;276017
44;2020-11-12;92;37;130;51248;16731;90;67979
44;2020-11-12;1871;1453;3338;2826745;2685002;0;5511747
52;2020-11-12;36;36;72;213594;223900;09;437494
52;2020-11-12;120;112;232;240818;255197;19;496015
52;2020-11-12;103;72;175;197010;200630;29;397640
52;2020-11-12;115;96;211;231204;224885;39;456089
52;2020-11-12;117;87;204;243874;243418;49;487292
52;2020-11-12;125;119;244;244100;239116;59;483216
52;2020-11-12;82;80;162;241796;221345;69;463141
52;2020-11-12;55;57;112;177805;149903;79;327708
52;2020-11-12;77;44;121;119561;75822;89;195383
52;2020-11-12;62;19;81;42559;15260;90;57819
52;2020-11-12;892;723;1615;1952321;1849476;0;3801797
53;2020-11-12;17;33;51;173813;182358;09;356171
53;2020-11-12;59;66;130;202720;214740;19;417460
53;2020-11-12;65;55;124;163116;173196;29;336312
53;2020-11-12;46;44;90;190526;187674;39;378200
53;2020-11-12;67;57;124;212098;212015;49;424113
53;2020-11-12;51;48;99;223699;219176;59;442875
53;2020-11-12;37;51;88;227435;209274;69;436709
53;2020-11-12;32;28;60;169992;140910;79;310902
53;2020-11-12;39;20;59;118117;69883;89;188000
53;2020-11-12;34;8;42;37370;12267;90;49637
53;2020-11-12;448;410;868;1718886;1621493;0;3340379
75;2020-11-12;39;38;79;293104;305291;09;598395
75;2020-11-12;140;121;265;337141;357785;19;694926
75;2020-11-12;153;135;289;295024;300618;29;595642
75;2020-11-12;170;136;306;347871;331233;39;679104
75;2020-11-12;201;169;370;384742;372771;49;757513
75;2020-11-12;185;169;354;413361;390880;59;804241
75;2020-11-12;119;127;246;425623;384060;69;809683
75;2020-11-12;101;92;193;325086;276298;79;601384
75;2020-11-12;120;87;207;213986;139308;89;353294
75;2020-11-12;109;33;142;77600;28200;90;105800
75;2020-11-12;1337;1107;2451;3113538;2886444;0;5999982
76;2020-11-12;37;35;73;305956;318589;09;624545
76;2020-11-12;176;167;348;338942;356969;19;695911
76;2020-11-12;176;135;311;316210;319570;29;635780
76;2020-11-12;155;154;309;356758;337587;39;694345
76;2020-11-12;220;175;395;376541;363812;49;740353
76;2020-11-12;213;160;373;402608;383750;59;786358
76;2020-11-12;138;136;274;394889;358997;69;753886
76;2020-11-12;109;99;208;308664;263806;79;572470
76;2020-11-12;157;85;242;195838;129272;89;325110
76;2020-11-12;141;48;190;69372;26728;90;96100
76;2020-11-12;1524;1198;2729;3065778;2859080;0;5924858
84;2020-11-12;116;107;224;459549;481088;09;940637
84;2020-11-12;563;564;1134;487711;511905;19;999616
84;2020-11-12;546;435;981;443824;451094;29;894918
84;2020-11-12;564;418;982;512522;493262;39;1005784
84;2020-11-12;580;489;1069;520248;515106;49;1035354
84;2020-11-12;654;556;1211;529611;514848;59;1044459
84;2020-11-12;354;341;695;486720;439940;69;926660
84;2020-11-12;273;315;588;372151;315211;79;687362
84;2020-11-12;362;210;572;237198;150524;89;387722
84;2020-11-12;338;81;420;81185;28680;90;109865
84;2020-11-12;4351;3516;7877;4130719;3901658;0;8032377
93;2020-11-12;36;52;88;268834;283093;09;551927
93;2020-11-12;167;141;308;280751;296087;19;576838
93;2020-11-12;213;142;355;254404;255552;29;509956
93;2020-11-12;220;185;405;310704;288398;39;599102
93;2020-11-12;248;179;428;325559;305827;49;631386
93;2020-11-12;266;209;475;353104;325389;59;678493
93;2020-11-12;144;160;304;336327;296459;69;632786
93;2020-11-12;138;127;265;279820;229699;79;509519
93;2020-11-12;145;73;218;171274;113716;89;284990
93;2020-11-12;109;24;133;58896;21758;90;80654
93;2020-11-12;1687;1294;2982;2639673;2415978;0;5055651
94;2020-11-12;3;1;4;16311;17433;09;33744
94;2020-11-12;6;6;12;16679;18132;19;34811
94;2020-11-12;6;4;10;16782;16579;29;33361
94;2020-11-12;10;3;13;23044;20580;39;43624
94;2020-11-12;11;3;14;23065;22140;49;45205
94;2020-11-12;5;8;13;24549;23421;59;47970
94;2020-11-12;11;8;19;23212;21883;69;45095
94;2020-11-12;3;5;8;19544;17141;79;36685
94;2020-11-12;3;3;6;11227;8178;89;19405
94;2020-11-12;3;1;4;3332;1447;90;4779
94;2020-11-12;61;42;103;177745;166934;0;344679
01;2020-11-13;0;1;1;19979;20155;09;40134
01;2020-11-13;1;2;3;24994;25489;19;50483
01;2020-11-13;1;1;2;17868;16690;29;34558
01;2020-11-13;0;2;2;22328;14821;39;37149
01;2020-11-13;2;0;2;28652;20276;49;48928
01;2020-11-13;0;2;2;33264;27260;59;60524
01;2020-11-13;0;0;0;27135;23978;69;51113
01;2020-11-13;1;2;3;18401;14661;79;33062
01;2020-11-13;1;0;1;9633;6375;89;16008
01;2020-11-13;0;0;0;3410;1510;90;4920
01;2020-11-13;6;10;16;205664;171215;0;376879
02;2020-11-13;0;0;0;16881;17110;09;33991
02;2020-11-13;5;6;11;21410;21604;19;43014
02;2020-11-13;5;5;10;16017;15479;29;31496
02;2020-11-13;6;3;9;19825;14455;39;34280
02;2020-11-13;6;3;9;24719;18248;49;42967
02;2020-11-13;9;8;17;34361;28310;59;62671
02;2020-11-13;4;3;7;28061;24495;69;52556
02;2020-11-13;4;0;4;18231;15278;79;33509
02;2020-11-13;1;0;1;11090;7677;89;18767
02;2020-11-13;0;0;0;3992;1506;90;5498
02;2020-11-13;40;28;68;194587;164162;0;358749
03;2020-11-13;1;0;1;31123;30920;09;62043
03;2020-11-13;2;1;3;29370;29268;19;58638
03;2020-11-13;1;1;2;21458;18963;29;40421
03;2020-11-13;5;2;7;21276;18326;39;39602
03;2020-11-13;2;2;4;18164;16593;49;34757
03;2020-11-13;0;2;2;13469;13557;59;27026
03;2020-11-13;2;1;3;8776;8670;69;17446
03;2020-11-13;0;0;0;3777;3591;79;7368
03;2020-11-13;0;0;0;1649;1072;89;2721
03;2020-11-13;0;0;0;485;184;90;669
03;2020-11-13;13;9;22;149547;141144;0;290691
04;2020-11-13;2;2;4;60314;61377;09;121691
04;2020-11-13;7;4;11;66065;68387;19;134452
04;2020-11-13;10;10;20;51059;47156;29;98215
04;2020-11-13;8;7;15;58788;45780;39;104568
04;2020-11-13;18;6;24;61408;52207;49;113615
04;2020-11-13;9;7;16;64838;60759;59;125597
04;2020-11-13;6;8;14;47008;42843;69;89851
04;2020-11-13;3;1;4;25509;21184;79;46693
04;2020-11-13;2;2;4;13168;7647;89;20815
04;2020-11-13;0;0;0;3209;1253;90;4462
04;2020-11-13;65;47;112;451366;408593;0;859959
05;2020-11-13;0;0;0;362.366008612902;341.338819562748;09;703.704828175651
05;2020-11-13;0;0;0;353.376145114279;370.349735405642;19;723.725880519921
05;2020-11-13;0;0;0;218.593559489256;256.539602589476;29;475.133162078732
05;2020-11-13;0;0;0;404.225408693299;360.321910454353;39;764.547319147651
05;2020-11-13;0;0;0;520.067953604221;497.108383964256;49;1017.17633756848
05;2020-11-13;0;0;0;468.146063921917;510.087601910415;59;978.233665832332
05;2020-11-13;0;0;0;340.368470050554;334.366842191253;69;674.735312241807
05;2020-11-13;0;0;0;212.598666888387;192.597753227106;79;405.196420115493
05;2020-11-13;0;0;0;148.727797095705;61.8681715431829;89;210.595968638888
05;2020-11-13;0;0;0;32.9601271090696;10.9909785719784;90;43.9511056810479
05;2020-11-13;0;0;0;3061.43020057959;2935.56979942041;0;5997
06;2020-11-13;0;0;0;42583;42380;09;84963
06;2020-11-13;4;4;8;33369;31925;19;65294
06;2020-11-13;5;2;7;21571;15080;29;36651
06;2020-11-13;7;4;11;21550;16147;39;37697
06;2020-11-13;3;4;7;14193;13939;49;28132
06;2020-11-13;3;3;6;7171;7597;59;14768
06;2020-11-13;1;2;3;3629;4117;69;7746
06;2020-11-13;0;1;1;1577;1457;79;3034
06;2020-11-13;0;0;0;531;474;89;1005
06;2020-11-13;0;0;0;88;93;90;181
06;2020-11-13;23;20;43;146262;133209;0;279471
07;2020-11-13;0;0;0;485;549;09;1034
07;2020-11-13;0;0;0;403;432;19;835
07;2020-11-13;1;0;1;764;841;29;1605
07;2020-11-13;2;1;3;824;928;39;1752
07;2020-11-13;0;0;0;788;1020;49;1808
07;2020-11-13;2;3;5;678;870;59;1548
07;2020-11-13;0;0;0;360;382;69;742
07;2020-11-13;0;0;0;231;190;79;421
07;2020-11-13;0;0;0;114;67;89;181
07;2020-11-13;0;0;0;24;11;90;35
07;2020-11-13;5;4;9;4671;5290;0;9961
08;2020-11-13;0;0;0;2715.22592983026;2997.75551488675;09;5712.98144471701
08;2020-11-13;0;0;0;2778.51901080978;3160.9156459093;19;5939.43465671908
08;2020-11-13;0;2;2;2080.8882988764;1718.16634315323;29;3799.05464202964
08;2020-11-13;0;0;0;2701.8582062647;1896.52641413317;39;4598.38462039786
08;2020-11-13;0;0;0;3151.45861023308;2460.52498233809;49;5611.98359257117
08;2020-11-13;1;1;2;2620.29868333099;2422.23566154656;59;5042.53434487755
08;2020-11-13;0;1;1;1621.44173420671;1438.58325779464;69;3060.02499200135
08;2020-11-13;0;0;0;626.575909335673;526.358467843651;79;1152.93437717932
08;2020-11-13;0;0;0;205.018522985054;140.993639349697;89;346.012162334751
08;2020-11-13;0;0;0;50.0325684687745;20.62259870351;90;70.6551671722846
08;2020-11-13;1;4;5;18551.3174743414;16782.6825256586;0;35334
11;2020-11-13;70;70;142;783071;811785;09;1594856
11;2020-11-13;281;235;533;761456;784653;19;1546109
11;2020-11-13;336;252;590;850145;801772;29;1651917
11;2020-11-13;381;302;683;914360;843488;39;1757848
11;2020-11-13;358;280;638;845609;826202;49;1671811
11;2020-11-13;317;274;591;793566;745070;59;1538636
11;2020-11-13;212;234;453;628649;549192;69;1177841
11;2020-11-13;124;98;222;434606;358356;79;792962
11;2020-11-13;96;88;184;261425;162933;89;424358
11;2020-11-13;71;16;87;89253;32619;90;121872
11;2020-11-13;2247;1850;4129;6362140;5916070;0;12278210
24;2020-11-13;10;15;25;139720;144686;09;284406
24;2020-11-13;57;69;128;152979;161185;19;314164
24;2020-11-13;73;57;131;122237;126536;29;248773
24;2020-11-13;62;54;116;150359;142009;39;292368
24;2020-11-13;71;64;135;161829;158758;49;320587
24;2020-11-13;60;68;128;172552;168011;59;340563
24;2020-11-13;63;59;122;172509;158177;69;330686
24;2020-11-13;51;45;96;129428;110593;79;240021
24;2020-11-13;35;27;62;87342;56882;89;144224
24;2020-11-13;26;8;34;31210;12071;90;43281
24;2020-11-13;509;467;979;1320165;1238908;0;2559073
27;2020-11-13;54;40;95;143373;149679;09;293052
27;2020-11-13;160;158;319;160962;173003;19;333965
27;2020-11-13;127;118;245;133746;142254;29;276000
27;2020-11-13;132;96;228;160004;155407;39;315411
27;2020-11-13;133;107;240;172333;169564;49;341897
27;2020-11-13;131;110;241;189979;183788;59;373767
27;2020-11-13;86;66;152;192591;178206;69;370797
27;2020-11-13;73;71;144;146876;127546;79;274422
27;2020-11-13;80;36;116;96896;61575;89;158471
27;2020-11-13;74;17;91;33148;12109;90;45257
27;2020-11-13;1050;819;1871;1429908;1353131;0;2783039
28;2020-11-13;26;16;42;180735;186856;09;367591
28;2020-11-13;58;61;122;200125;213621;19;413746
28;2020-11-13;73;62;135;168922;173007;29;341929
28;2020-11-13;71;56;127;196628;188487;39;385115
28;2020-11-13;73;61;134;205396;201699;49;407095
28;2020-11-13;97;76;173;222002;213866;59;435868
28;2020-11-13;65;56;122;224688;203758;69;428446
28;2020-11-13;50;32;82;163192;135543;79;298735
28;2020-11-13;64;35;99;109691;65377;89;175068
28;2020-11-13;52;14;66;37222;12685;90;49907
28;2020-11-13;629;469;1105;1708601;1594899;0;3303500
32;2020-11-13;67;70;137;358062;373689;09;731751
32;2020-11-13;218;225;445;387045;406742;19;793787
32;2020-11-13;223;180;405;342304;348587;29;690891
32;2020-11-13;246;176;422;382485;369972;39;752457
32;2020-11-13;234;196;432;382510;376716;49;759226
32;2020-11-13;258;217;475;386937;376527;59;763464
32;2020-11-13;175;136;311;371211;330938;69;702149
32;2020-11-13;121;92;213;250542;201459;79;452001
32;2020-11-13;124;71;195;163399;89786;89;253185
32;2020-11-13;88;20;108;48384;15367;90;63751
32;2020-11-13;1754;1383;3143;3072879;2889783;0;5962662
44;2020-11-13;46;56;102;291525;306839;09;598364
44;2020-11-13;180;190;372;320255;339504;19;659759
44;2020-11-13;169;155;326;302020;314428;29;616448
44;2020-11-13;190;146;337;342222;333292;39;675514
44;2020-11-13;169;137;306;349727;344491;49;694218
44;2020-11-13;184;158;342;381371;373239;59;754610
44;2020-11-13;126;124;251;367165;335850;69;703015
44;2020-11-13;92;94;186;250387;215436;79;465823
44;2020-11-13;125;75;200;170825;105192;89;276017
44;2020-11-13;69;19;88;51248;16731;90;67979
44;2020-11-13;1351;1154;2511;2826745;2685002;0;5511747
52;2020-11-13;23;20;44;213594;223900;09;437494
52;2020-11-13;91;91;185;240818;255197;19;496015
52;2020-11-13;76;67;143;197010;200630;29;397640
52;2020-11-13;77;51;129;231204;224885;39;456089
52;2020-11-13;82;72;154;243874;243418;49;487292
52;2020-11-13;84;59;143;244100;239116;59;483216
52;2020-11-13;52;56;108;241796;221345;69;463141
52;2020-11-13;41;56;97;177805;149903;79;327708
52;2020-11-13;49;34;83;119561;75822;89;195383
52;2020-11-13;51;15;66;42559;15260;90;57819
52;2020-11-13;626;521;1152;1952321;1849476;0;3801797
53;2020-11-13;17;24;42;173813;182358;09;356171
53;2020-11-13;49;48;99;202720;214740;19;417460
53;2020-11-13;45;39;86;163116;173196;29;336312
53;2020-11-13;40;26;66;190526;187674;39;378200
53;2020-11-13;58;34;92;212098;212015;49;424113
53;2020-11-13;55;57;112;223699;219176;59;442875
53;2020-11-13;30;40;70;227435;209274;69;436709
53;2020-11-13;23;23;46;169992;140910;79;310902
53;2020-11-13;29;20;49;118117;69883;89;188000
53;2020-11-13;23;6;29;37370;12267;90;49637
53;2020-11-13;369;317;691;1718886;1621493;0;3340379
75;2020-11-13;31;28;62;293104;305291;09;598395
75;2020-11-13;105;103;209;337141;357785;19;694926
75;2020-11-13;133;109;242;295024;300618;29;595642
75;2020-11-13;133;106;239;347871;331233;39;679104
75;2020-11-13;125;127;252;384742;372771;49;757513
75;2020-11-13;142;133;275;413361;390880;59;804241
75;2020-11-13;104;94;198;425623;384060;69;809683
75;2020-11-13;59;51;110;325086;276298;79;601384
75;2020-11-13;101;53;154;213986;139308;89;353294
75;2020-11-13;88;32;120;77600;28200;90;105800
75;2020-11-13;1021;836;1861;3113538;2886444;0;5999982
76;2020-11-13;30;32;66;305956;318589;09;624545
76;2020-11-13;116;127;247;338942;356969;19;695911
76;2020-11-13;152;127;279;316210;319570;29;635780
76;2020-11-13;160;114;274;356758;337587;39;694345
76;2020-11-13;142;120;262;376541;363812;49;740353
76;2020-11-13;179;126;305;402608;383750;59;786358
76;2020-11-13;137;114;251;394889;358997;69;753886
76;2020-11-13;86;79;165;308664;263806;79;572470
76;2020-11-13;129;67;196;195838;129272;89;325110
76;2020-11-13;109;33;142;69372;26728;90;96100
76;2020-11-13;1242;942;2192;3065778;2859080;0;5924858
84;2020-11-13;96;106;207;459549;481088;09;940637
84;2020-11-13;460;473;951;487711;511905;19;999616
84;2020-11-13;424;344;769;443824;451094;29;894918
84;2020-11-13;463;352;817;512522;493262;39;1005784
84;2020-11-13;465;352;817;520248;515106;49;1035354
84;2020-11-13;471;447;919;529611;514848;59;1044459
84;2020-11-13;314;283;597;486720;439940;69;926660
84;2020-11-13;253;232;485;372151;315211;79;687362
84;2020-11-13;302;158;460;237198;150524;89;387722
84;2020-11-13;251;78;329;81185;28680;90;109865
84;2020-11-13;3499;2826;6352;4130719;3901658;0;8032377
93;2020-11-13;41;30;71;268834;283093;09;551927
93;2020-11-13;155;151;306;280751;296087;19;576838
93;2020-11-13;178;125;304;254404;255552;29;509956
93;2020-11-13;161;133;294;310704;288398;39;599102
93;2020-11-13;167;165;332;325559;305827;49;631386
93;2020-11-13;191;161;352;353104;325389;59;678493
93;2020-11-13;147;131;279;336327;296459;69;632786
93;2020-11-13;111;109;221;279820;229699;79;509519
93;2020-11-13;158;74;232;171274;113716;89;284990
93;2020-11-13;101;35;136;58896;21758;90;80654
93;2020-11-13;1411;1116;2530;2639673;2415978;0;5055651
94;2020-11-13;0;1;3;16311;17433;09;33744
94;2020-11-13;6;1;7;16679;18132;19;34811
94;2020-11-13;6;4;10;16782;16579;29;33361
94;2020-11-13;3;8;11;23044;20580;39;43624
94;2020-11-13;2;8;10;23065;22140;49;45205
94;2020-11-13;5;7;12;24549;23421;59;47970
94;2020-11-13;1;4;5;23212;21883;69;45095
94;2020-11-13;1;1;2;19544;17141;79;36685
94;2020-11-13;0;0;0;11227;8178;89;19405
94;2020-11-13;1;0;1;3332;1447;90;4779
94;2020-11-13;25;34;61;177745;166934;0;344679
01;2020-11-14;0;1;1;19979;20155;09;40134
01;2020-11-14;0;1;1;24994;25489;19;50483
01;2020-11-14;0;0;0;17868;16690;29;34558
01;2020-11-14;1;1;2;22328;14821;39;37149
01;2020-11-14;1;1;2;28652;20276;49;48928
01;2020-11-14;2;0;2;33264;27260;59;60524
01;2020-11-14;1;0;1;27135;23978;69;51113
01;2020-11-14;1;0;1;18401;14661;79;33062
01;2020-11-14;0;0;0;9633;6375;89;16008
01;2020-11-14;0;0;0;3410;1510;90;4920
01;2020-11-14;6;4;10;205664;171215;0;376879
02;2020-11-14;0;0;0;16881;17110;09;33991
02;2020-11-14;4;0;4;21410;21604;19;43014
02;2020-11-14;0;0;0;16017;15479;29;31496
02;2020-11-14;0;0;0;19825;14455;39;34280
02;2020-11-14;3;1;4;24719;18248;49;42967
02;2020-11-14;0;2;2;34361;28310;59;62671
02;2020-11-14;1;1;2;28061;24495;69;52556
02;2020-11-14;0;0;0;18231;15278;79;33509
02;2020-11-14;0;0;0;11090;7677;89;18767
02;2020-11-14;0;0;0;3992;1506;90;5498
02;2020-11-14;8;4;12;194587;164162;0;358749
03;2020-11-14;1;0;1;31123;30920;09;62043
03;2020-11-14;4;1;5;29370;29268;19;58638
03;2020-11-14;2;4;6;21458;18963;29;40421
03;2020-11-14;1;0;1;21276;18326;39;39602
03;2020-11-14;3;0;3;18164;16593;49;34757
03;2020-11-14;4;2;6;13469;13557;59;27026
03;2020-11-14;0;0;0;8776;8670;69;17446
03;2020-11-14;0;0;0;3777;3591;79;7368
03;2020-11-14;0;0;0;1649;1072;89;2721
03;2020-11-14;0;0;0;485;184;90;669
03;2020-11-14;15;7;22;149547;141144;0;290691
04;2020-11-14;1;2;3;60314;61377;09;121691
04;2020-11-14;9;5;14;66065;68387;19;134452
04;2020-11-14;4;3;7;51059;47156;29;98215
04;2020-11-14;10;4;14;58788;45780;39;104568
04;2020-11-14;5;7;12;61408;52207;49;113615
04;2020-11-14;6;1;7;64838;60759;59;125597
04;2020-11-14;1;4;5;47008;42843;69;89851
04;2020-11-14;1;1;2;25509;21184;79;46693
04;2020-11-14;1;1;2;13168;7647;89;20815
04;2020-11-14;0;0;0;3209;1253;90;4462
04;2020-11-14;38;28;66;451366;408593;0;859959
05;2020-11-14;0;0;0;362.366008612902;341.338819562748;09;703.704828175651
05;2020-11-14;0;0;0;353.376145114279;370.349735405642;19;723.725880519921
05;2020-11-14;0;0;0;218.593559489256;256.539602589476;29;475.133162078732
05;2020-11-14;0;0;0;404.225408693299;360.321910454353;39;764.547319147651
05;2020-11-14;0;0;0;520.067953604221;497.108383964256;49;1017.17633756848
05;2020-11-14;0;0;0;468.146063921917;510.087601910415;59;978.233665832332
05;2020-11-14;0;0;0;340.368470050554;334.366842191253;69;674.735312241807
05;2020-11-14;0;0;0;212.598666888387;192.597753227106;79;405.196420115493
05;2020-11-14;0;0;0;148.727797095705;61.8681715431829;89;210.595968638888
05;2020-11-14;0;0;0;32.9601271090696;10.9909785719784;90;43.9511056810479
05;2020-11-14;0;0;0;3061.43020057959;2935.56979942041;0;5997
06;2020-11-14;0;0;0;42583;42380;09;84963
06;2020-11-14;1;0;1;33369;31925;19;65294
06;2020-11-14;1;2;3;21571;15080;29;36651
06;2020-11-14;2;0;2;21550;16147;39;37697
06;2020-11-14;0;2;2;14193;13939;49;28132
06;2020-11-14;0;0;0;7171;7597;59;14768
06;2020-11-14;1;0;1;3629;4117;69;7746
06;2020-11-14;0;0;0;1577;1457;79;3034
06;2020-11-14;0;0;0;531;474;89;1005
06;2020-11-14;0;0;0;88;93;90;181
06;2020-11-14;5;4;9;146262;133209;0;279471
07;2020-11-14;0;0;0;485;549;09;1034
07;2020-11-14;0;0;0;403;432;19;835
07;2020-11-14;0;0;0;764;841;29;1605
07;2020-11-14;0;1;1;824;928;39;1752
07;2020-11-14;0;0;0;788;1020;49;1808
07;2020-11-14;0;0;0;678;870;59;1548
07;2020-11-14;0;0;0;360;382;69;742
07;2020-11-14;0;0;0;231;190;79;421
07;2020-11-14;0;0;0;114;67;89;181
07;2020-11-14;0;0;0;24;11;90;35
07;2020-11-14;0;1;1;4671;5290;0;9961
08;2020-11-14;0;0;0;2715.22592983026;2997.75551488675;09;5712.98144471701
08;2020-11-14;0;0;0;2778.51901080978;3160.9156459093;19;5939.43465671908
08;2020-11-14;1;1;2;2080.8882988764;1718.16634315323;29;3799.05464202964
08;2020-11-14;0;0;0;2701.8582062647;1896.52641413317;39;4598.38462039786
08;2020-11-14;0;0;0;3151.45861023308;2460.52498233809;49;5611.98359257117
08;2020-11-14;1;0;1;2620.29868333099;2422.23566154656;59;5042.53434487755
08;2020-11-14;0;1;1;1621.44173420671;1438.58325779464;69;3060.02499200135
08;2020-11-14;0;0;0;626.575909335673;526.358467843651;79;1152.93437717932
08;2020-11-14;0;0;0;205.018522985054;140.993639349697;89;346.012162334751
08;2020-11-14;0;0;0;50.0325684687745;20.62259870351;90;70.6551671722846
08;2020-11-14;2;2;4;18551.3174743414;16782.6825256586;0;35334
11;2020-11-14;34;30;74;783071;811785;09;1594856
11;2020-11-14;103;102;222;761456;784653;19;1546109
11;2020-11-14;122;110;232;850145;801772;29;1651917
11;2020-11-14;131;115;246;914360;843488;39;1757848
11;2020-11-14;147;121;268;845609;826202;49;1671811
11;2020-11-14;130;114;245;793566;745070;59;1538636
11;2020-11-14;74;94;169;628649;549192;69;1177841
11;2020-11-14;46;48;94;434606;358356;79;792962
11;2020-11-14;45;17;62;261425;162933;89;424358
11;2020-11-14;32;14;46;89253;32619;90;121872
11;2020-11-14;864;765;1658;6362140;5916070;0;12278210
24;2020-11-14;8;7;15;139720;144686;09;284406
24;2020-11-14;43;29;72;152979;161185;19;314164
24;2020-11-14;34;21;55;122237;126536;29;248773
24;2020-11-14;40;33;73;150359;142009;39;292368
24;2020-11-14;32;29;61;161829;158758;49;320587
24;2020-11-14;40;32;72;172552;168011;59;340563
24;2020-11-14;14;21;35;172509;158177;69;330686
24;2020-11-14;9;17;26;129428;110593;79;240021
24;2020-11-14;12;13;25;87342;56882;89;144224
24;2020-11-14;10;2;12;31210;12071;90;43281
24;2020-11-14;242;204;446;1320165;1238908;0;2559073
27;2020-11-14;13;14;27;143373;149679;09;293052
27;2020-11-14;59;46;106;160962;173003;19;333965
27;2020-11-14;47;32;79;133746;142254;29;276000
27;2020-11-14;57;38;95;160004;155407;39;315411
27;2020-11-14;71;43;114;172333;169564;49;341897
27;2020-11-14;66;45;111;189979;183788;59;373767
27;2020-11-14;24;32;56;192591;178206;69;370797
27;2020-11-14;36;18;54;146876;127546;79;274422
27;2020-11-14;47;24;71;96896;61575;89;158471
27;2020-11-14;26;14;40;33148;12109;90;45257
27;2020-11-14;446;306;753;1429908;1353131;0;2783039
28;2020-11-14;7;4;12;180735;186856;09;367591
28;2020-11-14;27;20;47;200125;213621;19;413746
28;2020-11-14;37;18;55;168922;173007;29;341929
28;2020-11-14;40;26;66;196628;188487;39;385115
28;2020-11-14;39;27;66;205396;201699;49;407095
28;2020-11-14;30;32;62;222002;213866;59;435868
28;2020-11-14;24;25;49;224688;203758;69;428446
28;2020-11-14;20;23;43;163192;135543;79;298735
28;2020-11-14;22;22;44;109691;65377;89;175068
28;2020-11-14;38;7;45;37222;12685;90;49907
28;2020-11-14;284;204;489;1708601;1594899;0;3303500
32;2020-11-14;44;39;83;358062;373689;09;731751
32;2020-11-14;123;97;221;387045;406742;19;793787
32;2020-11-14;131;87;218;342304;348587;29;690891
32;2020-11-14;101;89;190;382485;369972;39;752457
32;2020-11-14;120;81;201;382510;376716;49;759226
32;2020-11-14;99;112;211;386937;376527;59;763464
32;2020-11-14;58;52;110;371211;330938;69;702149
32;2020-11-14;37;43;80;250542;201459;79;452001
32;2020-11-14;46;35;81;163399;89786;89;253185
32;2020-11-14;20;8;28;48384;15367;90;63751
32;2020-11-14;779;643;1423;3072879;2889783;0;5962662
44;2020-11-14;19;11;30;291525;306839;09;598364
44;2020-11-14;65;64;129;320255;339504;19;659759
44;2020-11-14;75;46;121;302020;314428;29;616448
44;2020-11-14;83;60;143;342222;333292;39;675514
44;2020-11-14;91;78;169;349727;344491;49;694218
44;2020-11-14;73;75;148;381371;373239;59;754610
44;2020-11-14;64;63;127;367165;335850;69;703015
44;2020-11-14;42;34;76;250387;215436;79;465823
44;2020-11-14;50;35;85;170825;105192;89;276017
44;2020-11-14;24;9;33;51248;16731;90;67979
44;2020-11-14;586;475;1061;2826745;2685002;0;5511747
52;2020-11-14;8;6;15;213594;223900;09;437494
52;2020-11-14;40;36;78;240818;255197;19;496015
52;2020-11-14;38;34;72;197010;200630;29;397640
52;2020-11-14;41;36;77;231204;224885;39;456089
52;2020-11-14;39;46;85;243874;243418;49;487292
52;2020-11-14;38;36;74;244100;239116;59;483216
52;2020-11-14;26;31;57;241796;221345;69;463141
52;2020-11-14;19;21;40;177805;149903;79;327708
52;2020-11-14;26;14;40;119561;75822;89;195383
52;2020-11-14;16;6;22;42559;15260;90;57819
52;2020-11-14;291;266;560;1952321;1849476;0;3801797
53;2020-11-14;10;15;25;173813;182358;09;356171
53;2020-11-14;23;32;56;202720;214740;19;417460
53;2020-11-14;22;20;42;163116;173196;29;336312
53;2020-11-14;23;17;40;190526;187674;39;378200
53;2020-11-14;34;11;45;212098;212015;49;424113
53;2020-11-14;22;37;59;223699;219176;59;442875
53;2020-11-14;14;13;27;227435;209274;69;436709
53;2020-11-14;12;3;15;169992;140910;79;310902
53;2020-11-14;7;15;22;118117;69883;89;188000
53;2020-11-14;13;2;15;37370;12267;90;49637
53;2020-11-14;180;165;346;1718886;1621493;0;3340379
75;2020-11-14;12;9;21;293104;305291;09;598395
75;2020-11-14;47;46;94;337141;357785;19;694926
75;2020-11-14;45;50;95;295024;300618;29;595642
75;2020-11-14;42;27;69;347871;331233;39;679104
75;2020-11-14;55;36;91;384742;372771;49;757513
75;2020-11-14;44;39;83;413361;390880;59;804241
75;2020-11-14;39;29;68;425623;384060;69;809683
75;2020-11-14;13;18;31;325086;276298;79;601384
75;2020-11-14;26;14;40;213986;139308;89;353294
75;2020-11-14;10;4;14;77600;28200;90;105800
75;2020-11-14;333;272;606;3113538;2886444;0;5999982
76;2020-11-14;9;14;23;305956;318589;09;624545
76;2020-11-14;47;52;100;338942;356969;19;695911
76;2020-11-14;52;41;93;316210;319570;29;635780
76;2020-11-14;51;34;85;356758;337587;39;694345
76;2020-11-14;56;48;104;376541;363812;49;740353
76;2020-11-14;47;41;88;402608;383750;59;786358
76;2020-11-14;41;32;74;394889;358997;69;753886
76;2020-11-14;29;28;57;308664;263806;79;572470
76;2020-11-14;26;14;41;195838;129272;89;325110
76;2020-11-14;20;13;33;69372;26728;90;96100
76;2020-11-14;379;317;699;3065778;2859080;0;5924858
84;2020-11-14;46;41;87;459549;481088;09;940637
84;2020-11-14;144;172;320;487711;511905;19;999616
84;2020-11-14;162;133;295;443824;451094;29;894918
84;2020-11-14;161;126;287;512522;493262;39;1005784
84;2020-11-14;168;121;289;520248;515106;49;1035354
84;2020-11-14;153;161;314;529611;514848;59;1044459
84;2020-11-14;103;117;220;486720;439940;69;926660
84;2020-11-14;72;66;138;372151;315211;79;687362
84;2020-11-14;93;50;143;237198;150524;89;387722
84;2020-11-14;55;16;71;81185;28680;90;109865
84;2020-11-14;1157;1003;2164;4130719;3901658;0;8032377
93;2020-11-14;7;5;12;268834;283093;09;551927
93;2020-11-14;33;34;67;280751;296087;19;576838
93;2020-11-14;46;31;77;254404;255552;29;509956
93;2020-11-14;49;41;90;310704;288398;39;599102
93;2020-11-14;43;47;90;325559;305827;49;631386
93;2020-11-14;44;41;85;353104;325389;59;678493
93;2020-11-14;23;40;63;336327;296459;69;632786
93;2020-11-14;34;30;64;279820;229699;79;509519
93;2020-11-14;38;21;59;171274;113716;89;284990
93;2020-11-14;31;8;39;58896;21758;90;80654
93;2020-11-14;349;299;648;2639673;2415978;0;5055651
94;2020-11-14;0;0;0;16311;17433;09;33744
94;2020-11-14;0;1;1;16679;18132;19;34811
94;2020-11-14;0;1;1;16782;16579;29;33361
94;2020-11-14;0;0;0;23044;20580;39;43624
94;2020-11-14;2;2;4;23065;22140;49;45205
94;2020-11-14;1;1;2;24549;23421;59;47970
94;2020-11-14;1;2;3;23212;21883;69;45095
94;2020-11-14;1;0;1;19544;17141;79;36685
94;2020-11-14;1;2;3;11227;8178;89;19405
94;2020-11-14;1;0;1;3332;1447;90;4779
94;2020-11-14;7;9;16;177745;166934;0;344679
01;2020-11-15;0;0;0;19979;20155;09;40134
01;2020-11-15;0;0;0;24994;25489;19;50483
01;2020-11-15;0;0;0;17868;16690;29;34558
01;2020-11-15;0;0;0;22328;14821;39;37149
01;2020-11-15;0;0;0;28652;20276;49;48928
01;2020-11-15;1;0;1;33264;27260;59;60524
01;2020-11-15;0;0;0;27135;23978;69;51113
01;2020-11-15;0;0;0;18401;14661;79;33062
01;2020-11-15;0;0;0;9633;6375;89;16008
01;2020-11-15;0;0;0;3410;1510;90;4920
01;2020-11-15;1;0;1;205664;171215;0;376879
02;2020-11-15;0;0;0;16881;17110;09;33991
02;2020-11-15;0;0;0;21410;21604;19;43014
02;2020-11-15;0;0;0;16017;15479;29;31496
02;2020-11-15;0;1;1;19825;14455;39;34280
02;2020-11-15;1;1;2;24719;18248;49;42967
02;2020-11-15;0;0;0;34361;28310;59;62671
02;2020-11-15;0;1;1;28061;24495;69;52556
02;2020-11-15;0;0;0;18231;15278;79;33509
02;2020-11-15;0;0;0;11090;7677;89;18767
02;2020-11-15;0;0;0;3992;1506;90;5498
02;2020-11-15;1;3;4;194587;164162;0;358749
03;2020-11-15;1;0;1;31123;30920;09;62043
03;2020-11-15;0;0;0;29370;29268;19;58638
03;2020-11-15;1;0;1;21458;18963;29;40421
03;2020-11-15;0;1;1;21276;18326;39;39602
03;2020-11-15;0;0;0;18164;16593;49;34757
03;2020-11-15;0;0;0;13469;13557;59;27026
03;2020-11-15;0;0;0;8776;8670;69;17446
03;2020-11-15;0;0;0;3777;3591;79;7368
03;2020-11-15;0;0;0;1649;1072;89;2721
03;2020-11-15;0;0;0;485;184;90;669
03;2020-11-15;2;1;3;149547;141144;0;290691
04;2020-11-15;2;0;2;60314;61377;09;121691
04;2020-11-15;0;2;2;66065;68387;19;134452
04;2020-11-15;1;0;1;51059;47156;29;98215
04;2020-11-15;1;0;1;58788;45780;39;104568
04;2020-11-15;2;1;3;61408;52207;49;113615
04;2020-11-15;1;1;2;64838;60759;59;125597
04;2020-11-15;0;0;0;47008;42843;69;89851
04;2020-11-15;2;0;2;25509;21184;79;46693
04;2020-11-15;0;0;0;13168;7647;89;20815
04;2020-11-15;1;0;1;3209;1253;90;4462
04;2020-11-15;10;4;14;451366;408593;0;859959
05;2020-11-15;0;0;0;362.366008612902;341.338819562748;09;703.704828175651
05;2020-11-15;0;0;0;353.376145114279;370.349735405642;19;723.725880519921
05;2020-11-15;0;0;0;218.593559489256;256.539602589476;29;475.133162078732
05;2020-11-15;0;0;0;404.225408693299;360.321910454353;39;764.547319147651
05;2020-11-15;0;0;0;520.067953604221;497.108383964256;49;1017.17633756848
05;2020-11-15;0;0;0;468.146063921917;510.087601910415;59;978.233665832332
05;2020-11-15;0;0;0;340.368470050554;334.366842191253;69;674.735312241807
05;2020-11-15;0;0;0;212.598666888387;192.597753227106;79;405.196420115493
05;2020-11-15;0;0;0;148.727797095705;61.8681715431829;89;210.595968638888
05;2020-11-15;0;0;0;32.9601271090696;10.9909785719784;90;43.9511056810479
05;2020-11-15;0;0;0;3061.43020057959;2935.56979942041;0;5997
06;2020-11-15;0;0;0;42583;42380;09;84963
06;2020-11-15;1;0;1;33369;31925;19;65294
06;2020-11-15;2;1;3;21571;15080;29;36651
06;2020-11-15;0;0;0;21550;16147;39;37697
06;2020-11-15;0;0;0;14193;13939;49;28132
06;2020-11-15;1;0;1;7171;7597;59;14768
06;2020-11-15;0;2;2;3629;4117;69;7746
06;2020-11-15;0;0;0;1577;1457;79;3034
06;2020-11-15;0;0;0;531;474;89;1005
06;2020-11-15;0;0;0;88;93;90;181
06;2020-11-15;4;3;7;146262;133209;0;279471
07;2020-11-15;0;0;0;485;549;09;1034
07;2020-11-15;0;0;0;403;432;19;835
07;2020-11-15;1;0;1;764;841;29;1605
07;2020-11-15;1;0;1;824;928;39;1752
07;2020-11-15;0;0;0;788;1020;49;1808
07;2020-11-15;0;0;0;678;870;59;1548
07;2020-11-15;0;0;0;360;382;69;742
07;2020-11-15;0;0;0;231;190;79;421
07;2020-11-15;0;0;0;114;67;89;181
07;2020-11-15;0;0;0;24;11;90;35
07;2020-11-15;2;0;2;4671;5290;0;9961
08;2020-11-15;0;0;0;2715.22592983026;2997.75551488675;09;5712.98144471701
08;2020-11-15;0;0;0;2778.51901080978;3160.9156459093;19;5939.43465671908
08;2020-11-15;0;0;0;2080.8882988764;1718.16634315323;29;3799.05464202964
08;2020-11-15;0;0;0;2701.8582062647;1896.52641413317;39;4598.38462039786
08;2020-11-15;0;0;0;3151.45861023308;2460.52498233809;49;5611.98359257117
08;2020-11-15;0;0;0;2620.29868333099;2422.23566154656;59;5042.53434487755
08;2020-11-15;0;0;0;1621.44173420671;1438.58325779464;69;3060.02499200135
08;2020-11-15;0;0;0;626.575909335673;526.358467843651;79;1152.93437717932
08;2020-11-15;0;0;0;205.018522985054;140.993639349697;89;346.012162334751
08;2020-11-15;0;0;0;50.0325684687745;20.62259870351;90;70.6551671722846
08;2020-11-15;0;0;0;18551.3174743414;16782.6825256586;0;35334
11;2020-11-15;7;10;17;783071;811785;09;1594856
11;2020-11-15;18;18;38;761456;784653;19;1546109
11;2020-11-15;38;24;62;850145;801772;29;1651917
11;2020-11-15;34;33;67;914360;843488;39;1757848
11;2020-11-15;25;28;53;845609;826202;49;1671811
11;2020-11-15;28;30;58;793566;745070;59;1538636
11;2020-11-15;17;25;42;628649;549192;69;1177841
11;2020-11-15;14;22;36;434606;358356;79;792962
11;2020-11-15;14;23;37;261425;162933;89;424358
11;2020-11-15;16;7;23;89253;32619;90;121872
11;2020-11-15;211;220;433;6362140;5916070;0;12278210
24;2020-11-15;3;3;6;139720;144686;09;284406
24;2020-11-15;10;12;22;152979;161185;19;314164
24;2020-11-15;13;5;18;122237;126536;29;248773
24;2020-11-15;11;7;18;150359;142009;39;292368
24;2020-11-15;7;9;16;161829;158758;49;320587
24;2020-11-15;6;12;18;172552;168011;59;340563
24;2020-11-15;6;7;13;172509;158177;69;330686
24;2020-11-15;2;4;6;129428;110593;79;240021
24;2020-11-15;10;3;13;87342;56882;89;144224
24;2020-11-15;5;2;7;31210;12071;90;43281
24;2020-11-15;73;64;137;1320165;1238908;0;2559073
27;2020-11-15;2;4;6;143373;149679;09;293052
27;2020-11-15;7;5;12;160962;173003;19;333965
27;2020-11-15;9;2;11;133746;142254;29;276000
27;2020-11-15;12;7;19;160004;155407;39;315411
27;2020-11-15;14;6;20;172333;169564;49;341897
27;2020-11-15;10;7;17;189979;183788;59;373767
27;2020-11-15;7;8;15;192591;178206;69;370797
27;2020-11-15;6;7;13;146876;127546;79;274422
27;2020-11-15;16;9;25;96896;61575;89;158471
27;2020-11-15;9;3;12;33148;12109;90;45257
27;2020-11-15;92;58;150;1429908;1353131;0;2783039
28;2020-11-15;5;5;10;180735;186856;09;367591
28;2020-11-15;10;14;24;200125;213621;19;413746
28;2020-11-15;18;9;27;168922;173007;29;341929
28;2020-11-15;19;8;27;196628;188487;39;385115
28;2020-11-15;16;9;25;205396;201699;49;407095
28;2020-11-15;12;8;20;222002;213866;59;435868
28;2020-11-15;7;10;17;224688;203758;69;428446
28;2020-11-15;7;9;16;163192;135543;79;298735
28;2020-11-15;6;8;14;109691;65377;89;175068
28;2020-11-15;9;4;13;37222;12685;90;49907
28;2020-11-15;109;85;194;1708601;1594899;0;3303500
32;2020-11-15;7;12;19;358062;373689;09;731751
32;2020-11-15;28;17;45;387045;406742;19;793787
32;2020-11-15;32;15;47;342304;348587;29;690891
32;2020-11-15;23;23;46;382485;369972;39;752457
32;2020-11-15;22;14;36;382510;376716;49;759226
32;2020-11-15;24;16;40;386937;376527;59;763464
32;2020-11-15;9;17;26;371211;330938;69;702149
32;2020-11-15;9;11;20;250542;201459;79;452001
32;2020-11-15;15;5;20;163399;89786;89;253185
32;2020-11-15;11;4;15;48384;15367;90;63751
32;2020-11-15;180;134;314;3072879;2889783;0;5962662
44;2020-11-15;0;0;0;291525;306839;09;598364
44;2020-11-15;6;5;12;320255;339504;19;659759
44;2020-11-15;7;10;17;302020;314428;29;616448
44;2020-11-15;11;6;17;342222;333292;39;675514
44;2020-11-15;11;3;14;349727;344491;49;694218
44;2020-11-15;8;8;16;381371;373239;59;754610
44;2020-11-15;10;10;21;367165;335850;69;703015
44;2020-11-15;11;6;18;250387;215436;79;465823
44;2020-11-15;19;10;29;170825;105192;89;276017
44;2020-11-15;4;5;9;51248;16731;90;67979
44;2020-11-15;87;63;153;2826745;2685002;0;5511747
52;2020-11-15;3;3;6;213594;223900;09;437494
52;2020-11-15;14;15;31;240818;255197;19;496015
52;2020-11-15;9;15;24;197010;200630;29;397640
52;2020-11-15;16;7;23;231204;224885;39;456089
52;2020-11-15;19;20;39;243874;243418;49;487292
52;2020-11-15;11;17;28;244100;239116;59;483216
52;2020-11-15;6;10;16;241796;221345;69;463141
52;2020-11-15;5;9;14;177805;149903;79;327708
52;2020-11-15;7;5;12;119561;75822;89;195383
52;2020-11-15;3;2;5;42559;15260;90;57819
52;2020-11-15;93;103;198;1952321;1849476;0;3801797
53;2020-11-15;1;4;5;173813;182358;09;356171
53;2020-11-15;3;2;5;202720;214740;19;417460
53;2020-11-15;7;5;12;163116;173196;29;336312
53;2020-11-15;7;4;11;190526;187674;39;378200
53;2020-11-15;6;5;11;212098;212015;49;424113
53;2020-11-15;6;1;7;223699;219176;59;442875
53;2020-11-15;3;10;13;227435;209274;69;436709
53;2020-11-15;5;4;9;169992;140910;79;310902
53;2020-11-15;13;4;17;118117;69883;89;188000
53;2020-11-15;15;3;18;37370;12267;90;49637
53;2020-11-15;66;42;108;1718886;1621493;0;3340379
75;2020-11-15;5;4;9;293104;305291;09;598395
75;2020-11-15;5;3;8;337141;357785;19;694926
75;2020-11-15;12;12;24;295024;300618;29;595642
75;2020-11-15;9;9;18;347871;331233;39;679104
75;2020-11-15;4;9;13;384742;372771;49;757513
75;2020-11-15;4;3;7;413361;390880;59;804241
75;2020-11-15;4;4;8;425623;384060;69;809683
75;2020-11-15;5;6;11;325086;276298;79;601384
75;2020-11-15;13;10;23;213986;139308;89;353294
75;2020-11-15;9;3;12;77600;28200;90;105800
75;2020-11-15;70;63;133;3113538;2886444;0;5999982
76;2020-11-15;4;3;8;305956;318589;09;624545
76;2020-11-15;10;9;19;338942;356969;19;695911
76;2020-11-15;16;19;35;316210;319570;29;635780
76;2020-11-15;13;9;22;356758;337587;39;694345
76;2020-11-15;10;11;21;376541;363812;49;740353
76;2020-11-15;10;9;19;402608;383750;59;786358
76;2020-11-15;5;3;8;394889;358997;69;753886
76;2020-11-15;10;7;17;308664;263806;79;572470
76;2020-11-15;14;11;25;195838;129272;89;325110
76;2020-11-15;10;3;13;69372;26728;90;96100
76;2020-11-15;102;84;187;3065778;2859080;0;5924858
84;2020-11-15;2;10;12;459549;481088;09;940637
84;2020-11-15;13;23;36;487711;511905;19;999616
84;2020-11-15;35;15;50;443824;451094;29;894918
84;2020-11-15;34;26;60;512522;493262;39;1005784
84;2020-11-15;34;31;65;520248;515106;49;1035354
84;2020-11-15;30;27;57;529611;514848;59;1044459
84;2020-11-15;15;19;34;486720;439940;69;926660
84;2020-11-15;22;24;46;372151;315211;79;687362
84;2020-11-15;36;35;71;237198;150524;89;387722
84;2020-11-15;33;15;48;81185;28680;90;109865
84;2020-11-15;254;225;479;4130719;3901658;0;8032377
93;2020-11-15;6;2;8;268834;283093;09;551927
93;2020-11-15;6;7;13;280751;296087;19;576838
93;2020-11-15;8;9;17;254404;255552;29;509956
93;2020-11-15;12;9;21;310704;288398;39;599102
93;2020-11-15;16;4;21;325559;305827;49;631386
93;2020-11-15;16;10;26;353104;325389;59;678493
93;2020-11-15;7;16;23;336327;296459;69;632786
93;2020-11-15;13;16;29;279820;229699;79;509519
93;2020-11-15;14;12;26;171274;113716;89;284990
93;2020-11-15;8;5;13;58896;21758;90;80654
93;2020-11-15;106;90;197;2639673;2415978;0;5055651
94;2020-11-15;0;0;0;16311;17433;09;33744
94;2020-11-15;0;0;0;16679;18132;19;34811
94;2020-11-15;0;0;0;16782;16579;29;33361
94;2020-11-15;0;0;0;23044;20580;39;43624
94;2020-11-15;0;0;0;23065;22140;49;45205
94;2020-11-15;0;0;0;24549;23421;59;47970
94;2020-11-15;0;0;0;23212;21883;69;45095
94;2020-11-15;0;0;0;19544;17141;79;36685
94;2020-11-15;0;0;0;11227;8178;89;19405
94;2020-11-15;1;0;1;3332;1447;90;4779
94;2020-11-15;1;0;1;177745;166934;0;344679
01;2020-11-16;0;0;0;19979;20155;09;40134
01;2020-11-16;1;1;2;24994;25489;19;50483
01;2020-11-16;2;0;2;17868;16690;29;34558
01;2020-11-16;0;3;3;22328;14821;39;37149
01;2020-11-16;3;3;6;28652;20276;49;48928
01;2020-11-16;4;2;6;33264;27260;59;60524
01;2020-11-16;2;0;2;27135;23978;69;51113
01;2020-11-16;0;1;1;18401;14661;79;33062
01;2020-11-16;0;1;1;9633;6375;89;16008
01;2020-11-16;1;0;1;3410;1510;90;4920
01;2020-11-16;13;11;24;205664;171215;0;376879
02;2020-11-16;1;0;1;16881;17110;09;33991
02;2020-11-16;5;4;9;21410;21604;19;43014
02;2020-11-16;4;2;6;16017;15479;29;31496
02;2020-11-16;3;4;7;19825;14455;39;34280
02;2020-11-16;5;0;5;24719;18248;49;42967
02;2020-11-16;3;2;5;34361;28310;59;62671
02;2020-11-16;7;1;8;28061;24495;69;52556
02;2020-11-16;1;4;5;18231;15278;79;33509
02;2020-11-16;1;0;1;11090;7677;89;18767
02;2020-11-16;0;0;0;3992;1506;90;5498
02;2020-11-16;30;17;47;194587;164162;0;358749
03;2020-11-16;0;0;0;31123;30920;09;62043
03;2020-11-16;5;2;7;29370;29268;19;58638
03;2020-11-16;4;3;7;21458;18963;29;40421
03;2020-11-16;5;4;9;21276;18326;39;39602
03;2020-11-16;5;6;11;18164;16593;49;34757
03;2020-11-16;3;1;4;13469;13557;59;27026
03;2020-11-16;1;1;2;8776;8670;69;17446
03;2020-11-16;0;0;0;3777;3591;79;7368
03;2020-11-16;0;0;0;1649;1072;89;2721
03;2020-11-16;0;0;0;485;184;90;669
03;2020-11-16;23;18;41;149547;141144;0;290691
04;2020-11-16;4;1;5;60314;61377;09;121691
04;2020-11-16;11;7;18;66065;68387;19;134452
04;2020-11-16;12;7;20;51059;47156;29;98215
04;2020-11-16;11;8;19;58788;45780;39;104568
04;2020-11-16;8;10;18;61408;52207;49;113615
04;2020-11-16;13;5;19;64838;60759;59;125597
04;2020-11-16;4;8;12;47008;42843;69;89851
04;2020-11-16;1;3;4;25509;21184;79;46693
04;2020-11-16;1;0;1;13168;7647;89;20815
04;2020-11-16;0;0;0;3209;1253;90;4462
04;2020-11-16;65;49;116;451366;408593;0;859959
05;2020-11-16;0;0;0;362.366008612902;341.338819562748;09;703.704828175651
05;2020-11-16;0;0;0;353.376145114279;370.349735405642;19;723.725880519921
05;2020-11-16;0;0;0;218.593559489256;256.539602589476;29;475.133162078732
05;2020-11-16;0;0;0;404.225408693299;360.321910454353;39;764.547319147651
05;2020-11-16;0;0;0;520.067953604221;497.108383964256;49;1017.17633756848
05;2020-11-16;0;0;0;468.146063921917;510.087601910415;59;978.233665832332
05;2020-11-16;0;0;0;340.368470050554;334.366842191253;69;674.735312241807
05;2020-11-16;0;0;0;212.598666888387;192.597753227106;79;405.196420115493
05;2020-11-16;0;0;0;148.727797095705;61.8681715431829;89;210.595968638888
05;2020-11-16;0;0;0;32.9601271090696;10.9909785719784;90;43.9511056810479
05;2020-11-16;0;0;0;3061.43020057959;2935.56979942041;0;5997
06;2020-11-16;1;0;1;42583;42380;09;84963
06;2020-11-16;2;3;6;33369;31925;19;65294
06;2020-11-16;2;1;3;21571;15080;29;36651
06;2020-11-16;4;4;8;21550;16147;39;37697
06;2020-11-16;5;8;13;14193;13939;49;28132
06;2020-11-16;4;1;5;7171;7597;59;14768
06;2020-11-16;1;1;2;3629;4117;69;7746
06;2020-11-16;0;0;0;1577;1457;79;3034
06;2020-11-16;0;1;1;531;474;89;1005
06;2020-11-16;0;0;0;88;93;90;181
06;2020-11-16;19;19;39;146262;133209;0;279471
07;2020-11-16;0;0;0;485;549;09;1034
07;2020-11-16;0;0;0;403;432;19;835
07;2020-11-16;0;2;2;764;841;29;1605
07;2020-11-16;0;0;0;824;928;39;1752
07;2020-11-16;0;0;0;788;1020;49;1808
07;2020-11-16;1;0;1;678;870;59;1548
07;2020-11-16;0;1;1;360;382;69;742
07;2020-11-16;1;0;1;231;190;79;421
07;2020-11-16;0;0;0;114;67;89;181
07;2020-11-16;0;0;0;24;11;90;35
07;2020-11-16;2;3;5;4671;5290;0;9961
08;2020-11-16;0;0;0;2715.22592983026;2997.75551488675;09;5712.98144471701
08;2020-11-16;0;0;0;2778.51901080978;3160.9156459093;19;5939.43465671908
08;2020-11-16;0;0;0;2080.8882988764;1718.16634315323;29;3799.05464202964
08;2020-11-16;1;1;2;2701.8582062647;1896.52641413317;39;4598.38462039786
08;2020-11-16;1;0;1;3151.45861023308;2460.52498233809;49;5611.98359257117
08;2020-11-16;0;0;0;2620.29868333099;2422.23566154656;59;5042.53434487755
08;2020-11-16;0;0;0;1621.44173420671;1438.58325779464;69;3060.02499200135
08;2020-11-16;0;0;0;626.575909335673;526.358467843651;79;1152.93437717932
08;2020-11-16;0;0;0;205.018522985054;140.993639349697;89;346.012162334751
08;2020-11-16;0;0;0;50.0325684687745;20.62259870351;90;70.6551671722846
08;2020-11-16;2;1;3;18551.3174743414;16782.6825256586;0;35334
11;2020-11-16;74;99;179;783071;811785;09;1594856
11;2020-11-16;321;301;642;761456;784653;19;1546109
11;2020-11-16;382;292;677;850145;801772;29;1651917
11;2020-11-16;443;357;801;914360;843488;39;1757848
11;2020-11-16;430;359;790;845609;826202;49;1671811
11;2020-11-16;345;328;676;793566;745070;59;1538636
11;2020-11-16;217;208;428;628649;549192;69;1177841
11;2020-11-16;158;150;308;434606;358356;79;792962
11;2020-11-16;120;75;195;261425;162933;89;424358
11;2020-11-16;116;31;147;89253;32619;90;121872
11;2020-11-16;2607;2203;4848;6362140;5916070;0;12278210
24;2020-11-16;7;5;13;139720;144686;09;284406
24;2020-11-16;49;54;104;152979;161185;19;314164
24;2020-11-16;50;51;101;122237;126536;29;248773
24;2020-11-16;66;46;112;150359;142009;39;292368
24;2020-11-16;87;54;141;161829;158758;49;320587
24;2020-11-16;72;66;138;172552;168011;59;340563
24;2020-11-16;52;47;99;172509;158177;69;330686
24;2020-11-16;34;37;71;129428;110593;79;240021
24;2020-11-16;54;42;96;87342;56882;89;144224
24;2020-11-16;59;7;66;31210;12071;90;43281
24;2020-11-16;530;409;941;1320165;1238908;0;2559073
27;2020-11-16;32;36;68;143373;149679;09;293052
27;2020-11-16;121;128;249;160962;173003;19;333965
27;2020-11-16;137;101;239;133746;142254;29;276000
27;2020-11-16;114;101;215;160004;155407;39;315411
27;2020-11-16;138;118;256;172333;169564;49;341897
27;2020-11-16;114;116;230;189979;183788;59;373767
27;2020-11-16;95;82;177;192591;178206;69;370797
27;2020-11-16;84;66;150;146876;127546;79;274422
27;2020-11-16;75;59;134;96896;61575;89;158471
27;2020-11-16;49;27;76;33148;12109;90;45257
27;2020-11-16;959;834;1794;1429908;1353131;0;2783039
28;2020-11-16;23;32;56;180735;186856;09;367591
28;2020-11-16;72;81;156;200125;213621;19;413746
28;2020-11-16;112;87;199;168922;173007;29;341929
28;2020-11-16;103;58;161;196628;188487;39;385115
28;2020-11-16;99;67;166;205396;201699;49;407095
28;2020-11-16;98;68;166;222002;213866;59;435868
28;2020-11-16;62;62;124;224688;203758;69;428446
28;2020-11-16;31;34;65;163192;135543;79;298735
28;2020-11-16;57;34;91;109691;65377;89;175068
28;2020-11-16;43;10;53;37222;12685;90;49907
28;2020-11-16;700;533;1237;1708601;1594899;0;3303500
32;2020-11-16;78;68;146;358062;373689;09;731751
32;2020-11-16;233;229;462;387045;406742;19;793787
32;2020-11-16;227;180;407;342304;348587;29;690891
32;2020-11-16;258;198;456;382485;369972;39;752457
32;2020-11-16;211;192;403;382510;376716;49;759226
32;2020-11-16;215;175;391;386937;376527;59;763464
32;2020-11-16;140;139;279;371211;330938;69;702149
32;2020-11-16;113;103;216;250542;201459;79;452001
32;2020-11-16;149;58;207;163399;89786;89;253185
32;2020-11-16;111;25;136;48384;15367;90;63751
32;2020-11-16;1735;1368;3104;3072879;2889783;0;5962662
44;2020-11-16;55;42;100;291525;306839;09;598364
44;2020-11-16;155;172;333;320255;339504;19;659759
44;2020-11-16;195;145;340;302020;314428;29;616448
44;2020-11-16;193;176;371;342222;333292;39;675514
44;2020-11-16;207;153;361;349727;344491;49;694218
44;2020-11-16;191;202;394;381371;373239;59;754610
44;2020-11-16;145;123;270;367165;335850;69;703015
44;2020-11-16;99;89;188;250387;215436;79;465823
44;2020-11-16;154;88;243;170825;105192;89;276017
44;2020-11-16;134;37;171;51248;16731;90;67979
44;2020-11-16;1528;1227;2771;2826745;2685002;0;5511747
52;2020-11-16;13;19;35;213594;223900;09;437494
52;2020-11-16;86;77;166;240818;255197;19;496015
52;2020-11-16;71;55;126;197010;200630;29;397640
52;2020-11-16;97;71;168;231204;224885;39;456089
52;2020-11-16;101;71;173;243874;243418;49;487292
52;2020-11-16;85;68;154;244100;239116;59;483216
52;2020-11-16;52;55;107;241796;221345;69;463141
52;2020-11-16;46;31;77;177805;149903;79;327708
52;2020-11-16;80;29;110;119561;75822;89;195383
52;2020-11-16;78;18;96;42559;15260;90;57819
52;2020-11-16;709;494;1212;1952321;1849476;0;3801797
53;2020-11-16;7;12;21;173813;182358;09;356171
53;2020-11-16;38;42;80;202720;214740;19;417460
53;2020-11-16;41;36;80;163116;173196;29;336312
53;2020-11-16;31;36;67;190526;187674;39;378200
53;2020-11-16;52;32;84;212098;212015;49;424113
53;2020-11-16;55;36;91;223699;219176;59;442875
53;2020-11-16;31;23;54;227435;209274;69;436709
53;2020-11-16;25;31;56;169992;140910;79;310902
53;2020-11-16;66;31;97;118117;69883;89;188000
53;2020-11-16;65;15;80;37370;12267;90;49637
53;2020-11-16;411;294;710;1718886;1621493;0;3340379
75;2020-11-16;38;30;71;293104;305291;09;598395
75;2020-11-16;99;123;223;337141;357785;19;694926
75;2020-11-16;124;87;211;295024;300618;29;595642
75;2020-11-16;141;79;220;347871;331233;39;679104
75;2020-11-16;161;115;276;384742;372771;49;757513
75;2020-11-16;150;111;261;413361;390880;59;804241
75;2020-11-16;84;90;174;425623;384060;69;809683
75;2020-11-16;67;57;124;325086;276298;79;601384
75;2020-11-16;129;74;203;213986;139308;89;353294
75;2020-11-16;124;34;158;77600;28200;90;105800
75;2020-11-16;1117;800;1921;3113538;2886444;0;5999982
76;2020-11-16;23;29;53;305956;318589;09;624545
76;2020-11-16;116;113;232;338942;356969;19;695911
76;2020-11-16;166;107;273;316210;319570;29;635780
76;2020-11-16;141;121;263;356758;337587;39;694345
76;2020-11-16;150;120;271;376541;363812;49;740353
76;2020-11-16;175;154;329;402608;383750;59;786358
76;2020-11-16;125;121;246;394889;358997;69;753886
76;2020-11-16;80;77;159;308664;263806;79;572470
76;2020-11-16;101;59;160;195838;129272;89;325110
76;2020-11-16;91;27;118;69372;26728;90;96100
76;2020-11-16;1172;928;2108;3065778;2859080;0;5924858
84;2020-11-16;103;121;227;459549;481088;09;940637
84;2020-11-16;404;472;882;487711;511905;19;999616
84;2020-11-16;469;339;809;443824;451094;29;894918
84;2020-11-16;540;380;921;512522;493262;39;1005784
84;2020-11-16;571;407;978;520248;515106;49;1035354
84;2020-11-16;542;485;1027;529611;514848;59;1044459
84;2020-11-16;306;289;595;486720;439940;69;926660
84;2020-11-16;211;188;399;372151;315211;79;687362
84;2020-11-16;285;148;433;237198;150524;89;387722
84;2020-11-16;238;75;313;81185;28680;90;109865
84;2020-11-16;3669;2905;6585;4130719;3901658;0;8032377
93;2020-11-16;45;51;96;268834;283093;09;551927
93;2020-11-16;120;168;288;280751;296087;19;576838
93;2020-11-16;211;157;368;254404;255552;29;509956
93;2020-11-16;200;176;378;310704;288398;39;599102
93;2020-11-16;204;152;356;325559;305827;49;631386
93;2020-11-16;215;182;397;353104;325389;59;678493
93;2020-11-16;140;135;275;336327;296459;69;632786
93;2020-11-16;106;104;210;279820;229699;79;509519
93;2020-11-16;136;88;225;171274;113716;89;284990
93;2020-11-16;92;41;134;58896;21758;90;80654
93;2020-11-16;1469;1254;2728;2639673;2415978;0;5055651
94;2020-11-16;2;0;2;16311;17433;09;33744
94;2020-11-16;4;4;8;16679;18132;19;34811
94;2020-11-16;2;2;4;16782;16579;29;33361
94;2020-11-16;5;5;10;23044;20580;39;43624
94;2020-11-16;4;8;12;23065;22140;49;45205
94;2020-11-16;6;4;10;24549;23421;59;47970
94;2020-11-16;4;7;11;23212;21883;69;45095
94;2020-11-16;1;4;5;19544;17141;79;36685
94;2020-11-16;0;2;2;11227;8178;89;19405
94;2020-11-16;0;0;0;3332;1447;90;4779
94;2020-11-16;28;36;64;177745;166934;0;344679
01;2020-11-17;0;0;0;19979;20155;09;40134
01;2020-11-17;2;0;2;24994;25489;19;50483
01;2020-11-17;0;0;0;17868;16690;29;34558
01;2020-11-17;1;2;3;22328;14821;39;37149
01;2020-11-17;0;2;2;28652;20276;49;48928
01;2020-11-17;4;3;7;33264;27260;59;60524
01;2020-11-17;1;0;1;27135;23978;69;51113
01;2020-11-17;0;1;1;18401;14661;79;33062
01;2020-11-17;0;1;1;9633;6375;89;16008
01;2020-11-17;1;0;1;3410;1510;90;4920
01;2020-11-17;9;9;18;205664;171215;0;376879
02;2020-11-17;0;1;1;16881;17110;09;33991
02;2020-11-17;5;2;7;21410;21604;19;43014
02;2020-11-17;3;3;6;16017;15479;29;31496
02;2020-11-17;9;1;10;19825;14455;39;34280
02;2020-11-17;5;6;11;24719;18248;49;42967
02;2020-11-17;6;4;10;34361;28310;59;62671
02;2020-11-17;3;1;4;28061;24495;69;52556
02;2020-11-17;1;3;4;18231;15278;79;33509
02;2020-11-17;1;0;1;11090;7677;89;18767
02;2020-11-17;2;0;2;3992;1506;90;5498
02;2020-11-17;35;21;56;194587;164162;0;358749
03;2020-11-17;1;1;2;31123;30920;09;62043
03;2020-11-17;5;3;8;29370;29268;19;58638
03;2020-11-17;6;1;7;21458;18963;29;40421
03;2020-11-17;3;4;7;21276;18326;39;39602
03;2020-11-17;1;1;2;18164;16593;49;34757
03;2020-11-17;3;2;5;13469;13557;59;27026
03;2020-11-17;2;0;2;8776;8670;69;17446
03;2020-11-17;0;0;0;3777;3591;79;7368
03;2020-11-17;0;0;0;1649;1072;89;2721
03;2020-11-17;0;0;0;485;184;90;669
03;2020-11-17;21;12;33;149547;141144;0;290691
04;2020-11-17;1;0;1;60314;61377;09;121691
04;2020-11-17;9;8;17;66065;68387;19;134452
04;2020-11-17;4;3;7;51059;47156;29;98215
04;2020-11-17;7;7;14;58788;45780;39;104568
04;2020-11-17;10;4;14;61408;52207;49;113615
04;2020-11-17;15;2;17;64838;60759;59;125597
04;2020-11-17;7;7;14;47008;42843;69;89851
04;2020-11-17;0;3;3;25509;21184;79;46693
04;2020-11-17;1;2;3;13168;7647;89;20815
04;2020-11-17;1;0;1;3209;1253;90;4462
04;2020-11-17;55;36;91;451366;408593;0;859959
05;2020-11-17;0;0;0;362.366008612902;341.338819562748;09;703.704828175651
05;2020-11-17;0;0;0;353.376145114279;370.349735405642;19;723.725880519921
05;2020-11-17;0;0;0;218.593559489256;256.539602589476;29;475.133162078732
05;2020-11-17;0;0;0;404.225408693299;360.321910454353;39;764.547319147651
05;2020-11-17;0;0;0;520.067953604221;497.108383964256;49;1017.17633756848
05;2020-11-17;0;0;0;468.146063921917;510.087601910415;59;978.233665832332
05;2020-11-17;0;0;0;340.368470050554;334.366842191253;69;674.735312241807
05;2020-11-17;0;0;0;212.598666888387;192.597753227106;79;405.196420115493
05;2020-11-17;0;0;0;148.727797095705;61.8681715431829;89;210.595968638888
05;2020-11-17;0;0;0;32.9601271090696;10.9909785719784;90;43.9511056810479
05;2020-11-17;0;0;0;3061.43020057959;2935.56979942041;0;5997
06;2020-11-17;1;0;1;42583;42380;09;84963
06;2020-11-17;2;1;3;33369;31925;19;65294
06;2020-11-17;3;2;5;21571;15080;29;36651
06;2020-11-17;6;3;9;21550;16147;39;37697
06;2020-11-17;3;3;6;14193;13939;49;28132
06;2020-11-17;3;2;5;7171;7597;59;14768
06;2020-11-17;1;2;3;3629;4117;69;7746
06;2020-11-17;0;0;0;1577;1457;79;3034
06;2020-11-17;0;0;0;531;474;89;1005
06;2020-11-17;0;0;0;88;93;90;181
06;2020-11-17;19;13;32;146262;133209;0;279471
07;2020-11-17;0;0;0;485;549;09;1034
07;2020-11-17;0;0;0;403;432;19;835
07;2020-11-17;0;1;1;764;841;29;1605
07;2020-11-17;0;0;0;824;928;39;1752
07;2020-11-17;0;0;0;788;1020;49;1808
07;2020-11-17;0;0;0;678;870;59;1548
07;2020-11-17;0;0;0;360;382;69;742
07;2020-11-17;0;0;0;231;190;79;421
07;2020-11-17;0;0;0;114;67;89;181
07;2020-11-17;0;0;0;24;11;90;35
07;2020-11-17;0;1;1;4671;5290;0;9961
08;2020-11-17;0;0;0;2715.22592983026;2997.75551488675;09;5712.98144471701
08;2020-11-17;1;0;1;2778.51901080978;3160.9156459093;19;5939.43465671908
08;2020-11-17;0;1;1;2080.8882988764;1718.16634315323;29;3799.05464202964
08;2020-11-17;1;2;3;2701.8582062647;1896.52641413317;39;4598.38462039786
08;2020-11-17;0;2;2;3151.45861023308;2460.52498233809;49;5611.98359257117
08;2020-11-17;0;0;0;2620.29868333099;2422.23566154656;59;5042.53434487755
08;2020-11-17;0;1;1;1621.44173420671;1438.58325779464;69;3060.02499200135
08;2020-11-17;0;0;0;626.575909335673;526.358467843651;79;1152.93437717932
08;2020-11-17;0;0;0;205.018522985054;140.993639349697;89;346.012162334751
08;2020-11-17;0;0;0;50.0325684687745;20.62259870351;90;70.6551671722846
08;2020-11-17;2;6;8;18551.3174743414;16782.6825256586;0;35334
11;2020-11-17;54;55;114;783071;811785;09;1594856
11;2020-11-17;216;246;474;761456;784653;19;1546109
11;2020-11-17;299;228;528;850145;801772;29;1651917
11;2020-11-17;346;259;606;914360;843488;39;1757848
11;2020-11-17;334;259;596;845609;826202;49;1671811
11;2020-11-17;273;236;509;793566;745070;59;1538636
11;2020-11-17;166;158;332;628649;549192;69;1177841
11;2020-11-17;102;101;203;434606;358356;79;792962
11;2020-11-17;103;73;176;261425;162933;89;424358
11;2020-11-17;79;26;105;89253;32619;90;121872
11;2020-11-17;1973;1641;3644;6362140;5916070;0;12278210
24;2020-11-17;7;10;17;139720;144686;09;284406
24;2020-11-17;52;49;102;152979;161185;19;314164
24;2020-11-17;47;40;87;122237;126536;29;248773
24;2020-11-17;53;43;96;150359;142009;39;292368
24;2020-11-17;74;47;121;161829;158758;49;320587
24;2020-11-17;54;49;103;172552;168011;59;340563
24;2020-11-17;36;43;79;172509;158177;69;330686
24;2020-11-17;24;35;59;129428;110593;79;240021
24;2020-11-17;26;15;41;87342;56882;89;144224
24;2020-11-17;29;9;38;31210;12071;90;43281
24;2020-11-17;402;340;743;1320165;1238908;0;2559073
27;2020-11-17;20;28;48;143373;149679;09;293052
27;2020-11-17;87;110;197;160962;173003;19;333965
27;2020-11-17;97;66;163;133746;142254;29;276000
27;2020-11-17;92;70;162;160004;155407;39;315411
27;2020-11-17;114;77;191;172333;169564;49;341897
27;2020-11-17;113;89;202;189979;183788;59;373767
27;2020-11-17;74;65;139;192591;178206;69;370797
27;2020-11-17;65;65;130;146876;127546;79;274422
27;2020-11-17;71;41;112;96896;61575;89;158471
27;2020-11-17;66;15;81;33148;12109;90;45257
27;2020-11-17;799;626;1425;1429908;1353131;0;2783039
28;2020-11-17;12;18;32;180735;186856;09;367591
28;2020-11-17;69;64;133;200125;213621;19;413746
28;2020-11-17;63;46;110;168922;173007;29;341929
28;2020-11-17;69;42;111;196628;188487;39;385115
28;2020-11-17;84;47;132;205396;201699;49;407095
28;2020-11-17;79;55;134;222002;213866;59;435868
28;2020-11-17;51;48;100;224688;203758;69;428446
28;2020-11-17;35;34;69;163192;135543;79;298735
28;2020-11-17;74;36;110;109691;65377;89;175068
28;2020-11-17;50;9;59;37222;12685;90;49907
28;2020-11-17;586;399;990;1708601;1594899;0;3303500
32;2020-11-17;57;31;88;358062;373689;09;731751
32;2020-11-17;153;137;290;387045;406742;19;793787
32;2020-11-17;131;120;251;342304;348587;29;690891
32;2020-11-17;163;125;288;382485;369972;39;752457
32;2020-11-17;179;121;300;382510;376716;49;759226
32;2020-11-17;137;147;284;386937;376527;59;763464
32;2020-11-17;114;102;216;371211;330938;69;702149
32;2020-11-17;79;70;149;250542;201459;79;452001
32;2020-11-17;99;47;146;163399;89786;89;253185
32;2020-11-17;57;14;71;48384;15367;90;63751
32;2020-11-17;1170;914;2084;3072879;2889783;0;5962662
44;2020-11-17;26;42;68;291525;306839;09;598364
44;2020-11-17;123;128;252;320255;339504;19;659759
44;2020-11-17;148;113;261;302020;314428;29;616448
44;2020-11-17;158;135;293;342222;333292;39;675514
44;2020-11-17;150;127;278;349727;344491;49;694218
44;2020-11-17;141;118;260;381371;373239;59;754610
44;2020-11-17;71;66;140;367165;335850;69;703015
44;2020-11-17;75;65;142;250387;215436;79;465823
44;2020-11-17;109;54;164;170825;105192;89;276017
44;2020-11-17;70;22;94;51248;16731;90;67979
44;2020-11-17;1071;870;1952;2826745;2685002;0;5511747
52;2020-11-17;5;21;29;213594;223900;09;437494
52;2020-11-17;47;39;89;240818;255197;19;496015
52;2020-11-17;57;45;102;197010;200630;29;397640
52;2020-11-17;74;36;110;231204;224885;39;456089
52;2020-11-17;63;48;111;243874;243418;49;487292
52;2020-11-17;62;49;111;244100;239116;59;483216
52;2020-11-17;40;39;79;241796;221345;69;463141
52;2020-11-17;26;25;51;177805;149903;79;327708
52;2020-11-17;49;33;82;119561;75822;89;195383
52;2020-11-17;44;10;54;42559;15260;90;57819
52;2020-11-17;467;345;818;1952321;1849476;0;3801797
53;2020-11-17;10;4;15;173813;182358;09;356171
53;2020-11-17;26;19;46;202720;214740;19;417460
53;2020-11-17;25;24;58;163116;173196;29;336312
53;2020-11-17;24;23;47;190526;187674;39;378200
53;2020-11-17;28;19;47;212098;212015;49;424113
53;2020-11-17;24;27;51;223699;219176;59;442875
53;2020-11-17;14;20;34;227435;209274;69;436709
53;2020-11-17;9;7;16;169992;140910;79;310902
53;2020-11-17;29;17;46;118117;69883;89;188000
53;2020-11-17;27;4;31;37370;12267;90;49637
53;2020-11-17;216;164;391;1718886;1621493;0;3340379
75;2020-11-17;15;21;38;293104;305291;09;598395
75;2020-11-17;93;62;155;337141;357785;19;694926
75;2020-11-17;96;74;170;295024;300618;29;595642
75;2020-11-17;95;76;171;347871;331233;39;679104
75;2020-11-17;119;75;194;384742;372771;49;757513
75;2020-11-17;93;79;172;413361;390880;59;804241
75;2020-11-17;59;78;137;425623;384060;69;809683
75;2020-11-17;48;42;91;325086;276298;79;601384
75;2020-11-17;93;47;140;213986;139308;89;353294
75;2020-11-17;83;26;109;77600;28200;90;105800
75;2020-11-17;794;580;1377;3113538;2886444;0;5999982
76;2020-11-17;16;27;45;305956;318589;09;624545
76;2020-11-17;60;58;119;338942;356969;19;695911
76;2020-11-17;95;102;198;316210;319570;29;635780
76;2020-11-17;102;84;186;356758;337587;39;694345
76;2020-11-17;109;83;192;376541;363812;49;740353
76;2020-11-17;108;93;201;402608;383750;59;786358
76;2020-11-17;72;61;133;394889;358997;69;753886
76;2020-11-17;58;60;118;308664;263806;79;572470
76;2020-11-17;78;46;124;195838;129272;89;325110
76;2020-11-17;62;15;77;69372;26728;90;96100
76;2020-11-17;763;631;1398;3065778;2859080;0;5924858
84;2020-11-17;67;66;140;459549;481088;09;940637
84;2020-11-17;325;278;607;487711;511905;19;999616
84;2020-11-17;315;269;584;443824;451094;29;894918
84;2020-11-17;327;243;571;512522;493262;39;1005784
84;2020-11-17;361;319;680;520248;515106;49;1035354
84;2020-11-17;302;273;575;529611;514848;59;1044459
84;2020-11-17;210;186;396;486720;439940;69;926660
84;2020-11-17;183;166;349;372151;315211;79;687362
84;2020-11-17;218;112;330;237198;150524;89;387722
84;2020-11-17;213;50;263;81185;28680;90;109865
84;2020-11-17;2521;1962;4495;4130719;3901658;0;8032377
93;2020-11-17;70;89;199;268834;283093;09;551927
93;2020-11-17;116;110;227;280751;296087;19;576838
93;2020-11-17;123;112;235;254404;255552;29;509956
93;2020-11-17;136;118;254;310704;288398;39;599102
93;2020-11-17;157;129;286;325559;305827;49;631386
93;2020-11-17;152;120;272;353104;325389;59;678493
93;2020-11-17;94;95;190;336327;296459;69;632786
93;2020-11-17;80;77;157;279820;229699;79;509519
93;2020-11-17;84;40;124;171274;113716;89;284990
93;2020-11-17;74;18;92;58896;21758;90;80654
93;2020-11-17;1118;928;2173;2639673;2415978;0;5055651
94;2020-11-17;2;1;3;16311;17433;09;33744
94;2020-11-17;1;0;1;16679;18132;19;34811
94;2020-11-17;1;3;4;16782;16579;29;33361
94;2020-11-17;0;3;3;23044;20580;39;43624
94;2020-11-17;2;6;8;23065;22140;49;45205
94;2020-11-17;3;3;6;24549;23421;59;47970
94;2020-11-17;4;4;8;23212;21883;69;45095
94;2020-11-17;1;3;4;19544;17141;79;36685
94;2020-11-17;1;1;2;11227;8178;89;19405
94;2020-11-17;0;0;0;3332;1447;90;4779
94;2020-11-17;15;24;39;177745;166934;0;344679
01;2020-11-18;0;0;0;19979;20155;09;40134
01;2020-11-18;1;2;3;24994;25489;19;50483
01;2020-11-18;0;1;1;17868;16690;29;34558
01;2020-11-18;2;1;3;22328;14821;39;37149
01;2020-11-18;2;0;2;28652;20276;49;48928
01;2020-11-18;0;0;0;33264;27260;59;60524
01;2020-11-18;2;0;2;27135;23978;69;51113
01;2020-11-18;1;1;2;18401;14661;79;33062
01;2020-11-18;1;0;1;9633;6375;89;16008
01;2020-11-18;0;1;1;3410;1510;90;4920
01;2020-11-18;9;6;15;205664;171215;0;376879
02;2020-11-18;0;0;0;16881;17110;09;33991
02;2020-11-18;3;1;4;21410;21604;19;43014
02;2020-11-18;1;1;2;16017;15479;29;31496
02;2020-11-18;1;2;3;19825;14455;39;34280
02;2020-11-18;4;3;7;24719;18248;49;42967
02;2020-11-18;3;4;7;34361;28310;59;62671
02;2020-11-18;1;2;3;28061;24495;69;52556
02;2020-11-18;0;2;2;18231;15278;79;33509
02;2020-11-18;0;1;1;11090;7677;89;18767
02;2020-11-18;0;0;0;3992;1506;90;5498
02;2020-11-18;13;16;29;194587;164162;0;358749
03;2020-11-18;0;0;0;31123;30920;09;62043
03;2020-11-18;2;3;5;29370;29268;19;58638
03;2020-11-18;1;2;3;21458;18963;29;40421
03;2020-11-18;3;3;6;21276;18326;39;39602
03;2020-11-18;3;1;4;18164;16593;49;34757
03;2020-11-18;1;0;1;13469;13557;59;27026
03;2020-11-18;0;0;0;8776;8670;69;17446
03;2020-11-18;0;1;1;3777;3591;79;7368
03;2020-11-18;0;0;0;1649;1072;89;2721
03;2020-11-18;0;0;0;485;184;90;669
03;2020-11-18;10;10;20;149547;141144;0;290691
04;2020-11-18;5;5;10;60314;61377;09;121691
04;2020-11-18;7;17;24;66065;68387;19;134452
04;2020-11-18;9;5;14;51059;47156;29;98215
04;2020-11-18;15;5;20;58788;45780;39;104568
04;2020-11-18;7;5;12;61408;52207;49;113615
04;2020-11-18;6;9;15;64838;60759;59;125597
04;2020-11-18;7;5;12;47008;42843;69;89851
04;2020-11-18;1;3;4;25509;21184;79;46693
04;2020-11-18;1;0;1;13168;7647;89;20815
04;2020-11-18;0;0;0;3209;1253;90;4462
04;2020-11-18;58;54;112;451366;408593;0;859959
05;2020-11-18;0;0;0;362.366008612902;341.338819562748;09;703.704828175651
05;2020-11-18;0;0;0;353.376145114279;370.349735405642;19;723.725880519921
05;2020-11-18;0;0;0;218.593559489256;256.539602589476;29;475.133162078732
05;2020-11-18;0;0;0;404.225408693299;360.321910454353;39;764.547319147651
05;2020-11-18;0;0;0;520.067953604221;497.108383964256;49;1017.17633756848
05;2020-11-18;0;0;0;468.146063921917;510.087601910415;59;978.233665832332
05;2020-11-18;0;0;0;340.368470050554;334.366842191253;69;674.735312241807
05;2020-11-18;0;0;0;212.598666888387;192.597753227106;79;405.196420115493
05;2020-11-18;0;0;0;148.727797095705;61.8681715431829;89;210.595968638888
05;2020-11-18;0;0;0;32.9601271090696;10.9909785719784;90;43.9511056810479
05;2020-11-18;0;0;0;3061.43020057959;2935.56979942041;0;5997
06;2020-11-18;1;0;1;42583;42380;09;84963
06;2020-11-18;3;3;6;33369;31925;19;65294
06;2020-11-18;3;1;4;21571;15080;29;36651
06;2020-11-18;4;2;6;21550;16147;39;37697
06;2020-11-18;1;2;3;14193;13939;49;28132
06;2020-11-18;2;2;4;7171;7597;59;14768
06;2020-11-18;2;2;4;3629;4117;69;7746
06;2020-11-18;1;1;2;1577;1457;79;3034
06;2020-11-18;0;0;0;531;474;89;1005
06;2020-11-18;0;0;0;88;93;90;181
06;2020-11-18;17;13;30;146262;133209;0;279471
07;2020-11-18;0;0;0;485;549;09;1034
07;2020-11-18;0;0;0;403;432;19;835
07;2020-11-18;1;1;2;764;841;29;1605
07;2020-11-18;0;0;0;824;928;39;1752
07;2020-11-18;0;0;0;788;1020;49;1808
07;2020-11-18;0;0;0;678;870;59;1548
07;2020-11-18;0;0;0;360;382;69;742
07;2020-11-18;0;0;0;231;190;79;421
07;2020-11-18;0;0;0;114;67;89;181
07;2020-11-18;0;0;0;24;11;90;35
07;2020-11-18;1;1;2;4671;5290;0;9961
08;2020-11-18;0;0;0;2715.22592983026;2997.75551488675;09;5712.98144471701
08;2020-11-18;0;0;0;2778.51901080978;3160.9156459093;19;5939.43465671908
08;2020-11-18;1;0;1;2080.8882988764;1718.16634315323;29;3799.05464202964
08;2020-11-18;1;1;2;2701.8582062647;1896.52641413317;39;4598.38462039786
08;2020-11-18;1;1;2;3151.45861023308;2460.52498233809;49;5611.98359257117
08;2020-11-18;0;0;0;2620.29868333099;2422.23566154656;59;5042.53434487755
08;2020-11-18;0;1;1;1621.44173420671;1438.58325779464;69;3060.02499200135
08;2020-11-18;0;0;0;626.575909335673;526.358467843651;79;1152.93437717932
08;2020-11-18;0;0;0;205.018522985054;140.993639349697;89;346.012162334751
08;2020-11-18;0;0;0;50.0325684687745;20.62259870351;90;70.6551671722846
08;2020-11-18;3;3;6;18551.3174743414;16782.6825256586;0;35334
11;2020-11-18;71;65;143;783071;811785;09;1594856
11;2020-11-18;199;221;438;761456;784653;19;1546109
11;2020-11-18;229;200;430;850145;801772;29;1651917
11;2020-11-18;257;240;498;914360;843488;39;1757848
11;2020-11-18;240;219;462;845609;826202;49;1671811
11;2020-11-18;232;219;454;793566;745070;59;1538636
11;2020-11-18;133;138;273;628649;549192;69;1177841
11;2020-11-18;91;78;169;434606;358356;79;792962
11;2020-11-18;93;54;147;261425;162933;89;424358
11;2020-11-18;55;20;75;89253;32619;90;121872
11;2020-11-18;1601;1454;3092;6362140;5916070;0;12278210
24;2020-11-18;7;8;15;139720;144686;09;284406
24;2020-11-18;58;51;109;152979;161185;19;314164
24;2020-11-18;44;38;82;122237;126536;29;248773
24;2020-11-18;47;29;76;150359;142009;39;292368
24;2020-11-18;67;40;107;161829;158758;49;320587
24;2020-11-18;51;40;91;172552;168011;59;340563
24;2020-11-18;29;33;62;172509;158177;69;330686
24;2020-11-18;24;19;43;129428;110593;79;240021
24;2020-11-18;32;26;58;87342;56882;89;144224
24;2020-11-18;37;10;47;31210;12071;90;43281
24;2020-11-18;396;294;690;1320165;1238908;0;2559073
27;2020-11-18;20;22;43;143373;149679;09;293052
27;2020-11-18;76;83;160;160962;173003;19;333965
27;2020-11-18;80;50;130;133746;142254;29;276000
27;2020-11-18;79;45;124;160004;155407;39;315411
27;2020-11-18;68;56;124;172333;169564;49;341897
27;2020-11-18;77;76;153;189979;183788;59;373767
27;2020-11-18;59;56;115;192591;178206;69;370797
27;2020-11-18;46;41;87;146876;127546;79;274422
27;2020-11-18;67;39;106;96896;61575;89;158471
27;2020-11-18;52;13;65;33148;12109;90;45257
27;2020-11-18;624;482;1108;1429908;1353131;0;2783039
28;2020-11-18;16;17;34;180735;186856;09;367591
28;2020-11-18;42;37;81;200125;213621;19;413746
28;2020-11-18;51;48;99;168922;173007;29;341929
28;2020-11-18;55;30;85;196628;188487;39;385115
28;2020-11-18;62;48;110;205396;201699;49;407095
28;2020-11-18;46;59;105;222002;213866;59;435868
28;2020-11-18;31;35;66;224688;203758;69;428446
28;2020-11-18;36;27;63;163192;135543;79;298735
28;2020-11-18;39;21;60;109691;65377;89;175068
28;2020-11-18;24;10;34;37222;12685;90;49907
28;2020-11-18;402;332;737;1708601;1594899;0;3303500
32;2020-11-18;31;22;54;358062;373689;09;731751
32;2020-11-18;126;120;247;387045;406742;19;793787
32;2020-11-18;139;118;257;342304;348587;29;690891
32;2020-11-18;146;95;241;382485;369972;39;752457
32;2020-11-18;131;114;245;382510;376716;49;759226
32;2020-11-18;140;99;239;386937;376527;59;763464
32;2020-11-18;84;86;170;371211;330938;69;702149
32;2020-11-18;66;60;126;250542;201459;79;452001
32;2020-11-18;92;50;142;163399;89786;89;253185
32;2020-11-18;56;12;68;48384;15367;90;63751
32;2020-11-18;1011;776;1789;3072879;2889783;0;5962662
44;2020-11-18;28;34;62;291525;306839;09;598364
44;2020-11-18;126;127;257;320255;339504;19;659759
44;2020-11-18;92;71;165;302020;314428;29;616448
44;2020-11-18;122;88;213;342222;333292;39;675514
44;2020-11-18;134;107;243;349727;344491;49;694218
44;2020-11-18;115;99;218;381371;373239;59;754610
44;2020-11-18;67;84;152;367165;335850;69;703015
44;2020-11-18;41;61;102;250387;215436;79;465823
44;2020-11-18;92;33;126;170825;105192;89;276017
44;2020-11-18;73;15;88;51248;16731;90;67979
44;2020-11-18;890;719;1626;2826745;2685002;0;5511747
52;2020-11-18;10;16;27;213594;223900;09;437494
52;2020-11-18;51;38;90;240818;255197;19;496015
52;2020-11-18;48;32;80;197010;200630;29;397640
52;2020-11-18;49;27;76;231204;224885;39;456089
52;2020-11-18;71;48;119;243874;243418;49;487292
52;2020-11-18;62;48;110;244100;239116;59;483216
52;2020-11-18;32;37;69;241796;221345;69;463141
52;2020-11-18;27;17;44;177805;149903;79;327708
52;2020-11-18;44;21;65;119561;75822;89;195383
52;2020-11-18;30;12;42;42559;15260;90;57819
52;2020-11-18;424;296;722;1952321;1849476;0;3801797
53;2020-11-18;4;9;15;173813;182358;09;356171
53;2020-11-18;22;13;38;202720;214740;19;417460
53;2020-11-18;20;25;47;163116;173196;29;336312
53;2020-11-18;11;13;24;190526;187674;39;378200
53;2020-11-18;27;18;45;212098;212015;49;424113
53;2020-11-18;20;17;37;223699;219176;59;442875
53;2020-11-18;17;14;31;227435;209274;69;436709
53;2020-11-18;12;7;19;169992;140910;79;310902
53;2020-11-18;8;5;13;118117;69883;89;188000
53;2020-11-18;8;1;9;37370;12267;90;49637
53;2020-11-18;149;122;278;1718886;1621493;0;3340379
75;2020-11-18;24;21;45;293104;305291;09;598395
75;2020-11-18;47;64;112;337141;357785;19;694926
75;2020-11-18;85;46;131;295024;300618;29;595642
75;2020-11-18;77;70;147;347871;331233;39;679104
75;2020-11-18;83;58;141;384742;372771;49;757513
75;2020-11-18;82;62;144;413361;390880;59;804241
75;2020-11-18;52;44;97;425623;384060;69;809683
75;2020-11-18;42;38;80;325086;276298;79;601384
75;2020-11-18;50;30;80;213986;139308;89;353294
75;2020-11-18;49;16;65;77600;28200;90;105800
75;2020-11-18;591;449;1042;3113538;2886444;0;5999982
76;2020-11-18;15;18;33;305956;318589;09;624545
76;2020-11-18;73;56;132;338942;356969;19;695911
76;2020-11-18;78;45;123;316210;319570;29;635780
76;2020-11-18;75;49;124;356758;337587;39;694345
76;2020-11-18;78;52;130;376541;363812;49;740353
76;2020-11-18;77;56;133;402608;383750;59;786358
76;2020-11-18;44;67;111;394889;358997;69;753886
76;2020-11-18;48;44;92;308664;263806;79;572470
76;2020-11-18;64;36;101;195838;129272;89;325110
76;2020-11-18;62;11;73;69372;26728;90;96100
76;2020-11-18;615;437;1056;3065778;2859080;0;5924858
84;2020-11-18;64;70;135;459549;481088;09;940637
84;2020-11-18;245;261;513;487711;511905;19;999616
84;2020-11-18;225;198;424;443824;451094;29;894918
84;2020-11-18;252;192;444;512522;493262;39;1005784
84;2020-11-18;274;214;488;520248;515106;49;1035354
84;2020-11-18;250;247;497;529611;514848;59;1044459
84;2020-11-18;151;151;302;486720;439940;69;926660
84;2020-11-18;107;118;225;372151;315211;79;687362
84;2020-11-18;185;82;267;237198;150524;89;387722
84;2020-11-18;151;41;192;81185;28680;90;109865
84;2020-11-18;1904;1574;3487;4130719;3901658;0;8032377
93;2020-11-18;26;30;56;268834;283093;09;551927
93;2020-11-18;71;88;159;280751;296087;19;576838
93;2020-11-18;112;92;204;254404;255552;29;509956
93;2020-11-18;95;89;185;310704;288398;39;599102
93;2020-11-18;110;84;194;325559;305827;49;631386
93;2020-11-18;115;88;204;353104;325389;59;678493
93;2020-11-18;79;74;153;336327;296459;69;632786
93;2020-11-18;56;66;122;279820;229699;79;509519
93;2020-11-18;77;43;120;171274;113716;89;284990
93;2020-11-18;51;20;71;58896;21758;90;80654
93;2020-11-18;793;674;1482;2639673;2415978;0;5055651
94;2020-11-18;0;0;0;16311;17433;09;33744
94;2020-11-18;1;0;2;16679;18132;19;34811
94;2020-11-18;1;0;1;16782;16579;29;33361
94;2020-11-18;2;4;6;23044;20580;39;43624
94;2020-11-18;2;2;4;23065;22140;49;45205
94;2020-11-18;1;0;1;24549;23421;59;47970
94;2020-11-18;1;0;1;23212;21883;69;45095
94;2020-11-18;1;1;2;19544;17141;79;36685
94;2020-11-18;0;1;1;11227;8178;89;19405
94;2020-11-18;1;0;1;3332;1447;90;4779
94;2020-11-18;10;8;19;177745;166934;0;344679
01;2020-11-19;0;0;0;19979;20155;09;40134
01;2020-11-19;2;4;6;24994;25489;19;50483
01;2020-11-19;2;2;4;17868;16690;29;34558
01;2020-11-19;2;3;5;22328;14821;39;37149
01;2020-11-19;1;1;2;28652;20276;49;48928
01;2020-11-19;1;0;1;33264;27260;59;60524
01;2020-11-19;2;1;3;27135;23978;69;51113
01;2020-11-19;0;0;0;18401;14661;79;33062
01;2020-11-19;1;0;1;9633;6375;89;16008
01;2020-11-19;1;0;1;3410;1510;90;4920
01;2020-11-19;12;11;23;205664;171215;0;376879
02;2020-11-19;0;0;0;16881;17110;09;33991
02;2020-11-19;1;4;5;21410;21604;19;43014
02;2020-11-19;1;2;3;16017;15479;29;31496
02;2020-11-19;4;5;9;19825;14455;39;34280
02;2020-11-19;4;3;7;24719;18248;49;42967
02;2020-11-19;9;3;12;34361;28310;59;62671
02;2020-11-19;2;0;3;28061;24495;69;52556
02;2020-11-19;1;2;3;18231;15278;79;33509
02;2020-11-19;1;0;1;11090;7677;89;18767
02;2020-11-19;0;0;0;3992;1506;90;5498
02;2020-11-19;23;19;43;194587;164162;0;358749
03;2020-11-19;0;0;0;31123;30920;09;62043
03;2020-11-19;2;2;4;29370;29268;19;58638
03;2020-11-19;1;2;3;21458;18963;29;40421
03;2020-11-19;6;1;7;21276;18326;39;39602
03;2020-11-19;4;1;5;18164;16593;49;34757
03;2020-11-19;1;1;2;13469;13557;59;27026
03;2020-11-19;0;0;0;8776;8670;69;17446
03;2020-11-19;0;0;0;3777;3591;79;7368
03;2020-11-19;1;1;2;1649;1072;89;2721
03;2020-11-19;0;0;0;485;184;90;669
03;2020-11-19;15;8;23;149547;141144;0;290691
04;2020-11-19;6;4;10;60314;61377;09;121691
04;2020-11-19;11;5;17;66065;68387;19;134452
04;2020-11-19;8;8;16;51059;47156;29;98215
04;2020-11-19;8;5;13;58788;45780;39;104568
04;2020-11-19;8;6;14;61408;52207;49;113615
04;2020-11-19;9;4;13;64838;60759;59;125597
04;2020-11-19;3;7;10;47008;42843;69;89851
04;2020-11-19;0;1;1;25509;21184;79;46693
04;2020-11-19;0;1;1;13168;7647;89;20815
04;2020-11-19;0;0;0;3209;1253;90;4462
04;2020-11-19;53;41;95;451366;408593;0;859959
05;2020-11-19;0;0;0;362.366008612902;341.338819562748;09;703.704828175651
05;2020-11-19;0;0;0;353.376145114279;370.349735405642;19;723.725880519921
05;2020-11-19;0;0;0;218.593559489256;256.539602589476;29;475.133162078732
05;2020-11-19;0;0;0;404.225408693299;360.321910454353;39;764.547319147651
05;2020-11-19;0;0;0;520.067953604221;497.108383964256;49;1017.17633756848
05;2020-11-19;0;0;0;468.146063921917;510.087601910415;59;978.233665832332
05;2020-11-19;0;0;0;340.368470050554;334.366842191253;69;674.735312241807
05;2020-11-19;0;0;0;212.598666888387;192.597753227106;79;405.196420115493
05;2020-11-19;0;0;0;148.727797095705;61.8681715431829;89;210.595968638888
05;2020-11-19;0;0;0;32.9601271090696;10.9909785719784;90;43.9511056810479
05;2020-11-19;0;0;0;3061.43020057959;2935.56979942041;0;5997
06;2020-11-19;0;0;0;42583;42380;09;84963
06;2020-11-19;3;1;4;33369;31925;19;65294
06;2020-11-19;3;1;4;21571;15080;29;36651
06;2020-11-19;2;1;3;21550;16147;39;37697
06;2020-11-19;2;1;3;14193;13939;49;28132
06;2020-11-19;1;2;3;7171;7597;59;14768
06;2020-11-19;1;1;2;3629;4117;69;7746
06;2020-11-19;1;0;1;1577;1457;79;3034
06;2020-11-19;0;0;0;531;474;89;1005
06;2020-11-19;0;0;0;88;93;90;181
06;2020-11-19;13;7;20;146262;133209;0;279471
07;2020-11-19;0;0;0;485;549;09;1034
07;2020-11-19;0;0;0;403;432;19;835
07;2020-11-19;0;1;1;764;841;29;1605
07;2020-11-19;1;0;1;824;928;39;1752
07;2020-11-19;0;1;1;788;1020;49;1808
07;2020-11-19;0;0;0;678;870;59;1548
07;2020-11-19;0;0;0;360;382;69;742
07;2020-11-19;0;0;0;231;190;79;421
07;2020-11-19;0;0;0;114;67;89;181
07;2020-11-19;0;0;0;24;11;90;35
07;2020-11-19;1;2;3;4671;5290;0;9961
08;2020-11-19;0;0;0;2715.22592983026;2997.75551488675;09;5712.98144471701
08;2020-11-19;0;0;0;2778.51901080978;3160.9156459093;19;5939.43465671908
08;2020-11-19;0;0;0;2080.8882988764;1718.16634315323;29;3799.05464202964
08;2020-11-19;1;0;1;2701.8582062647;1896.52641413317;39;4598.38462039786
08;2020-11-19;1;1;2;3151.45861023308;2460.52498233809;49;5611.98359257117
08;2020-11-19;0;0;0;2620.29868333099;2422.23566154656;59;5042.53434487755
08;2020-11-19;0;0;0;1621.44173420671;1438.58325779464;69;3060.02499200135
08;2020-11-19;0;0;0;626.575909335673;526.358467843651;79;1152.93437717932
08;2020-11-19;0;0;0;205.018522985054;140.993639349697;89;346.012162334751
08;2020-11-19;0;0;0;50.0325684687745;20.62259870351;90;70.6551671722846
08;2020-11-19;2;1;3;18551.3174743414;16782.6825256586;0;35334
11;2020-11-19;47;60;110;783071;811785;09;1594856
11;2020-11-19;183;191;385;761456;784653;19;1546109
11;2020-11-19;220;208;429;850145;801772;29;1651917
11;2020-11-19;277;194;473;914360;843488;39;1757848
11;2020-11-19;246;210;456;845609;826202;49;1671811
11;2020-11-19;197;182;379;793566;745070;59;1538636
11;2020-11-19;163;141;306;628649;549192;69;1177841
11;2020-11-19;99;81;181;434606;358356;79;792962
11;2020-11-19;87;48;136;261425;162933;89;424358
11;2020-11-19;31;16;47;89253;32619;90;121872
11;2020-11-19;1550;1334;2907;6362140;5916070;0;12278210
24;2020-11-19;12;5;17;139720;144686;09;284406
24;2020-11-19;38;31;69;152979;161185;19;314164
24;2020-11-19;45;25;70;122237;126536;29;248773
24;2020-11-19;38;40;78;150359;142009;39;292368
24;2020-11-19;59;33;92;161829;158758;49;320587
24;2020-11-19;38;44;82;172552;168011;59;340563
24;2020-11-19;17;21;38;172509;158177;69;330686
24;2020-11-19;13;24;37;129428;110593;79;240021
24;2020-11-19;23;13;36;87342;56882;89;144224
24;2020-11-19;11;9;20;31210;12071;90;43281
24;2020-11-19;294;245;539;1320165;1238908;0;2559073
27;2020-11-19;23;19;42;143373;149679;09;293052
27;2020-11-19;72;80;152;160962;173003;19;333965
27;2020-11-19;70;59;129;133746;142254;29;276000
27;2020-11-19;89;51;140;160004;155407;39;315411
27;2020-11-19;87;62;149;172333;169564;49;341897
27;2020-11-19;75;73;148;189979;183788;59;373767
27;2020-11-19;52;51;103;192591;178206;69;370797
27;2020-11-19;44;36;80;146876;127546;79;274422
27;2020-11-19;55;29;84;96896;61575;89;158471
27;2020-11-19;45;15;60;33148;12109;90;45257
27;2020-11-19;612;475;1087;1429908;1353131;0;2783039
28;2020-11-19;17;15;33;180735;186856;09;367591
28;2020-11-19;45;52;98;200125;213621;19;413746
28;2020-11-19;60;31;91;168922;173007;29;341929
28;2020-11-19;58;28;86;196628;188487;39;385115
28;2020-11-19;60;38;98;205396;201699;49;407095
28;2020-11-19;56;36;92;222002;213866;59;435868
28;2020-11-19;48;36;84;224688;203758;69;428446
28;2020-11-19;26;26;52;163192;135543;79;298735
28;2020-11-19;44;24;68;109691;65377;89;175068
28;2020-11-19;30;15;45;37222;12685;90;49907
28;2020-11-19;444;301;747;1708601;1594899;0;3303500
32;2020-11-19;36;44;80;358062;373689;09;731751
32;2020-11-19;116;133;250;387045;406742;19;793787
32;2020-11-19;124;105;230;342304;348587;29;690891
32;2020-11-19;130;93;223;382485;369972;39;752457
32;2020-11-19;126;107;233;382510;376716;49;759226
32;2020-11-19;119;128;248;386937;376527;59;763464
32;2020-11-19;77;84;162;371211;330938;69;702149
32;2020-11-19;68;50;118;250542;201459;79;452001
32;2020-11-19;75;40;115;163399;89786;89;253185
32;2020-11-19;46;13;59;48384;15367;90;63751
32;2020-11-19;917;797;1720;3072879;2889783;0;5962662
44;2020-11-19;27;39;69;291525;306839;09;598364
44;2020-11-19;100;100;203;320255;339504;19;659759
44;2020-11-19;121;81;205;302020;314428;29;616448
44;2020-11-19;157;90;248;342222;333292;39;675514
44;2020-11-19;148;99;249;349727;344491;49;694218
44;2020-11-19;127;102;231;381371;373239;59;754610
44;2020-11-19;75;62;140;367165;335850;69;703015
44;2020-11-19;57;64;122;250387;215436;79;465823
44;2020-11-19;98;37;135;170825;105192;89;276017
44;2020-11-19;59;15;74;51248;16731;90;67979
44;2020-11-19;969;689;1676;2826745;2685002;0;5511747
52;2020-11-19;12;11;24;213594;223900;09;437494
52;2020-11-19;42;50;95;240818;255197;19;496015
52;2020-11-19;48;32;80;197010;200630;29;397640
52;2020-11-19;51;33;84;231204;224885;39;456089
52;2020-11-19;46;43;89;243874;243418;49;487292
52;2020-11-19;48;39;87;244100;239116;59;483216
52;2020-11-19;22;25;47;241796;221345;69;463141
52;2020-11-19;26;12;38;177805;149903;79;327708
52;2020-11-19;26;17;43;119561;75822;89;195383
52;2020-11-19;27;11;38;42559;15260;90;57819
52;2020-11-19;348;273;625;1952321;1849476;0;3801797
53;2020-11-19;5;10;15;173813;182358;09;356171
53;2020-11-19;18;24;44;202720;214740;19;417460
53;2020-11-19;23;20;44;163116;173196;29;336312
53;2020-11-19;28;14;42;190526;187674;39;378200
53;2020-11-19;20;23;43;212098;212015;49;424113
53;2020-11-19;23;23;46;223699;219176;59;442875
53;2020-11-19;12;15;27;227435;209274;69;436709
53;2020-11-19;16;3;19;169992;140910;79;310902
53;2020-11-19;16;9;25;118117;69883;89;188000
53;2020-11-19;19;5;24;37370;12267;90;49637
53;2020-11-19;180;146;329;1718886;1621493;0;3340379
75;2020-11-19;18;32;50;293104;305291;09;598395
75;2020-11-19;75;61;140;337141;357785;19;694926
75;2020-11-19;68;47;115;295024;300618;29;595642
75;2020-11-19;67;50;117;347871;331233;39;679104
75;2020-11-19;83;63;146;384742;372771;49;757513
75;2020-11-19;77;66;143;413361;390880;59;804241
75;2020-11-19;43;30;73;425623;384060;69;809683
75;2020-11-19;39;36;75;325086;276298;79;601384
75;2020-11-19;61;36;97;213986;139308;89;353294
75;2020-11-19;78;19;97;77600;28200;90;105800
75;2020-11-19;610;440;1054;3113538;2886444;0;5999982
76;2020-11-19;8;14;25;305956;318589;09;624545
76;2020-11-19;48;54;102;338942;356969;19;695911
76;2020-11-19;53;59;112;316210;319570;29;635780
76;2020-11-19;87;49;136;356758;337587;39;694345
76;2020-11-19;86;59;145;376541;363812;49;740353
76;2020-11-19;97;78;175;402608;383750;59;786358
76;2020-11-19;47;52;99;394889;358997;69;753886
76;2020-11-19;32;37;69;308664;263806;79;572470
76;2020-11-19;56;39;95;195838;129272;89;325110
76;2020-11-19;39;8;47;69372;26728;90;96100
76;2020-11-19;553;450;1006;3065778;2859080;0;5924858
84;2020-11-19;47;78;125;459549;481088;09;940637
84;2020-11-19;249;240;489;487711;511905;19;999616
84;2020-11-19;220;161;384;443824;451094;29;894918
84;2020-11-19;252;173;425;512522;493262;39;1005784
84;2020-11-19;284;218;502;520248;515106;49;1035354
84;2020-11-19;247;196;443;529611;514848;59;1044459
84;2020-11-19;149;148;297;486720;439940;69;926660
84;2020-11-19;112;117;229;372151;315211;79;687362
84;2020-11-19;208;103;311;237198;150524;89;387722
84;2020-11-19;179;47;226;81185;28680;90;109865
84;2020-11-19;1948;1481;3432;4130719;3901658;0;8032377
93;2020-11-19;28;19;47;268834;283093;09;551927
93;2020-11-19;67;79;147;280751;296087;19;576838
93;2020-11-19;82;77;159;254404;255552;29;509956
93;2020-11-19;111;79;190;310704;288398;39;599102
93;2020-11-19;123;90;213;325559;305827;49;631386
93;2020-11-19;115;76;195;353104;325389;59;678493
93;2020-11-19;76;69;145;336327;296459;69;632786
93;2020-11-19;68;49;117;279820;229699;79;509519
93;2020-11-19;73;44;117;171274;113716;89;284990
93;2020-11-19;72;15;87;58896;21758;90;80654
93;2020-11-19;815;598;1418;2639673;2415978;0;5055651
94;2020-11-19;0;0;0;16311;17433;09;33744
94;2020-11-19;1;1;2;16679;18132;19;34811
94;2020-11-19;3;4;7;16782;16579;29;33361
94;2020-11-19;1;2;3;23044;20580;39;43624
94;2020-11-19;3;1;4;23065;22140;49;45205
94;2020-11-19;0;5;5;24549;23421;59;47970
94;2020-11-19;1;2;3;23212;21883;69;45095
94;2020-11-19;0;0;0;19544;17141;79;36685
94;2020-11-19;0;0;0;11227;8178;89;19405
94;2020-11-19;0;0;0;3332;1447;90;4779
94;2020-11-19;9;15;24;177745;166934;0;344679
01;2020-11-20;1;0;1;19979;20155;09;40134
01;2020-11-20;0;0;0;24994;25489;19;50483
01;2020-11-20;0;0;0;17868;16690;29;34558
01;2020-11-20;4;2;6;22328;14821;39;37149
01;2020-11-20;0;0;0;28652;20276;49;48928
01;2020-11-20;4;2;6;33264;27260;59;60524
01;2020-11-20;1;0;1;27135;23978;69;51113
01;2020-11-20;1;0;1;18401;14661;79;33062
01;2020-11-20;0;0;0;9633;6375;89;16008
01;2020-11-20;0;0;0;3410;1510;90;4920
01;2020-11-20;11;4;15;205664;171215;0;376879
02;2020-11-20;0;0;0;16881;17110;09;33991
02;2020-11-20;5;2;7;21410;21604;19;43014
02;2020-11-20;0;2;2;16017;15479;29;31496
02;2020-11-20;2;3;5;19825;14455;39;34280
02;2020-11-20;4;1;5;24719;18248;49;42967
02;2020-11-20;2;2;4;34361;28310;59;62671
02;2020-11-20;2;1;3;28061;24495;69;52556
02;2020-11-20;2;1;3;18231;15278;79;33509
02;2020-11-20;0;0;0;11090;7677;89;18767
02;2020-11-20;0;0;0;3992;1506;90;5498
02;2020-11-20;17;12;29;194587;164162;0;358749
03;2020-11-20;3;1;4;31123;30920;09;62043
03;2020-11-20;3;0;3;29370;29268;19;58638
03;2020-11-20;4;0;4;21458;18963;29;40421
03;2020-11-20;4;1;5;21276;18326;39;39602
03;2020-11-20;3;3;6;18164;16593;49;34757
03;2020-11-20;2;0;2;13469;13557;59;27026
03;2020-11-20;1;0;1;8776;8670;69;17446
03;2020-11-20;1;1;2;3777;3591;79;7368
03;2020-11-20;0;0;0;1649;1072;89;2721
03;2020-11-20;1;1;2;485;184;90;669
03;2020-11-20;22;7;29;149547;141144;0;290691
04;2020-11-20;8;3;11;60314;61377;09;121691
04;2020-11-20;12;14;26;66065;68387;19;134452
04;2020-11-20;15;6;21;51059;47156;29;98215
04;2020-11-20;4;9;13;58788;45780;39;104568
04;2020-11-20;7;6;13;61408;52207;49;113615
04;2020-11-20;8;6;14;64838;60759;59;125597
04;2020-11-20;5;5;10;47008;42843;69;89851
04;2020-11-20;3;0;3;25509;21184;79;46693
04;2020-11-20;3;0;3;13168;7647;89;20815
04;2020-11-20;0;1;1;3209;1253;90;4462
04;2020-11-20;65;50;115;451366;408593;0;859959
05;2020-11-20;0;0;0;362.366008612902;341.338819562748;09;703.704828175651
05;2020-11-20;0;0;0;353.376145114279;370.349735405642;19;723.725880519921
05;2020-11-20;0;0;0;218.593559489256;256.539602589476;29;475.133162078732
05;2020-11-20;0;0;0;404.225408693299;360.321910454353;39;764.547319147651
05;2020-11-20;0;0;0;520.067953604221;497.108383964256;49;1017.17633756848
05;2020-11-20;0;0;0;468.146063921917;510.087601910415;59;978.233665832332
05;2020-11-20;0;0;0;340.368470050554;334.366842191253;69;674.735312241807
05;2020-11-20;0;0;0;212.598666888387;192.597753227106;79;405.196420115493
05;2020-11-20;0;0;0;148.727797095705;61.8681715431829;89;210.595968638888
05;2020-11-20;0;0;0;32.9601271090696;10.9909785719784;90;43.9511056810479
05;2020-11-20;0;0;0;3061.43020057959;2935.56979942041;0;5997
06;2020-11-20;0;0;0;42583;42380;09;84963
06;2020-11-20;1;3;4;33369;31925;19;65294
06;2020-11-20;3;2;5;21571;15080;29;36651
06;2020-11-20;3;4;7;21550;16147;39;37697
06;2020-11-20;3;1;4;14193;13939;49;28132
06;2020-11-20;3;2;5;7171;7597;59;14768
06;2020-11-20;0;2;2;3629;4117;69;7746
06;2020-11-20;0;0;0;1577;1457;79;3034
06;2020-11-20;0;0;0;531;474;89;1005
06;2020-11-20;0;0;0;88;93;90;181
06;2020-11-20;14;14;28;146262;133209;0;279471
07;2020-11-20;0;0;0;485;549;09;1034
07;2020-11-20;0;0;0;403;432;19;835
07;2020-11-20;0;1;1;764;841;29;1605
07;2020-11-20;0;2;2;824;928;39;1752
07;2020-11-20;0;1;1;788;1020;49;1808
07;2020-11-20;0;0;0;678;870;59;1548
07;2020-11-20;0;0;0;360;382;69;742
07;2020-11-20;0;0;0;231;190;79;421
07;2020-11-20;0;0;0;114;67;89;181
07;2020-11-20;0;0;0;24;11;90;35
07;2020-11-20;0;4;4;4671;5290;0;9961
08;2020-11-20;0;0;0;2715.22592983026;2997.75551488675;09;5712.98144471701
08;2020-11-20;0;2;2;2778.51901080978;3160.9156459093;19;5939.43465671908
08;2020-11-20;0;1;1;2080.8882988764;1718.16634315323;29;3799.05464202964
08;2020-11-20;0;0;0;2701.8582062647;1896.52641413317;39;4598.38462039786
08;2020-11-20;0;0;0;3151.45861023308;2460.52498233809;49;5611.98359257117
08;2020-11-20;1;0;1;2620.29868333099;2422.23566154656;59;5042.53434487755
08;2020-11-20;0;0;0;1621.44173420671;1438.58325779464;69;3060.02499200135
08;2020-11-20;1;0;1;626.575909335673;526.358467843651;79;1152.93437717932
08;2020-11-20;0;0;0;205.018522985054;140.993639349697;89;346.012162334751
08;2020-11-20;0;0;0;50.0325684687745;20.62259870351;90;70.6551671722846
08;2020-11-20;2;3;5;18551.3174743414;16782.6825256586;0;35334
11;2020-11-20;51;44;103;783071;811785;09;1594856
11;2020-11-20;201;168;376;761456;784653;19;1546109
11;2020-11-20;217;192;409;850145;801772;29;1651917
11;2020-11-20;249;177;426;914360;843488;39;1757848
11;2020-11-20;254;209;463;845609;826202;49;1671811
11;2020-11-20;195;178;374;793566;745070;59;1538636
11;2020-11-20;146;134;284;628649;549192;69;1177841
11;2020-11-20;75;82;158;434606;358356;79;792962
11;2020-11-20;78;46;124;261425;162933;89;424358
11;2020-11-20;62;13;75;89253;32619;90;121872
11;2020-11-20;1528;1245;2806;6362140;5916070;0;12278210
24;2020-11-20;11;10;21;139720;144686;09;284406
24;2020-11-20;29;43;72;152979;161185;19;314164
24;2020-11-20;43;20;64;122237;126536;29;248773
24;2020-11-20;50;38;88;150359;142009;39;292368
24;2020-11-20;37;40;77;161829;158758;49;320587
24;2020-11-20;36;22;58;172552;168011;59;340563
24;2020-11-20;25;28;53;172509;158177;69;330686
24;2020-11-20;18;14;32;129428;110593;79;240021
24;2020-11-20;14;12;26;87342;56882;89;144224
24;2020-11-20;13;3;16;31210;12071;90;43281
24;2020-11-20;276;230;507;1320165;1238908;0;2559073
27;2020-11-20;15;22;37;143373;149679;09;293052
27;2020-11-20;87;67;154;160962;173003;19;333965
27;2020-11-20;62;61;123;133746;142254;29;276000
27;2020-11-20;61;44;105;160004;155407;39;315411
27;2020-11-20;80;58;138;172333;169564;49;341897
27;2020-11-20;82;51;133;189979;183788;59;373767
27;2020-11-20;42;47;89;192591;178206;69;370797
27;2020-11-20;26;25;51;146876;127546;79;274422
27;2020-11-20;60;33;93;96896;61575;89;158471
27;2020-11-20;44;18;62;33148;12109;90;45257
27;2020-11-20;560;426;986;1429908;1353131;0;2783039
28;2020-11-20;13;15;28;180735;186856;09;367591
28;2020-11-20;43;49;93;200125;213621;19;413746
28;2020-11-20;56;39;95;168922;173007;29;341929
28;2020-11-20;54;29;83;196628;188487;39;385115
28;2020-11-20;64;33;97;205396;201699;49;407095
28;2020-11-20;50;37;87;222002;213866;59;435868
28;2020-11-20;38;35;73;224688;203758;69;428446
28;2020-11-20;33;25;58;163192;135543;79;298735
28;2020-11-20;37;16;53;109691;65377;89;175068
28;2020-11-20;36;10;46;37222;12685;90;49907
28;2020-11-20;425;288;714;1708601;1594899;0;3303500
32;2020-11-20;38;42;80;358062;373689;09;731751
32;2020-11-20;132;122;255;387045;406742;19;793787
32;2020-11-20;120;98;218;342304;348587;29;690891
32;2020-11-20;142;89;231;382485;369972;39;752457
32;2020-11-20;138;113;251;382510;376716;49;759226
32;2020-11-20;126;109;235;386937;376527;59;763464
32;2020-11-20;85;70;155;371211;330938;69;702149
32;2020-11-20;69;54;123;250542;201459;79;452001
32;2020-11-20;68;42;110;163399;89786;89;253185
32;2020-11-20;65;19;84;48384;15367;90;63751
32;2020-11-20;983;758;1742;3072879;2889783;0;5962662
44;2020-11-20;36;40;77;291525;306839;09;598364
44;2020-11-20;117;130;249;320255;339504;19;659759
44;2020-11-20;107;86;193;302020;314428;29;616448
44;2020-11-20;142;80;222;342222;333292;39;675514
44;2020-11-20;121;103;225;349727;344491;49;694218
44;2020-11-20;140;112;253;381371;373239;59;754610
44;2020-11-20;67;64;131;367165;335850;69;703015
44;2020-11-20;55;62;118;250387;215436;79;465823
44;2020-11-20;74;49;123;170825;105192;89;276017
44;2020-11-20;45;18;63;51248;16731;90;67979
44;2020-11-20;904;744;1654;2826745;2685002;0;5511747
52;2020-11-20;17;14;31;213594;223900;09;437494
52;2020-11-20;41;38;82;240818;255197;19;496015
52;2020-11-20;46;35;81;197010;200630;29;397640
52;2020-11-20;42;35;77;231204;224885;39;456089
52;2020-11-20;42;37;79;243874;243418;49;487292
52;2020-11-20;45;27;72;244100;239116;59;483216
52;2020-11-20;17;25;42;241796;221345;69;463141
52;2020-11-20;20;23;43;177805;149903;79;327708
52;2020-11-20;38;20;58;119561;75822;89;195383
52;2020-11-20;31;14;45;42559;15260;90;57819
52;2020-11-20;339;268;610;1952321;1849476;0;3801797
53;2020-11-20;8;7;16;173813;182358;09;356171
53;2020-11-20;20;16;39;202720;214740;19;417460
53;2020-11-20;28;20;49;163116;173196;29;336312
53;2020-11-20;15;20;35;190526;187674;39;378200
53;2020-11-20;22;15;37;212098;212015;49;424113
53;2020-11-20;28;19;47;223699;219176;59;442875
53;2020-11-20;14;19;33;227435;209274;69;436709
53;2020-11-20;13;10;23;169992;140910;79;310902
53;2020-11-20;21;7;28;118117;69883;89;188000
53;2020-11-20;15;3;18;37370;12267;90;49637
53;2020-11-20;184;136;325;1718886;1621493;0;3340379
75;2020-11-20;23;15;40;293104;305291;09;598395
75;2020-11-20;51;63;114;337141;357785;19;694926
75;2020-11-20;76;60;136;295024;300618;29;595642
75;2020-11-20;65;57;122;347871;331233;39;679104
75;2020-11-20;69;60;129;384742;372771;49;757513
75;2020-11-20;73;73;146;413361;390880;59;804241
75;2020-11-20;43;46;89;425623;384060;69;809683
75;2020-11-20;39;32;71;325086;276298;79;601384
75;2020-11-20;37;27;64;213986;139308;89;353294
75;2020-11-20;44;14;58;77600;28200;90;105800
75;2020-11-20;520;447;969;3113538;2886444;0;5999982
76;2020-11-20;33;25;58;305956;318589;09;624545
76;2020-11-20;66;66;133;338942;356969;19;695911
76;2020-11-20;80;65;145;316210;319570;29;635780
76;2020-11-20;89;59;148;356758;337587;39;694345
76;2020-11-20;97;71;169;376541;363812;49;740353
76;2020-11-20;97;69;166;402608;383750;59;786358
76;2020-11-20;60;61;121;394889;358997;69;753886
76;2020-11-20;33;44;77;308664;263806;79;572470
76;2020-11-20;67;37;104;195838;129272;89;325110
76;2020-11-20;56;18;74;69372;26728;90;96100
76;2020-11-20;679;515;1196;3065778;2859080;0;5924858
84;2020-11-20;66;60;127;459549;481088;09;940637
84;2020-11-20;236;221;461;487711;511905;19;999616
84;2020-11-20;234;173;407;443824;451094;29;894918
84;2020-11-20;204;185;389;512522;493262;39;1005784
84;2020-11-20;278;218;496;520248;515106;49;1035354
84;2020-11-20;230;207;437;529611;514848;59;1044459
84;2020-11-20;133;131;264;486720;439940;69;926660
84;2020-11-20;95;103;198;372151;315211;79;687362
84;2020-11-20;125;77;202;237198;150524;89;387722
84;2020-11-20;108;38;146;81185;28680;90;109865
84;2020-11-20;1710;1414;3129;4130719;3901658;0;8032377
93;2020-11-20;19;19;38;268834;283093;09;551927
93;2020-11-20;81;105;187;280751;296087;19;576838
93;2020-11-20;91;78;169;254404;255552;29;509956
93;2020-11-20;86;86;172;310704;288398;39;599102
93;2020-11-20;108;89;197;325559;305827;49;631386
93;2020-11-20;98;78;176;353104;325389;59;678493
93;2020-11-20;81;58;139;336327;296459;69;632786
93;2020-11-20;48;56;104;279820;229699;79;509519
93;2020-11-20;56;44;100;171274;113716;89;284990
93;2020-11-20;46;19;65;58896;21758;90;80654
93;2020-11-20;714;632;1347;2639673;2415978;0;5055651
94;2020-11-20;0;1;1;16311;17433;09;33744
94;2020-11-20;1;2;3;16679;18132;19;34811
94;2020-11-20;1;1;2;16782;16579;29;33361
94;2020-11-20;2;3;5;23044;20580;39;43624
94;2020-11-20;1;5;6;23065;22140;49;45205
94;2020-11-20;1;3;4;24549;23421;59;47970
94;2020-11-20;0;2;2;23212;21883;69;45095
94;2020-11-20;1;0;1;19544;17141;79;36685
94;2020-11-20;0;3;3;11227;8178;89;19405
94;2020-11-20;0;0;0;3332;1447;90;4779
94;2020-11-20;7;20;27;177745;166934;0;344679
01;2020-11-21;0;0;0;19979;20155;09;40134
01;2020-11-21;0;1;1;24994;25489;19;50483
01;2020-11-21;0;0;0;17868;16690;29;34558
01;2020-11-21;0;0;0;22328;14821;39;37149
01;2020-11-21;1;1;2;28652;20276;49;48928
01;2020-11-21;1;0;1;33264;27260;59;60524
01;2020-11-21;0;1;1;27135;23978;69;51113
01;2020-11-21;0;1;1;18401;14661;79;33062
01;2020-11-21;1;0;1;9633;6375;89;16008
01;2020-11-21;0;0;0;3410;1510;90;4920
01;2020-11-21;3;4;7;205664;171215;0;376879
02;2020-11-21;0;0;0;16881;17110;09;33991
02;2020-11-21;0;0;0;21410;21604;19;43014
02;2020-11-21;2;6;8;16017;15479;29;31496
02;2020-11-21;2;6;8;19825;14455;39;34280
02;2020-11-21;1;2;3;24719;18248;49;42967
02;2020-11-21;2;0;2;34361;28310;59;62671
02;2020-11-21;0;1;1;28061;24495;69;52556
02;2020-11-21;0;0;0;18231;15278;79;33509
02;2020-11-21;0;0;0;11090;7677;89;18767
02;2020-11-21;0;0;0;3992;1506;90;5498
02;2020-11-21;7;15;22;194587;164162;0;358749
03;2020-11-21;0;0;0;31123;30920;09;62043
03;2020-11-21;2;0;2;29370;29268;19;58638
03;2020-11-21;1;1;2;21458;18963;29;40421
03;2020-11-21;2;1;3;21276;18326;39;39602
03;2020-11-21;0;1;1;18164;16593;49;34757
03;2020-11-21;0;2;2;13469;13557;59;27026
03;2020-11-21;1;0;1;8776;8670;69;17446
03;2020-11-21;0;0;0;3777;3591;79;7368
03;2020-11-21;0;0;0;1649;1072;89;2721
03;2020-11-21;1;2;3;485;184;90;669
03;2020-11-21;7;7;14;149547;141144;0;290691
04;2020-11-21;1;0;1;60314;61377;09;121691
04;2020-11-21;5;2;7;66065;68387;19;134452
04;2020-11-21;3;6;9;51059;47156;29;98215
04;2020-11-21;2;1;3;58788;45780;39;104568
04;2020-11-21;2;2;4;61408;52207;49;113615
04;2020-11-21;1;1;2;64838;60759;59;125597
04;2020-11-21;3;0;3;47008;42843;69;89851
04;2020-11-21;2;0;2;25509;21184;79;46693
04;2020-11-21;0;0;0;13168;7647;89;20815
04;2020-11-21;0;0;0;3209;1253;90;4462
04;2020-11-21;19;12;31;451366;408593;0;859959
05;2020-11-21;0;0;0;362.366008612902;341.338819562748;09;703.704828175651
05;2020-11-21;0;0;0;353.376145114279;370.349735405642;19;723.725880519921
05;2020-11-21;0;0;0;218.593559489256;256.539602589476;29;475.133162078732
05;2020-11-21;0;0;0;404.225408693299;360.321910454353;39;764.547319147651
05;2020-11-21;0;0;0;520.067953604221;497.108383964256;49;1017.17633756848
05;2020-11-21;0;0;0;468.146063921917;510.087601910415;59;978.233665832332
05;2020-11-21;0;0;0;340.368470050554;334.366842191253;69;674.735312241807
05;2020-11-21;0;0;0;212.598666888387;192.597753227106;79;405.196420115493
05;2020-11-21;0;0;0;148.727797095705;61.8681715431829;89;210.595968638888
05;2020-11-21;0;0;0;32.9601271090696;10.9909785719784;90;43.9511056810479
05;2020-11-21;0;0;0;3061.43020057959;2935.56979942041;0;5997
06;2020-11-21;0;0;0;42583;42380;09;84963
06;2020-11-21;3;0;3;33369;31925;19;65294
06;2020-11-21;1;1;2;21571;15080;29;36651
06;2020-11-21;1;1;2;21550;16147;39;37697
06;2020-11-21;0;2;2;14193;13939;49;28132
06;2020-11-21;1;0;1;7171;7597;59;14768
06;2020-11-21;0;0;0;3629;4117;69;7746
06;2020-11-21;0;0;0;1577;1457;79;3034
06;2020-11-21;0;0;0;531;474;89;1005
06;2020-11-21;0;0;0;88;93;90;181
06;2020-11-21;6;4;10;146262;133209;0;279471
07;2020-11-21;0;0;0;485;549;09;1034
07;2020-11-21;0;0;0;403;432;19;835
07;2020-11-21;0;0;0;764;841;29;1605
07;2020-11-21;0;0;0;824;928;39;1752
07;2020-11-21;0;1;1;788;1020;49;1808
07;2020-11-21;1;0;1;678;870;59;1548
07;2020-11-21;0;0;0;360;382;69;742
07;2020-11-21;0;0;0;231;190;79;421
07;2020-11-21;0;0;0;114;67;89;181
07;2020-11-21;0;0;0;24;11;90;35
07;2020-11-21;1;1;2;4671;5290;0;9961
08;2020-11-21;0;0;0;2715.22592983026;2997.75551488675;09;5712.98144471701
08;2020-11-21;1;0;1;2778.51901080978;3160.9156459093;19;5939.43465671908
08;2020-11-21;0;0;0;2080.8882988764;1718.16634315323;29;3799.05464202964
08;2020-11-21;0;2;2;2701.8582062647;1896.52641413317;39;4598.38462039786
08;2020-11-21;0;0;0;3151.45861023308;2460.52498233809;49;5611.98359257117
08;2020-11-21;0;0;0;2620.29868333099;2422.23566154656;59;5042.53434487755
08;2020-11-21;0;0;0;1621.44173420671;1438.58325779464;69;3060.02499200135
08;2020-11-21;0;0;0;626.575909335673;526.358467843651;79;1152.93437717932
08;2020-11-21;0;0;0;205.018522985054;140.993639349697;89;346.012162334751
08;2020-11-21;0;0;0;50.0325684687745;20.62259870351;90;70.6551671722846
08;2020-11-21;1;2;3;18551.3174743414;16782.6825256586;0;35334
11;2020-11-21;30;23;54;783071;811785;09;1594856
11;2020-11-21;105;104;213;761456;784653;19;1546109
11;2020-11-21;119;92;211;850145;801772;29;1651917
11;2020-11-21;118;115;233;914360;843488;39;1757848
11;2020-11-21;122;107;229;845609;826202;49;1671811
11;2020-11-21;109;110;220;793566;745070;59;1538636
11;2020-11-21;64;78;145;628649;549192;69;1177841
11;2020-11-21;49;37;86;434606;358356;79;792962
11;2020-11-21;26;22;49;261425;162933;89;424358
11;2020-11-21;28;8;36;89253;32619;90;121872
11;2020-11-21;770;700;1480;6362140;5916070;0;12278210
24;2020-11-21;9;2;11;139720;144686;09;284406
24;2020-11-21;20;15;35;152979;161185;19;314164
24;2020-11-21;29;13;42;122237;126536;29;248773
24;2020-11-21;21;10;31;150359;142009;39;292368
24;2020-11-21;20;20;40;161829;158758;49;320587
24;2020-11-21;15;18;33;172552;168011;59;340563
24;2020-11-21;9;13;22;172509;158177;69;330686
24;2020-11-21;3;8;11;129428;110593;79;240021
24;2020-11-21;20;8;28;87342;56882;89;144224
24;2020-11-21;13;2;15;31210;12071;90;43281
24;2020-11-21;159;109;268;1320165;1238908;0;2559073
27;2020-11-21;11;15;27;143373;149679;09;293052
27;2020-11-21;35;34;69;160962;173003;19;333965
27;2020-11-21;45;30;75;133746;142254;29;276000
27;2020-11-21;36;23;59;160004;155407;39;315411
27;2020-11-21;28;35;63;172333;169564;49;341897
27;2020-11-21;27;28;55;189979;183788;59;373767
27;2020-11-21;24;17;41;192591;178206;69;370797
27;2020-11-21;22;21;43;146876;127546;79;274422
27;2020-11-21;19;25;44;96896;61575;89;158471
27;2020-11-21;18;4;22;33148;12109;90;45257
27;2020-11-21;265;232;498;1429908;1353131;0;2783039
28;2020-11-21;9;10;19;180735;186856;09;367591
28;2020-11-21;19;19;38;200125;213621;19;413746
28;2020-11-21;20;13;33;168922;173007;29;341929
28;2020-11-21;19;13;32;196628;188487;39;385115
28;2020-11-21;23;15;38;205396;201699;49;407095
28;2020-11-21;21;17;38;222002;213866;59;435868
28;2020-11-21;11;17;28;224688;203758;69;428446
28;2020-11-21;14;13;27;163192;135543;79;298735
28;2020-11-21;18;12;30;109691;65377;89;175068
28;2020-11-21;10;2;12;37222;12685;90;49907
28;2020-11-21;164;131;295;1708601;1594899;0;3303500
32;2020-11-21;21;22;44;358062;373689;09;731751
32;2020-11-21;70;63;133;387045;406742;19;793787
32;2020-11-21;67;47;115;342304;348587;29;690891
32;2020-11-21;58;53;111;382485;369972;39;752457
32;2020-11-21;64;56;120;382510;376716;49;759226
32;2020-11-21;61;47;108;386937;376527;59;763464
32;2020-11-21;38;36;74;371211;330938;69;702149
32;2020-11-21;26;32;58;250542;201459;79;452001
32;2020-11-21;33;18;51;163399;89786;89;253185
32;2020-11-21;9;6;15;48384;15367;90;63751
32;2020-11-21;447;380;829;3072879;2889783;0;5962662
44;2020-11-21;11;21;34;291525;306839;09;598364
44;2020-11-21;52;42;94;320255;339504;19;659759
44;2020-11-21;56;54;111;302020;314428;29;616448
44;2020-11-21;62;48;110;342222;333292;39;675514
44;2020-11-21;55;39;94;349727;344491;49;694218
44;2020-11-21;63;54;117;381371;373239;59;754610
44;2020-11-21;38;28;66;367165;335850;69;703015
44;2020-11-21;20;25;45;250387;215436;79;465823
44;2020-11-21;26;22;48;170825;105192;89;276017
44;2020-11-21;18;5;24;51248;16731;90;67979
44;2020-11-21;401;338;743;2826745;2685002;0;5511747
52;2020-11-21;5;3;9;213594;223900;09;437494
52;2020-11-21;27;12;39;240818;255197;19;496015
52;2020-11-21;22;18;40;197010;200630;29;397640
52;2020-11-21;20;19;39;231204;224885;39;456089
52;2020-11-21;25;26;51;243874;243418;49;487292
52;2020-11-21;14;16;30;244100;239116;59;483216
52;2020-11-21;10;10;20;241796;221345;69;463141
52;2020-11-21;9;7;16;177805;149903;79;327708
52;2020-11-21;16;6;22;119561;75822;89;195383
52;2020-11-21;8;6;14;42559;15260;90;57819
52;2020-11-21;156;123;280;1952321;1849476;0;3801797
53;2020-11-21;7;5;12;173813;182358;09;356171
53;2020-11-21;13;13;26;202720;214740;19;417460
53;2020-11-21;14;9;23;163116;173196;29;336312
53;2020-11-21;13;5;18;190526;187674;39;378200
53;2020-11-21;13;17;30;212098;212015;49;424113
53;2020-11-21;10;10;20;223699;219176;59;442875
53;2020-11-21;4;6;10;227435;209274;69;436709
53;2020-11-21;1;5;6;169992;140910;79;310902
53;2020-11-21;6;1;7;118117;69883;89;188000
53;2020-11-21;3;1;4;37370;12267;90;49637
53;2020-11-21;84;72;156;1718886;1621493;0;3340379
75;2020-11-21;7;6;13;293104;305291;09;598395
75;2020-11-21;28;27;55;337141;357785;19;694926
75;2020-11-21;42;22;64;295024;300618;29;595642
75;2020-11-21;21;21;42;347871;331233;39;679104
75;2020-11-21;31;24;55;384742;372771;49;757513
75;2020-11-21;30;27;57;413361;390880;59;804241
75;2020-11-21;13;16;29;425623;384060;69;809683
75;2020-11-21;21;10;31;325086;276298;79;601384
75;2020-11-21;12;15;28;213986;139308;89;353294
75;2020-11-21;11;5;16;77600;28200;90;105800
75;2020-11-21;216;173;390;3113538;2886444;0;5999982
76;2020-11-21;6;3;9;305956;318589;09;624545
76;2020-11-21;30;26;57;338942;356969;19;695911
76;2020-11-21;26;31;57;316210;319570;29;635780
76;2020-11-21;33;24;57;356758;337587;39;694345
76;2020-11-21;35;26;61;376541;363812;49;740353
76;2020-11-21;30;20;50;402608;383750;59;786358
76;2020-11-21;14;14;28;394889;358997;69;753886
76;2020-11-21;16;14;30;308664;263806;79;572470
76;2020-11-21;14;15;29;195838;129272;89;325110
76;2020-11-21;8;4;12;69372;26728;90;96100
76;2020-11-21;213;177;391;3065778;2859080;0;5924858
84;2020-11-21;16;24;40;459549;481088;09;940637
84;2020-11-21;77;75;152;487711;511905;19;999616
84;2020-11-21;112;84;196;443824;451094;29;894918
84;2020-11-21;100;88;188;512522;493262;39;1005784
84;2020-11-21;109;95;204;520248;515106;49;1035354
84;2020-11-21;93;101;194;529611;514848;59;1044459
84;2020-11-21;54;66;120;486720;439940;69;926660
84;2020-11-21;26;43;69;372151;315211;79;687362
84;2020-11-21;63;35;98;237198;150524;89;387722
84;2020-11-21;29;5;34;81185;28680;90;109865
84;2020-11-21;679;616;1295;4130719;3901658;0;8032377
93;2020-11-21;15;8;23;268834;283093;09;551927
93;2020-11-21;27;32;60;280751;296087;19;576838
93;2020-11-21;48;28;76;254404;255552;29;509956
93;2020-11-21;47;40;87;310704;288398;39;599102
93;2020-11-21;38;33;71;325559;305827;49;631386
93;2020-11-21;45;41;86;353104;325389;59;678493
93;2020-11-21;25;23;48;336327;296459;69;632786
93;2020-11-21;15;14;29;279820;229699;79;509519
93;2020-11-21;19;11;30;171274;113716;89;284990
93;2020-11-21;13;5;18;58896;21758;90;80654
93;2020-11-21;293;235;529;2639673;2415978;0;5055651
94;2020-11-21;0;1;1;16311;17433;09;33744
94;2020-11-21;1;0;1;16679;18132;19;34811
94;2020-11-21;0;0;0;16782;16579;29;33361
94;2020-11-21;0;2;2;23044;20580;39;43624
94;2020-11-21;2;0;2;23065;22140;49;45205
94;2020-11-21;1;0;1;24549;23421;59;47970
94;2020-11-21;0;0;0;23212;21883;69;45095
94;2020-11-21;1;1;2;19544;17141;79;36685
94;2020-11-21;2;0;2;11227;8178;89;19405
94;2020-11-21;0;0;0;3332;1447;90;4779
94;2020-11-21;7;4;11;177745;166934;0;344679
01;2020-11-22;0;1;1;19979;20155;09;40134
01;2020-11-22;0;0;0;24994;25489;19;50483
01;2020-11-22;2;0;2;17868;16690;29;34558
01;2020-11-22;0;0;0;22328;14821;39;37149
01;2020-11-22;2;0;2;28652;20276;49;48928
01;2020-11-22;0;0;0;33264;27260;59;60524
01;2020-11-22;1;0;1;27135;23978;69;51113
01;2020-11-22;1;0;1;18401;14661;79;33062
01;2020-11-22;0;0;0;9633;6375;89;16008
01;2020-11-22;1;0;1;3410;1510;90;4920
01;2020-11-22;7;1;8;205664;171215;0;376879
02;2020-11-22;0;0;0;16881;17110;09;33991
02;2020-11-22;0;0;0;21410;21604;19;43014
02;2020-11-22;0;0;0;16017;15479;29;31496
02;2020-11-22;0;0;0;19825;14455;39;34280
02;2020-11-22;0;0;0;24719;18248;49;42967
02;2020-11-22;1;0;1;34361;28310;59;62671
02;2020-11-22;0;0;0;28061;24495;69;52556
02;2020-11-22;1;0;1;18231;15278;79;33509
02;2020-11-22;0;0;0;11090;7677;89;18767
02;2020-11-22;0;0;0;3992;1506;90;5498
02;2020-11-22;2;0;2;194587;164162;0;358749
03;2020-11-22;0;0;0;31123;30920;09;62043
03;2020-11-22;0;0;0;29370;29268;19;58638
03;2020-11-22;1;0;1;21458;18963;29;40421
03;2020-11-22;0;0;0;21276;18326;39;39602
03;2020-11-22;1;0;1;18164;16593;49;34757
03;2020-11-22;0;0;0;13469;13557;59;27026
03;2020-11-22;0;0;0;8776;8670;69;17446
03;2020-11-22;0;0;0;3777;3591;79;7368
03;2020-11-22;0;0;0;1649;1072;89;2721
03;2020-11-22;0;0;0;485;184;90;669
03;2020-11-22;2;0;2;149547;141144;0;290691
04;2020-11-22;2;3;5;60314;61377;09;121691
04;2020-11-22;3;2;5;66065;68387;19;134452
04;2020-11-22;0;1;1;51059;47156;29;98215
04;2020-11-22;2;0;2;58788;45780;39;104568
04;2020-11-22;1;3;4;61408;52207;49;113615
04;2020-11-22;2;1;3;64838;60759;59;125597
04;2020-11-22;1;0;1;47008;42843;69;89851
04;2020-11-22;0;0;0;25509;21184;79;46693
04;2020-11-22;0;0;0;13168;7647;89;20815
04;2020-11-22;0;0;0;3209;1253;90;4462
04;2020-11-22;11;10;21;451366;408593;0;859959
05;2020-11-22;0;0;0;362.366008612902;341.338819562748;09;703.704828175651
05;2020-11-22;0;0;0;353.376145114279;370.349735405642;19;723.725880519921
05;2020-11-22;0;0;0;218.593559489256;256.539602589476;29;475.133162078732
05;2020-11-22;0;0;0;404.225408693299;360.321910454353;39;764.547319147651
05;2020-11-22;0;0;0;520.067953604221;497.108383964256;49;1017.17633756848
05;2020-11-22;0;0;0;468.146063921917;510.087601910415;59;978.233665832332
05;2020-11-22;0;0;0;340.368470050554;334.366842191253;69;674.735312241807
05;2020-11-22;0;0;0;212.598666888387;192.597753227106;79;405.196420115493
05;2020-11-22;0;0;0;148.727797095705;61.8681715431829;89;210.595968638888
05;2020-11-22;0;0;0;32.9601271090696;10.9909785719784;90;43.9511056810479
05;2020-11-22;0;0;0;3061.43020057959;2935.56979942041;0;5997
06;2020-11-22;0;0;0;42583;42380;09;84963
06;2020-11-22;0;0;0;33369;31925;19;65294
06;2020-11-22;0;0;0;21571;15080;29;36651
06;2020-11-22;0;0;0;21550;16147;39;37697
06;2020-11-22;0;1;1;14193;13939;49;28132
06;2020-11-22;0;0;0;7171;7597;59;14768
06;2020-11-22;1;0;1;3629;4117;69;7746
06;2020-11-22;0;0;0;1577;1457;79;3034
06;2020-11-22;0;0;0;531;474;89;1005
06;2020-11-22;0;0;0;88;93;90;181
06;2020-11-22;1;1;2;146262;133209;0;279471
07;2020-11-22;0;0;0;485;549;09;1034
07;2020-11-22;0;0;0;403;432;19;835
07;2020-11-22;0;0;0;764;841;29;1605
07;2020-11-22;0;0;0;824;928;39;1752
07;2020-11-22;0;0;0;788;1020;49;1808
07;2020-11-22;0;0;0;678;870;59;1548
07;2020-11-22;0;0;0;360;382;69;742
07;2020-11-22;0;0;0;231;190;79;421
07;2020-11-22;0;0;0;114;67;89;181
07;2020-11-22;0;0;0;24;11;90;35
07;2020-11-22;0;0;0;4671;5290;0;9961
08;2020-11-22;0;0;0;2715.22592983026;2997.75551488675;09;5712.98144471701
08;2020-11-22;1;0;1;2778.51901080978;3160.9156459093;19;5939.43465671908
08;2020-11-22;1;0;1;2080.8882988764;1718.16634315323;29;3799.05464202964
08;2020-11-22;0;0;0;2701.8582062647;1896.52641413317;39;4598.38462039786
08;2020-11-22;0;0;0;3151.45861023308;2460.52498233809;49;5611.98359257117
08;2020-11-22;0;0;0;2620.29868333099;2422.23566154656;59;5042.53434487755
08;2020-11-22;0;0;0;1621.44173420671;1438.58325779464;69;3060.02499200135
08;2020-11-22;0;0;0;626.575909335673;526.358467843651;79;1152.93437717932
08;2020-11-22;0;0;0;205.018522985054;140.993639349697;89;346.012162334751
08;2020-11-22;0;0;0;50.0325684687745;20.62259870351;90;70.6551671722846
08;2020-11-22;2;0;2;18551.3174743414;16782.6825256586;0;35334
11;2020-11-22;6;3;9;783071;811785;09;1594856
11;2020-11-22;31;16;47;761456;784653;19;1546109
11;2020-11-22;23;25;48;850145;801772;29;1651917
11;2020-11-22;26;19;45;914360;843488;39;1757848
11;2020-11-22;32;28;60;845609;826202;49;1671811
11;2020-11-22;25;25;50;793566;745070;59;1538636
11;2020-11-22;19;23;42;628649;549192;69;1177841
11;2020-11-22;7;13;20;434606;358356;79;792962
11;2020-11-22;23;19;42;261425;162933;89;424358
11;2020-11-22;11;5;16;89253;32619;90;121872
11;2020-11-22;203;176;379;6362140;5916070;0;12278210
24;2020-11-22;2;1;3;139720;144686;09;284406
24;2020-11-22;5;2;7;152979;161185;19;314164
24;2020-11-22;5;6;11;122237;126536;29;248773
24;2020-11-22;5;9;14;150359;142009;39;292368
24;2020-11-22;5;3;8;161829;158758;49;320587
24;2020-11-22;5;5;10;172552;168011;59;340563
24;2020-11-22;2;4;6;172509;158177;69;330686
24;2020-11-22;2;3;5;129428;110593;79;240021
24;2020-11-22;3;4;7;87342;56882;89;144224
24;2020-11-22;2;2;4;31210;12071;90;43281
24;2020-11-22;36;39;75;1320165;1238908;0;2559073
27;2020-11-22;3;2;5;143373;149679;09;293052
27;2020-11-22;2;1;3;160962;173003;19;333965
27;2020-11-22;6;6;12;133746;142254;29;276000
27;2020-11-22;2;2;4;160004;155407;39;315411
27;2020-11-22;8;7;15;172333;169564;49;341897
27;2020-11-22;9;0;9;189979;183788;59;373767
27;2020-11-22;7;7;14;192591;178206;69;370797
27;2020-11-22;5;1;6;146876;127546;79;274422
27;2020-11-22;11;13;24;96896;61575;89;158471
27;2020-11-22;7;4;11;33148;12109;90;45257
27;2020-11-22;60;43;103;1429908;1353131;0;2783039
28;2020-11-22;3;2;5;180735;186856;09;367591
28;2020-11-22;4;8;12;200125;213621;19;413746
28;2020-11-22;9;6;15;168922;173007;29;341929
28;2020-11-22;2;8;10;196628;188487;39;385115
28;2020-11-22;6;8;14;205396;201699;49;407095
28;2020-11-22;9;6;15;222002;213866;59;435868
28;2020-11-22;2;3;5;224688;203758;69;428446
28;2020-11-22;4;4;8;163192;135543;79;298735
28;2020-11-22;7;5;12;109691;65377;89;175068
28;2020-11-22;6;1;7;37222;12685;90;49907
28;2020-11-22;52;51;103;1708601;1594899;0;3303500
32;2020-11-22;7;8;15;358062;373689;09;731751
32;2020-11-22;13;13;26;387045;406742;19;793787
32;2020-11-22;21;15;36;342304;348587;29;690891
32;2020-11-22;23;8;31;382485;369972;39;752457
32;2020-11-22;23;15;38;382510;376716;49;759226
32;2020-11-22;20;14;34;386937;376527;59;763464
32;2020-11-22;5;10;15;371211;330938;69;702149
32;2020-11-22;8;7;15;250542;201459;79;452001
32;2020-11-22;8;6;14;163399;89786;89;253185
32;2020-11-22;12;4;16;48384;15367;90;63751
32;2020-11-22;140;100;240;3072879;2889783;0;5962662
44;2020-11-22;1;2;3;291525;306839;09;598364
44;2020-11-22;4;3;7;320255;339504;19;659759
44;2020-11-22;10;3;13;302020;314428;29;616448
44;2020-11-22;10;5;15;342222;333292;39;675514
44;2020-11-22;10;2;12;349727;344491;49;694218
44;2020-11-22;9;6;15;381371;373239;59;754610
44;2020-11-22;4;4;8;367165;335850;69;703015
44;2020-11-22;10;8;18;250387;215436;79;465823
44;2020-11-22;16;10;26;170825;105192;89;276017
44;2020-11-22;10;2;12;51248;16731;90;67979
44;2020-11-22;84;45;129;2826745;2685002;0;5511747
52;2020-11-22;0;0;2;213594;223900;09;437494
52;2020-11-22;4;2;7;240818;255197;19;496015
52;2020-11-22;5;2;7;197010;200630;29;397640
52;2020-11-22;7;10;17;231204;224885;39;456089
52;2020-11-22;6;4;10;243874;243418;49;487292
52;2020-11-22;9;4;13;244100;239116;59;483216
52;2020-11-22;2;4;6;241796;221345;69;463141
52;2020-11-22;1;7;8;177805;149903;79;327708
52;2020-11-22;5;4;9;119561;75822;89;195383
52;2020-11-22;4;2;6;42559;15260;90;57819
52;2020-11-22;43;39;85;1952321;1849476;0;3801797
53;2020-11-22;2;1;3;173813;182358;09;356171
53;2020-11-22;4;3;7;202720;214740;19;417460
53;2020-11-22;5;6;11;163116;173196;29;336312
53;2020-11-22;7;1;8;190526;187674;39;378200
53;2020-11-22;3;2;5;212098;212015;49;424113
53;2020-11-22;2;1;3;223699;219176;59;442875
53;2020-11-22;0;1;1;227435;209274;69;436709
53;2020-11-22;0;4;4;169992;140910;79;310902
53;2020-11-22;2;0;2;118117;69883;89;188000
53;2020-11-22;1;1;2;37370;12267;90;49637
53;2020-11-22;26;20;46;1718886;1621493;0;3340379
75;2020-11-22;1;0;1;293104;305291;09;598395
75;2020-11-22;2;1;3;337141;357785;19;694926
75;2020-11-22;5;7;12;295024;300618;29;595642
75;2020-11-22;8;3;11;347871;331233;39;679104
75;2020-11-22;8;5;13;384742;372771;49;757513
75;2020-11-22;3;2;5;413361;390880;59;804241
75;2020-11-22;2;1;3;425623;384060;69;809683
75;2020-11-22;2;6;8;325086;276298;79;601384
75;2020-11-22;4;2;6;213986;139308;89;353294
75;2020-11-22;9;6;15;77600;28200;90;105800
75;2020-11-22;44;33;77;3113538;2886444;0;5999982
76;2020-11-22;1;2;3;305956;318589;09;624545
76;2020-11-22;9;4;13;338942;356969;19;695911
76;2020-11-22;11;4;15;316210;319570;29;635780
76;2020-11-22;14;7;21;356758;337587;39;694345
76;2020-11-22;11;2;13;376541;363812;49;740353
76;2020-11-22;13;6;19;402608;383750;59;786358
76;2020-11-22;5;4;9;394889;358997;69;753886
76;2020-11-22;4;4;8;308664;263806;79;572470
76;2020-11-22;5;6;11;195838;129272;89;325110
76;2020-11-22;11;6;17;69372;26728;90;96100
76;2020-11-22;84;45;129;3065778;2859080;0;5924858
84;2020-11-22;3;4;7;459549;481088;09;940637
84;2020-11-22;15;15;30;487711;511905;19;999616
84;2020-11-22;21;16;37;443824;451094;29;894918
84;2020-11-22;27;15;42;512522;493262;39;1005784
84;2020-11-22;22;14;36;520248;515106;49;1035354
84;2020-11-22;21;26;47;529611;514848;59;1044459
84;2020-11-22;4;18;22;486720;439940;69;926660
84;2020-11-22;13;14;27;372151;315211;79;687362
84;2020-11-22;19;11;30;237198;150524;89;387722
84;2020-11-22;17;3;20;81185;28680;90;109865
84;2020-11-22;162;136;298;4130719;3901658;0;8032377
93;2020-11-22;4;0;4;268834;283093;09;551927
93;2020-11-22;3;4;7;280751;296087;19;576838
93;2020-11-22;8;5;13;254404;255552;29;509956
93;2020-11-22;12;8;20;310704;288398;39;599102
93;2020-11-22;9;6;15;325559;305827;49;631386
93;2020-11-22;2;5;7;353104;325389;59;678493
93;2020-11-22;5;8;13;336327;296459;69;632786
93;2020-11-22;8;7;15;279820;229699;79;509519
93;2020-11-22;16;9;25;171274;113716;89;284990
93;2020-11-22;9;3;12;58896;21758;90;80654
93;2020-11-22;76;55;131;2639673;2415978;0;5055651
94;2020-11-22;0;0;0;16311;17433;09;33744
94;2020-11-22;0;0;0;16679;18132;19;34811
94;2020-11-22;1;0;1;16782;16579;29;33361
94;2020-11-22;0;0;0;23044;20580;39;43624
94;2020-11-22;0;0;0;23065;22140;49;45205
94;2020-11-22;0;0;0;24549;23421;59;47970
94;2020-11-22;0;0;0;23212;21883;69;45095
94;2020-11-22;0;0;0;19544;17141;79;36685
94;2020-11-22;0;0;0;11227;8178;89;19405
94;2020-11-22;0;0;0;3332;1447;90;4779
94;2020-11-22;1;0;1;177745;166934;0;344679
01;2020-11-23;0;0;0;19979;20155;09;40134
01;2020-11-23;0;0;0;24994;25489;19;50483
01;2020-11-23;2;0;2;17868;16690;29;34558
01;2020-11-23;1;0;1;22328;14821;39;37149
01;2020-11-23;1;0;1;28652;20276;49;48928
01;2020-11-23;1;2;3;33264;27260;59;60524
01;2020-11-23;1;1;2;27135;23978;69;51113
01;2020-11-23;2;1;3;18401;14661;79;33062
01;2020-11-23;1;0;1;9633;6375;89;16008
01;2020-11-23;0;0;0;3410;1510;90;4920
01;2020-11-23;9;4;13;205664;171215;0;376879
02;2020-11-23;0;0;0;16881;17110;09;33991
02;2020-11-23;3;3;6;21410;21604;19;43014
02;2020-11-23;1;3;4;16017;15479;29;31496
02;2020-11-23;3;4;7;19825;14455;39;34280
02;2020-11-23;2;1;3;24719;18248;49;42967
02;2020-11-23;3;0;4;34361;28310;59;62671
02;2020-11-23;0;0;0;28061;24495;69;52556
02;2020-11-23;1;0;1;18231;15278;79;33509
02;2020-11-23;0;0;0;11090;7677;89;18767
02;2020-11-23;0;0;0;3992;1506;90;5498
02;2020-11-23;13;11;25;194587;164162;0;358749
03;2020-11-23;1;1;2;31123;30920;09;62043
03;2020-11-23;8;5;13;29370;29268;19;58638
03;2020-11-23;4;2;6;21458;18963;29;40421
03;2020-11-23;7;4;11;21276;18326;39;39602
03;2020-11-23;0;3;3;18164;16593;49;34757
03;2020-11-23;3;3;6;13469;13557;59;27026
03;2020-11-23;1;1;2;8776;8670;69;17446
03;2020-11-23;2;1;3;3777;3591;79;7368
03;2020-11-23;1;0;1;1649;1072;89;2721
03;2020-11-23;0;0;0;485;184;90;669
03;2020-11-23;27;20;47;149547;141144;0;290691
04;2020-11-23;2;1;3;60314;61377;09;121691
04;2020-11-23;8;6;14;66065;68387;19;134452
04;2020-11-23;11;10;21;51059;47156;29;98215
04;2020-11-23;3;4;7;58788;45780;39;104568
04;2020-11-23;4;4;8;61408;52207;49;113615
04;2020-11-23;4;4;8;64838;60759;59;125597
04;2020-11-23;4;9;13;47008;42843;69;89851
04;2020-11-23;2;1;3;25509;21184;79;46693
04;2020-11-23;1;2;3;13168;7647;89;20815
04;2020-11-23;0;0;0;3209;1253;90;4462
04;2020-11-23;39;41;80;451366;408593;0;859959
05;2020-11-23;0;0;0;362.366008612902;341.338819562748;09;703.704828175651
05;2020-11-23;0;0;0;353.376145114279;370.349735405642;19;723.725880519921
05;2020-11-23;0;0;0;218.593559489256;256.539602589476;29;475.133162078732
05;2020-11-23;0;0;0;404.225408693299;360.321910454353;39;764.547319147651
05;2020-11-23;0;0;0;520.067953604221;497.108383964256;49;1017.17633756848
05;2020-11-23;0;0;0;468.146063921917;510.087601910415;59;978.233665832332
05;2020-11-23;0;0;0;340.368470050554;334.366842191253;69;674.735312241807
05;2020-11-23;0;0;0;212.598666888387;192.597753227106;79;405.196420115493
05;2020-11-23;0;0;0;148.727797095705;61.8681715431829;89;210.595968638888
05;2020-11-23;0;0;0;32.9601271090696;10.9909785719784;90;43.9511056810479
05;2020-11-23;0;0;0;3061.43020057959;2935.56979942041;0;5997
06;2020-11-23;0;0;0;42583;42380;09;84963
06;2020-11-23;2;2;4;33369;31925;19;65294
06;2020-11-23;5;4;9;21571;15080;29;36651
06;2020-11-23;5;2;7;21550;16147;39;37697
06;2020-11-23;0;2;2;14193;13939;49;28132
06;2020-11-23;3;2;5;7171;7597;59;14768
06;2020-11-23;0;0;0;3629;4117;69;7746
06;2020-11-23;0;0;0;1577;1457;79;3034
06;2020-11-23;0;1;1;531;474;89;1005
06;2020-11-23;1;0;1;88;93;90;181
06;2020-11-23;16;13;29;146262;133209;0;279471
07;2020-11-23;0;0;0;485;549;09;1034
07;2020-11-23;0;0;0;403;432;19;835
07;2020-11-23;1;0;1;764;841;29;1605
07;2020-11-23;1;0;1;824;928;39;1752
07;2020-11-23;0;1;1;788;1020;49;1808
07;2020-11-23;0;0;0;678;870;59;1548
07;2020-11-23;0;0;0;360;382;69;742
07;2020-11-23;0;0;0;231;190;79;421
07;2020-11-23;0;0;0;114;67;89;181
07;2020-11-23;0;0;0;24;11;90;35
07;2020-11-23;2;1;3;4671;5290;0;9961
08;2020-11-23;0;0;0;2715.22592983026;2997.75551488675;09;5712.98144471701
08;2020-11-23;0;1;1;2778.51901080978;3160.9156459093;19;5939.43465671908
08;2020-11-23;3;2;5;2080.8882988764;1718.16634315323;29;3799.05464202964
08;2020-11-23;3;1;4;2701.8582062647;1896.52641413317;39;4598.38462039786
08;2020-11-23;2;1;3;3151.45861023308;2460.52498233809;49;5611.98359257117
08;2020-11-23;0;2;2;2620.29868333099;2422.23566154656;59;5042.53434487755
08;2020-11-23;1;1;2;1621.44173420671;1438.58325779464;69;3060.02499200135
08;2020-11-23;0;0;0;626.575909335673;526.358467843651;79;1152.93437717932
08;2020-11-23;0;0;0;205.018522985054;140.993639349697;89;346.012162334751
08;2020-11-23;0;0;0;50.0325684687745;20.62259870351;90;70.6551671722846
08;2020-11-23;9;8;17;18551.3174743414;16782.6825256586;0;35334
11;2020-11-23;62;69;139;783071;811785;09;1594856
11;2020-11-23;221;215;446;761456;784653;19;1546109
11;2020-11-23;261;193;458;850145;801772;29;1651917
11;2020-11-23;335;255;591;914360;843488;39;1757848
11;2020-11-23;230;252;488;845609;826202;49;1671811
11;2020-11-23;223;218;445;793566;745070;59;1538636
11;2020-11-23;146;134;280;628649;549192;69;1177841
11;2020-11-23;92;94;187;434606;358356;79;792962
11;2020-11-23;86;58;146;261425;162933;89;424358
11;2020-11-23;83;22;105;89253;32619;90;121872
11;2020-11-23;1740;1510;3286;6362140;5916070;0;12278210
24;2020-11-23;2;2;5;139720;144686;09;284406
24;2020-11-23;24;37;63;152979;161185;19;314164
24;2020-11-23;36;25;61;122237;126536;29;248773
24;2020-11-23;44;28;72;150359;142009;39;292368
24;2020-11-23;56;39;95;161829;158758;49;320587
24;2020-11-23;48;42;90;172552;168011;59;340563
24;2020-11-23;29;23;52;172509;158177;69;330686
24;2020-11-23;22;24;46;129428;110593;79;240021
24;2020-11-23;44;32;76;87342;56882;89;144224
24;2020-11-23;33;15;48;31210;12071;90;43281
24;2020-11-23;338;267;608;1320165;1238908;0;2559073
27;2020-11-23;26;17;44;143373;149679;09;293052
27;2020-11-23;70;71;143;160962;173003;19;333965
27;2020-11-23;64;50;114;133746;142254;29;276000
27;2020-11-23;71;54;125;160004;155407;39;315411
27;2020-11-23;109;61;170;172333;169564;49;341897
27;2020-11-23;96;74;170;189979;183788;59;373767
27;2020-11-23;41;48;90;192591;178206;69;370797
27;2020-11-23;38;34;72;146876;127546;79;274422
27;2020-11-23;66;36;102;96896;61575;89;158471
27;2020-11-23;50;15;65;33148;12109;90;45257
27;2020-11-23;631;460;1095;1429908;1353131;0;2783039
28;2020-11-23;9;11;21;180735;186856;09;367591
28;2020-11-23;39;40;82;200125;213621;19;413746
28;2020-11-23;45;37;82;168922;173007;29;341929
28;2020-11-23;64;32;97;196628;188487;39;385115
28;2020-11-23;53;41;94;205396;201699;49;407095
28;2020-11-23;47;47;94;222002;213866;59;435868
28;2020-11-23;32;31;63;224688;203758;69;428446
28;2020-11-23;30;29;59;163192;135543;79;298735
28;2020-11-23;40;34;74;109691;65377;89;175068
28;2020-11-23;28;8;36;37222;12685;90;49907
28;2020-11-23;387;310;702;1708601;1594899;0;3303500
32;2020-11-23;27;29;56;358062;373689;09;731751
32;2020-11-23;128;99;227;387045;406742;19;793787
32;2020-11-23;111;94;205;342304;348587;29;690891
32;2020-11-23;158;94;252;382485;369972;39;752457
32;2020-11-23;151;99;250;382510;376716;49;759226
32;2020-11-23;116;119;235;386937;376527;59;763464
32;2020-11-23;76;76;152;371211;330938;69;702149
32;2020-11-23;67;60;127;250542;201459;79;452001
32;2020-11-23;72;35;107;163399;89786;89;253185
32;2020-11-23;62;10;72;48384;15367;90;63751
32;2020-11-23;968;715;1683;3072879;2889783;0;5962662
44;2020-11-23;36;46;83;291525;306839;09;598364
44;2020-11-23;89;103;192;320255;339504;19;659759
44;2020-11-23;130;91;221;302020;314428;29;616448
44;2020-11-23;132;87;220;342222;333292;39;675514
44;2020-11-23;158;114;273;349727;344491;49;694218
44;2020-11-23;142;119;261;381371;373239;59;754610
44;2020-11-23;69;67;139;367165;335850;69;703015
44;2020-11-23;60;56;116;250387;215436;79;465823
44;2020-11-23;96;46;145;170825;105192;89;276017
44;2020-11-23;76;22;99;51248;16731;90;67979
44;2020-11-23;988;751;1749;2826745;2685002;0;5511747
52;2020-11-23;9;8;17;213594;223900;09;437494
52;2020-11-23;40;28;72;240818;255197;19;496015
52;2020-11-23;39;38;77;197010;200630;29;397640
52;2020-11-23;47;43;90;231204;224885;39;456089
52;2020-11-23;46;33;79;243874;243418;49;487292
52;2020-11-23;45;41;86;244100;239116;59;483216
52;2020-11-23;20;22;42;241796;221345;69;463141
52;2020-11-23;15;14;29;177805;149903;79;327708
52;2020-11-23;33;20;53;119561;75822;89;195383
52;2020-11-23;40;18;58;42559;15260;90;57819
52;2020-11-23;334;265;603;1952321;1849476;0;3801797
53;2020-11-23;10;9;20;173813;182358;09;356171
53;2020-11-23;16;22;39;202720;214740;19;417460
53;2020-11-23;22;18;41;163116;173196;29;336312
53;2020-11-23;26;16;42;190526;187674;39;378200
53;2020-11-23;33;22;55;212098;212015;49;424113
53;2020-11-23;23;19;42;223699;219176;59;442875
53;2020-11-23;13;15;28;227435;209274;69;436709
53;2020-11-23;7;6;13;169992;140910;79;310902
53;2020-11-23;33;9;42;118117;69883;89;188000
53;2020-11-23;26;4;30;37370;12267;90;49637
53;2020-11-23;209;140;352;1718886;1621493;0;3340379
75;2020-11-23;14;14;29;293104;305291;09;598395
75;2020-11-23;53;53;107;337141;357785;19;694926
75;2020-11-23;107;59;167;295024;300618;29;595642
75;2020-11-23;83;60;143;347871;331233;39;679104
75;2020-11-23;76;70;146;384742;372771;49;757513
75;2020-11-23;95;55;150;413361;390880;59;804241
75;2020-11-23;46;44;90;425623;384060;69;809683
75;2020-11-23;36;43;79;325086;276298;79;601384
75;2020-11-23;68;38;106;213986;139308;89;353294
75;2020-11-23;67;16;83;77600;28200;90;105800
75;2020-11-23;646;452;1101;3113538;2886444;0;5999982
76;2020-11-23;21;18;39;305956;318589;09;624545
76;2020-11-23;62;63;128;338942;356969;19;695911
76;2020-11-23;67;36;103;316210;319570;29;635780
76;2020-11-23;83;71;154;356758;337587;39;694345
76;2020-11-23;81;68;149;376541;363812;49;740353
76;2020-11-23;97;64;161;402608;383750;59;786358
76;2020-11-23;70;64;134;394889;358997;69;753886
76;2020-11-23;52;38;90;308664;263806;79;572470
76;2020-11-23;62;23;85;195838;129272;89;325110
76;2020-11-23;44;14;58;69372;26728;90;96100
76;2020-11-23;643;461;1107;3065778;2859080;0;5924858
84;2020-11-23;59;66;126;459549;481088;09;940637
84;2020-11-23;228;247;478;487711;511905;19;999616
84;2020-11-23;242;183;425;443824;451094;29;894918
84;2020-11-23;257;208;466;512522;493262;39;1005784
84;2020-11-23;309;246;556;520248;515106;49;1035354
84;2020-11-23;275;248;523;529611;514848;59;1044459
84;2020-11-23;144;134;278;486720;439940;69;926660
84;2020-11-23;127;124;251;372151;315211;79;687362
84;2020-11-23;202;104;306;237198;150524;89;387722
84;2020-11-23;160;40;200;81185;28680;90;109865
84;2020-11-23;2003;1600;3609;4130719;3901658;0;8032377
93;2020-11-23;30;20;50;268834;283093;09;551927
93;2020-11-23;105;97;203;280751;296087;19;576838
93;2020-11-23;106;88;194;254404;255552;29;509956
93;2020-11-23;119;86;207;310704;288398;39;599102
93;2020-11-23;146;100;246;325559;305827;49;631386
93;2020-11-23;135;99;235;353104;325389;59;678493
93;2020-11-23;66;77;143;336327;296459;69;632786
93;2020-11-23;53;57;110;279820;229699;79;509519
93;2020-11-23;73;42;115;171274;113716;89;284990
93;2020-11-23;65;20;85;58896;21758;90;80654
93;2020-11-23;899;686;1589;2639673;2415978;0;5055651
94;2020-11-23;0;0;0;16311;17433;09;33744
94;2020-11-23;3;6;9;16679;18132;19;34811
94;2020-11-23;4;5;9;16782;16579;29;33361
94;2020-11-23;0;6;6;23044;20580;39;43624
94;2020-11-23;2;4;6;23065;22140;49;45205
94;2020-11-23;3;0;3;24549;23421;59;47970
94;2020-11-23;3;1;4;23212;21883;69;45095
94;2020-11-23;3;2;5;19544;17141;79;36685
94;2020-11-23;0;2;2;11227;8178;89;19405
94;2020-11-23;0;0;0;3332;1447;90;4779
94;2020-11-23;18;26;44;177745;166934;0;344679
01;2020-11-24;1;0;1;19979;20155;09;40134
01;2020-11-24;0;1;1;24994;25489;19;50483
01;2020-11-24;2;0;2;17868;16690;29;34558
01;2020-11-24;0;1;1;22328;14821;39;37149
01;2020-11-24;0;1;1;28652;20276;49;48928
01;2020-11-24;3;2;5;33264;27260;59;60524
01;2020-11-24;0;0;0;27135;23978;69;51113
01;2020-11-24;2;1;3;18401;14661;79;33062
01;2020-11-24;0;1;1;9633;6375;89;16008
01;2020-11-24;0;0;0;3410;1510;90;4920
01;2020-11-24;8;7;15;205664;171215;0;376879
02;2020-11-24;0;0;0;16881;17110;09;33991
02;2020-11-24;3;2;5;21410;21604;19;43014
02;2020-11-24;2;2;4;16017;15479;29;31496
02;2020-11-24;1;1;2;19825;14455;39;34280
02;2020-11-24;2;3;5;24719;18248;49;42967
02;2020-11-24;3;4;7;34361;28310;59;62671
02;2020-11-24;0;2;2;28061;24495;69;52556
02;2020-11-24;0;0;0;18231;15278;79;33509
02;2020-11-24;0;0;0;11090;7677;89;18767
02;2020-11-24;1;0;1;3992;1506;90;5498
02;2020-11-24;12;14;26;194587;164162;0;358749
03;2020-11-24;0;2;2;31123;30920;09;62043
03;2020-11-24;3;3;6;29370;29268;19;58638
03;2020-11-24;2;1;3;21458;18963;29;40421
03;2020-11-24;6;2;8;21276;18326;39;39602
03;2020-11-24;1;2;3;18164;16593;49;34757
03;2020-11-24;1;3;4;13469;13557;59;27026
03;2020-11-24;1;1;2;8776;8670;69;17446
03;2020-11-24;0;1;1;3777;3591;79;7368
03;2020-11-24;0;0;0;1649;1072;89;2721
03;2020-11-24;0;0;0;485;184;90;669
03;2020-11-24;14;15;30;149547;141144;0;290691
04;2020-11-24;0;1;1;60314;61377;09;121691
04;2020-11-24;5;7;12;66065;68387;19;134452
04;2020-11-24;5;9;14;51059;47156;29;98215
04;2020-11-24;6;4;10;58788;45780;39;104568
04;2020-11-24;4;4;8;61408;52207;49;113615
04;2020-11-24;5;6;11;64838;60759;59;125597
04;2020-11-24;4;4;8;47008;42843;69;89851
04;2020-11-24;3;2;5;25509;21184;79;46693
04;2020-11-24;1;0;1;13168;7647;89;20815
04;2020-11-24;0;0;0;3209;1253;90;4462
04;2020-11-24;33;37;70;451366;408593;0;859959
05;2020-11-24;0;0;0;362.366008612902;341.338819562748;09;703.704828175651
05;2020-11-24;0;0;0;353.376145114279;370.349735405642;19;723.725880519921
05;2020-11-24;0;0;0;218.593559489256;256.539602589476;29;475.133162078732
05;2020-11-24;0;0;0;404.225408693299;360.321910454353;39;764.547319147651
05;2020-11-24;0;0;0;520.067953604221;497.108383964256;49;1017.17633756848
05;2020-11-24;0;0;0;468.146063921917;510.087601910415;59;978.233665832332
05;2020-11-24;0;0;0;340.368470050554;334.366842191253;69;674.735312241807
05;2020-11-24;0;0;0;212.598666888387;192.597753227106;79;405.196420115493
05;2020-11-24;0;0;0;148.727797095705;61.8681715431829;89;210.595968638888
05;2020-11-24;0;0;0;32.9601271090696;10.9909785719784;90;43.9511056810479
05;2020-11-24;0;0;0;3061.43020057959;2935.56979942041;0;5997
06;2020-11-24;0;0;0;42583;42380;09;84963
06;2020-11-24;1;1;2;33369;31925;19;65294
06;2020-11-24;3;1;4;21571;15080;29;36651
06;2020-11-24;3;5;8;21550;16147;39;37697
06;2020-11-24;5;3;8;14193;13939;49;28132
06;2020-11-24;1;0;1;7171;7597;59;14768
06;2020-11-24;0;2;2;3629;4117;69;7746
06;2020-11-24;1;2;3;1577;1457;79;3034
06;2020-11-24;0;0;0;531;474;89;1005
06;2020-11-24;0;0;0;88;93;90;181
06;2020-11-24;14;14;28;146262;133209;0;279471
07;2020-11-24;0;0;0;485;549;09;1034
07;2020-11-24;0;0;0;403;432;19;835
07;2020-11-24;1;0;1;764;841;29;1605
07;2020-11-24;0;0;0;824;928;39;1752
07;2020-11-24;0;0;0;788;1020;49;1808
07;2020-11-24;0;1;1;678;870;59;1548
07;2020-11-24;0;0;0;360;382;69;742
07;2020-11-24;0;0;0;231;190;79;421
07;2020-11-24;0;0;0;114;67;89;181
07;2020-11-24;0;0;0;24;11;90;35
07;2020-11-24;1;1;2;4671;5290;0;9961
08;2020-11-24;0;0;0;2715.22592983026;2997.75551488675;09;5712.98144471701
08;2020-11-24;0;3;3;2778.51901080978;3160.9156459093;19;5939.43465671908
08;2020-11-24;3;2;5;2080.8882988764;1718.16634315323;29;3799.05464202964
08;2020-11-24;3;1;4;2701.8582062647;1896.52641413317;39;4598.38462039786
08;2020-11-24;2;0;2;3151.45861023308;2460.52498233809;49;5611.98359257117
08;2020-11-24;2;1;3;2620.29868333099;2422.23566154656;59;5042.53434487755
08;2020-11-24;0;1;1;1621.44173420671;1438.58325779464;69;3060.02499200135
08;2020-11-24;0;0;0;626.575909335673;526.358467843651;79;1152.93437717932
08;2020-11-24;0;0;0;205.018522985054;140.993639349697;89;346.012162334751
08;2020-11-24;0;0;0;50.0325684687745;20.62259870351;90;70.6551671722846
08;2020-11-24;10;8;18;18551.3174743414;16782.6825256586;0;35334
11;2020-11-24;43;30;75;783071;811785;09;1594856
11;2020-11-24;154;148;304;761456;784653;19;1546109
11;2020-11-24;209;147;356;850145;801772;29;1651917
11;2020-11-24;219;198;418;914360;843488;39;1757848
11;2020-11-24;201;183;386;845609;826202;49;1671811
11;2020-11-24;166;177;345;793566;745070;59;1538636
11;2020-11-24;124;107;233;628649;549192;69;1177841
11;2020-11-24;67;64;131;434606;358356;79;792962
11;2020-11-24;90;54;144;261425;162933;89;424358
11;2020-11-24;57;28;85;89253;32619;90;121872
11;2020-11-24;1330;1136;2479;6362140;5916070;0;12278210
24;2020-11-24;2;7;9;139720;144686;09;284406
24;2020-11-24;29;29;58;152979;161185;19;314164
24;2020-11-24;29;25;54;122237;126536;29;248773
24;2020-11-24;46;20;66;150359;142009;39;292368
24;2020-11-24;35;28;63;161829;158758;49;320587
24;2020-11-24;40;29;69;172552;168011;59;340563
24;2020-11-24;28;22;50;172509;158177;69;330686
24;2020-11-24;23;21;44;129428;110593;79;240021
24;2020-11-24;36;19;55;87342;56882;89;144224
24;2020-11-24;25;9;34;31210;12071;90;43281
24;2020-11-24;293;209;502;1320165;1238908;0;2559073
27;2020-11-24;14;8;23;143373;149679;09;293052
27;2020-11-24;58;50;109;160962;173003;19;333965
27;2020-11-24;62;40;102;133746;142254;29;276000
27;2020-11-24;48;44;92;160004;155407;39;315411
27;2020-11-24;72;42;114;172333;169564;49;341897
27;2020-11-24;72;54;126;189979;183788;59;373767
27;2020-11-24;49;38;87;192591;178206;69;370797
27;2020-11-24;34;37;71;146876;127546;79;274422
27;2020-11-24;55;30;85;96896;61575;89;158471
27;2020-11-24;68;13;81;33148;12109;90;45257
27;2020-11-24;532;356;890;1429908;1353131;0;2783039
28;2020-11-24;4;9;13;180735;186856;09;367591
28;2020-11-24;34;31;65;200125;213621;19;413746
28;2020-11-24;33;24;57;168922;173007;29;341929
28;2020-11-24;40;24;65;196628;188487;39;385115
28;2020-11-24;49;35;84;205396;201699;49;407095
28;2020-11-24;36;20;56;222002;213866;59;435868
28;2020-11-24;32;25;57;224688;203758;69;428446
28;2020-11-24;25;20;45;163192;135543;79;298735
28;2020-11-24;39;8;47;109691;65377;89;175068
28;2020-11-24;37;11;48;37222;12685;90;49907
28;2020-11-24;329;207;537;1708601;1594899;0;3303500
32;2020-11-24;29;26;55;358062;373689;09;731751
32;2020-11-24;79;88;167;387045;406742;19;793787
32;2020-11-24;84;67;151;342304;348587;29;690891
32;2020-11-24;101;68;169;382485;369972;39;752457
32;2020-11-24;109;75;184;382510;376716;49;759226
32;2020-11-24;100;91;191;386937;376527;59;763464
32;2020-11-24;65;55;120;371211;330938;69;702149
32;2020-11-24;52;50;102;250542;201459;79;452001
32;2020-11-24;74;26;100;163399;89786;89;253185
32;2020-11-24;55;15;70;48384;15367;90;63751
32;2020-11-24;748;561;1309;3072879;2889783;0;5962662
44;2020-11-24;21;24;45;291525;306839;09;598364
44;2020-11-24;90;69;161;320255;339504;19;659759
44;2020-11-24;85;53;139;302020;314428;29;616448
44;2020-11-24;107;70;179;342222;333292;39;675514
44;2020-11-24;108;76;187;349727;344491;49;694218
44;2020-11-24;101;72;175;381371;373239;59;754610
44;2020-11-24;69;75;145;367165;335850;69;703015
44;2020-11-24;50;51;101;250387;215436;79;465823
44;2020-11-24;105;46;153;170825;105192;89;276017
44;2020-11-24;77;28;106;51248;16731;90;67979
44;2020-11-24;813;564;1391;2826745;2685002;0;5511747
52;2020-11-24;8;4;12;213594;223900;09;437494
52;2020-11-24;32;25;57;240818;255197;19;496015
52;2020-11-24;49;20;69;197010;200630;29;397640
52;2020-11-24;30;23;53;231204;224885;39;456089
52;2020-11-24;37;30;67;243874;243418;49;487292
52;2020-11-24;36;28;64;244100;239116;59;483216
52;2020-11-24;17;11;28;241796;221345;69;463141
52;2020-11-24;14;17;31;177805;149903;79;327708
52;2020-11-24;43;17;60;119561;75822;89;195383
52;2020-11-24;46;8;54;42559;15260;90;57819
52;2020-11-24;312;183;495;1952321;1849476;0;3801797
53;2020-11-24;4;11;15;173813;182358;09;356171
53;2020-11-24;16;15;31;202720;214740;19;417460
53;2020-11-24;22;12;35;163116;173196;29;336312
53;2020-11-24;12;13;25;190526;187674;39;378200
53;2020-11-24;22;18;40;212098;212015;49;424113
53;2020-11-24;13;15;28;223699;219176;59;442875
53;2020-11-24;10;10;20;227435;209274;69;436709
53;2020-11-24;12;7;19;169992;140910;79;310902
53;2020-11-24;13;11;24;118117;69883;89;188000
53;2020-11-24;12;2;14;37370;12267;90;49637
53;2020-11-24;136;114;251;1718886;1621493;0;3340379
75;2020-11-24;10;20;31;293104;305291;09;598395
75;2020-11-24;51;36;87;337141;357785;19;694926
75;2020-11-24;63;39;102;295024;300618;29;595642
75;2020-11-24;56;45;101;347871;331233;39;679104
75;2020-11-24;85;54;139;384742;372771;49;757513
75;2020-11-24;68;54;122;413361;390880;59;804241
75;2020-11-24;39;40;79;425623;384060;69;809683
75;2020-11-24;32;28;60;325086;276298;79;601384
75;2020-11-24;65;36;101;213986;139308;89;353294
75;2020-11-24;55;22;77;77600;28200;90;105800
75;2020-11-24;524;374;899;3113538;2886444;0;5999982
76;2020-11-24;8;15;24;305956;318589;09;624545
76;2020-11-24;53;32;86;338942;356969;19;695911
76;2020-11-24;40;44;84;316210;319570;29;635780
76;2020-11-24;81;43;124;356758;337587;39;694345
76;2020-11-24;77;50;128;376541;363812;49;740353
76;2020-11-24;68;41;109;402608;383750;59;786358
76;2020-11-24;44;27;72;394889;358997;69;753886
76;2020-11-24;34;42;76;308664;263806;79;572470
76;2020-11-24;59;33;92;195838;129272;89;325110
76;2020-11-24;54;24;78;69372;26728;90;96100
76;2020-11-24;518;351;873;3065778;2859080;0;5924858
84;2020-11-24;35;30;65;459549;481088;09;940637
84;2020-11-24;166;169;337;487711;511905;19;999616
84;2020-11-24;158;137;296;443824;451094;29;894918
84;2020-11-24;204;125;331;512522;493262;39;1005784
84;2020-11-24;192;158;350;520248;515106;49;1035354
84;2020-11-24;211;139;350;529611;514848;59;1044459
84;2020-11-24;107;109;216;486720;439940;69;926660
84;2020-11-24;89;95;184;372151;315211;79;687362
84;2020-11-24;155;69;224;237198;150524;89;387722
84;2020-11-24;179;43;222;81185;28680;90;109865
84;2020-11-24;1496;1074;2575;4130719;3901658;0;8032377
93;2020-11-24;22;20;42;268834;283093;09;551927
93;2020-11-24;70;60;130;280751;296087;19;576838
93;2020-11-24;101;71;172;254404;255552;29;509956
93;2020-11-24;99;82;183;310704;288398;39;599102
93;2020-11-24;105;76;181;325559;305827;49;631386
93;2020-11-24;110;75;186;353104;325389;59;678493
93;2020-11-24;61;47;110;336327;296459;69;632786
93;2020-11-24;51;66;117;279820;229699;79;509519
93;2020-11-24;95;31;126;171274;113716;89;284990
93;2020-11-24;57;17;74;58896;21758;90;80654
93;2020-11-24;771;547;1323;2639673;2415978;0;5055651
94;2020-11-24;0;0;0;16311;17433;09;33744
94;2020-11-24;1;0;1;16679;18132;19;34811
94;2020-11-24;0;0;0;16782;16579;29;33361
94;2020-11-24;0;1;1;23044;20580;39;43624
94;2020-11-24;2;1;3;23065;22140;49;45205
94;2020-11-24;0;1;1;24549;23421;59;47970
94;2020-11-24;0;0;0;23212;21883;69;45095
94;2020-11-24;0;1;1;19544;17141;79;36685
94;2020-11-24;0;1;1;11227;8178;89;19405
94;2020-11-24;0;0;0;3332;1447;90;4779
94;2020-11-24;3;5;8;177745;166934;0;344679
01;2020-11-25;0;0;0;19979;20155;09;40134
01;2020-11-25;1;0;1;24994;25489;19;50483
01;2020-11-25;0;1;1;17868;16690;29;34558
01;2020-11-25;2;0;2;22328;14821;39;37149
01;2020-11-25;0;1;1;28652;20276;49;48928
01;2020-11-25;0;0;0;33264;27260;59;60524
01;2020-11-25;1;1;2;27135;23978;69;51113
01;2020-11-25;1;0;1;18401;14661;79;33062
01;2020-11-25;0;0;0;9633;6375;89;16008
01;2020-11-25;0;0;0;3410;1510;90;4920
01;2020-11-25;5;3;8;205664;171215;0;376879
02;2020-11-25;0;0;0;16881;17110;09;33991
02;2020-11-25;1;3;4;21410;21604;19;43014
02;2020-11-25;0;1;1;16017;15479;29;31496
02;2020-11-25;2;2;4;19825;14455;39;34280
02;2020-11-25;1;1;2;24719;18248;49;42967
02;2020-11-25;2;0;2;34361;28310;59;62671
02;2020-11-25;2;1;3;28061;24495;69;52556
02;2020-11-25;1;0;1;18231;15278;79;33509
02;2020-11-25;0;0;0;11090;7677;89;18767
02;2020-11-25;0;0;0;3992;1506;90;5498
02;2020-11-25;9;8;17;194587;164162;0;358749
03;2020-11-25;0;1;1;31123;30920;09;62043
03;2020-11-25;2;5;7;29370;29268;19;58638
03;2020-11-25;3;1;4;21458;18963;29;40421
03;2020-11-25;2;4;6;21276;18326;39;39602
03;2020-11-25;0;1;1;18164;16593;49;34757
03;2020-11-25;1;1;2;13469;13557;59;27026
03;2020-11-25;0;3;3;8776;8670;69;17446
03;2020-11-25;0;1;1;3777;3591;79;7368
03;2020-11-25;0;0;0;1649;1072;89;2721
03;2020-11-25;0;0;0;485;184;90;669
03;2020-11-25;8;17;25;149547;141144;0;290691
04;2020-11-25;1;2;3;60314;61377;09;121691
04;2020-11-25;9;4;13;66065;68387;19;134452
04;2020-11-25;3;4;7;51059;47156;29;98215
04;2020-11-25;5;1;6;58788;45780;39;104568
04;2020-11-25;4;3;7;61408;52207;49;113615
04;2020-11-25;4;4;8;64838;60759;59;125597
04;2020-11-25;0;1;1;47008;42843;69;89851
04;2020-11-25;1;1;2;25509;21184;79;46693
04;2020-11-25;0;0;0;13168;7647;89;20815
04;2020-11-25;0;0;0;3209;1253;90;4462
04;2020-11-25;27;20;47;451366;408593;0;859959
05;2020-11-25;0;0;0;362.366008612902;341.338819562748;09;703.704828175651
05;2020-11-25;0;0;0;353.376145114279;370.349735405642;19;723.725880519921
05;2020-11-25;0;0;0;218.593559489256;256.539602589476;29;475.133162078732
05;2020-11-25;0;0;0;404.225408693299;360.321910454353;39;764.547319147651
05;2020-11-25;0;0;0;520.067953604221;497.108383964256;49;1017.17633756848
05;2020-11-25;0;0;0;468.146063921917;510.087601910415;59;978.233665832332
05;2020-11-25;0;0;0;340.368470050554;334.366842191253;69;674.735312241807
05;2020-11-25;0;0;0;212.598666888387;192.597753227106;79;405.196420115493
05;2020-11-25;0;0;0;148.727797095705;61.8681715431829;89;210.595968638888
05;2020-11-25;0;0;0;32.9601271090696;10.9909785719784;90;43.9511056810479
05;2020-11-25;0;0;0;3061.43020057959;2935.56979942041;0;5997
06;2020-11-25;0;0;0;42583;42380;09;84963
06;2020-11-25;1;0;1;33369;31925;19;65294
06;2020-11-25;2;2;4;21571;15080;29;36651
06;2020-11-25;4;0;4;21550;16147;39;37697
06;2020-11-25;3;0;3;14193;13939;49;28132
06;2020-11-25;1;0;1;7171;7597;59;14768
06;2020-11-25;1;0;1;3629;4117;69;7746
06;2020-11-25;0;0;0;1577;1457;79;3034
06;2020-11-25;0;0;0;531;474;89;1005
06;2020-11-25;0;0;0;88;93;90;181
06;2020-11-25;12;2;14;146262;133209;0;279471
07;2020-11-25;0;0;0;485;549;09;1034
07;2020-11-25;0;0;0;403;432;19;835
07;2020-11-25;0;0;0;764;841;29;1605
07;2020-11-25;1;0;1;824;928;39;1752
07;2020-11-25;0;0;0;788;1020;49;1808
07;2020-11-25;0;0;0;678;870;59;1548
07;2020-11-25;0;0;0;360;382;69;742
07;2020-11-25;0;0;0;231;190;79;421
07;2020-11-25;0;0;0;114;67;89;181
07;2020-11-25;0;0;0;24;11;90;35
07;2020-11-25;1;0;1;4671;5290;0;9961
08;2020-11-25;0;1;1;2715.22592983026;2997.75551488675;09;5712.98144471701
08;2020-11-25;2;0;2;2778.51901080978;3160.9156459093;19;5939.43465671908
08;2020-11-25;1;3;4;2080.8882988764;1718.16634315323;29;3799.05464202964
08;2020-11-25;4;1;5;2701.8582062647;1896.52641413317;39;4598.38462039786
08;2020-11-25;1;3;4;3151.45861023308;2460.52498233809;49;5611.98359257117
08;2020-11-25;1;0;1;2620.29868333099;2422.23566154656;59;5042.53434487755
08;2020-11-25;0;0;0;1621.44173420671;1438.58325779464;69;3060.02499200135
08;2020-11-25;0;0;0;626.575909335673;526.358467843651;79;1152.93437717932
08;2020-11-25;0;0;0;205.018522985054;140.993639349697;89;346.012162334751
08;2020-11-25;0;0;0;50.0325684687745;20.62259870351;90;70.6551671722846
08;2020-11-25;9;8;17;18551.3174743414;16782.6825256586;0;35334
11;2020-11-25;51;48;106;783071;811785;09;1594856
11;2020-11-25;141;150;302;761456;784653;19;1546109
11;2020-11-25;212;189;402;850145;801772;29;1651917
11;2020-11-25;228;162;393;914360;843488;39;1757848
11;2020-11-25;229;188;418;845609;826202;49;1671811
11;2020-11-25;191;171;362;793566;745070;59;1538636
11;2020-11-25;109;131;241;628649;549192;69;1177841
11;2020-11-25;70;64;134;434606;358356;79;792962
11;2020-11-25;69;45;115;261425;162933;89;424358
11;2020-11-25;55;11;66;89253;32619;90;121872
11;2020-11-25;1356;1160;2542;6362140;5916070;0;12278210
24;2020-11-25;6;6;12;139720;144686;09;284406
24;2020-11-25;26;25;51;152979;161185;19;314164
24;2020-11-25;26;18;44;122237;126536;29;248773
24;2020-11-25;22;23;45;150359;142009;39;292368
24;2020-11-25;37;17;54;161829;158758;49;320587
24;2020-11-25;25;33;58;172552;168011;59;340563
24;2020-11-25;13;19;33;172509;158177;69;330686
24;2020-11-25;27;11;38;129428;110593;79;240021
24;2020-11-25;27;23;50;87342;56882;89;144224
24;2020-11-25;46;6;52;31210;12071;90;43281
24;2020-11-25;256;181;438;1320165;1238908;0;2559073
27;2020-11-25;10;14;24;143373;149679;09;293052
27;2020-11-25;53;51;104;160962;173003;19;333965
27;2020-11-25;58;30;88;133746;142254;29;276000
27;2020-11-25;69;50;119;160004;155407;39;315411
27;2020-11-25;66;45;111;172333;169564;49;341897
27;2020-11-25;72;38;110;189979;183788;59;373767
27;2020-11-25;25;39;64;192591;178206;69;370797
27;2020-11-25;40;31;71;146876;127546;79;274422
27;2020-11-25;52;27;79;96896;61575;89;158471
27;2020-11-25;42;12;54;33148;12109;90;45257
27;2020-11-25;487;337;824;1429908;1353131;0;2783039
28;2020-11-25;11;13;25;180735;186856;09;367591
28;2020-11-25;31;33;65;200125;213621;19;413746
28;2020-11-25;25;19;44;168922;173007;29;341929
28;2020-11-25;39;27;66;196628;188487;39;385115
28;2020-11-25;39;28;67;205396;201699;49;407095
28;2020-11-25;41;25;67;222002;213866;59;435868
28;2020-11-25;29;26;55;224688;203758;69;428446
28;2020-11-25;15;17;33;163192;135543;79;298735
28;2020-11-25;26;11;37;109691;65377;89;175068
28;2020-11-25;14;5;19;37222;12685;90;49907
28;2020-11-25;270;205;479;1708601;1594899;0;3303500
32;2020-11-25;42;26;68;358062;373689;09;731751
32;2020-11-25;82;75;157;387045;406742;19;793787
32;2020-11-25;77;69;146;342304;348587;29;690891
32;2020-11-25;90;67;157;382485;369972;39;752457
32;2020-11-25;82;71;153;382510;376716;49;759226
32;2020-11-25;94;65;159;386937;376527;59;763464
32;2020-11-25;57;57;114;371211;330938;69;702149
32;2020-11-25;47;38;85;250542;201459;79;452001
32;2020-11-25;49;28;77;163399;89786;89;253185
32;2020-11-25;50;10;60;48384;15367;90;63751
32;2020-11-25;670;506;1176;3072879;2889783;0;5962662
44;2020-11-25;17;21;39;291525;306839;09;598364
44;2020-11-25;83;59;142;320255;339504;19;659759
44;2020-11-25;78;70;148;302020;314428;29;616448
44;2020-11-25;93;72;166;342222;333292;39;675514
44;2020-11-25;89;68;157;349727;344491;49;694218
44;2020-11-25;90;52;144;381371;373239;59;754610
44;2020-11-25;44;38;82;367165;335850;69;703015
44;2020-11-25;41;44;86;250387;215436;79;465823
44;2020-11-25;73;38;111;170825;105192;89;276017
44;2020-11-25;48;13;61;51248;16731;90;67979
44;2020-11-25;656;475;1136;2826745;2685002;0;5511747
52;2020-11-25;12;12;24;213594;223900;09;437494
52;2020-11-25;27;28;56;240818;255197;19;496015
52;2020-11-25;33;27;60;197010;200630;29;397640
52;2020-11-25;29;27;56;231204;224885;39;456089
52;2020-11-25;31;26;57;243874;243418;49;487292
52;2020-11-25;41;18;59;244100;239116;59;483216
52;2020-11-25;19;16;35;241796;221345;69;463141
52;2020-11-25;15;9;24;177805;149903;79;327708
52;2020-11-25;40;21;61;119561;75822;89;195383
52;2020-11-25;25;6;31;42559;15260;90;57819
52;2020-11-25;272;190;463;1952321;1849476;0;3801797
53;2020-11-25;4;5;10;173813;182358;09;356171
53;2020-11-25;15;10;25;202720;214740;19;417460
53;2020-11-25;19;15;35;163116;173196;29;336312
53;2020-11-25;17;13;30;190526;187674;39;378200
53;2020-11-25;16;15;31;212098;212015;49;424113
53;2020-11-25;19;15;34;223699;219176;59;442875
53;2020-11-25;8;12;20;227435;209274;69;436709
53;2020-11-25;4;4;8;169992;140910;79;310902
53;2020-11-25;13;10;23;118117;69883;89;188000
53;2020-11-25;11;6;17;37370;12267;90;49637
53;2020-11-25;126;105;233;1718886;1621493;0;3340379
75;2020-11-25;16;10;26;293104;305291;09;598395
75;2020-11-25;60;44;106;337141;357785;19;694926
75;2020-11-25;65;52;117;295024;300618;29;595642
75;2020-11-25;69;51;120;347871;331233;39;679104
75;2020-11-25;75;40;115;384742;372771;49;757513
75;2020-11-25;86;47;133;413361;390880;59;804241
75;2020-11-25;33;29;62;425623;384060;69;809683
75;2020-11-25;31;22;53;325086;276298;79;601384
75;2020-11-25;49;19;68;213986;139308;89;353294
75;2020-11-25;62;17;79;77600;28200;90;105800
75;2020-11-25;546;331;879;3113538;2886444;0;5999982
76;2020-11-25;7;11;18;305956;318589;09;624545
76;2020-11-25;51;51;102;338942;356969;19;695911
76;2020-11-25;54;42;96;316210;319570;29;635780
76;2020-11-25;66;49;115;356758;337587;39;694345
76;2020-11-25;68;52;121;376541;363812;49;740353
76;2020-11-25;65;48;113;402608;383750;59;786358
76;2020-11-25;35;24;59;394889;358997;69;753886
76;2020-11-25;22;24;46;308664;263806;79;572470
76;2020-11-25;59;30;89;195838;129272;89;325110
76;2020-11-25;60;17;77;69372;26728;90;96100
76;2020-11-25;488;350;839;3065778;2859080;0;5924858
84;2020-11-25;37;32;71;459549;481088;09;940637
84;2020-11-25;147;164;313;487711;511905;19;999616
84;2020-11-25;176;100;276;443824;451094;29;894918
84;2020-11-25;177;122;299;512522;493262;39;1005784
84;2020-11-25;182;139;321;520248;515106;49;1035354
84;2020-11-25;165;145;310;529611;514848;59;1044459
84;2020-11-25;81;91;172;486720;439940;69;926660
84;2020-11-25;85;78;163;372151;315211;79;687362
84;2020-11-25;135;63;198;237198;150524;89;387722
84;2020-11-25;136;28;164;81185;28680;90;109865
84;2020-11-25;1321;962;2287;4130719;3901658;0;8032377
93;2020-11-25;17;22;39;268834;283093;09;551927
93;2020-11-25;59;60;120;280751;296087;19;576838
93;2020-11-25;93;83;176;254404;255552;29;509956
93;2020-11-25;72;72;144;310704;288398;39;599102
93;2020-11-25;88;69;157;325559;305827;49;631386
93;2020-11-25;84;75;159;353104;325389;59;678493
93;2020-11-25;61;56;117;336327;296459;69;632786
93;2020-11-25;55;35;90;279820;229699;79;509519
93;2020-11-25;74;42;116;171274;113716;89;284990
93;2020-11-25;62;13;75;58896;21758;90;80654
93;2020-11-25;665;527;1193;2639673;2415978;0;5055651
94;2020-11-25;1;0;1;16311;17433;09;33744
94;2020-11-25;0;1;1;16679;18132;19;34811
94;2020-11-25;0;0;0;16782;16579;29;33361
94;2020-11-25;0;2;2;23044;20580;39;43624
94;2020-11-25;2;2;4;23065;22140;49;45205
94;2020-11-25;1;1;2;24549;23421;59;47970
94;2020-11-25;0;2;2;23212;21883;69;45095
94;2020-11-25;0;0;0;19544;17141;79;36685
94;2020-11-25;1;0;1;11227;8178;89;19405
94;2020-11-25;1;0;1;3332;1447;90;4779
94;2020-11-25;6;8;14;177745;166934;0;344679
01;2020-11-26;0;0;0;19979;20155;09;40134
01;2020-11-26;2;3;5;24994;25489;19;50483
01;2020-11-26;1;1;2;17868;16690;29;34558
01;2020-11-26;1;1;2;22328;14821;39;37149
01;2020-11-26;1;1;2;28652;20276;49;48928
01;2020-11-26;1;0;1;33264;27260;59;60524
01;2020-11-26;0;1;1;27135;23978;69;51113
01;2020-11-26;1;1;2;18401;14661;79;33062
01;2020-11-26;0;0;0;9633;6375;89;16008
01;2020-11-26;0;0;0;3410;1510;90;4920
01;2020-11-26;7;8;15;205664;171215;0;376879
02;2020-11-26;0;0;0;16881;17110;09;33991
02;2020-11-26;1;0;1;21410;21604;19;43014
02;2020-11-26;0;1;1;16017;15479;29;31496
02;2020-11-26;3;8;11;19825;14455;39;34280
02;2020-11-26;0;1;1;24719;18248;49;42967
02;2020-11-26;2;1;3;34361;28310;59;62671
02;2020-11-26;3;0;3;28061;24495;69;52556
02;2020-11-26;1;0;1;18231;15278;79;33509
02;2020-11-26;0;0;0;11090;7677;89;18767
02;2020-11-26;0;0;0;3992;1506;90;5498
02;2020-11-26;10;11;21;194587;164162;0;358749
03;2020-11-26;0;0;0;31123;30920;09;62043
03;2020-11-26;2;4;6;29370;29268;19;58638
03;2020-11-26;2;2;4;21458;18963;29;40421
03;2020-11-26;2;4;6;21276;18326;39;39602
03;2020-11-26;1;1;2;18164;16593;49;34757
03;2020-11-26;1;0;1;13469;13557;59;27026
03;2020-11-26;2;0;2;8776;8670;69;17446
03;2020-11-26;0;0;0;3777;3591;79;7368
03;2020-11-26;0;0;0;1649;1072;89;2721
03;2020-11-26;0;0;0;485;184;90;669
03;2020-11-26;10;11;21;149547;141144;0;290691
04;2020-11-26;2;1;3;60314;61377;09;121691
04;2020-11-26;8;6;14;66065;68387;19;134452
04;2020-11-26;5;4;9;51059;47156;29;98215
04;2020-11-26;6;2;8;58788;45780;39;104568
04;2020-11-26;5;4;9;61408;52207;49;113615
04;2020-11-26;1;2;3;64838;60759;59;125597
04;2020-11-26;2;1;3;47008;42843;69;89851
04;2020-11-26;2;0;2;25509;21184;79;46693
04;2020-11-26;1;0;1;13168;7647;89;20815
04;2020-11-26;0;0;0;3209;1253;90;4462
04;2020-11-26;32;20;52;451366;408593;0;859959
05;2020-11-26;0;0;0;362.366008612902;341.338819562748;09;703.704828175651
05;2020-11-26;0;0;0;353.376145114279;370.349735405642;19;723.725880519921
05;2020-11-26;0;0;0;218.593559489256;256.539602589476;29;475.133162078732
05;2020-11-26;0;0;0;404.225408693299;360.321910454353;39;764.547319147651
05;2020-11-26;0;0;0;520.067953604221;497.108383964256;49;1017.17633756848
05;2020-11-26;0;0;0;468.146063921917;510.087601910415;59;978.233665832332
05;2020-11-26;0;0;0;340.368470050554;334.366842191253;69;674.735312241807
05;2020-11-26;0;0;0;212.598666888387;192.597753227106;79;405.196420115493
05;2020-11-26;0;0;0;148.727797095705;61.8681715431829;89;210.595968638888
05;2020-11-26;0;0;0;32.9601271090696;10.9909785719784;90;43.9511056810479
05;2020-11-26;0;0;0;3061.43020057959;2935.56979942041;0;5997
06;2020-11-26;1;0;1;42583;42380;09;84963
06;2020-11-26;3;0;3;33369;31925;19;65294
06;2020-11-26;3;2;5;21571;15080;29;36651
06;2020-11-26;3;2;5;21550;16147;39;37697
06;2020-11-26;0;0;0;14193;13939;49;28132
06;2020-11-26;3;1;4;7171;7597;59;14768
06;2020-11-26;0;1;1;3629;4117;69;7746
06;2020-11-26;0;0;0;1577;1457;79;3034
06;2020-11-26;0;0;0;531;474;89;1005
06;2020-11-26;0;0;0;88;93;90;181
06;2020-11-26;13;6;19;146262;133209;0;279471
07;2020-11-26;0;0;0;485;549;09;1034
07;2020-11-26;0;1;1;403;432;19;835
07;2020-11-26;0;0;0;764;841;29;1605
07;2020-11-26;0;1;1;824;928;39;1752
07;2020-11-26;0;0;0;788;1020;49;1808
07;2020-11-26;0;1;1;678;870;59;1548
07;2020-11-26;1;0;1;360;382;69;742
07;2020-11-26;0;0;0;231;190;79;421
07;2020-11-26;0;0;0;114;67;89;181
07;2020-11-26;0;0;0;24;11;90;35
07;2020-11-26;1;3;4;4671;5290;0;9961
08;2020-11-26;0;0;0;2715.22592983026;2997.75551488675;09;5712.98144471701
08;2020-11-26;2;0;2;2778.51901080978;3160.9156459093;19;5939.43465671908
08;2020-11-26;0;0;0;2080.8882988764;1718.16634315323;29;3799.05464202964
08;2020-11-26;1;0;1;2701.8582062647;1896.52641413317;39;4598.38462039786
08;2020-11-26;0;1;1;3151.45861023308;2460.52498233809;49;5611.98359257117
08;2020-11-26;0;0;0;2620.29868333099;2422.23566154656;59;5042.53434487755
08;2020-11-26;0;2;2;1621.44173420671;1438.58325779464;69;3060.02499200135
08;2020-11-26;0;0;0;626.575909335673;526.358467843651;79;1152.93437717932
08;2020-11-26;0;0;0;205.018522985054;140.993639349697;89;346.012162334751
08;2020-11-26;0;0;0;50.0325684687745;20.62259870351;90;70.6551671722846
08;2020-11-26;3;3;6;18551.3174743414;16782.6825256586;0;35334
11;2020-11-26;36;35;73;783071;811785;09;1594856
11;2020-11-26;146;151;308;761456;784653;19;1546109
11;2020-11-26;215;166;384;850145;801772;29;1651917
11;2020-11-26;231;174;406;914360;843488;39;1757848
11;2020-11-26;205;172;381;845609;826202;49;1671811
11;2020-11-26;161;159;321;793566;745070;59;1538636
11;2020-11-26;113;104;218;628649;549192;69;1177841
11;2020-11-26;46;53;100;434606;358356;79;792962
11;2020-11-26;50;42;92;261425;162933;89;424358
11;2020-11-26;47;17;64;89253;32619;90;121872
11;2020-11-26;1251;1076;2351;6362140;5916070;0;12278210
24;2020-11-26;11;4;15;139720;144686;09;284406
24;2020-11-26;23;16;39;152979;161185;19;314164
24;2020-11-26;32;15;47;122237;126536;29;248773
24;2020-11-26;41;28;69;150359;142009;39;292368
24;2020-11-26;24;24;50;161829;158758;49;320587
24;2020-11-26;34;41;76;172552;168011;59;340563
24;2020-11-26;20;20;40;172509;158177;69;330686
24;2020-11-26;20;9;29;129428;110593;79;240021
24;2020-11-26;11;14;25;87342;56882;89;144224
24;2020-11-26;16;6;22;31210;12071;90;43281
24;2020-11-26;233;178;414;1320165;1238908;0;2559073
27;2020-11-26;15;19;34;143373;149679;09;293052
27;2020-11-26;56;39;95;160962;173003;19;333965
27;2020-11-26;59;47;106;133746;142254;29;276000
27;2020-11-26;64;48;112;160004;155407;39;315411
27;2020-11-26;81;47;128;172333;169564;49;341897
27;2020-11-26;66;57;123;189979;183788;59;373767
27;2020-11-26;33;28;61;192591;178206;69;370797
27;2020-11-26;25;29;54;146876;127546;79;274422
27;2020-11-26;55;29;84;96896;61575;89;158471
27;2020-11-26;48;17;65;33148;12109;90;45257
27;2020-11-26;502;360;862;1429908;1353131;0;2783039
28;2020-11-26;11;3;14;180735;186856;09;367591
28;2020-11-26;40;30;72;200125;213621;19;413746
28;2020-11-26;33;15;48;168922;173007;29;341929
28;2020-11-26;40;20;60;196628;188487;39;385115
28;2020-11-26;47;27;74;205396;201699;49;407095
28;2020-11-26;37;35;72;222002;213866;59;435868
28;2020-11-26;18;20;38;224688;203758;69;428446
28;2020-11-26;20;16;36;163192;135543;79;298735
28;2020-11-26;47;18;65;109691;65377;89;175068
28;2020-11-26;41;11;52;37222;12685;90;49907
28;2020-11-26;334;195;531;1708601;1594899;0;3303500
32;2020-11-26;22;20;42;358062;373689;09;731751
32;2020-11-26;76;77;153;387045;406742;19;793787
32;2020-11-26;114;84;198;342304;348587;29;690891
32;2020-11-26;108;65;173;382485;369972;39;752457
32;2020-11-26;93;68;161;382510;376716;49;759226
32;2020-11-26;105;83;188;386937;376527;59;763464
32;2020-11-26;67;39;106;371211;330938;69;702149
32;2020-11-26;51;48;99;250542;201459;79;452001
32;2020-11-26;70;24;94;163399;89786;89;253185
32;2020-11-26;72;12;84;48384;15367;90;63751
32;2020-11-26;778;520;1298;3072879;2889783;0;5962662
44;2020-11-26;24;30;55;291525;306839;09;598364
44;2020-11-26;70;72;143;320255;339504;19;659759
44;2020-11-26;97;72;169;302020;314428;29;616448
44;2020-11-26;83;71;154;342222;333292;39;675514
44;2020-11-26;84;69;154;349727;344491;49;694218
44;2020-11-26;85;74;160;381371;373239;59;754610
44;2020-11-26;53;51;104;367165;335850;69;703015
44;2020-11-26;48;49;97;250387;215436;79;465823
44;2020-11-26;94;38;133;170825;105192;89;276017
44;2020-11-26;76;22;100;51248;16731;90;67979
44;2020-11-26;714;548;1269;2826745;2685002;0;5511747
52;2020-11-26;4;4;8;213594;223900;09;437494
52;2020-11-26;36;34;71;240818;255197;19;496015
52;2020-11-26;28;26;54;197010;200630;29;397640
52;2020-11-26;30;20;50;231204;224885;39;456089
52;2020-11-26;42;29;71;243874;243418;49;487292
52;2020-11-26;35;29;64;244100;239116;59;483216
52;2020-11-26;16;13;29;241796;221345;69;463141
52;2020-11-26;7;11;18;177805;149903;79;327708
52;2020-11-26;28;12;40;119561;75822;89;195383
52;2020-11-26;11;9;20;42559;15260;90;57819
52;2020-11-26;237;187;425;1952321;1849476;0;3801797
53;2020-11-26;2;8;10;173813;182358;09;356171
53;2020-11-26;20;13;34;202720;214740;19;417460
53;2020-11-26;15;11;26;163116;173196;29;336312
53;2020-11-26;18;8;26;190526;187674;39;378200
53;2020-11-26;12;11;23;212098;212015;49;424113
53;2020-11-26;21;6;27;223699;219176;59;442875
53;2020-11-26;6;8;14;227435;209274;69;436709
53;2020-11-26;6;4;10;169992;140910;79;310902
53;2020-11-26;8;3;11;118117;69883;89;188000
53;2020-11-26;5;0;5;37370;12267;90;49637
53;2020-11-26;114;72;187;1718886;1621493;0;3340379
75;2020-11-26;18;9;27;293104;305291;09;598395
75;2020-11-26;37;47;84;337141;357785;19;694926
75;2020-11-26;67;42;109;295024;300618;29;595642
75;2020-11-26;76;44;120;347871;331233;39;679104
75;2020-11-26;77;37;114;384742;372771;49;757513
75;2020-11-26;64;43;107;413361;390880;59;804241
75;2020-11-26;33;33;66;425623;384060;69;809683
75;2020-11-26;37;31;68;325086;276298;79;601384
75;2020-11-26;54;33;87;213986;139308;89;353294
75;2020-11-26;52;9;62;77600;28200;90;105800
75;2020-11-26;515;328;844;3113538;2886444;0;5999982
76;2020-11-26;8;7;15;305956;318589;09;624545
76;2020-11-26;40;39;82;338942;356969;19;695911
76;2020-11-26;62;44;106;316210;319570;29;635780
76;2020-11-26;67;39;106;356758;337587;39;694345
76;2020-11-26;73;66;139;376541;363812;49;740353
76;2020-11-26;68;32;100;402608;383750;59;786358
76;2020-11-26;39;29;68;394889;358997;69;753886
76;2020-11-26;32;33;65;308664;263806;79;572470
76;2020-11-26;54;22;76;195838;129272;89;325110
76;2020-11-26;58;15;73;69372;26728;90;96100
76;2020-11-26;501;326;830;3065778;2859080;0;5924858
84;2020-11-26;29;55;86;459549;481088;09;940637
84;2020-11-26;150;150;300;487711;511905;19;999616
84;2020-11-26;182;117;299;443824;451094;29;894918
84;2020-11-26;160;119;279;512522;493262;39;1005784
84;2020-11-26;196;138;334;520248;515106;49;1035354
84;2020-11-26;159;132;291;529611;514848;59;1044459
84;2020-11-26;89;96;185;486720;439940;69;926660
84;2020-11-26;63;77;140;372151;315211;79;687362
84;2020-11-26;135;71;206;237198;150524;89;387722
84;2020-11-26;102;29;131;81185;28680;90;109865
84;2020-11-26;1265;984;2251;4130719;3901658;0;8032377
93;2020-11-26;12;22;34;268834;283093;09;551927
93;2020-11-26;69;77;146;280751;296087;19;576838
93;2020-11-26;84;77;161;254404;255552;29;509956
93;2020-11-26;85;65;150;310704;288398;39;599102
93;2020-11-26;85;69;154;325559;305827;49;631386
93;2020-11-26;87;74;161;353104;325389;59;678493
93;2020-11-26;53;50;103;336327;296459;69;632786
93;2020-11-26;29;32;61;279820;229699;79;509519
93;2020-11-26;58;21;79;171274;113716;89;284990
93;2020-11-26;30;9;39;58896;21758;90;80654
93;2020-11-26;592;496;1088;2639673;2415978;0;5055651
94;2020-11-26;0;1;1;16311;17433;09;33744
94;2020-11-26;0;2;2;16679;18132;19;34811
94;2020-11-26;0;2;2;16782;16579;29;33361
94;2020-11-26;0;2;2;23044;20580;39;43624
94;2020-11-26;1;0;1;23065;22140;49;45205
94;2020-11-26;1;2;3;24549;23421;59;47970
94;2020-11-26;0;1;1;23212;21883;69;45095
94;2020-11-26;0;1;1;19544;17141;79;36685
94;2020-11-26;3;0;3;11227;8178;89;19405
94;2020-11-26;0;0;0;3332;1447;90;4779
94;2020-11-26;5;11;16;177745;166934;0;344679
01;2020-11-27;0;0;0;19979;20155;09;40134
01;2020-11-27;1;2;3;24994;25489;19;50483
01;2020-11-27;1;0;1;17868;16690;29;34558
01;2020-11-27;1;0;1;22328;14821;39;37149
01;2020-11-27;0;1;1;28652;20276;49;48928
01;2020-11-27;1;0;1;33264;27260;59;60524
01;2020-11-27;3;4;7;27135;23978;69;51113
01;2020-11-27;0;1;1;18401;14661;79;33062
01;2020-11-27;0;0;0;9633;6375;89;16008
01;2020-11-27;0;0;0;3410;1510;90;4920
01;2020-11-27;7;8;15;205664;171215;0;376879
02;2020-11-27;0;0;0;16881;17110;09;33991
02;2020-11-27;3;1;4;21410;21604;19;43014
02;2020-11-27;1;2;3;16017;15479;29;31496
02;2020-11-27;0;2;2;19825;14455;39;34280
02;2020-11-27;2;0;2;24719;18248;49;42967
02;2020-11-27;1;0;1;34361;28310;59;62671
02;2020-11-27;0;2;2;28061;24495;69;52556
02;2020-11-27;0;0;0;18231;15278;79;33509
02;2020-11-27;0;0;0;11090;7677;89;18767
02;2020-11-27;0;0;0;3992;1506;90;5498
02;2020-11-27;7;7;14;194587;164162;0;358749
03;2020-11-27;1;1;2;31123;30920;09;62043
03;2020-11-27;1;3;4;29370;29268;19;58638
03;2020-11-27;2;2;4;21458;18963;29;40421
03;2020-11-27;3;1;4;21276;18326;39;39602
03;2020-11-27;2;0;2;18164;16593;49;34757
03;2020-11-27;2;2;4;13469;13557;59;27026
03;2020-11-27;1;1;2;8776;8670;69;17446
03;2020-11-27;2;0;2;3777;3591;79;7368
03;2020-11-27;0;0;0;1649;1072;89;2721
03;2020-11-27;0;0;0;485;184;90;669
03;2020-11-27;14;10;24;149547;141144;0;290691
04;2020-11-27;2;3;5;60314;61377;09;121691
04;2020-11-27;5;10;15;66065;68387;19;134452
04;2020-11-27;3;4;7;51059;47156;29;98215
04;2020-11-27;2;5;7;58788;45780;39;104568
04;2020-11-27;4;3;7;61408;52207;49;113615
04;2020-11-27;5;7;12;64838;60759;59;125597
04;2020-11-27;2;2;4;47008;42843;69;89851
04;2020-11-27;1;0;1;25509;21184;79;46693
04;2020-11-27;0;1;1;13168;7647;89;20815
04;2020-11-27;0;0;0;3209;1253;90;4462
04;2020-11-27;24;35;59;451366;408593;0;859959
05;2020-11-27;0;0;0;362.366008612902;341.338819562748;09;703.704828175651
05;2020-11-27;0;0;0;353.376145114279;370.349735405642;19;723.725880519921
05;2020-11-27;0;0;0;218.593559489256;256.539602589476;29;475.133162078732
05;2020-11-27;0;0;0;404.225408693299;360.321910454353;39;764.547319147651
05;2020-11-27;0;0;0;520.067953604221;497.108383964256;49;1017.17633756848
05;2020-11-27;0;0;0;468.146063921917;510.087601910415;59;978.233665832332
05;2020-11-27;0;0;0;340.368470050554;334.366842191253;69;674.735312241807
05;2020-11-27;0;0;0;212.598666888387;192.597753227106;79;405.196420115493
05;2020-11-27;0;0;0;148.727797095705;61.8681715431829;89;210.595968638888
05;2020-11-27;0;0;0;32.9601271090696;10.9909785719784;90;43.9511056810479
05;2020-11-27;0;0;0;3061.43020057959;2935.56979942041;0;5997
06;2020-11-27;0;0;1;42583;42380;09;84963
06;2020-11-27;1;1;4;33369;31925;19;65294
06;2020-11-27;4;1;6;21571;15080;29;36651
06;2020-11-27;2;1;3;21550;16147;39;37697
06;2020-11-27;2;1;3;14193;13939;49;28132
06;2020-11-27;0;1;1;7171;7597;59;14768
06;2020-11-27;0;0;0;3629;4117;69;7746
06;2020-11-27;0;0;0;1577;1457;79;3034
06;2020-11-27;0;0;0;531;474;89;1005
06;2020-11-27;0;0;0;88;93;90;181
06;2020-11-27;9;5;18;146262;133209;0;279471
07;2020-11-27;0;0;0;485;549;09;1034
07;2020-11-27;1;0;1;403;432;19;835
07;2020-11-27;0;0;0;764;841;29;1605
07;2020-11-27;0;0;0;824;928;39;1752
07;2020-11-27;0;0;0;788;1020;49;1808
07;2020-11-27;0;0;0;678;870;59;1548
07;2020-11-27;0;0;0;360;382;69;742
07;2020-11-27;0;0;0;231;190;79;421
07;2020-11-27;0;0;0;114;67;89;181
07;2020-11-27;0;0;0;24;11;90;35
07;2020-11-27;1;0;1;4671;5290;0;9961
08;2020-11-27;0;0;0;2715.22592983026;2997.75551488675;09;5712.98144471701
08;2020-11-27;0;2;2;2778.51901080978;3160.9156459093;19;5939.43465671908
08;2020-11-27;0;0;0;2080.8882988764;1718.16634315323;29;3799.05464202964
08;2020-11-27;1;2;3;2701.8582062647;1896.52641413317;39;4598.38462039786
08;2020-11-27;0;1;1;3151.45861023308;2460.52498233809;49;5611.98359257117
08;2020-11-27;1;2;3;2620.29868333099;2422.23566154656;59;5042.53434487755
08;2020-11-27;0;1;1;1621.44173420671;1438.58325779464;69;3060.02499200135
08;2020-11-27;0;0;0;626.575909335673;526.358467843651;79;1152.93437717932
08;2020-11-27;0;0;0;205.018522985054;140.993639349697;89;346.012162334751
08;2020-11-27;0;0;0;50.0325684687745;20.62259870351;90;70.6551671722846
08;2020-11-27;2;8;10;18551.3174743414;16782.6825256586;0;35334
11;2020-11-27;35;34;72;783071;811785;09;1594856
11;2020-11-27;152;151;315;761456;784653;19;1546109
11;2020-11-27;175;187;364;850145;801772;29;1651917
11;2020-11-27;205;140;345;914360;843488;39;1757848
11;2020-11-27;217;161;380;845609;826202;49;1671811
11;2020-11-27;193;150;343;793566;745070;59;1538636
11;2020-11-27;104;91;197;628649;549192;69;1177841
11;2020-11-27;71;74;145;434606;358356;79;792962
11;2020-11-27;55;38;93;261425;162933;89;424358
11;2020-11-27;23;18;41;89253;32619;90;121872
11;2020-11-27;1230;1044;2295;6362140;5916070;0;12278210
24;2020-11-27;7;9;16;139720;144686;09;284406
24;2020-11-27;31;36;67;152979;161185;19;314164
24;2020-11-27;47;14;61;122237;126536;29;248773
24;2020-11-27;30;21;51;150359;142009;39;292368
24;2020-11-27;44;19;63;161829;158758;49;320587
24;2020-11-27;33;41;74;172552;168011;59;340563
24;2020-11-27;21;19;40;172509;158177;69;330686
24;2020-11-27;17;17;34;129428;110593;79;240021
24;2020-11-27;17;11;28;87342;56882;89;144224
24;2020-11-27;23;8;31;31210;12071;90;43281
24;2020-11-27;270;195;465;1320165;1238908;0;2559073
27;2020-11-27;12;18;30;143373;149679;09;293052
27;2020-11-27;46;52;98;160962;173003;19;333965
27;2020-11-27;48;57;105;133746;142254;29;276000
27;2020-11-27;52;39;91;160004;155407;39;315411
27;2020-11-27;78;48;126;172333;169564;49;341897
27;2020-11-27;50;56;106;189979;183788;59;373767
27;2020-11-27;29;34;63;192591;178206;69;370797
27;2020-11-27;27;28;55;146876;127546;79;274422
27;2020-11-27;62;27;89;96896;61575;89;158471
27;2020-11-27;43;14;57;33148;12109;90;45257
27;2020-11-27;447;373;821;1429908;1353131;0;2783039
28;2020-11-27;8;15;24;180735;186856;09;367591
28;2020-11-27;31;34;65;200125;213621;19;413746
28;2020-11-27;39;28;67;168922;173007;29;341929
28;2020-11-27;29;20;49;196628;188487;39;385115
28;2020-11-27;35;27;62;205396;201699;49;407095
28;2020-11-27;29;28;57;222002;213866;59;435868
28;2020-11-27;21;25;46;224688;203758;69;428446
28;2020-11-27;15;12;27;163192;135543;79;298735
28;2020-11-27;16;18;34;109691;65377;89;175068
28;2020-11-27;17;5;22;37222;12685;90;49907
28;2020-11-27;240;212;453;1708601;1594899;0;3303500
32;2020-11-27;22;28;50;358062;373689;09;731751
32;2020-11-27;82;75;157;387045;406742;19;793787
32;2020-11-27;118;54;172;342304;348587;29;690891
32;2020-11-27;94;67;161;382485;369972;39;752457
32;2020-11-27;91;69;160;382510;376716;49;759226
32;2020-11-27;87;93;180;386937;376527;59;763464
32;2020-11-27;46;60;106;371211;330938;69;702149
32;2020-11-27;64;37;101;250542;201459;79;452001
32;2020-11-27;61;37;98;163399;89786;89;253185
32;2020-11-27;34;7;41;48384;15367;90;63751
32;2020-11-27;699;528;1227;3072879;2889783;0;5962662
44;2020-11-27;21;24;46;291525;306839;09;598364
44;2020-11-27;83;81;164;320255;339504;19;659759
44;2020-11-27;79;72;153;302020;314428;29;616448
44;2020-11-27;80;69;149;342222;333292;39;675514
44;2020-11-27;94;80;174;349727;344491;49;694218
44;2020-11-27;110;84;195;381371;373239;59;754610
44;2020-11-27;68;52;120;367165;335850;69;703015
44;2020-11-27;45;42;88;250387;215436;79;465823
44;2020-11-27;66;40;106;170825;105192;89;276017
44;2020-11-27;43;14;57;51248;16731;90;67979
44;2020-11-27;689;558;1252;2826745;2685002;0;5511747
52;2020-11-27;6;6;12;213594;223900;09;437494
52;2020-11-27;36;24;62;240818;255197;19;496015
52;2020-11-27;46;21;67;197010;200630;29;397640
52;2020-11-27;42;27;69;231204;224885;39;456089
52;2020-11-27;37;33;70;243874;243418;49;487292
52;2020-11-27;30;27;57;244100;239116;59;483216
52;2020-11-27;19;13;32;241796;221345;69;463141
52;2020-11-27;13;6;19;177805;149903;79;327708
52;2020-11-27;16;13;30;119561;75822;89;195383
52;2020-11-27;26;10;36;42559;15260;90;57819
52;2020-11-27;271;180;454;1952321;1849476;0;3801797
53;2020-11-27;8;11;19;173813;182358;09;356171
53;2020-11-27;15;13;29;202720;214740;19;417460
53;2020-11-27;15;9;26;163116;173196;29;336312
53;2020-11-27;21;12;33;190526;187674;39;378200
53;2020-11-27;17;8;25;212098;212015;49;424113
53;2020-11-27;19;8;27;223699;219176;59;442875
53;2020-11-27;11;5;16;227435;209274;69;436709
53;2020-11-27;5;4;9;169992;140910;79;310902
53;2020-11-27;9;11;20;118117;69883;89;188000
53;2020-11-27;3;3;6;37370;12267;90;49637
53;2020-11-27;123;84;210;1718886;1621493;0;3340379
75;2020-11-27;12;13;27;293104;305291;09;598395
75;2020-11-27;35;33;69;337141;357785;19;694926
75;2020-11-27;59;43;102;295024;300618;29;595642
75;2020-11-27;64;49;113;347871;331233;39;679104
75;2020-11-27;69;41;111;384742;372771;49;757513
75;2020-11-27;56;39;95;413361;390880;59;804241
75;2020-11-27;28;21;49;425623;384060;69;809683
75;2020-11-27;25;26;51;325086;276298;79;601384
75;2020-11-27;49;24;73;213986;139308;89;353294
75;2020-11-27;41;7;48;77600;28200;90;105800
75;2020-11-27;438;296;738;3113538;2886444;0;5999982
76;2020-11-27;17;11;31;305956;318589;09;624545
76;2020-11-27;48;52;103;338942;356969;19;695911
76;2020-11-27;54;43;98;316210;319570;29;635780
76;2020-11-27;55;41;96;356758;337587;39;694345
76;2020-11-27;76;46;122;376541;363812;49;740353
76;2020-11-27;65;62;127;402608;383750;59;786358
76;2020-11-27;43;43;86;394889;358997;69;753886
76;2020-11-27;28;35;63;308664;263806;79;572470
76;2020-11-27;46;31;77;195838;129272;89;325110
76;2020-11-27;33;14;47;69372;26728;90;96100
76;2020-11-27;465;378;850;3065778;2859080;0;5924858
84;2020-11-27;52;56;109;459549;481088;09;940637
84;2020-11-27;186;182;371;487711;511905;19;999616
84;2020-11-27;166;121;287;443824;451094;29;894918
84;2020-11-27;171;128;299;512522;493262;39;1005784
84;2020-11-27;178;152;330;520248;515106;49;1035354
84;2020-11-27;173;147;321;529611;514848;59;1044459
84;2020-11-27;113;95;208;486720;439940;69;926660
84;2020-11-27;88;74;162;372151;315211;79;687362
84;2020-11-27;111;61;172;237198;150524;89;387722
84;2020-11-27;102;34;136;81185;28680;90;109865
84;2020-11-27;1340;1051;2397;4130719;3901658;0;8032377
93;2020-11-27;14;18;32;268834;283093;09;551927
93;2020-11-27;76;68;144;280751;296087;19;576838
93;2020-11-27;97;86;184;254404;255552;29;509956
93;2020-11-27;79;85;164;310704;288398;39;599102
93;2020-11-27;88;70;158;325559;305827;49;631386
93;2020-11-27;82;65;148;353104;325389;59;678493
93;2020-11-27;51;64;116;336327;296459;69;632786
93;2020-11-27;49;46;95;279820;229699;79;509519
93;2020-11-27;33;29;62;171274;113716;89;284990
93;2020-11-27;31;5;36;58896;21758;90;80654
93;2020-11-27;601;536;1140;2639673;2415978;0;5055651
94;2020-11-27;0;1;1;16311;17433;09;33744
94;2020-11-27;2;1;3;16679;18132;19;34811
94;2020-11-27;2;0;2;16782;16579;29;33361
94;2020-11-27;1;1;2;23044;20580;39;43624
94;2020-11-27;1;3;4;23065;22140;49;45205
94;2020-11-27;0;0;0;24549;23421;59;47970
94;2020-11-27;1;1;2;23212;21883;69;45095
94;2020-11-27;2;0;2;19544;17141;79;36685
94;2020-11-27;1;0;1;11227;8178;89;19405
94;2020-11-27;1;0;1;3332;1447;90;4779
94;2020-11-27;11;7;18;177745;166934;0;344679
01;2020-11-28;0;0;0;19979;20155;09;40134
01;2020-11-28;0;0;0;24994;25489;19;50483
01;2020-11-28;0;1;1;17868;16690;29;34558
01;2020-11-28;0;1;1;22328;14821;39;37149
01;2020-11-28;0;1;1;28652;20276;49;48928
01;2020-11-28;0;0;0;33264;27260;59;60524
01;2020-11-28;0;1;1;27135;23978;69;51113
01;2020-11-28;1;1;2;18401;14661;79;33062
01;2020-11-28;0;0;0;9633;6375;89;16008
01;2020-11-28;0;0;0;3410;1510;90;4920
01;2020-11-28;1;5;6;205664;171215;0;376879
02;2020-11-28;0;0;0;16881;17110;09;33991
02;2020-11-28;0;0;0;21410;21604;19;43014
02;2020-11-28;1;0;1;16017;15479;29;31496
02;2020-11-28;0;0;0;19825;14455;39;34280
02;2020-11-28;0;0;0;24719;18248;49;42967
02;2020-11-28;0;0;0;34361;28310;59;62671
02;2020-11-28;1;0;1;28061;24495;69;52556
02;2020-11-28;0;0;0;18231;15278;79;33509
02;2020-11-28;0;0;0;11090;7677;89;18767
02;2020-11-28;0;0;0;3992;1506;90;5498
02;2020-11-28;2;0;2;194587;164162;0;358749
03;2020-11-28;0;0;0;31123;30920;09;62043
03;2020-11-28;4;2;6;29370;29268;19;58638
03;2020-11-28;2;3;5;21458;18963;29;40421
03;2020-11-28;1;2;3;21276;18326;39;39602
03;2020-11-28;2;3;5;18164;16593;49;34757
03;2020-11-28;1;1;2;13469;13557;59;27026
03;2020-11-28;0;0;0;8776;8670;69;17446
03;2020-11-28;0;0;0;3777;3591;79;7368
03;2020-11-28;1;0;1;1649;1072;89;2721
03;2020-11-28;0;0;0;485;184;90;669
03;2020-11-28;11;11;22;149547;141144;0;290691
04;2020-11-28;2;0;2;60314;61377;09;121691
04;2020-11-28;2;2;4;66065;68387;19;134452
04;2020-11-28;3;0;3;51059;47156;29;98215
04;2020-11-28;2;1;3;58788;45780;39;104568
04;2020-11-28;2;1;3;61408;52207;49;113615
04;2020-11-28;1;3;4;64838;60759;59;125597
04;2020-11-28;1;0;1;47008;42843;69;89851
04;2020-11-28;1;0;1;25509;21184;79;46693
04;2020-11-28;2;0;2;13168;7647;89;20815
04;2020-11-28;0;0;0;3209;1253;90;4462
04;2020-11-28;16;7;23;451366;408593;0;859959
05;2020-11-28;0;0;0;362.366008612902;341.338819562748;09;703.704828175651
05;2020-11-28;0;0;0;353.376145114279;370.349735405642;19;723.725880519921
05;2020-11-28;0;0;0;218.593559489256;256.539602589476;29;475.133162078732
05;2020-11-28;0;0;0;404.225408693299;360.321910454353;39;764.547319147651
05;2020-11-28;0;0;0;520.067953604221;497.108383964256;49;1017.17633756848
05;2020-11-28;0;0;0;468.146063921917;510.087601910415;59;978.233665832332
05;2020-11-28;0;0;0;340.368470050554;334.366842191253;69;674.735312241807
05;2020-11-28;0;0;0;212.598666888387;192.597753227106;79;405.196420115493
05;2020-11-28;0;0;0;148.727797095705;61.8681715431829;89;210.595968638888
05;2020-11-28;0;0;0;32.9601271090696;10.9909785719784;90;43.9511056810479
05;2020-11-28;0;0;0;3061.43020057959;2935.56979942041;0;5997
06;2020-11-28;1;0;1;42583;42380;09;84963
06;2020-11-28;2;0;2;33369;31925;19;65294
06;2020-11-28;1;0;1;21571;15080;29;36651
06;2020-11-28;0;1;1;21550;16147;39;37697
06;2020-11-28;4;1;5;14193;13939;49;28132
06;2020-11-28;1;0;1;7171;7597;59;14768
06;2020-11-28;0;0;0;3629;4117;69;7746
06;2020-11-28;0;1;1;1577;1457;79;3034
06;2020-11-28;0;0;0;531;474;89;1005
06;2020-11-28;0;0;0;88;93;90;181
06;2020-11-28;9;3;12;146262;133209;0;279471
07;2020-11-28;0;0;0;485;549;09;1034
07;2020-11-28;0;0;0;403;432;19;835
07;2020-11-28;0;0;0;764;841;29;1605
07;2020-11-28;1;0;1;824;928;39;1752
07;2020-11-28;0;1;1;788;1020;49;1808
07;2020-11-28;0;0;0;678;870;59;1548
07;2020-11-28;0;0;0;360;382;69;742
07;2020-11-28;0;0;0;231;190;79;421
07;2020-11-28;0;0;0;114;67;89;181
07;2020-11-28;0;0;0;24;11;90;35
07;2020-11-28;1;1;2;4671;5290;0;9961
08;2020-11-28;0;0;0;2715.22592983026;2997.75551488675;09;5712.98144471701
08;2020-11-28;0;0;0;2778.51901080978;3160.9156459093;19;5939.43465671908
08;2020-11-28;1;1;2;2080.8882988764;1718.16634315323;29;3799.05464202964
08;2020-11-28;0;0;0;2701.8582062647;1896.52641413317;39;4598.38462039786
08;2020-11-28;1;0;1;3151.45861023308;2460.52498233809;49;5611.98359257117
08;2020-11-28;1;0;1;2620.29868333099;2422.23566154656;59;5042.53434487755
08;2020-11-28;0;0;0;1621.44173420671;1438.58325779464;69;3060.02499200135
08;2020-11-28;0;0;0;626.575909335673;526.358467843651;79;1152.93437717932
08;2020-11-28;0;0;0;205.018522985054;140.993639349697;89;346.012162334751
08;2020-11-28;0;0;0;50.0325684687745;20.62259870351;90;70.6551671722846
08;2020-11-28;3;1;4;18551.3174743414;16782.6825256586;0;35334
11;2020-11-28;25;11;40;783071;811785;09;1594856
11;2020-11-28;70;74;154;761456;784653;19;1546109
11;2020-11-28;101;90;191;850145;801772;29;1651917
11;2020-11-28;97;86;183;914360;843488;39;1757848
11;2020-11-28;102;94;196;845609;826202;49;1671811
11;2020-11-28;77;78;155;793566;745070;59;1538636
11;2020-11-28;67;50;117;628649;549192;69;1177841
11;2020-11-28;24;37;61;434606;358356;79;792962
11;2020-11-28;25;27;52;261425;162933;89;424358
11;2020-11-28;15;13;28;89253;32619;90;121872
11;2020-11-28;603;561;1178;6362140;5916070;0;12278210
24;2020-11-28;4;1;5;139720;144686;09;284406
24;2020-11-28;12;17;29;152979;161185;19;314164
24;2020-11-28;15;18;33;122237;126536;29;248773
24;2020-11-28;19;13;32;150359;142009;39;292368
24;2020-11-28;17;11;28;161829;158758;49;320587
24;2020-11-28;16;17;33;172552;168011;59;340563
24;2020-11-28;9;8;17;172509;158177;69;330686
24;2020-11-28;4;7;11;129428;110593;79;240021
24;2020-11-28;9;5;14;87342;56882;89;144224
24;2020-11-28;8;4;12;31210;12071;90;43281
24;2020-11-28;113;101;214;1320165;1238908;0;2559073
27;2020-11-28;5;8;13;143373;149679;09;293052
27;2020-11-28;33;31;64;160962;173003;19;333965
27;2020-11-28;28;25;53;133746;142254;29;276000
27;2020-11-28;29;27;56;160004;155407;39;315411
27;2020-11-28;38;24;62;172333;169564;49;341897
27;2020-11-28;42;33;75;189979;183788;59;373767
27;2020-11-28;22;24;46;192591;178206;69;370797
27;2020-11-28;22;20;42;146876;127546;79;274422
27;2020-11-28;29;14;43;96896;61575;89;158471
27;2020-11-28;24;7;31;33148;12109;90;45257
27;2020-11-28;272;213;485;1429908;1353131;0;2783039
28;2020-11-28;3;3;6;180735;186856;09;367591
28;2020-11-28;16;9;25;200125;213621;19;413746
28;2020-11-28;14;8;22;168922;173007;29;341929
28;2020-11-28;13;8;21;196628;188487;39;385115
28;2020-11-28;11;13;24;205396;201699;49;407095
28;2020-11-28;13;15;28;222002;213866;59;435868
28;2020-11-28;13;2;15;224688;203758;69;428446
28;2020-11-28;5;6;11;163192;135543;79;298735
28;2020-11-28;10;6;16;109691;65377;89;175068
28;2020-11-28;6;5;11;37222;12685;90;49907
28;2020-11-28;104;75;179;1708601;1594899;0;3303500
32;2020-11-28;16;10;26;358062;373689;09;731751
32;2020-11-28;60;40;100;387045;406742;19;793787
32;2020-11-28;38;35;73;342304;348587;29;690891
32;2020-11-28;59;42;101;382485;369972;39;752457
32;2020-11-28;51;33;84;382510;376716;49;759226
32;2020-11-28;47;42;89;386937;376527;59;763464
32;2020-11-28;25;22;47;371211;330938;69;702149
32;2020-11-28;27;20;47;250542;201459;79;452001
32;2020-11-28;33;13;46;163399;89786;89;253185
32;2020-11-28;13;5;18;48384;15367;90;63751
32;2020-11-28;369;262;631;3072879;2889783;0;5962662
44;2020-11-28;12;9;22;291525;306839;09;598364
44;2020-11-28;27;38;65;320255;339504;19;659759
44;2020-11-28;34;26;60;302020;314428;29;616448
44;2020-11-28;37;38;75;342222;333292;39;675514
44;2020-11-28;51;43;94;349727;344491;49;694218
44;2020-11-28;39;49;88;381371;373239;59;754610
44;2020-11-28;25;30;55;367165;335850;69;703015
44;2020-11-28;20;17;37;250387;215436;79;465823
44;2020-11-28;34;12;46;170825;105192;89;276017
44;2020-11-28;22;5;27;51248;16731;90;67979
44;2020-11-28;301;267;569;2826745;2685002;0;5511747
52;2020-11-28;6;5;11;213594;223900;09;437494
52;2020-11-28;13;11;25;240818;255197;19;496015
52;2020-11-28;17;23;40;197010;200630;29;397640
52;2020-11-28;10;17;27;231204;224885;39;456089
52;2020-11-28;12;20;32;243874;243418;49;487292
52;2020-11-28;30;24;54;244100;239116;59;483216
52;2020-11-28;7;10;17;241796;221345;69;463141
52;2020-11-28;11;8;19;177805;149903;79;327708
52;2020-11-28;13;6;19;119561;75822;89;195383
52;2020-11-28;8;8;16;42559;15260;90;57819
52;2020-11-28;127;132;260;1952321;1849476;0;3801797
53;2020-11-28;4;4;8;173813;182358;09;356171
53;2020-11-28;9;5;14;202720;214740;19;417460
53;2020-11-28;8;5;13;163116;173196;29;336312
53;2020-11-28;6;8;15;190526;187674;39;378200
53;2020-11-28;12;11;23;212098;212015;49;424113
53;2020-11-28;10;11;21;223699;219176;59;442875
53;2020-11-28;10;9;19;227435;209274;69;436709
53;2020-11-28;8;3;11;169992;140910;79;310902
53;2020-11-28;6;4;10;118117;69883;89;188000
53;2020-11-28;1;1;2;37370;12267;90;49637
53;2020-11-28;74;61;136;1718886;1621493;0;3340379
75;2020-11-28;6;3;9;293104;305291;09;598395
75;2020-11-28;21;20;41;337141;357785;19;694926
75;2020-11-28;23;23;46;295024;300618;29;595642
75;2020-11-28;36;14;50;347871;331233;39;679104
75;2020-11-28;24;19;43;384742;372771;49;757513
75;2020-11-28;34;18;52;413361;390880;59;804241
75;2020-11-28;14;19;33;425623;384060;69;809683
75;2020-11-28;14;17;31;325086;276298;79;601384
75;2020-11-28;16;7;23;213986;139308;89;353294
75;2020-11-28;15;7;22;77600;28200;90;105800
75;2020-11-28;203;147;350;3113538;2886444;0;5999982
76;2020-11-28;7;8;15;305956;318589;09;624545
76;2020-11-28;20;32;52;338942;356969;19;695911
76;2020-11-28;26;18;44;316210;319570;29;635780
76;2020-11-28;26;23;49;356758;337587;39;694345
76;2020-11-28;24;33;57;376541;363812;49;740353
76;2020-11-28;28;22;50;402608;383750;59;786358
76;2020-11-28;15;17;32;394889;358997;69;753886
76;2020-11-28;16;10;26;308664;263806;79;572470
76;2020-11-28;15;9;24;195838;129272;89;325110
76;2020-11-28;11;8;19;69372;26728;90;96100
76;2020-11-28;188;180;368;3065778;2859080;0;5924858
84;2020-11-28;16;25;42;459549;481088;09;940637
84;2020-11-28;78;93;172;487711;511905;19;999616
84;2020-11-28;80;51;132;443824;451094;29;894918
84;2020-11-28;95;71;166;512522;493262;39;1005784
84;2020-11-28;90;78;168;520248;515106;49;1035354
84;2020-11-28;89;84;174;529611;514848;59;1044459
84;2020-11-28;47;35;82;486720;439940;69;926660
84;2020-11-28;41;35;76;372151;315211;79;687362
84;2020-11-28;38;27;65;237198;150524;89;387722
84;2020-11-28;23;9;32;81185;28680;90;109865
84;2020-11-28;597;508;1109;4130719;3901658;0;8032377
93;2020-11-28;3;9;12;268834;283093;09;551927
93;2020-11-28;22;42;64;280751;296087;19;576838
93;2020-11-28;35;36;72;254404;255552;29;509956
93;2020-11-28;41;27;68;310704;288398;39;599102
93;2020-11-28;35;41;76;325559;305827;49;631386
93;2020-11-28;34;38;72;353104;325389;59;678493
93;2020-11-28;27;33;61;336327;296459;69;632786
93;2020-11-28;20;15;35;279820;229699;79;509519
93;2020-11-28;25;15;40;171274;113716;89;284990
93;2020-11-28;5;2;7;58896;21758;90;80654
93;2020-11-28;247;258;507;2639673;2415978;0;5055651
94;2020-11-28;0;0;0;16311;17433;09;33744
94;2020-11-28;2;0;2;16679;18132;19;34811
94;2020-11-28;1;2;3;16782;16579;29;33361
94;2020-11-28;1;0;1;23044;20580;39;43624
94;2020-11-28;0;1;1;23065;22140;49;45205
94;2020-11-28;1;2;3;24549;23421;59;47970
94;2020-11-28;2;0;2;23212;21883;69;45095
94;2020-11-28;0;0;0;19544;17141;79;36685
94;2020-11-28;1;0;1;11227;8178;89;19405
94;2020-11-28;0;0;0;3332;1447;90;4779
94;2020-11-28;8;6;14;177745;166934;0;344679
01;2020-11-29;0;0;0;19979;20155;09;40134
01;2020-11-29;0;0;0;24994;25489;19;50483
01;2020-11-29;0;0;0;17868;16690;29;34558
01;2020-11-29;0;0;0;22328;14821;39;37149
01;2020-11-29;0;0;0;28652;20276;49;48928
01;2020-11-29;0;0;0;33264;27260;59;60524
01;2020-11-29;1;0;1;27135;23978;69;51113
01;2020-11-29;0;0;0;18401;14661;79;33062
01;2020-11-29;0;0;0;9633;6375;89;16008
01;2020-11-29;0;0;0;3410;1510;90;4920
01;2020-11-29;1;0;1;205664;171215;0;376879
02;2020-11-29;0;0;0;16881;17110;09;33991
02;2020-11-29;0;0;0;21410;21604;19;43014
02;2020-11-29;0;0;0;16017;15479;29;31496
02;2020-11-29;0;0;0;19825;14455;39;34280
02;2020-11-29;0;0;0;24719;18248;49;42967
02;2020-11-29;0;0;0;34361;28310;59;62671
02;2020-11-29;0;0;0;28061;24495;69;52556
02;2020-11-29;0;0;0;18231;15278;79;33509
02;2020-11-29;0;0;0;11090;7677;89;18767
02;2020-11-29;0;0;0;3992;1506;90;5498
02;2020-11-29;0;0;0;194587;164162;0;358749
03;2020-11-29;0;0;0;31123;30920;09;62043
03;2020-11-29;0;0;0;29370;29268;19;58638
03;2020-11-29;0;0;0;21458;18963;29;40421
03;2020-11-29;1;1;2;21276;18326;39;39602
03;2020-11-29;0;0;0;18164;16593;49;34757
03;2020-11-29;0;0;0;13469;13557;59;27026
03;2020-11-29;0;1;1;8776;8670;69;17446
03;2020-11-29;0;0;0;3777;3591;79;7368
03;2020-11-29;0;1;1;1649;1072;89;2721
03;2020-11-29;0;0;0;485;184;90;669
03;2020-11-29;1;3;4;149547;141144;0;290691
04;2020-11-29;0;0;0;60314;61377;09;121691
04;2020-11-29;0;0;0;66065;68387;19;134452
04;2020-11-29;0;1;1;51059;47156;29;98215
04;2020-11-29;1;0;1;58788;45780;39;104568
04;2020-11-29;0;0;0;61408;52207;49;113615
04;2020-11-29;0;1;1;64838;60759;59;125597
04;2020-11-29;0;0;0;47008;42843;69;89851
04;2020-11-29;0;0;0;25509;21184;79;46693
04;2020-11-29;0;0;0;13168;7647;89;20815
04;2020-11-29;0;0;0;3209;1253;90;4462
04;2020-11-29;1;2;3;451366;408593;0;859959
05;2020-11-29;0;0;0;362.366008612902;341.338819562748;09;703.704828175651
05;2020-11-29;0;0;0;353.376145114279;370.349735405642;19;723.725880519921
05;2020-11-29;0;0;0;218.593559489256;256.539602589476;29;475.133162078732
05;2020-11-29;0;0;0;404.225408693299;360.321910454353;39;764.547319147651
05;2020-11-29;0;0;0;520.067953604221;497.108383964256;49;1017.17633756848
05;2020-11-29;0;0;0;468.146063921917;510.087601910415;59;978.233665832332
05;2020-11-29;0;0;0;340.368470050554;334.366842191253;69;674.735312241807
05;2020-11-29;0;0;0;212.598666888387;192.597753227106;79;405.196420115493
05;2020-11-29;0;0;0;148.727797095705;61.8681715431829;89;210.595968638888
05;2020-11-29;0;0;0;32.9601271090696;10.9909785719784;90;43.9511056810479
05;2020-11-29;0;0;0;3061.43020057959;2935.56979942041;0;5997
06;2020-11-29;0;0;0;42583;42380;09;84963
06;2020-11-29;0;0;0;33369;31925;19;65294
06;2020-11-29;0;0;0;21571;15080;29;36651
06;2020-11-29;0;0;0;21550;16147;39;37697
06;2020-11-29;0;1;1;14193;13939;49;28132
06;2020-11-29;0;1;1;7171;7597;59;14768
06;2020-11-29;0;0;0;3629;4117;69;7746
06;2020-11-29;0;0;0;1577;1457;79;3034
06;2020-11-29;0;0;0;531;474;89;1005
06;2020-11-29;0;0;0;88;93;90;181
06;2020-11-29;0;2;2;146262;133209;0;279471
07;2020-11-29;0;0;0;485;549;09;1034
07;2020-11-29;0;0;0;403;432;19;835
07;2020-11-29;0;0;0;764;841;29;1605
07;2020-11-29;0;0;0;824;928;39;1752
07;2020-11-29;0;0;0;788;1020;49;1808
07;2020-11-29;0;0;0;678;870;59;1548
07;2020-11-29;0;0;0;360;382;69;742
07;2020-11-29;0;0;0;231;190;79;421
07;2020-11-29;0;0;0;114;67;89;181
07;2020-11-29;0;0;0;24;11;90;35
07;2020-11-29;0;0;0;4671;5290;0;9961
08;2020-11-29;0;0;0;2715.22592983026;2997.75551488675;09;5712.98144471701
08;2020-11-29;0;0;0;2778.51901080978;3160.9156459093;19;5939.43465671908
08;2020-11-29;0;0;0;2080.8882988764;1718.16634315323;29;3799.05464202964
08;2020-11-29;0;1;1;2701.8582062647;1896.52641413317;39;4598.38462039786
08;2020-11-29;0;1;1;3151.45861023308;2460.52498233809;49;5611.98359257117
08;2020-11-29;0;0;0;2620.29868333099;2422.23566154656;59;5042.53434487755
08;2020-11-29;0;0;0;1621.44173420671;1438.58325779464;69;3060.02499200135
08;2020-11-29;0;0;0;626.575909335673;526.358467843651;79;1152.93437717932
08;2020-11-29;0;0;0;205.018522985054;140.993639349697;89;346.012162334751
08;2020-11-29;0;0;0;50.0325684687745;20.62259870351;90;70.6551671722846
08;2020-11-29;0;2;2;18551.3174743414;16782.6825256586;0;35334
11;2020-11-29;7;6;13;783071;811785;09;1594856
11;2020-11-29;16;16;33;761456;784653;19;1546109
11;2020-11-29;26;26;52;850145;801772;29;1651917
11;2020-11-29;38;19;57;914360;843488;39;1757848
11;2020-11-29;18;32;50;845609;826202;49;1671811
11;2020-11-29;17;19;36;793566;745070;59;1538636
11;2020-11-29;14;21;35;628649;549192;69;1177841
11;2020-11-29;5;17;22;434606;358356;79;792962
11;2020-11-29;20;13;33;261425;162933;89;424358
11;2020-11-29;12;5;17;89253;32619;90;121872
11;2020-11-29;173;174;348;6362140;5916070;0;12278210
24;2020-11-29;0;2;2;139720;144686;09;284406
24;2020-11-29;2;3;5;152979;161185;19;314164
24;2020-11-29;6;2;8;122237;126536;29;248773
24;2020-11-29;8;3;11;150359;142009;39;292368
24;2020-11-29;7;2;9;161829;158758;49;320587
24;2020-11-29;8;4;12;172552;168011;59;340563
24;2020-11-29;4;3;7;172509;158177;69;330686
24;2020-11-29;3;3;6;129428;110593;79;240021
24;2020-11-29;4;6;10;87342;56882;89;144224
24;2020-11-29;4;0;4;31210;12071;90;43281
24;2020-11-29;46;28;74;1320165;1238908;0;2559073
27;2020-11-29;2;1;3;143373;149679;09;293052
27;2020-11-29;4;0;4;160962;173003;19;333965
27;2020-11-29;5;5;10;133746;142254;29;276000
27;2020-11-29;9;1;10;160004;155407;39;315411
27;2020-11-29;10;3;13;172333;169564;49;341897
27;2020-11-29;12;1;13;189979;183788;59;373767
27;2020-11-29;5;6;11;192591;178206;69;370797
27;2020-11-29;6;7;13;146876;127546;79;274422
27;2020-11-29;11;7;18;96896;61575;89;158471
27;2020-11-29;7;8;15;33148;12109;90;45257
27;2020-11-29;71;39;110;1429908;1353131;0;2783039
28;2020-11-29;0;2;2;180735;186856;09;367591
28;2020-11-29;4;1;5;200125;213621;19;413746
28;2020-11-29;6;4;10;168922;173007;29;341929
28;2020-11-29;8;4;12;196628;188487;39;385115
28;2020-11-29;6;2;8;205396;201699;49;407095
28;2020-11-29;2;2;4;222002;213866;59;435868
28;2020-11-29;3;3;6;224688;203758;69;428446
28;2020-11-29;1;3;4;163192;135543;79;298735
28;2020-11-29;5;3;8;109691;65377;89;175068
28;2020-11-29;2;1;3;37222;12685;90;49907
28;2020-11-29;37;25;62;1708601;1594899;0;3303500
32;2020-11-29;2;5;7;358062;373689;09;731751
32;2020-11-29;13;12;25;387045;406742;19;793787
32;2020-11-29;19;19;38;342304;348587;29;690891
32;2020-11-29;19;14;33;382485;369972;39;752457
32;2020-11-29;11;14;25;382510;376716;49;759226
32;2020-11-29;5;5;10;386937;376527;59;763464
32;2020-11-29;3;3;6;371211;330938;69;702149
32;2020-11-29;8;9;17;250542;201459;79;452001
32;2020-11-29;5;6;11;163399;89786;89;253185
32;2020-11-29;2;2;4;48384;15367;90;63751
32;2020-11-29;87;89;176;3072879;2889783;0;5962662
44;2020-11-29;0;1;1;291525;306839;09;598364
44;2020-11-29;2;4;6;320255;339504;19;659759
44;2020-11-29;10;3;13;302020;314428;29;616448
44;2020-11-29;11;10;21;342222;333292;39;675514
44;2020-11-29;14;3;17;349727;344491;49;694218
44;2020-11-29;7;4;11;381371;373239;59;754610
44;2020-11-29;4;3;7;367165;335850;69;703015
44;2020-11-29;10;6;16;250387;215436;79;465823
44;2020-11-29;17;12;29;170825;105192;89;276017
44;2020-11-29;13;7;20;51248;16731;90;67979
44;2020-11-29;88;53;141;2826745;2685002;0;5511747
52;2020-11-29;0;3;3;213594;223900;09;437494
52;2020-11-29;2;0;2;240818;255197;19;496015
52;2020-11-29;7;3;10;197010;200630;29;397640
52;2020-11-29;6;1;7;231204;224885;39;456089
52;2020-11-29;1;3;4;243874;243418;49;487292
52;2020-11-29;2;3;5;244100;239116;59;483216
52;2020-11-29;4;0;4;241796;221345;69;463141
52;2020-11-29;2;3;5;177805;149903;79;327708
52;2020-11-29;6;6;12;119561;75822;89;195383
52;2020-11-29;8;1;9;42559;15260;90;57819
52;2020-11-29;38;23;61;1952321;1849476;0;3801797
53;2020-11-29;0;1;1;173813;182358;09;356171
53;2020-11-29;2;2;4;202720;214740;19;417460
53;2020-11-29;4;2;6;163116;173196;29;336312
53;2020-11-29;4;7;11;190526;187674;39;378200
53;2020-11-29;8;1;9;212098;212015;49;424113
53;2020-11-29;4;3;7;223699;219176;59;442875
53;2020-11-29;1;2;3;227435;209274;69;436709
53;2020-11-29;0;1;1;169992;140910;79;310902
53;2020-11-29;3;0;3;118117;69883;89;188000
53;2020-11-29;0;0;0;37370;12267;90;49637
53;2020-11-29;26;19;45;1718886;1621493;0;3340379
75;2020-11-29;1;0;1;293104;305291;09;598395
75;2020-11-29;3;1;4;337141;357785;19;694926
75;2020-11-29;1;3;4;295024;300618;29;595642
75;2020-11-29;8;6;14;347871;331233;39;679104
75;2020-11-29;4;3;7;384742;372771;49;757513
75;2020-11-29;6;6;12;413361;390880;59;804241
75;2020-11-29;3;6;9;425623;384060;69;809683
75;2020-11-29;4;7;11;325086;276298;79;601384
75;2020-11-29;10;1;11;213986;139308;89;353294
75;2020-11-29;8;1;9;77600;28200;90;105800
75;2020-11-29;48;34;82;3113538;2886444;0;5999982
76;2020-11-29;0;0;0;305956;318589;09;624545
76;2020-11-29;3;1;4;338942;356969;19;695911
76;2020-11-29;7;4;11;316210;319570;29;635780
76;2020-11-29;8;10;18;356758;337587;39;694345
76;2020-11-29;8;4;12;376541;363812;49;740353
76;2020-11-29;5;2;7;402608;383750;59;786358
76;2020-11-29;1;4;5;394889;358997;69;753886
76;2020-11-29;3;8;11;308664;263806;79;572470
76;2020-11-29;7;2;9;195838;129272;89;325110
76;2020-11-29;6;2;8;69372;26728;90;96100
76;2020-11-29;48;38;86;3065778;2859080;0;5924858
84;2020-11-29;3;2;5;459549;481088;09;940637
84;2020-11-29;9;13;22;487711;511905;19;999616
84;2020-11-29;22;9;31;443824;451094;29;894918
84;2020-11-29;24;14;38;512522;493262;39;1005784
84;2020-11-29;19;21;40;520248;515106;49;1035354
84;2020-11-29;17;13;30;529611;514848;59;1044459
84;2020-11-29;8;21;29;486720;439940;69;926660
84;2020-11-29;13;13;26;372151;315211;79;687362
84;2020-11-29;28;15;43;237198;150524;89;387722
84;2020-11-29;16;10;26;81185;28680;90;109865
84;2020-11-29;159;131;291;4130719;3901658;0;8032377
93;2020-11-29;3;2;5;268834;283093;09;551927
93;2020-11-29;4;3;7;280751;296087;19;576838
93;2020-11-29;11;0;11;254404;255552;29;509956
93;2020-11-29;11;5;16;310704;288398;39;599102
93;2020-11-29;8;5;13;325559;305827;49;631386
93;2020-11-29;9;4;13;353104;325389;59;678493
93;2020-11-29;4;5;9;336327;296459;69;632786
93;2020-11-29;2;9;11;279820;229699;79;509519
93;2020-11-29;8;12;20;171274;113716;89;284990
93;2020-11-29;5;6;11;58896;21758;90;80654
93;2020-11-29;65;51;116;2639673;2415978;0;5055651
94;2020-11-29;0;0;0;16311;17433;09;33744
94;2020-11-29;0;0;0;16679;18132;19;34811
94;2020-11-29;0;0;0;16782;16579;29;33361
94;2020-11-29;0;0;0;23044;20580;39;43624
94;2020-11-29;0;0;0;23065;22140;49;45205
94;2020-11-29;1;0;1;24549;23421;59;47970
94;2020-11-29;0;0;0;23212;21883;69;45095
94;2020-11-29;0;0;0;19544;17141;79;36685
94;2020-11-29;0;0;0;11227;8178;89;19405
94;2020-11-29;1;0;1;3332;1447;90;4779
94;2020-11-29;2;0;2;177745;166934;0;344679
01;2020-11-30;0;0;0;19979;20155;09;40134
01;2020-11-30;1;0;1;24994;25489;19;50483
01;2020-11-30;1;0;1;17868;16690;29;34558
01;2020-11-30;3;0;3;22328;14821;39;37149
01;2020-11-30;2;0;2;28652;20276;49;48928
01;2020-11-30;1;3;4;33264;27260;59;60524
01;2020-11-30;0;0;0;27135;23978;69;51113
01;2020-11-30;1;0;1;18401;14661;79;33062
01;2020-11-30;0;0;0;9633;6375;89;16008
01;2020-11-30;0;0;0;3410;1510;90;4920
01;2020-11-30;9;3;12;205664;171215;0;376879
02;2020-11-30;0;2;2;16881;17110;09;33991
02;2020-11-30;1;0;1;21410;21604;19;43014
02;2020-11-30;2;0;2;16017;15479;29;31496
02;2020-11-30;2;0;2;19825;14455;39;34280
02;2020-11-30;0;3;3;24719;18248;49;42967
02;2020-11-30;3;1;4;34361;28310;59;62671
02;2020-11-30;2;5;7;28061;24495;69;52556
02;2020-11-30;0;0;0;18231;15278;79;33509
02;2020-11-30;0;0;0;11090;7677;89;18767
02;2020-11-30;0;0;0;3992;1506;90;5498
02;2020-11-30;10;11;21;194587;164162;0;358749
03;2020-11-30;0;0;0;31123;30920;09;62043
03;2020-11-30;1;3;4;29370;29268;19;58638
03;2020-11-30;7;4;11;21458;18963;29;40421
03;2020-11-30;8;4;12;21276;18326;39;39602
03;2020-11-30;2;3;5;18164;16593;49;34757
03;2020-11-30;0;3;3;13469;13557;59;27026
03;2020-11-30;0;1;1;8776;8670;69;17446
03;2020-11-30;0;1;1;3777;3591;79;7368
03;2020-11-30;0;0;0;1649;1072;89;2721
03;2020-11-30;0;0;0;485;184;90;669
03;2020-11-30;18;19;37;149547;141144;0;290691
04;2020-11-30;1;4;5;60314;61377;09;121691
04;2020-11-30;3;10;13;66065;68387;19;134452
04;2020-11-30;7;5;12;51059;47156;29;98215
04;2020-11-30;2;1;3;58788;45780;39;104568
04;2020-11-30;4;3;7;61408;52207;49;113615
04;2020-11-30;4;1;5;64838;60759;59;125597
04;2020-11-30;1;1;2;47008;42843;69;89851
04;2020-11-30;1;2;3;25509;21184;79;46693
04;2020-11-30;0;0;0;13168;7647;89;20815
04;2020-11-30;0;0;0;3209;1253;90;4462
04;2020-11-30;23;27;50;451366;408593;0;859959
05;2020-11-30;0;0;0;362.366008612902;341.338819562748;09;703.704828175651
05;2020-11-30;0;0;0;353.376145114279;370.349735405642;19;723.725880519921
05;2020-11-30;0;0;0;218.593559489256;256.539602589476;29;475.133162078732
05;2020-11-30;0;0;0;404.225408693299;360.321910454353;39;764.547319147651
05;2020-11-30;0;0;0;520.067953604221;497.108383964256;49;1017.17633756848
05;2020-11-30;0;0;0;468.146063921917;510.087601910415;59;978.233665832332
05;2020-11-30;0;0;0;340.368470050554;334.366842191253;69;674.735312241807
05;2020-11-30;0;0;0;212.598666888387;192.597753227106;79;405.196420115493
05;2020-11-30;0;0;0;148.727797095705;61.8681715431829;89;210.595968638888
05;2020-11-30;0;0;0;32.9601271090696;10.9909785719784;90;43.9511056810479
05;2020-11-30;0;0;0;3061.43020057959;2935.56979942041;0;5997
06;2020-11-30;0;1;1;42583;42380;09;84963
06;2020-11-30;1;0;1;33369;31925;19;65294
06;2020-11-30;3;7;10;21571;15080;29;36651
06;2020-11-30;5;4;9;21550;16147;39;37697
06;2020-11-30;6;4;10;14193;13939;49;28132
06;2020-11-30;1;4;5;7171;7597;59;14768
06;2020-11-30;1;3;4;3629;4117;69;7746
06;2020-11-30;0;1;1;1577;1457;79;3034
06;2020-11-30;0;0;0;531;474;89;1005
06;2020-11-30;1;0;1;88;93;90;181
06;2020-11-30;18;24;42;146262;133209;0;279471
07;2020-11-30;0;0;0;485;549;09;1034
07;2020-11-30;0;0;0;403;432;19;835
07;2020-11-30;0;0;0;764;841;29;1605
07;2020-11-30;1;0;1;824;928;39;1752
07;2020-11-30;0;0;0;788;1020;49;1808
07;2020-11-30;1;0;1;678;870;59;1548
07;2020-11-30;0;0;0;360;382;69;742
07;2020-11-30;0;0;0;231;190;79;421
07;2020-11-30;0;0;0;114;67;89;181
07;2020-11-30;0;0;0;24;11;90;35
07;2020-11-30;2;0;2;4671;5290;0;9961
08;2020-11-30;0;0;0;2715.22592983026;2997.75551488675;09;5712.98144471701
08;2020-11-30;2;1;3;2778.51901080978;3160.9156459093;19;5939.43465671908
08;2020-11-30;1;0;1;2080.8882988764;1718.16634315323;29;3799.05464202964
08;2020-11-30;2;2;4;2701.8582062647;1896.52641413317;39;4598.38462039786
08;2020-11-30;1;2;3;3151.45861023308;2460.52498233809;49;5611.98359257117
08;2020-11-30;1;2;3;2620.29868333099;2422.23566154656;59;5042.53434487755
08;2020-11-30;1;0;1;1621.44173420671;1438.58325779464;69;3060.02499200135
08;2020-11-30;0;0;0;626.575909335673;526.358467843651;79;1152.93437717932
08;2020-11-30;0;0;0;205.018522985054;140.993639349697;89;346.012162334751
08;2020-11-30;0;0;0;50.0325684687745;20.62259870351;90;70.6551671722846
08;2020-11-30;8;7;15;18551.3174743414;16782.6825256586;0;35334
11;2020-11-30;51;43;102;783071;811785;09;1594856
11;2020-11-30;165;173;348;761456;784653;19;1546109
11;2020-11-30;247;195;442;850145;801772;29;1651917
11;2020-11-30;277;223;501;914360;843488;39;1757848
11;2020-11-30;240;204;445;845609;826202;49;1671811
11;2020-11-30;223;186;414;793566;745070;59;1538636
11;2020-11-30;120;134;255;628649;549192;69;1177841
11;2020-11-30;71;76;147;434606;358356;79;792962
11;2020-11-30;84;59;143;261425;162933;89;424358
11;2020-11-30;57;16;73;89253;32619;90;121872
11;2020-11-30;1536;1309;2871;6362140;5916070;0;12278210
24;2020-11-30;5;5;10;139720;144686;09;284406
24;2020-11-30;31;36;67;152979;161185;19;314164
24;2020-11-30;36;19;55;122237;126536;29;248773
24;2020-11-30;43;40;83;150359;142009;39;292368
24;2020-11-30;48;38;86;161829;158758;49;320587
24;2020-11-30;44;28;72;172552;168011;59;340563
24;2020-11-30;26;27;53;172509;158177;69;330686
24;2020-11-30;14;17;32;129428;110593;79;240021
24;2020-11-30;27;16;43;87342;56882;89;144224
24;2020-11-30;39;12;51;31210;12071;90;43281
24;2020-11-30;313;238;552;1320165;1238908;0;2559073
27;2020-11-30;11;15;27;143373;149679;09;293052
27;2020-11-30;53;63;118;160962;173003;19;333965
27;2020-11-30;65;52;117;133746;142254;29;276000
27;2020-11-30;78;42;120;160004;155407;39;315411
27;2020-11-30;86;84;170;172333;169564;49;341897
27;2020-11-30;88;82;170;189979;183788;59;373767
27;2020-11-30;58;53;111;192591;178206;69;370797
27;2020-11-30;39;37;76;146876;127546;79;274422
27;2020-11-30;53;38;91;96896;61575;89;158471
27;2020-11-30;59;16;75;33148;12109;90;45257
27;2020-11-30;590;482;1075;1429908;1353131;0;2783039
28;2020-11-30;6;8;15;180735;186856;09;367591
28;2020-11-30;21;20;42;200125;213621;19;413746
28;2020-11-30;29;15;44;168922;173007;29;341929
28;2020-11-30;24;30;54;196628;188487;39;385115
28;2020-11-30;24;23;47;205396;201699;49;407095
28;2020-11-30;45;33;78;222002;213866;59;435868
28;2020-11-30;30;25;55;224688;203758;69;428446
28;2020-11-30;12;15;27;163192;135543;79;298735
28;2020-11-30;27;13;40;109691;65377;89;175068
28;2020-11-30;31;4;35;37222;12685;90;49907
28;2020-11-30;249;186;437;1708601;1594899;0;3303500
32;2020-11-30;29;28;57;358062;373689;09;731751
32;2020-11-30;86;72;158;387045;406742;19;793787
32;2020-11-30;120;81;201;342304;348587;29;690891
32;2020-11-30;107;88;196;382485;369972;39;752457
32;2020-11-30;111;86;197;382510;376716;49;759226
32;2020-11-30;118;96;214;386937;376527;59;763464
32;2020-11-30;65;65;130;371211;330938;69;702149
32;2020-11-30;50;38;88;250542;201459;79;452001
32;2020-11-30;81;41;122;163399;89786;89;253185
32;2020-11-30;45;11;56;48384;15367;90;63751
32;2020-11-30;812;606;1419;3072879;2889783;0;5962662
44;2020-11-30;29;34;63;291525;306839;09;598364
44;2020-11-30;98;79;178;320255;339504;19;659759
44;2020-11-30;117;105;225;302020;314428;29;616448
44;2020-11-30;122;78;202;342222;333292;39;675514
44;2020-11-30;130;89;221;349727;344491;49;694218
44;2020-11-30;125;92;219;381371;373239;59;754610
44;2020-11-30;72;74;146;367165;335850;69;703015
44;2020-11-30;48;54;104;250387;215436;79;465823
44;2020-11-30;96;49;145;170825;105192;89;276017
44;2020-11-30;99;14;113;51248;16731;90;67979
44;2020-11-30;936;668;1616;2826745;2685002;0;5511747
52;2020-11-30;7;9;16;213594;223900;09;437494
52;2020-11-30;25;23;49;240818;255197;19;496015
52;2020-11-30;59;22;81;197010;200630;29;397640
52;2020-11-30;53;30;83;231204;224885;39;456089
52;2020-11-30;49;26;75;243874;243418;49;487292
52;2020-11-30;45;35;80;244100;239116;59;483216
52;2020-11-30;20;19;39;241796;221345;69;463141
52;2020-11-30;23;24;47;177805;149903;79;327708
52;2020-11-30;50;22;72;119561;75822;89;195383
52;2020-11-30;49;15;64;42559;15260;90;57819
52;2020-11-30;380;225;606;1952321;1849476;0;3801797
53;2020-11-30;8;7;16;173813;182358;09;356171
53;2020-11-30;19;7;26;202720;214740;19;417460
53;2020-11-30;27;17;44;163116;173196;29;336312
53;2020-11-30;23;14;37;190526;187674;39;378200
53;2020-11-30;28;17;45;212098;212015;49;424113
53;2020-11-30;21;6;27;223699;219176;59;442875
53;2020-11-30;20;17;37;227435;209274;69;436709
53;2020-11-30;9;8;17;169992;140910;79;310902
53;2020-11-30;8;9;17;118117;69883;89;188000
53;2020-11-30;11;6;17;37370;12267;90;49637
53;2020-11-30;174;108;283;1718886;1621493;0;3340379
75;2020-11-30;17;17;34;293104;305291;09;598395
75;2020-11-30;58;48;107;337141;357785;19;694926
75;2020-11-30;101;51;152;295024;300618;29;595642
75;2020-11-30;95;59;154;347871;331233;39;679104
75;2020-11-30;107;60;167;384742;372771;49;757513
75;2020-11-30;93;65;158;413361;390880;59;804241
75;2020-11-30;53;59;112;425623;384060;69;809683
75;2020-11-30;46;40;86;325086;276298;79;601384
75;2020-11-30;91;47;138;213986;139308;89;353294
75;2020-11-30;78;28;106;77600;28200;90;105800
75;2020-11-30;739;474;1214;3113538;2886444;0;5999982
76;2020-11-30;10;10;24;305956;318589;09;624545
76;2020-11-30;58;65;129;338942;356969;19;695911
76;2020-11-30;74;62;136;316210;319570;29;635780
76;2020-11-30;81;56;137;356758;337587;39;694345
76;2020-11-30;81;63;144;376541;363812;49;740353
76;2020-11-30;73;69;142;402608;383750;59;786358
76;2020-11-30;39;59;98;394889;358997;69;753886
76;2020-11-30;45;30;75;308664;263806;79;572470
76;2020-11-30;57;32;89;195838;129272;89;325110
76;2020-11-30;76;26;102;69372;26728;90;96100
76;2020-11-30;594;474;1078;3065778;2859080;0;5924858
84;2020-11-30;45;45;90;459549;481088;09;940637
84;2020-11-30;177;194;373;487711;511905;19;999616
84;2020-11-30;224;165;389;443824;451094;29;894918
84;2020-11-30;230;190;421;512522;493262;39;1005784
84;2020-11-30;232;189;421;520248;515106;49;1035354
84;2020-11-30;190;171;361;529611;514848;59;1044459
84;2020-11-30;119;141;260;486720;439940;69;926660
84;2020-11-30;99;102;201;372151;315211;79;687362
84;2020-11-30;156;95;251;237198;150524;89;387722
84;2020-11-30;151;37;188;81185;28680;90;109865
84;2020-11-30;1623;1329;2955;4130719;3901658;0;8032377
93;2020-11-30;27;26;54;268834;283093;09;551927
93;2020-11-30;79;86;167;280751;296087;19;576838
93;2020-11-30;128;69;197;254404;255552;29;509956
93;2020-11-30;131;87;218;310704;288398;39;599102
93;2020-11-30;127;110;237;325559;305827;49;631386
93;2020-11-30;99;104;203;353104;325389;59;678493
93;2020-11-30;78;73;151;336327;296459;69;632786
93;2020-11-30;63;52;115;279820;229699;79;509519
93;2020-11-30;73;40;113;171274;113716;89;284990
93;2020-11-30;78;17;95;58896;21758;90;80654
93;2020-11-30;883;664;1550;2639673;2415978;0;5055651
94;2020-11-30;0;1;1;16311;17433;09;33744
94;2020-11-30;1;1;2;16679;18132;19;34811
94;2020-11-30;2;3;5;16782;16579;29;33361
94;2020-11-30;3;0;3;23044;20580;39;43624
94;2020-11-30;1;3;4;23065;22140;49;45205
94;2020-11-30;0;1;1;24549;23421;59;47970
94;2020-11-30;0;3;3;23212;21883;69;45095
94;2020-11-30;1;0;1;19544;17141;79;36685
94;2020-11-30;2;1;3;11227;8178;89;19405
94;2020-11-30;1;0;1;3332;1447;90;4779
94;2020-11-30;11;13;24;177745;166934;0;344679
01;2020-12-01;0;1;1;19979;20155;09;40134
01;2020-12-01;0;1;1;24994;25489;19;50483
01;2020-12-01;0;1;1;17868;16690;29;34558
01;2020-12-01;1;1;2;22328;14821;39;37149
01;2020-12-01;1;3;4;28652;20276;49;48928
01;2020-12-01;2;1;3;33264;27260;59;60524
01;2020-12-01;1;3;4;27135;23978;69;51113
01;2020-12-01;0;1;1;18401;14661;79;33062
01;2020-12-01;0;0;0;9633;6375;89;16008
01;2020-12-01;0;0;0;3410;1510;90;4920
01;2020-12-01;5;12;17;205664;171215;0;376879
02;2020-12-01;0;0;0;16881;17110;09;33991
02;2020-12-01;0;0;0;21410;21604;19;43014
02;2020-12-01;0;0;0;16017;15479;29;31496
02;2020-12-01;0;0;0;19825;14455;39;34280
02;2020-12-01;1;2;3;24719;18248;49;42967
02;2020-12-01;0;3;3;34361;28310;59;62671
02;2020-12-01;0;1;1;28061;24495;69;52556
02;2020-12-01;0;0;0;18231;15278;79;33509
02;2020-12-01;0;0;0;11090;7677;89;18767
02;2020-12-01;0;0;0;3992;1506;90;5498
02;2020-12-01;1;6;7;194587;164162;0;358749
03;2020-12-01;1;1;2;31123;30920;09;62043
03;2020-12-01;3;2;5;29370;29268;19;58638
03;2020-12-01;2;3;5;21458;18963;29;40421
03;2020-12-01;4;4;8;21276;18326;39;39602
03;2020-12-01;6;4;10;18164;16593;49;34757
03;2020-12-01;4;0;4;13469;13557;59;27026
03;2020-12-01;0;1;1;8776;8670;69;17446
03;2020-12-01;1;0;1;3777;3591;79;7368
03;2020-12-01;0;0;0;1649;1072;89;2721
03;2020-12-01;0;0;0;485;184;90;669
03;2020-12-01;21;15;36;149547;141144;0;290691
04;2020-12-01;4;0;4;60314;61377;09;121691
04;2020-12-01;5;6;11;66065;68387;19;134452
04;2020-12-01;1;4;5;51059;47156;29;98215
04;2020-12-01;5;2;7;58788;45780;39;104568
04;2020-12-01;4;6;10;61408;52207;49;113615
04;2020-12-01;3;2;5;64838;60759;59;125597
04;2020-12-01;4;2;6;47008;42843;69;89851
04;2020-12-01;1;1;2;25509;21184;79;46693
04;2020-12-01;0;0;0;13168;7647;89;20815
04;2020-12-01;0;0;0;3209;1253;90;4462
04;2020-12-01;27;23;50;451366;408593;0;859959
05;2020-12-01;0;0;0;362.366008612902;341.338819562748;09;703.704828175651
05;2020-12-01;0;0;0;353.376145114279;370.349735405642;19;723.725880519921
05;2020-12-01;0;0;0;218.593559489256;256.539602589476;29;475.133162078732
05;2020-12-01;0;0;0;404.225408693299;360.321910454353;39;764.547319147651
05;2020-12-01;0;0;0;520.067953604221;497.108383964256;49;1017.17633756848
05;2020-12-01;0;0;0;468.146063921917;510.087601910415;59;978.233665832332
05;2020-12-01;0;0;0;340.368470050554;334.366842191253;69;674.735312241807
05;2020-12-01;0;0;0;212.598666888387;192.597753227106;79;405.196420115493
05;2020-12-01;0;0;0;148.727797095705;61.8681715431829;89;210.595968638888
05;2020-12-01;0;0;0;32.9601271090696;10.9909785719784;90;43.9511056810479
05;2020-12-01;0;0;0;3061.43020057959;2935.56979942041;0;5997
06;2020-12-01;0;0;0;42583;42380;09;84963
06;2020-12-01;1;0;1;33369;31925;19;65294
06;2020-12-01;4;5;9;21571;15080;29;36651
06;2020-12-01;3;5;8;21550;16147;39;37697
06;2020-12-01;1;4;5;14193;13939;49;28132
06;2020-12-01;2;4;6;7171;7597;59;14768
06;2020-12-01;0;2;2;3629;4117;69;7746
06;2020-12-01;0;0;0;1577;1457;79;3034
06;2020-12-01;0;0;0;531;474;89;1005
06;2020-12-01;0;0;0;88;93;90;181
06;2020-12-01;11;20;31;146262;133209;0;279471
07;2020-12-01;0;0;0;485;549;09;1034
07;2020-12-01;0;0;0;403;432;19;835
07;2020-12-01;0;0;0;764;841;29;1605
07;2020-12-01;1;0;1;824;928;39;1752
07;2020-12-01;0;1;1;788;1020;49;1808
07;2020-12-01;0;0;0;678;870;59;1548
07;2020-12-01;0;0;0;360;382;69;742
07;2020-12-01;0;0;0;231;190;79;421
07;2020-12-01;0;0;0;114;67;89;181
07;2020-12-01;0;0;0;24;11;90;35
07;2020-12-01;1;1;2;4671;5290;0;9961
08;2020-12-01;0;0;0;2715.22592983026;2997.75551488675;09;5712.98144471701
08;2020-12-01;1;1;2;2778.51901080978;3160.9156459093;19;5939.43465671908
08;2020-12-01;3;3;6;2080.8882988764;1718.16634315323;29;3799.05464202964
08;2020-12-01;5;2;7;2701.8582062647;1896.52641413317;39;4598.38462039786
08;2020-12-01;1;0;1;3151.45861023308;2460.52498233809;49;5611.98359257117
08;2020-12-01;0;1;1;2620.29868333099;2422.23566154656;59;5042.53434487755
08;2020-12-01;0;1;1;1621.44173420671;1438.58325779464;69;3060.02499200135
08;2020-12-01;0;2;2;626.575909335673;526.358467843651;79;1152.93437717932
08;2020-12-01;0;0;0;205.018522985054;140.993639349697;89;346.012162334751
08;2020-12-01;0;0;0;50.0325684687745;20.62259870351;90;70.6551671722846
08;2020-12-01;10;10;20;18551.3174743414;16782.6825256586;0;35334
11;2020-12-01;43;35;84;783071;811785;09;1594856
11;2020-12-01;118;112;243;761456;784653;19;1546109
11;2020-12-01;193;148;341;850145;801772;29;1651917
11;2020-12-01;196;155;353;914360;843488;39;1757848
11;2020-12-01;178;168;347;845609;826202;49;1671811
11;2020-12-01;157;129;286;793566;745070;59;1538636
11;2020-12-01;100;85;186;628649;549192;69;1177841
11;2020-12-01;46;64;110;434606;358356;79;792962
11;2020-12-01;81;37;118;261425;162933;89;424358
11;2020-12-01;59;18;77;89253;32619;90;121872
11;2020-12-01;1173;953;2149;6362140;5916070;0;12278210
24;2020-12-01;0;6;6;139720;144686;09;284406
24;2020-12-01;28;23;53;152979;161185;19;314164
24;2020-12-01;36;23;59;122237;126536;29;248773
24;2020-12-01;44;15;59;150359;142009;39;292368
24;2020-12-01;40;29;69;161829;158758;49;320587
24;2020-12-01;35;28;63;172552;168011;59;340563
24;2020-12-01;9;22;31;172509;158177;69;330686
24;2020-12-01;29;21;50;129428;110593;79;240021
24;2020-12-01;41;24;65;87342;56882;89;144224
24;2020-12-01;30;15;45;31210;12071;90;43281
24;2020-12-01;292;206;500;1320165;1238908;0;2559073
27;2020-12-01;10;13;23;143373;149679;09;293052
27;2020-12-01;41;54;96;160962;173003;19;333965
27;2020-12-01;59;36;95;133746;142254;29;276000
27;2020-12-01;55;34;89;160004;155407;39;315411
27;2020-12-01;60;46;106;172333;169564;49;341897
27;2020-12-01;57;53;110;189979;183788;59;373767
27;2020-12-01;27;43;70;192591;178206;69;370797
27;2020-12-01;33;34;67;146876;127546;79;274422
27;2020-12-01;44;33;77;96896;61575;89;158471
27;2020-12-01;41;13;54;33148;12109;90;45257
27;2020-12-01;427;359;787;1429908;1353131;0;2783039
28;2020-12-01;10;11;21;180735;186856;09;367591
28;2020-12-01;22;21;43;200125;213621;19;413746
28;2020-12-01;28;25;53;168922;173007;29;341929
28;2020-12-01;36;28;64;196628;188487;39;385115
28;2020-12-01;36;28;64;205396;201699;49;407095
28;2020-12-01;37;29;66;222002;213866;59;435868
28;2020-12-01;16;17;33;224688;203758;69;428446
28;2020-12-01;16;15;31;163192;135543;79;298735
28;2020-12-01;20;7;27;109691;65377;89;175068
28;2020-12-01;23;6;29;37222;12685;90;49907
28;2020-12-01;244;187;431;1708601;1594899;0;3303500
32;2020-12-01;16;23;39;358062;373689;09;731751
32;2020-12-01;68;57;125;387045;406742;19;793787
32;2020-12-01;101;49;150;342304;348587;29;690891
32;2020-12-01;94;53;147;382485;369972;39;752457
32;2020-12-01;101;84;185;382510;376716;49;759226
32;2020-12-01;70;78;148;386937;376527;59;763464
32;2020-12-01;50;46;96;371211;330938;69;702149
32;2020-12-01;44;39;83;250542;201459;79;452001
32;2020-12-01;81;39;120;163399;89786;89;253185
32;2020-12-01;89;15;104;48384;15367;90;63751
32;2020-12-01;714;484;1198;3072879;2889783;0;5962662
44;2020-12-01;24;22;46;291525;306839;09;598364
44;2020-12-01;63;67;131;320255;339504;19;659759
44;2020-12-01;87;54;143;302020;314428;29;616448
44;2020-12-01;105;88;194;342222;333292;39;675514
44;2020-12-01;78;88;167;349727;344491;49;694218
44;2020-12-01;107;91;200;381371;373239;59;754610
44;2020-12-01;54;47;101;367165;335850;69;703015
44;2020-12-01;50;28;80;250387;215436;79;465823
44;2020-12-01;90;49;140;170825;105192;89;276017
44;2020-12-01;76;11;87;51248;16731;90;67979
44;2020-12-01;734;545;1290;2826745;2685002;0;5511747
52;2020-12-01;11;8;20;213594;223900;09;437494
52;2020-12-01;25;27;52;240818;255197;19;496015
52;2020-12-01;40;21;61;197010;200630;29;397640
52;2020-12-01;39;15;54;231204;224885;39;456089
52;2020-12-01;49;28;77;243874;243418;49;487292
52;2020-12-01;35;30;65;244100;239116;59;483216
52;2020-12-01;14;15;29;241796;221345;69;463141
52;2020-12-01;9;17;26;177805;149903;79;327708
52;2020-12-01;45;28;73;119561;75822;89;195383
52;2020-12-01;33;14;47;42559;15260;90;57819
52;2020-12-01;300;203;504;1952321;1849476;0;3801797
53;2020-12-01;4;7;11;173813;182358;09;356171
53;2020-12-01;16;13;29;202720;214740;19;417460
53;2020-12-01;22;13;37;163116;173196;29;336312
53;2020-12-01;32;13;45;190526;187674;39;378200
53;2020-12-01;27;15;42;212098;212015;49;424113
53;2020-12-01;27;9;36;223699;219176;59;442875
53;2020-12-01;7;9;16;227435;209274;69;436709
53;2020-12-01;7;4;11;169992;140910;79;310902
53;2020-12-01;19;8;27;118117;69883;89;188000
53;2020-12-01;11;1;12;37370;12267;90;49637
53;2020-12-01;172;92;266;1718886;1621493;0;3340379
75;2020-12-01;11;7;19;293104;305291;09;598395
75;2020-12-01;41;34;76;337141;357785;19;694926
75;2020-12-01;63;37;100;295024;300618;29;595642
75;2020-12-01;73;43;116;347871;331233;39;679104
75;2020-12-01;65;35;100;384742;372771;49;757513
75;2020-12-01;59;44;103;413361;390880;59;804241
75;2020-12-01;36;28;64;425623;384060;69;809683
75;2020-12-01;31;21;52;325086;276298;79;601384
75;2020-12-01;69;32;101;213986;139308;89;353294
75;2020-12-01;64;20;84;77600;28200;90;105800
75;2020-12-01;512;301;815;3113538;2886444;0;5999982
76;2020-12-01;11;15;29;305956;318589;09;624545
76;2020-12-01;46;40;86;338942;356969;19;695911
76;2020-12-01;63;48;111;316210;319570;29;635780
76;2020-12-01;57;45;102;356758;337587;39;694345
76;2020-12-01;65;50;115;376541;363812;49;740353
76;2020-12-01;57;40;97;402608;383750;59;786358
76;2020-12-01;29;40;69;394889;358997;69;753886
76;2020-12-01;31;28;60;308664;263806;79;572470
76;2020-12-01;54;41;95;195838;129272;89;325110
76;2020-12-01;64;16;80;69372;26728;90;96100
76;2020-12-01;478;363;845;3065778;2859080;0;5924858
84;2020-12-01;41;38;79;459549;481088;09;940637
84;2020-12-01;135;133;268;487711;511905;19;999616
84;2020-12-01;169;113;282;443824;451094;29;894918
84;2020-12-01;179;128;307;512522;493262;39;1005784
84;2020-12-01;147;135;282;520248;515106;49;1035354
84;2020-12-01;157;135;292;529611;514848;59;1044459
84;2020-12-01;116;88;204;486720;439940;69;926660
84;2020-12-01;88;82;170;372151;315211;79;687362
84;2020-12-01;149;74;223;237198;150524;89;387722
84;2020-12-01;144;39;183;81185;28680;90;109865
84;2020-12-01;1325;965;2290;4130719;3901658;0;8032377
93;2020-12-01;20;15;35;268834;283093;09;551927
93;2020-12-01;52;57;109;280751;296087;19;576838
93;2020-12-01;88;71;159;254404;255552;29;509956
93;2020-12-01;95;71;166;310704;288398;39;599102
93;2020-12-01;100;65;166;325559;305827;49;631386
93;2020-12-01;91;67;158;353104;325389;59;678493
93;2020-12-01;57;47;104;336327;296459;69;632786
93;2020-12-01;42;29;71;279820;229699;79;509519
93;2020-12-01;68;29;97;171274;113716;89;284990
93;2020-12-01;46;13;59;58896;21758;90;80654
93;2020-12-01;659;464;1124;2639673;2415978;0;5055651
94;2020-12-01;0;2;2;16311;17433;09;33744
94;2020-12-01;1;1;2;16679;18132;19;34811
94;2020-12-01;3;2;5;16782;16579;29;33361
94;2020-12-01;0;3;3;23044;20580;39;43624
94;2020-12-01;0;2;2;23065;22140;49;45205
94;2020-12-01;3;0;3;24549;23421;59;47970
94;2020-12-01;0;1;1;23212;21883;69;45095
94;2020-12-01;0;0;0;19544;17141;79;36685
94;2020-12-01;0;0;0;11227;8178;89;19405
94;2020-12-01;0;0;0;3332;1447;90;4779
94;2020-12-01;7;11;18;177745;166934;0;344679
01;2020-12-02;0;0;0;19979;20155;09;40134
01;2020-12-02;0;1;1;24994;25489;19;50483
01;2020-12-02;1;1;2;17868;16690;29;34558
01;2020-12-02;1;1;2;22328;14821;39;37149
01;2020-12-02;0;0;0;28652;20276;49;48928
01;2020-12-02;0;0;0;33264;27260;59;60524
01;2020-12-02;0;1;1;27135;23978;69;51113
01;2020-12-02;0;0;0;18401;14661;79;33062
01;2020-12-02;0;0;0;9633;6375;89;16008
01;2020-12-02;0;0;0;3410;1510;90;4920
01;2020-12-02;2;4;7;205664;171215;0;376879
02;2020-12-02;0;0;0;16881;17110;09;33991
02;2020-12-02;0;0;0;21410;21604;19;43014
02;2020-12-02;1;1;2;16017;15479;29;31496
02;2020-12-02;0;1;1;19825;14455;39;34280
02;2020-12-02;0;2;2;24719;18248;49;42967
02;2020-12-02;1;1;2;34361;28310;59;62671
02;2020-12-02;1;0;1;28061;24495;69;52556
02;2020-12-02;1;0;1;18231;15278;79;33509
02;2020-12-02;0;0;0;11090;7677;89;18767
02;2020-12-02;0;0;0;3992;1506;90;5498
02;2020-12-02;4;5;9;194587;164162;0;358749
03;2020-12-02;0;0;0;31123;30920;09;62043
03;2020-12-02;9;2;12;29370;29268;19;58638
03;2020-12-02;4;3;7;21458;18963;29;40421
03;2020-12-02;3;4;7;21276;18326;39;39602
03;2020-12-02;4;2;6;18164;16593;49;34757
03;2020-12-02;1;4;5;13469;13557;59;27026
03;2020-12-02;0;2;2;8776;8670;69;17446
03;2020-12-02;1;0;1;3777;3591;79;7368
03;2020-12-02;0;0;0;1649;1072;89;2721
03;2020-12-02;0;0;0;485;184;90;669
03;2020-12-02;22;17;40;149547;141144;0;290691
04;2020-12-02;2;2;4;60314;61377;09;121691
04;2020-12-02;5;6;11;66065;68387;19;134452
04;2020-12-02;6;0;6;51059;47156;29;98215
04;2020-12-02;3;2;5;58788;45780;39;104568
04;2020-12-02;4;1;5;61408;52207;49;113615
04;2020-12-02;4;4;8;64838;60759;59;125597
04;2020-12-02;0;0;0;47008;42843;69;89851
04;2020-12-02;3;0;3;25509;21184;79;46693
04;2020-12-02;1;0;1;13168;7647;89;20815
04;2020-12-02;0;0;0;3209;1253;90;4462
04;2020-12-02;28;15;43;451366;408593;0;859959
05;2020-12-02;0;0;0;362.366008612902;341.338819562748;09;703.704828175651
05;2020-12-02;0;0;0;353.376145114279;370.349735405642;19;723.725880519921
05;2020-12-02;0;0;0;218.593559489256;256.539602589476;29;475.133162078732
05;2020-12-02;0;0;0;404.225408693299;360.321910454353;39;764.547319147651
05;2020-12-02;0;0;0;520.067953604221;497.108383964256;49;1017.17633756848
05;2020-12-02;0;0;0;468.146063921917;510.087601910415;59;978.233665832332
05;2020-12-02;0;0;0;340.368470050554;334.366842191253;69;674.735312241807
05;2020-12-02;0;0;0;212.598666888387;192.597753227106;79;405.196420115493
05;2020-12-02;0;0;0;148.727797095705;61.8681715431829;89;210.595968638888
05;2020-12-02;0;0;0;32.9601271090696;10.9909785719784;90;43.9511056810479
05;2020-12-02;0;0;0;3061.43020057959;2935.56979942041;0;5997
06;2020-12-02;0;0;0;42583;42380;09;84963
06;2020-12-02;2;1;3;33369;31925;19;65294
06;2020-12-02;6;4;10;21571;15080;29;36651
06;2020-12-02;12;5;17;21550;16147;39;37697
06;2020-12-02;2;2;4;14193;13939;49;28132
06;2020-12-02;1;2;3;7171;7597;59;14768
06;2020-12-02;2;1;3;3629;4117;69;7746
06;2020-12-02;0;0;0;1577;1457;79;3034
06;2020-12-02;0;0;0;531;474;89;1005
06;2020-12-02;0;0;0;88;93;90;181
06;2020-12-02;25;15;40;146262;133209;0;279471
07;2020-12-02;0;0;0;485;549;09;1034
07;2020-12-02;0;0;0;403;432;19;835
07;2020-12-02;0;0;0;764;841;29;1605
07;2020-12-02;0;0;0;824;928;39;1752
07;2020-12-02;0;0;0;788;1020;49;1808
07;2020-12-02;0;0;0;678;870;59;1548
07;2020-12-02;0;0;0;360;382;69;742
07;2020-12-02;0;0;0;231;190;79;421
07;2020-12-02;0;0;0;114;67;89;181
07;2020-12-02;0;0;0;24;11;90;35
07;2020-12-02;0;0;0;4671;5290;0;9961
08;2020-12-02;0;0;0;2715.22592983026;2997.75551488675;09;5712.98144471701
08;2020-12-02;2;0;2;2778.51901080978;3160.9156459093;19;5939.43465671908
08;2020-12-02;3;0;3;2080.8882988764;1718.16634315323;29;3799.05464202964
08;2020-12-02;5;1;6;2701.8582062647;1896.52641413317;39;4598.38462039786
08;2020-12-02;2;1;3;3151.45861023308;2460.52498233809;49;5611.98359257117
08;2020-12-02;0;0;0;2620.29868333099;2422.23566154656;59;5042.53434487755
08;2020-12-02;1;0;1;1621.44173420671;1438.58325779464;69;3060.02499200135
08;2020-12-02;1;0;1;626.575909335673;526.358467843651;79;1152.93437717932
08;2020-12-02;0;0;0;205.018522985054;140.993639349697;89;346.012162334751
08;2020-12-02;0;0;0;50.0325684687745;20.62259870351;90;70.6551671722846
08;2020-12-02;14;2;16;18551.3174743414;16782.6825256586;0;35334
11;2020-12-02;39;43;83;783071;811785;09;1594856
11;2020-12-02;112;109;230;761456;784653;19;1546109
11;2020-12-02;177;136;315;850145;801772;29;1651917
11;2020-12-02;194;171;367;914360;843488;39;1757848
11;2020-12-02;164;142;310;845609;826202;49;1671811
11;2020-12-02;166;121;288;793566;745070;59;1538636
11;2020-12-02;77;88;169;628649;549192;69;1177841
11;2020-12-02;44;52;96;434606;358356;79;792962
11;2020-12-02;40;32;72;261425;162933;89;424358
11;2020-12-02;32;15;47;89253;32619;90;121872
11;2020-12-02;1045;909;1979;6362140;5916070;0;12278210
24;2020-12-02;4;6;10;139720;144686;09;284406
24;2020-12-02;21;28;49;152979;161185;19;314164
24;2020-12-02;21;25;46;122237;126536;29;248773
24;2020-12-02;27;18;45;150359;142009;39;292368
24;2020-12-02;42;22;64;161829;158758;49;320587
24;2020-12-02;28;26;54;172552;168011;59;340563
24;2020-12-02;23;23;46;172509;158177;69;330686
24;2020-12-02;15;11;26;129428;110593;79;240021
24;2020-12-02;41;11;52;87342;56882;89;144224
24;2020-12-02;18;10;28;31210;12071;90;43281
24;2020-12-02;240;180;420;1320165;1238908;0;2559073
27;2020-12-02;8;8;18;143373;149679;09;293052
27;2020-12-02;49;51;100;160962;173003;19;333965
27;2020-12-02;63;41;104;133746;142254;29;276000
27;2020-12-02;54;30;84;160004;155407;39;315411
27;2020-12-02;57;41;98;172333;169564;49;341897
27;2020-12-02;54;44;98;189979;183788;59;373767
27;2020-12-02;33;38;71;192591;178206;69;370797
27;2020-12-02;37;39;77;146876;127546;79;274422
27;2020-12-02;60;26;86;96896;61575;89;158471
27;2020-12-02;55;13;68;33148;12109;90;45257
27;2020-12-02;470;331;804;1429908;1353131;0;2783039
28;2020-12-02;4;4;8;180735;186856;09;367591
28;2020-12-02;41;15;58;200125;213621;19;413746
28;2020-12-02;43;24;67;168922;173007;29;341929
28;2020-12-02;35;20;55;196628;188487;39;385115
28;2020-12-02;24;24;48;205396;201699;49;407095
28;2020-12-02;26;15;41;222002;213866;59;435868
28;2020-12-02;19;19;38;224688;203758;69;428446
28;2020-12-02;19;13;32;163192;135543;79;298735
28;2020-12-02;25;18;43;109691;65377;89;175068
28;2020-12-02;28;4;32;37222;12685;90;49907
28;2020-12-02;264;156;422;1708601;1594899;0;3303500
32;2020-12-02;22;16;38;358062;373689;09;731751
32;2020-12-02;69;68;137;387045;406742;19;793787
32;2020-12-02;80;69;149;342304;348587;29;690891
32;2020-12-02;95;61;156;382485;369972;39;752457
32;2020-12-02;73;73;146;382510;376716;49;759226
32;2020-12-02;62;60;122;386937;376527;59;763464
32;2020-12-02;44;41;85;371211;330938;69;702149
32;2020-12-02;35;35;70;250542;201459;79;452001
32;2020-12-02;53;38;91;163399;89786;89;253185
32;2020-12-02;62;12;74;48384;15367;90;63751
32;2020-12-02;595;473;1068;3072879;2889783;0;5962662
44;2020-12-02;16;17;34;291525;306839;09;598364
44;2020-12-02;63;65;128;320255;339504;19;659759
44;2020-12-02;95;87;182;302020;314428;29;616448
44;2020-12-02;91;74;166;342222;333292;39;675514
44;2020-12-02;89;77;167;349727;344491;49;694218
44;2020-12-02;84;82;166;381371;373239;59;754610
44;2020-12-02;53;60;114;367165;335850;69;703015
44;2020-12-02;56;43;100;250387;215436;79;465823
44;2020-12-02;75;30;105;170825;105192;89;276017
44;2020-12-02;59;18;78;51248;16731;90;67979
44;2020-12-02;681;553;1240;2826745;2685002;0;5511747
52;2020-12-02;4;5;10;213594;223900;09;437494
52;2020-12-02;31;24;56;240818;255197;19;496015
52;2020-12-02;37;28;65;197010;200630;29;397640
52;2020-12-02;32;14;46;231204;224885;39;456089
52;2020-12-02;35;33;68;243874;243418;49;487292
52;2020-12-02;29;28;57;244100;239116;59;483216
52;2020-12-02;18;24;42;241796;221345;69;463141
52;2020-12-02;15;11;26;177805;149903;79;327708
52;2020-12-02;36;10;46;119561;75822;89;195383
52;2020-12-02;28;9;37;42559;15260;90;57819
52;2020-12-02;265;186;453;1952321;1849476;0;3801797
53;2020-12-02;3;1;4;173813;182358;09;356171
53;2020-12-02;12;7;19;202720;214740;19;417460
53;2020-12-02;20;13;34;163116;173196;29;336312
53;2020-12-02;18;13;31;190526;187674;39;378200
53;2020-12-02;14;14;28;212098;212015;49;424113
53;2020-12-02;22;10;32;223699;219176;59;442875
53;2020-12-02;6;2;8;227435;209274;69;436709
53;2020-12-02;11;4;15;169992;140910;79;310902
53;2020-12-02;18;10;28;118117;69883;89;188000
53;2020-12-02;16;3;19;37370;12267;90;49637
53;2020-12-02;140;77;218;1718886;1621493;0;3340379
75;2020-12-02;16;16;33;293104;305291;09;598395
75;2020-12-02;50;46;100;337141;357785;19;694926
75;2020-12-02;67;42;109;295024;300618;29;595642
75;2020-12-02;60;60;120;347871;331233;39;679104
75;2020-12-02;68;40;108;384742;372771;49;757513
75;2020-12-02;61;59;120;413361;390880;59;804241
75;2020-12-02;35;39;74;425623;384060;69;809683
75;2020-12-02;20;21;41;325086;276298;79;601384
75;2020-12-02;61;37;98;213986;139308;89;353294
75;2020-12-02;79;17;96;77600;28200;90;105800
75;2020-12-02;517;377;899;3113538;2886444;0;5999982
76;2020-12-02;5;9;14;305956;318589;09;624545
76;2020-12-02;37;54;94;338942;356969;19;695911
76;2020-12-02;63;35;99;316210;319570;29;635780
76;2020-12-02;48;42;90;356758;337587;39;694345
76;2020-12-02;66;47;113;376541;363812;49;740353
76;2020-12-02;61;52;113;402608;383750;59;786358
76;2020-12-02;30;39;69;394889;358997;69;753886
76;2020-12-02;25;26;51;308664;263806;79;572470
76;2020-12-02;41;25;66;195838;129272;89;325110
76;2020-12-02;43;15;58;69372;26728;90;96100
76;2020-12-02;420;345;769;3065778;2859080;0;5924858
84;2020-12-02;40;44;85;459549;481088;09;940637
84;2020-12-02;130;133;264;487711;511905;19;999616
84;2020-12-02;146;120;266;443824;451094;29;894918
84;2020-12-02;155;105;260;512522;493262;39;1005784
84;2020-12-02;150;118;268;520248;515106;49;1035354
84;2020-12-02;127;116;243;529611;514848;59;1044459
84;2020-12-02;73;86;159;486720;439940;69;926660
84;2020-12-02;90;66;156;372151;315211;79;687362
84;2020-12-02;115;60;175;237198;150524;89;387722
84;2020-12-02;113;30;143;81185;28680;90;109865
84;2020-12-02;1139;878;2019;4130719;3901658;0;8032377
93;2020-12-02;20;16;36;268834;283093;09;551927
93;2020-12-02;52;69;121;280751;296087;19;576838
93;2020-12-02;89;61;150;254404;255552;29;509956
93;2020-12-02;82;59;141;310704;288398;39;599102
93;2020-12-02;66;53;120;325559;305827;49;631386
93;2020-12-02;82;62;144;353104;325389;59;678493
93;2020-12-02;47;57;104;336327;296459;69;632786
93;2020-12-02;49;41;90;279820;229699;79;509519
93;2020-12-02;76;30;106;171274;113716;89;284990
93;2020-12-02;63;12;75;58896;21758;90;80654
93;2020-12-02;626;460;1087;2639673;2415978;0;5055651
94;2020-12-02;0;0;0;16311;17433;09;33744
94;2020-12-02;0;2;2;16679;18132;19;34811
94;2020-12-02;2;1;3;16782;16579;29;33361
94;2020-12-02;1;1;2;23044;20580;39;43624
94;2020-12-02;1;0;1;23065;22140;49;45205
94;2020-12-02;1;1;2;24549;23421;59;47970
94;2020-12-02;0;1;1;23212;21883;69;45095
94;2020-12-02;0;2;2;19544;17141;79;36685
94;2020-12-02;0;0;0;11227;8178;89;19405
94;2020-12-02;0;1;1;3332;1447;90;4779
94;2020-12-02;5;9;14;177745;166934;0;344679
01;2020-12-03;0;0;0;19979;20155;09;40134
01;2020-12-03;0;0;0;24994;25489;19;50483
01;2020-12-03;0;0;0;17868;16690;29;34558
01;2020-12-03;0;0;0;22328;14821;39;37149
01;2020-12-03;1;1;2;28652;20276;49;48928
01;2020-12-03;0;1;1;33264;27260;59;60524
01;2020-12-03;0;0;0;27135;23978;69;51113
01;2020-12-03;0;0;0;18401;14661;79;33062
01;2020-12-03;0;0;0;9633;6375;89;16008
01;2020-12-03;0;0;0;3410;1510;90;4920
01;2020-12-03;1;2;3;205664;171215;0;376879
02;2020-12-03;0;0;0;16881;17110;09;33991
02;2020-12-03;0;1;1;21410;21604;19;43014
02;2020-12-03;1;0;1;16017;15479;29;31496
02;2020-12-03;0;0;0;19825;14455;39;34280
02;2020-12-03;0;1;1;24719;18248;49;42967
02;2020-12-03;0;1;1;34361;28310;59;62671
02;2020-12-03;1;0;1;28061;24495;69;52556
02;2020-12-03;0;1;1;18231;15278;79;33509
02;2020-12-03;0;0;0;11090;7677;89;18767
02;2020-12-03;1;0;1;3992;1506;90;5498
02;2020-12-03;3;4;7;194587;164162;0;358749
03;2020-12-03;1;1;2;31123;30920;09;62043
03;2020-12-03;6;4;10;29370;29268;19;58638
03;2020-12-03;4;7;11;21458;18963;29;40421
03;2020-12-03;5;3;8;21276;18326;39;39602
03;2020-12-03;3;2;5;18164;16593;49;34757
03;2020-12-03;3;3;6;13469;13557;59;27026
03;2020-12-03;0;3;3;8776;8670;69;17446
03;2020-12-03;0;0;0;3777;3591;79;7368
03;2020-12-03;0;0;0;1649;1072;89;2721
03;2020-12-03;0;0;0;485;184;90;669
03;2020-12-03;22;23;45;149547;141144;0;290691
04;2020-12-03;0;1;1;60314;61377;09;121691
04;2020-12-03;9;11;20;66065;68387;19;134452
04;2020-12-03;8;6;14;51059;47156;29;98215
04;2020-12-03;5;2;7;58788;45780;39;104568
04;2020-12-03;2;2;4;61408;52207;49;113615
04;2020-12-03;4;3;7;64838;60759;59;125597
04;2020-12-03;1;2;3;47008;42843;69;89851
04;2020-12-03;1;1;2;25509;21184;79;46693
04;2020-12-03;1;0;1;13168;7647;89;20815
04;2020-12-03;0;0;0;3209;1253;90;4462
04;2020-12-03;31;28;59;451366;408593;0;859959
05;2020-12-03;0;0;0;362.366008612902;341.338819562748;09;703.704828175651
05;2020-12-03;0;0;0;353.376145114279;370.349735405642;19;723.725880519921
05;2020-12-03;0;0;0;218.593559489256;256.539602589476;29;475.133162078732
05;2020-12-03;0;0;0;404.225408693299;360.321910454353;39;764.547319147651
05;2020-12-03;0;0;0;520.067953604221;497.108383964256;49;1017.17633756848
05;2020-12-03;1;0;1;468.146063921917;510.087601910415;59;978.233665832332
05;2020-12-03;0;0;0;340.368470050554;334.366842191253;69;674.735312241807
05;2020-12-03;0;0;0;212.598666888387;192.597753227106;79;405.196420115493
05;2020-12-03;0;0;0;148.727797095705;61.8681715431829;89;210.595968638888
05;2020-12-03;0;0;0;32.9601271090696;10.9909785719784;90;43.9511056810479
05;2020-12-03;1;0;1;3061.43020057959;2935.56979942041;0;5997
06;2020-12-03;0;0;0;42583;42380;09;84963
06;2020-12-03;3;1;4;33369;31925;19;65294
06;2020-12-03;3;3;6;21571;15080;29;36651
06;2020-12-03;4;5;9;21550;16147;39;37697
06;2020-12-03;5;2;7;14193;13939;49;28132
06;2020-12-03;0;0;0;7171;7597;59;14768
06;2020-12-03;0;0;0;3629;4117;69;7746
06;2020-12-03;0;0;0;1577;1457;79;3034
06;2020-12-03;0;0;0;531;474;89;1005
06;2020-12-03;0;0;0;88;93;90;181
06;2020-12-03;15;11;26;146262;133209;0;279471
07;2020-12-03;0;0;0;485;549;09;1034
07;2020-12-03;0;0;0;403;432;19;835
07;2020-12-03;0;0;0;764;841;29;1605
07;2020-12-03;0;0;0;824;928;39;1752
07;2020-12-03;0;1;1;788;1020;49;1808
07;2020-12-03;0;0;0;678;870;59;1548
07;2020-12-03;1;0;1;360;382;69;742
07;2020-12-03;0;0;0;231;190;79;421
07;2020-12-03;0;0;0;114;67;89;181
07;2020-12-03;0;0;0;24;11;90;35
07;2020-12-03;1;1;2;4671;5290;0;9961
08;2020-12-03;0;0;0;2715.22592983026;2997.75551488675;09;5712.98144471701
08;2020-12-03;1;1;2;2778.51901080978;3160.9156459093;19;5939.43465671908
08;2020-12-03;0;0;0;2080.8882988764;1718.16634315323;29;3799.05464202964
08;2020-12-03;2;0;2;2701.8582062647;1896.52641413317;39;4598.38462039786
08;2020-12-03;0;1;1;3151.45861023308;2460.52498233809;49;5611.98359257117
08;2020-12-03;0;0;0;2620.29868333099;2422.23566154656;59;5042.53434487755
08;2020-12-03;1;0;1;1621.44173420671;1438.58325779464;69;3060.02499200135
08;2020-12-03;0;0;0;626.575909335673;526.358467843651;79;1152.93437717932
08;2020-12-03;0;0;0;205.018522985054;140.993639349697;89;346.012162334751
08;2020-12-03;0;0;0;50.0325684687745;20.62259870351;90;70.6551671722846
08;2020-12-03;4;2;6;18551.3174743414;16782.6825256586;0;35334
11;2020-12-03;27;35;65;783071;811785;09;1594856
11;2020-12-03;100;139;241;761456;784653;19;1546109
11;2020-12-03;171;159;331;850145;801772;29;1651917
11;2020-12-03;190;155;347;914360;843488;39;1757848
11;2020-12-03;176;138;316;845609;826202;49;1671811
11;2020-12-03;143;142;287;793566;745070;59;1538636
11;2020-12-03;104;106;215;628649;549192;69;1177841
11;2020-12-03;42;57;99;434606;358356;79;792962
11;2020-12-03;53;35;88;261425;162933;89;424358
11;2020-12-03;25;18;43;89253;32619;90;121872
11;2020-12-03;1031;984;2032;6362140;5916070;0;12278210
24;2020-12-03;4;9;13;139720;144686;09;284406
24;2020-12-03;29;36;66;152979;161185;19;314164
24;2020-12-03;28;23;51;122237;126536;29;248773
24;2020-12-03;54;27;81;150359;142009;39;292368
24;2020-12-03;30;36;66;161829;158758;49;320587
24;2020-12-03;36;37;73;172552;168011;59;340563
24;2020-12-03;26;18;44;172509;158177;69;330686
24;2020-12-03;14;9;23;129428;110593;79;240021
24;2020-12-03;15;12;27;87342;56882;89;144224
24;2020-12-03;15;4;19;31210;12071;90;43281
24;2020-12-03;251;211;463;1320165;1238908;0;2559073
27;2020-12-03;13;12;25;143373;149679;09;293052
27;2020-12-03;35;44;79;160962;173003;19;333965
27;2020-12-03;75;38;113;133746;142254;29;276000
27;2020-12-03;57;49;106;160004;155407;39;315411
27;2020-12-03;56;54;110;172333;169564;49;341897
27;2020-12-03;84;51;135;189979;183788;59;373767
27;2020-12-03;40;33;73;192591;178206;69;370797
27;2020-12-03;24;24;48;146876;127546;79;274422
27;2020-12-03;38;18;56;96896;61575;89;158471
27;2020-12-03;59;18;77;33148;12109;90;45257
27;2020-12-03;481;341;822;1429908;1353131;0;2783039
28;2020-12-03;10;8;20;180735;186856;09;367591
28;2020-12-03;24;21;45;200125;213621;19;413746
28;2020-12-03;39;30;69;168922;173007;29;341929
28;2020-12-03;32;15;47;196628;188487;39;385115
28;2020-12-03;34;24;58;205396;201699;49;407095
28;2020-12-03;30;21;51;222002;213866;59;435868
28;2020-12-03;21;16;37;224688;203758;69;428446
28;2020-12-03;13;11;24;163192;135543;79;298735
28;2020-12-03;34;13;47;109691;65377;89;175068
28;2020-12-03;23;7;30;37222;12685;90;49907
28;2020-12-03;260;167;429;1708601;1594899;0;3303500
32;2020-12-03;29;16;45;358062;373689;09;731751
32;2020-12-03;79;66;145;387045;406742;19;793787
32;2020-12-03;114;82;196;342304;348587;29;690891
32;2020-12-03;91;58;149;382485;369972;39;752457
32;2020-12-03;119;79;198;382510;376716;49;759226
32;2020-12-03;95;58;153;386937;376527;59;763464
32;2020-12-03;38;46;84;371211;330938;69;702149
32;2020-12-03;42;35;77;250542;201459;79;452001
32;2020-12-03;72;22;94;163399;89786;89;253185
32;2020-12-03;62;9;71;48384;15367;90;63751
32;2020-12-03;741;471;1212;3072879;2889783;0;5962662
44;2020-12-03;25;33;58;291525;306839;09;598364
44;2020-12-03;78;61;140;320255;339504;19;659759
44;2020-12-03;112;78;193;302020;314428;29;616448
44;2020-12-03;102;73;176;342222;333292;39;675514
44;2020-12-03;131;80;213;349727;344491;49;694218
44;2020-12-03;112;88;201;381371;373239;59;754610
44;2020-12-03;76;47;123;367165;335850;69;703015
44;2020-12-03;42;63;105;250387;215436;79;465823
44;2020-12-03;94;44;139;170825;105192;89;276017
44;2020-12-03;91;14;105;51248;16731;90;67979
44;2020-12-03;863;581;1453;2826745;2685002;0;5511747
52;2020-12-03;5;4;9;213594;223900;09;437494
52;2020-12-03;19;19;40;240818;255197;19;496015
52;2020-12-03;42;24;67;197010;200630;29;397640
52;2020-12-03;42;25;67;231204;224885;39;456089
52;2020-12-03;31;22;53;243874;243418;49;487292
52;2020-12-03;30;34;64;244100;239116;59;483216
52;2020-12-03;20;14;34;241796;221345;69;463141
52;2020-12-03;11;17;28;177805;149903;79;327708
52;2020-12-03;33;12;45;119561;75822;89;195383
52;2020-12-03;36;14;50;42559;15260;90;57819
52;2020-12-03;269;185;457;1952321;1849476;0;3801797
53;2020-12-03;6;4;10;173813;182358;09;356171
53;2020-12-03;14;11;25;202720;214740;19;417460
53;2020-12-03;16;12;28;163116;173196;29;336312
53;2020-12-03;20;11;31;190526;187674;39;378200
53;2020-12-03;11;5;16;212098;212015;49;424113
53;2020-12-03;18;13;31;223699;219176;59;442875
53;2020-12-03;12;10;22;227435;209274;69;436709
53;2020-12-03;13;7;20;169992;140910;79;310902
53;2020-12-03;14;8;22;118117;69883;89;188000
53;2020-12-03;17;3;20;37370;12267;90;49637
53;2020-12-03;141;84;225;1718886;1621493;0;3340379
75;2020-12-03;7;22;31;293104;305291;09;598395
75;2020-12-03;29;41;70;337141;357785;19;694926
75;2020-12-03;72;51;123;295024;300618;29;595642
75;2020-12-03;70;41;111;347871;331233;39;679104
75;2020-12-03;63;42;105;384742;372771;49;757513
75;2020-12-03;71;52;123;413361;390880;59;804241
75;2020-12-03;42;34;76;425623;384060;69;809683
75;2020-12-03;28;28;56;325086;276298;79;601384
75;2020-12-03;57;31;88;213986;139308;89;353294
75;2020-12-03;53;17;70;77600;28200;90;105800
75;2020-12-03;493;359;854;3113538;2886444;0;5999982
76;2020-12-03;5;12;18;305956;318589;09;624545
76;2020-12-03;57;47;107;338942;356969;19;695911
76;2020-12-03;57;52;109;316210;319570;29;635780
76;2020-12-03;70;41;111;356758;337587;39;694345
76;2020-12-03;65;48;113;376541;363812;49;740353
76;2020-12-03;56;47;103;402608;383750;59;786358
76;2020-12-03;29;34;63;394889;358997;69;753886
76;2020-12-03;31;23;54;308664;263806;79;572470
76;2020-12-03;40;24;64;195838;129272;89;325110
76;2020-12-03;42;7;49;69372;26728;90;96100
76;2020-12-03;452;335;791;3065778;2859080;0;5924858
84;2020-12-03;29;30;59;459549;481088;09;940637
84;2020-12-03;108;135;245;487711;511905;19;999616
84;2020-12-03;158;118;276;443824;451094;29;894918
84;2020-12-03;172;108;280;512522;493262;39;1005784
84;2020-12-03;174;96;270;520248;515106;49;1035354
84;2020-12-03;168;127;295;529611;514848;59;1044459
84;2020-12-03;99;84;183;486720;439940;69;926660
84;2020-12-03;69;62;131;372151;315211;79;687362
84;2020-12-03;127;62;189;237198;150524;89;387722
84;2020-12-03;104;27;131;81185;28680;90;109865
84;2020-12-03;1208;849;2060;4130719;3901658;0;8032377
93;2020-12-03;11;17;28;268834;283093;09;551927
93;2020-12-03;70;71;142;280751;296087;19;576838
93;2020-12-03;67;64;131;254404;255552;29;509956
93;2020-12-03;95;65;160;310704;288398;39;599102
93;2020-12-03;76;62;139;325559;305827;49;631386
93;2020-12-03;72;70;142;353104;325389;59;678493
93;2020-12-03;47;58;105;336327;296459;69;632786
93;2020-12-03;29;32;61;279820;229699;79;509519
93;2020-12-03;41;31;72;171274;113716;89;284990
93;2020-12-03;30;8;38;58896;21758;90;80654
93;2020-12-03;538;478;1019;2639673;2415978;0;5055651
94;2020-12-03;0;0;0;16311;17433;09;33744
94;2020-12-03;0;3;3;16679;18132;19;34811
94;2020-12-03;0;2;2;16782;16579;29;33361
94;2020-12-03;0;0;0;23044;20580;39;43624
94;2020-12-03;1;1;2;23065;22140;49;45205
94;2020-12-03;2;2;4;24549;23421;59;47970
94;2020-12-03;0;1;1;23212;21883;69;45095
94;2020-12-03;0;1;1;19544;17141;79;36685
94;2020-12-03;1;0;1;11227;8178;89;19405
94;2020-12-03;3;1;4;3332;1447;90;4779
94;2020-12-03;7;11;18;177745;166934;0;344679
01;2020-12-04;0;0;0;19979;20155;09;40134
01;2020-12-04;0;0;0;24994;25489;19;50483
01;2020-12-04;0;0;0;17868;16690;29;34558
01;2020-12-04;1;0;1;22328;14821;39;37149
01;2020-12-04;1;0;1;28652;20276;49;48928
01;2020-12-04;0;0;0;33264;27260;59;60524
01;2020-12-04;1;0;1;27135;23978;69;51113
01;2020-12-04;0;0;0;18401;14661;79;33062
01;2020-12-04;0;0;0;9633;6375;89;16008
01;2020-12-04;0;0;0;3410;1510;90;4920
01;2020-12-04;3;0;3;205664;171215;0;376879
02;2020-12-04;0;0;0;16881;17110;09;33991
02;2020-12-04;1;0;1;21410;21604;19;43014
02;2020-12-04;1;1;2;16017;15479;29;31496
02;2020-12-04;3;0;3;19825;14455;39;34280
02;2020-12-04;1;1;2;24719;18248;49;42967
02;2020-12-04;1;1;2;34361;28310;59;62671
02;2020-12-04;0;0;0;28061;24495;69;52556
02;2020-12-04;1;0;1;18231;15278;79;33509
02;2020-12-04;1;0;1;11090;7677;89;18767
02;2020-12-04;0;0;0;3992;1506;90;5498
02;2020-12-04;9;3;12;194587;164162;0;358749
03;2020-12-04;0;0;0;31123;30920;09;62043
03;2020-12-04;11;4;15;29370;29268;19;58638
03;2020-12-04;6;6;13;21458;18963;29;40421
03;2020-12-04;6;7;13;21276;18326;39;39602
03;2020-12-04;4;3;7;18164;16593;49;34757
03;2020-12-04;1;1;2;13469;13557;59;27026
03;2020-12-04;2;2;4;8776;8670;69;17446
03;2020-12-04;1;0;1;3777;3591;79;7368
03;2020-12-04;0;0;0;1649;1072;89;2721
03;2020-12-04;0;0;0;485;184;90;669
03;2020-12-04;31;23;55;149547;141144;0;290691
04;2020-12-04;1;1;2;60314;61377;09;121691
04;2020-12-04;5;4;9;66065;68387;19;134452
04;2020-12-04;5;2;7;51059;47156;29;98215
04;2020-12-04;2;1;3;58788;45780;39;104568
04;2020-12-04;5;0;5;61408;52207;49;113615
04;2020-12-04;5;2;7;64838;60759;59;125597
04;2020-12-04;0;1;1;47008;42843;69;89851
04;2020-12-04;1;0;1;25509;21184;79;46693
04;2020-12-04;0;0;0;13168;7647;89;20815
04;2020-12-04;0;0;0;3209;1253;90;4462
04;2020-12-04;24;11;35;451366;408593;0;859959
05;2020-12-04;0;0;0;362.366008612902;341.338819562748;09;703.704828175651
05;2020-12-04;0;0;0;353.376145114279;370.349735405642;19;723.725880519921
05;2020-12-04;0;0;0;218.593559489256;256.539602589476;29;475.133162078732
05;2020-12-04;0;0;0;404.225408693299;360.321910454353;39;764.547319147651
05;2020-12-04;0;0;0;520.067953604221;497.108383964256;49;1017.17633756848
05;2020-12-04;0;0;0;468.146063921917;510.087601910415;59;978.233665832332
05;2020-12-04;0;0;0;340.368470050554;334.366842191253;69;674.735312241807
05;2020-12-04;0;0;0;212.598666888387;192.597753227106;79;405.196420115493
05;2020-12-04;0;0;0;148.727797095705;61.8681715431829;89;210.595968638888
05;2020-12-04;0;0;0;32.9601271090696;10.9909785719784;90;43.9511056810479
05;2020-12-04;0;0;0;3061.43020057959;2935.56979942041;0;5997
06;2020-12-04;0;1;1;42583;42380;09;84963
06;2020-12-04;5;1;6;33369;31925;19;65294
06;2020-12-04;5;4;9;21571;15080;29;36651
06;2020-12-04;4;6;10;21550;16147;39;37697
06;2020-12-04;5;2;7;14193;13939;49;28132
06;2020-12-04;1;1;2;7171;7597;59;14768
06;2020-12-04;1;3;4;3629;4117;69;7746
06;2020-12-04;0;0;0;1577;1457;79;3034
06;2020-12-04;1;0;1;531;474;89;1005
06;2020-12-04;0;0;0;88;93;90;181
06;2020-12-04;22;18;40;146262;133209;0;279471
07;2020-12-04;0;0;0;485;549;09;1034
07;2020-12-04;0;0;0;403;432;19;835
07;2020-12-04;1;0;1;764;841;29;1605
07;2020-12-04;0;0;0;824;928;39;1752
07;2020-12-04;0;0;0;788;1020;49;1808
07;2020-12-04;0;0;0;678;870;59;1548
07;2020-12-04;1;0;1;360;382;69;742
07;2020-12-04;0;0;0;231;190;79;421
07;2020-12-04;1;0;1;114;67;89;181
07;2020-12-04;0;0;0;24;11;90;35
07;2020-12-04;3;0;3;4671;5290;0;9961
08;2020-12-04;0;0;0;2715.22592983026;2997.75551488675;09;5712.98144471701
08;2020-12-04;0;0;0;2778.51901080978;3160.9156459093;19;5939.43465671908
08;2020-12-04;1;0;1;2080.8882988764;1718.16634315323;29;3799.05464202964
08;2020-12-04;0;1;1;2701.8582062647;1896.52641413317;39;4598.38462039786
08;2020-12-04;0;2;2;3151.45861023308;2460.52498233809;49;5611.98359257117
08;2020-12-04;1;4;5;2620.29868333099;2422.23566154656;59;5042.53434487755
08;2020-12-04;0;0;0;1621.44173420671;1438.58325779464;69;3060.02499200135
08;2020-12-04;0;1;1;626.575909335673;526.358467843651;79;1152.93437717932
08;2020-12-04;0;0;0;205.018522985054;140.993639349697;89;346.012162334751
08;2020-12-04;0;0;0;50.0325684687745;20.62259870351;90;70.6551671722846
08;2020-12-04;2;8;10;18551.3174743414;16782.6825256586;0;35334
11;2020-12-04;38;55;98;783071;811785;09;1594856
11;2020-12-04;107;109;219;761456;784653;19;1546109
11;2020-12-04;215;164;382;850145;801772;29;1651917
11;2020-12-04;206;195;405;914360;843488;39;1757848
11;2020-12-04;207;185;392;845609;826202;49;1671811
11;2020-12-04;151;136;289;793566;745070;59;1538636
11;2020-12-04;122;103;230;628649;549192;69;1177841
11;2020-12-04;64;69;133;434606;358356;79;792962
11;2020-12-04;61;38;99;261425;162933;89;424358
11;2020-12-04;33;15;48;89253;32619;90;121872
11;2020-12-04;1204;1070;2296;6362140;5916070;0;12278210
24;2020-12-04;7;5;12;139720;144686;09;284406
24;2020-12-04;36;27;63;152979;161185;19;314164
24;2020-12-04;33;25;58;122237;126536;29;248773
24;2020-12-04;37;20;57;150359;142009;39;292368
24;2020-12-04;40;26;66;161829;158758;49;320587
24;2020-12-04;34;19;53;172552;168011;59;340563
24;2020-12-04;18;23;41;172509;158177;69;330686
24;2020-12-04;16;12;28;129428;110593;79;240021
24;2020-12-04;18;10;28;87342;56882;89;144224
24;2020-12-04;12;8;20;31210;12071;90;43281
24;2020-12-04;252;176;428;1320165;1238908;0;2559073
27;2020-12-04;17;17;34;143373;149679;09;293052
27;2020-12-04;59;58;117;160962;173003;19;333965
27;2020-12-04;58;48;106;133746;142254;29;276000
27;2020-12-04;61;43;104;160004;155407;39;315411
27;2020-12-04;70;51;121;172333;169564;49;341897
27;2020-12-04;69;44;113;189979;183788;59;373767
27;2020-12-04;60;36;96;192591;178206;69;370797
27;2020-12-04;32;28;60;146876;127546;79;274422
27;2020-12-04;43;26;69;96896;61575;89;158471
27;2020-12-04;64;28;92;33148;12109;90;45257
27;2020-12-04;533;379;912;1429908;1353131;0;2783039
28;2020-12-04;10;9;21;180735;186856;09;367591
28;2020-12-04;40;24;65;200125;213621;19;413746
28;2020-12-04;34;24;58;168922;173007;29;341929
28;2020-12-04;26;25;51;196628;188487;39;385115
28;2020-12-04;39;30;69;205396;201699;49;407095
28;2020-12-04;24;30;54;222002;213866;59;435868
28;2020-12-04;17;22;39;224688;203758;69;428446
28;2020-12-04;17;12;29;163192;135543;79;298735
28;2020-12-04;21;8;29;109691;65377;89;175068
28;2020-12-04;12;5;17;37222;12685;90;49907
28;2020-12-04;240;189;432;1708601;1594899;0;3303500
32;2020-12-04;16;24;40;358062;373689;09;731751
32;2020-12-04;73;72;145;387045;406742;19;793787
32;2020-12-04;98;77;175;342304;348587;29;690891
32;2020-12-04;94;79;173;382485;369972;39;752457
32;2020-12-04;78;72;150;382510;376716;49;759226
32;2020-12-04;85;73;158;386937;376527;59;763464
32;2020-12-04;52;46;98;371211;330938;69;702149
32;2020-12-04;47;43;90;250542;201459;79;452001
32;2020-12-04;40;26;66;163399;89786;89;253185
32;2020-12-04;60;10;70;48384;15367;90;63751
32;2020-12-04;643;522;1165;3072879;2889783;0;5962662
44;2020-12-04;25;21;47;291525;306839;09;598364
44;2020-12-04;83;85;168;320255;339504;19;659759
44;2020-12-04;98;67;165;302020;314428;29;616448
44;2020-12-04;114;77;191;342222;333292;39;675514
44;2020-12-04;109;85;194;349727;344491;49;694218
44;2020-12-04;115;101;217;381371;373239;59;754610
44;2020-12-04;91;68;159;367165;335850;69;703015
44;2020-12-04;52;52;104;250387;215436;79;465823
44;2020-12-04;74;46;121;170825;105192;89;276017
44;2020-12-04;45;14;59;51248;16731;90;67979
44;2020-12-04;806;616;1425;2826745;2685002;0;5511747
52;2020-12-04;2;8;11;213594;223900;09;437494
52;2020-12-04;20;25;46;240818;255197;19;496015
52;2020-12-04;43;29;72;197010;200630;29;397640
52;2020-12-04;41;27;68;231204;224885;39;456089
52;2020-12-04;37;34;71;243874;243418;49;487292
52;2020-12-04;50;29;79;244100;239116;59;483216
52;2020-12-04;19;26;45;241796;221345;69;463141
52;2020-12-04;21;13;35;177805;149903;79;327708
52;2020-12-04;21;13;34;119561;75822;89;195383
52;2020-12-04;23;14;37;42559;15260;90;57819
52;2020-12-04;277;218;498;1952321;1849476;0;3801797
53;2020-12-04;7;4;11;173813;182358;09;356171
53;2020-12-04;16;14;30;202720;214740;19;417460
53;2020-12-04;16;9;25;163116;173196;29;336312
53;2020-12-04;11;8;19;190526;187674;39;378200
53;2020-12-04;18;17;36;212098;212015;49;424113
53;2020-12-04;15;18;33;223699;219176;59;442875
53;2020-12-04;13;6;19;227435;209274;69;436709
53;2020-12-04;9;4;13;169992;140910;79;310902
53;2020-12-04;16;5;21;118117;69883;89;188000
53;2020-12-04;16;5;21;37370;12267;90;49637
53;2020-12-04;137;90;228;1718886;1621493;0;3340379
75;2020-12-04;18;15;33;293104;305291;09;598395
75;2020-12-04;49;51;102;337141;357785;19;694926
75;2020-12-04;51;41;92;295024;300618;29;595642
75;2020-12-04;75;41;116;347871;331233;39;679104
75;2020-12-04;68;53;121;384742;372771;49;757513
75;2020-12-04;66;59;125;413361;390880;59;804241
75;2020-12-04;46;35;81;425623;384060;69;809683
75;2020-12-04;28;26;54;325086;276298;79;601384
75;2020-12-04;44;33;77;213986;139308;89;353294
75;2020-12-04;35;13;48;77600;28200;90;105800
75;2020-12-04;480;367;849;3113538;2886444;0;5999982
76;2020-12-04;12;7;20;305956;318589;09;624545
76;2020-12-04;64;48;116;338942;356969;19;695911
76;2020-12-04;66;44;110;316210;319570;29;635780
76;2020-12-04;63;46;109;356758;337587;39;694345
76;2020-12-04;63;46;109;376541;363812;49;740353
76;2020-12-04;66;35;101;402608;383750;59;786358
76;2020-12-04;49;46;95;394889;358997;69;753886
76;2020-12-04;36;27;63;308664;263806;79;572470
76;2020-12-04;35;16;51;195838;129272;89;325110
76;2020-12-04;28;11;39;69372;26728;90;96100
76;2020-12-04;482;326;813;3065778;2859080;0;5924858
84;2020-12-04;40;45;86;459549;481088;09;940637
84;2020-12-04;151;140;293;487711;511905;19;999616
84;2020-12-04;160;164;325;443824;451094;29;894918
84;2020-12-04;160;135;295;512522;493262;39;1005784
84;2020-12-04;168;125;293;520248;515106;49;1035354
84;2020-12-04;188;126;314;529611;514848;59;1044459
84;2020-12-04;122;111;233;486720;439940;69;926660
84;2020-12-04;83;65;148;372151;315211;79;687362
84;2020-12-04;113;71;184;237198;150524;89;387722
84;2020-12-04;87;25;112;81185;28680;90;109865
84;2020-12-04;1272;1007;2283;4130719;3901658;0;8032377
93;2020-12-04;22;22;44;268834;283093;09;551927
93;2020-12-04;60;68;129;280751;296087;19;576838
93;2020-12-04;79;39;118;254404;255552;29;509956
93;2020-12-04;89;64;153;310704;288398;39;599102
93;2020-12-04;87;67;154;325559;305827;49;631386
93;2020-12-04;81;66;148;353104;325389;59;678493
93;2020-12-04;47;41;89;336327;296459;69;632786
93;2020-12-04;32;30;62;279820;229699;79;509519
93;2020-12-04;49;28;77;171274;113716;89;284990
93;2020-12-04;47;10;57;58896;21758;90;80654
93;2020-12-04;594;435;1032;2639673;2415978;0;5055651
94;2020-12-04;1;0;1;16311;17433;09;33744
94;2020-12-04;1;0;1;16679;18132;19;34811
94;2020-12-04;0;3;3;16782;16579;29;33361
94;2020-12-04;1;1;2;23044;20580;39;43624
94;2020-12-04;2;2;4;23065;22140;49;45205
94;2020-12-04;2;1;3;24549;23421;59;47970
94;2020-12-04;0;0;0;23212;21883;69;45095
94;2020-12-04;1;1;2;19544;17141;79;36685
94;2020-12-04;7;0;7;11227;8178;89;19405
94;2020-12-04;2;5;7;3332;1447;90;4779
94;2020-12-04;17;13;30;177745;166934;0;344679
01;2020-12-05;0;0;0;19979;20155;09;40134
01;2020-12-05;0;0;0;24994;25489;19;50483
01;2020-12-05;0;1;1;17868;16690;29;34558
01;2020-12-05;0;0;0;22328;14821;39;37149
01;2020-12-05;0;0;0;28652;20276;49;48928
01;2020-12-05;0;0;0;33264;27260;59;60524
01;2020-12-05;0;0;0;27135;23978;69;51113
01;2020-12-05;0;0;0;18401;14661;79;33062
01;2020-12-05;0;0;0;9633;6375;89;16008
01;2020-12-05;0;0;0;3410;1510;90;4920
01;2020-12-05;0;1;1;205664;171215;0;376879
02;2020-12-05;0;0;0;16881;17110;09;33991
02;2020-12-05;0;0;0;21410;21604;19;43014
02;2020-12-05;0;0;0;16017;15479;29;31496
02;2020-12-05;0;0;0;19825;14455;39;34280
02;2020-12-05;0;0;0;24719;18248;49;42967
02;2020-12-05;1;0;1;34361;28310;59;62671
02;2020-12-05;0;0;0;28061;24495;69;52556
02;2020-12-05;0;0;0;18231;15278;79;33509
02;2020-12-05;0;0;0;11090;7677;89;18767
02;2020-12-05;0;0;0;3992;1506;90;5498
02;2020-12-05;1;0;1;194587;164162;0;358749
03;2020-12-05;1;0;2;31123;30920;09;62043
03;2020-12-05;2;2;4;29370;29268;19;58638
03;2020-12-05;4;5;9;21458;18963;29;40421
03;2020-12-05;4;6;10;21276;18326;39;39602
03;2020-12-05;0;5;5;18164;16593;49;34757
03;2020-12-05;0;1;1;13469;13557;59;27026
03;2020-12-05;2;2;4;8776;8670;69;17446
03;2020-12-05;0;0;0;3777;3591;79;7368
03;2020-12-05;0;0;0;1649;1072;89;2721
03;2020-12-05;0;0;0;485;184;90;669
03;2020-12-05;13;21;35;149547;141144;0;290691
04;2020-12-05;0;0;0;60314;61377;09;121691
04;2020-12-05;1;1;2;66065;68387;19;134452
04;2020-12-05;2;3;5;51059;47156;29;98215
04;2020-12-05;2;0;2;58788;45780;39;104568
04;2020-12-05;0;0;0;61408;52207;49;113615
04;2020-12-05;0;0;0;64838;60759;59;125597
04;2020-12-05;1;0;1;47008;42843;69;89851
04;2020-12-05;0;0;0;25509;21184;79;46693
04;2020-12-05;0;1;1;13168;7647;89;20815
04;2020-12-05;0;0;0;3209;1253;90;4462
04;2020-12-05;6;5;11;451366;408593;0;859959
05;2020-12-05;0;0;0;362.366008612902;341.338819562748;09;703.704828175651
05;2020-12-05;0;0;0;353.376145114279;370.349735405642;19;723.725880519921
05;2020-12-05;0;0;0;218.593559489256;256.539602589476;29;475.133162078732
05;2020-12-05;0;0;0;404.225408693299;360.321910454353;39;764.547319147651
05;2020-12-05;0;0;0;520.067953604221;497.108383964256;49;1017.17633756848
05;2020-12-05;0;0;0;468.146063921917;510.087601910415;59;978.233665832332
05;2020-12-05;0;0;0;340.368470050554;334.366842191253;69;674.735312241807
05;2020-12-05;0;0;0;212.598666888387;192.597753227106;79;405.196420115493
05;2020-12-05;0;0;0;148.727797095705;61.8681715431829;89;210.595968638888
05;2020-12-05;0;0;0;32.9601271090696;10.9909785719784;90;43.9511056810479
05;2020-12-05;0;0;0;3061.43020057959;2935.56979942041;0;5997
06;2020-12-05;0;0;0;42583;42380;09;84963
06;2020-12-05;1;2;3;33369;31925;19;65294
06;2020-12-05;1;0;1;21571;15080;29;36651
06;2020-12-05;1;0;1;21550;16147;39;37697
06;2020-12-05;0;2;2;14193;13939;49;28132
06;2020-12-05;0;0;0;7171;7597;59;14768
06;2020-12-05;0;1;1;3629;4117;69;7746
06;2020-12-05;0;0;0;1577;1457;79;3034
06;2020-12-05;0;0;0;531;474;89;1005
06;2020-12-05;0;0;0;88;93;90;181
06;2020-12-05;3;5;8;146262;133209;0;279471
07;2020-12-05;0;0;0;485;549;09;1034
07;2020-12-05;0;0;0;403;432;19;835
07;2020-12-05;1;0;1;764;841;29;1605
07;2020-12-05;0;0;0;824;928;39;1752
07;2020-12-05;0;0;0;788;1020;49;1808
07;2020-12-05;0;0;0;678;870;59;1548
07;2020-12-05;0;0;0;360;382;69;742
07;2020-12-05;0;1;1;231;190;79;421
07;2020-12-05;0;0;0;114;67;89;181
07;2020-12-05;0;0;0;24;11;90;35
07;2020-12-05;1;1;2;4671;5290;0;9961
08;2020-12-05;0;0;0;2715.22592983026;2997.75551488675;09;5712.98144471701
08;2020-12-05;0;0;0;2778.51901080978;3160.9156459093;19;5939.43465671908
08;2020-12-05;1;1;2;2080.8882988764;1718.16634315323;29;3799.05464202964
08;2020-12-05;0;0;0;2701.8582062647;1896.52641413317;39;4598.38462039786
08;2020-12-05;1;3;4;3151.45861023308;2460.52498233809;49;5611.98359257117
08;2020-12-05;0;1;1;2620.29868333099;2422.23566154656;59;5042.53434487755
08;2020-12-05;0;0;0;1621.44173420671;1438.58325779464;69;3060.02499200135
08;2020-12-05;0;0;0;626.575909335673;526.358467843651;79;1152.93437717932
08;2020-12-05;0;0;0;205.018522985054;140.993639349697;89;346.012162334751
08;2020-12-05;0;0;0;50.0325684687745;20.62259870351;90;70.6551671722846
08;2020-12-05;2;5;7;18551.3174743414;16782.6825256586;0;35334
11;2020-12-05;17;21;39;783071;811785;09;1594856
11;2020-12-05;79;80;160;761456;784653;19;1546109
11;2020-12-05;110;100;211;850145;801772;29;1651917
11;2020-12-05;102;114;217;914360;843488;39;1757848
11;2020-12-05;109;97;206;845609;826202;49;1671811
11;2020-12-05;111;82;193;793566;745070;59;1538636
11;2020-12-05;58;55;115;628649;549192;69;1177841
11;2020-12-05;38;35;73;434606;358356;79;792962
11;2020-12-05;19;24;43;261425;162933;89;424358
11;2020-12-05;10;4;14;89253;32619;90;121872
11;2020-12-05;653;612;1271;6362140;5916070;0;12278210
24;2020-12-05;3;6;9;139720;144686;09;284406
24;2020-12-05;17;18;35;152979;161185;19;314164
24;2020-12-05;23;12;35;122237;126536;29;248773
24;2020-12-05;19;10;29;150359;142009;39;292368
24;2020-12-05;26;11;37;161829;158758;49;320587
24;2020-12-05;21;19;40;172552;168011;59;340563
24;2020-12-05;10;4;14;172509;158177;69;330686
24;2020-12-05;5;12;17;129428;110593;79;240021
24;2020-12-05;13;10;23;87342;56882;89;144224
24;2020-12-05;17;8;25;31210;12071;90;43281
24;2020-12-05;154;110;264;1320165;1238908;0;2559073
27;2020-12-05;10;14;24;143373;149679;09;293052
27;2020-12-05;18;23;41;160962;173003;19;333965
27;2020-12-05;27;21;48;133746;142254;29;276000
27;2020-12-05;32;25;57;160004;155407;39;315411
27;2020-12-05;46;27;73;172333;169564;49;341897
27;2020-12-05;42;35;77;189979;183788;59;373767
27;2020-12-05;30;25;55;192591;178206;69;370797
27;2020-12-05;21;21;42;146876;127546;79;274422
27;2020-12-05;26;20;46;96896;61575;89;158471
27;2020-12-05;29;6;35;33148;12109;90;45257
27;2020-12-05;281;217;498;1429908;1353131;0;2783039
28;2020-12-05;3;2;5;180735;186856;09;367591
28;2020-12-05;11;11;25;200125;213621;19;413746
28;2020-12-05;19;11;30;168922;173007;29;341929
28;2020-12-05;12;15;27;196628;188487;39;385115
28;2020-12-05;20;12;32;205396;201699;49;407095
28;2020-12-05;9;10;19;222002;213866;59;435868
28;2020-12-05;11;8;19;224688;203758;69;428446
28;2020-12-05;12;12;24;163192;135543;79;298735
28;2020-12-05;11;6;17;109691;65377;89;175068
28;2020-12-05;11;1;12;37222;12685;90;49907
28;2020-12-05;119;88;210;1708601;1594899;0;3303500
32;2020-12-05;17;13;31;358062;373689;09;731751
32;2020-12-05;30;21;51;387045;406742;19;793787
32;2020-12-05;44;42;86;342304;348587;29;690891
32;2020-12-05;50;43;93;382485;369972;39;752457
32;2020-12-05;52;46;98;382510;376716;49;759226
32;2020-12-05;44;47;91;386937;376527;59;763464
32;2020-12-05;34;28;62;371211;330938;69;702149
32;2020-12-05;21;16;37;250542;201459;79;452001
32;2020-12-05;26;14;40;163399;89786;89;253185
32;2020-12-05;17;4;21;48384;15367;90;63751
32;2020-12-05;335;274;610;3072879;2889783;0;5962662
44;2020-12-05;12;18;30;291525;306839;09;598364
44;2020-12-05;37;43;80;320255;339504;19;659759
44;2020-12-05;56;48;104;302020;314428;29;616448
44;2020-12-05;67;54;121;342222;333292;39;675514
44;2020-12-05;53;48;101;349727;344491;49;694218
44;2020-12-05;67;56;123;381371;373239;59;754610
44;2020-12-05;44;35;79;367165;335850;69;703015
44;2020-12-05;41;27;68;250387;215436;79;465823
44;2020-12-05;42;24;66;170825;105192;89;276017
44;2020-12-05;21;5;26;51248;16731;90;67979
44;2020-12-05;440;358;798;2826745;2685002;0;5511747
52;2020-12-05;3;7;10;213594;223900;09;437494
52;2020-12-05;18;16;37;240818;255197;19;496015
52;2020-12-05;29;24;53;197010;200630;29;397640
52;2020-12-05;29;18;48;231204;224885;39;456089
52;2020-12-05;16;19;35;243874;243418;49;487292
52;2020-12-05;28;11;39;244100;239116;59;483216
52;2020-12-05;10;11;21;241796;221345;69;463141
52;2020-12-05;7;12;19;177805;149903;79;327708
52;2020-12-05;16;7;23;119561;75822;89;195383
52;2020-12-05;10;4;14;42559;15260;90;57819
52;2020-12-05;166;129;299;1952321;1849476;0;3801797
53;2020-12-05;5;6;15;173813;182358;09;356171
53;2020-12-05;15;14;29;202720;214740;19;417460
53;2020-12-05;10;16;26;163116;173196;29;336312
53;2020-12-05;19;13;32;190526;187674;39;378200
53;2020-12-05;13;6;19;212098;212015;49;424113
53;2020-12-05;14;11;25;223699;219176;59;442875
53;2020-12-05;7;6;13;227435;209274;69;436709
53;2020-12-05;3;5;8;169992;140910;79;310902
53;2020-12-05;10;4;14;118117;69883;89;188000
53;2020-12-05;1;0;1;37370;12267;90;49637
53;2020-12-05;97;81;183;1718886;1621493;0;3340379
75;2020-12-05;7;8;15;293104;305291;09;598395
75;2020-12-05;24;22;47;337141;357785;19;694926
75;2020-12-05;27;32;59;295024;300618;29;595642
75;2020-12-05;36;18;54;347871;331233;39;679104
75;2020-12-05;36;18;54;384742;372771;49;757513
75;2020-12-05;31;22;53;413361;390880;59;804241
75;2020-12-05;21;18;39;425623;384060;69;809683
75;2020-12-05;14;10;24;325086;276298;79;601384
75;2020-12-05;20;13;33;213986;139308;89;353294
75;2020-12-05;12;3;15;77600;28200;90;105800
75;2020-12-05;229;164;394;3113538;2886444;0;5999982
76;2020-12-05;2;6;8;305956;318589;09;624545
76;2020-12-05;24;15;39;338942;356969;19;695911
76;2020-12-05;37;21;58;316210;319570;29;635780
76;2020-12-05;33;25;58;356758;337587;39;694345
76;2020-12-05;31;26;57;376541;363812;49;740353
76;2020-12-05;26;21;47;402608;383750;59;786358
76;2020-12-05;14;18;32;394889;358997;69;753886
76;2020-12-05;15;12;27;308664;263806;79;572470
76;2020-12-05;24;11;35;195838;129272;89;325110
76;2020-12-05;9;1;10;69372;26728;90;96100
76;2020-12-05;215;156;371;3065778;2859080;0;5924858
84;2020-12-05;15;22;37;459549;481088;09;940637
84;2020-12-05;82;53;136;487711;511905;19;999616
84;2020-12-05;79;59;138;443824;451094;29;894918
84;2020-12-05;79;66;145;512522;493262;39;1005784
84;2020-12-05;103;69;172;520248;515106;49;1035354
84;2020-12-05;68;77;145;529611;514848;59;1044459
84;2020-12-05;48;51;99;486720;439940;69;926660
84;2020-12-05;33;23;56;372151;315211;79;687362
84;2020-12-05;41;30;71;237198;150524;89;387722
84;2020-12-05;25;12;37;81185;28680;90;109865
84;2020-12-05;573;462;1036;4130719;3901658;0;8032377
93;2020-12-05;10;99;109;268834;283093;09;551927
93;2020-12-05;30;32;62;280751;296087;19;576838
93;2020-12-05;34;23;57;254404;255552;29;509956
93;2020-12-05;42;27;69;310704;288398;39;599102
93;2020-12-05;43;20;63;325559;305827;49;631386
93;2020-12-05;49;35;84;353104;325389;59;678493
93;2020-12-05;27;20;47;336327;296459;69;632786
93;2020-12-05;11;10;21;279820;229699;79;509519
93;2020-12-05;21;12;33;171274;113716;89;284990
93;2020-12-05;13;8;21;58896;21758;90;80654
93;2020-12-05;280;286;566;2639673;2415978;0;5055651
94;2020-12-05;0;0;0;16311;17433;09;33744
94;2020-12-05;0;1;1;16679;18132;19;34811
94;2020-12-05;0;0;0;16782;16579;29;33361
94;2020-12-05;1;1;2;23044;20580;39;43624
94;2020-12-05;1;0;1;23065;22140;49;45205
94;2020-12-05;0;0;0;24549;23421;59;47970
94;2020-12-05;1;0;1;23212;21883;69;45095
94;2020-12-05;0;0;0;19544;17141;79;36685
94;2020-12-05;0;0;0;11227;8178;89;19405
94;2020-12-05;0;0;0;3332;1447;90;4779
94;2020-12-05;3;2;5;177745;166934;0;344679
01;2020-12-06;0;0;0;19979;20155;09;40134
01;2020-12-06;1;0;1;24994;25489;19;50483
01;2020-12-06;0;0;0;17868;16690;29;34558
01;2020-12-06;1;1;2;22328;14821;39;37149
01;2020-12-06;0;0;0;28652;20276;49;48928
01;2020-12-06;0;1;1;33264;27260;59;60524
01;2020-12-06;1;0;1;27135;23978;69;51113
01;2020-12-06;0;1;1;18401;14661;79;33062
01;2020-12-06;0;0;0;9633;6375;89;16008
01;2020-12-06;0;0;0;3410;1510;90;4920
01;2020-12-06;3;3;6;205664;171215;0;376879
02;2020-12-06;0;0;0;16881;17110;09;33991
02;2020-12-06;0;0;0;21410;21604;19;43014
02;2020-12-06;0;0;0;16017;15479;29;31496
02;2020-12-06;0;0;0;19825;14455;39;34280
02;2020-12-06;0;0;0;24719;18248;49;42967
02;2020-12-06;1;1;2;34361;28310;59;62671
02;2020-12-06;0;0;0;28061;24495;69;52556
02;2020-12-06;0;0;0;18231;15278;79;33509
02;2020-12-06;0;0;0;11090;7677;89;18767
02;2020-12-06;0;0;0;3992;1506;90;5498
02;2020-12-06;1;1;2;194587;164162;0;358749
03;2020-12-06;0;0;0;31123;30920;09;62043
03;2020-12-06;0;0;0;29370;29268;19;58638
03;2020-12-06;2;0;2;21458;18963;29;40421
03;2020-12-06;0;0;0;21276;18326;39;39602
03;2020-12-06;0;0;0;18164;16593;49;34757
03;2020-12-06;0;0;0;13469;13557;59;27026
03;2020-12-06;0;1;1;8776;8670;69;17446
03;2020-12-06;0;0;0;3777;3591;79;7368
03;2020-12-06;0;0;0;1649;1072;89;2721
03;2020-12-06;0;0;0;485;184;90;669
03;2020-12-06;2;1;3;149547;141144;0;290691
04;2020-12-06;0;0;0;60314;61377;09;121691
04;2020-12-06;1;0;1;66065;68387;19;134452
04;2020-12-06;3;1;4;51059;47156;29;98215
04;2020-12-06;0;0;0;58788;45780;39;104568
04;2020-12-06;0;0;0;61408;52207;49;113615
04;2020-12-06;1;0;1;64838;60759;59;125597
04;2020-12-06;0;1;1;47008;42843;69;89851
04;2020-12-06;1;0;1;25509;21184;79;46693
04;2020-12-06;0;0;0;13168;7647;89;20815
04;2020-12-06;0;0;0;3209;1253;90;4462
04;2020-12-06;6;2;8;451366;408593;0;859959
05;2020-12-06;0;0;0;362.366008612902;341.338819562748;09;703.704828175651
05;2020-12-06;0;0;0;353.376145114279;370.349735405642;19;723.725880519921
05;2020-12-06;0;0;0;218.593559489256;256.539602589476;29;475.133162078732
05;2020-12-06;0;0;0;404.225408693299;360.321910454353;39;764.547319147651
05;2020-12-06;0;0;0;520.067953604221;497.108383964256;49;1017.17633756848
05;2020-12-06;0;0;0;468.146063921917;510.087601910415;59;978.233665832332
05;2020-12-06;0;0;0;340.368470050554;334.366842191253;69;674.735312241807
05;2020-12-06;0;0;0;212.598666888387;192.597753227106;79;405.196420115493
05;2020-12-06;0;0;0;148.727797095705;61.8681715431829;89;210.595968638888
05;2020-12-06;0;0;0;32.9601271090696;10.9909785719784;90;43.9511056810479
05;2020-12-06;0;0;0;3061.43020057959;2935.56979942041;0;5997
06;2020-12-06;0;0;0;42583;42380;09;84963
06;2020-12-06;0;0;0;33369;31925;19;65294
06;2020-12-06;0;0;0;21571;15080;29;36651
06;2020-12-06;0;0;0;21550;16147;39;37697
06;2020-12-06;0;1;1;14193;13939;49;28132
06;2020-12-06;0;0;0;7171;7597;59;14768
06;2020-12-06;0;1;1;3629;4117;69;7746
06;2020-12-06;0;1;1;1577;1457;79;3034
06;2020-12-06;0;0;0;531;474;89;1005
06;2020-12-06;0;0;0;88;93;90;181
06;2020-12-06;0;3;3;146262;133209;0;279471
07;2020-12-06;0;0;0;485;549;09;1034
07;2020-12-06;0;0;0;403;432;19;835
07;2020-12-06;0;0;0;764;841;29;1605
07;2020-12-06;0;0;0;824;928;39;1752
07;2020-12-06;0;0;0;788;1020;49;1808
07;2020-12-06;0;0;0;678;870;59;1548
07;2020-12-06;0;0;0;360;382;69;742
07;2020-12-06;0;0;0;231;190;79;421
07;2020-12-06;0;0;0;114;67;89;181
07;2020-12-06;0;0;0;24;11;90;35
07;2020-12-06;0;0;0;4671;5290;0;9961
08;2020-12-06;0;0;0;2715.22592983026;2997.75551488675;09;5712.98144471701
08;2020-12-06;0;0;0;2778.51901080978;3160.9156459093;19;5939.43465671908
08;2020-12-06;0;0;0;2080.8882988764;1718.16634315323;29;3799.05464202964
08;2020-12-06;0;0;0;2701.8582062647;1896.52641413317;39;4598.38462039786
08;2020-12-06;0;0;0;3151.45861023308;2460.52498233809;49;5611.98359257117
08;2020-12-06;0;0;0;2620.29868333099;2422.23566154656;59;5042.53434487755
08;2020-12-06;0;0;0;1621.44173420671;1438.58325779464;69;3060.02499200135
08;2020-12-06;0;0;0;626.575909335673;526.358467843651;79;1152.93437717932
08;2020-12-06;0;0;0;205.018522985054;140.993639349697;89;346.012162334751
08;2020-12-06;0;0;0;50.0325684687745;20.62259870351;90;70.6551671722846
08;2020-12-06;0;0;0;18551.3174743414;16782.6825256586;0;35334
11;2020-12-06;5;5;10;783071;811785;09;1594856
11;2020-12-06;12;11;23;761456;784653;19;1546109
11;2020-12-06;30;10;40;850145;801772;29;1651917
11;2020-12-06;34;36;70;914360;843488;39;1757848
11;2020-12-06;21;21;42;845609;826202;49;1671811
11;2020-12-06;18;23;41;793566;745070;59;1538636
11;2020-12-06;15;14;29;628649;549192;69;1177841
11;2020-12-06;16;11;27;434606;358356;79;792962
11;2020-12-06;13;11;24;261425;162933;89;424358
11;2020-12-06;9;3;12;89253;32619;90;121872
11;2020-12-06;173;145;318;6362140;5916070;0;12278210
24;2020-12-06;0;0;0;139720;144686;09;284406
24;2020-12-06;3;9;12;152979;161185;19;314164
24;2020-12-06;2;2;4;122237;126536;29;248773
24;2020-12-06;7;2;9;150359;142009;39;292368
24;2020-12-06;5;3;8;161829;158758;49;320587
24;2020-12-06;3;3;6;172552;168011;59;340563
24;2020-12-06;6;3;9;172509;158177;69;330686
24;2020-12-06;2;6;8;129428;110593;79;240021
24;2020-12-06;7;4;11;87342;56882;89;144224
24;2020-12-06;2;4;6;31210;12071;90;43281
24;2020-12-06;37;36;73;1320165;1238908;0;2559073
27;2020-12-06;1;3;4;143373;149679;09;293052
27;2020-12-06;3;3;6;160962;173003;19;333965
27;2020-12-06;6;5;11;133746;142254;29;276000
27;2020-12-06;7;7;14;160004;155407;39;315411
27;2020-12-06;5;7;12;172333;169564;49;341897
27;2020-12-06;6;3;9;189979;183788;59;373767
27;2020-12-06;2;5;7;192591;178206;69;370797
27;2020-12-06;5;8;13;146876;127546;79;274422
27;2020-12-06;15;8;23;96896;61575;89;158471
27;2020-12-06;5;3;8;33148;12109;90;45257
27;2020-12-06;55;52;107;1429908;1353131;0;2783039
28;2020-12-06;2;1;3;180735;186856;09;367591
28;2020-12-06;5;1;6;200125;213621;19;413746
28;2020-12-06;10;5;15;168922;173007;29;341929
28;2020-12-06;7;0;7;196628;188487;39;385115
28;2020-12-06;6;2;8;205396;201699;49;407095
28;2020-12-06;12;3;15;222002;213866;59;435868
28;2020-12-06;8;6;14;224688;203758;69;428446
28;2020-12-06;9;4;13;163192;135543;79;298735
28;2020-12-06;18;2;20;109691;65377;89;175068
28;2020-12-06;18;5;23;37222;12685;90;49907
28;2020-12-06;95;29;124;1708601;1594899;0;3303500
32;2020-12-06;2;3;5;358062;373689;09;731751
32;2020-12-06;11;13;24;387045;406742;19;793787
32;2020-12-06;16;14;30;342304;348587;29;690891
32;2020-12-06;11;10;21;382485;369972;39;752457
32;2020-12-06;15;10;25;382510;376716;49;759226
32;2020-12-06;10;7;17;386937;376527;59;763464
32;2020-12-06;10;13;24;371211;330938;69;702149
32;2020-12-06;12;10;22;250542;201459;79;452001
32;2020-12-06;30;6;36;163399;89786;89;253185
32;2020-12-06;17;4;21;48384;15367;90;63751
32;2020-12-06;134;90;225;3072879;2889783;0;5962662
44;2020-12-06;2;2;4;291525;306839;09;598364
44;2020-12-06;7;2;9;320255;339504;19;659759
44;2020-12-06;12;8;20;302020;314428;29;616448
44;2020-12-06;12;8;20;342222;333292;39;675514
44;2020-12-06;10;7;17;349727;344491;49;694218
44;2020-12-06;15;6;21;381371;373239;59;754610
44;2020-12-06;5;10;15;367165;335850;69;703015
44;2020-12-06;9;12;21;250387;215436;79;465823
44;2020-12-06;11;13;24;170825;105192;89;276017
44;2020-12-06;7;7;14;51248;16731;90;67979
44;2020-12-06;90;75;165;2826745;2685002;0;5511747
52;2020-12-06;1;2;3;213594;223900;09;437494
52;2020-12-06;0;5;5;240818;255197;19;496015
52;2020-12-06;5;5;10;197010;200630;29;397640
52;2020-12-06;11;7;18;231204;224885;39;456089
52;2020-12-06;6;10;16;243874;243418;49;487292
52;2020-12-06;7;7;14;244100;239116;59;483216
52;2020-12-06;2;4;6;241796;221345;69;463141
52;2020-12-06;2;2;4;177805;149903;79;327708
52;2020-12-06;6;3;9;119561;75822;89;195383
52;2020-12-06;6;0;6;42559;15260;90;57819
52;2020-12-06;46;45;91;1952321;1849476;0;3801797
53;2020-12-06;1;1;2;173813;182358;09;356171
53;2020-12-06;1;1;2;202720;214740;19;417460
53;2020-12-06;0;0;0;163116;173196;29;336312
53;2020-12-06;3;2;5;190526;187674;39;378200
53;2020-12-06;1;2;3;212098;212015;49;424113
53;2020-12-06;1;1;2;223699;219176;59;442875
53;2020-12-06;0;0;0;227435;209274;69;436709
53;2020-12-06;0;1;1;169992;140910;79;310902
53;2020-12-06;3;3;6;118117;69883;89;188000
53;2020-12-06;0;1;1;37370;12267;90;49637
53;2020-12-06;10;12;22;1718886;1621493;0;3340379
75;2020-12-06;1;1;2;293104;305291;09;598395
75;2020-12-06;7;1;8;337141;357785;19;694926
75;2020-12-06;11;6;17;295024;300618;29;595642
75;2020-12-06;9;2;11;347871;331233;39;679104
75;2020-12-06;10;4;14;384742;372771;49;757513
75;2020-12-06;6;1;7;413361;390880;59;804241
75;2020-12-06;4;8;12;425623;384060;69;809683
75;2020-12-06;3;4;7;325086;276298;79;601384
75;2020-12-06;16;8;24;213986;139308;89;353294
75;2020-12-06;9;6;15;77600;28200;90;105800
75;2020-12-06;76;41;117;3113538;2886444;0;5999982
76;2020-12-06;0;1;1;305956;318589;09;624545
76;2020-12-06;3;4;7;338942;356969;19;695911
76;2020-12-06;10;7;17;316210;319570;29;635780
76;2020-12-06;13;7;20;356758;337587;39;694345
76;2020-12-06;7;6;13;376541;363812;49;740353
76;2020-12-06;9;5;14;402608;383750;59;786358
76;2020-12-06;1;3;4;394889;358997;69;753886
76;2020-12-06;4;5;9;308664;263806;79;572470
76;2020-12-06;4;6;10;195838;129272;89;325110
76;2020-12-06;4;1;5;69372;26728;90;96100
76;2020-12-06;55;45;100;3065778;2859080;0;5924858
84;2020-12-06;1;4;5;459549;481088;09;940637
84;2020-12-06;12;10;22;487711;511905;19;999616
84;2020-12-06;17;11;28;443824;451094;29;894918
84;2020-12-06;13;9;22;512522;493262;39;1005784
84;2020-12-06;16;19;35;520248;515106;49;1035354
84;2020-12-06;13;18;31;529611;514848;59;1044459
84;2020-12-06;10;11;21;486720;439940;69;926660
84;2020-12-06;12;11;23;372151;315211;79;687362
84;2020-12-06;26;15;41;237198;150524;89;387722
84;2020-12-06;21;7;28;81185;28680;90;109865
84;2020-12-06;141;115;256;4130719;3901658;0;8032377
93;2020-12-06;4;2;6;268834;283093;09;551927
93;2020-12-06;3;7;10;280751;296087;19;576838
93;2020-12-06;6;12;18;254404;255552;29;509956
93;2020-12-06;12;13;25;310704;288398;39;599102
93;2020-12-06;6;10;16;325559;305827;49;631386
93;2020-12-06;8;6;14;353104;325389;59;678493
93;2020-12-06;4;9;13;336327;296459;69;632786
93;2020-12-06;4;9;13;279820;229699;79;509519
93;2020-12-06;8;6;14;171274;113716;89;284990
93;2020-12-06;5;4;9;58896;21758;90;80654
93;2020-12-06;60;78;138;2639673;2415978;0;5055651
94;2020-12-06;0;0;0;16311;17433;09;33744
94;2020-12-06;0;0;0;16679;18132;19;34811
94;2020-12-06;0;0;0;16782;16579;29;33361
94;2020-12-06;0;0;0;23044;20580;39;43624
94;2020-12-06;0;0;0;23065;22140;49;45205
94;2020-12-06;1;0;1;24549;23421;59;47970
94;2020-12-06;0;0;0;23212;21883;69;45095
94;2020-12-06;0;0;0;19544;17141;79;36685
94;2020-12-06;0;0;0;11227;8178;89;19405
94;2020-12-06;0;0;0;3332;1447;90;4779
94;2020-12-06;1;0;1;177745;166934;0;344679
01;2020-12-07;0;0;0;19979;20155;09;40134
01;2020-12-07;1;0;1;24994;25489;19;50483
01;2020-12-07;2;0;2;17868;16690;29;34558
01;2020-12-07;0;1;1;22328;14821;39;37149
01;2020-12-07;1;2;3;28652;20276;49;48928
01;2020-12-07;1;1;2;33264;27260;59;60524
01;2020-12-07;0;2;2;27135;23978;69;51113
01;2020-12-07;0;0;0;18401;14661;79;33062
01;2020-12-07;0;0;0;9633;6375;89;16008
01;2020-12-07;0;0;0;3410;1510;90;4920
01;2020-12-07;5;6;11;205664;171215;0;376879
02;2020-12-07;0;0;0;16881;17110;09;33991
02;2020-12-07;1;0;1;21410;21604;19;43014
02;2020-12-07;1;0;1;16017;15479;29;31496
02;2020-12-07;3;3;6;19825;14455;39;34280
02;2020-12-07;1;0;1;24719;18248;49;42967
02;2020-12-07;1;4;5;34361;28310;59;62671
02;2020-12-07;0;0;0;28061;24495;69;52556
02;2020-12-07;2;0;2;18231;15278;79;33509
02;2020-12-07;0;0;0;11090;7677;89;18767
02;2020-12-07;0;0;0;3992;1506;90;5498
02;2020-12-07;9;7;16;194587;164162;0;358749
03;2020-12-07;0;2;2;31123;30920;09;62043
03;2020-12-07;6;4;10;29370;29268;19;58638
03;2020-12-07;6;5;11;21458;18963;29;40421
03;2020-12-07;7;6;13;21276;18326;39;39602
03;2020-12-07;5;1;6;18164;16593;49;34757
03;2020-12-07;2;4;6;13469;13557;59;27026
03;2020-12-07;4;5;9;8776;8670;69;17446
03;2020-12-07;0;0;0;3777;3591;79;7368
03;2020-12-07;0;0;0;1649;1072;89;2721
03;2020-12-07;0;0;0;485;184;90;669
03;2020-12-07;30;27;57;149547;141144;0;290691
04;2020-12-07;1;0;1;60314;61377;09;121691
04;2020-12-07;9;3;12;66065;68387;19;134452
04;2020-12-07;5;4;9;51059;47156;29;98215
04;2020-12-07;3;6;9;58788;45780;39;104568
04;2020-12-07;4;7;11;61408;52207;49;113615
04;2020-12-07;2;5;7;64838;60759;59;125597
04;2020-12-07;2;2;4;47008;42843;69;89851
04;2020-12-07;0;1;1;25509;21184;79;46693
04;2020-12-07;0;1;1;13168;7647;89;20815
04;2020-12-07;0;0;0;3209;1253;90;4462
04;2020-12-07;26;29;55;451366;408593;0;859959
05;2020-12-07;0;0;0;362.366008612902;341.338819562748;09;703.704828175651
05;2020-12-07;0;0;0;353.376145114279;370.349735405642;19;723.725880519921
05;2020-12-07;0;0;0;218.593559489256;256.539602589476;29;475.133162078732
05;2020-12-07;0;0;0;404.225408693299;360.321910454353;39;764.547319147651
05;2020-12-07;0;0;0;520.067953604221;497.108383964256;49;1017.17633756848
05;2020-12-07;0;0;0;468.146063921917;510.087601910415;59;978.233665832332
05;2020-12-07;0;0;0;340.368470050554;334.366842191253;69;674.735312241807
05;2020-12-07;0;0;0;212.598666888387;192.597753227106;79;405.196420115493
05;2020-12-07;0;0;0;148.727797095705;61.8681715431829;89;210.595968638888
05;2020-12-07;0;0;0;32.9601271090696;10.9909785719784;90;43.9511056810479
05;2020-12-07;0;0;0;3061.43020057959;2935.56979942041;0;5997
06;2020-12-07;0;0;0;42583;42380;09;84963
06;2020-12-07;2;3;5;33369;31925;19;65294
06;2020-12-07;3;3;6;21571;15080;29;36651
06;2020-12-07;3;4;7;21550;16147;39;37697
06;2020-12-07;6;4;10;14193;13939;49;28132
06;2020-12-07;1;2;3;7171;7597;59;14768
06;2020-12-07;1;2;3;3629;4117;69;7746
06;2020-12-07;0;0;0;1577;1457;79;3034
06;2020-12-07;2;1;3;531;474;89;1005
06;2020-12-07;1;0;1;88;93;90;181
06;2020-12-07;19;19;38;146262;133209;0;279471
07;2020-12-07;0;0;0;485;549;09;1034
07;2020-12-07;0;0;0;403;432;19;835
07;2020-12-07;0;0;0;764;841;29;1605
07;2020-12-07;0;0;0;824;928;39;1752
07;2020-12-07;0;0;0;788;1020;49;1808
07;2020-12-07;0;0;0;678;870;59;1548
07;2020-12-07;0;0;0;360;382;69;742
07;2020-12-07;0;0;0;231;190;79;421
07;2020-12-07;0;0;0;114;67;89;181
07;2020-12-07;0;0;0;24;11;90;35
07;2020-12-07;0;0;0;4671;5290;0;9961
08;2020-12-07;0;0;0;2715.22592983026;2997.75551488675;09;5712.98144471701
08;2020-12-07;1;1;2;2778.51901080978;3160.9156459093;19;5939.43465671908
08;2020-12-07;4;1;5;2080.8882988764;1718.16634315323;29;3799.05464202964
08;2020-12-07;1;0;1;2701.8582062647;1896.52641413317;39;4598.38462039786
08;2020-12-07;0;0;0;3151.45861023308;2460.52498233809;49;5611.98359257117
08;2020-12-07;1;3;4;2620.29868333099;2422.23566154656;59;5042.53434487755
08;2020-12-07;1;1;2;1621.44173420671;1438.58325779464;69;3060.02499200135
08;2020-12-07;0;0;0;626.575909335673;526.358467843651;79;1152.93437717932
08;2020-12-07;0;0;0;205.018522985054;140.993639349697;89;346.012162334751
08;2020-12-07;0;0;0;50.0325684687745;20.62259870351;90;70.6551671722846
08;2020-12-07;8;6;14;18551.3174743414;16782.6825256586;0;35334
11;2020-12-07;51;34;88;783071;811785;09;1594856
11;2020-12-07;156;167;327;761456;784653;19;1546109
11;2020-12-07;285;233;519;850145;801772;29;1651917
11;2020-12-07;293;241;534;914360;843488;39;1757848
11;2020-12-07;245;202;450;845609;826202;49;1671811
11;2020-12-07;241;182;430;793566;745070;59;1538636
11;2020-12-07;144;136;282;628649;549192;69;1177841
11;2020-12-07;73;91;165;434606;358356;79;792962
11;2020-12-07;83;55;138;261425;162933;89;424358
11;2020-12-07;57;14;71;89253;32619;90;121872
11;2020-12-07;1628;1355;3004;6362140;5916070;0;12278210
24;2020-12-07;3;7;10;139720;144686;09;284406
24;2020-12-07;14;30;44;152979;161185;19;314164
24;2020-12-07;38;27;65;122237;126536;29;248773
24;2020-12-07;51;35;86;150359;142009;39;292368
24;2020-12-07;42;38;80;161829;158758;49;320587
24;2020-12-07;58;32;90;172552;168011;59;340563
24;2020-12-07;25;26;51;172509;158177;69;330686
24;2020-12-07;25;24;49;129428;110593;79;240021
24;2020-12-07;46;20;66;87342;56882;89;144224
24;2020-12-07;39;12;51;31210;12071;90;43281
24;2020-12-07;342;251;593;1320165;1238908;0;2559073
27;2020-12-07;17;17;34;143373;149679;09;293052
27;2020-12-07;63;67;130;160962;173003;19;333965
27;2020-12-07;84;51;135;133746;142254;29;276000
27;2020-12-07;98;63;161;160004;155407;39;315411
27;2020-12-07;95;78;173;172333;169564;49;341897
27;2020-12-07;84;71;155;189979;183788;59;373767
27;2020-12-07;63;55;118;192591;178206;69;370797
27;2020-12-07;40;36;76;146876;127546;79;274422
27;2020-12-07;68;31;99;96896;61575;89;158471
27;2020-12-07;79;17;96;33148;12109;90;45257
27;2020-12-07;691;486;1177;1429908;1353131;0;2783039
28;2020-12-07;6;16;22;180735;186856;09;367591
28;2020-12-07;33;32;65;200125;213621;19;413746
28;2020-12-07;43;35;78;168922;173007;29;341929
28;2020-12-07;44;31;75;196628;188487;39;385115
28;2020-12-07;55;45;100;205396;201699;49;407095
28;2020-12-07;48;38;86;222002;213866;59;435868
28;2020-12-07;29;25;54;224688;203758;69;428446
28;2020-12-07;24;13;37;163192;135543;79;298735
28;2020-12-07;29;10;39;109691;65377;89;175068
28;2020-12-07;24;5;29;37222;12685;90;49907
28;2020-12-07;335;250;585;1708601;1594899;0;3303500
32;2020-12-07;26;40;66;358062;373689;09;731751
32;2020-12-07;80;78;158;387045;406742;19;793787
32;2020-12-07;136;94;230;342304;348587;29;690891
32;2020-12-07;129;99;228;382485;369972;39;752457
32;2020-12-07;104;76;180;382510;376716;49;759226
32;2020-12-07;96;96;192;386937;376527;59;763464
32;2020-12-07;82;70;152;371211;330938;69;702149
32;2020-12-07;56;53;109;250542;201459;79;452001
32;2020-12-07;87;41;128;163399;89786;89;253185
32;2020-12-07;68;20;88;48384;15367;90;63751
32;2020-12-07;864;668;1532;3072879;2889783;0;5962662
44;2020-12-07;41;42;83;291525;306839;09;598364
44;2020-12-07;94;91;187;320255;339504;19;659759
44;2020-12-07;150;126;277;302020;314428;29;616448
44;2020-12-07;175;153;330;342222;333292;39;675514
44;2020-12-07;155;137;293;349727;344491;49;694218
44;2020-12-07;156;138;295;381371;373239;59;754610
44;2020-12-07;83;89;174;367165;335850;69;703015
44;2020-12-07;84;72;158;250387;215436;79;465823
44;2020-12-07;86;47;133;170825;105192;89;276017
44;2020-12-07;92;18;112;51248;16731;90;67979
44;2020-12-07;1116;913;2042;2826745;2685002;0;5511747
52;2020-12-07;2;5;7;213594;223900;09;437494
52;2020-12-07;32;34;67;240818;255197;19;496015
52;2020-12-07;49;31;80;197010;200630;29;397640
52;2020-12-07;58;34;92;231204;224885;39;456089
52;2020-12-07;58;31;89;243874;243418;49;487292
52;2020-12-07;43;38;81;244100;239116;59;483216
52;2020-12-07;24;29;53;241796;221345;69;463141
52;2020-12-07;25;15;40;177805;149903;79;327708
52;2020-12-07;41;14;55;119561;75822;89;195383
52;2020-12-07;43;10;53;42559;15260;90;57819
52;2020-12-07;375;242;618;1952321;1849476;0;3801797
53;2020-12-07;8;5;13;173813;182358;09;356171
53;2020-12-07;12;10;23;202720;214740;19;417460
53;2020-12-07;19;19;38;163116;173196;29;336312
53;2020-12-07;24;20;44;190526;187674;39;378200
53;2020-12-07;21;9;30;212098;212015;49;424113
53;2020-12-07;19;13;32;223699;219176;59;442875
53;2020-12-07;7;15;22;227435;209274;69;436709
53;2020-12-07;3;8;11;169992;140910;79;310902
53;2020-12-07;19;13;32;118117;69883;89;188000
53;2020-12-07;7;4;11;37370;12267;90;49637
53;2020-12-07;139;116;256;1718886;1621493;0;3340379
75;2020-12-07;20;14;34;293104;305291;09;598395
75;2020-12-07;61;60;121;337141;357785;19;694926
75;2020-12-07;94;59;153;295024;300618;29;595642
75;2020-12-07;94;79;173;347871;331233;39;679104
75;2020-12-07;99;77;176;384742;372771;49;757513
75;2020-12-07;98;92;190;413361;390880;59;804241
75;2020-12-07;68;67;135;425623;384060;69;809683
75;2020-12-07;48;41;89;325086;276298;79;601384
75;2020-12-07;58;41;99;213986;139308;89;353294
75;2020-12-07;71;21;92;77600;28200;90;105800
75;2020-12-07;711;551;1262;3113538;2886444;0;5999982
76;2020-12-07;17;13;30;305956;318589;09;624545
76;2020-12-07;51;47;99;338942;356969;19;695911
76;2020-12-07;65;60;126;316210;319570;29;635780
76;2020-12-07;52;53;105;356758;337587;39;694345
76;2020-12-07;83;63;146;376541;363812;49;740353
76;2020-12-07;69;54;123;402608;383750;59;786358
76;2020-12-07;52;45;97;394889;358997;69;753886
76;2020-12-07;38;28;66;308664;263806;79;572470
76;2020-12-07;37;17;54;195838;129272;89;325110
76;2020-12-07;43;15;58;69372;26728;90;96100
76;2020-12-07;508;395;905;3065778;2859080;0;5924858
84;2020-12-07;53;47;101;459549;481088;09;940637
84;2020-12-07;185;170;359;487711;511905;19;999616
84;2020-12-07;204;167;371;443824;451094;29;894918
84;2020-12-07;224;176;400;512522;493262;39;1005784
84;2020-12-07;241;203;444;520248;515106;49;1035354
84;2020-12-07;261;207;468;529611;514848;59;1044459
84;2020-12-07;153;149;302;486720;439940;69;926660
84;2020-12-07;105;90;195;372151;315211;79;687362
84;2020-12-07;129;78;207;237198;150524;89;387722
84;2020-12-07;125;42;167;81185;28680;90;109865
84;2020-12-07;1680;1329;3014;4130719;3901658;0;8032377
93;2020-12-07;18;24;43;268834;283093;09;551927
93;2020-12-07;78;108;186;280751;296087;19;576838
93;2020-12-07;114;80;194;254404;255552;29;509956
93;2020-12-07;127;108;235;310704;288398;39;599102
93;2020-12-07;111;86;198;325559;305827;49;631386
93;2020-12-07;121;82;203;353104;325389;59;678493
93;2020-12-07;71;79;150;336327;296459;69;632786
93;2020-12-07;66;52;118;279820;229699;79;509519
93;2020-12-07;66;39;105;171274;113716;89;284990
93;2020-12-07;60;10;70;58896;21758;90;80654
93;2020-12-07;833;668;1503;2639673;2415978;0;5055651
94;2020-12-07;0;0;0;16311;17433;09;33744
94;2020-12-07;0;1;1;16679;18132;19;34811
94;2020-12-07;0;2;2;16782;16579;29;33361
94;2020-12-07;0;0;0;23044;20580;39;43624
94;2020-12-07;2;0;2;23065;22140;49;45205
94;2020-12-07;0;1;1;24549;23421;59;47970
94;2020-12-07;1;1;2;23212;21883;69;45095
94;2020-12-07;1;1;2;19544;17141;79;36685
94;2020-12-07;1;0;1;11227;8178;89;19405
94;2020-12-07;0;0;0;3332;1447;90;4779
94;2020-12-07;5;6;11;177745;166934;0;344679
01;2020-12-08;0;0;0;19979;20155;09;40134
01;2020-12-08;1;1;2;24994;25489;19;50483
01;2020-12-08;1;1;2;17868;16690;29;34558
01;2020-12-08;0;0;0;22328;14821;39;37149
01;2020-12-08;1;0;1;28652;20276;49;48928
01;2020-12-08;1;1;2;33264;27260;59;60524
01;2020-12-08;0;0;0;27135;23978;69;51113
01;2020-12-08;0;3;3;18401;14661;79;33062
01;2020-12-08;0;0;0;9633;6375;89;16008
01;2020-12-08;0;0;0;3410;1510;90;4920
01;2020-12-08;4;6;10;205664;171215;0;376879
02;2020-12-08;1;0;1;16881;17110;09;33991
02;2020-12-08;3;0;3;21410;21604;19;43014
02;2020-12-08;0;2;2;16017;15479;29;31496
02;2020-12-08;0;0;0;19825;14455;39;34280
02;2020-12-08;1;0;1;24719;18248;49;42967
02;2020-12-08;2;1;3;34361;28310;59;62671
02;2020-12-08;1;1;2;28061;24495;69;52556
02;2020-12-08;2;0;2;18231;15278;79;33509
02;2020-12-08;0;2;2;11090;7677;89;18767
02;2020-12-08;0;0;0;3992;1506;90;5498
02;2020-12-08;10;6;16;194587;164162;0;358749
03;2020-12-08;0;1;1;31123;30920;09;62043
03;2020-12-08;6;3;9;29370;29268;19;58638
03;2020-12-08;12;8;20;21458;18963;29;40421
03;2020-12-08;14;4;18;21276;18326;39;39602
03;2020-12-08;7;7;14;18164;16593;49;34757
03;2020-12-08;6;2;8;13469;13557;59;27026
03;2020-12-08;1;2;3;8776;8670;69;17446
03;2020-12-08;0;0;0;3777;3591;79;7368
03;2020-12-08;0;0;0;1649;1072;89;2721
03;2020-12-08;0;0;0;485;184;90;669
03;2020-12-08;46;27;73;149547;141144;0;290691
04;2020-12-08;1;1;2;60314;61377;09;121691
04;2020-12-08;2;2;4;66065;68387;19;134452
04;2020-12-08;4;1;5;51059;47156;29;98215
04;2020-12-08;2;3;5;58788;45780;39;104568
04;2020-12-08;4;2;6;61408;52207;49;113615
04;2020-12-08;3;2;5;64838;60759;59;125597
04;2020-12-08;3;1;4;47008;42843;69;89851
04;2020-12-08;1;1;2;25509;21184;79;46693
04;2020-12-08;0;0;0;13168;7647;89;20815
04;2020-12-08;0;0;0;3209;1253;90;4462
04;2020-12-08;20;13;33;451366;408593;0;859959
05;2020-12-08;0;0;0;362.366008612902;341.338819562748;09;703.704828175651
05;2020-12-08;0;0;0;353.376145114279;370.349735405642;19;723.725880519921
05;2020-12-08;0;0;0;218.593559489256;256.539602589476;29;475.133162078732
05;2020-12-08;0;0;0;404.225408693299;360.321910454353;39;764.547319147651
05;2020-12-08;0;0;0;520.067953604221;497.108383964256;49;1017.17633756848
05;2020-12-08;0;0;0;468.146063921917;510.087601910415;59;978.233665832332
05;2020-12-08;0;0;0;340.368470050554;334.366842191253;69;674.735312241807
05;2020-12-08;0;0;0;212.598666888387;192.597753227106;79;405.196420115493
05;2020-12-08;0;0;0;148.727797095705;61.8681715431829;89;210.595968638888
05;2020-12-08;0;0;0;32.9601271090696;10.9909785719784;90;43.9511056810479
05;2020-12-08;0;0;0;3061.43020057959;2935.56979942041;0;5997
06;2020-12-08;1;0;1;42583;42380;09;84963
06;2020-12-08;1;3;4;33369;31925;19;65294
06;2020-12-08;1;1;2;21571;15080;29;36651
06;2020-12-08;3;0;3;21550;16147;39;37697
06;2020-12-08;2;3;5;14193;13939;49;28132
06;2020-12-08;1;3;4;7171;7597;59;14768
06;2020-12-08;1;0;1;3629;4117;69;7746
06;2020-12-08;1;0;1;1577;1457;79;3034
06;2020-12-08;0;0;0;531;474;89;1005
06;2020-12-08;0;0;0;88;93;90;181
06;2020-12-08;11;10;21;146262;133209;0;279471
07;2020-12-08;0;0;0;485;549;09;1034
07;2020-12-08;0;0;0;403;432;19;835
07;2020-12-08;0;0;0;764;841;29;1605
07;2020-12-08;0;0;0;824;928;39;1752
07;2020-12-08;0;0;0;788;1020;49;1808
07;2020-12-08;0;0;0;678;870;59;1548
07;2020-12-08;0;0;0;360;382;69;742
07;2020-12-08;0;0;0;231;190;79;421
07;2020-12-08;0;0;0;114;67;89;181
07;2020-12-08;0;0;0;24;11;90;35
07;2020-12-08;0;0;0;4671;5290;0;9961
08;2020-12-08;0;0;0;2715.22592983026;2997.75551488675;09;5712.98144471701
08;2020-12-08;0;0;0;2778.51901080978;3160.9156459093;19;5939.43465671908
08;2020-12-08;0;0;0;2080.8882988764;1718.16634315323;29;3799.05464202964
08;2020-12-08;0;1;1;2701.8582062647;1896.52641413317;39;4598.38462039786
08;2020-12-08;0;0;0;3151.45861023308;2460.52498233809;49;5611.98359257117
08;2020-12-08;2;0;2;2620.29868333099;2422.23566154656;59;5042.53434487755
08;2020-12-08;0;0;0;1621.44173420671;1438.58325779464;69;3060.02499200135
08;2020-12-08;0;0;0;626.575909335673;526.358467843651;79;1152.93437717932
08;2020-12-08;0;0;0;205.018522985054;140.993639349697;89;346.012162334751
08;2020-12-08;0;0;0;50.0325684687745;20.62259870351;90;70.6551671722846
08;2020-12-08;2;1;3;18551.3174743414;16782.6825256586;0;35334
11;2020-12-08;32;46;80;783071;811785;09;1594856
11;2020-12-08;123;116;247;761456;784653;19;1546109
11;2020-12-08;202;172;376;850145;801772;29;1651917
11;2020-12-08;221;195;418;914360;843488;39;1757848
11;2020-12-08;198;176;376;845609;826202;49;1671811
11;2020-12-08;158;133;295;793566;745070;59;1538636
11;2020-12-08;101;100;201;628649;549192;69;1177841
11;2020-12-08;75;61;137;434606;358356;79;792962
11;2020-12-08;84;33;117;261425;162933;89;424358
11;2020-12-08;32;17;49;89253;32619;90;121872
11;2020-12-08;1226;1050;2298;6362140;5916070;0;12278210
24;2020-12-08;5;8;14;139720;144686;09;284406
24;2020-12-08;28;25;53;152979;161185;19;314164
24;2020-12-08;33;30;63;122237;126536;29;248773
24;2020-12-08;38;33;71;150359;142009;39;292368
24;2020-12-08;49;27;76;161829;158758;49;320587
24;2020-12-08;41;37;78;172552;168011;59;340563
24;2020-12-08;28;30;58;172509;158177;69;330686
24;2020-12-08;31;21;52;129428;110593;79;240021
24;2020-12-08;33;20;53;87342;56882;89;144224
24;2020-12-08;33;13;46;31210;12071;90;43281
24;2020-12-08;319;244;564;1320165;1238908;0;2559073
27;2020-12-08;13;17;31;143373;149679;09;293052
27;2020-12-08;51;52;103;160962;173003;19;333965
27;2020-12-08;56;44;100;133746;142254;29;276000
27;2020-12-08;80;52;132;160004;155407;39;315411
27;2020-12-08;68;65;133;172333;169564;49;341897
27;2020-12-08;68;58;126;189979;183788;59;373767
27;2020-12-08;44;38;82;192591;178206;69;370797
27;2020-12-08;39;36;75;146876;127546;79;274422
27;2020-12-08;55;29;84;96896;61575;89;158471
27;2020-12-08;69;19;88;33148;12109;90;45257
27;2020-12-08;543;410;954;1429908;1353131;0;2783039
28;2020-12-08;7;5;13;180735;186856;09;367591
28;2020-12-08;37;22;59;200125;213621;19;413746
28;2020-12-08;47;25;72;168922;173007;29;341929
28;2020-12-08;40;22;62;196628;188487;39;385115
28;2020-12-08;46;22;68;205396;201699;49;407095
28;2020-12-08;40;22;62;222002;213866;59;435868
28;2020-12-08;27;27;54;224688;203758;69;428446
28;2020-12-08;19;20;39;163192;135543;79;298735
28;2020-12-08;25;23;48;109691;65377;89;175068
28;2020-12-08;22;8;30;37222;12685;90;49907
28;2020-12-08;310;196;507;1708601;1594899;0;3303500
32;2020-12-08;19;17;37;358062;373689;09;731751
32;2020-12-08;67;78;145;387045;406742;19;793787
32;2020-12-08;87;76;163;342304;348587;29;690891
32;2020-12-08;88;75;164;382485;369972;39;752457
32;2020-12-08;104;73;177;382510;376716;49;759226
32;2020-12-08;72;72;144;386937;376527;59;763464
32;2020-12-08;61;54;115;371211;330938;69;702149
32;2020-12-08;43;45;88;250542;201459;79;452001
32;2020-12-08;66;34;100;163399;89786;89;253185
32;2020-12-08;78;16;94;48384;15367;90;63751
32;2020-12-08;685;540;1227;3072879;2889783;0;5962662
44;2020-12-08;27;25;52;291525;306839;09;598364
44;2020-12-08;90;82;173;320255;339504;19;659759
44;2020-12-08;126;105;232;302020;314428;29;616448
44;2020-12-08;143;99;244;342222;333292;39;675514
44;2020-12-08;126;91;217;349727;344491;49;694218
44;2020-12-08;129;99;230;381371;373239;59;754610
44;2020-12-08;84;67;151;367165;335850;69;703015
44;2020-12-08;59;64;123;250387;215436;79;465823
44;2020-12-08;109;53;162;170825;105192;89;276017
44;2020-12-08;79;16;95;51248;16731;90;67979
44;2020-12-08;972;701;1679;2826745;2685002;0;5511747
52;2020-12-08;4;1;5;213594;223900;09;437494
52;2020-12-08;22;33;58;240818;255197;19;496015
52;2020-12-08;46;25;71;197010;200630;29;397640
52;2020-12-08;32;20;52;231204;224885;39;456089
52;2020-12-08;40;15;55;243874;243418;49;487292
52;2020-12-08;44;29;73;244100;239116;59;483216
52;2020-12-08;16;20;36;241796;221345;69;463141
52;2020-12-08;14;22;36;177805;149903;79;327708
52;2020-12-08;31;17;48;119561;75822;89;195383
52;2020-12-08;32;12;44;42559;15260;90;57819
52;2020-12-08;281;194;478;1952321;1849476;0;3801797
53;2020-12-08;7;6;13;173813;182358;09;356171
53;2020-12-08;18;12;30;202720;214740;19;417460
53;2020-12-08;16;15;31;163116;173196;29;336312
53;2020-12-08;22;15;37;190526;187674;39;378200
53;2020-12-08;9;14;23;212098;212015;49;424113
53;2020-12-08;14;11;25;223699;219176;59;442875
53;2020-12-08;9;14;23;227435;209274;69;436709
53;2020-12-08;5;7;12;169992;140910;79;310902
53;2020-12-08;16;7;23;118117;69883;89;188000
53;2020-12-08;3;1;4;37370;12267;90;49637
53;2020-12-08;119;102;221;1718886;1621493;0;3340379
75;2020-12-08;14;17;31;293104;305291;09;598395
75;2020-12-08;46;54;101;337141;357785;19;694926
75;2020-12-08;79;56;135;295024;300618;29;595642
75;2020-12-08;58;55;113;347871;331233;39;679104
75;2020-12-08;74;46;120;384742;372771;49;757513
75;2020-12-08;63;51;115;413361;390880;59;804241
75;2020-12-08;41;36;77;425623;384060;69;809683
75;2020-12-08;26;41;67;325086;276298;79;601384
75;2020-12-08;56;23;79;213986;139308;89;353294
75;2020-12-08;60;13;73;77600;28200;90;105800
75;2020-12-08;518;393;913;3113538;2886444;0;5999982
76;2020-12-08;11;6;17;305956;318589;09;624545
76;2020-12-08;45;34;81;338942;356969;19;695911
76;2020-12-08;61;57;118;316210;319570;29;635780
76;2020-12-08;67;44;111;356758;337587;39;694345
76;2020-12-08;69;56;125;376541;363812;49;740353
76;2020-12-08;60;55;115;402608;383750;59;786358
76;2020-12-08;48;42;90;394889;358997;69;753886
76;2020-12-08;26;23;49;308664;263806;79;572470
76;2020-12-08;30;18;48;195838;129272;89;325110
76;2020-12-08;53;7;60;69372;26728;90;96100
76;2020-12-08;472;342;816;3065778;2859080;0;5924858
84;2020-12-08;34;37;71;459549;481088;09;940637
84;2020-12-08;136;148;284;487711;511905;19;999616
84;2020-12-08;174;125;301;443824;451094;29;894918
84;2020-12-08;176;142;319;512522;493262;39;1005784
84;2020-12-08;162;112;274;520248;515106;49;1035354
84;2020-12-08;150;149;299;529611;514848;59;1044459
84;2020-12-08;114;110;224;486720;439940;69;926660
84;2020-12-08;86;62;148;372151;315211;79;687362
84;2020-12-08;133;69;202;237198;150524;89;387722
84;2020-12-08;127;25;152;81185;28680;90;109865
84;2020-12-08;1292;979;2275;4130719;3901658;0;8032377
93;2020-12-08;19;18;37;268834;283093;09;551927
93;2020-12-08;68;52;120;280751;296087;19;576838
93;2020-12-08;88;81;169;254404;255552;29;509956
93;2020-12-08;106;56;162;310704;288398;39;599102
93;2020-12-08;81;70;151;325559;305827;49;631386
93;2020-12-08;101;84;185;353104;325389;59;678493
93;2020-12-08;48;58;107;336327;296459;69;632786
93;2020-12-08;42;35;77;279820;229699;79;509519
93;2020-12-08;46;22;68;171274;113716;89;284990
93;2020-12-08;45;2;47;58896;21758;90;80654
93;2020-12-08;644;478;1123;2639673;2415978;0;5055651
94;2020-12-08;0;0;0;16311;17433;09;33744
94;2020-12-08;0;2;2;16679;18132;19;34811
94;2020-12-08;1;1;2;16782;16579;29;33361
94;2020-12-08;0;2;2;23044;20580;39;43624
94;2020-12-08;0;1;1;23065;22140;49;45205
94;2020-12-08;0;1;1;24549;23421;59;47970
94;2020-12-08;1;1;2;23212;21883;69;45095
94;2020-12-08;1;1;2;19544;17141;79;36685
94;2020-12-08;1;1;2;11227;8178;89;19405
94;2020-12-08;1;0;1;3332;1447;90;4779
94;2020-12-08;5;10;15;177745;166934;0;344679
01;2020-12-09;0;0;0;19979;20155;09;40134
01;2020-12-09;0;0;0;24994;25489;19;50483
01;2020-12-09;0;0;0;17868;16690;29;34558
01;2020-12-09;1;1;2;22328;14821;39;37149
01;2020-12-09;2;1;3;28652;20276;49;48928
01;2020-12-09;0;1;1;33264;27260;59;60524
01;2020-12-09;0;0;0;27135;23978;69;51113
01;2020-12-09;0;0;0;18401;14661;79;33062
01;2020-12-09;0;0;0;9633;6375;89;16008
01;2020-12-09;0;0;0;3410;1510;90;4920
01;2020-12-09;3;3;6;205664;171215;0;376879
02;2020-12-09;0;0;0;16881;17110;09;33991
02;2020-12-09;1;1;2;21410;21604;19;43014
02;2020-12-09;0;0;0;16017;15479;29;31496
02;2020-12-09;0;0;0;19825;14455;39;34280
02;2020-12-09;1;1;2;24719;18248;49;42967
02;2020-12-09;1;1;2;34361;28310;59;62671
02;2020-12-09;0;0;0;28061;24495;69;52556
02;2020-12-09;0;0;0;18231;15278;79;33509
02;2020-12-09;0;0;0;11090;7677;89;18767
02;2020-12-09;0;0;0;3992;1506;90;5498
02;2020-12-09;3;3;6;194587;164162;0;358749
03;2020-12-09;0;2;2;31123;30920;09;62043
03;2020-12-09;2;2;4;29370;29268;19;58638
03;2020-12-09;11;9;20;21458;18963;29;40421
03;2020-12-09;7;5;12;21276;18326;39;39602
03;2020-12-09;4;4;8;18164;16593;49;34757
03;2020-12-09;2;5;7;13469;13557;59;27026
03;2020-12-09;4;2;6;8776;8670;69;17446
03;2020-12-09;1;1;2;3777;3591;79;7368
03;2020-12-09;0;0;0;1649;1072;89;2721
03;2020-12-09;0;0;0;485;184;90;669
03;2020-12-09;31;30;61;149547;141144;0;290691
04;2020-12-09;2;0;2;60314;61377;09;121691
04;2020-12-09;5;1;6;66065;68387;19;134452
04;2020-12-09;0;3;3;51059;47156;29;98215
04;2020-12-09;3;2;5;58788;45780;39;104568
04;2020-12-09;5;3;8;61408;52207;49;113615
04;2020-12-09;3;6;9;64838;60759;59;125597
04;2020-12-09;0;2;2;47008;42843;69;89851
04;2020-12-09;1;0;1;25509;21184;79;46693
04;2020-12-09;1;0;1;13168;7647;89;20815
04;2020-12-09;0;0;0;3209;1253;90;4462
04;2020-12-09;20;17;37;451366;408593;0;859959
05;2020-12-09;0;0;0;362.366008612902;341.338819562748;09;703.704828175651
05;2020-12-09;0;0;0;353.376145114279;370.349735405642;19;723.725880519921
05;2020-12-09;0;0;0;218.593559489256;256.539602589476;29;475.133162078732
05;2020-12-09;0;0;0;404.225408693299;360.321910454353;39;764.547319147651
05;2020-12-09;0;0;0;520.067953604221;497.108383964256;49;1017.17633756848
05;2020-12-09;0;0;0;468.146063921917;510.087601910415;59;978.233665832332
05;2020-12-09;0;0;0;340.368470050554;334.366842191253;69;674.735312241807
05;2020-12-09;0;0;0;212.598666888387;192.597753227106;79;405.196420115493
05;2020-12-09;0;0;0;148.727797095705;61.8681715431829;89;210.595968638888
05;2020-12-09;0;0;0;32.9601271090696;10.9909785719784;90;43.9511056810479
05;2020-12-09;0;0;0;3061.43020057959;2935.56979942041;0;5997
06;2020-12-09;0;0;0;42583;42380;09;84963
06;2020-12-09;1;2;3;33369;31925;19;65294
06;2020-12-09;5;1;6;21571;15080;29;36651
06;2020-12-09;4;1;5;21550;16147;39;37697
06;2020-12-09;2;4;6;14193;13939;49;28132
06;2020-12-09;2;1;3;7171;7597;59;14768
06;2020-12-09;1;2;3;3629;4117;69;7746
06;2020-12-09;0;1;1;1577;1457;79;3034
06;2020-12-09;0;0;0;531;474;89;1005
06;2020-12-09;0;0;0;88;93;90;181
06;2020-12-09;15;12;27;146262;133209;0;279471
07;2020-12-09;0;0;0;485;549;09;1034
07;2020-12-09;0;0;0;403;432;19;835
07;2020-12-09;0;0;0;764;841;29;1605
07;2020-12-09;0;0;0;824;928;39;1752
07;2020-12-09;0;1;1;788;1020;49;1808
07;2020-12-09;0;0;0;678;870;59;1548
07;2020-12-09;0;0;0;360;382;69;742
07;2020-12-09;0;0;0;231;190;79;421
07;2020-12-09;0;0;0;114;67;89;181
07;2020-12-09;0;0;0;24;11;90;35
07;2020-12-09;0;1;1;4671;5290;0;9961
08;2020-12-09;0;0;0;2715.22592983026;2997.75551488675;09;5712.98144471701
08;2020-12-09;0;0;0;2778.51901080978;3160.9156459093;19;5939.43465671908
08;2020-12-09;0;2;2;2080.8882988764;1718.16634315323;29;3799.05464202964
08;2020-12-09;2;1;3;2701.8582062647;1896.52641413317;39;4598.38462039786
08;2020-12-09;3;1;4;3151.45861023308;2460.52498233809;49;5611.98359257117
08;2020-12-09;0;0;0;2620.29868333099;2422.23566154656;59;5042.53434487755
08;2020-12-09;3;2;5;1621.44173420671;1438.58325779464;69;3060.02499200135
08;2020-12-09;1;0;1;626.575909335673;526.358467843651;79;1152.93437717932
08;2020-12-09;0;0;0;205.018522985054;140.993639349697;89;346.012162334751
08;2020-12-09;0;0;0;50.0325684687745;20.62259870351;90;70.6551671722846
08;2020-12-09;9;6;15;18551.3174743414;16782.6825256586;0;35334
11;2020-12-09;56;43;102;783071;811785;09;1594856
11;2020-12-09;126;144;275;761456;784653;19;1546109
11;2020-12-09;232;146;379;850145;801772;29;1651917
11;2020-12-09;204;164;369;914360;843488;39;1757848
11;2020-12-09;171;188;362;845609;826202;49;1671811
11;2020-12-09;134;133;269;793566;745070;59;1538636
11;2020-12-09;85;103;190;628649;549192;69;1177841
11;2020-12-09;59;59;118;434606;358356;79;792962
11;2020-12-09;48;46;94;261425;162933;89;424358
11;2020-12-09;34;13;47;89253;32619;90;121872
11;2020-12-09;1150;1039;2206;6362140;5916070;0;12278210
24;2020-12-09;9;5;14;139720;144686;09;284406
24;2020-12-09;28;34;62;152979;161185;19;314164
24;2020-12-09;34;24;58;122237;126536;29;248773
24;2020-12-09;38;26;64;150359;142009;39;292368
24;2020-12-09;44;24;68;161829;158758;49;320587
24;2020-12-09;33;18;51;172552;168011;59;340563
24;2020-12-09;22;26;48;172509;158177;69;330686
24;2020-12-09;24;14;38;129428;110593;79;240021
24;2020-12-09;30;13;43;87342;56882;89;144224
24;2020-12-09;19;2;21;31210;12071;90;43281
24;2020-12-09;281;186;467;1320165;1238908;0;2559073
27;2020-12-09;13;24;37;143373;149679;09;293052
27;2020-12-09;49;55;106;160962;173003;19;333965
27;2020-12-09;80;57;137;133746;142254;29;276000
27;2020-12-09;69;56;125;160004;155407;39;315411
27;2020-12-09;84;40;124;172333;169564;49;341897
27;2020-12-09;55;60;115;189979;183788;59;373767
27;2020-12-09;52;44;96;192591;178206;69;370797
27;2020-12-09;38;41;79;146876;127546;79;274422
27;2020-12-09;63;35;98;96896;61575;89;158471
27;2020-12-09;59;26;85;33148;12109;90;45257
27;2020-12-09;562;438;1002;1429908;1353131;0;2783039
28;2020-12-09;14;12;28;180735;186856;09;367591
28;2020-12-09;29;19;51;200125;213621;19;413746
28;2020-12-09;38;25;63;168922;173007;29;341929
28;2020-12-09;46;26;72;196628;188487;39;385115
28;2020-12-09;40;25;65;205396;201699;49;407095
28;2020-12-09;30;21;51;222002;213866;59;435868
28;2020-12-09;18;18;36;224688;203758;69;428446
28;2020-12-09;12;21;33;163192;135543;79;298735
28;2020-12-09;29;18;47;109691;65377;89;175068
28;2020-12-09;35;7;42;37222;12685;90;49907
28;2020-12-09;291;192;488;1708601;1594899;0;3303500
32;2020-12-09;26;19;45;358062;373689;09;731751
32;2020-12-09;69;71;140;387045;406742;19;793787
32;2020-12-09;89;60;149;342304;348587;29;690891
32;2020-12-09;107;67;174;382485;369972;39;752457
32;2020-12-09;82;56;138;382510;376716;49;759226
32;2020-12-09;75;77;152;386937;376527;59;763464
32;2020-12-09;52;46;98;371211;330938;69;702149
32;2020-12-09;36;42;78;250542;201459;79;452001
32;2020-12-09;70;29;99;163399;89786;89;253185
32;2020-12-09;60;10;70;48384;15367;90;63751
32;2020-12-09;667;477;1144;3072879;2889783;0;5962662
44;2020-12-09;33;33;67;291525;306839;09;598364
44;2020-12-09;95;69;166;320255;339504;19;659759
44;2020-12-09;121;100;222;302020;314428;29;616448
44;2020-12-09;102;112;215;342222;333292;39;675514
44;2020-12-09;116;95;212;349727;344491;49;694218
44;2020-12-09;107;109;216;381371;373239;59;754610
44;2020-12-09;61;74;137;367165;335850;69;703015
44;2020-12-09;65;63;128;250387;215436;79;465823
44;2020-12-09;109;65;175;170825;105192;89;276017
44;2020-12-09;71;15;86;51248;16731;90;67979
44;2020-12-09;880;735;1624;2826745;2685002;0;5511747
52;2020-12-09;4;4;8;213594;223900;09;437494
52;2020-12-09;24;22;46;240818;255197;19;496015
52;2020-12-09;41;32;73;197010;200630;29;397640
52;2020-12-09;32;25;58;231204;224885;39;456089
52;2020-12-09;40;27;67;243874;243418;49;487292
52;2020-12-09;40;36;76;244100;239116;59;483216
52;2020-12-09;31;30;61;241796;221345;69;463141
52;2020-12-09;20;15;35;177805;149903;79;327708
52;2020-12-09;34;28;63;119561;75822;89;195383
52;2020-12-09;45;10;55;42559;15260;90;57819
52;2020-12-09;311;229;542;1952321;1849476;0;3801797
53;2020-12-09;6;4;10;173813;182358;09;356171
53;2020-12-09;11;5;16;202720;214740;19;417460
53;2020-12-09;20;13;39;163116;173196;29;336312
53;2020-12-09;16;12;28;190526;187674;39;378200
53;2020-12-09;18;12;30;212098;212015;49;424113
53;2020-12-09;14;14;28;223699;219176;59;442875
53;2020-12-09;10;13;23;227435;209274;69;436709
53;2020-12-09;18;14;32;169992;140910;79;310902
53;2020-12-09;29;10;39;118117;69883;89;188000
53;2020-12-09;25;11;36;37370;12267;90;49637
53;2020-12-09;167;108;281;1718886;1621493;0;3340379
75;2020-12-09;21;19;40;293104;305291;09;598395
75;2020-12-09;38;45;83;337141;357785;19;694926
75;2020-12-09;68;46;114;295024;300618;29;595642
75;2020-12-09;66;41;107;347871;331233;39;679104
75;2020-12-09;69;36;105;384742;372771;49;757513
75;2020-12-09;49;49;98;413361;390880;59;804241
75;2020-12-09;33;31;64;425623;384060;69;809683
75;2020-12-09;30;23;53;325086;276298;79;601384
75;2020-12-09;43;18;62;213986;139308;89;353294
75;2020-12-09;35;14;49;77600;28200;90;105800
75;2020-12-09;452;323;776;3113538;2886444;0;5999982
76;2020-12-09;8;11;19;305956;318589;09;624545
76;2020-12-09;45;50;97;338942;356969;19;695911
76;2020-12-09;60;54;114;316210;319570;29;635780
76;2020-12-09;49;38;87;356758;337587;39;694345
76;2020-12-09;56;40;96;376541;363812;49;740353
76;2020-12-09;62;54;117;402608;383750;59;786358
76;2020-12-09;34;23;57;394889;358997;69;753886
76;2020-12-09;35;27;62;308664;263806;79;572470
76;2020-12-09;41;19;60;195838;129272;89;325110
76;2020-12-09;28;9;37;69372;26728;90;96100
76;2020-12-09;418;325;746;3065778;2859080;0;5924858
84;2020-12-09;26;42;68;459549;481088;09;940637
84;2020-12-09;106;168;275;487711;511905;19;999616
84;2020-12-09;187;142;329;443824;451094;29;894918
84;2020-12-09;192;130;322;512522;493262;39;1005784
84;2020-12-09;173;137;310;520248;515106;49;1035354
84;2020-12-09;145;140;285;529611;514848;59;1044459
84;2020-12-09;106;82;188;486720;439940;69;926660
84;2020-12-09;80;66;146;372151;315211;79;687362
84;2020-12-09;81;52;133;237198;150524;89;387722
84;2020-12-09;84;19;103;81185;28680;90;109865
84;2020-12-09;1183;978;2162;4130719;3901658;0;8032377
93;2020-12-09;25;13;38;268834;283093;09;551927
93;2020-12-09;76;89;165;280751;296087;19;576838
93;2020-12-09;83;59;142;254404;255552;29;509956
93;2020-12-09;88;67;156;310704;288398;39;599102
93;2020-12-09;105;70;175;325559;305827;49;631386
93;2020-12-09;70;69;139;353104;325389;59;678493
93;2020-12-09;56;46;102;336327;296459;69;632786
93;2020-12-09;39;38;77;279820;229699;79;509519
93;2020-12-09;45;26;71;171274;113716;89;284990
93;2020-12-09;28;24;52;58896;21758;90;80654
93;2020-12-09;615;501;1117;2639673;2415978;0;5055651
94;2020-12-09;0;0;0;16311;17433;09;33744
94;2020-12-09;1;0;1;16679;18132;19;34811
94;2020-12-09;0;3;3;16782;16579;29;33361
94;2020-12-09;1;2;3;23044;20580;39;43624
94;2020-12-09;1;3;4;23065;22140;49;45205
94;2020-12-09;2;0;2;24549;23421;59;47970
94;2020-12-09;0;2;2;23212;21883;69;45095
94;2020-12-09;0;0;0;19544;17141;79;36685
94;2020-12-09;0;1;1;11227;8178;89;19405
94;2020-12-09;1;0;1;3332;1447;90;4779
94;2020-12-09;6;11;20;177745;166934;0;344679
01;2020-12-10;0;0;0;19979;20155;09;40134
01;2020-12-10;0;0;0;24994;25489;19;50483
01;2020-12-10;2;0;2;17868;16690;29;34558
01;2020-12-10;0;1;1;22328;14821;39;37149
01;2020-12-10;0;0;0;28652;20276;49;48928
01;2020-12-10;2;0;2;33264;27260;59;60524
01;2020-12-10;0;0;0;27135;23978;69;51113
01;2020-12-10;0;0;0;18401;14661;79;33062
01;2020-12-10;0;0;0;9633;6375;89;16008
01;2020-12-10;1;0;1;3410;1510;90;4920
01;2020-12-10;5;1;6;205664;171215;0;376879
02;2020-12-10;0;0;0;16881;17110;09;33991
02;2020-12-10;1;0;1;21410;21604;19;43014
02;2020-12-10;1;1;2;16017;15479;29;31496
02;2020-12-10;1;0;1;19825;14455;39;34280
02;2020-12-10;0;2;2;24719;18248;49;42967
02;2020-12-10;0;0;0;34361;28310;59;62671
02;2020-12-10;1;1;2;28061;24495;69;52556
02;2020-12-10;0;0;0;18231;15278;79;33509
02;2020-12-10;0;0;0;11090;7677;89;18767
02;2020-12-10;0;0;0;3992;1506;90;5498
02;2020-12-10;4;4;8;194587;164162;0;358749
03;2020-12-10;0;0;0;31123;30920;09;62043
03;2020-12-10;2;5;7;29370;29268;19;58638
03;2020-12-10;10;15;25;21458;18963;29;40421
03;2020-12-10;12;12;24;21276;18326;39;39602
03;2020-12-10;4;12;16;18164;16593;49;34757
03;2020-12-10;6;3;9;13469;13557;59;27026
03;2020-12-10;4;1;5;8776;8670;69;17446
03;2020-12-10;0;1;1;3777;3591;79;7368
03;2020-12-10;1;0;1;1649;1072;89;2721
03;2020-12-10;0;0;0;485;184;90;669
03;2020-12-10;39;49;88;149547;141144;0;290691
04;2020-12-10;1;2;3;60314;61377;09;121691
04;2020-12-10;3;3;6;66065;68387;19;134452
04;2020-12-10;4;3;7;51059;47156;29;98215
04;2020-12-10;6;0;6;58788;45780;39;104568
04;2020-12-10;3;5;8;61408;52207;49;113615
04;2020-12-10;2;4;6;64838;60759;59;125597
04;2020-12-10;3;3;6;47008;42843;69;89851
04;2020-12-10;0;0;0;25509;21184;79;46693
04;2020-12-10;0;0;0;13168;7647;89;20815
04;2020-12-10;0;0;0;3209;1253;90;4462
04;2020-12-10;22;20;42;451366;408593;0;859959
05;2020-12-10;0;0;0;362.366008612902;341.338819562748;09;703.704828175651
05;2020-12-10;0;0;0;353.376145114279;370.349735405642;19;723.725880519921
05;2020-12-10;0;0;0;218.593559489256;256.539602589476;29;475.133162078732
05;2020-12-10;0;0;0;404.225408693299;360.321910454353;39;764.547319147651
05;2020-12-10;0;0;0;520.067953604221;497.108383964256;49;1017.17633756848
05;2020-12-10;0;0;0;468.146063921917;510.087601910415;59;978.233665832332
05;2020-12-10;0;0;0;340.368470050554;334.366842191253;69;674.735312241807
05;2020-12-10;0;0;0;212.598666888387;192.597753227106;79;405.196420115493
05;2020-12-10;0;0;0;148.727797095705;61.8681715431829;89;210.595968638888
05;2020-12-10;0;0;0;32.9601271090696;10.9909785719784;90;43.9511056810479
05;2020-12-10;0;0;0;3061.43020057959;2935.56979942041;0;5997
06;2020-12-10;0;0;0;42583;42380;09;84963
06;2020-12-10;1;1;2;33369;31925;19;65294
06;2020-12-10;2;0;2;21571;15080;29;36651
06;2020-12-10;3;2;5;21550;16147;39;37697
06;2020-12-10;2;3;5;14193;13939;49;28132
06;2020-12-10;1;0;1;7171;7597;59;14768
06;2020-12-10;2;0;2;3629;4117;69;7746
06;2020-12-10;0;1;1;1577;1457;79;3034
06;2020-12-10;0;0;0;531;474;89;1005
06;2020-12-10;0;0;0;88;93;90;181
06;2020-12-10;11;7;18;146262;133209;0;279471
07;2020-12-10;0;0;0;485;549;09;1034
07;2020-12-10;0;0;0;403;432;19;835
07;2020-12-10;0;0;0;764;841;29;1605
07;2020-12-10;0;0;0;824;928;39;1752
07;2020-12-10;0;0;0;788;1020;49;1808
07;2020-12-10;0;0;0;678;870;59;1548
07;2020-12-10;0;0;0;360;382;69;742
07;2020-12-10;0;0;0;231;190;79;421
07;2020-12-10;0;0;0;114;67;89;181
07;2020-12-10;0;0;0;24;11;90;35
07;2020-12-10;0;0;0;4671;5290;0;9961
08;2020-12-10;1;0;1;2715.22592983026;2997.75551488675;09;5712.98144471701
08;2020-12-10;0;0;0;2778.51901080978;3160.9156459093;19;5939.43465671908
08;2020-12-10;0;0;0;2080.8882988764;1718.16634315323;29;3799.05464202964
08;2020-12-10;4;1;5;2701.8582062647;1896.52641413317;39;4598.38462039786
08;2020-12-10;3;0;3;3151.45861023308;2460.52498233809;49;5611.98359257117
08;2020-12-10;0;0;0;2620.29868333099;2422.23566154656;59;5042.53434487755
08;2020-12-10;0;0;0;1621.44173420671;1438.58325779464;69;3060.02499200135
08;2020-12-10;0;0;0;626.575909335673;526.358467843651;79;1152.93437717932
08;2020-12-10;0;0;0;205.018522985054;140.993639349697;89;346.012162334751
08;2020-12-10;0;0;0;50.0325684687745;20.62259870351;90;70.6551671722846
08;2020-12-10;8;1;9;18551.3174743414;16782.6825256586;0;35334
11;2020-12-10;37;47;89;783071;811785;09;1594856
11;2020-12-10;135;142;286;761456;784653;19;1546109
11;2020-12-10;219;199;418;850145;801772;29;1651917
11;2020-12-10;245;211;457;914360;843488;39;1757848
11;2020-12-10;195;186;383;845609;826202;49;1671811
11;2020-12-10;188;173;364;793566;745070;59;1538636
11;2020-12-10;109;96;208;628649;549192;69;1177841
11;2020-12-10;65;63;129;434606;358356;79;792962
11;2020-12-10;54;42;96;261425;162933;89;424358
11;2020-12-10;47;20;67;89253;32619;90;121872
11;2020-12-10;1294;1180;2500;6362140;5916070;0;12278210
24;2020-12-10;5;9;14;139720;144686;09;284406
24;2020-12-10;26;24;50;152979;161185;19;314164
24;2020-12-10;47;29;76;122237;126536;29;248773
24;2020-12-10;32;23;55;150359;142009;39;292368
24;2020-12-10;37;33;70;161829;158758;49;320587
24;2020-12-10;44;39;83;172552;168011;59;340563
24;2020-12-10;24;13;37;172509;158177;69;330686
24;2020-12-10;19;24;43;129428;110593;79;240021
24;2020-12-10;31;14;45;87342;56882;89;144224
24;2020-12-10;27;11;38;31210;12071;90;43281
24;2020-12-10;292;219;511;1320165;1238908;0;2559073
27;2020-12-10;14;15;31;143373;149679;09;293052
27;2020-12-10;43;47;90;160962;173003;19;333965
27;2020-12-10;59;43;102;133746;142254;29;276000
27;2020-12-10;65;46;111;160004;155407;39;315411
27;2020-12-10;68;50;118;172333;169564;49;341897
27;2020-12-10;78;62;140;189979;183788;59;373767
27;2020-12-10;49;39;89;192591;178206;69;370797
27;2020-12-10;46;45;91;146876;127546;79;274422
27;2020-12-10;57;41;98;96896;61575;89;158471
27;2020-12-10;56;12;68;33148;12109;90;45257
27;2020-12-10;535;400;938;1429908;1353131;0;2783039
28;2020-12-10;12;15;27;180735;186856;09;367591
28;2020-12-10;30;34;66;200125;213621;19;413746
28;2020-12-10;36;34;70;168922;173007;29;341929
28;2020-12-10;37;21;59;196628;188487;39;385115
28;2020-12-10;40;28;68;205396;201699;49;407095
28;2020-12-10;34;39;73;222002;213866;59;435868
28;2020-12-10;18;22;40;224688;203758;69;428446
28;2020-12-10;23;18;41;163192;135543;79;298735
28;2020-12-10;57;19;76;109691;65377;89;175068
28;2020-12-10;47;10;57;37222;12685;90;49907
28;2020-12-10;334;240;577;1708601;1594899;0;3303500
32;2020-12-10;26;15;41;358062;373689;09;731751
32;2020-12-10;67;73;140;387045;406742;19;793787
32;2020-12-10;108;95;204;342304;348587;29;690891
32;2020-12-10;108;77;186;382485;369972;39;752457
32;2020-12-10;115;86;202;382510;376716;49;759226
32;2020-12-10;93;70;163;386937;376527;59;763464
32;2020-12-10;62;64;126;371211;330938;69;702149
32;2020-12-10;55;39;94;250542;201459;79;452001
32;2020-12-10;60;28;88;163399;89786;89;253185
32;2020-12-10;49;9;58;48384;15367;90;63751
32;2020-12-10;743;556;1302;3072879;2889783;0;5962662
44;2020-12-10;29;24;54;291525;306839;09;598364
44;2020-12-10;90;93;185;320255;339504;19;659759
44;2020-12-10;128;114;242;302020;314428;29;616448
44;2020-12-10;137;109;247;342222;333292;39;675514
44;2020-12-10;127;88;215;349727;344491;49;694218
44;2020-12-10;122;112;235;381371;373239;59;754610
44;2020-12-10;79;79;160;367165;335850;69;703015
44;2020-12-10;78;66;147;250387;215436;79;465823
44;2020-12-10;92;67;159;170825;105192;89;276017
44;2020-12-10;72;17;89;51248;16731;90;67979
44;2020-12-10;954;769;1733;2826745;2685002;0;5511747
52;2020-12-10;4;4;8;213594;223900;09;437494
52;2020-12-10;32;29;61;240818;255197;19;496015
52;2020-12-10;60;46;106;197010;200630;29;397640
52;2020-12-10;37;30;67;231204;224885;39;456089
52;2020-12-10;46;21;67;243874;243418;49;487292
52;2020-12-10;34;33;67;244100;239116;59;483216
52;2020-12-10;24;26;51;241796;221345;69;463141
52;2020-12-10;15;13;28;177805;149903;79;327708
52;2020-12-10;44;23;68;119561;75822;89;195383
52;2020-12-10;43;13;56;42559;15260;90;57819
52;2020-12-10;339;238;579;1952321;1849476;0;3801797
53;2020-12-10;1;5;6;173813;182358;09;356171
53;2020-12-10;14;9;23;202720;214740;19;417460
53;2020-12-10;22;13;36;163116;173196;29;336312
53;2020-12-10;13;13;26;190526;187674;39;378200
53;2020-12-10;24;6;30;212098;212015;49;424113
53;2020-12-10;20;14;34;223699;219176;59;442875
53;2020-12-10;14;14;28;227435;209274;69;436709
53;2020-12-10;8;7;15;169992;140910;79;310902
53;2020-12-10;18;7;25;118117;69883;89;188000
53;2020-12-10;11;6;17;37370;12267;90;49637
53;2020-12-10;145;94;240;1718886;1621493;0;3340379
75;2020-12-10;18;14;32;293104;305291;09;598395
75;2020-12-10;52;39;92;337141;357785;19;694926
75;2020-12-10;57;38;95;295024;300618;29;595642
75;2020-12-10;57;55;112;347871;331233;39;679104
75;2020-12-10;57;54;112;384742;372771;49;757513
75;2020-12-10;66;43;109;413361;390880;59;804241
75;2020-12-10;35;36;71;425623;384060;69;809683
75;2020-12-10;30;25;55;325086;276298;79;601384
75;2020-12-10;46;41;87;213986;139308;89;353294
75;2020-12-10;53;16;69;77600;28200;90;105800
75;2020-12-10;471;361;834;3113538;2886444;0;5999982
76;2020-12-10;11;7;18;305956;318589;09;624545
76;2020-12-10;48;41;90;338942;356969;19;695911
76;2020-12-10;68;40;108;316210;319570;29;635780
76;2020-12-10;75;59;134;356758;337587;39;694345
76;2020-12-10;67;49;117;376541;363812;49;740353
76;2020-12-10;60;54;114;402608;383750;59;786358
76;2020-12-10;34;31;65;394889;358997;69;753886
76;2020-12-10;26;14;40;308664;263806;79;572470
76;2020-12-10;54;24;78;195838;129272;89;325110
76;2020-12-10;39;7;46;69372;26728;90;96100
76;2020-12-10;482;326;810;3065778;2859080;0;5924858
84;2020-12-10;33;47;81;459549;481088;09;940637
84;2020-12-10;154;144;299;487711;511905;19;999616
84;2020-12-10;163;127;290;443824;451094;29;894918
84;2020-12-10;170;127;297;512522;493262;39;1005784
84;2020-12-10;213;144;357;520248;515106;49;1035354
84;2020-12-10;163;128;291;529611;514848;59;1044459
84;2020-12-10;103;92;195;486720;439940;69;926660
84;2020-12-10;73;82;155;372151;315211;79;687362
84;2020-12-10;103;48;151;237198;150524;89;387722
84;2020-12-10;86;38;124;81185;28680;90;109865
84;2020-12-10;1261;977;2240;4130719;3901658;0;8032377
93;2020-12-10;18;14;32;268834;283093;09;551927
93;2020-12-10;60;69;129;280751;296087;19;576838
93;2020-12-10;99;63;163;254404;255552;29;509956
93;2020-12-10;80;67;147;310704;288398;39;599102
93;2020-12-10;82;70;152;325559;305827;49;631386
93;2020-12-10;79;66;145;353104;325389;59;678493
93;2020-12-10;58;55;113;336327;296459;69;632786
93;2020-12-10;49;31;80;279820;229699;79;509519
93;2020-12-10;52;34;86;171274;113716;89;284990
93;2020-12-10;40;14;54;58896;21758;90;80654
93;2020-12-10;617;483;1101;2639673;2415978;0;5055651
94;2020-12-10;0;0;0;16311;17433;09;33744
94;2020-12-10;0;0;0;16679;18132;19;34811
94;2020-12-10;0;2;2;16782;16579;29;33361
94;2020-12-10;0;0;0;23044;20580;39;43624
94;2020-12-10;0;0;0;23065;22140;49;45205
94;2020-12-10;1;0;1;24549;23421;59;47970
94;2020-12-10;0;2;2;23212;21883;69;45095
94;2020-12-10;0;0;0;19544;17141;79;36685
94;2020-12-10;1;1;2;11227;8178;89;19405
94;2020-12-10;0;0;0;3332;1447;90;4779
94;2020-12-10;2;5;7;177745;166934;0;344679
01;2020-12-11;0;0;0;19979;20155;09;40134
01;2020-12-11;0;0;0;24994;25489;19;50483
01;2020-12-11;2;0;2;17868;16690;29;34558
01;2020-12-11;1;0;1;22328;14821;39;37149
01;2020-12-11;1;0;1;28652;20276;49;48928
01;2020-12-11;3;0;3;33264;27260;59;60524
01;2020-12-11;2;0;2;27135;23978;69;51113
01;2020-12-11;0;0;0;18401;14661;79;33062
01;2020-12-11;0;0;0;9633;6375;89;16008
01;2020-12-11;0;0;0;3410;1510;90;4920
01;2020-12-11;9;0;9;205664;171215;0;376879
02;2020-12-11;0;0;0;16881;17110;09;33991
02;2020-12-11;1;0;1;21410;21604;19;43014
02;2020-12-11;1;2;3;16017;15479;29;31496
02;2020-12-11;0;0;0;19825;14455;39;34280
02;2020-12-11;2;2;4;24719;18248;49;42967
02;2020-12-11;2;1;3;34361;28310;59;62671
02;2020-12-11;2;1;3;28061;24495;69;52556
02;2020-12-11;2;0;2;18231;15278;79;33509
02;2020-12-11;0;1;1;11090;7677;89;18767
02;2020-12-11;0;0;0;3992;1506;90;5498
02;2020-12-11;10;7;17;194587;164162;0;358749
03;2020-12-11;0;0;0;31123;30920;09;62043
03;2020-12-11;8;5;13;29370;29268;19;58638
03;2020-12-11;10;7;17;21458;18963;29;40421
03;2020-12-11;12;7;19;21276;18326;39;39602
03;2020-12-11;5;6;11;18164;16593;49;34757
03;2020-12-11;4;1;5;13469;13557;59;27026
03;2020-12-11;2;2;4;8776;8670;69;17446
03;2020-12-11;0;1;1;3777;3591;79;7368
03;2020-12-11;0;0;0;1649;1072;89;2721
03;2020-12-11;0;0;0;485;184;90;669
03;2020-12-11;41;29;70;149547;141144;0;290691
04;2020-12-11;1;0;1;60314;61377;09;121691
04;2020-12-11;6;3;9;66065;68387;19;134452
04;2020-12-11;4;2;6;51059;47156;29;98215
04;2020-12-11;4;3;7;58788;45780;39;104568
04;2020-12-11;5;5;10;61408;52207;49;113615
04;2020-12-11;3;4;7;64838;60759;59;125597
04;2020-12-11;2;2;4;47008;42843;69;89851
04;2020-12-11;2;0;2;25509;21184;79;46693
04;2020-12-11;0;0;0;13168;7647;89;20815
04;2020-12-11;0;0;0;3209;1253;90;4462
04;2020-12-11;27;19;46;451366;408593;0;859959
05;2020-12-11;0;0;0;362.366008612902;341.338819562748;09;703.704828175651
05;2020-12-11;0;0;0;353.376145114279;370.349735405642;19;723.725880519921
05;2020-12-11;0;0;0;218.593559489256;256.539602589476;29;475.133162078732
05;2020-12-11;0;0;0;404.225408693299;360.321910454353;39;764.547319147651
05;2020-12-11;0;0;0;520.067953604221;497.108383964256;49;1017.17633756848
05;2020-12-11;0;0;0;468.146063921917;510.087601910415;59;978.233665832332
05;2020-12-11;0;0;0;340.368470050554;334.366842191253;69;674.735312241807
05;2020-12-11;0;0;0;212.598666888387;192.597753227106;79;405.196420115493
05;2020-12-11;0;0;0;148.727797095705;61.8681715431829;89;210.595968638888
05;2020-12-11;0;0;0;32.9601271090696;10.9909785719784;90;43.9511056810479
05;2020-12-11;0;0;0;3061.43020057959;2935.56979942041;0;5997
06;2020-12-11;0;0;0;42583;42380;09;84963
06;2020-12-11;0;0;0;33369;31925;19;65294
06;2020-12-11;3;1;4;21571;15080;29;36651
06;2020-12-11;2;4;6;21550;16147;39;37697
06;2020-12-11;5;2;7;14193;13939;49;28132
06;2020-12-11;2;3;5;7171;7597;59;14768
06;2020-12-11;1;0;1;3629;4117;69;7746
06;2020-12-11;0;0;0;1577;1457;79;3034
06;2020-12-11;0;0;0;531;474;89;1005
06;2020-12-11;0;0;0;88;93;90;181
06;2020-12-11;13;10;23;146262;133209;0;279471
07;2020-12-11;0;0;0;485;549;09;1034
07;2020-12-11;0;0;0;403;432;19;835
07;2020-12-11;0;0;0;764;841;29;1605
07;2020-12-11;0;0;0;824;928;39;1752
07;2020-12-11;0;0;0;788;1020;49;1808
07;2020-12-11;0;0;0;678;870;59;1548
07;2020-12-11;0;0;0;360;382;69;742
07;2020-12-11;0;0;0;231;190;79;421
07;2020-12-11;0;0;0;114;67;89;181
07;2020-12-11;0;0;0;24;11;90;35
07;2020-12-11;0;0;0;4671;5290;0;9961
08;2020-12-11;0;0;0;2715.22592983026;2997.75551488675;09;5712.98144471701
08;2020-12-11;0;0;0;2778.51901080978;3160.9156459093;19;5939.43465671908
08;2020-12-11;1;0;1;2080.8882988764;1718.16634315323;29;3799.05464202964
08;2020-12-11;1;1;2;2701.8582062647;1896.52641413317;39;4598.38462039786
08;2020-12-11;2;0;2;3151.45861023308;2460.52498233809;49;5611.98359257117
08;2020-12-11;1;0;1;2620.29868333099;2422.23566154656;59;5042.53434487755
08;2020-12-11;0;0;0;1621.44173420671;1438.58325779464;69;3060.02499200135
08;2020-12-11;0;0;0;626.575909335673;526.358467843651;79;1152.93437717932
08;2020-12-11;0;0;0;205.018522985054;140.993639349697;89;346.012162334751
08;2020-12-11;0;0;0;50.0325684687745;20.62259870351;90;70.6551671722846
08;2020-12-11;5;1;6;18551.3174743414;16782.6825256586;0;35334
11;2020-12-11;39;50;96;783071;811785;09;1594856
11;2020-12-11;146;160;321;761456;784653;19;1546109
11;2020-12-11;242;187;430;850145;801772;29;1651917
11;2020-12-11;250;225;476;914360;843488;39;1757848
11;2020-12-11;223;187;413;845609;826202;49;1671811
11;2020-12-11;167;175;344;793566;745070;59;1538636
11;2020-12-11;121;110;233;628649;549192;69;1177841
11;2020-12-11;76;69;146;434606;358356;79;792962
11;2020-12-11;58;49;108;261425;162933;89;424358
11;2020-12-11;53;22;75;89253;32619;90;121872
11;2020-12-11;1375;1235;2644;6362140;5916070;0;12278210
24;2020-12-11;6;10;17;139720;144686;09;284406
24;2020-12-11;33;40;73;152979;161185;19;314164
24;2020-12-11;46;32;79;122237;126536;29;248773
24;2020-12-11;42;30;72;150359;142009;39;292368
24;2020-12-11;43;29;72;161829;158758;49;320587
24;2020-12-11;42;25;67;172552;168011;59;340563
24;2020-12-11;26;28;54;172509;158177;69;330686
24;2020-12-11;11;26;37;129428;110593;79;240021
24;2020-12-11;17;8;25;87342;56882;89;144224
24;2020-12-11;10;8;18;31210;12071;90;43281
24;2020-12-11;276;236;514;1320165;1238908;0;2559073
27;2020-12-11;17;13;30;143373;149679;09;293052
27;2020-12-11;48;73;121;160962;173003;19;333965
27;2020-12-11;75;48;123;133746;142254;29;276000
27;2020-12-11;78;54;132;160004;155407;39;315411
27;2020-12-11;68;54;122;172333;169564;49;341897
27;2020-12-11;69;62;131;189979;183788;59;373767
27;2020-12-11;44;49;93;192591;178206;69;370797
27;2020-12-11;47;37;84;146876;127546;79;274422
27;2020-12-11;57;39;96;96896;61575;89;158471
27;2020-12-11;40;14;54;33148;12109;90;45257
27;2020-12-11;543;443;986;1429908;1353131;0;2783039
28;2020-12-11;5;14;19;180735;186856;09;367591
28;2020-12-11;27;18;46;200125;213621;19;413746
28;2020-12-11;35;20;55;168922;173007;29;341929
28;2020-12-11;39;26;65;196628;188487;39;385115
28;2020-12-11;36;19;55;205396;201699;49;407095
28;2020-12-11;38;29;67;222002;213866;59;435868
28;2020-12-11;12;21;33;224688;203758;69;428446
28;2020-12-11;14;22;36;163192;135543;79;298735
28;2020-12-11;37;9;46;109691;65377;89;175068
28;2020-12-11;23;3;26;37222;12685;90;49907
28;2020-12-11;266;181;448;1708601;1594899;0;3303500
32;2020-12-11;27;20;47;358062;373689;09;731751
32;2020-12-11;100;88;188;387045;406742;19;793787
32;2020-12-11;106;85;191;342304;348587;29;690891
32;2020-12-11;113;82;195;382485;369972;39;752457
32;2020-12-11;98;103;201;382510;376716;49;759226
32;2020-12-11;85;92;177;386937;376527;59;763464
32;2020-12-11;55;60;115;371211;330938;69;702149
32;2020-12-11;55;45;100;250542;201459;79;452001
32;2020-12-11;66;32;98;163399;89786;89;253185
32;2020-12-11;40;4;44;48384;15367;90;63751
32;2020-12-11;745;611;1356;3072879;2889783;0;5962662
44;2020-12-11;35;32;68;291525;306839;09;598364
44;2020-12-11;106;86;194;320255;339504;19;659759
44;2020-12-11;153;117;272;302020;314428;29;616448
44;2020-12-11;128;113;241;342222;333292;39;675514
44;2020-12-11;133;102;239;349727;344491;49;694218
44;2020-12-11;155;120;278;381371;373239;59;754610
44;2020-12-11;100;85;185;367165;335850;69;703015
44;2020-12-11;58;70;128;250387;215436;79;465823
44;2020-12-11;80;54;135;170825;105192;89;276017
44;2020-12-11;60;18;78;51248;16731;90;67979
44;2020-12-11;1008;797;1818;2826745;2685002;0;5511747
52;2020-12-11;5;5;10;213594;223900;09;437494
52;2020-12-11;24;30;55;240818;255197;19;496015
52;2020-12-11;28;35;63;197010;200630;29;397640
52;2020-12-11;46;32;79;231204;224885;39;456089
52;2020-12-11;45;43;89;243874;243418;49;487292
52;2020-12-11;42;33;75;244100;239116;59;483216
52;2020-12-11;29;24;53;241796;221345;69;463141
52;2020-12-11;18;16;34;177805;149903;79;327708
52;2020-12-11;58;21;79;119561;75822;89;195383
52;2020-12-11;36;8;44;42559;15260;90;57819
52;2020-12-11;331;247;581;1952321;1849476;0;3801797
53;2020-12-11;4;7;11;173813;182358;09;356171
53;2020-12-11;17;13;31;202720;214740;19;417460
53;2020-12-11;22;31;55;163116;173196;29;336312
53;2020-12-11;20;13;33;190526;187674;39;378200
53;2020-12-11;18;11;29;212098;212015;49;424113
53;2020-12-11;17;12;29;223699;219176;59;442875
53;2020-12-11;14;14;28;227435;209274;69;436709
53;2020-12-11;14;8;22;169992;140910;79;310902
53;2020-12-11;9;9;18;118117;69883;89;188000
53;2020-12-11;5;1;6;37370;12267;90;49637
53;2020-12-11;140;119;262;1718886;1621493;0;3340379
75;2020-12-11;17;17;34;293104;305291;09;598395
75;2020-12-11;56;65;121;337141;357785;19;694926
75;2020-12-11;69;59;129;295024;300618;29;595642
75;2020-12-11;56;52;108;347871;331233;39;679104
75;2020-12-11;68;59;127;384742;372771;49;757513
75;2020-12-11;49;48;97;413361;390880;59;804241
75;2020-12-11;31;43;74;425623;384060;69;809683
75;2020-12-11;28;27;55;325086;276298;79;601384
75;2020-12-11;32;20;52;213986;139308;89;353294
75;2020-12-11;24;7;31;77600;28200;90;105800
75;2020-12-11;430;398;829;3113538;2886444;0;5999982
76;2020-12-11;8;12;22;305956;318589;09;624545
76;2020-12-11;51;52;106;338942;356969;19;695911
76;2020-12-11;62;63;125;316210;319570;29;635780
76;2020-12-11;64;60;124;356758;337587;39;694345
76;2020-12-11;78;64;143;376541;363812;49;740353
76;2020-12-11;55;61;116;402608;383750;59;786358
76;2020-12-11;38;42;80;394889;358997;69;753886
76;2020-12-11;38;33;71;308664;263806;79;572470
76;2020-12-11;40;21;61;195838;129272;89;325110
76;2020-12-11;26;5;31;69372;26728;90;96100
76;2020-12-11;461;413;880;3065778;2859080;0;5924858
84;2020-12-11;46;66;112;459549;481088;09;940637
84;2020-12-11;200;171;375;487711;511905;19;999616
84;2020-12-11;156;142;299;443824;451094;29;894918
84;2020-12-11;204;134;338;512522;493262;39;1005784
84;2020-12-11;181;150;331;520248;515106;49;1035354
84;2020-12-11;147;144;291;529611;514848;59;1044459
84;2020-12-11;119;106;225;486720;439940;69;926660
84;2020-12-11;82;80;162;372151;315211;79;687362
84;2020-12-11;101;44;145;237198;150524;89;387722
84;2020-12-11;86;22;108;81185;28680;90;109865
84;2020-12-11;1322;1059;2386;4130719;3901658;0;8032377
93;2020-12-11;13;13;27;268834;283093;09;551927
93;2020-12-11;71;60;133;280751;296087;19;576838
93;2020-12-11;80;84;164;254404;255552;29;509956
93;2020-12-11;88;74;162;310704;288398;39;599102
93;2020-12-11;95;88;184;325559;305827;49;631386
93;2020-12-11;87;79;166;353104;325389;59;678493
93;2020-12-11;66;51;117;336327;296459;69;632786
93;2020-12-11;37;56;93;279820;229699;79;509519
93;2020-12-11;51;24;75;171274;113716;89;284990
93;2020-12-11;44;13;57;58896;21758;90;80654
93;2020-12-11;632;542;1178;2639673;2415978;0;5055651
94;2020-12-11;0;0;0;16311;17433;09;33744
94;2020-12-11;2;1;3;16679;18132;19;34811
94;2020-12-11;0;1;1;16782;16579;29;33361
94;2020-12-11;0;0;0;23044;20580;39;43624
94;2020-12-11;1;4;5;23065;22140;49;45205
94;2020-12-11;2;0;2;24549;23421;59;47970
94;2020-12-11;1;1;2;23212;21883;69;45095
94;2020-12-11;0;1;1;19544;17141;79;36685
94;2020-12-11;2;0;2;11227;8178;89;19405
94;2020-12-11;3;0;3;3332;1447;90;4779
94;2020-12-11;11;8;19;177745;166934;0;344679
01;2020-12-12;0;0;0;19979;20155;09;40134
01;2020-12-12;0;0;0;24994;25489;19;50483
01;2020-12-12;0;0;0;17868;16690;29;34558
01;2020-12-12;0;0;0;22328;14821;39;37149
01;2020-12-12;2;0;2;28652;20276;49;48928
01;2020-12-12;0;0;0;33264;27260;59;60524
01;2020-12-12;0;0;0;27135;23978;69;51113
01;2020-12-12;0;0;0;18401;14661;79;33062
01;2020-12-12;0;0;0;9633;6375;89;16008
01;2020-12-12;0;0;0;3410;1510;90;4920
01;2020-12-12;2;0;2;205664;171215;0;376879
02;2020-12-12;0;0;0;16881;17110;09;33991
02;2020-12-12;0;0;0;21410;21604;19;43014
02;2020-12-12;1;0;1;16017;15479;29;31496
02;2020-12-12;0;0;0;19825;14455;39;34280
02;2020-12-12;1;0;1;24719;18248;49;42967
02;2020-12-12;1;0;1;34361;28310;59;62671
02;2020-12-12;0;0;0;28061;24495;69;52556
02;2020-12-12;0;0;0;18231;15278;79;33509
02;2020-12-12;0;0;0;11090;7677;89;18767
02;2020-12-12;0;0;0;3992;1506;90;5498
02;2020-12-12;3;0;3;194587;164162;0;358749
03;2020-12-12;0;0;0;31123;30920;09;62043
03;2020-12-12;1;0;1;29370;29268;19;58638
03;2020-12-12;3;7;10;21458;18963;29;40421
03;2020-12-12;4;9;13;21276;18326;39;39602
03;2020-12-12;3;7;11;18164;16593;49;34757
03;2020-12-12;0;3;3;13469;13557;59;27026
03;2020-12-12;0;1;1;8776;8670;69;17446
03;2020-12-12;0;0;0;3777;3591;79;7368
03;2020-12-12;1;0;1;1649;1072;89;2721
03;2020-12-12;0;0;0;485;184;90;669
03;2020-12-12;12;27;40;149547;141144;0;290691
04;2020-12-12;1;1;2;60314;61377;09;121691
04;2020-12-12;2;1;3;66065;68387;19;134452
04;2020-12-12;1;2;3;51059;47156;29;98215
04;2020-12-12;1;0;1;58788;45780;39;104568
04;2020-12-12;0;3;3;61408;52207;49;113615
04;2020-12-12;2;2;4;64838;60759;59;125597
04;2020-12-12;3;2;5;47008;42843;69;89851
04;2020-12-12;0;1;1;25509;21184;79;46693
04;2020-12-12;0;0;0;13168;7647;89;20815
04;2020-12-12;0;0;0;3209;1253;90;4462
04;2020-12-12;10;12;22;451366;408593;0;859959
05;2020-12-12;0;0;0;362.366008612902;341.338819562748;09;703.704828175651
05;2020-12-12;0;0;0;353.376145114279;370.349735405642;19;723.725880519921
05;2020-12-12;0;0;0;218.593559489256;256.539602589476;29;475.133162078732
05;2020-12-12;0;0;0;404.225408693299;360.321910454353;39;764.547319147651
05;2020-12-12;0;0;0;520.067953604221;497.108383964256;49;1017.17633756848
05;2020-12-12;0;0;0;468.146063921917;510.087601910415;59;978.233665832332
05;2020-12-12;0;0;0;340.368470050554;334.366842191253;69;674.735312241807
05;2020-12-12;0;0;0;212.598666888387;192.597753227106;79;405.196420115493
05;2020-12-12;0;0;0;148.727797095705;61.8681715431829;89;210.595968638888
05;2020-12-12;0;0;0;32.9601271090696;10.9909785719784;90;43.9511056810479
05;2020-12-12;0;0;0;3061.43020057959;2935.56979942041;0;5997
06;2020-12-12;0;0;0;42583;42380;09;84963
06;2020-12-12;2;1;3;33369;31925;19;65294
06;2020-12-12;0;3;3;21571;15080;29;36651
06;2020-12-12;2;0;2;21550;16147;39;37697
06;2020-12-12;2;1;3;14193;13939;49;28132
06;2020-12-12;1;0;1;7171;7597;59;14768
06;2020-12-12;1;2;3;3629;4117;69;7746
06;2020-12-12;0;0;0;1577;1457;79;3034
06;2020-12-12;0;0;0;531;474;89;1005
06;2020-12-12;0;0;0;88;93;90;181
06;2020-12-12;8;7;15;146262;133209;0;279471
07;2020-12-12;0;0;0;485;549;09;1034
07;2020-12-12;0;0;0;403;432;19;835
07;2020-12-12;0;0;0;764;841;29;1605
07;2020-12-12;0;0;0;824;928;39;1752
07;2020-12-12;0;0;0;788;1020;49;1808
07;2020-12-12;1;0;1;678;870;59;1548
07;2020-12-12;0;0;0;360;382;69;742
07;2020-12-12;0;0;0;231;190;79;421
07;2020-12-12;0;0;0;114;67;89;181
07;2020-12-12;0;0;0;24;11;90;35
07;2020-12-12;1;0;1;4671;5290;0;9961
08;2020-12-12;0;0;0;2715.22592983026;2997.75551488675;09;5712.98144471701
08;2020-12-12;0;1;1;2778.51901080978;3160.9156459093;19;5939.43465671908
08;2020-12-12;1;0;1;2080.8882988764;1718.16634315323;29;3799.05464202964
08;2020-12-12;0;0;0;2701.8582062647;1896.52641413317;39;4598.38462039786
08;2020-12-12;2;1;3;3151.45861023308;2460.52498233809;49;5611.98359257117
08;2020-12-12;0;0;0;2620.29868333099;2422.23566154656;59;5042.53434487755
08;2020-12-12;0;2;2;1621.44173420671;1438.58325779464;69;3060.02499200135
08;2020-12-12;0;0;0;626.575909335673;526.358467843651;79;1152.93437717932
08;2020-12-12;0;0;0;205.018522985054;140.993639349697;89;346.012162334751
08;2020-12-12;0;0;0;50.0325684687745;20.62259870351;90;70.6551671722846
08;2020-12-12;3;4;7;18551.3174743414;16782.6825256586;0;35334
11;2020-12-12;23;18;44;783071;811785;09;1594856
11;2020-12-12;101;107;211;761456;784653;19;1546109
11;2020-12-12;122;102;224;850145;801772;29;1651917
11;2020-12-12;172;120;292;914360;843488;39;1757848
11;2020-12-12;134;111;247;845609;826202;49;1671811
11;2020-12-12;110;94;204;793566;745070;59;1538636
11;2020-12-12;68;70;138;628649;549192;69;1177841
11;2020-12-12;30;28;58;434606;358356;79;792962
11;2020-12-12;33;35;68;261425;162933;89;424358
11;2020-12-12;22;10;32;89253;32619;90;121872
11;2020-12-12;815;695;1518;6362140;5916070;0;12278210
24;2020-12-12;4;5;9;139720;144686;09;284406
24;2020-12-12;10;16;26;152979;161185;19;314164
24;2020-12-12;26;15;41;122237;126536;29;248773
24;2020-12-12;23;24;47;150359;142009;39;292368
24;2020-12-12;28;18;46;161829;158758;49;320587
24;2020-12-12;22;17;39;172552;168011;59;340563
24;2020-12-12;16;17;33;172509;158177;69;330686
24;2020-12-12;7;11;18;129428;110593;79;240021
24;2020-12-12;8;9;17;87342;56882;89;144224
24;2020-12-12;19;7;26;31210;12071;90;43281
24;2020-12-12;163;139;302;1320165;1238908;0;2559073
27;2020-12-12;12;10;22;143373;149679;09;293052
27;2020-12-12;32;31;63;160962;173003;19;333965
27;2020-12-12;43;40;83;133746;142254;29;276000
27;2020-12-12;63;34;97;160004;155407;39;315411
27;2020-12-12;55;46;101;172333;169564;49;341897
27;2020-12-12;65;39;104;189979;183788;59;373767
27;2020-12-12;38;36;74;192591;178206;69;370797
27;2020-12-12;19;24;43;146876;127546;79;274422
27;2020-12-12;31;13;44;96896;61575;89;158471
27;2020-12-12;20;8;28;33148;12109;90;45257
27;2020-12-12;378;281;659;1429908;1353131;0;2783039
28;2020-12-12;10;12;22;180735;186856;09;367591
28;2020-12-12;12;7;20;200125;213621;19;413746
28;2020-12-12;24;13;37;168922;173007;29;341929
28;2020-12-12;23;22;45;196628;188487;39;385115
28;2020-12-12;16;11;27;205396;201699;49;407095
28;2020-12-12;16;17;33;222002;213866;59;435868
28;2020-12-12;10;10;20;224688;203758;69;428446
28;2020-12-12;13;7;20;163192;135543;79;298735
28;2020-12-12;21;13;34;109691;65377;89;175068
28;2020-12-12;17;7;24;37222;12685;90;49907
28;2020-12-12;162;119;282;1708601;1594899;0;3303500
32;2020-12-12;10;15;25;358062;373689;09;731751
32;2020-12-12;40;37;77;387045;406742;19;793787
32;2020-12-12;76;41;117;342304;348587;29;690891
32;2020-12-12;59;66;125;382485;369972;39;752457
32;2020-12-12;61;38;99;382510;376716;49;759226
32;2020-12-12;56;63;119;386937;376527;59;763464
32;2020-12-12;36;42;78;371211;330938;69;702149
32;2020-12-12;19;24;43;250542;201459;79;452001
32;2020-12-12;28;21;49;163399;89786;89;253185
32;2020-12-12;10;9;19;48384;15367;90;63751
32;2020-12-12;395;356;751;3072879;2889783;0;5962662
44;2020-12-12;24;24;48;291525;306839;09;598364
44;2020-12-12;59;67;126;320255;339504;19;659759
44;2020-12-12;92;54;146;302020;314428;29;616448
44;2020-12-12;84;66;150;342222;333292;39;675514
44;2020-12-12;102;90;192;349727;344491;49;694218
44;2020-12-12;89;78;167;381371;373239;59;754610
44;2020-12-12;44;52;97;367165;335850;69;703015
44;2020-12-12;45;44;89;250387;215436;79;465823
44;2020-12-12;28;28;56;170825;105192;89;276017
44;2020-12-12;20;13;33;51248;16731;90;67979
44;2020-12-12;587;516;1104;2826745;2685002;0;5511747
52;2020-12-12;3;4;7;213594;223900;09;437494
52;2020-12-12;19;13;32;240818;255197;19;496015
52;2020-12-12;18;20;38;197010;200630;29;397640
52;2020-12-12;22;16;38;231204;224885;39;456089
52;2020-12-12;14;15;29;243874;243418;49;487292
52;2020-12-12;28;21;49;244100;239116;59;483216
52;2020-12-12;19;16;35;241796;221345;69;463141
52;2020-12-12;8;8;16;177805;149903;79;327708
52;2020-12-12;13;7;20;119561;75822;89;195383
52;2020-12-12;12;4;16;42559;15260;90;57819
52;2020-12-12;156;124;280;1952321;1849476;0;3801797
53;2020-12-12;2;3;5;173813;182358;09;356171
53;2020-12-12;10;11;21;202720;214740;19;417460
53;2020-12-12;14;18;32;163116;173196;29;336312
53;2020-12-12;11;9;20;190526;187674;39;378200
53;2020-12-12;13;9;22;212098;212015;49;424113
53;2020-12-12;15;5;20;223699;219176;59;442875
53;2020-12-12;9;13;22;227435;209274;69;436709
53;2020-12-12;4;6;10;169992;140910;79;310902
53;2020-12-12;25;3;28;118117;69883;89;188000
53;2020-12-12;7;2;9;37370;12267;90;49637
53;2020-12-12;110;79;189;1718886;1621493;0;3340379
75;2020-12-12;8;9;17;293104;305291;09;598395
75;2020-12-12;40;23;63;337141;357785;19;694926
75;2020-12-12;41;29;70;295024;300618;29;595642
75;2020-12-12;29;26;55;347871;331233;39;679104
75;2020-12-12;40;23;63;384742;372771;49;757513
75;2020-12-12;34;29;63;413361;390880;59;804241
75;2020-12-12;18;16;34;425623;384060;69;809683
75;2020-12-12;15;12;27;325086;276298;79;601384
75;2020-12-12;25;12;37;213986;139308;89;353294
75;2020-12-12;8;3;11;77600;28200;90;105800
75;2020-12-12;258;182;440;3113538;2886444;0;5999982
76;2020-12-12;2;7;9;305956;318589;09;624545
76;2020-12-12;24;24;48;338942;356969;19;695911
76;2020-12-12;27;23;50;316210;319570;29;635780
76;2020-12-12;34;31;65;356758;337587;39;694345
76;2020-12-12;34;36;70;376541;363812;49;740353
76;2020-12-12;31;32;63;402608;383750;59;786358
76;2020-12-12;17;16;33;394889;358997;69;753886
76;2020-12-12;11;13;24;308664;263806;79;572470
76;2020-12-12;9;11;20;195838;129272;89;325110
76;2020-12-12;15;0;15;69372;26728;90;96100
76;2020-12-12;204;193;397;3065778;2859080;0;5924858
84;2020-12-12;14;24;38;459549;481088;09;940637
84;2020-12-12;78;61;139;487711;511905;19;999616
84;2020-12-12;97;64;161;443824;451094;29;894918
84;2020-12-12;91;69;160;512522;493262;39;1005784
84;2020-12-12;98;98;196;520248;515106;49;1035354
84;2020-12-12;89;84;173;529611;514848;59;1044459
84;2020-12-12;53;51;104;486720;439940;69;926660
84;2020-12-12;35;27;62;372151;315211;79;687362
84;2020-12-12;39;29;68;237198;150524;89;387722
84;2020-12-12;19;13;32;81185;28680;90;109865
84;2020-12-12;613;520;1133;4130719;3901658;0;8032377
93;2020-12-12;7;5;12;268834;283093;09;551927
93;2020-12-12;36;42;78;280751;296087;19;576838
93;2020-12-12;66;44;110;254404;255552;29;509956
93;2020-12-12;63;32;98;310704;288398;39;599102
93;2020-12-12;47;46;98;325559;305827;49;631386
93;2020-12-12;61;56;120;353104;325389;59;678493
93;2020-12-12;32;23;55;336327;296459;69;632786
93;2020-12-12;17;26;43;279820;229699;79;509519
93;2020-12-12;24;16;40;171274;113716;89;284990
93;2020-12-12;16;8;24;58896;21758;90;80654
93;2020-12-12;370;298;679;2639673;2415978;0;5055651
94;2020-12-12;0;0;0;16311;17433;09;33744
94;2020-12-12;0;0;0;16679;18132;19;34811
94;2020-12-12;1;0;1;16782;16579;29;33361
94;2020-12-12;1;1;2;23044;20580;39;43624
94;2020-12-12;0;0;0;23065;22140;49;45205
94;2020-12-12;1;0;1;24549;23421;59;47970
94;2020-12-12;1;0;1;23212;21883;69;45095
94;2020-12-12;1;1;2;19544;17141;79;36685
94;2020-12-12;0;0;0;11227;8178;89;19405
94;2020-12-12;0;0;0;3332;1447;90;4779
94;2020-12-12;5;2;7;177745;166934;0;344679
01;2020-12-13;0;0;0;19979;20155;09;40134
01;2020-12-13;1;0;1;24994;25489;19;50483
01;2020-12-13;0;0;0;17868;16690;29;34558
01;2020-12-13;1;1;2;22328;14821;39;37149
01;2020-12-13;0;0;0;28652;20276;49;48928
01;2020-12-13;0;0;0;33264;27260;59;60524
01;2020-12-13;0;0;0;27135;23978;69;51113
01;2020-12-13;0;0;0;18401;14661;79;33062
01;2020-12-13;0;0;0;9633;6375;89;16008
01;2020-12-13;0;0;0;3410;1510;90;4920
01;2020-12-13;2;1;3;205664;171215;0;376879
02;2020-12-13;0;0;0;16881;17110;09;33991
02;2020-12-13;0;0;0;21410;21604;19;43014
02;2020-12-13;0;0;0;16017;15479;29;31496
02;2020-12-13;0;0;0;19825;14455;39;34280
02;2020-12-13;0;0;0;24719;18248;49;42967
02;2020-12-13;0;0;0;34361;28310;59;62671
02;2020-12-13;0;0;0;28061;24495;69;52556
02;2020-12-13;0;0;0;18231;15278;79;33509
02;2020-12-13;0;0;0;11090;7677;89;18767
02;2020-12-13;0;0;0;3992;1506;90;5498
02;2020-12-13;0;0;0;194587;164162;0;358749
03;2020-12-13;0;0;0;31123;30920;09;62043
03;2020-12-13;1;0;1;29370;29268;19;58638
03;2020-12-13;0;5;5;21458;18963;29;40421
03;2020-12-13;2;1;3;21276;18326;39;39602
03;2020-12-13;2;0;2;18164;16593;49;34757
03;2020-12-13;2;3;5;13469;13557;59;27026
03;2020-12-13;1;1;2;8776;8670;69;17446
03;2020-12-13;0;0;0;3777;3591;79;7368
03;2020-12-13;0;0;0;1649;1072;89;2721
03;2020-12-13;0;0;0;485;184;90;669
03;2020-12-13;8;10;18;149547;141144;0;290691
04;2020-12-13;0;0;0;60314;61377;09;121691
04;2020-12-13;1;1;2;66065;68387;19;134452
04;2020-12-13;1;0;1;51059;47156;29;98215
04;2020-12-13;0;0;0;58788;45780;39;104568
04;2020-12-13;2;0;2;61408;52207;49;113615
04;2020-12-13;0;0;0;64838;60759;59;125597
04;2020-12-13;0;1;1;47008;42843;69;89851
04;2020-12-13;0;0;0;25509;21184;79;46693
04;2020-12-13;0;0;0;13168;7647;89;20815
04;2020-12-13;0;0;0;3209;1253;90;4462
04;2020-12-13;4;2;6;451366;408593;0;859959
05;2020-12-13;0;0;0;362.366008612902;341.338819562748;09;703.704828175651
05;2020-12-13;0;0;0;353.376145114279;370.349735405642;19;723.725880519921
05;2020-12-13;0;0;0;218.593559489256;256.539602589476;29;475.133162078732
05;2020-12-13;0;0;0;404.225408693299;360.321910454353;39;764.547319147651
05;2020-12-13;0;0;0;520.067953604221;497.108383964256;49;1017.17633756848
05;2020-12-13;0;0;0;468.146063921917;510.087601910415;59;978.233665832332
05;2020-12-13;0;0;0;340.368470050554;334.366842191253;69;674.735312241807
05;2020-12-13;0;0;0;212.598666888387;192.597753227106;79;405.196420115493
05;2020-12-13;0;0;0;148.727797095705;61.8681715431829;89;210.595968638888
05;2020-12-13;0;0;0;32.9601271090696;10.9909785719784;90;43.9511056810479
05;2020-12-13;0;0;0;3061.43020057959;2935.56979942041;0;5997
06;2020-12-13;0;0;0;42583;42380;09;84963
06;2020-12-13;0;0;0;33369;31925;19;65294
06;2020-12-13;0;0;0;21571;15080;29;36651
06;2020-12-13;0;0;0;21550;16147;39;37697
06;2020-12-13;1;0;1;14193;13939;49;28132
06;2020-12-13;0;0;0;7171;7597;59;14768
06;2020-12-13;0;0;0;3629;4117;69;7746
06;2020-12-13;0;0;0;1577;1457;79;3034
06;2020-12-13;0;0;0;531;474;89;1005
06;2020-12-13;0;1;1;88;93;90;181
06;2020-12-13;1;1;2;146262;133209;0;279471
07;2020-12-13;0;0;0;485;549;09;1034
07;2020-12-13;0;0;0;403;432;19;835
07;2020-12-13;0;0;0;764;841;29;1605
07;2020-12-13;0;0;0;824;928;39;1752
07;2020-12-13;0;0;0;788;1020;49;1808
07;2020-12-13;0;0;0;678;870;59;1548
07;2020-12-13;0;0;0;360;382;69;742
07;2020-12-13;0;0;0;231;190;79;421
07;2020-12-13;0;0;0;114;67;89;181
07;2020-12-13;0;0;0;24;11;90;35
07;2020-12-13;0;0;0;4671;5290;0;9961
08;2020-12-13;0;0;0;2715.22592983026;2997.75551488675;09;5712.98144471701
08;2020-12-13;0;0;0;2778.51901080978;3160.9156459093;19;5939.43465671908
08;2020-12-13;1;0;1;2080.8882988764;1718.16634315323;29;3799.05464202964
08;2020-12-13;0;0;0;2701.8582062647;1896.52641413317;39;4598.38462039786
08;2020-12-13;1;0;1;3151.45861023308;2460.52498233809;49;5611.98359257117
08;2020-12-13;0;0;0;2620.29868333099;2422.23566154656;59;5042.53434487755
08;2020-12-13;0;1;1;1621.44173420671;1438.58325779464;69;3060.02499200135
08;2020-12-13;0;1;1;626.575909335673;526.358467843651;79;1152.93437717932
08;2020-12-13;0;0;0;205.018522985054;140.993639349697;89;346.012162334751
08;2020-12-13;0;0;0;50.0325684687745;20.62259870351;90;70.6551671722846
08;2020-12-13;2;2;4;18551.3174743414;16782.6825256586;0;35334
11;2020-12-13;4;7;11;783071;811785;09;1594856
11;2020-12-13;21;22;43;761456;784653;19;1546109
11;2020-12-13;39;33;72;850145;801772;29;1651917
11;2020-12-13;36;36;72;914360;843488;39;1757848
11;2020-12-13;31;34;65;845609;826202;49;1671811
11;2020-12-13;33;30;63;793566;745070;59;1538636
11;2020-12-13;14;18;32;628649;549192;69;1177841
11;2020-12-13;9;17;26;434606;358356;79;792962
11;2020-12-13;15;20;35;261425;162933;89;424358
11;2020-12-13;14;3;17;89253;32619;90;121872
11;2020-12-13;216;220;437;6362140;5916070;0;12278210
24;2020-12-13;0;1;1;139720;144686;09;284406
24;2020-12-13;3;3;6;152979;161185;19;314164
24;2020-12-13;8;3;11;122237;126536;29;248773
24;2020-12-13;4;7;11;150359;142009;39;292368
24;2020-12-13;5;5;10;161829;158758;49;320587
24;2020-12-13;7;5;12;172552;168011;59;340563
24;2020-12-13;6;6;12;172509;158177;69;330686
24;2020-12-13;2;4;6;129428;110593;79;240021
24;2020-12-13;7;3;10;87342;56882;89;144224
24;2020-12-13;3;1;4;31210;12071;90;43281
24;2020-12-13;45;38;83;1320165;1238908;0;2559073
27;2020-12-13;3;0;3;143373;149679;09;293052
27;2020-12-13;6;6;12;160962;173003;19;333965
27;2020-12-13;5;4;9;133746;142254;29;276000
27;2020-12-13;9;4;13;160004;155407;39;315411
27;2020-12-13;9;5;14;172333;169564;49;341897
27;2020-12-13;6;8;14;189979;183788;59;373767
27;2020-12-13;4;10;14;192591;178206;69;370797
27;2020-12-13;8;10;18;146876;127546;79;274422
27;2020-12-13;14;11;25;96896;61575;89;158471
27;2020-12-13;14;4;18;33148;12109;90;45257
27;2020-12-13;78;62;140;1429908;1353131;0;2783039
28;2020-12-13;6;2;8;180735;186856;09;367591
28;2020-12-13;2;3;5;200125;213621;19;413746
28;2020-12-13;6;6;12;168922;173007;29;341929
28;2020-12-13;8;1;9;196628;188487;39;385115
28;2020-12-13;7;8;15;205396;201699;49;407095
28;2020-12-13;8;8;16;222002;213866;59;435868
28;2020-12-13;4;6;10;224688;203758;69;428446
28;2020-12-13;2;4;6;163192;135543;79;298735
28;2020-12-13;9;2;11;109691;65377;89;175068
28;2020-12-13;1;1;2;37222;12685;90;49907
28;2020-12-13;53;41;94;1708601;1594899;0;3303500
32;2020-12-13;3;2;5;358062;373689;09;731751
32;2020-12-13;6;8;14;387045;406742;19;793787
32;2020-12-13;17;8;25;342304;348587;29;690891
32;2020-12-13;9;11;20;382485;369972;39;752457
32;2020-12-13;14;10;24;382510;376716;49;759226
32;2020-12-13;8;12;20;386937;376527;59;763464
32;2020-12-13;3;6;9;371211;330938;69;702149
32;2020-12-13;5;11;16;250542;201459;79;452001
32;2020-12-13;10;6;16;163399;89786;89;253185
32;2020-12-13;7;2;9;48384;15367;90;63751
32;2020-12-13;82;76;158;3072879;2889783;0;5962662
44;2020-12-13;0;1;1;291525;306839;09;598364
44;2020-12-13;8;8;16;320255;339504;19;659759
44;2020-12-13;12;12;24;302020;314428;29;616448
44;2020-12-13;25;12;37;342222;333292;39;675514
44;2020-12-13;21;10;31;349727;344491;49;694218
44;2020-12-13;14;7;21;381371;373239;59;754610
44;2020-12-13;11;8;19;367165;335850;69;703015
44;2020-12-13;11;12;23;250387;215436;79;465823
44;2020-12-13;13;20;33;170825;105192;89;276017
44;2020-12-13;13;4;17;51248;16731;90;67979
44;2020-12-13;128;94;222;2826745;2685002;0;5511747
52;2020-12-13;4;2;7;213594;223900;09;437494
52;2020-12-13;1;9;11;240818;255197;19;496015
52;2020-12-13;9;8;17;197010;200630;29;397640
52;2020-12-13;12;5;17;231204;224885;39;456089
52;2020-12-13;7;8;15;243874;243418;49;487292
52;2020-12-13;4;6;10;244100;239116;59;483216
52;2020-12-13;6;10;16;241796;221345;69;463141
52;2020-12-13;4;9;13;177805;149903;79;327708
52;2020-12-13;8;1;9;119561;75822;89;195383
52;2020-12-13;5;2;7;42559;15260;90;57819
52;2020-12-13;60;60;122;1952321;1849476;0;3801797
53;2020-12-13;0;1;1;173813;182358;09;356171
53;2020-12-13;2;0;2;202720;214740;19;417460
53;2020-12-13;3;4;7;163116;173196;29;336312
53;2020-12-13;5;6;11;190526;187674;39;378200
53;2020-12-13;2;5;7;212098;212015;49;424113
53;2020-12-13;4;1;5;223699;219176;59;442875
53;2020-12-13;1;2;3;227435;209274;69;436709
53;2020-12-13;2;1;3;169992;140910;79;310902
53;2020-12-13;9;0;9;118117;69883;89;188000
53;2020-12-13;9;2;11;37370;12267;90;49637
53;2020-12-13;37;22;59;1718886;1621493;0;3340379
75;2020-12-13;0;2;2;293104;305291;09;598395
75;2020-12-13;5;3;8;337141;357785;19;694926
75;2020-12-13;7;5;12;295024;300618;29;595642
75;2020-12-13;6;4;10;347871;331233;39;679104
75;2020-12-13;3;11;14;384742;372771;49;757513
75;2020-12-13;7;7;14;413361;390880;59;804241
75;2020-12-13;4;6;10;425623;384060;69;809683
75;2020-12-13;4;6;10;325086;276298;79;601384
75;2020-12-13;10;4;14;213986;139308;89;353294
75;2020-12-13;7;3;10;77600;28200;90;105800
75;2020-12-13;53;51;104;3113538;2886444;0;5999982
76;2020-12-13;1;0;1;305956;318589;09;624545
76;2020-12-13;5;4;9;338942;356969;19;695911
76;2020-12-13;15;8;23;316210;319570;29;635780
76;2020-12-13;8;7;15;356758;337587;39;694345
76;2020-12-13;19;6;25;376541;363812;49;740353
76;2020-12-13;7;7;14;402608;383750;59;786358
76;2020-12-13;7;9;16;394889;358997;69;753886
76;2020-12-13;8;7;15;308664;263806;79;572470
76;2020-12-13;12;6;18;195838;129272;89;325110
76;2020-12-13;9;7;16;69372;26728;90;96100
76;2020-12-13;91;61;152;3065778;2859080;0;5924858
84;2020-12-13;2;1;3;459549;481088;09;940637
84;2020-12-13;9;9;18;487711;511905;19;999616
84;2020-12-13;20;10;30;443824;451094;29;894918
84;2020-12-13;21;19;40;512522;493262;39;1005784
84;2020-12-13;12;12;24;520248;515106;49;1035354
84;2020-12-13;14;10;24;529611;514848;59;1044459
84;2020-12-13;11;11;22;486720;439940;69;926660
84;2020-12-13;10;9;19;372151;315211;79;687362
84;2020-12-13;23;16;39;237198;150524;89;387722
84;2020-12-13;13;10;23;81185;28680;90;109865
84;2020-12-13;135;107;242;4130719;3901658;0;8032377
93;2020-12-13;1;1;2;268834;283093;09;551927
93;2020-12-13;6;11;17;280751;296087;19;576838
93;2020-12-13;15;7;22;254404;255552;29;509956
93;2020-12-13;14;15;29;310704;288398;39;599102
93;2020-12-13;13;14;27;325559;305827;49;631386
93;2020-12-13;8;11;19;353104;325389;59;678493
93;2020-12-13;6;13;19;336327;296459;69;632786
93;2020-12-13;10;12;22;279820;229699;79;509519
93;2020-12-13;12;8;20;171274;113716;89;284990
93;2020-12-13;6;4;10;58896;21758;90;80654
93;2020-12-13;91;96;187;2639673;2415978;0;5055651
94;2020-12-13;0;0;0;16311;17433;09;33744
94;2020-12-13;0;0;0;16679;18132;19;34811
94;2020-12-13;0;0;0;16782;16579;29;33361
94;2020-12-13;0;0;0;23044;20580;39;43624
94;2020-12-13;0;0;0;23065;22140;49;45205
94;2020-12-13;0;0;0;24549;23421;59;47970
94;2020-12-13;0;0;0;23212;21883;69;45095
94;2020-12-13;0;0;0;19544;17141;79;36685
94;2020-12-13;0;0;0;11227;8178;89;19405
94;2020-12-13;0;0;0;3332;1447;90;4779
94;2020-12-13;0;0;0;177745;166934;0;344679
01;2020-12-14;0;0;0;19979;20155;09;40134
01;2020-12-14;1;1;2;24994;25489;19;50483
01;2020-12-14;1;1;2;17868;16690;29;34558
01;2020-12-14;2;1;3;22328;14821;39;37149
01;2020-12-14;1;0;1;28652;20276;49;48928
01;2020-12-14;1;0;1;33264;27260;59;60524
01;2020-12-14;0;1;1;27135;23978;69;51113
01;2020-12-14;0;1;1;18401;14661;79;33062
01;2020-12-14;0;0;0;9633;6375;89;16008
01;2020-12-14;0;0;0;3410;1510;90;4920
01;2020-12-14;6;5;11;205664;171215;0;376879
02;2020-12-14;0;0;0;16881;17110;09;33991
02;2020-12-14;1;0;1;21410;21604;19;43014
02;2020-12-14;3;1;4;16017;15479;29;31496
02;2020-12-14;1;1;2;19825;14455;39;34280
02;2020-12-14;1;0;1;24719;18248;49;42967
02;2020-12-14;1;1;2;34361;28310;59;62671
02;2020-12-14;1;2;3;28061;24495;69;52556
02;2020-12-14;2;1;3;18231;15278;79;33509
02;2020-12-14;1;0;1;11090;7677;89;18767
02;2020-12-14;0;1;1;3992;1506;90;5498
02;2020-12-14;11;7;18;194587;164162;0;358749
03;2020-12-14;0;0;0;31123;30920;09;62043
03;2020-12-14;7;2;9;29370;29268;19;58638
03;2020-12-14;7;7;14;21458;18963;29;40421
03;2020-12-14;18;15;33;21276;18326;39;39602
03;2020-12-14;11;12;23;18164;16593;49;34757
03;2020-12-14;12;6;18;13469;13557;59;27026
03;2020-12-14;5;4;9;8776;8670;69;17446
03;2020-12-14;2;1;3;3777;3591;79;7368
03;2020-12-14;0;0;0;1649;1072;89;2721
03;2020-12-14;0;0;0;485;184;90;669
03;2020-12-14;62;47;109;149547;141144;0;290691
04;2020-12-14;1;0;1;60314;61377;09;121691
04;2020-12-14;2;5;7;66065;68387;19;134452
04;2020-12-14;8;4;12;51059;47156;29;98215
04;2020-12-14;4;1;5;58788;45780;39;104568
04;2020-12-14;2;3;5;61408;52207;49;113615
04;2020-12-14;5;3;8;64838;60759;59;125597
04;2020-12-14;0;3;3;47008;42843;69;89851
04;2020-12-14;1;2;3;25509;21184;79;46693
04;2020-12-14;0;1;1;13168;7647;89;20815
04;2020-12-14;0;0;0;3209;1253;90;4462
04;2020-12-14;23;22;45;451366;408593;0;859959
05;2020-12-14;0;0;0;362.366008612902;341.338819562748;09;703.704828175651
05;2020-12-14;0;0;0;353.376145114279;370.349735405642;19;723.725880519921
05;2020-12-14;0;0;0;218.593559489256;256.539602589476;29;475.133162078732
05;2020-12-14;0;0;0;404.225408693299;360.321910454353;39;764.547319147651
05;2020-12-14;0;0;0;520.067953604221;497.108383964256;49;1017.17633756848
05;2020-12-14;0;0;0;468.146063921917;510.087601910415;59;978.233665832332
05;2020-12-14;0;0;0;340.368470050554;334.366842191253;69;674.735312241807
05;2020-12-14;0;0;0;212.598666888387;192.597753227106;79;405.196420115493
05;2020-12-14;0;0;0;148.727797095705;61.8681715431829;89;210.595968638888
05;2020-12-14;0;0;0;32.9601271090696;10.9909785719784;90;43.9511056810479
05;2020-12-14;0;0;0;3061.43020057959;2935.56979942041;0;5997
06;2020-12-14;0;0;0;42583;42380;09;84963
06;2020-12-14;2;0;2;33369;31925;19;65294
06;2020-12-14;2;2;4;21571;15080;29;36651
06;2020-12-14;6;1;7;21550;16147;39;37697
06;2020-12-14;1;3;4;14193;13939;49;28132
06;2020-12-14;0;2;2;7171;7597;59;14768
06;2020-12-14;1;4;5;3629;4117;69;7746
06;2020-12-14;0;1;1;1577;1457;79;3034
06;2020-12-14;1;0;1;531;474;89;1005
06;2020-12-14;0;0;0;88;93;90;181
06;2020-12-14;13;13;26;146262;133209;0;279471
07;2020-12-14;0;0;0;485;549;09;1034
07;2020-12-14;0;0;0;403;432;19;835
07;2020-12-14;0;0;0;764;841;29;1605
07;2020-12-14;0;0;0;824;928;39;1752
07;2020-12-14;0;0;0;788;1020;49;1808
07;2020-12-14;0;0;0;678;870;59;1548
07;2020-12-14;0;0;0;360;382;69;742
07;2020-12-14;0;0;0;231;190;79;421
07;2020-12-14;0;0;0;114;67;89;181
07;2020-12-14;0;0;0;24;11;90;35
07;2020-12-14;0;0;0;4671;5290;0;9961
08;2020-12-14;0;0;0;2715.22592983026;2997.75551488675;09;5712.98144471701
08;2020-12-14;0;0;0;2778.51901080978;3160.9156459093;19;5939.43465671908
08;2020-12-14;0;0;0;2080.8882988764;1718.16634315323;29;3799.05464202964
08;2020-12-14;0;2;2;2701.8582062647;1896.52641413317;39;4598.38462039786
08;2020-12-14;1;0;1;3151.45861023308;2460.52498233809;49;5611.98359257117
08;2020-12-14;3;0;3;2620.29868333099;2422.23566154656;59;5042.53434487755
08;2020-12-14;2;0;2;1621.44173420671;1438.58325779464;69;3060.02499200135
08;2020-12-14;0;0;0;626.575909335673;526.358467843651;79;1152.93437717932
08;2020-12-14;0;0;0;205.018522985054;140.993639349697;89;346.012162334751
08;2020-12-14;0;0;0;50.0325684687745;20.62259870351;90;70.6551671722846
08;2020-12-14;6;2;8;18551.3174743414;16782.6825256586;0;35334
11;2020-12-14;43;50;97;783071;811785;09;1594856
11;2020-12-14;195;159;371;761456;784653;19;1546109
11;2020-12-14;304;265;572;850145;801772;29;1651917
11;2020-12-14;366;294;661;914360;843488;39;1757848
11;2020-12-14;312;253;566;845609;826202;49;1671811
11;2020-12-14;244;231;477;793566;745070;59;1538636
11;2020-12-14;177;186;367;628649;549192;69;1177841
11;2020-12-14;92;84;176;434606;358356;79;792962
11;2020-12-14;97;71;168;261425;162933;89;424358
11;2020-12-14;89;22;111;89253;32619;90;121872
11;2020-12-14;1920;1616;3568;6362140;5916070;0;12278210
24;2020-12-14;10;5;15;139720;144686;09;284406
24;2020-12-14;36;29;66;152979;161185;19;314164
24;2020-12-14;53;34;87;122237;126536;29;248773
24;2020-12-14;44;41;85;150359;142009;39;292368
24;2020-12-14;45;49;94;161829;158758;49;320587
24;2020-12-14;44;41;85;172552;168011;59;340563
24;2020-12-14;26;33;59;172509;158177;69;330686
24;2020-12-14;24;22;46;129428;110593;79;240021
24;2020-12-14;45;17;62;87342;56882;89;144224
24;2020-12-14;36;12;48;31210;12071;90;43281
24;2020-12-14;363;283;647;1320165;1238908;0;2559073
27;2020-12-14;17;17;34;143373;149679;09;293052
27;2020-12-14;88;70;158;160962;173003;19;333965
27;2020-12-14;96;66;162;133746;142254;29;276000
27;2020-12-14;116;73;189;160004;155407;39;315411
27;2020-12-14;117;69;186;172333;169564;49;341897
27;2020-12-14;128;83;211;189979;183788;59;373767
27;2020-12-14;82;78;160;192591;178206;69;370797
27;2020-12-14;48;60;108;146876;127546;79;274422
27;2020-12-14;68;43;111;96896;61575;89;158471
27;2020-12-14;67;10;77;33148;12109;90;45257
27;2020-12-14;827;569;1396;1429908;1353131;0;2783039
28;2020-12-14;11;11;22;180735;186856;09;367591
28;2020-12-14;46;36;82;200125;213621;19;413746
28;2020-12-14;51;37;88;168922;173007;29;341929
28;2020-12-14;61;46;107;196628;188487;39;385115
28;2020-12-14;59;44;104;205396;201699;49;407095
28;2020-12-14;65;45;110;222002;213866;59;435868
28;2020-12-14;28;22;50;224688;203758;69;428446
28;2020-12-14;31;17;48;163192;135543;79;298735
28;2020-12-14;35;25;60;109691;65377;89;175068
28;2020-12-14;34;11;45;37222;12685;90;49907
28;2020-12-14;421;294;716;1708601;1594899;0;3303500
32;2020-12-14;25;27;52;358062;373689;09;731751
32;2020-12-14;111;80;191;387045;406742;19;793787
32;2020-12-14;143;100;243;342304;348587;29;690891
32;2020-12-14;130;112;242;382485;369972;39;752457
32;2020-12-14;124;112;236;382510;376716;49;759226
32;2020-12-14;150;104;254;386937;376527;59;763464
32;2020-12-14;96;90;186;371211;330938;69;702149
32;2020-12-14;62;64;126;250542;201459;79;452001
32;2020-12-14;79;47;126;163399;89786;89;253185
32;2020-12-14;69;17;86;48384;15367;90;63751
32;2020-12-14;989;753;1742;3072879;2889783;0;5962662
44;2020-12-14;32;49;81;291525;306839;09;598364
44;2020-12-14;128;132;262;320255;339504;19;659759
44;2020-12-14;218;119;338;302020;314428;29;616448
44;2020-12-14;241;187;430;342222;333292;39;675514
44;2020-12-14;220;167;389;349727;344491;49;694218
44;2020-12-14;190;192;383;381371;373239;59;754610
44;2020-12-14;119;121;242;367165;335850;69;703015
44;2020-12-14;102;62;164;250387;215436;79;465823
44;2020-12-14;121;76;198;170825;105192;89;276017
44;2020-12-14;78;29;109;51248;16731;90;67979
44;2020-12-14;1449;1134;2596;2826745;2685002;0;5511747
52;2020-12-14;7;14;23;213594;223900;09;437494
52;2020-12-14;33;29;63;240818;255197;19;496015
52;2020-12-14;68;21;89;197010;200630;29;397640
52;2020-12-14;50;46;96;231204;224885;39;456089
52;2020-12-14;51;57;108;243874;243418;49;487292
52;2020-12-14;50;34;84;244100;239116;59;483216
52;2020-12-14;34;26;60;241796;221345;69;463141
52;2020-12-14;32;17;49;177805;149903;79;327708
52;2020-12-14;28;20;48;119561;75822;89;195383
52;2020-12-14;32;14;46;42559;15260;90;57819
52;2020-12-14;385;278;666;1952321;1849476;0;3801797
53;2020-12-14;7;5;14;173813;182358;09;356171
53;2020-12-14;25;19;44;202720;214740;19;417460
53;2020-12-14;35;17;54;163116;173196;29;336312
53;2020-12-14;32;9;41;190526;187674;39;378200
53;2020-12-14;25;12;37;212098;212015;49;424113
53;2020-12-14;26;23;49;223699;219176;59;442875
53;2020-12-14;15;13;28;227435;209274;69;436709
53;2020-12-14;26;22;48;169992;140910;79;310902
53;2020-12-14;24;15;39;118117;69883;89;188000
53;2020-12-14;24;10;35;37370;12267;90;49637
53;2020-12-14;239;145;389;1718886;1621493;0;3340379
75;2020-12-14;16;12;29;293104;305291;09;598395
75;2020-12-14;70;61;131;337141;357785;19;694926
75;2020-12-14;84;46;131;295024;300618;29;595642
75;2020-12-14;88;66;155;347871;331233;39;679104
75;2020-12-14;94;69;163;384742;372771;49;757513
75;2020-12-14;113;78;191;413361;390880;59;804241
75;2020-12-14;64;58;122;425623;384060;69;809683
75;2020-12-14;40;45;85;325086;276298;79;601384
75;2020-12-14;56;34;90;213986;139308;89;353294
75;2020-12-14;60;21;81;77600;28200;90;105800
75;2020-12-14;685;490;1178;3113538;2886444;0;5999982
76;2020-12-14;19;17;37;305956;318589;09;624545
76;2020-12-14;67;45;113;338942;356969;19;695911
76;2020-12-14;86;71;157;316210;319570;29;635780
76;2020-12-14;94;76;170;356758;337587;39;694345
76;2020-12-14;99;76;175;376541;363812;49;740353
76;2020-12-14;89;75;164;402608;383750;59;786358
76;2020-12-14;53;56;109;394889;358997;69;753886
76;2020-12-14;48;37;85;308664;263806;79;572470
76;2020-12-14;57;29;86;195838;129272;89;325110
76;2020-12-14;35;7;42;69372;26728;90;96100
76;2020-12-14;648;489;1139;3065778;2859080;0;5924858
84;2020-12-14;48;42;90;459549;481088;09;940637
84;2020-12-14;241;261;504;487711;511905;19;999616
84;2020-12-14;255;177;432;443824;451094;29;894918
84;2020-12-14;277;225;502;512522;493262;39;1005784
84;2020-12-14;289;210;500;520248;515106;49;1035354
84;2020-12-14;270;196;466;529611;514848;59;1044459
84;2020-12-14;151;177;328;486720;439940;69;926660
84;2020-12-14;125;115;240;372151;315211;79;687362
84;2020-12-14;174;69;243;237198;150524;89;387722
84;2020-12-14;152;32;184;81185;28680;90;109865
84;2020-12-14;1982;1504;3490;4130719;3901658;0;8032377
93;2020-12-14;31;14;45;268834;283093;09;551927
93;2020-12-14;102;98;200;280751;296087;19;576838
93;2020-12-14;158;118;276;254404;255552;29;509956
93;2020-12-14;142;119;262;310704;288398;39;599102
93;2020-12-14;164;123;287;325559;305827;49;631386
93;2020-12-14;155;124;279;353104;325389;59;678493
93;2020-12-14;79;91;170;336327;296459;69;632786
93;2020-12-14;71;53;124;279820;229699;79;509519
93;2020-12-14;90;49;139;171274;113716;89;284990
93;2020-12-14;74;21;95;58896;21758;90;80654
93;2020-12-14;1066;810;1878;2639673;2415978;0;5055651
94;2020-12-14;0;0;0;16311;17433;09;33744
94;2020-12-14;1;0;1;16679;18132;19;34811
94;2020-12-14;1;2;3;16782;16579;29;33361
94;2020-12-14;1;0;1;23044;20580;39;43624
94;2020-12-14;2;0;2;23065;22140;49;45205
94;2020-12-14;0;1;1;24549;23421;59;47970
94;2020-12-14;0;0;0;23212;21883;69;45095
94;2020-12-14;2;1;3;19544;17141;79;36685
94;2020-12-14;0;0;0;11227;8178;89;19405
94;2020-12-14;0;0;0;3332;1447;90;4779
94;2020-12-14;7;4;12;177745;166934;0;344679
01;2020-12-15;0;1;1;19979;20155;09;40134
01;2020-12-15;0;0;0;24994;25489;19;50483
01;2020-12-15;2;0;2;17868;16690;29;34558
01;2020-12-15;1;2;3;22328;14821;39;37149
01;2020-12-15;3;2;5;28652;20276;49;48928
01;2020-12-15;0;0;0;33264;27260;59;60524
01;2020-12-15;0;0;0;27135;23978;69;51113
01;2020-12-15;0;0;0;18401;14661;79;33062
01;2020-12-15;0;1;1;9633;6375;89;16008
01;2020-12-15;0;0;0;3410;1510;90;4920
01;2020-12-15;6;6;12;205664;171215;0;376879
02;2020-12-15;0;0;0;16881;17110;09;33991
02;2020-12-15;0;0;0;21410;21604;19;43014
02;2020-12-15;1;0;1;16017;15479;29;31496
02;2020-12-15;1;2;3;19825;14455;39;34280
02;2020-12-15;0;0;0;24719;18248;49;42967
02;2020-12-15;3;0;3;34361;28310;59;62671
02;2020-12-15;1;2;3;28061;24495;69;52556
02;2020-12-15;1;1;2;18231;15278;79;33509
02;2020-12-15;0;0;0;11090;7677;89;18767
02;2020-12-15;0;0;0;3992;1506;90;5498
02;2020-12-15;7;5;12;194587;164162;0;358749
03;2020-12-15;2;2;4;31123;30920;09;62043
03;2020-12-15;6;7;13;29370;29268;19;58638
03;2020-12-15;9;13;22;21458;18963;29;40421
03;2020-12-15;25;13;38;21276;18326;39;39602
03;2020-12-15;7;8;15;18164;16593;49;34757
03;2020-12-15;9;5;14;13469;13557;59;27026
03;2020-12-15;0;3;3;8776;8670;69;17446
03;2020-12-15;1;3;4;3777;3591;79;7368
03;2020-12-15;0;1;1;1649;1072;89;2721
03;2020-12-15;0;0;0;485;184;90;669
03;2020-12-15;59;55;114;149547;141144;0;290691
04;2020-12-15;2;3;5;60314;61377;09;121691
04;2020-12-15;4;6;10;66065;68387;19;134452
04;2020-12-15;4;4;8;51059;47156;29;98215
04;2020-12-15;6;4;10;58788;45780;39;104568
04;2020-12-15;8;3;11;61408;52207;49;113615
04;2020-12-15;8;3;11;64838;60759;59;125597
04;2020-12-15;2;2;4;47008;42843;69;89851
04;2020-12-15;0;1;1;25509;21184;79;46693
04;2020-12-15;0;1;1;13168;7647;89;20815
04;2020-12-15;0;0;0;3209;1253;90;4462
04;2020-12-15;34;27;61;451366;408593;0;859959
05;2020-12-15;0;0;0;362.366008612902;341.338819562748;09;703.704828175651
05;2020-12-15;0;0;0;353.376145114279;370.349735405642;19;723.725880519921
05;2020-12-15;0;0;0;218.593559489256;256.539602589476;29;475.133162078732
05;2020-12-15;0;0;0;404.225408693299;360.321910454353;39;764.547319147651
05;2020-12-15;0;0;0;520.067953604221;497.108383964256;49;1017.17633756848
05;2020-12-15;0;0;0;468.146063921917;510.087601910415;59;978.233665832332
05;2020-12-15;0;0;0;340.368470050554;334.366842191253;69;674.735312241807
05;2020-12-15;0;0;0;212.598666888387;192.597753227106;79;405.196420115493
05;2020-12-15;0;0;0;148.727797095705;61.8681715431829;89;210.595968638888
05;2020-12-15;0;0;0;32.9601271090696;10.9909785719784;90;43.9511056810479
05;2020-12-15;0;0;0;3061.43020057959;2935.56979942041;0;5997
06;2020-12-15;0;0;0;42583;42380;09;84963
06;2020-12-15;1;4;5;33369;31925;19;65294
06;2020-12-15;1;1;2;21571;15080;29;36651
06;2020-12-15;4;6;10;21550;16147;39;37697
06;2020-12-15;3;1;4;14193;13939;49;28132
06;2020-12-15;4;2;6;7171;7597;59;14768
06;2020-12-15;1;1;2;3629;4117;69;7746
06;2020-12-15;0;0;0;1577;1457;79;3034
06;2020-12-15;0;0;0;531;474;89;1005
06;2020-12-15;0;0;0;88;93;90;181
06;2020-12-15;14;15;29;146262;133209;0;279471
07;2020-12-15;0;0;0;485;549;09;1034
07;2020-12-15;0;0;0;403;432;19;835
07;2020-12-15;0;0;0;764;841;29;1605
07;2020-12-15;0;0;0;824;928;39;1752
07;2020-12-15;0;0;0;788;1020;49;1808
07;2020-12-15;0;0;0;678;870;59;1548
07;2020-12-15;0;0;0;360;382;69;742
07;2020-12-15;0;0;0;231;190;79;421
07;2020-12-15;0;0;0;114;67;89;181
07;2020-12-15;0;0;0;24;11;90;35
07;2020-12-15;0;0;0;4671;5290;0;9961
08;2020-12-15;0;0;0;2715.22592983026;2997.75551488675;09;5712.98144471701
08;2020-12-15;0;0;0;2778.51901080978;3160.9156459093;19;5939.43465671908
08;2020-12-15;0;0;0;2080.8882988764;1718.16634315323;29;3799.05464202964
08;2020-12-15;0;0;0;2701.8582062647;1896.52641413317;39;4598.38462039786
08;2020-12-15;1;1;2;3151.45861023308;2460.52498233809;49;5611.98359257117
08;2020-12-15;0;1;1;2620.29868333099;2422.23566154656;59;5042.53434487755
08;2020-12-15;0;0;0;1621.44173420671;1438.58325779464;69;3060.02499200135
08;2020-12-15;0;0;0;626.575909335673;526.358467843651;79;1152.93437717932
08;2020-12-15;0;0;0;205.018522985054;140.993639349697;89;346.012162334751
08;2020-12-15;0;0;0;50.0325684687745;20.62259870351;90;70.6551671722846
08;2020-12-15;1;2;3;18551.3174743414;16782.6825256586;0;35334
11;2020-12-15;34;43;81;783071;811785;09;1594856
11;2020-12-15;164;134;311;761456;784653;19;1546109
11;2020-12-15;280;213;494;850145;801772;29;1651917
11;2020-12-15;252;228;482;914360;843488;39;1757848
11;2020-12-15;215;215;431;845609;826202;49;1671811
11;2020-12-15;210;181;392;793566;745070;59;1538636
11;2020-12-15;122;109;231;628649;549192;69;1177841
11;2020-12-15;87;76;163;434606;358356;79;792962
11;2020-12-15;88;40;128;261425;162933;89;424358
11;2020-12-15;88;21;109;89253;32619;90;121872
11;2020-12-15;1540;1263;2826;6362140;5916070;0;12278210
24;2020-12-15;6;11;18;139720;144686;09;284406
24;2020-12-15;47;34;82;152979;161185;19;314164
24;2020-12-15;46;32;78;122237;126536;29;248773
24;2020-12-15;47;45;92;150359;142009;39;292368
24;2020-12-15;58;35;93;161829;158758;49;320587
24;2020-12-15;33;50;83;172552;168011;59;340563
24;2020-12-15;22;26;48;172509;158177;69;330686
24;2020-12-15;19;22;41;129428;110593;79;240021
24;2020-12-15;48;17;65;87342;56882;89;144224
24;2020-12-15;33;11;44;31210;12071;90;43281
24;2020-12-15;360;283;645;1320165;1238908;0;2559073
27;2020-12-15;15;20;35;143373;149679;09;293052
27;2020-12-15;56;71;127;160962;173003;19;333965
27;2020-12-15;114;67;181;133746;142254;29;276000
27;2020-12-15;90;60;150;160004;155407;39;315411
27;2020-12-15;88;59;147;172333;169564;49;341897
27;2020-12-15;94;69;163;189979;183788;59;373767
27;2020-12-15;45;50;95;192591;178206;69;370797
27;2020-12-15;47;55;102;146876;127546;79;274422
27;2020-12-15;72;54;126;96896;61575;89;158471
27;2020-12-15;88;20;108;33148;12109;90;45257
27;2020-12-15;709;526;1235;1429908;1353131;0;2783039
28;2020-12-15;7;10;17;180735;186856;09;367591
28;2020-12-15;22;25;49;200125;213621;19;413746
28;2020-12-15;48;34;82;168922;173007;29;341929
28;2020-12-15;39;32;71;196628;188487;39;385115
28;2020-12-15;53;34;87;205396;201699;49;407095
28;2020-12-15;35;27;62;222002;213866;59;435868
28;2020-12-15;34;37;71;224688;203758;69;428446
28;2020-12-15;20;17;37;163192;135543;79;298735
28;2020-12-15;38;14;52;109691;65377;89;175068
28;2020-12-15;21;5;27;37222;12685;90;49907
28;2020-12-15;317;235;555;1708601;1594899;0;3303500
32;2020-12-15;15;22;37;358062;373689;09;731751
32;2020-12-15;82;74;156;387045;406742;19;793787
32;2020-12-15;118;85;203;342304;348587;29;690891
32;2020-12-15;122;81;203;382485;369972;39;752457
32;2020-12-15;109;87;196;382510;376716;49;759226
32;2020-12-15;91;74;165;386937;376527;59;763464
32;2020-12-15;65;67;132;371211;330938;69;702149
32;2020-12-15;53;53;106;250542;201459;79;452001
32;2020-12-15;67;49;116;163399;89786;89;253185
32;2020-12-15;51;11;62;48384;15367;90;63751
32;2020-12-15;773;604;1377;3072879;2889783;0;5962662
44;2020-12-15;26;32;59;291525;306839;09;598364
44;2020-12-15;101;108;210;320255;339504;19;659759
44;2020-12-15;166;126;293;302020;314428;29;616448
44;2020-12-15;176;115;293;342222;333292;39;675514
44;2020-12-15;166;124;290;349727;344491;49;694218
44;2020-12-15;167;138;307;381371;373239;59;754610
44;2020-12-15;114;96;216;367165;335850;69;703015
44;2020-12-15;93;67;160;250387;215436;79;465823
44;2020-12-15;110;75;187;170825;105192;89;276017
44;2020-12-15;107;31;138;51248;16731;90;67979
44;2020-12-15;1226;912;2153;2826745;2685002;0;5511747
52;2020-12-15;9;11;20;213594;223900;09;437494
52;2020-12-15;28;32;61;240818;255197;19;496015
52;2020-12-15;47;32;79;197010;200630;29;397640
52;2020-12-15;54;30;84;231204;224885;39;456089
52;2020-12-15;57;26;83;243874;243418;49;487292
52;2020-12-15;32;31;63;244100;239116;59;483216
52;2020-12-15;26;25;51;241796;221345;69;463141
52;2020-12-15;26;24;50;177805;149903;79;327708
52;2020-12-15;34;24;58;119561;75822;89;195383
52;2020-12-15;35;9;44;42559;15260;90;57819
52;2020-12-15;348;244;593;1952321;1849476;0;3801797
53;2020-12-15;3;3;8;173813;182358;09;356171
53;2020-12-15;13;18;31;202720;214740;19;417460
53;2020-12-15;29;14;44;163116;173196;29;336312
53;2020-12-15;24;6;30;190526;187674;39;378200
53;2020-12-15;25;9;34;212098;212015;49;424113
53;2020-12-15;10;18;28;223699;219176;59;442875
53;2020-12-15;15;10;25;227435;209274;69;436709
53;2020-12-15;20;10;30;169992;140910;79;310902
53;2020-12-15;19;8;27;118117;69883;89;188000
53;2020-12-15;17;6;23;37370;12267;90;49637
53;2020-12-15;175;102;280;1718886;1621493;0;3340379
75;2020-12-15;13;22;35;293104;305291;09;598395
75;2020-12-15;48;41;89;337141;357785;19;694926
75;2020-12-15;77;41;119;295024;300618;29;595642
75;2020-12-15;69;46;115;347871;331233;39;679104
75;2020-12-15;68;47;115;384742;372771;49;757513
75;2020-12-15;77;47;124;413361;390880;59;804241
75;2020-12-15;46;39;85;425623;384060;69;809683
75;2020-12-15;30;32;62;325086;276298;79;601384
75;2020-12-15;52;36;88;213986;139308;89;353294
75;2020-12-15;50;21;71;77600;28200;90;105800
75;2020-12-15;530;372;903;3113538;2886444;0;5999982
76;2020-12-15;10;8;18;305956;318589;09;624545
76;2020-12-15;49;35;84;338942;356969;19;695911
76;2020-12-15;72;58;130;316210;319570;29;635780
76;2020-12-15;61;59;120;356758;337587;39;694345
76;2020-12-15;80;62;142;376541;363812;49;740353
76;2020-12-15;73;66;139;402608;383750;59;786358
76;2020-12-15;48;46;94;394889;358997;69;753886
76;2020-12-15;35;31;66;308664;263806;79;572470
76;2020-12-15;43;25;68;195838;129272;89;325110
76;2020-12-15;34;13;47;69372;26728;90;96100
76;2020-12-15;505;403;908;3065778;2859080;0;5924858
84;2020-12-15;35;46;81;459549;481088;09;940637
84;2020-12-15;191;237;435;487711;511905;19;999616
84;2020-12-15;214;149;364;443824;451094;29;894918
84;2020-12-15;212;163;375;512522;493262;39;1005784
84;2020-12-15;201;133;335;520248;515106;49;1035354
84;2020-12-15;195;147;346;529611;514848;59;1044459
84;2020-12-15;142;105;247;486720;439940;69;926660
84;2020-12-15;95;93;188;372151;315211;79;687362
84;2020-12-15;98;55;153;237198;150524;89;387722
84;2020-12-15;89;27;116;81185;28680;90;109865
84;2020-12-15;1473;1155;2642;4130719;3901658;0;8032377
93;2020-12-15;24;23;47;268834;283093;09;551927
93;2020-12-15;87;68;156;280751;296087;19;576838
93;2020-12-15;112;90;202;254404;255552;29;509956
93;2020-12-15;138;104;242;310704;288398;39;599102
93;2020-12-15;143;87;230;325559;305827;49;631386
93;2020-12-15;114;94;208;353104;325389;59;678493
93;2020-12-15;74;74;148;336327;296459;69;632786
93;2020-12-15;64;54;118;279820;229699;79;509519
93;2020-12-15;77;32;109;171274;113716;89;284990
93;2020-12-15;59;19;78;58896;21758;90;80654
93;2020-12-15;892;646;1539;2639673;2415978;0;5055651
94;2020-12-15;1;0;1;16311;17433;09;33744
94;2020-12-15;0;1;2;16679;18132;19;34811
94;2020-12-15;0;2;2;16782;16579;29;33361
94;2020-12-15;2;3;5;23044;20580;39;43624
94;2020-12-15;1;3;4;23065;22140;49;45205
94;2020-12-15;0;2;2;24549;23421;59;47970
94;2020-12-15;0;0;0;23212;21883;69;45095
94;2020-12-15;2;1;3;19544;17141;79;36685
94;2020-12-15;0;0;0;11227;8178;89;19405
94;2020-12-15;1;0;1;3332;1447;90;4779
94;2020-12-15;7;12;20;177745;166934;0;344679
01;2020-12-16;0;0;0;19979;20155;09;40134
01;2020-12-16;1;1;2;24994;25489;19;50483
01;2020-12-16;0;0;0;17868;16690;29;34558
01;2020-12-16;0;0;0;22328;14821;39;37149
01;2020-12-16;0;1;1;28652;20276;49;48928
01;2020-12-16;2;1;3;33264;27260;59;60524
01;2020-12-16;1;1;2;27135;23978;69;51113
01;2020-12-16;0;1;1;18401;14661;79;33062
01;2020-12-16;0;0;0;9633;6375;89;16008
01;2020-12-16;0;0;0;3410;1510;90;4920
01;2020-12-16;4;5;9;205664;171215;0;376879
02;2020-12-16;0;1;1;16881;17110;09;33991
02;2020-12-16;3;2;5;21410;21604;19;43014
02;2020-12-16;2;0;2;16017;15479;29;31496
02;2020-12-16;2;0;2;19825;14455;39;34280
02;2020-12-16;2;3;5;24719;18248;49;42967
02;2020-12-16;3;1;5;34361;28310;59;62671
02;2020-12-16;1;2;3;28061;24495;69;52556
02;2020-12-16;0;0;0;18231;15278;79;33509
02;2020-12-16;0;0;0;11090;7677;89;18767
02;2020-12-16;0;0;0;3992;1506;90;5498
02;2020-12-16;13;9;23;194587;164162;0;358749
03;2020-12-16;2;1;3;31123;30920;09;62043
03;2020-12-16;6;7;13;29370;29268;19;58638
03;2020-12-16;9;8;17;21458;18963;29;40421
03;2020-12-16;12;13;25;21276;18326;39;39602
03;2020-12-16;3;12;15;18164;16593;49;34757
03;2020-12-16;8;6;14;13469;13557;59;27026
03;2020-12-16;3;8;11;8776;8670;69;17446
03;2020-12-16;0;0;0;3777;3591;79;7368
03;2020-12-16;1;0;1;1649;1072;89;2721
03;2020-12-16;0;0;0;485;184;90;669
03;2020-12-16;44;55;99;149547;141144;0;290691
04;2020-12-16;1;3;4;60314;61377;09;121691
04;2020-12-16;7;7;14;66065;68387;19;134452
04;2020-12-16;5;5;10;51059;47156;29;98215
04;2020-12-16;2;2;4;58788;45780;39;104568
04;2020-12-16;7;0;7;61408;52207;49;113615
04;2020-12-16;4;7;11;64838;60759;59;125597
04;2020-12-16;0;3;3;47008;42843;69;89851
04;2020-12-16;0;1;1;25509;21184;79;46693
04;2020-12-16;0;0;0;13168;7647;89;20815
04;2020-12-16;0;0;0;3209;1253;90;4462
04;2020-12-16;26;28;54;451366;408593;0;859959
05;2020-12-16;0;0;0;362.366008612902;341.338819562748;09;703.704828175651
05;2020-12-16;0;0;0;353.376145114279;370.349735405642;19;723.725880519921
05;2020-12-16;0;0;0;218.593559489256;256.539602589476;29;475.133162078732
05;2020-12-16;0;0;0;404.225408693299;360.321910454353;39;764.547319147651
05;2020-12-16;0;0;0;520.067953604221;497.108383964256;49;1017.17633756848
05;2020-12-16;0;0;0;468.146063921917;510.087601910415;59;978.233665832332
05;2020-12-16;0;0;0;340.368470050554;334.366842191253;69;674.735312241807
05;2020-12-16;0;0;0;212.598666888387;192.597753227106;79;405.196420115493
05;2020-12-16;0;0;0;148.727797095705;61.8681715431829;89;210.595968638888
05;2020-12-16;0;0;0;32.9601271090696;10.9909785719784;90;43.9511056810479
05;2020-12-16;0;0;0;3061.43020057959;2935.56979942041;0;5997
06;2020-12-16;0;1;1;42583;42380;09;84963
06;2020-12-16;5;5;10;33369;31925;19;65294
06;2020-12-16;1;2;3;21571;15080;29;36651
06;2020-12-16;4;3;7;21550;16147;39;37697
06;2020-12-16;4;4;8;14193;13939;49;28132
06;2020-12-16;1;1;2;7171;7597;59;14768
06;2020-12-16;1;1;2;3629;4117;69;7746
06;2020-12-16;0;1;1;1577;1457;79;3034
06;2020-12-16;0;1;1;531;474;89;1005
06;2020-12-16;0;0;0;88;93;90;181
06;2020-12-16;16;19;35;146262;133209;0;279471
07;2020-12-16;0;0;0;485;549;09;1034
07;2020-12-16;0;0;0;403;432;19;835
07;2020-12-16;0;0;0;764;841;29;1605
07;2020-12-16;0;0;0;824;928;39;1752
07;2020-12-16;0;0;0;788;1020;49;1808
07;2020-12-16;0;0;0;678;870;59;1548
07;2020-12-16;0;0;0;360;382;69;742
07;2020-12-16;0;0;0;231;190;79;421
07;2020-12-16;0;0;0;114;67;89;181
07;2020-12-16;0;0;0;24;11;90;35
07;2020-12-16;0;0;0;4671;5290;0;9961
08;2020-12-16;0;0;0;2715.22592983026;2997.75551488675;09;5712.98144471701
08;2020-12-16;0;0;0;2778.51901080978;3160.9156459093;19;5939.43465671908
08;2020-12-16;0;0;0;2080.8882988764;1718.16634315323;29;3799.05464202964
08;2020-12-16;3;0;3;2701.8582062647;1896.52641413317;39;4598.38462039786
08;2020-12-16;1;1;2;3151.45861023308;2460.52498233809;49;5611.98359257117
08;2020-12-16;0;0;0;2620.29868333099;2422.23566154656;59;5042.53434487755
08;2020-12-16;0;0;0;1621.44173420671;1438.58325779464;69;3060.02499200135
08;2020-12-16;0;1;1;626.575909335673;526.358467843651;79;1152.93437717932
08;2020-12-16;1;0;1;205.018522985054;140.993639349697;89;346.012162334751
08;2020-12-16;0;0;0;50.0325684687745;20.62259870351;90;70.6551671722846
08;2020-12-16;5;2;7;18551.3174743414;16782.6825256586;0;35334
11;2020-12-16;52;49;108;783071;811785;09;1594856
11;2020-12-16;151;162;323;761456;784653;19;1546109
11;2020-12-16;269;208;477;850145;801772;29;1651917
11;2020-12-16;292;260;552;914360;843488;39;1757848
11;2020-12-16;215;194;409;845609;826202;49;1671811
11;2020-12-16;202;156;359;793566;745070;59;1538636
11;2020-12-16;117;114;232;628649;549192;69;1177841
11;2020-12-16;76;61;137;434606;358356;79;792962
11;2020-12-16;73;32;106;261425;162933;89;424358
11;2020-12-16;48;12;60;89253;32619;90;121872
11;2020-12-16;1496;1249;2766;6362140;5916070;0;12278210
24;2020-12-16;5;11;16;139720;144686;09;284406
24;2020-12-16;27;34;61;152979;161185;19;314164
24;2020-12-16;44;28;72;122237;126536;29;248773
24;2020-12-16;54;29;83;150359;142009;39;292368
24;2020-12-16;34;37;71;161829;158758;49;320587
24;2020-12-16;43;50;93;172552;168011;59;340563
24;2020-12-16;22;27;49;172509;158177;69;330686
24;2020-12-16;31;14;45;129428;110593;79;240021
24;2020-12-16;46;18;64;87342;56882;89;144224
24;2020-12-16;41;6;47;31210;12071;90;43281
24;2020-12-16;347;254;601;1320165;1238908;0;2559073
27;2020-12-16;17;10;27;143373;149679;09;293052
27;2020-12-16;61;83;144;160962;173003;19;333965
27;2020-12-16;88;62;150;133746;142254;29;276000
27;2020-12-16;71;72;143;160004;155407;39;315411
27;2020-12-16;85;70;155;172333;169564;49;341897
27;2020-12-16;76;86;162;189979;183788;59;373767
27;2020-12-16;53;63;116;192591;178206;69;370797
27;2020-12-16;45;47;92;146876;127546;79;274422
27;2020-12-16;81;33;114;96896;61575;89;158471
27;2020-12-16;81;22;103;33148;12109;90;45257
27;2020-12-16;658;548;1206;1429908;1353131;0;2783039
28;2020-12-16;5;15;21;180735;186856;09;367591
28;2020-12-16;23;19;42;200125;213621;19;413746
28;2020-12-16;40;29;69;168922;173007;29;341929
28;2020-12-16;37;38;75;196628;188487;39;385115
28;2020-12-16;38;30;68;205396;201699;49;407095
28;2020-12-16;30;46;76;222002;213866;59;435868
28;2020-12-16;33;37;70;224688;203758;69;428446
28;2020-12-16;13;21;34;163192;135543;79;298735
28;2020-12-16;24;10;34;109691;65377;89;175068
28;2020-12-16;20;1;21;37222;12685;90;49907
28;2020-12-16;263;246;510;1708601;1594899;0;3303500
32;2020-12-16;13;21;34;358062;373689;09;731751
32;2020-12-16;89;69;158;387045;406742;19;793787
32;2020-12-16;116;79;195;342304;348587;29;690891
32;2020-12-16;97;103;200;382485;369972;39;752457
32;2020-12-16;105;70;175;382510;376716;49;759226
32;2020-12-16;99;95;194;386937;376527;59;763464
32;2020-12-16;60;62;122;371211;330938;69;702149
32;2020-12-16;50;54;104;250542;201459;79;452001
32;2020-12-16;70;36;106;163399;89786;89;253185
32;2020-12-16;55;13;68;48384;15367;90;63751
32;2020-12-16;754;602;1356;3072879;2889783;0;5962662
44;2020-12-16;27;37;64;291525;306839;09;598364
44;2020-12-16;131;106;238;320255;339504;19;659759
44;2020-12-16;154;129;285;302020;314428;29;616448
44;2020-12-16;154;86;242;342222;333292;39;675514
44;2020-12-16;173;114;287;349727;344491;49;694218
44;2020-12-16;152;129;282;381371;373239;59;754610
44;2020-12-16;95;94;189;367165;335850;69;703015
44;2020-12-16;75;83;158;250387;215436;79;465823
44;2020-12-16;95;54;151;170825;105192;89;276017
44;2020-12-16;88;20;110;51248;16731;90;67979
44;2020-12-16;1144;852;2006;2826745;2685002;0;5511747
52;2020-12-16;5;5;10;213594;223900;09;437494
52;2020-12-16;37;34;72;240818;255197;19;496015
52;2020-12-16;46;39;85;197010;200630;29;397640
52;2020-12-16;43;35;78;231204;224885;39;456089
52;2020-12-16;47;34;81;243874;243418;49;487292
52;2020-12-16;47;43;90;244100;239116;59;483216
52;2020-12-16;23;25;48;241796;221345;69;463141
52;2020-12-16;24;17;41;177805;149903;79;327708
52;2020-12-16;26;23;49;119561;75822;89;195383
52;2020-12-16;29;6;35;42559;15260;90;57819
52;2020-12-16;327;261;589;1952321;1849476;0;3801797
53;2020-12-16;4;2;6;173813;182358;09;356171
53;2020-12-16;25;19;44;202720;214740;19;417460
53;2020-12-16;32;16;50;163116;173196;29;336312
53;2020-12-16;21;10;31;190526;187674;39;378200
53;2020-12-16;19;9;28;212098;212015;49;424113
53;2020-12-16;14;16;30;223699;219176;59;442875
53;2020-12-16;14;16;30;227435;209274;69;436709
53;2020-12-16;14;20;34;169992;140910;79;310902
53;2020-12-16;29;27;56;118117;69883;89;188000
53;2020-12-16;18;7;25;37370;12267;90;49637
53;2020-12-16;190;142;335;1718886;1621493;0;3340379
75;2020-12-16;14;20;34;293104;305291;09;598395
75;2020-12-16;42;59;102;337141;357785;19;694926
75;2020-12-16;70;49;119;295024;300618;29;595642
75;2020-12-16;75;42;117;347871;331233;39;679104
75;2020-12-16;71;47;118;384742;372771;49;757513
75;2020-12-16;58;46;104;413361;390880;59;804241
75;2020-12-16;38;46;84;425623;384060;69;809683
75;2020-12-16;35;21;56;325086;276298;79;601384
75;2020-12-16;36;23;59;213986;139308;89;353294
75;2020-12-16;40;9;49;77600;28200;90;105800
75;2020-12-16;480;362;843;3113538;2886444;0;5999982
76;2020-12-16;19;12;31;305956;318589;09;624545
76;2020-12-16;48;60;108;338942;356969;19;695911
76;2020-12-16;66;63;129;316210;319570;29;635780
76;2020-12-16;86;45;131;356758;337587;39;694345
76;2020-12-16;64;63;127;376541;363812;49;740353
76;2020-12-16;59;59;118;402608;383750;59;786358
76;2020-12-16;48;48;96;394889;358997;69;753886
76;2020-12-16;28;36;65;308664;263806;79;572470
76;2020-12-16;45;24;69;195838;129272;89;325110
76;2020-12-16;38;18;56;69372;26728;90;96100
76;2020-12-16;501;428;937;3065778;2859080;0;5924858
84;2020-12-16;48;50;100;459549;481088;09;940637
84;2020-12-16;176;207;385;487711;511905;19;999616
84;2020-12-16;194;143;338;443824;451094;29;894918
84;2020-12-16;220;137;357;512522;493262;39;1005784
84;2020-12-16;198;141;339;520248;515106;49;1035354
84;2020-12-16;175;160;335;529611;514848;59;1044459
84;2020-12-16;110;102;212;486720;439940;69;926660
84;2020-12-16;91;79;170;372151;315211;79;687362
84;2020-12-16;80;53;133;237198;150524;89;387722
84;2020-12-16;80;26;106;81185;28680;90;109865
84;2020-12-16;1372;1099;2476;4130719;3901658;0;8032377
93;2020-12-16;12;23;35;268834;283093;09;551927
93;2020-12-16;89;91;180;280751;296087;19;576838
93;2020-12-16;116;82;198;254404;255552;29;509956
93;2020-12-16;134;113;247;310704;288398;39;599102
93;2020-12-16;101;114;216;325559;305827;49;631386
93;2020-12-16;120;95;216;353104;325389;59;678493
93;2020-12-16;96;65;161;336327;296459;69;632786
93;2020-12-16;50;59;109;279820;229699;79;509519
93;2020-12-16;49;29;78;171274;113716;89;284990
93;2020-12-16;41;17;58;58896;21758;90;80654
93;2020-12-16;808;688;1498;2639673;2415978;0;5055651
94;2020-12-16;0;0;0;16311;17433;09;33744
94;2020-12-16;0;0;0;16679;18132;19;34811
94;2020-12-16;1;0;1;16782;16579;29;33361
94;2020-12-16;3;0;3;23044;20580;39;43624
94;2020-12-16;0;0;0;23065;22140;49;45205
94;2020-12-16;2;4;6;24549;23421;59;47970
94;2020-12-16;1;0;1;23212;21883;69;45095
94;2020-12-16;0;1;1;19544;17141;79;36685
94;2020-12-16;0;0;0;11227;8178;89;19405
94;2020-12-16;0;0;0;3332;1447;90;4779
94;2020-12-16;7;5;12;177745;166934;0;344679
01;2020-12-17;0;0;0;19979;20155;09;40134
01;2020-12-17;0;1;1;24994;25489;19;50483
01;2020-12-17;1;2;3;17868;16690;29;34558
01;2020-12-17;4;1;5;22328;14821;39;37149
01;2020-12-17;0;1;1;28652;20276;49;48928
01;2020-12-17;2;1;3;33264;27260;59;60524
01;2020-12-17;1;1;2;27135;23978;69;51113
01;2020-12-17;1;2;3;18401;14661;79;33062
01;2020-12-17;0;0;0;9633;6375;89;16008
01;2020-12-17;0;0;0;3410;1510;90;4920
01;2020-12-17;9;9;18;205664;171215;0;376879
02;2020-12-17;1;0;1;16881;17110;09;33991
02;2020-12-17;0;0;0;21410;21604;19;43014
02;2020-12-17;1;0;1;16017;15479;29;31496
02;2020-12-17;2;1;3;19825;14455;39;34280
02;2020-12-17;2;1;3;24719;18248;49;42967
02;2020-12-17;2;2;4;34361;28310;59;62671
02;2020-12-17;0;1;1;28061;24495;69;52556
02;2020-12-17;0;0;0;18231;15278;79;33509
02;2020-12-17;1;0;1;11090;7677;89;18767
02;2020-12-17;0;0;0;3992;1506;90;5498
02;2020-12-17;9;5;14;194587;164162;0;358749
03;2020-12-17;0;3;3;31123;30920;09;62043
03;2020-12-17;7;6;13;29370;29268;19;58638
03;2020-12-17;11;10;21;21458;18963;29;40421
03;2020-12-17;11;11;22;21276;18326;39;39602
03;2020-12-17;8;10;18;18164;16593;49;34757
03;2020-12-17;6;8;14;13469;13557;59;27026
03;2020-12-17;5;5;10;8776;8670;69;17446
03;2020-12-17;0;0;0;3777;3591;79;7368
03;2020-12-17;0;1;1;1649;1072;89;2721
03;2020-12-17;0;0;0;485;184;90;669
03;2020-12-17;48;54;102;149547;141144;0;290691
04;2020-12-17;2;2;4;60314;61377;09;121691
04;2020-12-17;5;5;10;66065;68387;19;134452
04;2020-12-17;3;4;7;51059;47156;29;98215
04;2020-12-17;2;0;2;58788;45780;39;104568
04;2020-12-17;2;0;2;61408;52207;49;113615
04;2020-12-17;5;3;8;64838;60759;59;125597
04;2020-12-17;1;2;3;47008;42843;69;89851
04;2020-12-17;1;0;1;25509;21184;79;46693
04;2020-12-17;0;0;0;13168;7647;89;20815
04;2020-12-17;0;0;0;3209;1253;90;4462
04;2020-12-17;21;16;37;451366;408593;0;859959
05;2020-12-17;0;0;0;362.366008612902;341.338819562748;09;703.704828175651
05;2020-12-17;0;0;0;353.376145114279;370.349735405642;19;723.725880519921
05;2020-12-17;0;0;0;218.593559489256;256.539602589476;29;475.133162078732
05;2020-12-17;0;0;0;404.225408693299;360.321910454353;39;764.547319147651
05;2020-12-17;0;0;0;520.067953604221;497.108383964256;49;1017.17633756848
05;2020-12-17;0;0;0;468.146063921917;510.087601910415;59;978.233665832332
05;2020-12-17;0;0;0;340.368470050554;334.366842191253;69;674.735312241807
05;2020-12-17;0;0;0;212.598666888387;192.597753227106;79;405.196420115493
05;2020-12-17;0;0;0;148.727797095705;61.8681715431829;89;210.595968638888
05;2020-12-17;0;0;0;32.9601271090696;10.9909785719784;90;43.9511056810479
05;2020-12-17;0;0;0;3061.43020057959;2935.56979942041;0;5997
06;2020-12-17;0;1;1;42583;42380;09;84963
06;2020-12-17;2;0;2;33369;31925;19;65294
06;2020-12-17;2;1;3;21571;15080;29;36651
06;2020-12-17;5;1;6;21550;16147;39;37697
06;2020-12-17;5;4;9;14193;13939;49;28132
06;2020-12-17;1;0;1;7171;7597;59;14768
06;2020-12-17;1;0;1;3629;4117;69;7746
06;2020-12-17;0;0;0;1577;1457;79;3034
06;2020-12-17;0;0;0;531;474;89;1005
06;2020-12-17;0;0;0;88;93;90;181
06;2020-12-17;16;7;23;146262;133209;0;279471
07;2020-12-17;0;0;0;485;549;09;1034
07;2020-12-17;0;0;0;403;432;19;835
07;2020-12-17;3;1;4;764;841;29;1605
07;2020-12-17;0;2;2;824;928;39;1752
07;2020-12-17;0;0;0;788;1020;49;1808
07;2020-12-17;0;1;1;678;870;59;1548
07;2020-12-17;0;0;0;360;382;69;742
07;2020-12-17;0;0;0;231;190;79;421
07;2020-12-17;0;0;0;114;67;89;181
07;2020-12-17;0;0;0;24;11;90;35
07;2020-12-17;3;4;7;4671;5290;0;9961
08;2020-12-17;0;0;0;2715.22592983026;2997.75551488675;09;5712.98144471701
08;2020-12-17;0;0;0;2778.51901080978;3160.9156459093;19;5939.43465671908
08;2020-12-17;1;1;2;2080.8882988764;1718.16634315323;29;3799.05464202964
08;2020-12-17;2;0;2;2701.8582062647;1896.52641413317;39;4598.38462039786
08;2020-12-17;0;0;0;3151.45861023308;2460.52498233809;49;5611.98359257117
08;2020-12-17;3;2;5;2620.29868333099;2422.23566154656;59;5042.53434487755
08;2020-12-17;0;1;1;1621.44173420671;1438.58325779464;69;3060.02499200135
08;2020-12-17;0;0;0;626.575909335673;526.358467843651;79;1152.93437717932
08;2020-12-17;0;0;0;205.018522985054;140.993639349697;89;346.012162334751
08;2020-12-17;0;0;0;50.0325684687745;20.62259870351;90;70.6551671722846
08;2020-12-17;6;4;10;18551.3174743414;16782.6825256586;0;35334
11;2020-12-17;36;34;71;783071;811785;09;1594856
11;2020-12-17;147;136;285;761456;784653;19;1546109
11;2020-12-17;271;208;479;850145;801772;29;1651917
11;2020-12-17;294;210;504;914360;843488;39;1757848
11;2020-12-17;209;198;409;845609;826202;49;1671811
11;2020-12-17;170;168;338;793566;745070;59;1538636
11;2020-12-17;104;116;220;628649;549192;69;1177841
11;2020-12-17;72;60;133;434606;358356;79;792962
11;2020-12-17;59;42;101;261425;162933;89;424358
11;2020-12-17;37;16;53;89253;32619;90;121872
11;2020-12-17;1399;1190;2595;6362140;5916070;0;12278210
24;2020-12-17;6;4;11;139720;144686;09;284406
24;2020-12-17;26;16;42;152979;161185;19;314164
24;2020-12-17;53;29;82;122237;126536;29;248773
24;2020-12-17;35;27;62;150359;142009;39;292368
24;2020-12-17;49;30;79;161829;158758;49;320587
24;2020-12-17;46;34;80;172552;168011;59;340563
24;2020-12-17;31;31;62;172509;158177;69;330686
24;2020-12-17;18;19;37;129428;110593;79;240021
24;2020-12-17;40;18;58;87342;56882;89;144224
24;2020-12-17;48;11;59;31210;12071;90;43281
24;2020-12-17;352;219;572;1320165;1238908;0;2559073
27;2020-12-17;21;18;41;143373;149679;09;293052
27;2020-12-17;60;72;133;160962;173003;19;333965
27;2020-12-17;72;55;127;133746;142254;29;276000
27;2020-12-17;87;62;149;160004;155407;39;315411
27;2020-12-17;68;67;135;172333;169564;49;341897
27;2020-12-17;81;78;159;189979;183788;59;373767
27;2020-12-17;64;56;120;192591;178206;69;370797
27;2020-12-17;36;32;68;146876;127546;79;274422
27;2020-12-17;58;44;102;96896;61575;89;158471
27;2020-12-17;63;18;81;33148;12109;90;45257
27;2020-12-17;610;502;1115;1429908;1353131;0;2783039
28;2020-12-17;8;7;15;180735;186856;09;367591
28;2020-12-17;40;31;71;200125;213621;19;413746
28;2020-12-17;42;35;77;168922;173007;29;341929
28;2020-12-17;69;40;109;196628;188487;39;385115
28;2020-12-17;42;24;66;205396;201699;49;407095
28;2020-12-17;46;30;76;222002;213866;59;435868
28;2020-12-17;22;28;50;224688;203758;69;428446
28;2020-12-17;17;20;37;163192;135543;79;298735
28;2020-12-17;40;25;65;109691;65377;89;175068
28;2020-12-17;47;9;56;37222;12685;90;49907
28;2020-12-17;373;249;623;1708601;1594899;0;3303500
32;2020-12-17;17;23;40;358062;373689;09;731751
32;2020-12-17;77;75;153;387045;406742;19;793787
32;2020-12-17;117;82;199;342304;348587;29;690891
32;2020-12-17;121;102;223;382485;369972;39;752457
32;2020-12-17;114;78;192;382510;376716;49;759226
32;2020-12-17;94;87;181;386937;376527;59;763464
32;2020-12-17;93;70;163;371211;330938;69;702149
32;2020-12-17;57;40;97;250542;201459;79;452001
32;2020-12-17;89;24;113;163399;89786;89;253185
32;2020-12-17;44;14;58;48384;15367;90;63751
32;2020-12-17;823;596;1420;3072879;2889783;0;5962662
44;2020-12-17;30;28;59;291525;306839;09;598364
44;2020-12-17;109;106;217;320255;339504;19;659759
44;2020-12-17;165;144;316;302020;314428;29;616448
44;2020-12-17;177;141;321;342222;333292;39;675514
44;2020-12-17;166;129;298;349727;344491;49;694218
44;2020-12-17;153;139;296;381371;373239;59;754610
44;2020-12-17;115;91;207;367165;335850;69;703015
44;2020-12-17;85;71;160;250387;215436;79;465823
44;2020-12-17;116;61;177;170825;105192;89;276017
44;2020-12-17;85;25;110;51248;16731;90;67979
44;2020-12-17;1201;935;2161;2826745;2685002;0;5511747
52;2020-12-17;5;10;15;213594;223900;09;437494
52;2020-12-17;28;33;62;240818;255197;19;496015
52;2020-12-17;57;32;89;197010;200630;29;397640
52;2020-12-17;41;30;71;231204;224885;39;456089
52;2020-12-17;55;36;93;243874;243418;49;487292
52;2020-12-17;45;31;76;244100;239116;59;483216
52;2020-12-17;32;23;55;241796;221345;69;463141
52;2020-12-17;23;26;49;177805;149903;79;327708
52;2020-12-17;57;21;78;119561;75822;89;195383
52;2020-12-17;46;16;62;42559;15260;90;57819
52;2020-12-17;389;258;650;1952321;1849476;0;3801797
53;2020-12-17;1;3;4;173813;182358;09;356171
53;2020-12-17;25;17;42;202720;214740;19;417460
53;2020-12-17;29;23;54;163116;173196;29;336312
53;2020-12-17;17;8;25;190526;187674;39;378200
53;2020-12-17;25;7;32;212098;212015;49;424113
53;2020-12-17;18;11;30;223699;219176;59;442875
53;2020-12-17;7;15;22;227435;209274;69;436709
53;2020-12-17;11;12;23;169992;140910;79;310902
53;2020-12-17;21;11;32;118117;69883;89;188000
53;2020-12-17;22;3;26;37370;12267;90;49637
53;2020-12-17;176;110;290;1718886;1621493;0;3340379
75;2020-12-17;19;18;38;293104;305291;09;598395
75;2020-12-17;61;54;115;337141;357785;19;694926
75;2020-12-17;79;52;132;295024;300618;29;595642
75;2020-12-17;77;47;124;347871;331233;39;679104
75;2020-12-17;76;49;125;384742;372771;49;757513
75;2020-12-17;76;52;128;413361;390880;59;804241
75;2020-12-17;34;40;74;425623;384060;69;809683
75;2020-12-17;25;30;55;325086;276298;79;601384
75;2020-12-17;42;25;67;213986;139308;89;353294
75;2020-12-17;25;13;39;77600;28200;90;105800
75;2020-12-17;514;380;897;3113538;2886444;0;5999982
76;2020-12-17;12;13;26;305956;318589;09;624545
76;2020-12-17;53;40;94;338942;356969;19;695911
76;2020-12-17;70;90;160;316210;319570;29;635780
76;2020-12-17;77;69;146;356758;337587;39;694345
76;2020-12-17;89;63;152;376541;363812;49;740353
76;2020-12-17;73;64;137;402608;383750;59;786358
76;2020-12-17;40;48;88;394889;358997;69;753886
76;2020-12-17;30;33;63;308664;263806;79;572470
76;2020-12-17;42;21;63;195838;129272;89;325110
76;2020-12-17;40;13;53;69372;26728;90;96100
76;2020-12-17;528;454;984;3065778;2859080;0;5924858
84;2020-12-17;28;31;59;459549;481088;09;940637
84;2020-12-17;206;226;435;487711;511905;19;999616
84;2020-12-17;221;174;395;443824;451094;29;894918
84;2020-12-17;229;149;379;512522;493262;39;1005784
84;2020-12-17;225;173;398;520248;515106;49;1035354
84;2020-12-17;192;188;380;529611;514848;59;1044459
84;2020-12-17;135;138;273;486720;439940;69;926660
84;2020-12-17;97;92;189;372151;315211;79;687362
84;2020-12-17;118;64;182;237198;150524;89;387722
84;2020-12-17;81;26;107;81185;28680;90;109865
84;2020-12-17;1532;1261;2797;4130719;3901658;0;8032377
93;2020-12-17;9;20;29;268834;283093;09;551927
93;2020-12-17;67;96;164;280751;296087;19;576838
93;2020-12-17;121;95;216;254404;255552;29;509956
93;2020-12-17;134;146;280;310704;288398;39;599102
93;2020-12-17;133;90;226;325559;305827;49;631386
93;2020-12-17;133;109;243;353104;325389;59;678493
93;2020-12-17;86;75;161;336327;296459;69;632786
93;2020-12-17;62;36;98;279820;229699;79;509519
93;2020-12-17;47;34;81;171274;113716;89;284990
93;2020-12-17;48;16;64;58896;21758;90;80654
93;2020-12-17;840;717;1562;2639673;2415978;0;5055651
94;2020-12-17;0;0;0;16311;17433;09;33744
94;2020-12-17;0;1;1;16679;18132;19;34811
94;2020-12-17;0;1;1;16782;16579;29;33361
94;2020-12-17;0;3;3;23044;20580;39;43624
94;2020-12-17;1;0;1;23065;22140;49;45205
94;2020-12-17;2;0;2;24549;23421;59;47970
94;2020-12-17;0;1;1;23212;21883;69;45095
94;2020-12-17;0;0;0;19544;17141;79;36685
94;2020-12-17;0;0;0;11227;8178;89;19405
94;2020-12-17;0;0;0;3332;1447;90;4779
94;2020-12-17;3;6;9;177745;166934;0;344679
01;2020-12-18;0;1;1;19979;20155;09;40134
01;2020-12-18;0;1;1;24994;25489;19;50483
01;2020-12-18;0;0;0;17868;16690;29;34558
01;2020-12-18;1;1;2;22328;14821;39;37149
01;2020-12-18;2;2;4;28652;20276;49;48928
01;2020-12-18;1;0;1;33264;27260;59;60524
01;2020-12-18;2;0;2;27135;23978;69;51113
01;2020-12-18;0;0;0;18401;14661;79;33062
01;2020-12-18;0;0;0;9633;6375;89;16008
01;2020-12-18;1;0;1;3410;1510;90;4920
01;2020-12-18;7;5;12;205664;171215;0;376879
02;2020-12-18;0;1;1;16881;17110;09;33991
02;2020-12-18;0;1;1;21410;21604;19;43014
02;2020-12-18;2;1;3;16017;15479;29;31496
02;2020-12-18;0;5;5;19825;14455;39;34280
02;2020-12-18;0;0;0;24719;18248;49;42967
02;2020-12-18;5;3;8;34361;28310;59;62671
02;2020-12-18;1;2;3;28061;24495;69;52556
02;2020-12-18;0;0;0;18231;15278;79;33509
02;2020-12-18;0;0;0;11090;7677;89;18767
02;2020-12-18;0;0;0;3992;1506;90;5498
02;2020-12-18;8;13;21;194587;164162;0;358749
03;2020-12-18;0;0;1;31123;30920;09;62043
03;2020-12-18;3;4;7;29370;29268;19;58638
03;2020-12-18;12;12;24;21458;18963;29;40421
03;2020-12-18;10;3;13;21276;18326;39;39602
03;2020-12-18;4;12;16;18164;16593;49;34757
03;2020-12-18;3;6;9;13469;13557;59;27026
03;2020-12-18;2;3;5;8776;8670;69;17446
03;2020-12-18;2;3;5;3777;3591;79;7368
03;2020-12-18;0;0;0;1649;1072;89;2721
03;2020-12-18;0;0;0;485;184;90;669
03;2020-12-18;36;43;80;149547;141144;0;290691
04;2020-12-18;1;2;3;60314;61377;09;121691
04;2020-12-18;6;5;11;66065;68387;19;134452
04;2020-12-18;2;1;3;51059;47156;29;98215
04;2020-12-18;3;3;6;58788;45780;39;104568
04;2020-12-18;4;1;5;61408;52207;49;113615
04;2020-12-18;2;2;4;64838;60759;59;125597
04;2020-12-18;2;1;3;47008;42843;69;89851
04;2020-12-18;0;0;0;25509;21184;79;46693
04;2020-12-18;0;0;0;13168;7647;89;20815
04;2020-12-18;0;0;0;3209;1253;90;4462
04;2020-12-18;20;15;35;451366;408593;0;859959
05;2020-12-18;0;0;0;362.366008612902;341.338819562748;09;703.704828175651
05;2020-12-18;0;0;0;353.376145114279;370.349735405642;19;723.725880519921
05;2020-12-18;0;0;0;218.593559489256;256.539602589476;29;475.133162078732
05;2020-12-18;0;0;0;404.225408693299;360.321910454353;39;764.547319147651
05;2020-12-18;0;0;0;520.067953604221;497.108383964256;49;1017.17633756848
05;2020-12-18;0;0;0;468.146063921917;510.087601910415;59;978.233665832332
05;2020-12-18;0;0;0;340.368470050554;334.366842191253;69;674.735312241807
05;2020-12-18;0;0;0;212.598666888387;192.597753227106;79;405.196420115493
05;2020-12-18;0;0;0;148.727797095705;61.8681715431829;89;210.595968638888
05;2020-12-18;0;0;0;32.9601271090696;10.9909785719784;90;43.9511056810479
05;2020-12-18;0;0;0;3061.43020057959;2935.56979942041;0;5997
06;2020-12-18;0;0;0;42583;42380;09;84963
06;2020-12-18;4;1;5;33369;31925;19;65294
06;2020-12-18;2;2;4;21571;15080;29;36651
06;2020-12-18;2;2;4;21550;16147;39;37697
06;2020-12-18;2;2;4;14193;13939;49;28132
06;2020-12-18;1;2;3;7171;7597;59;14768
06;2020-12-18;2;1;3;3629;4117;69;7746
06;2020-12-18;0;0;0;1577;1457;79;3034
06;2020-12-18;0;0;0;531;474;89;1005
06;2020-12-18;0;0;0;88;93;90;181
06;2020-12-18;13;10;23;146262;133209;0;279471
07;2020-12-18;0;0;0;485;549;09;1034
07;2020-12-18;0;0;0;403;432;19;835
07;2020-12-18;0;1;1;764;841;29;1605
07;2020-12-18;0;0;0;824;928;39;1752
07;2020-12-18;1;0;1;788;1020;49;1808
07;2020-12-18;0;0;0;678;870;59;1548
07;2020-12-18;0;0;0;360;382;69;742
07;2020-12-18;0;0;0;231;190;79;421
07;2020-12-18;0;0;0;114;67;89;181
07;2020-12-18;0;0;0;24;11;90;35
07;2020-12-18;1;1;2;4671;5290;0;9961
08;2020-12-18;0;0;0;2715.22592983026;2997.75551488675;09;5712.98144471701
08;2020-12-18;0;1;1;2778.51901080978;3160.9156459093;19;5939.43465671908
08;2020-12-18;1;0;1;2080.8882988764;1718.16634315323;29;3799.05464202964
08;2020-12-18;2;0;2;2701.8582062647;1896.52641413317;39;4598.38462039786
08;2020-12-18;0;1;1;3151.45861023308;2460.52498233809;49;5611.98359257117
08;2020-12-18;0;1;1;2620.29868333099;2422.23566154656;59;5042.53434487755
08;2020-12-18;1;0;1;1621.44173420671;1438.58325779464;69;3060.02499200135
08;2020-12-18;0;0;0;626.575909335673;526.358467843651;79;1152.93437717932
08;2020-12-18;0;0;0;205.018522985054;140.993639349697;89;346.012162334751
08;2020-12-18;0;0;0;50.0325684687745;20.62259870351;90;70.6551671722846
08;2020-12-18;4;3;7;18551.3174743414;16782.6825256586;0;35334
11;2020-12-18;50;48;100;783071;811785;09;1594856
11;2020-12-18;152;159;317;761456;784653;19;1546109
11;2020-12-18;299;250;549;850145;801772;29;1651917
11;2020-12-18;308;281;589;914360;843488;39;1757848
11;2020-12-18;243;226;470;845609;826202;49;1671811
11;2020-12-18;217;200;417;793566;745070;59;1538636
11;2020-12-18;144;139;283;628649;549192;69;1177841
11;2020-12-18;66;67;133;434606;358356;79;792962
11;2020-12-18;56;41;97;261425;162933;89;424358
11;2020-12-18;48;14;62;89253;32619;90;121872
11;2020-12-18;1585;1426;3020;6362140;5916070;0;12278210
24;2020-12-18;7;11;18;139720;144686;09;284406
24;2020-12-18;31;30;63;152979;161185;19;314164
24;2020-12-18;41;34;75;122237;126536;29;248773
24;2020-12-18;39;36;75;150359;142009;39;292368
24;2020-12-18;47;32;79;161829;158758;49;320587
24;2020-12-18;38;43;81;172552;168011;59;340563
24;2020-12-18;29;30;59;172509;158177;69;330686
24;2020-12-18;24;28;52;129428;110593;79;240021
24;2020-12-18;24;17;41;87342;56882;89;144224
24;2020-12-18;28;6;34;31210;12071;90;43281
24;2020-12-18;308;267;577;1320165;1238908;0;2559073
27;2020-12-18;16;21;38;143373;149679;09;293052
27;2020-12-18;73;76;150;160962;173003;19;333965
27;2020-12-18;76;53;129;133746;142254;29;276000
27;2020-12-18;80;66;146;160004;155407;39;315411
27;2020-12-18;103;63;166;172333;169564;49;341897
27;2020-12-18;90;76;166;189979;183788;59;373767
27;2020-12-18;55;67;122;192591;178206;69;370797
27;2020-12-18;45;34;79;146876;127546;79;274422
27;2020-12-18;65;31;96;96896;61575;89;158471
27;2020-12-18;61;25;86;33148;12109;90;45257
27;2020-12-18;664;512;1178;1429908;1353131;0;2783039
28;2020-12-18;7;8;15;180735;186856;09;367591
28;2020-12-18;30;34;64;200125;213621;19;413746
28;2020-12-18;49;30;79;168922;173007;29;341929
28;2020-12-18;40;35;75;196628;188487;39;385115
28;2020-12-18;49;50;99;205396;201699;49;407095
28;2020-12-18;56;44;100;222002;213866;59;435868
28;2020-12-18;23;30;53;224688;203758;69;428446
28;2020-12-18;23;20;43;163192;135543;79;298735
28;2020-12-18;21;18;39;109691;65377;89;175068
28;2020-12-18;27;9;36;37222;12685;90;49907
28;2020-12-18;325;279;604;1708601;1594899;0;3303500
32;2020-12-18;42;25;67;358062;373689;09;731751
32;2020-12-18;92;79;171;387045;406742;19;793787
32;2020-12-18;108;85;193;342304;348587;29;690891
32;2020-12-18;110;103;213;382485;369972;39;752457
32;2020-12-18;124;104;229;382510;376716;49;759226
32;2020-12-18;112;95;207;386937;376527;59;763464
32;2020-12-18;80;92;172;371211;330938;69;702149
32;2020-12-18;55;55;110;250542;201459;79;452001
32;2020-12-18;85;40;125;163399;89786;89;253185
32;2020-12-18;65;19;84;48384;15367;90;63751
32;2020-12-18;874;697;1572;3072879;2889783;0;5962662
44;2020-12-18;39;32;74;291525;306839;09;598364
44;2020-12-18;135;104;241;320255;339504;19;659759
44;2020-12-18;184;149;335;302020;314428;29;616448
44;2020-12-18;200;133;334;342222;333292;39;675514
44;2020-12-18;166;178;345;349727;344491;49;694218
44;2020-12-18;169;154;325;381371;373239;59;754610
44;2020-12-18;118;97;215;367165;335850;69;703015
44;2020-12-18;74;79;154;250387;215436;79;465823
44;2020-12-18;89;51;141;170825;105192;89;276017
44;2020-12-18;42;10;52;51248;16731;90;67979
44;2020-12-18;1216;988;2217;2826745;2685002;0;5511747
52;2020-12-18;6;6;12;213594;223900;09;437494
52;2020-12-18;32;27;60;240818;255197;19;496015
52;2020-12-18;41;37;78;197010;200630;29;397640
52;2020-12-18;60;37;97;231204;224885;39;456089
52;2020-12-18;40;37;77;243874;243418;49;487292
52;2020-12-18;48;40;88;244100;239116;59;483216
52;2020-12-18;26;35;62;241796;221345;69;463141
52;2020-12-18;12;16;28;177805;149903;79;327708
52;2020-12-18;23;13;36;119561;75822;89;195383
52;2020-12-18;20;5;25;42559;15260;90;57819
52;2020-12-18;308;253;563;1952321;1849476;0;3801797
53;2020-12-18;5;5;11;173813;182358;09;356171
53;2020-12-18;13;23;36;202720;214740;19;417460
53;2020-12-18;22;12;39;163116;173196;29;336312
53;2020-12-18;20;16;36;190526;187674;39;378200
53;2020-12-18;18;17;35;212098;212015;49;424113
53;2020-12-18;18;22;40;223699;219176;59;442875
53;2020-12-18;11;14;25;227435;209274;69;436709
53;2020-12-18;11;8;19;169992;140910;79;310902
53;2020-12-18;12;2;14;118117;69883;89;188000
53;2020-12-18;5;2;7;37370;12267;90;49637
53;2020-12-18;135;121;262;1718886;1621493;0;3340379
75;2020-12-18;10;10;20;293104;305291;09;598395
75;2020-12-18;58;45;103;337141;357785;19;694926
75;2020-12-18;49;57;106;295024;300618;29;595642
75;2020-12-18;71;57;128;347871;331233;39;679104
75;2020-12-18;55;49;104;384742;372771;49;757513
75;2020-12-18;38;57;95;413361;390880;59;804241
75;2020-12-18;42;42;84;425623;384060;69;809683
75;2020-12-18;29;24;53;325086;276298;79;601384
75;2020-12-18;49;20;69;213986;139308;89;353294
75;2020-12-18;49;13;62;77600;28200;90;105800
75;2020-12-18;450;375;825;3113538;2886444;0;5999982
76;2020-12-18;13;10;24;305956;318589;09;624545
76;2020-12-18;63;58;122;338942;356969;19;695911
76;2020-12-18;82;74;156;316210;319570;29;635780
76;2020-12-18;72;66;138;356758;337587;39;694345
76;2020-12-18;95;68;163;376541;363812;49;740353
76;2020-12-18;67;70;137;402608;383750;59;786358
76;2020-12-18;54;66;121;394889;358997;69;753886
76;2020-12-18;42;34;76;308664;263806;79;572470
76;2020-12-18;40;34;74;195838;129272;89;325110
76;2020-12-18;40;11;51;69372;26728;90;96100
76;2020-12-18;569;491;1063;3065778;2859080;0;5924858
84;2020-12-18;49;45;94;459549;481088;09;940637
84;2020-12-18;221;242;463;487711;511905;19;999616
84;2020-12-18;252;191;443;443824;451094;29;894918
84;2020-12-18;314;228;543;512522;493262;39;1005784
84;2020-12-18;287;238;525;520248;515106;49;1035354
84;2020-12-18;232;217;449;529611;514848;59;1044459
84;2020-12-18;206;196;402;486720;439940;69;926660
84;2020-12-18;181;187;368;372151;315211;79;687362
84;2020-12-18;130;93;223;237198;150524;89;387722
84;2020-12-18;79;23;102;81185;28680;90;109865
84;2020-12-18;1952;1660;3613;4130719;3901658;0;8032377
93;2020-12-18;21;25;46;268834;283093;09;551927
93;2020-12-18;91;99;190;280751;296087;19;576838
93;2020-12-18;136;108;244;254404;255552;29;509956
93;2020-12-18;148;106;254;310704;288398;39;599102
93;2020-12-18;154;110;264;325559;305827;49;631386
93;2020-12-18;128;139;267;353104;325389;59;678493
93;2020-12-18;106;101;207;336327;296459;69;632786
93;2020-12-18;64;69;133;279820;229699;79;509519
93;2020-12-18;78;42;120;171274;113716;89;284990
93;2020-12-18;63;16;79;58896;21758;90;80654
93;2020-12-18;989;815;1804;2639673;2415978;0;5055651
94;2020-12-18;0;0;0;16311;17433;09;33744
94;2020-12-18;0;0;0;16679;18132;19;34811
94;2020-12-18;0;0;0;16782;16579;29;33361
94;2020-12-18;0;3;3;23044;20580;39;43624
94;2020-12-18;1;1;2;23065;22140;49;45205
94;2020-12-18;1;1;2;24549;23421;59;47970
94;2020-12-18;2;5;7;23212;21883;69;45095
94;2020-12-18;1;0;1;19544;17141;79;36685
94;2020-12-18;0;0;0;11227;8178;89;19405
94;2020-12-18;0;0;0;3332;1447;90;4779
94;2020-12-18;5;10;15;177745;166934;0;344679
01;2020-12-19;0;0;0;19979;20155;09;40134
01;2020-12-19;0;1;1;24994;25489;19;50483
01;2020-12-19;2;0;2;17868;16690;29;34558
01;2020-12-19;0;0;0;22328;14821;39;37149
01;2020-12-19;0;0;0;28652;20276;49;48928
01;2020-12-19;3;0;3;33264;27260;59;60524
01;2020-12-19;2;0;2;27135;23978;69;51113
01;2020-12-19;0;1;1;18401;14661;79;33062
01;2020-12-19;0;0;0;9633;6375;89;16008
01;2020-12-19;0;0;0;3410;1510;90;4920
01;2020-12-19;7;2;9;205664;171215;0;376879
02;2020-12-19;0;0;0;16881;17110;09;33991
02;2020-12-19;0;0;0;21410;21604;19;43014
02;2020-12-19;0;0;0;16017;15479;29;31496
02;2020-12-19;0;0;0;19825;14455;39;34280
02;2020-12-19;1;1;2;24719;18248;49;42967
02;2020-12-19;1;0;1;34361;28310;59;62671
02;2020-12-19;1;1;2;28061;24495;69;52556
02;2020-12-19;1;0;1;18231;15278;79;33509
02;2020-12-19;0;0;0;11090;7677;89;18767
02;2020-12-19;0;0;0;3992;1506;90;5498
02;2020-12-19;4;2;6;194587;164162;0;358749
03;2020-12-19;0;0;0;31123;30920;09;62043
03;2020-12-19;1;6;7;29370;29268;19;58638
03;2020-12-19;5;4;9;21458;18963;29;40421
03;2020-12-19;2;3;6;21276;18326;39;39602
03;2020-12-19;8;5;13;18164;16593;49;34757
03;2020-12-19;6;5;11;13469;13557;59;27026
03;2020-12-19;0;2;2;8776;8670;69;17446
03;2020-12-19;0;0;0;3777;3591;79;7368
03;2020-12-19;0;0;0;1649;1072;89;2721
03;2020-12-19;0;0;0;485;184;90;669
03;2020-12-19;22;25;48;149547;141144;0;290691
04;2020-12-19;0;2;2;60314;61377;09;121691
04;2020-12-19;0;1;1;66065;68387;19;134452
04;2020-12-19;2;2;4;51059;47156;29;98215
04;2020-12-19;4;3;7;58788;45780;39;104568
04;2020-12-19;0;2;2;61408;52207;49;113615
04;2020-12-19;1;1;2;64838;60759;59;125597
04;2020-12-19;0;0;0;47008;42843;69;89851
04;2020-12-19;0;1;1;25509;21184;79;46693
04;2020-12-19;0;1;1;13168;7647;89;20815
04;2020-12-19;0;0;0;3209;1253;90;4462
04;2020-12-19;7;13;20;451366;408593;0;859959
05;2020-12-19;0;0;0;362.366008612902;341.338819562748;09;703.704828175651
05;2020-12-19;0;0;0;353.376145114279;370.349735405642;19;723.725880519921
05;2020-12-19;0;0;0;218.593559489256;256.539602589476;29;475.133162078732
05;2020-12-19;0;0;0;404.225408693299;360.321910454353;39;764.547319147651
05;2020-12-19;0;0;0;520.067953604221;497.108383964256;49;1017.17633756848
05;2020-12-19;0;0;0;468.146063921917;510.087601910415;59;978.233665832332
05;2020-12-19;0;0;0;340.368470050554;334.366842191253;69;674.735312241807
05;2020-12-19;0;0;0;212.598666888387;192.597753227106;79;405.196420115493
05;2020-12-19;0;0;0;148.727797095705;61.8681715431829;89;210.595968638888
05;2020-12-19;0;0;0;32.9601271090696;10.9909785719784;90;43.9511056810479
05;2020-12-19;0;0;0;3061.43020057959;2935.56979942041;0;5997
06;2020-12-19;0;0;0;42583;42380;09;84963
06;2020-12-19;3;1;4;33369;31925;19;65294
06;2020-12-19;1;0;1;21571;15080;29;36651
06;2020-12-19;0;0;0;21550;16147;39;37697
06;2020-12-19;1;2;3;14193;13939;49;28132
06;2020-12-19;1;0;1;7171;7597;59;14768
06;2020-12-19;0;1;1;3629;4117;69;7746
06;2020-12-19;0;0;0;1577;1457;79;3034
06;2020-12-19;0;0;0;531;474;89;1005
06;2020-12-19;0;0;0;88;93;90;181
06;2020-12-19;6;4;10;146262;133209;0;279471
07;2020-12-19;0;0;0;485;549;09;1034
07;2020-12-19;0;0;0;403;432;19;835
07;2020-12-19;0;0;0;764;841;29;1605
07;2020-12-19;0;0;0;824;928;39;1752
07;2020-12-19;0;0;0;788;1020;49;1808
07;2020-12-19;0;0;0;678;870;59;1548
07;2020-12-19;0;0;0;360;382;69;742
07;2020-12-19;0;0;0;231;190;79;421
07;2020-12-19;0;0;0;114;67;89;181
07;2020-12-19;0;0;0;24;11;90;35
07;2020-12-19;0;0;0;4671;5290;0;9961
08;2020-12-19;0;0;0;2715.22592983026;2997.75551488675;09;5712.98144471701
08;2020-12-19;0;0;0;2778.51901080978;3160.9156459093;19;5939.43465671908
08;2020-12-19;2;1;3;2080.8882988764;1718.16634315323;29;3799.05464202964
08;2020-12-19;1;0;1;2701.8582062647;1896.52641413317;39;4598.38462039786
08;2020-12-19;0;0;0;3151.45861023308;2460.52498233809;49;5611.98359257117
08;2020-12-19;0;0;0;2620.29868333099;2422.23566154656;59;5042.53434487755
08;2020-12-19;0;0;0;1621.44173420671;1438.58325779464;69;3060.02499200135
08;2020-12-19;0;0;0;626.575909335673;526.358467843651;79;1152.93437717932
08;2020-12-19;0;0;0;205.018522985054;140.993639349697;89;346.012162334751
08;2020-12-19;0;0;0;50.0325684687745;20.62259870351;90;70.6551671722846
08;2020-12-19;3;1;4;18551.3174743414;16782.6825256586;0;35334
11;2020-12-19;43;24;69;783071;811785;09;1594856
11;2020-12-19;124;93;224;761456;784653;19;1546109
11;2020-12-19;187;129;316;850145;801772;29;1651917
11;2020-12-19;175;174;349;914360;843488;39;1757848
11;2020-12-19;147;137;284;845609;826202;49;1671811
11;2020-12-19;151;131;282;793566;745070;59;1538636
11;2020-12-19;94;90;188;628649;549192;69;1177841
11;2020-12-19;44;40;84;434606;358356;79;792962
11;2020-12-19;40;26;66;261425;162933;89;424358
11;2020-12-19;12;10;22;89253;32619;90;121872
11;2020-12-19;1017;854;1884;6362140;5916070;0;12278210
24;2020-12-19;6;5;11;139720;144686;09;284406
24;2020-12-19;16;19;36;152979;161185;19;314164
24;2020-12-19;26;21;47;122237;126536;29;248773
24;2020-12-19;25;21;46;150359;142009;39;292368
24;2020-12-19;18;39;57;161829;158758;49;320587
24;2020-12-19;27;33;60;172552;168011;59;340563
24;2020-12-19;21;12;33;172509;158177;69;330686
24;2020-12-19;10;15;25;129428;110593;79;240021
24;2020-12-19;11;4;15;87342;56882;89;144224
24;2020-12-19;4;6;10;31210;12071;90;43281
24;2020-12-19;164;175;340;1320165;1238908;0;2559073
27;2020-12-19;16;12;28;143373;149679;09;293052
27;2020-12-19;39;51;90;160962;173003;19;333965
27;2020-12-19;49;29;78;133746;142254;29;276000
27;2020-12-19;52;44;96;160004;155407;39;315411
27;2020-12-19;45;45;90;172333;169564;49;341897
27;2020-12-19;50;45;95;189979;183788;59;373767
27;2020-12-19;42;29;71;192591;178206;69;370797
27;2020-12-19;26;27;53;146876;127546;79;274422
27;2020-12-19;38;17;55;96896;61575;89;158471
27;2020-12-19;23;10;33;33148;12109;90;45257
27;2020-12-19;380;310;690;1429908;1353131;0;2783039
28;2020-12-19;6;7;13;180735;186856;09;367591
28;2020-12-19;23;15;38;200125;213621;19;413746
28;2020-12-19;28;20;48;168922;173007;29;341929
28;2020-12-19;27;18;45;196628;188487;39;385115
28;2020-12-19;23;19;42;205396;201699;49;407095
28;2020-12-19;33;23;56;222002;213866;59;435868
28;2020-12-19;15;18;33;224688;203758;69;428446
28;2020-12-19;9;6;15;163192;135543;79;298735
28;2020-12-19;8;8;16;109691;65377;89;175068
28;2020-12-19;4;3;7;37222;12685;90;49907
28;2020-12-19;176;137;313;1708601;1594899;0;3303500
32;2020-12-19;8;20;28;358062;373689;09;731751
32;2020-12-19;43;42;85;387045;406742;19;793787
32;2020-12-19;84;65;149;342304;348587;29;690891
32;2020-12-19;66;56;122;382485;369972;39;752457
32;2020-12-19;69;65;134;382510;376716;49;759226
32;2020-12-19;66;62;128;386937;376527;59;763464
32;2020-12-19;38;42;80;371211;330938;69;702149
32;2020-12-19;42;30;72;250542;201459;79;452001
32;2020-12-19;25;18;43;163399;89786;89;253185
32;2020-12-19;9;7;16;48384;15367;90;63751
32;2020-12-19;450;407;857;3072879;2889783;0;5962662
44;2020-12-19;17;33;50;291525;306839;09;598364
44;2020-12-19;97;84;182;320255;339504;19;659759
44;2020-12-19;125;74;199;302020;314428;29;616448
44;2020-12-19;113;103;216;342222;333292;39;675514
44;2020-12-19;107;84;191;349727;344491;49;694218
44;2020-12-19;121;116;237;381371;373239;59;754610
44;2020-12-19;75;61;137;367165;335850;69;703015
44;2020-12-19;56;48;104;250387;215436;79;465823
44;2020-12-19;40;29;70;170825;105192;89;276017
44;2020-12-19;28;11;39;51248;16731;90;67979
44;2020-12-19;779;643;1425;2826745;2685002;0;5511747
52;2020-12-19;7;7;14;213594;223900;09;437494
52;2020-12-19;20;21;42;240818;255197;19;496015
52;2020-12-19;25;22;47;197010;200630;29;397640
52;2020-12-19;34;31;65;231204;224885;39;456089
52;2020-12-19;23;31;54;243874;243418;49;487292
52;2020-12-19;26;18;45;244100;239116;59;483216
52;2020-12-19;17;17;34;241796;221345;69;463141
52;2020-12-19;7;10;17;177805;149903;79;327708
52;2020-12-19;17;8;25;119561;75822;89;195383
52;2020-12-19;10;1;11;42559;15260;90;57819
52;2020-12-19;186;166;354;1952321;1849476;0;3801797
53;2020-12-19;2;3;5;173813;182358;09;356171
53;2020-12-19;11;9;20;202720;214740;19;417460
53;2020-12-19;9;9;18;163116;173196;29;336312
53;2020-12-19;8;11;19;190526;187674;39;378200
53;2020-12-19;17;13;30;212098;212015;49;424113
53;2020-12-19;10;4;14;223699;219176;59;442875
53;2020-12-19;4;4;8;227435;209274;69;436709
53;2020-12-19;4;5;9;169992;140910;79;310902
53;2020-12-19;3;2;5;118117;69883;89;188000
53;2020-12-19;4;0;4;37370;12267;90;49637
53;2020-12-19;72;60;132;1718886;1621493;0;3340379
75;2020-12-19;6;6;12;293104;305291;09;598395
75;2020-12-19;28;17;45;337141;357785;19;694926
75;2020-12-19;42;27;69;295024;300618;29;595642
75;2020-12-19;37;44;81;347871;331233;39;679104
75;2020-12-19;41;17;58;384742;372771;49;757513
75;2020-12-19;41;24;65;413361;390880;59;804241
75;2020-12-19;23;27;50;425623;384060;69;809683
75;2020-12-19;11;18;29;325086;276298;79;601384
75;2020-12-19;15;13;28;213986;139308;89;353294
75;2020-12-19;7;4;11;77600;28200;90;105800
75;2020-12-19;251;198;449;3113538;2886444;0;5999982
76;2020-12-19;7;11;18;305956;318589;09;624545
76;2020-12-19;26;27;53;338942;356969;19;695911
76;2020-12-19;53;40;93;316210;319570;29;635780
76;2020-12-19;36;48;84;356758;337587;39;694345
76;2020-12-19;35;34;69;376541;363812;49;740353
76;2020-12-19;48;34;83;402608;383750;59;786358
76;2020-12-19;22;28;50;394889;358997;69;753886
76;2020-12-19;11;12;23;308664;263806;79;572470
76;2020-12-19;14;9;23;195838;129272;89;325110
76;2020-12-19;6;3;9;69372;26728;90;96100
76;2020-12-19;260;246;507;3065778;2859080;0;5924858
84;2020-12-19;42;39;82;459549;481088;09;940637
84;2020-12-19;182;149;333;487711;511905;19;999616
84;2020-12-19;166;135;301;443824;451094;29;894918
84;2020-12-19;186;183;369;512522;493262;39;1005784
84;2020-12-19;217;175;394;520248;515106;49;1035354
84;2020-12-19;209;159;368;529611;514848;59;1044459
84;2020-12-19;161;163;324;486720;439940;69;926660
84;2020-12-19;133;124;257;372151;315211;79;687362
84;2020-12-19;66;58;124;237198;150524;89;387722
84;2020-12-19;20;17;37;81185;28680;90;109865
84;2020-12-19;1382;1203;2590;4130719;3901658;0;8032377
93;2020-12-19;6;11;17;268834;283093;09;551927
93;2020-12-19;41;60;101;280751;296087;19;576838
93;2020-12-19;67;63;130;254404;255552;29;509956
93;2020-12-19;87;74;161;310704;288398;39;599102
93;2020-12-19;82;70;152;325559;305827;49;631386
93;2020-12-19;80;72;152;353104;325389;59;678493
93;2020-12-19;45;62;108;336327;296459;69;632786
93;2020-12-19;39;37;76;279820;229699;79;509519
93;2020-12-19;43;23;66;171274;113716;89;284990
93;2020-12-19;30;9;39;58896;21758;90;80654
93;2020-12-19;520;481;1002;2639673;2415978;0;5055651
94;2020-12-19;1;0;1;16311;17433;09;33744
94;2020-12-19;0;0;0;16679;18132;19;34811
94;2020-12-19;0;1;1;16782;16579;29;33361
94;2020-12-19;0;2;2;23044;20580;39;43624
94;2020-12-19;1;1;2;23065;22140;49;45205
94;2020-12-19;1;2;3;24549;23421;59;47970
94;2020-12-19;1;1;2;23212;21883;69;45095
94;2020-12-19;1;1;2;19544;17141;79;36685
94;2020-12-19;1;0;1;11227;8178;89;19405
94;2020-12-19;1;0;1;3332;1447;90;4779
94;2020-12-19;7;8;15;177745;166934;0;344679
01;2020-12-20;0;0;0;19979;20155;09;40134
01;2020-12-20;1;0;1;24994;25489;19;50483
01;2020-12-20;0;0;0;17868;16690;29;34558
01;2020-12-20;0;0;0;22328;14821;39;37149
01;2020-12-20;1;0;1;28652;20276;49;48928
01;2020-12-20;0;0;0;33264;27260;59;60524
01;2020-12-20;0;0;0;27135;23978;69;51113
01;2020-12-20;0;0;0;18401;14661;79;33062
01;2020-12-20;0;0;0;9633;6375;89;16008
01;2020-12-20;0;0;0;3410;1510;90;4920
01;2020-12-20;2;0;2;205664;171215;0;376879
02;2020-12-20;0;0;0;16881;17110;09;33991
02;2020-12-20;0;0;0;21410;21604;19;43014
02;2020-12-20;1;0;1;16017;15479;29;31496
02;2020-12-20;0;0;0;19825;14455;39;34280
02;2020-12-20;0;1;1;24719;18248;49;42967
02;2020-12-20;0;0;0;34361;28310;59;62671
02;2020-12-20;0;0;0;28061;24495;69;52556
02;2020-12-20;0;0;0;18231;15278;79;33509
02;2020-12-20;0;0;0;11090;7677;89;18767
02;2020-12-20;0;0;0;3992;1506;90;5498
02;2020-12-20;1;1;2;194587;164162;0;358749
03;2020-12-20;0;0;0;31123;30920;09;62043
03;2020-12-20;0;0;0;29370;29268;19;58638
03;2020-12-20;2;2;4;21458;18963;29;40421
03;2020-12-20;1;2;3;21276;18326;39;39602
03;2020-12-20;2;1;3;18164;16593;49;34757
03;2020-12-20;0;0;0;13469;13557;59;27026
03;2020-12-20;1;0;1;8776;8670;69;17446
03;2020-12-20;1;0;1;3777;3591;79;7368
03;2020-12-20;0;0;0;1649;1072;89;2721
03;2020-12-20;0;0;0;485;184;90;669
03;2020-12-20;7;5;12;149547;141144;0;290691
04;2020-12-20;0;0;0;60314;61377;09;121691
04;2020-12-20;1;1;2;66065;68387;19;134452
04;2020-12-20;0;1;1;51059;47156;29;98215
04;2020-12-20;0;1;1;58788;45780;39;104568
04;2020-12-20;0;0;0;61408;52207;49;113615
04;2020-12-20;1;0;1;64838;60759;59;125597
04;2020-12-20;0;0;0;47008;42843;69;89851
04;2020-12-20;0;1;1;25509;21184;79;46693
04;2020-12-20;0;0;0;13168;7647;89;20815
04;2020-12-20;0;0;0;3209;1253;90;4462
04;2020-12-20;2;4;6;451366;408593;0;859959
05;2020-12-20;0;0;0;362.366008612902;341.338819562748;09;703.704828175651
05;2020-12-20;0;0;0;353.376145114279;370.349735405642;19;723.725880519921
05;2020-12-20;0;0;0;218.593559489256;256.539602589476;29;475.133162078732
05;2020-12-20;0;0;0;404.225408693299;360.321910454353;39;764.547319147651
05;2020-12-20;0;0;0;520.067953604221;497.108383964256;49;1017.17633756848
05;2020-12-20;0;0;0;468.146063921917;510.087601910415;59;978.233665832332
05;2020-12-20;0;0;0;340.368470050554;334.366842191253;69;674.735312241807
05;2020-12-20;0;0;0;212.598666888387;192.597753227106;79;405.196420115493
05;2020-12-20;0;0;0;148.727797095705;61.8681715431829;89;210.595968638888
05;2020-12-20;0;0;0;32.9601271090696;10.9909785719784;90;43.9511056810479
05;2020-12-20;0;0;0;3061.43020057959;2935.56979942041;0;5997
06;2020-12-20;0;0;0;42583;42380;09;84963
06;2020-12-20;0;0;0;33369;31925;19;65294
06;2020-12-20;2;0;2;21571;15080;29;36651
06;2020-12-20;0;0;0;21550;16147;39;37697
06;2020-12-20;0;0;0;14193;13939;49;28132
06;2020-12-20;0;0;0;7171;7597;59;14768
06;2020-12-20;0;0;0;3629;4117;69;7746
06;2020-12-20;0;0;0;1577;1457;79;3034
06;2020-12-20;0;0;0;531;474;89;1005
06;2020-12-20;0;0;0;88;93;90;181
06;2020-12-20;2;0;2;146262;133209;0;279471
07;2020-12-20;0;0;0;485;549;09;1034
07;2020-12-20;0;0;0;403;432;19;835
07;2020-12-20;0;0;0;764;841;29;1605
07;2020-12-20;0;0;0;824;928;39;1752
07;2020-12-20;0;0;0;788;1020;49;1808
07;2020-12-20;0;0;0;678;870;59;1548
07;2020-12-20;0;0;0;360;382;69;742
07;2020-12-20;0;0;0;231;190;79;421
07;2020-12-20;0;0;0;114;67;89;181
07;2020-12-20;0;0;0;24;11;90;35
07;2020-12-20;0;0;0;4671;5290;0;9961
08;2020-12-20;0;0;0;2715.22592983026;2997.75551488675;09;5712.98144471701
08;2020-12-20;0;0;0;2778.51901080978;3160.9156459093;19;5939.43465671908
08;2020-12-20;0;0;0;2080.8882988764;1718.16634315323;29;3799.05464202964
08;2020-12-20;0;0;0;2701.8582062647;1896.52641413317;39;4598.38462039786
08;2020-12-20;0;0;0;3151.45861023308;2460.52498233809;49;5611.98359257117
08;2020-12-20;0;0;0;2620.29868333099;2422.23566154656;59;5042.53434487755
08;2020-12-20;0;0;0;1621.44173420671;1438.58325779464;69;3060.02499200135
08;2020-12-20;0;0;0;626.575909335673;526.358467843651;79;1152.93437717932
08;2020-12-20;0;0;0;205.018522985054;140.993639349697;89;346.012162334751
08;2020-12-20;0;0;0;50.0325684687745;20.62259870351;90;70.6551671722846
08;2020-12-20;0;0;0;18551.3174743414;16782.6825256586;0;35334
11;2020-12-20;9;4;16;783071;811785;09;1594856
11;2020-12-20;8;14;22;761456;784653;19;1546109
11;2020-12-20;66;44;110;850145;801772;29;1651917
11;2020-12-20;42;57;100;914360;843488;39;1757848
11;2020-12-20;39;35;74;845609;826202;49;1671811
11;2020-12-20;34;36;70;793566;745070;59;1538636
11;2020-12-20;26;36;62;628649;549192;69;1177841
11;2020-12-20;16;20;36;434606;358356;79;792962
11;2020-12-20;22;11;33;261425;162933;89;424358
11;2020-12-20;9;7;16;89253;32619;90;121872
11;2020-12-20;271;264;539;6362140;5916070;0;12278210
24;2020-12-20;0;1;2;139720;144686;09;284406
24;2020-12-20;8;3;11;152979;161185;19;314164
24;2020-12-20;5;9;14;122237;126536;29;248773
24;2020-12-20;4;8;12;150359;142009;39;292368
24;2020-12-20;9;3;12;161829;158758;49;320587
24;2020-12-20;6;3;9;172552;168011;59;340563
24;2020-12-20;4;6;10;172509;158177;69;330686
24;2020-12-20;3;2;5;129428;110593;79;240021
24;2020-12-20;8;7;15;87342;56882;89;144224
24;2020-12-20;1;0;1;31210;12071;90;43281
24;2020-12-20;48;42;91;1320165;1238908;0;2559073
27;2020-12-20;0;0;0;143373;149679;09;293052
27;2020-12-20;4;3;7;160962;173003;19;333965
27;2020-12-20;19;10;29;133746;142254;29;276000
27;2020-12-20;9;8;17;160004;155407;39;315411
27;2020-12-20;7;7;14;172333;169564;49;341897
27;2020-12-20;9;11;20;189979;183788;59;373767
27;2020-12-20;3;6;9;192591;178206;69;370797
27;2020-12-20;7;14;21;146876;127546;79;274422
27;2020-12-20;14;7;21;96896;61575;89;158471
27;2020-12-20;10;1;11;33148;12109;90;45257
27;2020-12-20;82;67;149;1429908;1353131;0;2783039
28;2020-12-20;3;1;4;180735;186856;09;367591
28;2020-12-20;4;4;8;200125;213621;19;413746
28;2020-12-20;8;5;13;168922;173007;29;341929
28;2020-12-20;12;4;16;196628;188487;39;385115
28;2020-12-20;8;7;15;205396;201699;49;407095
28;2020-12-20;8;3;11;222002;213866;59;435868
28;2020-12-20;3;3;6;224688;203758;69;428446
28;2020-12-20;3;2;5;163192;135543;79;298735
28;2020-12-20;6;7;13;109691;65377;89;175068
28;2020-12-20;1;0;1;37222;12685;90;49907
28;2020-12-20;56;36;92;1708601;1594899;0;3303500
32;2020-12-20;3;3;6;358062;373689;09;731751
32;2020-12-20;14;4;18;387045;406742;19;793787
32;2020-12-20;14;7;21;342304;348587;29;690891
32;2020-12-20;23;16;39;382485;369972;39;752457
32;2020-12-20;20;21;41;382510;376716;49;759226
32;2020-12-20;16;20;36;386937;376527;59;763464
32;2020-12-20;8;15;23;371211;330938;69;702149
32;2020-12-20;6;10;16;250542;201459;79;452001
32;2020-12-20;10;9;19;163399;89786;89;253185
32;2020-12-20;12;2;14;48384;15367;90;63751
32;2020-12-20;126;107;233;3072879;2889783;0;5962662
44;2020-12-20;5;4;9;291525;306839;09;598364
44;2020-12-20;14;4;18;320255;339504;19;659759
44;2020-12-20;21;16;37;302020;314428;29;616448
44;2020-12-20;13;16;29;342222;333292;39;675514
44;2020-12-20;23;14;37;349727;344491;49;694218
44;2020-12-20;17;6;23;381371;373239;59;754610
44;2020-12-20;12;11;23;367165;335850;69;703015
44;2020-12-20;10;11;21;250387;215436;79;465823
44;2020-12-20;18;16;35;170825;105192;89;276017
44;2020-12-20;13;11;24;51248;16731;90;67979
44;2020-12-20;146;109;256;2826745;2685002;0;5511747
52;2020-12-20;2;0;2;213594;223900;09;437494
52;2020-12-20;6;6;12;240818;255197;19;496015
52;2020-12-20;12;1;13;197010;200630;29;397640
52;2020-12-20;11;7;18;231204;224885;39;456089
52;2020-12-20;7;7;14;243874;243418;49;487292
52;2020-12-20;5;7;12;244100;239116;59;483216
52;2020-12-20;3;11;14;241796;221345;69;463141
52;2020-12-20;1;4;5;177805;149903;79;327708
52;2020-12-20;1;7;8;119561;75822;89;195383
52;2020-12-20;6;0;6;42559;15260;90;57819
52;2020-12-20;54;50;104;1952321;1849476;0;3801797
53;2020-12-20;1;0;1;173813;182358;09;356171
53;2020-12-20;2;5;7;202720;214740;19;417460
53;2020-12-20;5;1;6;163116;173196;29;336312
53;2020-12-20;4;5;9;190526;187674;39;378200
53;2020-12-20;4;3;7;212098;212015;49;424113
53;2020-12-20;6;2;8;223699;219176;59;442875
53;2020-12-20;0;1;1;227435;209274;69;436709
53;2020-12-20;0;1;1;169992;140910;79;310902
53;2020-12-20;2;0;2;118117;69883;89;188000
53;2020-12-20;0;0;0;37370;12267;90;49637
53;2020-12-20;24;18;42;1718886;1621493;0;3340379
75;2020-12-20;1;1;2;293104;305291;09;598395
75;2020-12-20;2;3;5;337141;357785;19;694926
75;2020-12-20;3;4;7;295024;300618;29;595642
75;2020-12-20;6;12;18;347871;331233;39;679104
75;2020-12-20;5;1;6;384742;372771;49;757513
75;2020-12-20;7;3;10;413361;390880;59;804241
75;2020-12-20;2;4;6;425623;384060;69;809683
75;2020-12-20;2;2;4;325086;276298;79;601384
75;2020-12-20;8;4;12;213986;139308;89;353294
75;2020-12-20;4;2;6;77600;28200;90;105800
75;2020-12-20;40;36;76;3113538;2886444;0;5999982
76;2020-12-20;2;3;5;305956;318589;09;624545
76;2020-12-20;3;5;8;338942;356969;19;695911
76;2020-12-20;6;7;13;316210;319570;29;635780
76;2020-12-20;4;7;11;356758;337587;39;694345
76;2020-12-20;10;4;14;376541;363812;49;740353
76;2020-12-20;11;4;15;402608;383750;59;786358
76;2020-12-20;4;4;8;394889;358997;69;753886
76;2020-12-20;1;5;6;308664;263806;79;572470
76;2020-12-20;6;5;11;195838;129272;89;325110
76;2020-12-20;1;2;3;69372;26728;90;96100
76;2020-12-20;48;46;94;3065778;2859080;0;5924858
84;2020-12-20;25;31;57;459549;481088;09;940637
84;2020-12-20;118;109;228;487711;511905;19;999616
84;2020-12-20;125;87;213;443824;451094;29;894918
84;2020-12-20;111;106;217;512522;493262;39;1005784
84;2020-12-20;158;127;286;520248;515106;49;1035354
84;2020-12-20;127;116;243;529611;514848;59;1044459
84;2020-12-20;91;83;174;486720;439940;69;926660
84;2020-12-20;69;71;141;372151;315211;79;687362
84;2020-12-20;26;38;64;237198;150524;89;387722
84;2020-12-20;14;5;19;81185;28680;90;109865
84;2020-12-20;864;774;1643;4130719;3901658;0;8032377
93;2020-12-20;3;4;7;268834;283093;09;551927
93;2020-12-20;9;9;18;280751;296087;19;576838
93;2020-12-20;20;14;34;254404;255552;29;509956
93;2020-12-20;21;27;48;310704;288398;39;599102
93;2020-12-20;23;22;45;325559;305827;49;631386
93;2020-12-20;20;20;40;353104;325389;59;678493
93;2020-12-20;16;10;26;336327;296459;69;632786
93;2020-12-20;19;10;29;279820;229699;79;509519
93;2020-12-20;21;11;32;171274;113716;89;284990
93;2020-12-20;13;6;19;58896;21758;90;80654
93;2020-12-20;165;133;298;2639673;2415978;0;5055651
94;2020-12-20;0;0;0;16311;17433;09;33744
94;2020-12-20;0;0;0;16679;18132;19;34811
94;2020-12-20;0;0;0;16782;16579;29;33361
94;2020-12-20;0;1;1;23044;20580;39;43624
94;2020-12-20;0;1;1;23065;22140;49;45205
94;2020-12-20;0;2;2;24549;23421;59;47970
94;2020-12-20;0;0;0;23212;21883;69;45095
94;2020-12-20;1;1;2;19544;17141;79;36685
94;2020-12-20;0;0;0;11227;8178;89;19405
94;2020-12-20;0;0;0;3332;1447;90;4779
94;2020-12-20;1;5;6;177745;166934;0;344679
01;2020-12-21;0;0;0;19979;20155;09;40134
01;2020-12-21;1;0;1;24994;25489;19;50483
01;2020-12-21;1;0;1;17868;16690;29;34558
01;2020-12-21;1;1;2;22328;14821;39;37149
01;2020-12-21;1;1;2;28652;20276;49;48928
01;2020-12-21;2;2;4;33264;27260;59;60524
01;2020-12-21;1;0;1;27135;23978;69;51113
01;2020-12-21;0;0;0;18401;14661;79;33062
01;2020-12-21;0;0;0;9633;6375;89;16008
01;2020-12-21;0;0;0;3410;1510;90;4920
01;2020-12-21;7;4;11;205664;171215;0;376879
02;2020-12-21;0;0;0;16881;17110;09;33991
02;2020-12-21;0;0;0;21410;21604;19;43014
02;2020-12-21;0;0;0;16017;15479;29;31496
02;2020-12-21;1;1;2;19825;14455;39;34280
02;2020-12-21;2;1;3;24719;18248;49;42967
02;2020-12-21;2;2;4;34361;28310;59;62671
02;2020-12-21;0;1;1;28061;24495;69;52556
02;2020-12-21;0;1;1;18231;15278;79;33509
02;2020-12-21;1;0;1;11090;7677;89;18767
02;2020-12-21;0;1;1;3992;1506;90;5498
02;2020-12-21;6;7;13;194587;164162;0;358749
03;2020-12-21;1;1;2;31123;30920;09;62043
03;2020-12-21;2;11;13;29370;29268;19;58638
03;2020-12-21;9;9;18;21458;18963;29;40421
03;2020-12-21;9;11;20;21276;18326;39;39602
03;2020-12-21;20;9;29;18164;16593;49;34757
03;2020-12-21;4;9;13;13469;13557;59;27026
03;2020-12-21;4;5;9;8776;8670;69;17446
03;2020-12-21;2;1;3;3777;3591;79;7368
03;2020-12-21;0;0;0;1649;1072;89;2721
03;2020-12-21;0;0;0;485;184;90;669
03;2020-12-21;51;56;107;149547;141144;0;290691
04;2020-12-21;0;0;0;60314;61377;09;121691
04;2020-12-21;0;3;3;66065;68387;19;134452
04;2020-12-21;3;2;5;51059;47156;29;98215
04;2020-12-21;3;2;5;58788;45780;39;104568
04;2020-12-21;3;6;9;61408;52207;49;113615
04;2020-12-21;3;1;4;64838;60759;59;125597
04;2020-12-21;0;1;1;47008;42843;69;89851
04;2020-12-21;1;1;2;25509;21184;79;46693
04;2020-12-21;1;0;1;13168;7647;89;20815
04;2020-12-21;0;0;0;3209;1253;90;4462
04;2020-12-21;14;16;30;451366;408593;0;859959
05;2020-12-21;0;0;0;362.366008612902;341.338819562748;09;703.704828175651
05;2020-12-21;0;0;0;353.376145114279;370.349735405642;19;723.725880519921
05;2020-12-21;0;0;0;218.593559489256;256.539602589476;29;475.133162078732
05;2020-12-21;0;0;0;404.225408693299;360.321910454353;39;764.547319147651
05;2020-12-21;0;0;0;520.067953604221;497.108383964256;49;1017.17633756848
05;2020-12-21;0;0;0;468.146063921917;510.087601910415;59;978.233665832332
05;2020-12-21;0;0;0;340.368470050554;334.366842191253;69;674.735312241807
05;2020-12-21;0;0;0;212.598666888387;192.597753227106;79;405.196420115493
05;2020-12-21;0;0;0;148.727797095705;61.8681715431829;89;210.595968638888
05;2020-12-21;0;0;0;32.9601271090696;10.9909785719784;90;43.9511056810479
05;2020-12-21;0;0;0;3061.43020057959;2935.56979942041;0;5997
06;2020-12-21;0;0;0;42583;42380;09;84963
06;2020-12-21;4;1;5;33369;31925;19;65294
06;2020-12-21;5;1;6;21571;15080;29;36651
06;2020-12-21;8;5;13;21550;16147;39;37697
06;2020-12-21;5;6;11;14193;13939;49;28132
06;2020-12-21;6;2;8;7171;7597;59;14768
06;2020-12-21;0;0;0;3629;4117;69;7746
06;2020-12-21;1;0;1;1577;1457;79;3034
06;2020-12-21;0;0;0;531;474;89;1005
06;2020-12-21;0;0;0;88;93;90;181
06;2020-12-21;29;15;44;146262;133209;0;279471
07;2020-12-21;0;0;0;485;549;09;1034
07;2020-12-21;0;0;0;403;432;19;835
07;2020-12-21;0;0;0;764;841;29;1605
07;2020-12-21;0;0;0;824;928;39;1752
07;2020-12-21;0;0;0;788;1020;49;1808
07;2020-12-21;0;0;0;678;870;59;1548
07;2020-12-21;0;0;0;360;382;69;742
07;2020-12-21;0;0;0;231;190;79;421
07;2020-12-21;0;0;0;114;67;89;181
07;2020-12-21;0;0;0;24;11;90;35
07;2020-12-21;0;0;0;4671;5290;0;9961
08;2020-12-21;0;0;0;2715.22592983026;2997.75551488675;09;5712.98144471701
08;2020-12-21;0;1;1;2778.51901080978;3160.9156459093;19;5939.43465671908
08;2020-12-21;0;2;2;2080.8882988764;1718.16634315323;29;3799.05464202964
08;2020-12-21;2;0;2;2701.8582062647;1896.52641413317;39;4598.38462039786
08;2020-12-21;0;1;1;3151.45861023308;2460.52498233809;49;5611.98359257117
08;2020-12-21;1;2;3;2620.29868333099;2422.23566154656;59;5042.53434487755
08;2020-12-21;0;2;2;1621.44173420671;1438.58325779464;69;3060.02499200135
08;2020-12-21;0;0;0;626.575909335673;526.358467843651;79;1152.93437717932
08;2020-12-21;0;0;0;205.018522985054;140.993639349697;89;346.012162334751
08;2020-12-21;0;0;0;50.0325684687745;20.62259870351;90;70.6551671722846
08;2020-12-21;3;8;11;18551.3174743414;16782.6825256586;0;35334
11;2020-12-21;56;55;118;783071;811785;09;1594856
11;2020-12-21;195;168;373;761456;784653;19;1546109
11;2020-12-21;336;294;631;850145;801772;29;1651917
11;2020-12-21;360;309;670;914360;843488;39;1757848
11;2020-12-21;318;280;599;845609;826202;49;1671811
11;2020-12-21;290;226;517;793566;745070;59;1538636
11;2020-12-21;190;163;358;628649;549192;69;1177841
11;2020-12-21;95;76;171;434606;358356;79;792962
11;2020-12-21;102;62;164;261425;162933;89;424358
11;2020-12-21;83;35;118;89253;32619;90;121872
11;2020-12-21;2025;1669;3720;6362140;5916070;0;12278210
24;2020-12-21;9;9;20;139720;144686;09;284406
24;2020-12-21;20;24;44;152979;161185;19;314164
24;2020-12-21;49;43;92;122237;126536;29;248773
24;2020-12-21;55;36;91;150359;142009;39;292368
24;2020-12-21;60;47;107;161829;158758;49;320587
24;2020-12-21;61;46;107;172552;168011;59;340563
24;2020-12-21;39;35;74;172509;158177;69;330686
24;2020-12-21;28;27;55;129428;110593;79;240021
24;2020-12-21;30;19;49;87342;56882;89;144224
24;2020-12-21;22;17;39;31210;12071;90;43281
24;2020-12-21;373;303;678;1320165;1238908;0;2559073
27;2020-12-21;21;32;53;143373;149679;09;293052
27;2020-12-21;92;89;181;160962;173003;19;333965
27;2020-12-21;107;70;177;133746;142254;29;276000
27;2020-12-21;112;75;187;160004;155407;39;315411
27;2020-12-21;121;90;211;172333;169564;49;341897
27;2020-12-21;146;121;267;189979;183788;59;373767
27;2020-12-21;89;66;155;192591;178206;69;370797
27;2020-12-21;74;65;139;146876;127546;79;274422
27;2020-12-21;81;64;145;96896;61575;89;158471
27;2020-12-21;92;21;113;33148;12109;90;45257
27;2020-12-21;935;693;1628;1429908;1353131;0;2783039
28;2020-12-21;10;13;23;180735;186856;09;367591
28;2020-12-21;48;34;83;200125;213621;19;413746
28;2020-12-21;61;50;111;168922;173007;29;341929
28;2020-12-21;56;45;101;196628;188487;39;385115
28;2020-12-21;65;63;129;205396;201699;49;407095
28;2020-12-21;66;53;119;222002;213866;59;435868
28;2020-12-21;35;52;87;224688;203758;69;428446
28;2020-12-21;34;22;56;163192;135543;79;298735
28;2020-12-21;33;23;56;109691;65377;89;175068
28;2020-12-21;19;7;26;37222;12685;90;49907
28;2020-12-21;427;362;795;1708601;1594899;0;3303500
32;2020-12-21;30;21;51;358062;373689;09;731751
32;2020-12-21;98;90;188;387045;406742;19;793787
32;2020-12-21;129;121;250;342304;348587;29;690891
32;2020-12-21;176;124;300;382485;369972;39;752457
32;2020-12-21;163;130;293;382510;376716;49;759226
32;2020-12-21;132;128;260;386937;376527;59;763464
32;2020-12-21;103;83;186;371211;330938;69;702149
32;2020-12-21;67;49;116;250542;201459;79;452001
32;2020-12-21;106;40;146;163399;89786;89;253185
32;2020-12-21;77;14;91;48384;15367;90;63751
32;2020-12-21;1081;800;1881;3072879;2889783;0;5962662
44;2020-12-21;37;36;73;291525;306839;09;598364
44;2020-12-21;145;145;295;320255;339504;19;659759
44;2020-12-21;219;162;382;302020;314428;29;616448
44;2020-12-21;256;158;414;342222;333292;39;675514
44;2020-12-21;230;162;392;349727;344491;49;694218
44;2020-12-21;228;187;416;381371;373239;59;754610
44;2020-12-21;165;160;328;367165;335850;69;703015
44;2020-12-21;127;108;238;250387;215436;79;465823
44;2020-12-21;145;59;206;170825;105192;89;276017
44;2020-12-21;84;34;119;51248;16731;90;67979
44;2020-12-21;1636;1212;2865;2826745;2685002;0;5511747
52;2020-12-21;8;6;16;213594;223900;09;437494
52;2020-12-21;34;44;80;240818;255197;19;496015
52;2020-12-21;56;38;94;197010;200630;29;397640
52;2020-12-21;42;37;79;231204;224885;39;456089
52;2020-12-21;66;46;112;243874;243418;49;487292
52;2020-12-21;53;38;91;244100;239116;59;483216
52;2020-12-21;36;32;68;241796;221345;69;463141
52;2020-12-21;30;35;65;177805;149903;79;327708
52;2020-12-21;25;27;52;119561;75822;89;195383
52;2020-12-21;33;15;48;42559;15260;90;57819
52;2020-12-21;383;318;705;1952321;1849476;0;3801797
53;2020-12-21;4;7;11;173813;182358;09;356171
53;2020-12-21;24;21;47;202720;214740;19;417460
53;2020-12-21;19;26;51;163116;173196;29;336312
53;2020-12-21;30;10;40;190526;187674;39;378200
53;2020-12-21;31;21;52;212098;212015;49;424113
53;2020-12-21;25;24;49;223699;219176;59;442875
53;2020-12-21;10;18;28;227435;209274;69;436709
53;2020-12-21;12;18;30;169992;140910;79;310902
53;2020-12-21;15;6;21;118117;69883;89;188000
53;2020-12-21;7;3;10;37370;12267;90;49637
53;2020-12-21;177;154;339;1718886;1621493;0;3340379
75;2020-12-21;16;15;31;293104;305291;09;598395
75;2020-12-21;52;47;99;337141;357785;19;694926
75;2020-12-21;83;69;152;295024;300618;29;595642
75;2020-12-21;94;54;148;347871;331233;39;679104
75;2020-12-21;92;62;154;384742;372771;49;757513
75;2020-12-21;71;66;137;413361;390880;59;804241
75;2020-12-21;58;39;97;425623;384060;69;809683
75;2020-12-21;42;31;73;325086;276298;79;601384
75;2020-12-21;79;42;121;213986;139308;89;353294
75;2020-12-21;60;24;84;77600;28200;90;105800
75;2020-12-21;647;449;1096;3113538;2886444;0;5999982
76;2020-12-21;10;11;23;305956;318589;09;624545
76;2020-12-21;89;66;157;338942;356969;19;695911
76;2020-12-21;92;92;184;316210;319570;29;635780
76;2020-12-21;98;97;195;356758;337587;39;694345
76;2020-12-21;110;97;208;376541;363812;49;740353
76;2020-12-21;116;96;212;402608;383750;59;786358
76;2020-12-21;77;70;147;394889;358997;69;753886
76;2020-12-21;58;61;119;308664;263806;79;572470
76;2020-12-21;56;39;95;195838;129272;89;325110
76;2020-12-21;46;13;59;69372;26728;90;96100
76;2020-12-21;752;642;1399;3065778;2859080;0;5924858
84;2020-12-21;46;64;110;459549;481088;09;940637
84;2020-12-21;186;192;379;487711;511905;19;999616
84;2020-12-21;259;198;458;443824;451094;29;894918
84;2020-12-21;262;192;454;512522;493262;39;1005784
84;2020-12-21;254;210;464;520248;515106;49;1035354
84;2020-12-21;276;225;501;529611;514848;59;1044459
84;2020-12-21;167;156;323;486720;439940;69;926660
84;2020-12-21;139;110;249;372151;315211;79;687362
84;2020-12-21;156;79;235;237198;150524;89;387722
84;2020-12-21;148;43;191;81185;28680;90;109865
84;2020-12-21;1893;1470;3365;4130719;3901658;0;8032377
93;2020-12-21;24;27;52;268834;283093;09;551927
93;2020-12-21;121;115;236;280751;296087;19;576838
93;2020-12-21;205;164;370;254404;255552;29;509956
93;2020-12-21;214;173;387;310704;288398;39;599102
93;2020-12-21;203;155;360;325559;305827;49;631386
93;2020-12-21;222;170;392;353104;325389;59;678493
93;2020-12-21;141;144;285;336327;296459;69;632786
93;2020-12-21;74;81;155;279820;229699;79;509519
93;2020-12-21;111;52;163;171274;113716;89;284990
93;2020-12-21;102;24;126;58896;21758;90;80654
93;2020-12-21;1417;1106;2527;2639673;2415978;0;5055651
94;2020-12-21;0;0;0;16311;17433;09;33744
94;2020-12-21;0;0;0;16679;18132;19;34811
94;2020-12-21;2;1;3;16782;16579;29;33361
94;2020-12-21;6;3;9;23044;20580;39;43624
94;2020-12-21;2;1;3;23065;22140;49;45205
94;2020-12-21;3;3;6;24549;23421;59;47970
94;2020-12-21;3;2;5;23212;21883;69;45095
94;2020-12-21;1;3;4;19544;17141;79;36685
94;2020-12-21;1;0;1;11227;8178;89;19405
94;2020-12-21;1;0;1;3332;1447;90;4779
94;2020-12-21;19;13;32;177745;166934;0;344679
01;2020-12-22;0;0;0;19979;20155;09;40134
01;2020-12-22;0;0;0;24994;25489;19;50483
01;2020-12-22;3;1;4;17868;16690;29;34558
01;2020-12-22;1;0;1;22328;14821;39;37149
01;2020-12-22;1;1;2;28652;20276;49;48928
01;2020-12-22;0;1;1;33264;27260;59;60524
01;2020-12-22;1;1;2;27135;23978;69;51113
01;2020-12-22;0;0;0;18401;14661;79;33062
01;2020-12-22;0;0;0;9633;6375;89;16008
01;2020-12-22;0;1;1;3410;1510;90;4920
01;2020-12-22;6;5;11;205664;171215;0;376879
02;2020-12-22;0;0;0;16881;17110;09;33991
02;2020-12-22;1;2;3;21410;21604;19;43014
02;2020-12-22;0;0;0;16017;15479;29;31496
02;2020-12-22;0;2;2;19825;14455;39;34280
02;2020-12-22;1;1;2;24719;18248;49;42967
02;2020-12-22;0;0;0;34361;28310;59;62671
02;2020-12-22;1;1;2;28061;24495;69;52556
02;2020-12-22;0;0;0;18231;15278;79;33509
02;2020-12-22;1;0;1;11090;7677;89;18767
02;2020-12-22;0;0;0;3992;1506;90;5498
02;2020-12-22;4;6;10;194587;164162;0;358749
03;2020-12-22;0;1;1;31123;30920;09;62043
03;2020-12-22;5;4;9;29370;29268;19;58638
03;2020-12-22;10;8;18;21458;18963;29;40421
03;2020-12-22;11;6;17;21276;18326;39;39602
03;2020-12-22;8;12;20;18164;16593;49;34757
03;2020-12-22;3;12;15;13469;13557;59;27026
03;2020-12-22;1;4;6;8776;8670;69;17446
03;2020-12-22;0;1;1;3777;3591;79;7368
03;2020-12-22;0;1;1;1649;1072;89;2721
03;2020-12-22;0;0;0;485;184;90;669
03;2020-12-22;38;49;88;149547;141144;0;290691
04;2020-12-22;1;1;2;60314;61377;09;121691
04;2020-12-22;6;0;6;66065;68387;19;134452
04;2020-12-22;6;4;10;51059;47156;29;98215
04;2020-12-22;3;2;5;58788;45780;39;104568
04;2020-12-22;3;3;6;61408;52207;49;113615
04;2020-12-22;1;2;3;64838;60759;59;125597
04;2020-12-22;0;2;2;47008;42843;69;89851
04;2020-12-22;1;0;1;25509;21184;79;46693
04;2020-12-22;0;0;0;13168;7647;89;20815
04;2020-12-22;0;0;0;3209;1253;90;4462
04;2020-12-22;21;14;35;451366;408593;0;859959
05;2020-12-22;0;0;0;362.366008612902;341.338819562748;09;703.704828175651
05;2020-12-22;0;0;0;353.376145114279;370.349735405642;19;723.725880519921
05;2020-12-22;0;0;0;218.593559489256;256.539602589476;29;475.133162078732
05;2020-12-22;0;0;0;404.225408693299;360.321910454353;39;764.547319147651
05;2020-12-22;0;0;0;520.067953604221;497.108383964256;49;1017.17633756848
05;2020-12-22;0;0;0;468.146063921917;510.087601910415;59;978.233665832332
05;2020-12-22;0;0;0;340.368470050554;334.366842191253;69;674.735312241807
05;2020-12-22;0;0;0;212.598666888387;192.597753227106;79;405.196420115493
05;2020-12-22;0;0;0;148.727797095705;61.8681715431829;89;210.595968638888
05;2020-12-22;0;0;0;32.9601271090696;10.9909785719784;90;43.9511056810479
05;2020-12-22;0;0;0;3061.43020057959;2935.56979942041;0;5997
06;2020-12-22;0;0;0;42583;42380;09;84963
06;2020-12-22;1;2;3;33369;31925;19;65294
06;2020-12-22;3;3;6;21571;15080;29;36651
06;2020-12-22;5;0;5;21550;16147;39;37697
06;2020-12-22;5;2;7;14193;13939;49;28132
06;2020-12-22;3;2;5;7171;7597;59;14768
06;2020-12-22;0;3;3;3629;4117;69;7746
06;2020-12-22;0;0;0;1577;1457;79;3034
06;2020-12-22;0;2;2;531;474;89;1005
06;2020-12-22;0;0;0;88;93;90;181
06;2020-12-22;17;14;31;146262;133209;0;279471
07;2020-12-22;0;0;0;485;549;09;1034
07;2020-12-22;0;0;0;403;432;19;835
07;2020-12-22;0;0;0;764;841;29;1605
07;2020-12-22;0;0;0;824;928;39;1752
07;2020-12-22;1;1;2;788;1020;49;1808
07;2020-12-22;0;1;1;678;870;59;1548
07;2020-12-22;0;0;0;360;382;69;742
07;2020-12-22;1;1;2;231;190;79;421
07;2020-12-22;0;0;0;114;67;89;181
07;2020-12-22;0;0;0;24;11;90;35
07;2020-12-22;2;3;5;4671;5290;0;9961
08;2020-12-22;0;1;1;2715.22592983026;2997.75551488675;09;5712.98144471701
08;2020-12-22;1;0;1;2778.51901080978;3160.9156459093;19;5939.43465671908
08;2020-12-22;1;1;2;2080.8882988764;1718.16634315323;29;3799.05464202964
08;2020-12-22;0;2;2;2701.8582062647;1896.52641413317;39;4598.38462039786
08;2020-12-22;1;2;3;3151.45861023308;2460.52498233809;49;5611.98359257117
08;2020-12-22;1;3;4;2620.29868333099;2422.23566154656;59;5042.53434487755
08;2020-12-22;0;0;0;1621.44173420671;1438.58325779464;69;3060.02499200135
08;2020-12-22;0;0;0;626.575909335673;526.358467843651;79;1152.93437717932
08;2020-12-22;0;0;0;205.018522985054;140.993639349697;89;346.012162334751
08;2020-12-22;0;0;0;50.0325684687745;20.62259870351;90;70.6551671722846
08;2020-12-22;4;9;13;18551.3174743414;16782.6825256586;0;35334
11;2020-12-22;26;40;70;783071;811785;09;1594856
11;2020-12-22;162;146;314;761456;784653;19;1546109
11;2020-12-22;318;278;597;850145;801772;29;1651917
11;2020-12-22;322;251;573;914360;843488;39;1757848
11;2020-12-22;244;222;466;845609;826202;49;1671811
11;2020-12-22;217;176;393;793566;745070;59;1538636
11;2020-12-22;165;130;295;628649;549192;69;1177841
11;2020-12-22;91;91;182;434606;358356;79;792962
11;2020-12-22;86;50;136;261425;162933;89;424358
11;2020-12-22;60;14;74;89253;32619;90;121872
11;2020-12-22;1692;1399;3105;6362140;5916070;0;12278210
24;2020-12-22;8;8;16;139720;144686;09;284406
24;2020-12-22;22;23;46;152979;161185;19;314164
24;2020-12-22;58;44;102;122237;126536;29;248773
24;2020-12-22;58;27;85;150359;142009;39;292368
24;2020-12-22;44;49;93;161829;158758;49;320587
24;2020-12-22;60;29;89;172552;168011;59;340563
24;2020-12-22;34;23;57;172509;158177;69;330686
24;2020-12-22;24;29;53;129428;110593;79;240021
24;2020-12-22;34;22;56;87342;56882;89;144224
24;2020-12-22;28;11;39;31210;12071;90;43281
24;2020-12-22;370;265;636;1320165;1238908;0;2559073
27;2020-12-22;18;23;41;143373;149679;09;293052
27;2020-12-22;55;75;130;160962;173003;19;333965
27;2020-12-22;112;55;167;133746;142254;29;276000
27;2020-12-22;109;61;170;160004;155407;39;315411
27;2020-12-22;101;74;176;172333;169564;49;341897
27;2020-12-22;98;98;196;189979;183788;59;373767
27;2020-12-22;73;81;154;192591;178206;69;370797
27;2020-12-22;58;42;100;146876;127546;79;274422
27;2020-12-22;76;35;111;96896;61575;89;158471
27;2020-12-22;64;19;83;33148;12109;90;45257
27;2020-12-22;764;563;1328;1429908;1353131;0;2783039
28;2020-12-22;11;12;23;180735;186856;09;367591
28;2020-12-22;43;44;90;200125;213621;19;413746
28;2020-12-22;57;27;84;168922;173007;29;341929
28;2020-12-22;38;35;73;196628;188487;39;385115
28;2020-12-22;55;48;103;205396;201699;49;407095
28;2020-12-22;41;44;85;222002;213866;59;435868
28;2020-12-22;27;37;64;224688;203758;69;428446
28;2020-12-22;23;21;44;163192;135543;79;298735
28;2020-12-22;34;15;49;109691;65377;89;175068
28;2020-12-22;26;11;37;37222;12685;90;49907
28;2020-12-22;355;295;653;1708601;1594899;0;3303500
32;2020-12-22;20;19;39;358062;373689;09;731751
32;2020-12-22;91;77;169;387045;406742;19;793787
32;2020-12-22;159;114;273;342304;348587;29;690891
32;2020-12-22;118;115;233;382485;369972;39;752457
32;2020-12-22;124;116;240;382510;376716;49;759226
32;2020-12-22;107;109;216;386937;376527;59;763464
32;2020-12-22;81;88;169;371211;330938;69;702149
32;2020-12-22;71;71;142;250542;201459;79;452001
32;2020-12-22;107;50;157;163399;89786;89;253185
32;2020-12-22;71;21;92;48384;15367;90;63751
32;2020-12-22;949;780;1730;3072879;2889783;0;5962662
44;2020-12-22;32;23;56;291525;306839;09;598364
44;2020-12-22;117;127;244;320255;339504;19;659759
44;2020-12-22;174;158;334;302020;314428;29;616448
44;2020-12-22;208;157;365;342222;333292;39;675514
44;2020-12-22;195;149;346;349727;344491;49;694218
44;2020-12-22;194;174;369;381371;373239;59;754610
44;2020-12-22;138;128;266;367165;335850;69;703015
44;2020-12-22;112;90;205;250387;215436;79;465823
44;2020-12-22;146;65;214;170825;105192;89;276017
44;2020-12-22;123;26;149;51248;16731;90;67979
44;2020-12-22;1439;1097;2548;2826745;2685002;0;5511747
52;2020-12-22;10;7;17;213594;223900;09;437494
52;2020-12-22;33;44;79;240818;255197;19;496015
52;2020-12-22;43;41;84;197010;200630;29;397640
52;2020-12-22;41;41;82;231204;224885;39;456089
52;2020-12-22;52;42;95;243874;243418;49;487292
52;2020-12-22;52;47;99;244100;239116;59;483216
52;2020-12-22;36;33;69;241796;221345;69;463141
52;2020-12-22;17;20;37;177805;149903;79;327708
52;2020-12-22;26;16;43;119561;75822;89;195383
52;2020-12-22;19;9;28;42559;15260;90;57819
52;2020-12-22;329;300;633;1952321;1849476;0;3801797
53;2020-12-22;1;2;3;173813;182358;09;356171
53;2020-12-22;16;28;44;202720;214740;19;417460
53;2020-12-22;38;19;59;163116;173196;29;336312
53;2020-12-22;22;17;39;190526;187674;39;378200
53;2020-12-22;19;12;31;212098;212015;49;424113
53;2020-12-22;23;20;43;223699;219176;59;442875
53;2020-12-22;13;12;25;227435;209274;69;436709
53;2020-12-22;7;8;15;169992;140910;79;310902
53;2020-12-22;11;9;20;118117;69883;89;188000
53;2020-12-22;9;4;13;37370;12267;90;49637
53;2020-12-22;159;131;292;1718886;1621493;0;3340379
75;2020-12-22;15;18;33;293104;305291;09;598395
75;2020-12-22;54;55;109;337141;357785;19;694926
75;2020-12-22;79;37;116;295024;300618;29;595642
75;2020-12-22;68;59;127;347871;331233;39;679104
75;2020-12-22;64;49;113;384742;372771;49;757513
75;2020-12-22;66;63;129;413361;390880;59;804241
75;2020-12-22;48;53;101;425623;384060;69;809683
75;2020-12-22;27;31;58;325086;276298;79;601384
75;2020-12-22;53;28;81;213986;139308;89;353294
75;2020-12-22;56;12;68;77600;28200;90;105800
75;2020-12-22;530;405;935;3113538;2886444;0;5999982
76;2020-12-22;10;12;23;305956;318589;09;624545
76;2020-12-22;61;56;117;338942;356969;19;695911
76;2020-12-22;115;85;201;316210;319570;29;635780
76;2020-12-22;100;66;166;356758;337587;39;694345
76;2020-12-22;104;72;177;376541;363812;49;740353
76;2020-12-22;96;63;159;402608;383750;59;786358
76;2020-12-22;59;58;117;394889;358997;69;753886
76;2020-12-22;49;31;80;308664;263806;79;572470
76;2020-12-22;50;35;85;195838;129272;89;325110
76;2020-12-22;43;21;64;69372;26728;90;96100
76;2020-12-22;687;499;1189;3065778;2859080;0;5924858
84;2020-12-22;45;43;88;459549;481088;09;940637
84;2020-12-22;154;164;319;487711;511905;19;999616
84;2020-12-22;237;174;411;443824;451094;29;894918
84;2020-12-22;231;180;412;512522;493262;39;1005784
84;2020-12-22;229;211;441;520248;515106;49;1035354
84;2020-12-22;231;184;415;529611;514848;59;1044459
84;2020-12-22;148;143;291;486720;439940;69;926660
84;2020-12-22;128;94;222;372151;315211;79;687362
84;2020-12-22;128;85;213;237198;150524;89;387722
84;2020-12-22;98;19;117;81185;28680;90;109865
84;2020-12-22;1629;1297;2929;4130719;3901658;0;8032377
93;2020-12-22;24;30;54;268834;283093;09;551927
93;2020-12-22;105;94;201;280751;296087;19;576838
93;2020-12-22;156;138;295;254404;255552;29;509956
93;2020-12-22;175;130;307;310704;288398;39;599102
93;2020-12-22;165;123;289;325559;305827;49;631386
93;2020-12-22;174;168;342;353104;325389;59;678493
93;2020-12-22;121;103;224;336327;296459;69;632786
93;2020-12-22;74;99;173;279820;229699;79;509519
93;2020-12-22;107;71;178;171274;113716;89;284990
93;2020-12-22;82;29;111;58896;21758;90;80654
93;2020-12-22;1184;985;2175;2639673;2415978;0;5055651
94;2020-12-22;0;0;0;16311;17433;09;33744
94;2020-12-22;1;0;1;16679;18132;19;34811
94;2020-12-22;1;1;2;16782;16579;29;33361
94;2020-12-22;0;1;1;23044;20580;39;43624
94;2020-12-22;1;2;3;23065;22140;49;45205
94;2020-12-22;2;1;3;24549;23421;59;47970
94;2020-12-22;1;1;2;23212;21883;69;45095
94;2020-12-22;2;2;4;19544;17141;79;36685
94;2020-12-22;0;0;0;11227;8178;89;19405
94;2020-12-22;0;0;0;3332;1447;90;4779
94;2020-12-22;8;8;16;177745;166934;0;344679
01;2020-12-23;0;0;0;19979;20155;09;40134
01;2020-12-23;0;2;2;24994;25489;19;50483
01;2020-12-23;1;0;1;17868;16690;29;34558
01;2020-12-23;6;0;6;22328;14821;39;37149
01;2020-12-23;2;0;2;28652;20276;49;48928
01;2020-12-23;1;0;1;33264;27260;59;60524
01;2020-12-23;0;2;2;27135;23978;69;51113
01;2020-12-23;1;0;1;18401;14661;79;33062
01;2020-12-23;1;0;1;9633;6375;89;16008
01;2020-12-23;0;0;0;3410;1510;90;4920
01;2020-12-23;12;4;16;205664;171215;0;376879
02;2020-12-23;0;0;0;16881;17110;09;33991
02;2020-12-23;1;0;1;21410;21604;19;43014
02;2020-12-23;2;1;3;16017;15479;29;31496
02;2020-12-23;1;0;1;19825;14455;39;34280
02;2020-12-23;1;0;1;24719;18248;49;42967
02;2020-12-23;1;0;1;34361;28310;59;62671
02;2020-12-23;2;2;4;28061;24495;69;52556
02;2020-12-23;0;0;0;18231;15278;79;33509
02;2020-12-23;0;0;0;11090;7677;89;18767
02;2020-12-23;0;0;0;3992;1506;90;5498
02;2020-12-23;8;3;11;194587;164162;0;358749
03;2020-12-23;0;0;0;31123;30920;09;62043
03;2020-12-23;6;0;6;29370;29268;19;58638
03;2020-12-23;9;5;14;21458;18963;29;40421
03;2020-12-23;16;9;25;21276;18326;39;39602
03;2020-12-23;9;10;19;18164;16593;49;34757
03;2020-12-23;3;6;9;13469;13557;59;27026
03;2020-12-23;5;6;11;8776;8670;69;17446
03;2020-12-23;0;0;0;3777;3591;79;7368
03;2020-12-23;0;1;1;1649;1072;89;2721
03;2020-12-23;0;0;0;485;184;90;669
03;2020-12-23;48;37;85;149547;141144;0;290691
04;2020-12-23;1;0;1;60314;61377;09;121691
04;2020-12-23;4;2;6;66065;68387;19;134452
04;2020-12-23;2;3;5;51059;47156;29;98215
04;2020-12-23;1;2;3;58788;45780;39;104568
04;2020-12-23;1;2;3;61408;52207;49;113615
04;2020-12-23;4;3;7;64838;60759;59;125597
04;2020-12-23;1;1;2;47008;42843;69;89851
04;2020-12-23;0;3;3;25509;21184;79;46693
04;2020-12-23;0;0;0;13168;7647;89;20815
04;2020-12-23;0;0;0;3209;1253;90;4462
04;2020-12-23;14;16;30;451366;408593;0;859959
05;2020-12-23;0;0;0;362.366008612902;341.338819562748;09;703.704828175651
05;2020-12-23;0;0;0;353.376145114279;370.349735405642;19;723.725880519921
05;2020-12-23;0;0;0;218.593559489256;256.539602589476;29;475.133162078732
05;2020-12-23;0;0;0;404.225408693299;360.321910454353;39;764.547319147651
05;2020-12-23;0;0;0;520.067953604221;497.108383964256;49;1017.17633756848
05;2020-12-23;0;0;0;468.146063921917;510.087601910415;59;978.233665832332
05;2020-12-23;0;0;0;340.368470050554;334.366842191253;69;674.735312241807
05;2020-12-23;0;0;0;212.598666888387;192.597753227106;79;405.196420115493
05;2020-12-23;0;0;0;148.727797095705;61.8681715431829;89;210.595968638888
05;2020-12-23;0;0;0;32.9601271090696;10.9909785719784;90;43.9511056810479
05;2020-12-23;0;0;0;3061.43020057959;2935.56979942041;0;5997
06;2020-12-23;0;1;1;42583;42380;09;84963
06;2020-12-23;2;2;4;33369;31925;19;65294
06;2020-12-23;2;2;4;21571;15080;29;36651
06;2020-12-23;7;2;9;21550;16147;39;37697
06;2020-12-23;0;3;3;14193;13939;49;28132
06;2020-12-23;1;5;6;7171;7597;59;14768
06;2020-12-23;1;0;1;3629;4117;69;7746
06;2020-12-23;0;0;0;1577;1457;79;3034
06;2020-12-23;0;0;0;531;474;89;1005
06;2020-12-23;0;0;0;88;93;90;181
06;2020-12-23;13;15;28;146262;133209;0;279471
07;2020-12-23;0;0;0;485;549;09;1034
07;2020-12-23;0;0;0;403;432;19;835
07;2020-12-23;0;0;0;764;841;29;1605
07;2020-12-23;0;0;0;824;928;39;1752
07;2020-12-23;0;0;0;788;1020;49;1808
07;2020-12-23;0;0;0;678;870;59;1548
07;2020-12-23;0;0;0;360;382;69;742
07;2020-12-23;0;0;0;231;190;79;421
07;2020-12-23;0;0;0;114;67;89;181
07;2020-12-23;0;0;0;24;11;90;35
07;2020-12-23;0;0;0;4671;5290;0;9961
08;2020-12-23;0;0;0;2715.22592983026;2997.75551488675;09;5712.98144471701
08;2020-12-23;0;1;1;2778.51901080978;3160.9156459093;19;5939.43465671908
08;2020-12-23;0;0;0;2080.8882988764;1718.16634315323;29;3799.05464202964
08;2020-12-23;0;0;0;2701.8582062647;1896.52641413317;39;4598.38462039786
08;2020-12-23;0;1;1;3151.45861023308;2460.52498233809;49;5611.98359257117
08;2020-12-23;0;0;0;2620.29868333099;2422.23566154656;59;5042.53434487755
08;2020-12-23;0;0;0;1621.44173420671;1438.58325779464;69;3060.02499200135
08;2020-12-23;0;1;1;626.575909335673;526.358467843651;79;1152.93437717932
08;2020-12-23;0;0;0;205.018522985054;140.993639349697;89;346.012162334751
08;2020-12-23;0;0;0;50.0325684687745;20.62259870351;90;70.6551671722846
08;2020-12-23;0;3;3;18551.3174743414;16782.6825256586;0;35334
11;2020-12-23;42;39;85;783071;811785;09;1594856
11;2020-12-23;138;135;281;761456;784653;19;1546109
11;2020-12-23;311;236;549;850145;801772;29;1651917
11;2020-12-23;292;246;541;914360;843488;39;1757848
11;2020-12-23;244;223;468;845609;826202;49;1671811
11;2020-12-23;202;182;384;793566;745070;59;1538636
11;2020-12-23;113;142;258;628649;549192;69;1177841
11;2020-12-23;73;75;148;434606;358356;79;792962
11;2020-12-23;88;36;124;261425;162933;89;424358
11;2020-12-23;46;10;56;89253;32619;90;121872
11;2020-12-23;1550;1325;2896;6362140;5916070;0;12278210
24;2020-12-23;4;5;9;139720;144686;09;284406
24;2020-12-23;29;21;50;152979;161185;19;314164
24;2020-12-23;48;41;89;122237;126536;29;248773
24;2020-12-23;56;33;89;150359;142009;39;292368
24;2020-12-23;30;32;62;161829;158758;49;320587
24;2020-12-23;39;36;75;172552;168011;59;340563
24;2020-12-23;33;23;56;172509;158177;69;330686
24;2020-12-23;19;20;39;129428;110593;79;240021
24;2020-12-23;42;21;63;87342;56882;89;144224
24;2020-12-23;41;17;58;31210;12071;90;43281
24;2020-12-23;341;249;590;1320165;1238908;0;2559073
27;2020-12-23;14;16;30;143373;149679;09;293052
27;2020-12-23;54;67;121;160962;173003;19;333965
27;2020-12-23;83;54;137;133746;142254;29;276000
27;2020-12-23;83;54;137;160004;155407;39;315411
27;2020-12-23;92;69;161;172333;169564;49;341897
27;2020-12-23;95;88;183;189979;183788;59;373767
27;2020-12-23;54;57;111;192591;178206;69;370797
27;2020-12-23;52;32;84;146876;127546;79;274422
27;2020-12-23;59;31;90;96896;61575;89;158471
27;2020-12-23;57;10;67;33148;12109;90;45257
27;2020-12-23;644;478;1122;1429908;1353131;0;2783039
28;2020-12-23;10;13;23;180735;186856;09;367591
28;2020-12-23;41;33;77;200125;213621;19;413746
28;2020-12-23;47;35;82;168922;173007;29;341929
28;2020-12-23;41;50;91;196628;188487;39;385115
28;2020-12-23;52;39;91;205396;201699;49;407095
28;2020-12-23;61;51;112;222002;213866;59;435868
28;2020-12-23;38;38;76;224688;203758;69;428446
28;2020-12-23;28;30;58;163192;135543;79;298735
28;2020-12-23;33;16;49;109691;65377;89;175068
28;2020-12-23;14;5;19;37222;12685;90;49907
28;2020-12-23;365;310;678;1708601;1594899;0;3303500
32;2020-12-23;21;18;39;358062;373689;09;731751
32;2020-12-23;90;78;168;387045;406742;19;793787
32;2020-12-23;106;95;201;342304;348587;29;690891
32;2020-12-23;125;102;227;382485;369972;39;752457
32;2020-12-23;98;107;205;382510;376716;49;759226
32;2020-12-23;112;87;199;386937;376527;59;763464
32;2020-12-23;74;69;144;371211;330938;69;702149
32;2020-12-23;57;44;101;250542;201459;79;452001
32;2020-12-23;79;35;114;163399;89786;89;253185
32;2020-12-23;31;8;39;48384;15367;90;63751
32;2020-12-23;793;643;1437;3072879;2889783;0;5962662
44;2020-12-23;28;33;63;291525;306839;09;598364
44;2020-12-23;129;116;245;320255;339504;19;659759
44;2020-12-23;197;158;355;302020;314428;29;616448
44;2020-12-23;217;139;358;342222;333292;39;675514
44;2020-12-23;200;157;358;349727;344491;49;694218
44;2020-12-23;187;152;341;381371;373239;59;754610
44;2020-12-23;124;140;266;367165;335850;69;703015
44;2020-12-23;103;81;187;250387;215436;79;465823
44;2020-12-23;110;72;184;170825;105192;89;276017
44;2020-12-23;76;17;94;51248;16731;90;67979
44;2020-12-23;1372;1066;2453;2826745;2685002;0;5511747
52;2020-12-23;7;11;18;213594;223900;09;437494
52;2020-12-23;51;49;101;240818;255197;19;496015
52;2020-12-23;58;38;96;197010;200630;29;397640
52;2020-12-23;46;46;92;231204;224885;39;456089
52;2020-12-23;51;39;90;243874;243418;49;487292
52;2020-12-23;45;29;74;244100;239116;59;483216
52;2020-12-23;27;33;60;241796;221345;69;463141
52;2020-12-23;22;17;39;177805;149903;79;327708
52;2020-12-23;28;17;45;119561;75822;89;195383
52;2020-12-23;30;12;42;42559;15260;90;57819
52;2020-12-23;365;291;657;1952321;1849476;0;3801797
53;2020-12-23;5;4;10;173813;182358;09;356171
53;2020-12-23;18;18;39;202720;214740;19;417460
53;2020-12-23;31;32;66;163116;173196;29;336312
53;2020-12-23;16;18;34;190526;187674;39;378200
53;2020-12-23;20;16;36;212098;212015;49;424113
53;2020-12-23;24;19;43;223699;219176;59;442875
53;2020-12-23;7;13;20;227435;209274;69;436709
53;2020-12-23;10;3;13;169992;140910;79;310902
53;2020-12-23;15;8;23;118117;69883;89;188000
53;2020-12-23;9;3;12;37370;12267;90;49637
53;2020-12-23;155;134;296;1718886;1621493;0;3340379
75;2020-12-23;19;18;38;293104;305291;09;598395
75;2020-12-23;47;38;85;337141;357785;19;694926
75;2020-12-23;79;54;134;295024;300618;29;595642
75;2020-12-23;77;46;124;347871;331233;39;679104
75;2020-12-23;60;61;122;384742;372771;49;757513
75;2020-12-23;62;44;106;413361;390880;59;804241
75;2020-12-23;41;46;87;425623;384060;69;809683
75;2020-12-23;40;12;52;325086;276298;79;601384
75;2020-12-23;57;24;81;213986;139308;89;353294
75;2020-12-23;58;16;74;77600;28200;90;105800
75;2020-12-23;541;359;904;3113538;2886444;0;5999982
76;2020-12-23;12;16;30;305956;318589;09;624545
76;2020-12-23;51;63;115;338942;356969;19;695911
76;2020-12-23;87;78;165;316210;319570;29;635780
76;2020-12-23;80;84;164;356758;337587;39;694345
76;2020-12-23;78;74;152;376541;363812;49;740353
76;2020-12-23;75;65;140;402608;383750;59;786358
76;2020-12-23;55;44;99;394889;358997;69;753886
76;2020-12-23;37;29;67;308664;263806;79;572470
76;2020-12-23;34;23;57;195838;129272;89;325110
76;2020-12-23;28;8;36;69372;26728;90;96100
76;2020-12-23;537;484;1025;3065778;2859080;0;5924858
84;2020-12-23;43;42;85;459549;481088;09;940637
84;2020-12-23;165;131;297;487711;511905;19;999616
84;2020-12-23;204;154;358;443824;451094;29;894918
84;2020-12-23;243;166;409;512522;493262;39;1005784
84;2020-12-23;208;170;378;520248;515106;49;1035354
84;2020-12-23;196;168;364;529611;514848;59;1044459
84;2020-12-23;115;137;252;486720;439940;69;926660
84;2020-12-23;81;91;172;372151;315211;79;687362
84;2020-12-23;99;50;149;237198;150524;89;387722
84;2020-12-23;60;34;94;81185;28680;90;109865
84;2020-12-23;1414;1143;2558;4130719;3901658;0;8032377
93;2020-12-23;19;17;36;268834;283093;09;551927
93;2020-12-23;113;92;205;280751;296087;19;576838
93;2020-12-23;169;135;304;254404;255552;29;509956
93;2020-12-23;164;133;297;310704;288398;39;599102
93;2020-12-23;163;141;304;325559;305827;49;631386
93;2020-12-23;148;145;293;353104;325389;59;678493
93;2020-12-23;98;105;203;336327;296459;69;632786
93;2020-12-23;79;66;145;279820;229699;79;509519
93;2020-12-23;92;51;143;171274;113716;89;284990
93;2020-12-23;83;11;94;58896;21758;90;80654
93;2020-12-23;1128;896;2024;2639673;2415978;0;5055651
94;2020-12-23;0;0;0;16311;17433;09;33744
94;2020-12-23;0;1;1;16679;18132;19;34811
94;2020-12-23;2;0;2;16782;16579;29;33361
94;2020-12-23;4;2;6;23044;20580;39;43624
94;2020-12-23;2;3;5;23065;22140;49;45205
94;2020-12-23;1;5;6;24549;23421;59;47970
94;2020-12-23;2;0;2;23212;21883;69;45095
94;2020-12-23;1;0;1;19544;17141;79;36685
94;2020-12-23;1;0;1;11227;8178;89;19405
94;2020-12-23;0;0;0;3332;1447;90;4779
94;2020-12-23;13;11;30;177745;166934;0;344679
01;2020-12-24;0;0;0;19979;20155;09;40134
01;2020-12-24;0;4;4;24994;25489;19;50483
01;2020-12-24;1;1;2;17868;16690;29;34558
01;2020-12-24;2;1;3;22328;14821;39;37149
01;2020-12-24;1;1;2;28652;20276;49;48928
01;2020-12-24;1;2;3;33264;27260;59;60524
01;2020-12-24;1;2;3;27135;23978;69;51113
01;2020-12-24;1;1;2;18401;14661;79;33062
01;2020-12-24;1;0;1;9633;6375;89;16008
01;2020-12-24;0;0;0;3410;1510;90;4920
01;2020-12-24;8;12;20;205664;171215;0;376879
02;2020-12-24;0;0;0;16881;17110;09;33991
02;2020-12-24;2;0;2;21410;21604;19;43014
02;2020-12-24;0;0;0;16017;15479;29;31496
02;2020-12-24;0;0;0;19825;14455;39;34280
02;2020-12-24;0;0;0;24719;18248;49;42967
02;2020-12-24;0;1;1;34361;28310;59;62671
02;2020-12-24;0;0;0;28061;24495;69;52556
02;2020-12-24;1;0;1;18231;15278;79;33509
02;2020-12-24;0;0;0;11090;7677;89;18767
02;2020-12-24;0;0;0;3992;1506;90;5498
02;2020-12-24;3;1;4;194587;164162;0;358749
03;2020-12-24;0;2;2;31123;30920;09;62043
03;2020-12-24;3;3;6;29370;29268;19;58638
03;2020-12-24;6;6;12;21458;18963;29;40421
03;2020-12-24;8;6;14;21276;18326;39;39602
03;2020-12-24;6;3;9;18164;16593;49;34757
03;2020-12-24;5;1;6;13469;13557;59;27026
03;2020-12-24;5;2;7;8776;8670;69;17446
03;2020-12-24;1;0;1;3777;3591;79;7368
03;2020-12-24;0;0;0;1649;1072;89;2721
03;2020-12-24;0;0;0;485;184;90;669
03;2020-12-24;34;23;57;149547;141144;0;290691
04;2020-12-24;2;0;2;60314;61377;09;121691
04;2020-12-24;0;1;1;66065;68387;19;134452
04;2020-12-24;2;1;3;51059;47156;29;98215
04;2020-12-24;1;1;2;58788;45780;39;104568
04;2020-12-24;1;2;3;61408;52207;49;113615
04;2020-12-24;1;3;4;64838;60759;59;125597
04;2020-12-24;1;0;1;47008;42843;69;89851
04;2020-12-24;0;0;0;25509;21184;79;46693
04;2020-12-24;0;0;0;13168;7647;89;20815
04;2020-12-24;0;0;0;3209;1253;90;4462
04;2020-12-24;8;8;16;451366;408593;0;859959
05;2020-12-24;0;0;0;362.366008612902;341.338819562748;09;703.704828175651
05;2020-12-24;0;0;0;353.376145114279;370.349735405642;19;723.725880519921
05;2020-12-24;0;0;0;218.593559489256;256.539602589476;29;475.133162078732
05;2020-12-24;0;0;0;404.225408693299;360.321910454353;39;764.547319147651
05;2020-12-24;0;0;0;520.067953604221;497.108383964256;49;1017.17633756848
05;2020-12-24;0;0;0;468.146063921917;510.087601910415;59;978.233665832332
05;2020-12-24;0;0;0;340.368470050554;334.366842191253;69;674.735312241807
05;2020-12-24;0;0;0;212.598666888387;192.597753227106;79;405.196420115493
05;2020-12-24;0;0;0;148.727797095705;61.8681715431829;89;210.595968638888
05;2020-12-24;0;0;0;32.9601271090696;10.9909785719784;90;43.9511056810479
05;2020-12-24;0;0;0;3061.43020057959;2935.56979942041;0;5997
06;2020-12-24;0;0;0;42583;42380;09;84963
06;2020-12-24;0;1;1;33369;31925;19;65294
06;2020-12-24;2;1;3;21571;15080;29;36651
06;2020-12-24;5;2;7;21550;16147;39;37697
06;2020-12-24;6;2;8;14193;13939;49;28132
06;2020-12-24;0;2;2;7171;7597;59;14768
06;2020-12-24;0;2;2;3629;4117;69;7746
06;2020-12-24;0;0;0;1577;1457;79;3034
06;2020-12-24;0;0;0;531;474;89;1005
06;2020-12-24;0;0;0;88;93;90;181
06;2020-12-24;13;10;23;146262;133209;0;279471
07;2020-12-24;0;0;0;485;549;09;1034
07;2020-12-24;0;0;0;403;432;19;835
07;2020-12-24;0;0;0;764;841;29;1605
07;2020-12-24;0;0;0;824;928;39;1752
07;2020-12-24;0;0;0;788;1020;49;1808
07;2020-12-24;0;0;0;678;870;59;1548
07;2020-12-24;0;0;0;360;382;69;742
07;2020-12-24;0;0;0;231;190;79;421
07;2020-12-24;0;0;0;114;67;89;181
07;2020-12-24;0;0;0;24;11;90;35
07;2020-12-24;0;0;0;4671;5290;0;9961
08;2020-12-24;0;0;0;2715.22592983026;2997.75551488675;09;5712.98144471701
08;2020-12-24;0;0;0;2778.51901080978;3160.9156459093;19;5939.43465671908
08;2020-12-24;0;1;1;2080.8882988764;1718.16634315323;29;3799.05464202964
08;2020-12-24;0;1;1;2701.8582062647;1896.52641413317;39;4598.38462039786
08;2020-12-24;1;0;1;3151.45861023308;2460.52498233809;49;5611.98359257117
08;2020-12-24;0;0;0;2620.29868333099;2422.23566154656;59;5042.53434487755
08;2020-12-24;0;0;0;1621.44173420671;1438.58325779464;69;3060.02499200135
08;2020-12-24;0;0;0;626.575909335673;526.358467843651;79;1152.93437717932
08;2020-12-24;0;0;0;205.018522985054;140.993639349697;89;346.012162334751
08;2020-12-24;0;0;0;50.0325684687745;20.62259870351;90;70.6551671722846
08;2020-12-24;1;2;3;18551.3174743414;16782.6825256586;0;35334
11;2020-12-24;37;43;80;783071;811785;09;1594856
11;2020-12-24;135;131;267;761456;784653;19;1546109
11;2020-12-24;242;213;455;850145;801772;29;1651917
11;2020-12-24;255;198;453;914360;843488;39;1757848
11;2020-12-24;195;194;389;845609;826202;49;1671811
11;2020-12-24;198;150;349;793566;745070;59;1538636
11;2020-12-24;124;113;237;628649;549192;69;1177841
11;2020-12-24;60;59;119;434606;358356;79;792962
11;2020-12-24;62;41;104;261425;162933;89;424358
11;2020-12-24;39;15;54;89253;32619;90;121872
11;2020-12-24;1348;1157;2508;6362140;5916070;0;12278210
24;2020-12-24;3;4;7;139720;144686;09;284406
24;2020-12-24;14;23;38;152979;161185;19;314164
24;2020-12-24;36;27;63;122237;126536;29;248773
24;2020-12-24;32;36;68;150359;142009;39;292368
24;2020-12-24;32;28;60;161829;158758;49;320587
24;2020-12-24;36;33;69;172552;168011;59;340563
24;2020-12-24;17;32;49;172509;158177;69;330686
24;2020-12-24;13;25;38;129428;110593;79;240021
24;2020-12-24;24;13;37;87342;56882;89;144224
24;2020-12-24;14;7;21;31210;12071;90;43281
24;2020-12-24;221;228;450;1320165;1238908;0;2559073
27;2020-12-24;14;18;32;143373;149679;09;293052
27;2020-12-24;52;57;109;160962;173003;19;333965
27;2020-12-24;78;58;136;133746;142254;29;276000
27;2020-12-24;69;50;119;160004;155407;39;315411
27;2020-12-24;54;66;120;172333;169564;49;341897
27;2020-12-24;78;61;139;189979;183788;59;373767
27;2020-12-24;43;58;101;192591;178206;69;370797
27;2020-12-24;41;35;76;146876;127546;79;274422
27;2020-12-24;54;29;83;96896;61575;89;158471
27;2020-12-24;28;12;40;33148;12109;90;45257
27;2020-12-24;511;444;955;1429908;1353131;0;2783039
28;2020-12-24;6;7;13;180735;186856;09;367591
28;2020-12-24;29;29;58;200125;213621;19;413746
28;2020-12-24;44;32;76;168922;173007;29;341929
28;2020-12-24;45;30;76;196628;188487;39;385115
28;2020-12-24;33;37;70;205396;201699;49;407095
28;2020-12-24;40;30;70;222002;213866;59;435868
28;2020-12-24;26;25;51;224688;203758;69;428446
28;2020-12-24;20;20;40;163192;135543;79;298735
28;2020-12-24;21;7;28;109691;65377;89;175068
28;2020-12-24;21;3;24;37222;12685;90;49907
28;2020-12-24;285;220;506;1708601;1594899;0;3303500
32;2020-12-24;23;9;32;358062;373689;09;731751
32;2020-12-24;52;50;102;387045;406742;19;793787
32;2020-12-24;86;68;154;342304;348587;29;690891
32;2020-12-24;87;84;171;382485;369972;39;752457
32;2020-12-24;83;73;156;382510;376716;49;759226
32;2020-12-24;62;67;129;386937;376527;59;763464
32;2020-12-24;59;57;116;371211;330938;69;702149
32;2020-12-24;40;39;79;250542;201459;79;452001
32;2020-12-24;46;27;73;163399;89786;89;253185
32;2020-12-24;28;10;38;48384;15367;90;63751
32;2020-12-24;566;484;1050;3072879;2889783;0;5962662
44;2020-12-24;37;22;59;291525;306839;09;598364
44;2020-12-24;73;72;145;320255;339504;19;659759
44;2020-12-24;124;101;225;302020;314428;29;616448
44;2020-12-24;129;106;235;342222;333292;39;675514
44;2020-12-24;123;116;239;349727;344491;49;694218
44;2020-12-24;137;121;258;381371;373239;59;754610
44;2020-12-24;70;86;156;367165;335850;69;703015
44;2020-12-24;62;48;112;250387;215436;79;465823
44;2020-12-24;63;30;93;170825;105192;89;276017
44;2020-12-24;37;12;49;51248;16731;90;67979
44;2020-12-24;855;714;1571;2826745;2685002;0;5511747
52;2020-12-24;3;3;6;213594;223900;09;437494
52;2020-12-24;31;42;73;240818;255197;19;496015
52;2020-12-24;43;45;88;197010;200630;29;397640
52;2020-12-24;39;34;73;231204;224885;39;456089
52;2020-12-24;41;36;77;243874;243418;49;487292
52;2020-12-24;35;37;72;244100;239116;59;483216
52;2020-12-24;30;26;56;241796;221345;69;463141
52;2020-12-24;22;16;38;177805;149903;79;327708
52;2020-12-24;21;10;31;119561;75822;89;195383
52;2020-12-24;20;4;24;42559;15260;90;57819
52;2020-12-24;286;253;539;1952321;1849476;0;3801797
53;2020-12-24;6;2;8;173813;182358;09;356171
53;2020-12-24;15;18;34;202720;214740;19;417460
53;2020-12-24;17;22;39;163116;173196;29;336312
53;2020-12-24;23;8;31;190526;187674;39;378200
53;2020-12-24;16;6;22;212098;212015;49;424113
53;2020-12-24;20;19;39;223699;219176;59;442875
53;2020-12-24;13;9;22;227435;209274;69;436709
53;2020-12-24;10;5;15;169992;140910;79;310902
53;2020-12-24;9;4;13;118117;69883;89;188000
53;2020-12-24;4;0;4;37370;12267;90;49637
53;2020-12-24;133;93;227;1718886;1621493;0;3340379
75;2020-12-24;11;17;28;293104;305291;09;598395
75;2020-12-24;24;38;64;337141;357785;19;694926
75;2020-12-24;65;40;105;295024;300618;29;595642
75;2020-12-24;35;35;70;347871;331233;39;679104
75;2020-12-24;59;40;99;384742;372771;49;757513
75;2020-12-24;50;49;100;413361;390880;59;804241
75;2020-12-24;33;33;66;425623;384060;69;809683
75;2020-12-24;24;18;42;325086;276298;79;601384
75;2020-12-24;27;10;37;213986;139308;89;353294
75;2020-12-24;19;7;26;77600;28200;90;105800
75;2020-12-24;347;287;637;3113538;2886444;0;5999982
76;2020-12-24;8;5;14;305956;318589;09;624545
76;2020-12-24;37;43;81;338942;356969;19;695911
76;2020-12-24;76;94;170;316210;319570;29;635780
76;2020-12-24;67;65;132;356758;337587;39;694345
76;2020-12-24;81;67;148;376541;363812;49;740353
76;2020-12-24;75;67;143;402608;383750;59;786358
76;2020-12-24;58;52;110;394889;358997;69;753886
76;2020-12-24;40;32;72;308664;263806;79;572470
76;2020-12-24;27;23;50;195838;129272;89;325110
76;2020-12-24;36;13;49;69372;26728;90;96100
76;2020-12-24;505;461;969;3065778;2859080;0;5924858
84;2020-12-24;30;34;64;459549;481088;09;940637
84;2020-12-24;132;142;276;487711;511905;19;999616
84;2020-12-24;153;141;294;443824;451094;29;894918
84;2020-12-24;142;125;267;512522;493262;39;1005784
84;2020-12-24;145;142;287;520248;515106;49;1035354
84;2020-12-24;140;130;270;529611;514848;59;1044459
84;2020-12-24;74;90;164;486720;439940;69;926660
84;2020-12-24;66;72;138;372151;315211;79;687362
84;2020-12-24;60;41;101;237198;150524;89;387722
84;2020-12-24;41;10;51;81185;28680;90;109865
84;2020-12-24;983;927;1912;4130719;3901658;0;8032377
93;2020-12-24;18;17;35;268834;283093;09;551927
93;2020-12-24;81;82;164;280751;296087;19;576838
93;2020-12-24;120;113;233;254404;255552;29;509956
93;2020-12-24;121;105;227;310704;288398;39;599102
93;2020-12-24;112;110;222;325559;305827;49;631386
93;2020-12-24;129;116;245;353104;325389;59;678493
93;2020-12-24;87;96;183;336327;296459;69;632786
93;2020-12-24;58;47;105;279820;229699;79;509519
93;2020-12-24;44;33;77;171274;113716;89;284990
93;2020-12-24;49;14;63;58896;21758;90;80654
93;2020-12-24;820;733;1555;2639673;2415978;0;5055651
94;2020-12-24;0;0;0;16311;17433;09;33744
94;2020-12-24;0;1;1;16679;18132;19;34811
94;2020-12-24;2;2;4;16782;16579;29;33361
94;2020-12-24;2;1;3;23044;20580;39;43624
94;2020-12-24;2;3;5;23065;22140;49;45205
94;2020-12-24;1;3;4;24549;23421;59;47970
94;2020-12-24;2;3;5;23212;21883;69;45095
94;2020-12-24;1;2;3;19544;17141;79;36685
94;2020-12-24;0;2;2;11227;8178;89;19405
94;2020-12-24;1;0;1;3332;1447;90;4779
94;2020-12-24;11;17;28;177745;166934;0;344679
01;2020-12-25;0;0;0;19979;20155;09;40134
01;2020-12-25;0;0;0;24994;25489;19;50483
01;2020-12-25;1;0;1;17868;16690;29;34558
01;2020-12-25;0;0;0;22328;14821;39;37149
01;2020-12-25;0;0;0;28652;20276;49;48928
01;2020-12-25;0;0;0;33264;27260;59;60524
01;2020-12-25;1;1;2;27135;23978;69;51113
01;2020-12-25;0;0;0;18401;14661;79;33062
01;2020-12-25;0;0;0;9633;6375;89;16008
01;2020-12-25;0;0;0;3410;1510;90;4920
01;2020-12-25;2;1;3;205664;171215;0;376879
02;2020-12-25;0;0;0;16881;17110;09;33991
02;2020-12-25;0;0;0;21410;21604;19;43014
02;2020-12-25;0;0;0;16017;15479;29;31496
02;2020-12-25;0;0;0;19825;14455;39;34280
02;2020-12-25;0;0;0;24719;18248;49;42967
02;2020-12-25;0;0;0;34361;28310;59;62671
02;2020-12-25;0;0;0;28061;24495;69;52556
02;2020-12-25;0;0;0;18231;15278;79;33509
02;2020-12-25;0;0;0;11090;7677;89;18767
02;2020-12-25;0;0;0;3992;1506;90;5498
02;2020-12-25;0;0;0;194587;164162;0;358749
03;2020-12-25;0;0;0;31123;30920;09;62043
03;2020-12-25;0;0;0;29370;29268;19;58638
03;2020-12-25;3;0;3;21458;18963;29;40421
03;2020-12-25;0;0;0;21276;18326;39;39602
03;2020-12-25;0;1;1;18164;16593;49;34757
03;2020-12-25;0;0;0;13469;13557;59;27026
03;2020-12-25;0;1;1;8776;8670;69;17446
03;2020-12-25;0;0;0;3777;3591;79;7368
03;2020-12-25;0;0;0;1649;1072;89;2721
03;2020-12-25;0;0;0;485;184;90;669
03;2020-12-25;3;2;5;149547;141144;0;290691
04;2020-12-25;0;0;0;60314;61377;09;121691
04;2020-12-25;0;0;0;66065;68387;19;134452
04;2020-12-25;0;0;0;51059;47156;29;98215
04;2020-12-25;1;0;1;58788;45780;39;104568
04;2020-12-25;0;0;0;61408;52207;49;113615
04;2020-12-25;0;0;0;64838;60759;59;125597
04;2020-12-25;1;0;1;47008;42843;69;89851
04;2020-12-25;0;1;1;25509;21184;79;46693
04;2020-12-25;0;0;0;13168;7647;89;20815
04;2020-12-25;0;0;0;3209;1253;90;4462
04;2020-12-25;2;1;3;451366;408593;0;859959
05;2020-12-25;0;0;0;362.366008612902;341.338819562748;09;703.704828175651
05;2020-12-25;0;0;0;353.376145114279;370.349735405642;19;723.725880519921
05;2020-12-25;0;0;0;218.593559489256;256.539602589476;29;475.133162078732
05;2020-12-25;0;0;0;404.225408693299;360.321910454353;39;764.547319147651
05;2020-12-25;0;0;0;520.067953604221;497.108383964256;49;1017.17633756848
05;2020-12-25;0;0;0;468.146063921917;510.087601910415;59;978.233665832332
05;2020-12-25;0;0;0;340.368470050554;334.366842191253;69;674.735312241807
05;2020-12-25;0;0;0;212.598666888387;192.597753227106;79;405.196420115493
05;2020-12-25;0;0;0;148.727797095705;61.8681715431829;89;210.595968638888
05;2020-12-25;0;0;0;32.9601271090696;10.9909785719784;90;43.9511056810479
05;2020-12-25;0;0;0;3061.43020057959;2935.56979942041;0;5997
06;2020-12-25;0;0;0;42583;42380;09;84963
06;2020-12-25;0;0;0;33369;31925;19;65294
06;2020-12-25;0;0;0;21571;15080;29;36651
06;2020-12-25;1;0;1;21550;16147;39;37697
06;2020-12-25;1;0;1;14193;13939;49;28132
06;2020-12-25;1;0;1;7171;7597;59;14768
06;2020-12-25;0;0;0;3629;4117;69;7746
06;2020-12-25;0;0;0;1577;1457;79;3034
06;2020-12-25;0;0;0;531;474;89;1005
06;2020-12-25;0;0;0;88;93;90;181
06;2020-12-25;3;0;3;146262;133209;0;279471
07;2020-12-25;0;0;0;485;549;09;1034
07;2020-12-25;0;0;0;403;432;19;835
07;2020-12-25;0;0;0;764;841;29;1605
07;2020-12-25;0;0;0;824;928;39;1752
07;2020-12-25;0;0;0;788;1020;49;1808
07;2020-12-25;0;0;0;678;870;59;1548
07;2020-12-25;0;0;0;360;382;69;742
07;2020-12-25;0;0;0;231;190;79;421
07;2020-12-25;0;0;0;114;67;89;181
07;2020-12-25;0;0;0;24;11;90;35
07;2020-12-25;0;0;0;4671;5290;0;9961
08;2020-12-25;0;0;0;2715.22592983026;2997.75551488675;09;5712.98144471701
08;2020-12-25;0;0;0;2778.51901080978;3160.9156459093;19;5939.43465671908
08;2020-12-25;0;0;0;2080.8882988764;1718.16634315323;29;3799.05464202964
08;2020-12-25;0;0;0;2701.8582062647;1896.52641413317;39;4598.38462039786
08;2020-12-25;0;0;0;3151.45861023308;2460.52498233809;49;5611.98359257117
08;2020-12-25;0;0;0;2620.29868333099;2422.23566154656;59;5042.53434487755
08;2020-12-25;0;0;0;1621.44173420671;1438.58325779464;69;3060.02499200135
08;2020-12-25;0;0;0;626.575909335673;526.358467843651;79;1152.93437717932
08;2020-12-25;0;0;0;205.018522985054;140.993639349697;89;346.012162334751
08;2020-12-25;0;0;0;50.0325684687745;20.62259870351;90;70.6551671722846
08;2020-12-25;0;0;0;18551.3174743414;16782.6825256586;0;35334
11;2020-12-25;4;4;8;783071;811785;09;1594856
11;2020-12-25;10;7;17;761456;784653;19;1546109
11;2020-12-25;39;26;65;850145;801772;29;1651917
11;2020-12-25;36;36;72;914360;843488;39;1757848
11;2020-12-25;20;18;38;845609;826202;49;1671811
11;2020-12-25;15;10;25;793566;745070;59;1538636
11;2020-12-25;11;20;31;628649;549192;69;1177841
11;2020-12-25;11;11;22;434606;358356;79;792962
11;2020-12-25;13;12;25;261425;162933;89;424358
11;2020-12-25;8;4;12;89253;32619;90;121872
11;2020-12-25;167;148;315;6362140;5916070;0;12278210
24;2020-12-25;1;1;2;139720;144686;09;284406
24;2020-12-25;2;1;3;152979;161185;19;314164
24;2020-12-25;0;1;1;122237;126536;29;248773
24;2020-12-25;0;4;4;150359;142009;39;292368
24;2020-12-25;4;2;6;161829;158758;49;320587
24;2020-12-25;3;2;5;172552;168011;59;340563
24;2020-12-25;1;4;5;172509;158177;69;330686
24;2020-12-25;1;3;4;129428;110593;79;240021
24;2020-12-25;1;4;5;87342;56882;89;144224
24;2020-12-25;9;1;10;31210;12071;90;43281
24;2020-12-25;22;23;45;1320165;1238908;0;2559073
27;2020-12-25;1;0;1;143373;149679;09;293052
27;2020-12-25;1;2;3;160962;173003;19;333965
27;2020-12-25;3;2;5;133746;142254;29;276000
27;2020-12-25;6;1;7;160004;155407;39;315411
27;2020-12-25;5;3;8;172333;169564;49;341897
27;2020-12-25;4;1;5;189979;183788;59;373767
27;2020-12-25;4;5;9;192591;178206;69;370797
27;2020-12-25;5;8;13;146876;127546;79;274422
27;2020-12-25;11;5;16;96896;61575;89;158471
27;2020-12-25;5;1;6;33148;12109;90;45257
27;2020-12-25;45;28;73;1429908;1353131;0;2783039
28;2020-12-25;3;0;3;180735;186856;09;367591
28;2020-12-25;6;1;7;200125;213621;19;413746
28;2020-12-25;3;5;8;168922;173007;29;341929
28;2020-12-25;6;2;8;196628;188487;39;385115
28;2020-12-25;4;5;9;205396;201699;49;407095
28;2020-12-25;2;5;7;222002;213866;59;435868
28;2020-12-25;0;1;1;224688;203758;69;428446
28;2020-12-25;3;2;5;163192;135543;79;298735
28;2020-12-25;3;4;7;109691;65377;89;175068
28;2020-12-25;2;1;3;37222;12685;90;49907
28;2020-12-25;32;26;58;1708601;1594899;0;3303500
32;2020-12-25;2;1;3;358062;373689;09;731751
32;2020-12-25;6;0;6;387045;406742;19;793787
32;2020-12-25;7;6;13;342304;348587;29;690891
32;2020-12-25;7;10;17;382485;369972;39;752457
32;2020-12-25;6;4;10;382510;376716;49;759226
32;2020-12-25;4;13;18;386937;376527;59;763464
32;2020-12-25;3;4;7;371211;330938;69;702149
32;2020-12-25;6;6;12;250542;201459;79;452001
32;2020-12-25;9;7;16;163399;89786;89;253185
32;2020-12-25;8;4;12;48384;15367;90;63751
32;2020-12-25;58;55;114;3072879;2889783;0;5962662
44;2020-12-25;0;2;2;291525;306839;09;598364
44;2020-12-25;1;4;5;320255;339504;19;659759
44;2020-12-25;13;6;19;302020;314428;29;616448
44;2020-12-25;9;8;17;342222;333292;39;675514
44;2020-12-25;1;9;10;349727;344491;49;694218
44;2020-12-25;8;7;15;381371;373239;59;754610
44;2020-12-25;7;13;20;367165;335850;69;703015
44;2020-12-25;6;10;16;250387;215436;79;465823
44;2020-12-25;15;17;32;170825;105192;89;276017
44;2020-12-25;13;7;20;51248;16731;90;67979
44;2020-12-25;73;83;156;2826745;2685002;0;5511747
52;2020-12-25;0;0;0;213594;223900;09;437494
52;2020-12-25;4;1;5;240818;255197;19;496015
52;2020-12-25;9;1;10;197010;200630;29;397640
52;2020-12-25;3;1;4;231204;224885;39;456089
52;2020-12-25;3;4;7;243874;243418;49;487292
52;2020-12-25;5;3;8;244100;239116;59;483216
52;2020-12-25;2;1;3;241796;221345;69;463141
52;2020-12-25;1;3;4;177805;149903;79;327708
52;2020-12-25;4;1;5;119561;75822;89;195383
52;2020-12-25;2;0;2;42559;15260;90;57819
52;2020-12-25;33;15;48;1952321;1849476;0;3801797
53;2020-12-25;0;0;0;173813;182358;09;356171
53;2020-12-25;0;0;0;202720;214740;19;417460
53;2020-12-25;0;0;0;163116;173196;29;336312
53;2020-12-25;3;0;3;190526;187674;39;378200
53;2020-12-25;1;1;2;212098;212015;49;424113
53;2020-12-25;2;5;7;223699;219176;59;442875
53;2020-12-25;0;1;1;227435;209274;69;436709
53;2020-12-25;2;0;2;169992;140910;79;310902
53;2020-12-25;0;0;0;118117;69883;89;188000
53;2020-12-25;2;0;2;37370;12267;90;49637
53;2020-12-25;10;7;17;1718886;1621493;0;3340379
75;2020-12-25;0;0;0;293104;305291;09;598395
75;2020-12-25;1;3;4;337141;357785;19;694926
75;2020-12-25;4;2;6;295024;300618;29;595642
75;2020-12-25;2;2;4;347871;331233;39;679104
75;2020-12-25;1;0;1;384742;372771;49;757513
75;2020-12-25;3;1;4;413361;390880;59;804241
75;2020-12-25;3;4;7;425623;384060;69;809683
75;2020-12-25;1;5;6;325086;276298;79;601384
75;2020-12-25;5;2;7;213986;139308;89;353294
75;2020-12-25;3;4;7;77600;28200;90;105800
75;2020-12-25;23;23;46;3113538;2886444;0;5999982
76;2020-12-25;0;1;1;305956;318589;09;624545
76;2020-12-25;3;8;11;338942;356969;19;695911
76;2020-12-25;7;10;17;316210;319570;29;635780
76;2020-12-25;9;9;18;356758;337587;39;694345
76;2020-12-25;5;5;10;376541;363812;49;740353
76;2020-12-25;4;6;10;402608;383750;59;786358
76;2020-12-25;4;2;6;394889;358997;69;753886
76;2020-12-25;1;3;4;308664;263806;79;572470
76;2020-12-25;5;0;5;195838;129272;89;325110
76;2020-12-25;2;1;3;69372;26728;90;96100
76;2020-12-25;40;45;85;3065778;2859080;0;5924858
84;2020-12-25;1;3;4;459549;481088;09;940637
84;2020-12-25;12;10;22;487711;511905;19;999616
84;2020-12-25;9;9;18;443824;451094;29;894918
84;2020-12-25;21;15;36;512522;493262;39;1005784
84;2020-12-25;13;6;19;520248;515106;49;1035354
84;2020-12-25;11;15;26;529611;514848;59;1044459
84;2020-12-25;8;5;13;486720;439940;69;926660
84;2020-12-25;9;9;18;372151;315211;79;687362
84;2020-12-25;12;7;19;237198;150524;89;387722
84;2020-12-25;7;7;14;81185;28680;90;109865
84;2020-12-25;103;86;190;4130719;3901658;0;8032377
93;2020-12-25;0;1;1;268834;283093;09;551927
93;2020-12-25;5;3;8;280751;296087;19;576838
93;2020-12-25;10;9;19;254404;255552;29;509956
93;2020-12-25;8;7;15;310704;288398;39;599102
93;2020-12-25;15;10;25;325559;305827;49;631386
93;2020-12-25;9;3;12;353104;325389;59;678493
93;2020-12-25;5;6;11;336327;296459;69;632786
93;2020-12-25;6;6;12;279820;229699;79;509519
93;2020-12-25;12;10;22;171274;113716;89;284990
93;2020-12-25;7;8;15;58896;21758;90;80654
93;2020-12-25;77;63;140;2639673;2415978;0;5055651
94;2020-12-25;1;0;1;16311;17433;09;33744
94;2020-12-25;0;0;0;16679;18132;19;34811
94;2020-12-25;1;0;1;16782;16579;29;33361
94;2020-12-25;0;0;0;23044;20580;39;43624
94;2020-12-25;0;0;0;23065;22140;49;45205
94;2020-12-25;0;1;1;24549;23421;59;47970
94;2020-12-25;0;0;0;23212;21883;69;45095
94;2020-12-25;0;0;0;19544;17141;79;36685
94;2020-12-25;0;0;0;11227;8178;89;19405
94;2020-12-25;0;0;0;3332;1447;90;4779
94;2020-12-25;2;1;3;177745;166934;0;344679
01;2020-12-26;0;0;0;19979;20155;09;40134
01;2020-12-26;0;0;0;24994;25489;19;50483
01;2020-12-26;1;0;1;17868;16690;29;34558
01;2020-12-26;0;0;0;22328;14821;39;37149
01;2020-12-26;1;1;2;28652;20276;49;48928
01;2020-12-26;0;0;0;33264;27260;59;60524
01;2020-12-26;0;0;0;27135;23978;69;51113
01;2020-12-26;0;0;0;18401;14661;79;33062
01;2020-12-26;1;0;1;9633;6375;89;16008
01;2020-12-26;0;0;0;3410;1510;90;4920
01;2020-12-26;3;1;4;205664;171215;0;376879
02;2020-12-26;0;0;0;16881;17110;09;33991
02;2020-12-26;0;0;0;21410;21604;19;43014
02;2020-12-26;1;0;1;16017;15479;29;31496
02;2020-12-26;0;0;0;19825;14455;39;34280
02;2020-12-26;0;0;0;24719;18248;49;42967
02;2020-12-26;1;0;1;34361;28310;59;62671
02;2020-12-26;1;1;2;28061;24495;69;52556
02;2020-12-26;0;0;0;18231;15278;79;33509
02;2020-12-26;1;0;1;11090;7677;89;18767
02;2020-12-26;0;0;0;3992;1506;90;5498
02;2020-12-26;4;1;5;194587;164162;0;358749
03;2020-12-26;0;0;0;31123;30920;09;62043
03;2020-12-26;0;0;0;29370;29268;19;58638
03;2020-12-26;8;3;11;21458;18963;29;40421
03;2020-12-26;7;5;12;21276;18326;39;39602
03;2020-12-26;5;6;11;18164;16593;49;34757
03;2020-12-26;1;5;6;13469;13557;59;27026
03;2020-12-26;4;2;6;8776;8670;69;17446
03;2020-12-26;0;1;1;3777;3591;79;7368
03;2020-12-26;2;0;2;1649;1072;89;2721
03;2020-12-26;0;0;0;485;184;90;669
03;2020-12-26;27;22;49;149547;141144;0;290691
04;2020-12-26;0;0;0;60314;61377;09;121691
04;2020-12-26;0;0;0;66065;68387;19;134452
04;2020-12-26;0;0;0;51059;47156;29;98215
04;2020-12-26;4;3;7;58788;45780;39;104568
04;2020-12-26;2;1;3;61408;52207;49;113615
04;2020-12-26;4;2;6;64838;60759;59;125597
04;2020-12-26;0;0;0;47008;42843;69;89851
04;2020-12-26;0;1;1;25509;21184;79;46693
04;2020-12-26;0;0;0;13168;7647;89;20815
04;2020-12-26;0;0;0;3209;1253;90;4462
04;2020-12-26;10;7;17;451366;408593;0;859959
05;2020-12-26;0;0;0;362.366008612902;341.338819562748;09;703.704828175651
05;2020-12-26;0;0;0;353.376145114279;370.349735405642;19;723.725880519921
05;2020-12-26;0;0;0;218.593559489256;256.539602589476;29;475.133162078732
05;2020-12-26;0;0;0;404.225408693299;360.321910454353;39;764.547319147651
05;2020-12-26;0;0;0;520.067953604221;497.108383964256;49;1017.17633756848
05;2020-12-26;0;0;0;468.146063921917;510.087601910415;59;978.233665832332
05;2020-12-26;0;0;0;340.368470050554;334.366842191253;69;674.735312241807
05;2020-12-26;0;0;0;212.598666888387;192.597753227106;79;405.196420115493
05;2020-12-26;0;0;0;148.727797095705;61.8681715431829;89;210.595968638888
05;2020-12-26;0;0;0;32.9601271090696;10.9909785719784;90;43.9511056810479
05;2020-12-26;0;0;0;3061.43020057959;2935.56979942041;0;5997
06;2020-12-26;0;0;0;42583;42380;09;84963
06;2020-12-26;0;0;0;33369;31925;19;65294
06;2020-12-26;5;0;5;21571;15080;29;36651
06;2020-12-26;1;0;1;21550;16147;39;37697
06;2020-12-26;2;1;3;14193;13939;49;28132
06;2020-12-26;0;1;1;7171;7597;59;14768
06;2020-12-26;0;0;0;3629;4117;69;7746
06;2020-12-26;0;0;0;1577;1457;79;3034
06;2020-12-26;0;0;0;531;474;89;1005
06;2020-12-26;0;0;0;88;93;90;181
06;2020-12-26;8;2;10;146262;133209;0;279471
07;2020-12-26;0;0;0;485;549;09;1034
07;2020-12-26;0;0;0;403;432;19;835
07;2020-12-26;0;0;0;764;841;29;1605
07;2020-12-26;0;0;0;824;928;39;1752
07;2020-12-26;0;0;0;788;1020;49;1808
07;2020-12-26;0;1;1;678;870;59;1548
07;2020-12-26;0;0;0;360;382;69;742
07;2020-12-26;0;0;0;231;190;79;421
07;2020-12-26;0;0;0;114;67;89;181
07;2020-12-26;0;0;0;24;11;90;35
07;2020-12-26;0;1;1;4671;5290;0;9961
08;2020-12-26;0;0;0;2715.22592983026;2997.75551488675;09;5712.98144471701
08;2020-12-26;1;1;2;2778.51901080978;3160.9156459093;19;5939.43465671908
08;2020-12-26;0;0;0;2080.8882988764;1718.16634315323;29;3799.05464202964
08;2020-12-26;0;0;0;2701.8582062647;1896.52641413317;39;4598.38462039786
08;2020-12-26;1;0;1;3151.45861023308;2460.52498233809;49;5611.98359257117
08;2020-12-26;0;0;0;2620.29868333099;2422.23566154656;59;5042.53434487755
08;2020-12-26;0;0;0;1621.44173420671;1438.58325779464;69;3060.02499200135
08;2020-12-26;0;0;0;626.575909335673;526.358467843651;79;1152.93437717932
08;2020-12-26;0;0;0;205.018522985054;140.993639349697;89;346.012162334751
08;2020-12-26;0;0;0;50.0325684687745;20.62259870351;90;70.6551671722846
08;2020-12-26;2;1;3;18551.3174743414;16782.6825256586;0;35334
11;2020-12-26;31;28;61;783071;811785;09;1594856
11;2020-12-26;112;107;225;761456;784653;19;1546109
11;2020-12-26;265;174;439;850145;801772;29;1651917
11;2020-12-26;232;190;423;914360;843488;39;1757848
11;2020-12-26;161;171;335;845609;826202;49;1671811
11;2020-12-26;142;139;281;793566;745070;59;1538636
11;2020-12-26;95;89;189;628649;549192;69;1177841
11;2020-12-26;54;50;104;434606;358356;79;792962
11;2020-12-26;31;31;62;261425;162933;89;424358
11;2020-12-26;10;6;16;89253;32619;90;121872
11;2020-12-26;1133;985;2135;6362140;5916070;0;12278210
24;2020-12-26;1;6;7;139720;144686;09;284406
24;2020-12-26;17;15;32;152979;161185;19;314164
24;2020-12-26;26;24;50;122237;126536;29;248773
24;2020-12-26;13;22;35;150359;142009;39;292368
24;2020-12-26;23;18;41;161829;158758;49;320587
24;2020-12-26;29;24;53;172552;168011;59;340563
24;2020-12-26;17;16;33;172509;158177;69;330686
24;2020-12-26;14;11;25;129428;110593;79;240021
24;2020-12-26;8;3;11;87342;56882;89;144224
24;2020-12-26;7;5;12;31210;12071;90;43281
24;2020-12-26;155;144;299;1320165;1238908;0;2559073
27;2020-12-26;14;9;23;143373;149679;09;293052
27;2020-12-26;34;34;68;160962;173003;19;333965
27;2020-12-26;71;43;114;133746;142254;29;276000
27;2020-12-26;65;47;112;160004;155407;39;315411
27;2020-12-26;64;45;109;172333;169564;49;341897
27;2020-12-26;53;49;102;189979;183788;59;373767
27;2020-12-26;35;57;92;192591;178206;69;370797
27;2020-12-26;27;27;54;146876;127546;79;274422
27;2020-12-26;25;19;44;96896;61575;89;158471
27;2020-12-26;18;6;24;33148;12109;90;45257
27;2020-12-26;406;336;742;1429908;1353131;0;2783039
28;2020-12-26;6;8;14;180735;186856;09;367591
28;2020-12-26;20;22;42;200125;213621;19;413746
28;2020-12-26;29;31;60;168922;173007;29;341929
28;2020-12-26;45;35;80;196628;188487;39;385115
28;2020-12-26;25;30;55;205396;201699;49;407095
28;2020-12-26;22;25;47;222002;213866;59;435868
28;2020-12-26;17;23;40;224688;203758;69;428446
28;2020-12-26;17;13;30;163192;135543;79;298735
28;2020-12-26;10;13;23;109691;65377;89;175068
28;2020-12-26;9;4;13;37222;12685;90;49907
28;2020-12-26;200;204;404;1708601;1594899;0;3303500
32;2020-12-26;14;18;32;358062;373689;09;731751
32;2020-12-26;56;39;95;387045;406742;19;793787
32;2020-12-26;73;66;139;342304;348587;29;690891
32;2020-12-26;78;57;135;382485;369972;39;752457
32;2020-12-26;57;54;111;382510;376716;49;759226
32;2020-12-26;61;61;122;386937;376527;59;763464
32;2020-12-26;39;45;84;371211;330938;69;702149
32;2020-12-26;33;29;62;250542;201459;79;452001
32;2020-12-26;42;19;61;163399;89786;89;253185
32;2020-12-26;22;7;29;48384;15367;90;63751
32;2020-12-26;475;395;870;3072879;2889783;0;5962662
44;2020-12-26;23;11;35;291525;306839;09;598364
44;2020-12-26;49;51;101;320255;339504;19;659759
44;2020-12-26;74;50;124;302020;314428;29;616448
44;2020-12-26;81;70;151;342222;333292;39;675514
44;2020-12-26;70;60;130;349727;344491;49;694218
44;2020-12-26;61;73;134;381371;373239;59;754610
44;2020-12-26;47;49;96;367165;335850;69;703015
44;2020-12-26;33;24;57;250387;215436;79;465823
44;2020-12-26;33;24;57;170825;105192;89;276017
44;2020-12-26;15;8;23;51248;16731;90;67979
44;2020-12-26;486;420;908;2826745;2685002;0;5511747
52;2020-12-26;4;3;8;213594;223900;09;437494
52;2020-12-26;17;20;37;240818;255197;19;496015
52;2020-12-26;42;27;69;197010;200630;29;397640
52;2020-12-26;33;20;54;231204;224885;39;456089
52;2020-12-26;37;24;61;243874;243418;49;487292
52;2020-12-26;31;34;65;244100;239116;59;483216
52;2020-12-26;19;30;50;241796;221345;69;463141
52;2020-12-26;15;15;30;177805;149903;79;327708
52;2020-12-26;22;13;35;119561;75822;89;195383
52;2020-12-26;9;5;14;42559;15260;90;57819
52;2020-12-26;229;191;423;1952321;1849476;0;3801797
53;2020-12-26;3;7;11;173813;182358;09;356171
53;2020-12-26;13;14;27;202720;214740;19;417460
53;2020-12-26;23;15;38;163116;173196;29;336312
53;2020-12-26;21;14;35;190526;187674;39;378200
53;2020-12-26;8;15;23;212098;212015;49;424113
53;2020-12-26;19;19;38;223699;219176;59;442875
53;2020-12-26;9;12;21;227435;209274;69;436709
53;2020-12-26;6;9;15;169992;140910;79;310902
53;2020-12-26;1;2;3;118117;69883;89;188000
53;2020-12-26;2;0;2;37370;12267;90;49637
53;2020-12-26;105;107;213;1718886;1621493;0;3340379
75;2020-12-26;9;10;19;293104;305291;09;598395
75;2020-12-26;31;27;58;337141;357785;19;694926
75;2020-12-26;45;39;84;295024;300618;29;595642
75;2020-12-26;59;33;92;347871;331233;39;679104
75;2020-12-26;33;31;64;384742;372771;49;757513
75;2020-12-26;39;30;69;413361;390880;59;804241
75;2020-12-26;17;23;40;425623;384060;69;809683
75;2020-12-26;22;17;39;325086;276298;79;601384
75;2020-12-26;20;9;29;213986;139308;89;353294
75;2020-12-26;17;4;21;77600;28200;90;105800
75;2020-12-26;293;223;516;3113538;2886444;0;5999982
76;2020-12-26;7;8;15;305956;318589;09;624545
76;2020-12-26;36;27;63;338942;356969;19;695911
76;2020-12-26;54;48;102;316210;319570;29;635780
76;2020-12-26;66;45;111;356758;337587;39;694345
76;2020-12-26;43;33;76;376541;363812;49;740353
76;2020-12-26;53;33;86;402608;383750;59;786358
76;2020-12-26;29;30;59;394889;358997;69;753886
76;2020-12-26;21;18;39;308664;263806;79;572470
76;2020-12-26;16;5;21;195838;129272;89;325110
76;2020-12-26;7;12;19;69372;26728;90;96100
76;2020-12-26;332;259;591;3065778;2859080;0;5924858
84;2020-12-26;19;27;46;459549;481088;09;940637
84;2020-12-26;82;65;148;487711;511905;19;999616
84;2020-12-26;127;99;226;443824;451094;29;894918
84;2020-12-26;144;99;243;512522;493262;39;1005784
84;2020-12-26;134;93;228;520248;515106;49;1035354
84;2020-12-26;103;98;201;529611;514848;59;1044459
84;2020-12-26;60;75;135;486720;439940;69;926660
84;2020-12-26;39;35;74;372151;315211;79;687362
84;2020-12-26;40;19;59;237198;150524;89;387722
84;2020-12-26;25;7;32;81185;28680;90;109865
84;2020-12-26;773;618;1393;4130719;3901658;0;8032377
93;2020-12-26;9;9;19;268834;283093;09;551927
93;2020-12-26;56;50;106;280751;296087;19;576838
93;2020-12-26;117;69;186;254404;255552;29;509956
93;2020-12-26;101;84;185;310704;288398;39;599102
93;2020-12-26;109;72;181;325559;305827;49;631386
93;2020-12-26;92;77;169;353104;325389;59;678493
93;2020-12-26;68;47;115;336327;296459;69;632786
93;2020-12-26;34;37;71;279820;229699;79;509519
93;2020-12-26;25;18;43;171274;113716;89;284990
93;2020-12-26;26;7;33;58896;21758;90;80654
93;2020-12-26;637;470;1108;2639673;2415978;0;5055651
94;2020-12-26;0;0;0;16311;17433;09;33744
94;2020-12-26;1;5;6;16679;18132;19;34811
94;2020-12-26;4;8;12;16782;16579;29;33361
94;2020-12-26;1;3;4;23044;20580;39;43624
94;2020-12-26;2;0;2;23065;22140;49;45205
94;2020-12-26;2;2;4;24549;23421;59;47970
94;2020-12-26;3;5;8;23212;21883;69;45095
94;2020-12-26;4;1;5;19544;17141;79;36685
94;2020-12-26;0;1;1;11227;8178;89;19405
94;2020-12-26;0;0;0;3332;1447;90;4779
94;2020-12-26;17;25;42;177745;166934;0;344679
01;2020-12-27;0;0;0;19979;20155;09;40134
01;2020-12-27;0;0;0;24994;25489;19;50483
01;2020-12-27;0;0;0;17868;16690;29;34558
01;2020-12-27;1;0;1;22328;14821;39;37149
01;2020-12-27;0;1;1;28652;20276;49;48928
01;2020-12-27;3;0;3;33264;27260;59;60524
01;2020-12-27;0;0;0;27135;23978;69;51113
01;2020-12-27;0;0;0;18401;14661;79;33062
01;2020-12-27;0;0;0;9633;6375;89;16008
01;2020-12-27;0;0;0;3410;1510;90;4920
01;2020-12-27;4;1;5;205664;171215;0;376879
02;2020-12-27;0;0;0;16881;17110;09;33991
02;2020-12-27;0;0;0;21410;21604;19;43014
02;2020-12-27;0;0;0;16017;15479;29;31496
02;2020-12-27;0;0;0;19825;14455;39;34280
02;2020-12-27;0;0;0;24719;18248;49;42967
02;2020-12-27;0;0;0;34361;28310;59;62671
02;2020-12-27;0;0;0;28061;24495;69;52556
02;2020-12-27;0;0;0;18231;15278;79;33509
02;2020-12-27;0;0;0;11090;7677;89;18767
02;2020-12-27;0;0;0;3992;1506;90;5498
02;2020-12-27;0;0;0;194587;164162;0;358749
03;2020-12-27;0;0;0;31123;30920;09;62043
03;2020-12-27;0;0;0;29370;29268;19;58638
03;2020-12-27;0;0;0;21458;18963;29;40421
03;2020-12-27;1;0;1;21276;18326;39;39602
03;2020-12-27;0;0;0;18164;16593;49;34757
03;2020-12-27;0;0;0;13469;13557;59;27026
03;2020-12-27;0;0;0;8776;8670;69;17446
03;2020-12-27;0;0;0;3777;3591;79;7368
03;2020-12-27;0;0;0;1649;1072;89;2721
03;2020-12-27;0;0;0;485;184;90;669
03;2020-12-27;1;0;1;149547;141144;0;290691
04;2020-12-27;0;0;0;60314;61377;09;121691
04;2020-12-27;0;0;0;66065;68387;19;134452
04;2020-12-27;1;1;2;51059;47156;29;98215
04;2020-12-27;0;1;1;58788;45780;39;104568
04;2020-12-27;0;1;1;61408;52207;49;113615
04;2020-12-27;1;0;1;64838;60759;59;125597
04;2020-12-27;0;0;0;47008;42843;69;89851
04;2020-12-27;0;0;0;25509;21184;79;46693
04;2020-12-27;0;0;0;13168;7647;89;20815
04;2020-12-27;0;0;0;3209;1253;90;4462
04;2020-12-27;2;3;5;451366;408593;0;859959
05;2020-12-27;0;0;0;362.366008612902;341.338819562748;09;703.704828175651
05;2020-12-27;0;0;0;353.376145114279;370.349735405642;19;723.725880519921
05;2020-12-27;0;0;0;218.593559489256;256.539602589476;29;475.133162078732
05;2020-12-27;0;0;0;404.225408693299;360.321910454353;39;764.547319147651
05;2020-12-27;0;0;0;520.067953604221;497.108383964256;49;1017.17633756848
05;2020-12-27;0;0;0;468.146063921917;510.087601910415;59;978.233665832332
05;2020-12-27;0;0;0;340.368470050554;334.366842191253;69;674.735312241807
05;2020-12-27;0;0;0;212.598666888387;192.597753227106;79;405.196420115493
05;2020-12-27;0;0;0;148.727797095705;61.8681715431829;89;210.595968638888
05;2020-12-27;0;0;0;32.9601271090696;10.9909785719784;90;43.9511056810479
05;2020-12-27;0;0;0;3061.43020057959;2935.56979942041;0;5997
06;2020-12-27;0;0;0;42583;42380;09;84963
06;2020-12-27;0;0;0;33369;31925;19;65294
06;2020-12-27;1;0;1;21571;15080;29;36651
06;2020-12-27;1;0;1;21550;16147;39;37697
06;2020-12-27;0;1;1;14193;13939;49;28132
06;2020-12-27;0;0;0;7171;7597;59;14768
06;2020-12-27;0;0;0;3629;4117;69;7746
06;2020-12-27;0;0;0;1577;1457;79;3034
06;2020-12-27;0;0;0;531;474;89;1005
06;2020-12-27;0;0;0;88;93;90;181
06;2020-12-27;2;1;3;146262;133209;0;279471
07;2020-12-27;0;0;0;485;549;09;1034
07;2020-12-27;0;0;0;403;432;19;835
07;2020-12-27;0;0;0;764;841;29;1605
07;2020-12-27;0;0;0;824;928;39;1752
07;2020-12-27;0;0;0;788;1020;49;1808
07;2020-12-27;0;0;0;678;870;59;1548
07;2020-12-27;0;0;0;360;382;69;742
07;2020-12-27;0;0;0;231;190;79;421
07;2020-12-27;0;0;0;114;67;89;181
07;2020-12-27;0;0;0;24;11;90;35
07;2020-12-27;0;0;0;4671;5290;0;9961
08;2020-12-27;0;0;0;2715.22592983026;2997.75551488675;09;5712.98144471701
08;2020-12-27;0;0;0;2778.51901080978;3160.9156459093;19;5939.43465671908
08;2020-12-27;0;0;0;2080.8882988764;1718.16634315323;29;3799.05464202964
08;2020-12-27;0;0;0;2701.8582062647;1896.52641413317;39;4598.38462039786
08;2020-12-27;0;0;0;3151.45861023308;2460.52498233809;49;5611.98359257117
08;2020-12-27;0;0;0;2620.29868333099;2422.23566154656;59;5042.53434487755
08;2020-12-27;0;0;0;1621.44173420671;1438.58325779464;69;3060.02499200135
08;2020-12-27;0;0;0;626.575909335673;526.358467843651;79;1152.93437717932
08;2020-12-27;0;0;0;205.018522985054;140.993639349697;89;346.012162334751
08;2020-12-27;0;0;0;50.0325684687745;20.62259870351;90;70.6551671722846
08;2020-12-27;0;0;0;18551.3174743414;16782.6825256586;0;35334
11;2020-12-27;9;7;16;783071;811785;09;1594856
11;2020-12-27;17;19;36;761456;784653;19;1546109
11;2020-12-27;43;49;93;850145;801772;29;1651917
11;2020-12-27;40;39;79;914360;843488;39;1757848
11;2020-12-27;20;25;45;845609;826202;49;1671811
11;2020-12-27;30;31;61;793566;745070;59;1538636
11;2020-12-27;20;21;41;628649;549192;69;1177841
11;2020-12-27;10;13;23;434606;358356;79;792962
11;2020-12-27;16;16;32;261425;162933;89;424358
11;2020-12-27;15;10;25;89253;32619;90;121872
11;2020-12-27;220;230;451;6362140;5916070;0;12278210
24;2020-12-27;0;0;0;139720;144686;09;284406
24;2020-12-27;3;1;4;152979;161185;19;314164
24;2020-12-27;4;4;8;122237;126536;29;248773
24;2020-12-27;6;1;7;150359;142009;39;292368
24;2020-12-27;5;4;9;161829;158758;49;320587
24;2020-12-27;4;6;10;172552;168011;59;340563
24;2020-12-27;1;3;4;172509;158177;69;330686
24;2020-12-27;5;9;14;129428;110593;79;240021
24;2020-12-27;10;3;13;87342;56882;89;144224
24;2020-12-27;9;1;10;31210;12071;90;43281
24;2020-12-27;47;32;79;1320165;1238908;0;2559073
27;2020-12-27;1;1;2;143373;149679;09;293052
27;2020-12-27;5;3;8;160962;173003;19;333965
27;2020-12-27;7;2;9;133746;142254;29;276000
27;2020-12-27;10;7;17;160004;155407;39;315411
27;2020-12-27;8;4;12;172333;169564;49;341897
27;2020-12-27;10;6;16;189979;183788;59;373767
27;2020-12-27;5;6;11;192591;178206;69;370797
27;2020-12-27;11;13;24;146876;127546;79;274422
27;2020-12-27;9;10;19;96896;61575;89;158471
27;2020-12-27;4;3;7;33148;12109;90;45257
27;2020-12-27;70;55;125;1429908;1353131;0;2783039
28;2020-12-27;1;2;3;180735;186856;09;367591
28;2020-12-27;3;5;8;200125;213621;19;413746
28;2020-12-27;3;9;12;168922;173007;29;341929
28;2020-12-27;9;4;13;196628;188487;39;385115
28;2020-12-27;5;10;15;205396;201699;49;407095
28;2020-12-27;8;4;12;222002;213866;59;435868
28;2020-12-27;5;3;8;224688;203758;69;428446
28;2020-12-27;5;3;8;163192;135543;79;298735
28;2020-12-27;6;2;8;109691;65377;89;175068
28;2020-12-27;1;2;3;37222;12685;90;49907
28;2020-12-27;46;44;90;1708601;1594899;0;3303500
32;2020-12-27;4;2;6;358062;373689;09;731751
32;2020-12-27;12;4;16;387045;406742;19;793787
32;2020-12-27;20;3;23;342304;348587;29;690891
32;2020-12-27;23;18;41;382485;369972;39;752457
32;2020-12-27;11;15;26;382510;376716;49;759226
32;2020-12-27;10;8;18;386937;376527;59;763464
32;2020-12-27;4;5;9;371211;330938;69;702149
32;2020-12-27;4;10;14;250542;201459;79;452001
32;2020-12-27;14;11;25;163399;89786;89;253185
32;2020-12-27;4;0;4;48384;15367;90;63751
32;2020-12-27;107;76;183;3072879;2889783;0;5962662
44;2020-12-27;1;4;5;291525;306839;09;598364
44;2020-12-27;7;4;11;320255;339504;19;659759
44;2020-12-27;24;11;35;302020;314428;29;616448
44;2020-12-27;23;9;32;342222;333292;39;675514
44;2020-12-27;12;12;24;349727;344491;49;694218
44;2020-12-27;20;15;35;381371;373239;59;754610
44;2020-12-27;10;15;25;367165;335850;69;703015
44;2020-12-27;20;10;30;250387;215436;79;465823
44;2020-12-27;18;9;27;170825;105192;89;276017
44;2020-12-27;15;4;19;51248;16731;90;67979
44;2020-12-27;150;93;243;2826745;2685002;0;5511747
52;2020-12-27;2;0;2;213594;223900;09;437494
52;2020-12-27;2;3;5;240818;255197;19;496015
52;2020-12-27;7;4;11;197010;200630;29;397640
52;2020-12-27;9;5;14;231204;224885;39;456089
52;2020-12-27;3;3;6;243874;243418;49;487292
52;2020-12-27;8;7;15;244100;239116;59;483216
52;2020-12-27;3;3;6;241796;221345;69;463141
52;2020-12-27;2;4;6;177805;149903;79;327708
52;2020-12-27;6;3;9;119561;75822;89;195383
52;2020-12-27;5;2;7;42559;15260;90;57819
52;2020-12-27;47;34;81;1952321;1849476;0;3801797
53;2020-12-27;0;0;0;173813;182358;09;356171
53;2020-12-27;2;1;3;202720;214740;19;417460
53;2020-12-27;3;3;6;163116;173196;29;336312
53;2020-12-27;3;1;4;190526;187674;39;378200
53;2020-12-27;3;2;5;212098;212015;49;424113
53;2020-12-27;2;5;7;223699;219176;59;442875
53;2020-12-27;3;1;4;227435;209274;69;436709
53;2020-12-27;1;4;5;169992;140910;79;310902
53;2020-12-27;1;3;4;118117;69883;89;188000
53;2020-12-27;0;1;1;37370;12267;90;49637
53;2020-12-27;18;21;39;1718886;1621493;0;3340379
75;2020-12-27;5;0;5;293104;305291;09;598395
75;2020-12-27;0;0;0;337141;357785;19;694926
75;2020-12-27;9;7;16;295024;300618;29;595642
75;2020-12-27;9;8;17;347871;331233;39;679104
75;2020-12-27;5;5;10;384742;372771;49;757513
75;2020-12-27;7;8;15;413361;390880;59;804241
75;2020-12-27;4;6;10;425623;384060;69;809683
75;2020-12-27;2;6;8;325086;276298;79;601384
75;2020-12-27;7;10;17;213986;139308;89;353294
75;2020-12-27;8;1;9;77600;28200;90;105800
75;2020-12-27;57;51;108;3113538;2886444;0;5999982
76;2020-12-27;1;1;2;305956;318589;09;624545
76;2020-12-27;6;3;9;338942;356969;19;695911
76;2020-12-27;6;10;16;316210;319570;29;635780
76;2020-12-27;16;20;36;356758;337587;39;694345
76;2020-12-27;13;8;21;376541;363812;49;740353
76;2020-12-27;4;7;11;402608;383750;59;786358
76;2020-12-27;7;8;15;394889;358997;69;753886
76;2020-12-27;6;3;9;308664;263806;79;572470
76;2020-12-27;7;3;10;195838;129272;89;325110
76;2020-12-27;7;2;9;69372;26728;90;96100
76;2020-12-27;73;66;139;3065778;2859080;0;5924858
84;2020-12-27;5;8;13;459549;481088;09;940637
84;2020-12-27;11;13;24;487711;511905;19;999616
84;2020-12-27;25;10;35;443824;451094;29;894918
84;2020-12-27;30;20;50;512522;493262;39;1005784
84;2020-12-27;24;20;44;520248;515106;49;1035354
84;2020-12-27;14;13;28;529611;514848;59;1044459
84;2020-12-27;12;15;27;486720;439940;69;926660
84;2020-12-27;17;17;34;372151;315211;79;687362
84;2020-12-27;25;15;40;237198;150524;89;387722
84;2020-12-27;13;6;19;81185;28680;90;109865
84;2020-12-27;176;137;314;4130719;3901658;0;8032377
93;2020-12-27;2;2;5;268834;283093;09;551927
93;2020-12-27;11;12;23;280751;296087;19;576838
93;2020-12-27;21;18;39;254404;255552;29;509956
93;2020-12-27;28;15;43;310704;288398;39;599102
93;2020-12-27;21;22;43;325559;305827;49;631386
93;2020-12-27;25;11;36;353104;325389;59;678493
93;2020-12-27;13;10;23;336327;296459;69;632786
93;2020-12-27;10;12;22;279820;229699;79;509519
93;2020-12-27;11;12;23;171274;113716;89;284990
93;2020-12-27;9;3;12;58896;21758;90;80654
93;2020-12-27;151;117;269;2639673;2415978;0;5055651
94;2020-12-27;0;0;0;16311;17433;09;33744
94;2020-12-27;0;0;0;16679;18132;19;34811
94;2020-12-27;0;1;1;16782;16579;29;33361
94;2020-12-27;0;0;0;23044;20580;39;43624
94;2020-12-27;0;0;0;23065;22140;49;45205
94;2020-12-27;1;0;1;24549;23421;59;47970
94;2020-12-27;0;2;2;23212;21883;69;45095
94;2020-12-27;0;0;0;19544;17141;79;36685
94;2020-12-27;0;0;0;11227;8178;89;19405
94;2020-12-27;0;0;0;3332;1447;90;4779
94;2020-12-27;1;3;4;177745;166934;0;344679
01;2020-12-28;0;0;0;19979;20155;09;40134
01;2020-12-28;0;0;0;24994;25489;19;50483
01;2020-12-28;4;1;5;17868;16690;29;34558
01;2020-12-28;3;1;4;22328;14821;39;37149
01;2020-12-28;1;1;2;28652;20276;49;48928
01;2020-12-28;2;1;3;33264;27260;59;60524
01;2020-12-28;1;0;1;27135;23978;69;51113
01;2020-12-28;0;2;2;18401;14661;79;33062
01;2020-12-28;0;0;0;9633;6375;89;16008
01;2020-12-28;0;0;0;3410;1510;90;4920
01;2020-12-28;11;6;17;205664;171215;0;376879
02;2020-12-28;0;0;1;16881;17110;09;33991
02;2020-12-28;1;1;2;21410;21604;19;43014
02;2020-12-28;2;0;2;16017;15479;29;31496
02;2020-12-28;1;0;1;19825;14455;39;34280
02;2020-12-28;1;1;2;24719;18248;49;42967
02;2020-12-28;1;2;3;34361;28310;59;62671
02;2020-12-28;1;1;2;28061;24495;69;52556
02;2020-12-28;1;1;2;18231;15278;79;33509
02;2020-12-28;1;0;1;11090;7677;89;18767
02;2020-12-28;0;0;0;3992;1506;90;5498
02;2020-12-28;9;6;16;194587;164162;0;358749
03;2020-12-28;0;0;0;31123;30920;09;62043
03;2020-12-28;10;7;17;29370;29268;19;58638
03;2020-12-28;11;5;16;21458;18963;29;40421
03;2020-12-28;13;12;25;21276;18326;39;39602
03;2020-12-28;12;9;21;18164;16593;49;34757
03;2020-12-28;12;6;18;13469;13557;59;27026
03;2020-12-28;5;6;11;8776;8670;69;17446
03;2020-12-28;3;1;4;3777;3591;79;7368
03;2020-12-28;2;0;2;1649;1072;89;2721
03;2020-12-28;0;0;0;485;184;90;669
03;2020-12-28;68;46;114;149547;141144;0;290691
04;2020-12-28;0;1;1;60314;61377;09;121691
04;2020-12-28;5;2;7;66065;68387;19;134452
04;2020-12-28;3;2;5;51059;47156;29;98215
04;2020-12-28;3;2;5;58788;45780;39;104568
04;2020-12-28;0;3;3;61408;52207;49;113615
04;2020-12-28;5;3;8;64838;60759;59;125597
04;2020-12-28;3;0;3;47008;42843;69;89851
04;2020-12-28;0;1;1;25509;21184;79;46693
04;2020-12-28;0;0;0;13168;7647;89;20815
04;2020-12-28;0;0;0;3209;1253;90;4462
04;2020-12-28;19;14;33;451366;408593;0;859959
05;2020-12-28;0;0;0;362.366008612902;341.338819562748;09;703.704828175651
05;2020-12-28;0;0;0;353.376145114279;370.349735405642;19;723.725880519921
05;2020-12-28;0;0;0;218.593559489256;256.539602589476;29;475.133162078732
05;2020-12-28;0;0;0;404.225408693299;360.321910454353;39;764.547319147651
05;2020-12-28;0;0;0;520.067953604221;497.108383964256;49;1017.17633756848
05;2020-12-28;0;0;0;468.146063921917;510.087601910415;59;978.233665832332
05;2020-12-28;0;0;0;340.368470050554;334.366842191253;69;674.735312241807
05;2020-12-28;0;0;0;212.598666888387;192.597753227106;79;405.196420115493
05;2020-12-28;0;0;0;148.727797095705;61.8681715431829;89;210.595968638888
05;2020-12-28;0;0;0;32.9601271090696;10.9909785719784;90;43.9511056810479
05;2020-12-28;0;0;0;3061.43020057959;2935.56979942041;0;5997
06;2020-12-28;3;1;4;42583;42380;09;84963
06;2020-12-28;3;4;7;33369;31925;19;65294
06;2020-12-28;0;3;3;21571;15080;29;36651
06;2020-12-28;12;2;14;21550;16147;39;37697
06;2020-12-28;3;5;8;14193;13939;49;28132
06;2020-12-28;0;7;7;7171;7597;59;14768
06;2020-12-28;0;1;1;3629;4117;69;7746
06;2020-12-28;0;0;0;1577;1457;79;3034
06;2020-12-28;0;1;1;531;474;89;1005
06;2020-12-28;0;0;0;88;93;90;181
06;2020-12-28;21;24;45;146262;133209;0;279471
07;2020-12-28;0;0;0;485;549;09;1034
07;2020-12-28;0;0;0;403;432;19;835
07;2020-12-28;0;0;0;764;841;29;1605
07;2020-12-28;0;0;0;824;928;39;1752
07;2020-12-28;0;0;0;788;1020;49;1808
07;2020-12-28;0;0;0;678;870;59;1548
07;2020-12-28;0;0;0;360;382;69;742
07;2020-12-28;0;0;0;231;190;79;421
07;2020-12-28;0;0;0;114;67;89;181
07;2020-12-28;0;0;0;24;11;90;35
07;2020-12-28;0;0;0;4671;5290;0;9961
08;2020-12-28;0;0;0;2715.22592983026;2997.75551488675;09;5712.98144471701
08;2020-12-28;0;0;0;2778.51901080978;3160.9156459093;19;5939.43465671908
08;2020-12-28;0;0;0;2080.8882988764;1718.16634315323;29;3799.05464202964
08;2020-12-28;0;0;0;2701.8582062647;1896.52641413317;39;4598.38462039786
08;2020-12-28;0;0;0;3151.45861023308;2460.52498233809;49;5611.98359257117
08;2020-12-28;0;1;1;2620.29868333099;2422.23566154656;59;5042.53434487755
08;2020-12-28;0;0;0;1621.44173420671;1438.58325779464;69;3060.02499200135
08;2020-12-28;0;0;0;626.575909335673;526.358467843651;79;1152.93437717932
08;2020-12-28;0;0;0;205.018522985054;140.993639349697;89;346.012162334751
08;2020-12-28;0;0;0;50.0325684687745;20.62259870351;90;70.6551671722846
08;2020-12-28;0;1;1;18551.3174743414;16782.6825256586;0;35334
11;2020-12-28;52;44;98;783071;811785;09;1594856
11;2020-12-28;172;177;360;761456;784653;19;1546109
11;2020-12-28;411;321;736;850145;801772;29;1651917
11;2020-12-28;404;338;742;914360;843488;39;1757848
11;2020-12-28;323;287;613;845609;826202;49;1671811
11;2020-12-28;296;259;557;793566;745070;59;1538636
11;2020-12-28;208;175;385;628649;549192;69;1177841
11;2020-12-28;131;115;247;434606;358356;79;792962
11;2020-12-28;100;55;155;261425;162933;89;424358
11;2020-12-28;61;22;83;89253;32619;90;121872
11;2020-12-28;2158;1793;3976;6362140;5916070;0;12278210
24;2020-12-28;5;9;15;139720;144686;09;284406
24;2020-12-28;43;49;92;152979;161185;19;314164
24;2020-12-28;57;38;95;122237;126536;29;248773
24;2020-12-28;70;54;124;150359;142009;39;292368
24;2020-12-28;55;47;102;161829;158758;49;320587
24;2020-12-28;69;43;112;172552;168011;59;340563
24;2020-12-28;45;39;84;172509;158177;69;330686
24;2020-12-28;27;31;58;129428;110593;79;240021
24;2020-12-28;25;13;38;87342;56882;89;144224
24;2020-12-28;18;11;29;31210;12071;90;43281
24;2020-12-28;414;334;749;1320165;1238908;0;2559073
27;2020-12-28;13;21;34;143373;149679;09;293052
27;2020-12-28;67;73;141;160962;173003;19;333965
27;2020-12-28;119;86;205;133746;142254;29;276000
27;2020-12-28;142;103;245;160004;155407;39;315411
27;2020-12-28;129;99;228;172333;169564;49;341897
27;2020-12-28;116;121;237;189979;183788;59;373767
27;2020-12-28;73;95;169;192591;178206;69;370797
27;2020-12-28;75;63;138;146876;127546;79;274422
27;2020-12-28;70;51;121;96896;61575;89;158471
27;2020-12-28;58;22;80;33148;12109;90;45257
27;2020-12-28;862;734;1598;1429908;1353131;0;2783039
28;2020-12-28;11;15;26;180735;186856;09;367591
28;2020-12-28;45;47;92;200125;213621;19;413746
28;2020-12-28;78;72;150;168922;173007;29;341929
28;2020-12-28;68;64;132;196628;188487;39;385115
28;2020-12-28;57;54;111;205396;201699;49;407095
28;2020-12-28;69;64;133;222002;213866;59;435868
28;2020-12-28;46;57;103;224688;203758;69;428446
28;2020-12-28;38;35;73;163192;135543;79;298735
28;2020-12-28;31;14;45;109691;65377;89;175068
28;2020-12-28;11;8;19;37222;12685;90;49907
28;2020-12-28;454;430;884;1708601;1594899;0;3303500
32;2020-12-28;22;23;45;358062;373689;09;731751
32;2020-12-28;97;93;190;387045;406742;19;793787
32;2020-12-28;180;162;342;342304;348587;29;690891
32;2020-12-28;147;131;278;382485;369972;39;752457
32;2020-12-28;165;119;284;382510;376716;49;759226
32;2020-12-28;138;141;279;386937;376527;59;763464
32;2020-12-28;107;99;206;371211;330938;69;702149
32;2020-12-28;51;67;118;250542;201459;79;452001
32;2020-12-28;59;35;94;163399;89786;89;253185
32;2020-12-28;49;14;63;48384;15367;90;63751
32;2020-12-28;1015;884;1899;3072879;2889783;0;5962662
44;2020-12-28;39;36;76;291525;306839;09;598364
44;2020-12-28;164;132;298;320255;339504;19;659759
44;2020-12-28;252;215;467;302020;314428;29;616448
44;2020-12-28;299;216;515;342222;333292;39;675514
44;2020-12-28;222;203;425;349727;344491;49;694218
44;2020-12-28;268;210;479;381371;373239;59;754610
44;2020-12-28;199;178;377;367165;335850;69;703015
44;2020-12-28;131;135;267;250387;215436;79;465823
44;2020-12-28;130;72;202;170825;105192;89;276017
44;2020-12-28;79;25;104;51248;16731;90;67979
44;2020-12-28;1783;1422;3210;2826745;2685002;0;5511747
52;2020-12-28;10;5;17;213594;223900;09;437494
52;2020-12-28;55;41;96;240818;255197;19;496015
52;2020-12-28;76;62;138;197010;200630;29;397640
52;2020-12-28;60;44;104;231204;224885;39;456089
52;2020-12-28;67;53;120;243874;243418;49;487292
52;2020-12-28;63;62;125;244100;239116;59;483216
52;2020-12-28;37;35;72;241796;221345;69;463141
52;2020-12-28;25;32;57;177805;149903;79;327708
52;2020-12-28;28;17;45;119561;75822;89;195383
52;2020-12-28;27;10;37;42559;15260;90;57819
52;2020-12-28;448;361;811;1952321;1849476;0;3801797
53;2020-12-28;7;4;11;173813;182358;09;356171
53;2020-12-28;29;32;61;202720;214740;19;417460
53;2020-12-28;49;44;97;163116;173196;29;336312
53;2020-12-28;22;20;42;190526;187674;39;378200
53;2020-12-28;27;43;70;212098;212015;49;424113
53;2020-12-28;31;35;66;223699;219176;59;442875
53;2020-12-28;29;16;45;227435;209274;69;436709
53;2020-12-28;13;15;28;169992;140910;79;310902
53;2020-12-28;11;14;25;118117;69883;89;188000
53;2020-12-28;9;2;11;37370;12267;90;49637
53;2020-12-28;227;225;456;1718886;1621493;0;3340379
75;2020-12-28;21;24;45;293104;305291;09;598395
75;2020-12-28;54;56;113;337141;357785;19;694926
75;2020-12-28;94;70;164;295024;300618;29;595642
75;2020-12-28;116;70;186;347871;331233;39;679104
75;2020-12-28;96;83;179;384742;372771;49;757513
75;2020-12-28;102;71;173;413361;390880;59;804241
75;2020-12-28;46;60;106;425623;384060;69;809683
75;2020-12-28;41;38;79;325086;276298;79;601384
75;2020-12-28;61;29;90;213986;139308;89;353294
75;2020-12-28;50;13;63;77600;28200;90;105800
75;2020-12-28;681;514;1198;3113538;2886444;0;5999982
76;2020-12-28;14;10;25;305956;318589;09;624545
76;2020-12-28;84;53;138;338942;356969;19;695911
76;2020-12-28;114;108;222;316210;319570;29;635780
76;2020-12-28;133;102;235;356758;337587;39;694345
76;2020-12-28;111;98;209;376541;363812;49;740353
76;2020-12-28;112;84;196;402608;383750;59;786358
76;2020-12-28;84;73;157;394889;358997;69;753886
76;2020-12-28;61;55;116;308664;263806;79;572470
76;2020-12-28;61;29;90;195838;129272;89;325110
76;2020-12-28;42;13;55;69372;26728;90;96100
76;2020-12-28;816;625;1443;3065778;2859080;0;5924858
84;2020-12-28;45;37;83;459549;481088;09;940637
84;2020-12-28;198;171;369;487711;511905;19;999616
84;2020-12-28;307;206;515;443824;451094;29;894918
84;2020-12-28;282;229;511;512522;493262;39;1005784
84;2020-12-28;255;204;459;520248;515106;49;1035354
84;2020-12-28;270;243;513;529611;514848;59;1044459
84;2020-12-28;202;164;366;486720;439940;69;926660
84;2020-12-28;107;114;221;372151;315211;79;687362
84;2020-12-28;99;68;167;237198;150524;89;387722
84;2020-12-28;63;13;76;81185;28680;90;109865
84;2020-12-28;1829;1449;3281;4130719;3901658;0;8032377
93;2020-12-28;21;21;42;268834;283093;09;551927
93;2020-12-28;136;127;263;280751;296087;19;576838
93;2020-12-28;201;177;379;254404;255552;29;509956
93;2020-12-28;231;167;399;310704;288398;39;599102
93;2020-12-28;268;197;465;325559;305827;49;631386
93;2020-12-28;242;218;461;353104;325389;59;678493
93;2020-12-28;172;152;325;336327;296459;69;632786
93;2020-12-28;118;105;223;279820;229699;79;509519
93;2020-12-28;110;62;172;171274;113716;89;284990
93;2020-12-28;70;19;89;58896;21758;90;80654
93;2020-12-28;1569;1246;2819;2639673;2415978;0;5055651
94;2020-12-28;1;0;1;16311;17433;09;33744
94;2020-12-28;3;1;5;16679;18132;19;34811
94;2020-12-28;6;2;8;16782;16579;29;33361
94;2020-12-28;4;2;6;23044;20580;39;43624
94;2020-12-28;2;3;5;23065;22140;49;45205
94;2020-12-28;7;4;11;24549;23421;59;47970
94;2020-12-28;1;6;7;23212;21883;69;45095
94;2020-12-28;4;2;6;19544;17141;79;36685
94;2020-12-28;1;0;1;11227;8178;89;19405
94;2020-12-28;0;0;0;3332;1447;90;4779
94;2020-12-28;29;20;50;177745;166934;0;344679
01;2020-12-29;0;0;0;19979;20155;09;40134
01;2020-12-29;1;1;2;24994;25489;19;50483
01;2020-12-29;1;2;3;17868;16690;29;34558
01;2020-12-29;1;0;1;22328;14821;39;37149
01;2020-12-29;2;3;5;28652;20276;49;48928
01;2020-12-29;1;1;2;33264;27260;59;60524
01;2020-12-29;1;0;1;27135;23978;69;51113
01;2020-12-29;1;1;2;18401;14661;79;33062
01;2020-12-29;0;0;0;9633;6375;89;16008
01;2020-12-29;0;0;0;3410;1510;90;4920
01;2020-12-29;8;8;16;205664;171215;0;376879
02;2020-12-29;0;0;0;16881;17110;09;33991
02;2020-12-29;0;0;0;21410;21604;19;43014
02;2020-12-29;2;0;2;16017;15479;29;31496
02;2020-12-29;0;2;2;19825;14455;39;34280
02;2020-12-29;0;0;0;24719;18248;49;42967
02;2020-12-29;2;2;4;34361;28310;59;62671
02;2020-12-29;2;0;2;28061;24495;69;52556
02;2020-12-29;0;0;0;18231;15278;79;33509
02;2020-12-29;0;0;0;11090;7677;89;18767
02;2020-12-29;0;0;0;3992;1506;90;5498
02;2020-12-29;6;4;10;194587;164162;0;358749
03;2020-12-29;2;1;3;31123;30920;09;62043
03;2020-12-29;3;4;7;29370;29268;19;58638
03;2020-12-29;18;9;27;21458;18963;29;40421
03;2020-12-29;16;8;24;21276;18326;39;39602
03;2020-12-29;13;10;23;18164;16593;49;34757
03;2020-12-29;4;6;10;13469;13557;59;27026
03;2020-12-29;5;3;8;8776;8670;69;17446
03;2020-12-29;2;2;4;3777;3591;79;7368
03;2020-12-29;0;0;0;1649;1072;89;2721
03;2020-12-29;0;0;0;485;184;90;669
03;2020-12-29;63;43;106;149547;141144;0;290691
04;2020-12-29;2;0;2;60314;61377;09;121691
04;2020-12-29;4;1;5;66065;68387;19;134452
04;2020-12-29;2;3;5;51059;47156;29;98215
04;2020-12-29;3;2;5;58788;45780;39;104568
04;2020-12-29;4;6;10;61408;52207;49;113615
04;2020-12-29;2;2;5;64838;60759;59;125597
04;2020-12-29;0;1;1;47008;42843;69;89851
04;2020-12-29;0;0;0;25509;21184;79;46693
04;2020-12-29;1;0;1;13168;7647;89;20815
04;2020-12-29;0;0;0;3209;1253;90;4462
04;2020-12-29;18;15;34;451366;408593;0;859959
05;2020-12-29;0;0;0;362.366008612902;341.338819562748;09;703.704828175651
05;2020-12-29;0;0;0;353.376145114279;370.349735405642;19;723.725880519921
05;2020-12-29;0;0;0;218.593559489256;256.539602589476;29;475.133162078732
05;2020-12-29;0;0;0;404.225408693299;360.321910454353;39;764.547319147651
05;2020-12-29;0;0;0;520.067953604221;497.108383964256;49;1017.17633756848
05;2020-12-29;0;0;0;468.146063921917;510.087601910415;59;978.233665832332
05;2020-12-29;0;0;0;340.368470050554;334.366842191253;69;674.735312241807
05;2020-12-29;0;0;0;212.598666888387;192.597753227106;79;405.196420115493
05;2020-12-29;0;0;0;148.727797095705;61.8681715431829;89;210.595968638888
05;2020-12-29;0;0;0;32.9601271090696;10.9909785719784;90;43.9511056810479
05;2020-12-29;0;0;0;3061.43020057959;2935.56979942041;0;5997
06;2020-12-29;0;0;0;42583;42380;09;84963
06;2020-12-29;2;1;3;33369;31925;19;65294
06;2020-12-29;5;3;8;21571;15080;29;36651
06;2020-12-29;3;1;4;21550;16147;39;37697
06;2020-12-29;3;2;5;14193;13939;49;28132
06;2020-12-29;2;2;4;7171;7597;59;14768
06;2020-12-29;1;0;1;3629;4117;69;7746
06;2020-12-29;0;1;1;1577;1457;79;3034
06;2020-12-29;0;0;0;531;474;89;1005
06;2020-12-29;0;0;0;88;93;90;181
06;2020-12-29;16;10;26;146262;133209;0;279471
07;2020-12-29;0;0;0;485;549;09;1034
07;2020-12-29;0;0;0;403;432;19;835
07;2020-12-29;0;0;0;764;841;29;1605
07;2020-12-29;1;0;1;824;928;39;1752
07;2020-12-29;0;0;0;788;1020;49;1808
07;2020-12-29;0;0;0;678;870;59;1548
07;2020-12-29;0;0;0;360;382;69;742
07;2020-12-29;0;0;0;231;190;79;421
07;2020-12-29;0;0;0;114;67;89;181
07;2020-12-29;0;0;0;24;11;90;35
07;2020-12-29;1;0;1;4671;5290;0;9961
08;2020-12-29;0;0;0;2715.22592983026;2997.75551488675;09;5712.98144471701
08;2020-12-29;0;0;0;2778.51901080978;3160.9156459093;19;5939.43465671908
08;2020-12-29;1;1;2;2080.8882988764;1718.16634315323;29;3799.05464202964
08;2020-12-29;0;0;0;2701.8582062647;1896.52641413317;39;4598.38462039786
08;2020-12-29;0;0;0;3151.45861023308;2460.52498233809;49;5611.98359257117
08;2020-12-29;0;0;0;2620.29868333099;2422.23566154656;59;5042.53434487755
08;2020-12-29;0;0;0;1621.44173420671;1438.58325779464;69;3060.02499200135
08;2020-12-29;0;0;0;626.575909335673;526.358467843651;79;1152.93437717932
08;2020-12-29;0;0;0;205.018522985054;140.993639349697;89;346.012162334751
08;2020-12-29;0;0;0;50.0325684687745;20.62259870351;90;70.6551671722846
08;2020-12-29;1;1;2;18551.3174743414;16782.6825256586;0;35334
11;2020-12-29;42;44;87;783071;811785;09;1594856
11;2020-12-29;181;152;336;761456;784653;19;1546109
11;2020-12-29;338;277;616;850145;801772;29;1651917
11;2020-12-29;320;287;607;914360;843488;39;1757848
11;2020-12-29;266;232;498;845609;826202;49;1671811
11;2020-12-29;242;176;418;793566;745070;59;1538636
11;2020-12-29;177;171;350;628649;549192;69;1177841
11;2020-12-29;117;87;204;434606;358356;79;792962
11;2020-12-29;74;50;125;261425;162933;89;424358
11;2020-12-29;55;21;76;89253;32619;90;121872
11;2020-12-29;1813;1498;3319;6362140;5916070;0;12278210
24;2020-12-29;4;5;9;139720;144686;09;284406
24;2020-12-29;36;26;62;152979;161185;19;314164
24;2020-12-29;45;38;83;122237;126536;29;248773
24;2020-12-29;60;32;93;150359;142009;39;292368
24;2020-12-29;50;39;89;161829;158758;49;320587
24;2020-12-29;45;35;80;172552;168011;59;340563
24;2020-12-29;33;39;72;172509;158177;69;330686
24;2020-12-29;24;29;53;129428;110593;79;240021
24;2020-12-29;38;13;51;87342;56882;89;144224
24;2020-12-29;24;9;33;31210;12071;90;43281
24;2020-12-29;359;265;625;1320165;1238908;0;2559073
27;2020-12-29;15;18;33;143373;149679;09;293052
27;2020-12-29;73;82;155;160962;173003;19;333965
27;2020-12-29;101;69;170;133746;142254;29;276000
27;2020-12-29;91;84;175;160004;155407;39;315411
27;2020-12-29;91;87;178;172333;169564;49;341897
27;2020-12-29;113;78;191;189979;183788;59;373767
27;2020-12-29;94;82;176;192591;178206;69;370797
27;2020-12-29;63;62;125;146876;127546;79;274422
27;2020-12-29;88;44;132;96896;61575;89;158471
27;2020-12-29;84;18;102;33148;12109;90;45257
27;2020-12-29;813;625;1438;1429908;1353131;0;2783039
28;2020-12-29;9;12;21;180735;186856;09;367591
28;2020-12-29;46;41;88;200125;213621;19;413746
28;2020-12-29;73;60;133;168922;173007;29;341929
28;2020-12-29;61;57;118;196628;188487;39;385115
28;2020-12-29;47;37;84;205396;201699;49;407095
28;2020-12-29;61;54;115;222002;213866;59;435868
28;2020-12-29;51;51;102;224688;203758;69;428446
28;2020-12-29;32;22;54;163192;135543;79;298735
28;2020-12-29;65;21;86;109691;65377;89;175068
28;2020-12-29;39;11;50;37222;12685;90;49907
28;2020-12-29;484;366;851;1708601;1594899;0;3303500
32;2020-12-29;23;22;45;358062;373689;09;731751
32;2020-12-29;91;95;186;387045;406742;19;793787
32;2020-12-29;161;128;289;342304;348587;29;690891
32;2020-12-29;153;111;265;382485;369972;39;752457
32;2020-12-29;115;113;228;382510;376716;49;759226
32;2020-12-29;136;113;250;386937;376527;59;763464
32;2020-12-29;93;97;190;371211;330938;69;702149
32;2020-12-29;66;56;122;250542;201459;79;452001
32;2020-12-29;67;42;110;163399;89786;89;253185
32;2020-12-29;57;16;73;48384;15367;90;63751
32;2020-12-29;963;793;1759;3072879;2889783;0;5962662
44;2020-12-29;33;29;62;291525;306839;09;598364
44;2020-12-29;130;131;262;320255;339504;19;659759
44;2020-12-29;206;193;399;302020;314428;29;616448
44;2020-12-29;188;169;358;342222;333292;39;675514
44;2020-12-29;190;147;337;349727;344491;49;694218
44;2020-12-29;178;167;346;381371;373239;59;754610
44;2020-12-29;146;144;291;367165;335850;69;703015
44;2020-12-29;114;108;224;250387;215436;79;465823
44;2020-12-29;122;67;190;170825;105192;89;276017
44;2020-12-29;109;32;141;51248;16731;90;67979
44;2020-12-29;1416;1187;2610;2826745;2685002;0;5511747
52;2020-12-29;14;16;31;213594;223900;09;437494
52;2020-12-29;33;46;79;240818;255197;19;496015
52;2020-12-29;56;48;104;197010;200630;29;397640
52;2020-12-29;58;49;107;231204;224885;39;456089
52;2020-12-29;60;47;107;243874;243418;49;487292
52;2020-12-29;64;49;113;244100;239116;59;483216
52;2020-12-29;27;39;67;241796;221345;69;463141
52;2020-12-29;21;23;44;177805;149903;79;327708
52;2020-12-29;25;14;39;119561;75822;89;195383
52;2020-12-29;21;10;31;42559;15260;90;57819
52;2020-12-29;379;341;722;1952321;1849476;0;3801797
53;2020-12-29;7;5;12;173813;182358;09;356171
53;2020-12-29;15;19;34;202720;214740;19;417460
53;2020-12-29;49;36;86;163116;173196;29;336312
53;2020-12-29;33;21;54;190526;187674;39;378200
53;2020-12-29;24;23;47;212098;212015;49;424113
53;2020-12-29;24;15;39;223699;219176;59;442875
53;2020-12-29;22;15;37;227435;209274;69;436709
53;2020-12-29;13;11;24;169992;140910;79;310902
53;2020-12-29;13;4;17;118117;69883;89;188000
53;2020-12-29;4;6;10;37370;12267;90;49637
53;2020-12-29;204;155;360;1718886;1621493;0;3340379
75;2020-12-29;12;16;28;293104;305291;09;598395
75;2020-12-29;60;61;121;337141;357785;19;694926
75;2020-12-29;85;74;160;295024;300618;29;595642
75;2020-12-29;92;62;154;347871;331233;39;679104
75;2020-12-29;90;62;152;384742;372771;49;757513
75;2020-12-29;80;80;160;413361;390880;59;804241
75;2020-12-29;57;70;127;425623;384060;69;809683
75;2020-12-29;50;38;88;325086;276298;79;601384
75;2020-12-29;71;33;104;213986;139308;89;353294
75;2020-12-29;60;9;70;77600;28200;90;105800
75;2020-12-29;657;505;1164;3113538;2886444;0;5999982
76;2020-12-29;15;24;40;305956;318589;09;624545
76;2020-12-29;72;67;141;338942;356969;19;695911
76;2020-12-29;130;88;218;316210;319570;29;635780
76;2020-12-29;134;91;225;356758;337587;39;694345
76;2020-12-29;113;79;192;376541;363812;49;740353
76;2020-12-29;118;72;190;402608;383750;59;786358
76;2020-12-29;97;90;187;394889;358997;69;753886
76;2020-12-29;60;50;110;308664;263806;79;572470
76;2020-12-29;82;38;120;195838;129272;89;325110
76;2020-12-29;57;13;70;69372;26728;90;96100
76;2020-12-29;879;612;1494;3065778;2859080;0;5924858
84;2020-12-29;45;39;84;459549;481088;09;940637
84;2020-12-29;151;147;299;487711;511905;19;999616
84;2020-12-29;242;186;429;443824;451094;29;894918
84;2020-12-29;269;227;497;512522;493262;39;1005784
84;2020-12-29;253;171;424;520248;515106;49;1035354
84;2020-12-29;224;189;413;529611;514848;59;1044459
84;2020-12-29;160;149;309;486720;439940;69;926660
84;2020-12-29;113;105;218;372151;315211;79;687362
84;2020-12-29;133;52;185;237198;150524;89;387722
84;2020-12-29;108;42;150;81185;28680;90;109865
84;2020-12-29;1698;1307;3009;4130719;3901658;0;8032377
93;2020-12-29;34;29;68;268834;283093;09;551927
93;2020-12-29;125;99;224;280751;296087;19;576838
93;2020-12-29;205;129;335;254404;255552;29;509956
93;2020-12-29;206;150;356;310704;288398;39;599102
93;2020-12-29;147;160;307;325559;305827;49;631386
93;2020-12-29;187;156;344;353104;325389;59;678493
93;2020-12-29;157;143;300;336327;296459;69;632786
93;2020-12-29;122;97;219;279820;229699;79;509519
93;2020-12-29;120;72;192;171274;113716;89;284990
93;2020-12-29;114;11;125;58896;21758;90;80654
93;2020-12-29;1417;1046;2470;2639673;2415978;0;5055651
94;2020-12-29;0;0;0;16311;17433;09;33744
94;2020-12-29;2;4;6;16679;18132;19;34811
94;2020-12-29;3;3;6;16782;16579;29;33361
94;2020-12-29;2;3;5;23044;20580;39;43624
94;2020-12-29;4;4;8;23065;22140;49;45205
94;2020-12-29;1;2;3;24549;23421;59;47970
94;2020-12-29;3;1;4;23212;21883;69;45095
94;2020-12-29;6;1;7;19544;17141;79;36685
94;2020-12-29;0;1;1;11227;8178;89;19405
94;2020-12-29;1;1;2;3332;1447;90;4779
94;2020-12-29;22;20;42;177745;166934;0;344679
01;2020-12-30;0;0;0;19979;20155;09;40134
01;2020-12-30;2;1;3;24994;25489;19;50483
01;2020-12-30;2;2;4;17868;16690;29;34558
01;2020-12-30;3;1;4;22328;14821;39;37149
01;2020-12-30;4;2;6;28652;20276;49;48928
01;2020-12-30;2;1;3;33264;27260;59;60524
01;2020-12-30;1;0;1;27135;23978;69;51113
01;2020-12-30;0;0;0;18401;14661;79;33062
01;2020-12-30;0;0;0;9633;6375;89;16008
01;2020-12-30;0;0;0;3410;1510;90;4920
01;2020-12-30;14;7;21;205664;171215;0;376879
02;2020-12-30;0;0;0;16881;17110;09;33991
02;2020-12-30;1;0;1;21410;21604;19;43014
02;2020-12-30;0;0;0;16017;15479;29;31496
02;2020-12-30;2;1;3;19825;14455;39;34280
02;2020-12-30;2;1;3;24719;18248;49;42967
02;2020-12-30;4;1;5;34361;28310;59;62671
02;2020-12-30;3;2;5;28061;24495;69;52556
02;2020-12-30;0;3;3;18231;15278;79;33509
02;2020-12-30;0;0;0;11090;7677;89;18767
02;2020-12-30;2;0;2;3992;1506;90;5498
02;2020-12-30;14;8;22;194587;164162;0;358749
03;2020-12-30;3;2;5;31123;30920;09;62043
03;2020-12-30;13;6;19;29370;29268;19;58638
03;2020-12-30;19;8;27;21458;18963;29;40421
03;2020-12-30;15;10;25;21276;18326;39;39602
03;2020-12-30;8;3;11;18164;16593;49;34757
03;2020-12-30;5;7;12;13469;13557;59;27026
03;2020-12-30;4;6;10;8776;8670;69;17446
03;2020-12-30;1;1;2;3777;3591;79;7368
03;2020-12-30;0;0;0;1649;1072;89;2721
03;2020-12-30;0;0;0;485;184;90;669
03;2020-12-30;68;43;111;149547;141144;0;290691
04;2020-12-30;2;2;4;60314;61377;09;121691
04;2020-12-30;3;4;7;66065;68387;19;134452
04;2020-12-30;2;3;5;51059;47156;29;98215
04;2020-12-30;2;5;7;58788;45780;39;104568
04;2020-12-30;5;5;10;61408;52207;49;113615
04;2020-12-30;4;4;8;64838;60759;59;125597
04;2020-12-30;2;2;4;47008;42843;69;89851
04;2020-12-30;0;0;0;25509;21184;79;46693
04;2020-12-30;0;1;1;13168;7647;89;20815
04;2020-12-30;0;0;0;3209;1253;90;4462
04;2020-12-30;20;26;46;451366;408593;0;859959
05;2020-12-30;0;0;0;362.366008612902;341.338819562748;09;703.704828175651
05;2020-12-30;0;0;0;353.376145114279;370.349735405642;19;723.725880519921
05;2020-12-30;0;0;0;218.593559489256;256.539602589476;29;475.133162078732
05;2020-12-30;0;0;0;404.225408693299;360.321910454353;39;764.547319147651
05;2020-12-30;0;0;0;520.067953604221;497.108383964256;49;1017.17633756848
05;2020-12-30;0;0;0;468.146063921917;510.087601910415;59;978.233665832332
05;2020-12-30;0;0;0;340.368470050554;334.366842191253;69;674.735312241807
05;2020-12-30;0;0;0;212.598666888387;192.597753227106;79;405.196420115493
05;2020-12-30;0;0;0;148.727797095705;61.8681715431829;89;210.595968638888
05;2020-12-30;0;0;0;32.9601271090696;10.9909785719784;90;43.9511056810479
05;2020-12-30;0;0;0;3061.43020057959;2935.56979942041;0;5997
06;2020-12-30;0;0;0;42583;42380;09;84963
06;2020-12-30;1;0;1;33369;31925;19;65294
06;2020-12-30;3;2;5;21571;15080;29;36651
06;2020-12-30;3;1;4;21550;16147;39;37697
06;2020-12-30;4;2;6;14193;13939;49;28132
06;2020-12-30;0;1;1;7171;7597;59;14768
06;2020-12-30;1;0;1;3629;4117;69;7746
06;2020-12-30;1;0;1;1577;1457;79;3034
06;2020-12-30;0;0;0;531;474;89;1005
06;2020-12-30;0;0;0;88;93;90;181
06;2020-12-30;13;6;19;146262;133209;0;279471
07;2020-12-30;0;0;0;485;549;09;1034
07;2020-12-30;0;0;0;403;432;19;835
07;2020-12-30;1;0;1;764;841;29;1605
07;2020-12-30;0;0;0;824;928;39;1752
07;2020-12-30;0;0;0;788;1020;49;1808
07;2020-12-30;0;0;0;678;870;59;1548
07;2020-12-30;0;0;0;360;382;69;742
07;2020-12-30;0;0;0;231;190;79;421
07;2020-12-30;0;0;0;114;67;89;181
07;2020-12-30;0;0;0;24;11;90;35
07;2020-12-30;1;0;1;4671;5290;0;9961
08;2020-12-30;0;0;0;2715.22592983026;2997.75551488675;09;5712.98144471701
08;2020-12-30;2;0;2;2778.51901080978;3160.9156459093;19;5939.43465671908
08;2020-12-30;0;0;0;2080.8882988764;1718.16634315323;29;3799.05464202964
08;2020-12-30;1;0;1;2701.8582062647;1896.52641413317;39;4598.38462039786
08;2020-12-30;0;1;1;3151.45861023308;2460.52498233809;49;5611.98359257117
08;2020-12-30;1;0;1;2620.29868333099;2422.23566154656;59;5042.53434487755
08;2020-12-30;0;0;0;1621.44173420671;1438.58325779464;69;3060.02499200135
08;2020-12-30;0;0;0;626.575909335673;526.358467843651;79;1152.93437717932
08;2020-12-30;0;0;0;205.018522985054;140.993639349697;89;346.012162334751
08;2020-12-30;0;0;0;50.0325684687745;20.62259870351;90;70.6551671722846
08;2020-12-30;4;1;5;18551.3174743414;16782.6825256586;0;35334
11;2020-12-30;41;41;88;783071;811785;09;1594856
11;2020-12-30;162;182;357;761456;784653;19;1546109
11;2020-12-30;359;295;655;850145;801772;29;1651917
11;2020-12-30;316;253;572;914360;843488;39;1757848
11;2020-12-30;252;212;469;845609;826202;49;1671811
11;2020-12-30;213;185;398;793566;745070;59;1538636
11;2020-12-30;174;151;329;628649;549192;69;1177841
11;2020-12-30;90;75;165;434606;358356;79;792962
11;2020-12-30;62;41;103;261425;162933;89;424358
11;2020-12-30;32;16;48;89253;32619;90;121872
11;2020-12-30;1704;1453;3189;6362140;5916070;0;12278210
24;2020-12-30;13;6;19;139720;144686;09;284406
24;2020-12-30;36;28;65;152979;161185;19;314164
24;2020-12-30;62;50;112;122237;126536;29;248773
24;2020-12-30;57;45;102;150359;142009;39;292368
24;2020-12-30;50;37;87;161829;158758;49;320587
24;2020-12-30;70;48;118;172552;168011;59;340563
24;2020-12-30;47;30;77;172509;158177;69;330686
24;2020-12-30;23;28;51;129428;110593;79;240021
24;2020-12-30;32;13;45;87342;56882;89;144224
24;2020-12-30;24;9;33;31210;12071;90;43281
24;2020-12-30;414;294;709;1320165;1238908;0;2559073
27;2020-12-30;17;25;42;143373;149679;09;293052
27;2020-12-30;81;91;172;160962;173003;19;333965
27;2020-12-30;122;87;209;133746;142254;29;276000
27;2020-12-30;96;62;158;160004;155407;39;315411
27;2020-12-30;107;71;178;172333;169564;49;341897
27;2020-12-30;106;75;181;189979;183788;59;373767
27;2020-12-30;74;76;150;192591;178206;69;370797
27;2020-12-30;69;58;127;146876;127546;79;274422
27;2020-12-30;52;41;93;96896;61575;89;158471
27;2020-12-30;38;12;50;33148;12109;90;45257
27;2020-12-30;762;598;1360;1429908;1353131;0;2783039
28;2020-12-30;5;5;11;180735;186856;09;367591
28;2020-12-30;43;26;71;200125;213621;19;413746
28;2020-12-30;77;54;132;168922;173007;29;341929
28;2020-12-30;65;44;109;196628;188487;39;385115
28;2020-12-30;52;58;110;205396;201699;49;407095
28;2020-12-30;66;48;114;222002;213866;59;435868
28;2020-12-30;46;35;81;224688;203758;69;428446
28;2020-12-30;35;24;59;163192;135543;79;298735
28;2020-12-30;46;23;69;109691;65377;89;175068
28;2020-12-30;33;6;39;37222;12685;90;49907
28;2020-12-30;468;323;795;1708601;1594899;0;3303500
32;2020-12-30;17;29;46;358062;373689;09;731751
32;2020-12-30;107;89;198;387045;406742;19;793787
32;2020-12-30;140;121;261;342304;348587;29;690891
32;2020-12-30;135;116;252;382485;369972;39;752457
32;2020-12-30;118;92;210;382510;376716;49;759226
32;2020-12-30;105;99;204;386937;376527;59;763464
32;2020-12-30;88;80;168;371211;330938;69;702149
32;2020-12-30;72;43;116;250542;201459;79;452001
32;2020-12-30;75;26;101;163399;89786;89;253185
32;2020-12-30;38;9;47;48384;15367;90;63751
32;2020-12-30;895;704;1603;3072879;2889783;0;5962662
44;2020-12-30;38;41;79;291525;306839;09;598364
44;2020-12-30;146;141;289;320255;339504;19;659759
44;2020-12-30;224;192;416;302020;314428;29;616448
44;2020-12-30;193;179;372;342222;333292;39;675514
44;2020-12-30;181;172;354;349727;344491;49;694218
44;2020-12-30;196;169;365;381371;373239;59;754610
44;2020-12-30;133;125;259;367165;335850;69;703015
44;2020-12-30;100;80;182;250387;215436;79;465823
44;2020-12-30;114;63;177;170825;105192;89;276017
44;2020-12-30;53;18;71;51248;16731;90;67979
44;2020-12-30;1378;1180;2564;2826745;2685002;0;5511747
52;2020-12-30;10;8;18;213594;223900;09;437494
52;2020-12-30;38;49;89;240818;255197;19;496015
52;2020-12-30;51;54;105;197010;200630;29;397640
52;2020-12-30;68;46;115;231204;224885;39;456089
52;2020-12-30;65;41;107;243874;243418;49;487292
52;2020-12-30;61;53;114;244100;239116;59;483216
52;2020-12-30;43;38;81;241796;221345;69;463141
52;2020-12-30;22;24;49;177805;149903;79;327708
52;2020-12-30;33;19;52;119561;75822;89;195383
52;2020-12-30;30;8;38;42559;15260;90;57819
52;2020-12-30;421;340;769;1952321;1849476;0;3801797
53;2020-12-30;2;7;9;173813;182358;09;356171
53;2020-12-30;25;18;43;202720;214740;19;417460
53;2020-12-30;42;41;83;163116;173196;29;336312
53;2020-12-30;27;21;48;190526;187674;39;378200
53;2020-12-30;30;14;44;212098;212015;49;424113
53;2020-12-30;28;19;47;223699;219176;59;442875
53;2020-12-30;21;22;43;227435;209274;69;436709
53;2020-12-30;9;17;26;169992;140910;79;310902
53;2020-12-30;11;2;13;118117;69883;89;188000
53;2020-12-30;10;6;16;37370;12267;90;49637
53;2020-12-30;205;167;372;1718886;1621493;0;3340379
75;2020-12-30;21;26;48;293104;305291;09;598395
75;2020-12-30;76;77;154;337141;357785;19;694926
75;2020-12-30;100;77;177;295024;300618;29;595642
75;2020-12-30;81;78;160;347871;331233;39;679104
75;2020-12-30;104;83;187;384742;372771;49;757513
75;2020-12-30;93;81;174;413361;390880;59;804241
75;2020-12-30;71;60;131;425623;384060;69;809683
75;2020-12-30;35;46;81;325086;276298;79;601384
75;2020-12-30;39;21;60;213986;139308;89;353294
75;2020-12-30;30;10;40;77600;28200;90;105800
75;2020-12-30;650;559;1212;3113538;2886444;0;5999982
76;2020-12-30;18;18;37;305956;318589;09;624545
76;2020-12-30;96;74;172;338942;356969;19;695911
76;2020-12-30;129;111;240;316210;319570;29;635780
76;2020-12-30;111;101;212;356758;337587;39;694345
76;2020-12-30;110;102;212;376541;363812;49;740353
76;2020-12-30;112;98;210;402608;383750;59;786358
76;2020-12-30;81;73;154;394889;358997;69;753886
76;2020-12-30;63;62;125;308664;263806;79;572470
76;2020-12-30;65;42;107;195838;129272;89;325110
76;2020-12-30;54;14;68;69372;26728;90;96100
76;2020-12-30;840;695;1538;3065778;2859080;0;5924858
84;2020-12-30;45;32;77;459549;481088;09;940637
84;2020-12-30;166;183;352;487711;511905;19;999616
84;2020-12-30;255;209;464;443824;451094;29;894918
84;2020-12-30;260;203;463;512522;493262;39;1005784
84;2020-12-30;200;170;370;520248;515106;49;1035354
84;2020-12-30;208;187;395;529611;514848;59;1044459
84;2020-12-30;149;125;274;486720;439940;69;926660
84;2020-12-30;122;84;206;372151;315211;79;687362
84;2020-12-30;119;68;187;237198;150524;89;387722
84;2020-12-30;98;29;127;81185;28680;90;109865
84;2020-12-30;1622;1290;2915;4130719;3901658;0;8032377
93;2020-12-30;38;40;79;268834;283093;09;551927
93;2020-12-30;134;125;261;280751;296087;19;576838
93;2020-12-30;211;174;385;254404;255552;29;509956
93;2020-12-30;200;143;344;310704;288398;39;599102
93;2020-12-30;188;140;328;325559;305827;49;631386
93;2020-12-30;172;177;349;353104;325389;59;678493
93;2020-12-30;156;142;299;336327;296459;69;632786
93;2020-12-30;101;103;204;279820;229699;79;509519
93;2020-12-30;100;70;170;171274;113716;89;284990
93;2020-12-30;53;21;74;58896;21758;90;80654
93;2020-12-30;1354;1135;2494;2639673;2415978;0;5055651
94;2020-12-30;0;1;1;16311;17433;09;33744
94;2020-12-30;4;3;7;16679;18132;19;34811
94;2020-12-30;2;2;4;16782;16579;29;33361
94;2020-12-30;4;6;10;23044;20580;39;43624
94;2020-12-30;2;5;7;23065;22140;49;45205
94;2020-12-30;6;3;9;24549;23421;59;47970
94;2020-12-30;2;4;6;23212;21883;69;45095
94;2020-12-30;0;3;3;19544;17141;79;36685
94;2020-12-30;0;1;1;11227;8178;89;19405
94;2020-12-30;0;0;0;3332;1447;90;4779
94;2020-12-30;20;28;48;177745;166934;0;344679
01;2020-12-31;0;1;1;19979;20155;09;40134
01;2020-12-31;3;0;3;24994;25489;19;50483
01;2020-12-31;2;0;2;17868;16690;29;34558
01;2020-12-31;1;3;4;22328;14821;39;37149
01;2020-12-31;1;2;3;28652;20276;49;48928
01;2020-12-31;2;0;2;33264;27260;59;60524
01;2020-12-31;1;0;1;27135;23978;69;51113
01;2020-12-31;0;0;0;18401;14661;79;33062
01;2020-12-31;1;0;1;9633;6375;89;16008
01;2020-12-31;0;0;0;3410;1510;90;4920
01;2020-12-31;11;6;17;205664;171215;0;376879
02;2020-12-31;1;0;1;16881;17110;09;33991
02;2020-12-31;2;1;3;21410;21604;19;43014
02;2020-12-31;2;0;2;16017;15479;29;31496
02;2020-12-31;3;3;6;19825;14455;39;34280
02;2020-12-31;4;4;8;24719;18248;49;42967
02;2020-12-31;1;1;2;34361;28310;59;62671
02;2020-12-31;3;0;3;28061;24495;69;52556
02;2020-12-31;0;0;0;18231;15278;79;33509
02;2020-12-31;0;0;0;11090;7677;89;18767
02;2020-12-31;0;0;0;3992;1506;90;5498
02;2020-12-31;16;9;25;194587;164162;0;358749
03;2020-12-31;1;0;1;31123;30920;09;62043
03;2020-12-31;14;4;19;29370;29268;19;58638
03;2020-12-31;13;6;19;21458;18963;29;40421
03;2020-12-31;9;10;20;21276;18326;39;39602
03;2020-12-31;4;10;14;18164;16593;49;34757
03;2020-12-31;5;5;10;13469;13557;59;27026
03;2020-12-31;4;2;6;8776;8670;69;17446
03;2020-12-31;1;0;1;3777;3591;79;7368
03;2020-12-31;0;1;1;1649;1072;89;2721
03;2020-12-31;0;0;0;485;184;90;669
03;2020-12-31;51;38;91;149547;141144;0;290691
04;2020-12-31;0;0;0;60314;61377;09;121691
04;2020-12-31;4;3;7;66065;68387;19;134452
04;2020-12-31;6;3;9;51059;47156;29;98215
04;2020-12-31;5;3;8;58788;45780;39;104568
04;2020-12-31;1;6;7;61408;52207;49;113615
04;2020-12-31;6;2;8;64838;60759;59;125597
04;2020-12-31;4;3;7;47008;42843;69;89851
04;2020-12-31;1;1;2;25509;21184;79;46693
04;2020-12-31;0;0;0;13168;7647;89;20815
04;2020-12-31;0;0;0;3209;1253;90;4462
04;2020-12-31;27;21;48;451366;408593;0;859959
05;2020-12-31;0;0;0;362.366008612902;341.338819562748;09;703.704828175651
05;2020-12-31;0;0;0;353.376145114279;370.349735405642;19;723.725880519921
05;2020-12-31;0;0;0;218.593559489256;256.539602589476;29;475.133162078732
05;2020-12-31;0;0;0;404.225408693299;360.321910454353;39;764.547319147651
05;2020-12-31;0;0;0;520.067953604221;497.108383964256;49;1017.17633756848
05;2020-12-31;0;0;0;468.146063921917;510.087601910415;59;978.233665832332
05;2020-12-31;0;0;0;340.368470050554;334.366842191253;69;674.735312241807
05;2020-12-31;0;0;0;212.598666888387;192.597753227106;79;405.196420115493
05;2020-12-31;0;0;0;148.727797095705;61.8681715431829;89;210.595968638888
05;2020-12-31;0;0;0;32.9601271090696;10.9909785719784;90;43.9511056810479
05;2020-12-31;0;0;0;3061.43020057959;2935.56979942041;0;5997
06;2020-12-31;1;0;1;42583;42380;09;84963
06;2020-12-31;2;1;3;33369;31925;19;65294
06;2020-12-31;4;4;8;21571;15080;29;36651
06;2020-12-31;7;4;11;21550;16147;39;37697
06;2020-12-31;1;4;5;14193;13939;49;28132
06;2020-12-31;2;3;5;7171;7597;59;14768
06;2020-12-31;0;1;1;3629;4117;69;7746
06;2020-12-31;0;1;1;1577;1457;79;3034
06;2020-12-31;0;0;0;531;474;89;1005
06;2020-12-31;0;0;0;88;93;90;181
06;2020-12-31;17;18;35;146262;133209;0;279471
07;2020-12-31;0;0;0;485;549;09;1034
07;2020-12-31;0;0;0;403;432;19;835
07;2020-12-31;0;0;0;764;841;29;1605
07;2020-12-31;1;0;1;824;928;39;1752
07;2020-12-31;0;0;0;788;1020;49;1808
07;2020-12-31;0;0;0;678;870;59;1548
07;2020-12-31;0;0;0;360;382;69;742
07;2020-12-31;0;0;0;231;190;79;421
07;2020-12-31;0;0;0;114;67;89;181
07;2020-12-31;0;0;0;24;11;90;35
07;2020-12-31;1;0;1;4671;5290;0;9961
08;2020-12-31;0;0;0;2715.22592983026;2997.75551488675;09;5712.98144471701
08;2020-12-31;0;0;0;2778.51901080978;3160.9156459093;19;5939.43465671908
08;2020-12-31;0;0;0;2080.8882988764;1718.16634315323;29;3799.05464202964
08;2020-12-31;0;0;0;2701.8582062647;1896.52641413317;39;4598.38462039786
08;2020-12-31;2;0;2;3151.45861023308;2460.52498233809;49;5611.98359257117
08;2020-12-31;1;0;1;2620.29868333099;2422.23566154656;59;5042.53434487755
08;2020-12-31;0;0;0;1621.44173420671;1438.58325779464;69;3060.02499200135
08;2020-12-31;0;0;0;626.575909335673;526.358467843651;79;1152.93437717932
08;2020-12-31;0;0;0;205.018522985054;140.993639349697;89;346.012162334751
08;2020-12-31;0;0;0;50.0325684687745;20.62259870351;90;70.6551671722846
08;2020-12-31;3;0;3;18551.3174743414;16782.6825256586;0;35334
11;2020-12-31;36;36;73;783071;811785;09;1594856
11;2020-12-31;153;148;307;761456;784653;19;1546109
11;2020-12-31;279;251;530;850145;801772;29;1651917
11;2020-12-31;280;249;530;914360;843488;39;1757848
11;2020-12-31;225;201;426;845609;826202;49;1671811
11;2020-12-31;189;163;354;793566;745070;59;1538636
11;2020-12-31;122;124;248;628649;549192;69;1177841
11;2020-12-31;85;75;160;434606;358356;79;792962
11;2020-12-31;54;41;95;261425;162933;89;424358
11;2020-12-31;36;19;55;89253;32619;90;121872
11;2020-12-31;1459;1307;2782;6362140;5916070;0;12278210
24;2020-12-31;7;8;15;139720;144686;09;284406
24;2020-12-31;39;33;72;152979;161185;19;314164
24;2020-12-31;47;46;93;122237;126536;29;248773
24;2020-12-31;39;40;79;150359;142009;39;292368
24;2020-12-31;49;38;87;161829;158758;49;320587
24;2020-12-31;41;52;93;172552;168011;59;340563
24;2020-12-31;31;33;65;172509;158177;69;330686
24;2020-12-31;31;21;52;129428;110593;79;240021
24;2020-12-31;14;6;20;87342;56882;89;144224
24;2020-12-31;8;4;12;31210;12071;90;43281
24;2020-12-31;306;281;588;1320165;1238908;0;2559073
27;2020-12-31;16;17;33;143373;149679;09;293052
27;2020-12-31;71;74;145;160962;173003;19;333965
27;2020-12-31;84;82;166;133746;142254;29;276000
27;2020-12-31;65;72;137;160004;155407;39;315411
27;2020-12-31;87;71;158;172333;169564;49;341897
27;2020-12-31;102;77;179;189979;183788;59;373767
27;2020-12-31;52;72;124;192591;178206;69;370797
27;2020-12-31;57;41;98;146876;127546;79;274422
27;2020-12-31;69;32;101;96896;61575;89;158471
27;2020-12-31;42;12;54;33148;12109;90;45257
27;2020-12-31;645;550;1195;1429908;1353131;0;2783039
28;2020-12-31;8;6;16;180735;186856;09;367591
28;2020-12-31;37;42;79;200125;213621;19;413746
28;2020-12-31;46;37;83;168922;173007;29;341929
28;2020-12-31;60;42;102;196628;188487;39;385115
28;2020-12-31;49;44;93;205396;201699;49;407095
28;2020-12-31;41;47;88;222002;213866;59;435868
28;2020-12-31;44;30;74;224688;203758;69;428446
28;2020-12-31;25;23;48;163192;135543;79;298735
28;2020-12-31;36;9;45;109691;65377;89;175068
28;2020-12-31;27;3;30;37222;12685;90;49907
28;2020-12-31;373;283;658;1708601;1594899;0;3303500
32;2020-12-31;18;24;42;358062;373689;09;731751
32;2020-12-31;59;75;134;387045;406742;19;793787
32;2020-12-31;100;81;181;342304;348587;29;690891
32;2020-12-31;109;93;202;382485;369972;39;752457
32;2020-12-31;74;82;156;382510;376716;49;759226
32;2020-12-31;90;77;168;386937;376527;59;763464
32;2020-12-31;71;67;138;371211;330938;69;702149
32;2020-12-31;51;47;98;250542;201459;79;452001
32;2020-12-31;60;25;85;163399;89786;89;253185
32;2020-12-31;31;5;36;48384;15367;90;63751
32;2020-12-31;663;576;1240;3072879;2889783;0;5962662
44;2020-12-31;33;23;56;291525;306839;09;598364
44;2020-12-31;109;102;213;320255;339504;19;659759
44;2020-12-31;155;141;296;302020;314428;29;616448
44;2020-12-31;160;148;308;342222;333292;39;675514
44;2020-12-31;115;110;225;349727;344491;49;694218
44;2020-12-31;140;120;260;381371;373239;59;754610
44;2020-12-31;115;119;234;367165;335850;69;703015
44;2020-12-31;63;56;119;250387;215436;79;465823
44;2020-12-31;67;55;122;170825;105192;89;276017
44;2020-12-31;33;17;51;51248;16731;90;67979
44;2020-12-31;990;891;1884;2826745;2685002;0;5511747
52;2020-12-31;13;12;26;213594;223900;09;437494
52;2020-12-31;37;27;64;240818;255197;19;496015
52;2020-12-31;55;46;101;197010;200630;29;397640
52;2020-12-31;63;46;109;231204;224885;39;456089
52;2020-12-31;43;39;82;243874;243418;49;487292
52;2020-12-31;42;43;85;244100;239116;59;483216
52;2020-12-31;31;24;55;241796;221345;69;463141
52;2020-12-31;25;29;56;177805;149903;79;327708
52;2020-12-31;14;10;24;119561;75822;89;195383
52;2020-12-31;11;4;15;42559;15260;90;57819
52;2020-12-31;334;280;617;1952321;1849476;0;3801797
53;2020-12-31;2;1;3;173813;182358;09;356171
53;2020-12-31;23;29;52;202720;214740;19;417460
53;2020-12-31;36;40;77;163116;173196;29;336312
53;2020-12-31;25;24;49;190526;187674;39;378200
53;2020-12-31;25;20;45;212098;212015;49;424113
53;2020-12-31;34;26;60;223699;219176;59;442875
53;2020-12-31;19;23;42;227435;209274;69;436709
53;2020-12-31;13;15;28;169992;140910;79;310902
53;2020-12-31;15;10;25;118117;69883;89;188000
53;2020-12-31;8;3;12;37370;12267;90;49637
53;2020-12-31;200;191;393;1718886;1621493;0;3340379
75;2020-12-31;21;12;34;293104;305291;09;598395
75;2020-12-31;56;55;112;337141;357785;19;694926
75;2020-12-31;84;55;139;295024;300618;29;595642
75;2020-12-31;75;73;148;347871;331233;39;679104
75;2020-12-31;66;55;121;384742;372771;49;757513
75;2020-12-31;79;80;159;413361;390880;59;804241
75;2020-12-31;59;46;105;425623;384060;69;809683
75;2020-12-31;39;29;68;325086;276298;79;601384
75;2020-12-31;46;30;76;213986;139308;89;353294
75;2020-12-31;32;7;39;77600;28200;90;105800
75;2020-12-31;557;442;1001;3113538;2886444;0;5999982
76;2020-12-31;8;8;18;305956;318589;09;624545
76;2020-12-31;73;78;153;338942;356969;19;695911
76;2020-12-31;102;115;217;316210;319570;29;635780
76;2020-12-31;92;77;169;356758;337587;39;694345
76;2020-12-31;95;71;166;376541;363812;49;740353
76;2020-12-31;74;76;150;402608;383750;59;786358
76;2020-12-31;70;65;135;394889;358997;69;753886
76;2020-12-31;47;46;93;308664;263806;79;572470
76;2020-12-31;34;35;69;195838;129272;89;325110
76;2020-12-31;19;6;25;69372;26728;90;96100
76;2020-12-31;614;577;1195;3065778;2859080;0;5924858
84;2020-12-31;41;36;78;459549;481088;09;940637
84;2020-12-31;129;142;271;487711;511905;19;999616
84;2020-12-31;215;179;394;443824;451094;29;894918
84;2020-12-31;188;177;365;512522;493262;39;1005784
84;2020-12-31;181;154;336;520248;515106;49;1035354
84;2020-12-31;159;153;312;529611;514848;59;1044459
84;2020-12-31;114;126;241;486720;439940;69;926660
84;2020-12-31;96;82;178;372151;315211;79;687362
84;2020-12-31;76;49;125;237198;150524;89;387722
84;2020-12-31;60;13;73;81185;28680;90;109865
84;2020-12-31;1260;1111;2374;4130719;3901658;0;8032377
93;2020-12-31;26;26;52;268834;283093;09;551927
93;2020-12-31;102;93;195;280751;296087;19;576838
93;2020-12-31;182;147;329;254404;255552;29;509956
93;2020-12-31;173;135;309;310704;288398;39;599102
93;2020-12-31;151;131;283;325559;305827;49;631386
93;2020-12-31;172;123;295;353104;325389;59;678493
93;2020-12-31;109;106;215;336327;296459;69;632786
93;2020-12-31;77;60;137;279820;229699;79;509519
93;2020-12-31;58;45;103;171274;113716;89;284990
93;2020-12-31;27;16;43;58896;21758;90;80654
93;2020-12-31;1077;882;1961;2639673;2415978;0;5055651
94;2020-12-31;0;0;0;16311;17433;09;33744
94;2020-12-31;1;3;4;16679;18132;19;34811
94;2020-12-31;1;5;6;16782;16579;29;33361
94;2020-12-31;3;5;8;23044;20580;39;43624
94;2020-12-31;3;4;7;23065;22140;49;45205
94;2020-12-31;2;2;4;24549;23421;59;47970
94;2020-12-31;3;2;5;23212;21883;69;45095
94;2020-12-31;2;0;2;19544;17141;79;36685
94;2020-12-31;4;0;4;11227;8178;89;19405
94;2020-12-31;1;0;1;3332;1447;90;4779
94;2020-12-31;20;21;41;177745;166934;0;344679
01;2021-01-01;0;0;0;19979;20155;09;40134
01;2021-01-01;1;0;1;24994;25489;19;50483
01;2021-01-01;0;1;1;17868;16690;29;34558
01;2021-01-01;0;1;1;22328;14821;39;37149
01;2021-01-01;0;1;1;28652;20276;49;48928
01;2021-01-01;0;0;0;33264;27260;59;60524
01;2021-01-01;0;0;0;27135;23978;69;51113
01;2021-01-01;0;0;0;18401;14661;79;33062
01;2021-01-01;0;0;0;9633;6375;89;16008
01;2021-01-01;0;0;0;3410;1510;90;4920
01;2021-01-01;1;3;4;205664;171215;0;376879
02;2021-01-01;0;0;0;16881;17110;09;33991
02;2021-01-01;1;0;1;21410;21604;19;43014
02;2021-01-01;0;0;0;16017;15479;29;31496
02;2021-01-01;0;0;0;19825;14455;39;34280
02;2021-01-01;0;0;0;24719;18248;49;42967
02;2021-01-01;0;0;0;34361;28310;59;62671
02;2021-01-01;0;0;0;28061;24495;69;52556
02;2021-01-01;0;0;0;18231;15278;79;33509
02;2021-01-01;0;0;0;11090;7677;89;18767
02;2021-01-01;0;0;0;3992;1506;90;5498
02;2021-01-01;1;0;1;194587;164162;0;358749
03;2021-01-01;0;0;0;31123;30920;09;62043
03;2021-01-01;0;1;2;29370;29268;19;58638
03;2021-01-01;1;6;7;21458;18963;29;40421
03;2021-01-01;1;0;1;21276;18326;39;39602
03;2021-01-01;1;2;3;18164;16593;49;34757
03;2021-01-01;0;0;0;13469;13557;59;27026
03;2021-01-01;1;1;2;8776;8670;69;17446
03;2021-01-01;0;0;0;3777;3591;79;7368
03;2021-01-01;0;0;0;1649;1072;89;2721
03;2021-01-01;0;0;0;485;184;90;669
03;2021-01-01;4;10;15;149547;141144;0;290691
04;2021-01-01;0;0;0;60314;61377;09;121691
04;2021-01-01;0;0;0;66065;68387;19;134452
04;2021-01-01;0;0;0;51059;47156;29;98215
04;2021-01-01;1;0;1;58788;45780;39;104568
04;2021-01-01;0;0;0;61408;52207;49;113615
04;2021-01-01;0;2;2;64838;60759;59;125597
04;2021-01-01;0;0;0;47008;42843;69;89851
04;2021-01-01;0;0;0;25509;21184;79;46693
04;2021-01-01;0;0;0;13168;7647;89;20815
04;2021-01-01;0;0;0;3209;1253;90;4462
04;2021-01-01;1;2;3;451366;408593;0;859959
05;2021-01-01;0;0;0;362.366008612902;341.338819562748;09;703.704828175651
05;2021-01-01;0;0;0;353.376145114279;370.349735405642;19;723.725880519921
05;2021-01-01;0;0;0;218.593559489256;256.539602589476;29;475.133162078732
05;2021-01-01;0;0;0;404.225408693299;360.321910454353;39;764.547319147651
05;2021-01-01;0;0;0;520.067953604221;497.108383964256;49;1017.17633756848
05;2021-01-01;0;0;0;468.146063921917;510.087601910415;59;978.233665832332
05;2021-01-01;0;0;0;340.368470050554;334.366842191253;69;674.735312241807
05;2021-01-01;0;0;0;212.598666888387;192.597753227106;79;405.196420115493
05;2021-01-01;0;0;0;148.727797095705;61.8681715431829;89;210.595968638888
05;2021-01-01;0;0;0;32.9601271090696;10.9909785719784;90;43.9511056810479
05;2021-01-01;0;0;0;3061.43020057959;2935.56979942041;0;5997
06;2021-01-01;0;0;0;42583;42380;09;84963
06;2021-01-01;0;1;1;33369;31925;19;65294
06;2021-01-01;2;0;2;21571;15080;29;36651
06;2021-01-01;0;0;0;21550;16147;39;37697
06;2021-01-01;0;2;2;14193;13939;49;28132
06;2021-01-01;2;0;2;7171;7597;59;14768
06;2021-01-01;0;0;0;3629;4117;69;7746
06;2021-01-01;0;1;1;1577;1457;79;3034
06;2021-01-01;0;1;1;531;474;89;1005
06;2021-01-01;0;0;0;88;93;90;181
06;2021-01-01;4;5;9;146262;133209;0;279471
07;2021-01-01;0;0;0;485;549;09;1034
07;2021-01-01;0;0;0;403;432;19;835
07;2021-01-01;0;0;0;764;841;29;1605
07;2021-01-01;0;0;0;824;928;39;1752
07;2021-01-01;0;0;0;788;1020;49;1808
07;2021-01-01;0;0;0;678;870;59;1548
07;2021-01-01;0;0;0;360;382;69;742
07;2021-01-01;0;0;0;231;190;79;421
07;2021-01-01;0;0;0;114;67;89;181
07;2021-01-01;0;0;0;24;11;90;35
07;2021-01-01;0;0;0;4671;5290;0;9961
08;2021-01-01;0;0;0;2715.22592983026;2997.75551488675;09;5712.98144471701
08;2021-01-01;0;0;0;2778.51901080978;3160.9156459093;19;5939.43465671908
08;2021-01-01;0;0;0;2080.8882988764;1718.16634315323;29;3799.05464202964
08;2021-01-01;0;0;0;2701.8582062647;1896.52641413317;39;4598.38462039786
08;2021-01-01;0;0;0;3151.45861023308;2460.52498233809;49;5611.98359257117
08;2021-01-01;0;0;0;2620.29868333099;2422.23566154656;59;5042.53434487755
08;2021-01-01;0;0;0;1621.44173420671;1438.58325779464;69;3060.02499200135
08;2021-01-01;0;0;0;626.575909335673;526.358467843651;79;1152.93437717932
08;2021-01-01;0;0;0;205.018522985054;140.993639349697;89;346.012162334751
08;2021-01-01;0;0;0;50.0325684687745;20.62259870351;90;70.6551671722846
08;2021-01-01;0;0;0;18551.3174743414;16782.6825256586;0;35334
11;2021-01-01;2;4;6;783071;811785;09;1594856
11;2021-01-01;16;20;36;761456;784653;19;1546109
11;2021-01-01;33;21;54;850145;801772;29;1651917
11;2021-01-01;42;40;82;914360;843488;39;1757848
11;2021-01-01;24;30;54;845609;826202;49;1671811
11;2021-01-01;12;24;36;793566;745070;59;1538636
11;2021-01-01;18;14;33;628649;549192;69;1177841
11;2021-01-01;14;25;39;434606;358356;79;792962
11;2021-01-01;22;10;33;261425;162933;89;424358
11;2021-01-01;11;3;14;89253;32619;90;121872
11;2021-01-01;194;191;387;6362140;5916070;0;12278210
24;2021-01-01;0;3;3;139720;144686;09;284406
24;2021-01-01;2;2;4;152979;161185;19;314164
24;2021-01-01;7;2;9;122237;126536;29;248773
24;2021-01-01;5;3;8;150359;142009;39;292368
24;2021-01-01;3;1;4;161829;158758;49;320587
24;2021-01-01;3;4;7;172552;168011;59;340563
24;2021-01-01;3;1;4;172509;158177;69;330686
24;2021-01-01;4;5;9;129428;110593;79;240021
24;2021-01-01;4;2;6;87342;56882;89;144224
24;2021-01-01;4;1;5;31210;12071;90;43281
24;2021-01-01;35;24;59;1320165;1238908;0;2559073
27;2021-01-01;1;0;1;143373;149679;09;293052
27;2021-01-01;5;0;5;160962;173003;19;333965
27;2021-01-01;8;4;12;133746;142254;29;276000
27;2021-01-01;6;5;11;160004;155407;39;315411
27;2021-01-01;5;4;9;172333;169564;49;341897
27;2021-01-01;9;1;10;189979;183788;59;373767
27;2021-01-01;12;9;21;192591;178206;69;370797
27;2021-01-01;5;6;11;146876;127546;79;274422
27;2021-01-01;7;8;15;96896;61575;89;158471
27;2021-01-01;7;0;7;33148;12109;90;45257
27;2021-01-01;65;37;102;1429908;1353131;0;2783039
28;2021-01-01;0;2;2;180735;186856;09;367591
28;2021-01-01;4;5;9;200125;213621;19;413746
28;2021-01-01;4;3;7;168922;173007;29;341929
28;2021-01-01;10;5;15;196628;188487;39;385115
28;2021-01-01;5;4;9;205396;201699;49;407095
28;2021-01-01;2;3;5;222002;213866;59;435868
28;2021-01-01;6;4;10;224688;203758;69;428446
28;2021-01-01;4;12;16;163192;135543;79;298735
28;2021-01-01;1;1;2;109691;65377;89;175068
28;2021-01-01;2;1;3;37222;12685;90;49907
28;2021-01-01;38;40;78;1708601;1594899;0;3303500
32;2021-01-01;6;1;7;358062;373689;09;731751
32;2021-01-01;8;2;10;387045;406742;19;793787
32;2021-01-01;11;13;24;342304;348587;29;690891
32;2021-01-01;6;7;13;382485;369972;39;752457
32;2021-01-01;11;12;23;382510;376716;49;759226
32;2021-01-01;6;8;14;386937;376527;59;763464
32;2021-01-01;4;7;11;371211;330938;69;702149
32;2021-01-01;3;5;8;250542;201459;79;452001
32;2021-01-01;7;5;12;163399;89786;89;253185
32;2021-01-01;7;1;8;48384;15367;90;63751
32;2021-01-01;69;61;130;3072879;2889783;0;5962662
44;2021-01-01;1;1;2;291525;306839;09;598364
44;2021-01-01;0;3;3;320255;339504;19;659759
44;2021-01-01;5;9;14;302020;314428;29;616448
44;2021-01-01;8;7;15;342222;333292;39;675514
44;2021-01-01;13;6;19;349727;344491;49;694218
44;2021-01-01;11;9;20;381371;373239;59;754610
44;2021-01-01;9;16;25;367165;335850;69;703015
44;2021-01-01;11;10;21;250387;215436;79;465823
44;2021-01-01;12;9;21;170825;105192;89;276017
44;2021-01-01;14;6;20;51248;16731;90;67979
44;2021-01-01;84;76;160;2826745;2685002;0;5511747
52;2021-01-01;1;1;2;213594;223900;09;437494
52;2021-01-01;3;2;5;240818;255197;19;496015
52;2021-01-01;7;6;13;197010;200630;29;397640
52;2021-01-01;4;7;11;231204;224885;39;456089
52;2021-01-01;5;5;10;243874;243418;49;487292
52;2021-01-01;5;3;8;244100;239116;59;483216
52;2021-01-01;7;4;11;241796;221345;69;463141
52;2021-01-01;2;2;4;177805;149903;79;327708
52;2021-01-01;7;2;9;119561;75822;89;195383
52;2021-01-01;2;4;6;42559;15260;90;57819
52;2021-01-01;43;36;79;1952321;1849476;0;3801797
53;2021-01-01;0;0;0;173813;182358;09;356171
53;2021-01-01;0;0;0;202720;214740;19;417460
53;2021-01-01;3;2;5;163116;173196;29;336312
53;2021-01-01;1;2;3;190526;187674;39;378200
53;2021-01-01;0;3;3;212098;212015;49;424113
53;2021-01-01;3;3;6;223699;219176;59;442875
53;2021-01-01;4;0;4;227435;209274;69;436709
53;2021-01-01;4;4;8;169992;140910;79;310902
53;2021-01-01;2;3;5;118117;69883;89;188000
53;2021-01-01;1;3;4;37370;12267;90;49637
53;2021-01-01;18;20;38;1718886;1621493;0;3340379
75;2021-01-01;1;1;2;293104;305291;09;598395
75;2021-01-01;3;3;6;337141;357785;19;694926
75;2021-01-01;3;4;7;295024;300618;29;595642
75;2021-01-01;1;4;5;347871;331233;39;679104
75;2021-01-01;5;1;6;384742;372771;49;757513
75;2021-01-01;4;2;6;413361;390880;59;804241
75;2021-01-01;4;1;5;425623;384060;69;809683
75;2021-01-01;4;6;10;325086;276298;79;601384
75;2021-01-01;9;9;18;213986;139308;89;353294
75;2021-01-01;4;1;5;77600;28200;90;105800
75;2021-01-01;38;32;70;3113538;2886444;0;5999982
76;2021-01-01;3;1;4;305956;318589;09;624545
76;2021-01-01;2;4;6;338942;356969;19;695911
76;2021-01-01;6;6;12;316210;319570;29;635780
76;2021-01-01;5;7;12;356758;337587;39;694345
76;2021-01-01;7;12;19;376541;363812;49;740353
76;2021-01-01;6;10;16;402608;383750;59;786358
76;2021-01-01;2;7;9;394889;358997;69;753886
76;2021-01-01;6;6;12;308664;263806;79;572470
76;2021-01-01;7;4;11;195838;129272;89;325110
76;2021-01-01;3;1;4;69372;26728;90;96100
76;2021-01-01;47;58;105;3065778;2859080;0;5924858
84;2021-01-01;6;3;9;459549;481088;09;940637
84;2021-01-01;4;2;6;487711;511905;19;999616
84;2021-01-01;16;9;25;443824;451094;29;894918
84;2021-01-01;13;11;24;512522;493262;39;1005784
84;2021-01-01;8;12;20;520248;515106;49;1035354
84;2021-01-01;11;15;26;529611;514848;59;1044459
84;2021-01-01;19;9;28;486720;439940;69;926660
84;2021-01-01;7;4;11;372151;315211;79;687362
84;2021-01-01;21;1;22;237198;150524;89;387722
84;2021-01-01;6;5;11;81185;28680;90;109865
84;2021-01-01;111;71;182;4130719;3901658;0;8032377
93;2021-01-01;1;2;3;268834;283093;09;551927
93;2021-01-01;3;6;9;280751;296087;19;576838
93;2021-01-01;14;11;25;254404;255552;29;509956
93;2021-01-01;14;13;27;310704;288398;39;599102
93;2021-01-01;13;17;30;325559;305827;49;631386
93;2021-01-01;10;9;19;353104;325389;59;678493
93;2021-01-01;11;12;23;336327;296459;69;632786
93;2021-01-01;6;6;12;279820;229699;79;509519
93;2021-01-01;10;12;22;171274;113716;89;284990
93;2021-01-01;10;7;17;58896;21758;90;80654
93;2021-01-01;92;96;188;2639673;2415978;0;5055651
94;2021-01-01;0;0;0;16311;17433;09;33744
94;2021-01-01;0;0;0;16679;18132;19;34811
94;2021-01-01;0;0;0;16782;16579;29;33361
94;2021-01-01;0;1;1;23044;20580;39;43624
94;2021-01-01;0;0;0;23065;22140;49;45205
94;2021-01-01;0;0;0;24549;23421;59;47970
94;2021-01-01;0;0;0;23212;21883;69;45095
94;2021-01-01;0;1;1;19544;17141;79;36685
94;2021-01-01;0;0;0;11227;8178;89;19405
94;2021-01-01;0;0;0;3332;1447;90;4779
94;2021-01-01;0;2;2;177745;166934;0;344679
01;2021-01-02;0;0;0;19979;20155;09;40134
01;2021-01-02;4;2;6;24994;25489;19;50483
01;2021-01-02;5;0;5;17868;16690;29;34558
01;2021-01-02;3;1;4;22328;14821;39;37149
01;2021-01-02;2;1;3;28652;20276;49;48928
01;2021-01-02;5;1;6;33264;27260;59;60524
01;2021-01-02;0;1;1;27135;23978;69;51113
01;2021-01-02;0;0;0;18401;14661;79;33062
01;2021-01-02;0;0;0;9633;6375;89;16008
01;2021-01-02;0;0;0;3410;1510;90;4920
01;2021-01-02;19;6;25;205664;171215;0;376879
02;2021-01-02;0;0;0;16881;17110;09;33991
02;2021-01-02;0;0;0;21410;21604;19;43014
02;2021-01-02;1;0;1;16017;15479;29;31496
02;2021-01-02;0;3;3;19825;14455;39;34280
02;2021-01-02;2;2;4;24719;18248;49;42967
02;2021-01-02;1;1;2;34361;28310;59;62671
02;2021-01-02;1;0;1;28061;24495;69;52556
02;2021-01-02;1;0;1;18231;15278;79;33509
02;2021-01-02;0;0;0;11090;7677;89;18767
02;2021-01-02;0;0;0;3992;1506;90;5498
02;2021-01-02;6;6;12;194587;164162;0;358749
03;2021-01-02;1;1;2;31123;30920;09;62043
03;2021-01-02;4;4;8;29370;29268;19;58638
03;2021-01-02;9;3;13;21458;18963;29;40421
03;2021-01-02;7;6;13;21276;18326;39;39602
03;2021-01-02;9;9;18;18164;16593;49;34757
03;2021-01-02;4;6;10;13469;13557;59;27026
03;2021-01-02;6;3;9;8776;8670;69;17446
03;2021-01-02;0;0;0;3777;3591;79;7368
03;2021-01-02;0;0;0;1649;1072;89;2721
03;2021-01-02;0;0;0;485;184;90;669
03;2021-01-02;40;32;73;149547;141144;0;290691
04;2021-01-02;2;2;4;60314;61377;09;121691
04;2021-01-02;4;1;5;66065;68387;19;134452
04;2021-01-02;3;2;5;51059;47156;29;98215
04;2021-01-02;5;1;6;58788;45780;39;104568
04;2021-01-02;7;6;13;61408;52207;49;113615
04;2021-01-02;3;0;3;64838;60759;59;125597
04;2021-01-02;4;3;7;47008;42843;69;89851
04;2021-01-02;0;0;0;25509;21184;79;46693
04;2021-01-02;0;0;0;13168;7647;89;20815
04;2021-01-02;0;0;0;3209;1253;90;4462
04;2021-01-02;28;15;43;451366;408593;0;859959
05;2021-01-02;0;0;0;362.366008612902;341.338819562748;09;703.704828175651
05;2021-01-02;0;0;0;353.376145114279;370.349735405642;19;723.725880519921
05;2021-01-02;0;0;0;218.593559489256;256.539602589476;29;475.133162078732
05;2021-01-02;0;0;0;404.225408693299;360.321910454353;39;764.547319147651
05;2021-01-02;0;0;0;520.067953604221;497.108383964256;49;1017.17633756848
05;2021-01-02;0;0;0;468.146063921917;510.087601910415;59;978.233665832332
05;2021-01-02;0;0;0;340.368470050554;334.366842191253;69;674.735312241807
05;2021-01-02;0;0;0;212.598666888387;192.597753227106;79;405.196420115493
05;2021-01-02;0;0;0;148.727797095705;61.8681715431829;89;210.595968638888
05;2021-01-02;0;0;0;32.9601271090696;10.9909785719784;90;43.9511056810479
05;2021-01-02;0;0;0;3061.43020057959;2935.56979942041;0;5997
06;2021-01-02;0;0;0;42583;42380;09;84963
06;2021-01-02;5;3;8;33369;31925;19;65294
06;2021-01-02;4;3;7;21571;15080;29;36651
06;2021-01-02;3;3;6;21550;16147;39;37697
06;2021-01-02;2;2;4;14193;13939;49;28132
06;2021-01-02;3;0;3;7171;7597;59;14768
06;2021-01-02;2;3;5;3629;4117;69;7746
06;2021-01-02;0;0;0;1577;1457;79;3034
06;2021-01-02;0;1;1;531;474;89;1005
06;2021-01-02;0;0;0;88;93;90;181
06;2021-01-02;19;15;34;146262;133209;0;279471
07;2021-01-02;0;0;0;485;549;09;1034
07;2021-01-02;0;0;0;403;432;19;835
07;2021-01-02;1;0;1;764;841;29;1605
07;2021-01-02;1;0;1;824;928;39;1752
07;2021-01-02;0;0;0;788;1020;49;1808
07;2021-01-02;0;0;0;678;870;59;1548
07;2021-01-02;1;0;1;360;382;69;742
07;2021-01-02;0;0;0;231;190;79;421
07;2021-01-02;0;0;0;114;67;89;181
07;2021-01-02;0;0;0;24;11;90;35
07;2021-01-02;3;0;3;4671;5290;0;9961
08;2021-01-02;0;0;0;2715.22592983026;2997.75551488675;09;5712.98144471701
08;2021-01-02;2;0;2;2778.51901080978;3160.9156459093;19;5939.43465671908
08;2021-01-02;1;0;1;2080.8882988764;1718.16634315323;29;3799.05464202964
08;2021-01-02;0;1;1;2701.8582062647;1896.52641413317;39;4598.38462039786
08;2021-01-02;0;2;2;3151.45861023308;2460.52498233809;49;5611.98359257117
08;2021-01-02;1;0;1;2620.29868333099;2422.23566154656;59;5042.53434487755
08;2021-01-02;1;0;1;1621.44173420671;1438.58325779464;69;3060.02499200135
08;2021-01-02;0;0;0;626.575909335673;526.358467843651;79;1152.93437717932
08;2021-01-02;0;0;0;205.018522985054;140.993639349697;89;346.012162334751
08;2021-01-02;0;0;0;50.0325684687745;20.62259870351;90;70.6551671722846
08;2021-01-02;5;3;8;18551.3174743414;16782.6825256586;0;35334
11;2021-01-02;43;49;94;783071;811785;09;1594856
11;2021-01-02;155;125;285;761456;784653;19;1546109
11;2021-01-02;288;230;518;850145;801772;29;1651917
11;2021-01-02;253;228;481;914360;843488;39;1757848
11;2021-01-02;205;208;413;845609;826202;49;1671811
11;2021-01-02;152;162;314;793566;745070;59;1538636
11;2021-01-02;117;93;211;628649;549192;69;1177841
11;2021-01-02;58;42;102;434606;358356;79;792962
11;2021-01-02;50;28;78;261425;162933;89;424358
11;2021-01-02;14;8;22;89253;32619;90;121872
11;2021-01-02;1335;1173;2518;6362140;5916070;0;12278210
24;2021-01-02;7;5;12;139720;144686;09;284406
24;2021-01-02;18;27;45;152979;161185;19;314164
24;2021-01-02;32;40;72;122237;126536;29;248773
24;2021-01-02;39;36;75;150359;142009;39;292368
24;2021-01-02;27;30;57;161829;158758;49;320587
24;2021-01-02;34;24;59;172552;168011;59;340563
24;2021-01-02;21;17;38;172509;158177;69;330686
24;2021-01-02;10;17;27;129428;110593;79;240021
24;2021-01-02;13;6;19;87342;56882;89;144224
24;2021-01-02;9;2;11;31210;12071;90;43281
24;2021-01-02;210;204;415;1320165;1238908;0;2559073
27;2021-01-02;11;10;21;143373;149679;09;293052
27;2021-01-02;76;63;139;160962;173003;19;333965
27;2021-01-02;78;68;146;133746;142254;29;276000
27;2021-01-02;77;71;149;160004;155407;39;315411
27;2021-01-02;65;62;127;172333;169564;49;341897
27;2021-01-02;66;81;147;189979;183788;59;373767
27;2021-01-02;63;53;116;192591;178206;69;370797
27;2021-01-02;44;42;86;146876;127546;79;274422
27;2021-01-02;37;22;59;96896;61575;89;158471
27;2021-01-02;16;8;24;33148;12109;90;45257
27;2021-01-02;533;480;1014;1429908;1353131;0;2783039
28;2021-01-02;6;5;11;180735;186856;09;367591
28;2021-01-02;41;27;69;200125;213621;19;413746
28;2021-01-02;41;44;85;168922;173007;29;341929
28;2021-01-02;48;33;81;196628;188487;39;385115
28;2021-01-02;38;39;77;205396;201699;49;407095
28;2021-01-02;44;35;79;222002;213866;59;435868
28;2021-01-02;26;25;51;224688;203758;69;428446
28;2021-01-02;21;22;43;163192;135543;79;298735
28;2021-01-02;17;15;32;109691;65377;89;175068
28;2021-01-02;12;1;13;37222;12685;90;49907
28;2021-01-02;294;246;541;1708601;1594899;0;3303500
32;2021-01-02;28;25;54;358062;373689;09;731751
32;2021-01-02;79;75;154;387045;406742;19;793787
32;2021-01-02;104;92;196;342304;348587;29;690891
32;2021-01-02;122;111;233;382485;369972;39;752457
32;2021-01-02;103;82;185;382510;376716;49;759226
32;2021-01-02;101;91;192;386937;376527;59;763464
32;2021-01-02;74;62;136;371211;330938;69;702149
32;2021-01-02;46;41;87;250542;201459;79;452001
32;2021-01-02;32;15;47;163399;89786;89;253185
32;2021-01-02;15;5;20;48384;15367;90;63751
32;2021-01-02;704;599;1304;3072879;2889783;0;5962662
44;2021-01-02;40;30;70;291525;306839;09;598364
44;2021-01-02;143;127;273;320255;339504;19;659759
44;2021-01-02;159;120;279;302020;314428;29;616448
44;2021-01-02;154;148;302;342222;333292;39;675514
44;2021-01-02;165;144;309;349727;344491;49;694218
44;2021-01-02;145;125;270;381371;373239;59;754610
44;2021-01-02;95;103;198;367165;335850;69;703015
44;2021-01-02;68;68;136;250387;215436;79;465823
44;2021-01-02;56;27;83;170825;105192;89;276017
44;2021-01-02;20;7;27;51248;16731;90;67979
44;2021-01-02;1045;899;1947;2826745;2685002;0;5511747
52;2021-01-02;15;12;28;213594;223900;09;437494
52;2021-01-02;40;44;85;240818;255197;19;496015
52;2021-01-02;51;41;92;197010;200630;29;397640
52;2021-01-02;51;37;89;231204;224885;39;456089
52;2021-01-02;35;40;75;243874;243418;49;487292
52;2021-01-02;48;41;89;244100;239116;59;483216
52;2021-01-02;19;44;64;241796;221345;69;463141
52;2021-01-02;20;14;34;177805;149903;79;327708
52;2021-01-02;15;14;30;119561;75822;89;195383
52;2021-01-02;7;7;14;42559;15260;90;57819
52;2021-01-02;301;294;600;1952321;1849476;0;3801797
53;2021-01-02;5;8;13;173813;182358;09;356171
53;2021-01-02;11;14;25;202720;214740;19;417460
53;2021-01-02;31;29;60;163116;173196;29;336312
53;2021-01-02;24;16;40;190526;187674;39;378200
53;2021-01-02;16;20;36;212098;212015;49;424113
53;2021-01-02;19;17;36;223699;219176;59;442875
53;2021-01-02;17;18;35;227435;209274;69;436709
53;2021-01-02;9;3;12;169992;140910;79;310902
53;2021-01-02;8;10;18;118117;69883;89;188000
53;2021-01-02;5;2;7;37370;12267;90;49637
53;2021-01-02;145;137;282;1718886;1621493;0;3340379
75;2021-01-02;9;14;23;293104;305291;09;598395
75;2021-01-02;58;48;107;337141;357785;19;694926
75;2021-01-02;71;64;135;295024;300618;29;595642
75;2021-01-02;65;37;102;347871;331233;39;679104
75;2021-01-02;68;67;135;384742;372771;49;757513
75;2021-01-02;60;63;123;413361;390880;59;804241
75;2021-01-02;40;34;74;425623;384060;69;809683
75;2021-01-02;36;28;64;325086;276298;79;601384
75;2021-01-02;23;19;42;213986;139308;89;353294
75;2021-01-02;21;7;28;77600;28200;90;105800
75;2021-01-02;451;381;833;3113538;2886444;0;5999982
76;2021-01-02;11;16;27;305956;318589;09;624545
76;2021-01-02;43;48;91;338942;356969;19;695911
76;2021-01-02;74;72;146;316210;319570;29;635780
76;2021-01-02;80;67;147;356758;337587;39;694345
76;2021-01-02;66;50;116;376541;363812;49;740353
76;2021-01-02;63;55;118;402608;383750;59;786358
76;2021-01-02;45;28;73;394889;358997;69;753886
76;2021-01-02;28;29;57;308664;263806;79;572470
76;2021-01-02;25;22;47;195838;129272;89;325110
76;2021-01-02;4;4;8;69372;26728;90;96100
76;2021-01-02;439;391;830;3065778;2859080;0;5924858
84;2021-01-02;33;31;65;459549;481088;09;940637
84;2021-01-02;132;122;256;487711;511905;19;999616
84;2021-01-02;153;121;274;443824;451094;29;894918
84;2021-01-02;183;125;308;512522;493262;39;1005784
84;2021-01-02;139;123;262;520248;515106;49;1035354
84;2021-01-02;116;121;237;529611;514848;59;1044459
84;2021-01-02;69;77;146;486720;439940;69;926660
84;2021-01-02;61;48;109;372151;315211;79;687362
84;2021-01-02;46;50;96;237198;150524;89;387722
84;2021-01-02;25;10;35;81185;28680;90;109865
84;2021-01-02;957;828;1788;4130719;3901658;0;8032377
93;2021-01-02;19;21;40;268834;283093;09;551927
93;2021-01-02;84;87;171;280751;296087;19;576838
93;2021-01-02;137;115;252;254404;255552;29;509956
93;2021-01-02;129;114;244;310704;288398;39;599102
93;2021-01-02;142;108;250;325559;305827;49;631386
93;2021-01-02;129;94;223;353104;325389;59;678493
93;2021-01-02;61;74;135;336327;296459;69;632786
93;2021-01-02;52;42;94;279820;229699;79;509519
93;2021-01-02;60;20;80;171274;113716;89;284990
93;2021-01-02;18;8;26;58896;21758;90;80654
93;2021-01-02;831;683;1515;2639673;2415978;0;5055651
94;2021-01-02;0;0;0;16311;17433;09;33744
94;2021-01-02;3;2;5;16679;18132;19;34811
94;2021-01-02;1;3;4;16782;16579;29;33361
94;2021-01-02;3;0;3;23044;20580;39;43624
94;2021-01-02;5;2;7;23065;22140;49;45205
94;2021-01-02;5;8;13;24549;23421;59;47970
94;2021-01-02;2;5;7;23212;21883;69;45095
94;2021-01-02;1;1;2;19544;17141;79;36685
94;2021-01-02;0;0;0;11227;8178;89;19405
94;2021-01-02;0;0;0;3332;1447;90;4779
94;2021-01-02;20;21;41;177745;166934;0;344679
01;2021-01-03;0;0;0;19979;20155;09;40134
01;2021-01-03;0;0;0;24994;25489;19;50483
01;2021-01-03;0;0;0;17868;16690;29;34558
01;2021-01-03;0;0;0;22328;14821;39;37149
01;2021-01-03;0;1;1;28652;20276;49;48928
01;2021-01-03;0;0;0;33264;27260;59;60524
01;2021-01-03;0;0;0;27135;23978;69;51113
01;2021-01-03;0;0;0;18401;14661;79;33062
01;2021-01-03;0;1;1;9633;6375;89;16008
01;2021-01-03;0;0;0;3410;1510;90;4920
01;2021-01-03;0;2;2;205664;171215;0;376879
02;2021-01-03;0;0;0;16881;17110;09;33991
02;2021-01-03;0;0;0;21410;21604;19;43014
02;2021-01-03;0;0;0;16017;15479;29;31496
02;2021-01-03;2;0;2;19825;14455;39;34280
02;2021-01-03;0;0;0;24719;18248;49;42967
02;2021-01-03;0;1;1;34361;28310;59;62671
02;2021-01-03;0;0;0;28061;24495;69;52556
02;2021-01-03;0;0;0;18231;15278;79;33509
02;2021-01-03;0;0;0;11090;7677;89;18767
02;2021-01-03;0;0;0;3992;1506;90;5498
02;2021-01-03;2;1;3;194587;164162;0;358749
03;2021-01-03;0;0;0;31123;30920;09;62043
03;2021-01-03;1;0;1;29370;29268;19;58638
03;2021-01-03;2;0;2;21458;18963;29;40421
03;2021-01-03;3;2;5;21276;18326;39;39602
03;2021-01-03;3;0;4;18164;16593;49;34757
03;2021-01-03;1;2;4;13469;13557;59;27026
03;2021-01-03;0;1;1;8776;8670;69;17446
03;2021-01-03;1;0;1;3777;3591;79;7368
03;2021-01-03;0;0;0;1649;1072;89;2721
03;2021-01-03;0;0;0;485;184;90;669
03;2021-01-03;11;5;18;149547;141144;0;290691
04;2021-01-03;0;0;0;60314;61377;09;121691
04;2021-01-03;0;0;0;66065;68387;19;134452
04;2021-01-03;0;0;0;51059;47156;29;98215
04;2021-01-03;1;0;1;58788;45780;39;104568
04;2021-01-03;0;0;0;61408;52207;49;113615
04;2021-01-03;0;0;0;64838;60759;59;125597
04;2021-01-03;0;0;0;47008;42843;69;89851
04;2021-01-03;0;0;0;25509;21184;79;46693
04;2021-01-03;0;0;0;13168;7647;89;20815
04;2021-01-03;0;0;0;3209;1253;90;4462
04;2021-01-03;1;0;1;451366;408593;0;859959
05;2021-01-03;0;0;0;362.366008612902;341.338819562748;09;703.704828175651
05;2021-01-03;0;0;0;353.376145114279;370.349735405642;19;723.725880519921
05;2021-01-03;0;0;0;218.593559489256;256.539602589476;29;475.133162078732
05;2021-01-03;0;0;0;404.225408693299;360.321910454353;39;764.547319147651
05;2021-01-03;0;0;0;520.067953604221;497.108383964256;49;1017.17633756848
05;2021-01-03;0;0;0;468.146063921917;510.087601910415;59;978.233665832332
05;2021-01-03;0;0;0;340.368470050554;334.366842191253;69;674.735312241807
05;2021-01-03;0;0;0;212.598666888387;192.597753227106;79;405.196420115493
05;2021-01-03;0;0;0;148.727797095705;61.8681715431829;89;210.595968638888
05;2021-01-03;0;0;0;32.9601271090696;10.9909785719784;90;43.9511056810479
05;2021-01-03;0;0;0;3061.43020057959;2935.56979942041;0;5997
06;2021-01-03;0;0;0;42583;42380;09;84963
06;2021-01-03;0;0;0;33369;31925;19;65294
06;2021-01-03;0;3;3;21571;15080;29;36651
06;2021-01-03;1;2;3;21550;16147;39;37697
06;2021-01-03;1;0;1;14193;13939;49;28132
06;2021-01-03;2;2;4;7171;7597;59;14768
06;2021-01-03;0;0;0;3629;4117;69;7746
06;2021-01-03;1;0;1;1577;1457;79;3034
06;2021-01-03;0;0;0;531;474;89;1005
06;2021-01-03;0;0;0;88;93;90;181
06;2021-01-03;5;7;12;146262;133209;0;279471
07;2021-01-03;0;0;0;485;549;09;1034
07;2021-01-03;0;1;1;403;432;19;835
07;2021-01-03;0;0;0;764;841;29;1605
07;2021-01-03;0;0;0;824;928;39;1752
07;2021-01-03;4;3;7;788;1020;49;1808
07;2021-01-03;0;0;0;678;870;59;1548
07;2021-01-03;0;0;0;360;382;69;742
07;2021-01-03;0;1;1;231;190;79;421
07;2021-01-03;0;0;0;114;67;89;181
07;2021-01-03;0;0;0;24;11;90;35
07;2021-01-03;4;5;9;4671;5290;0;9961
08;2021-01-03;0;0;0;2715.22592983026;2997.75551488675;09;5712.98144471701
08;2021-01-03;0;0;0;2778.51901080978;3160.9156459093;19;5939.43465671908
08;2021-01-03;0;1;1;2080.8882988764;1718.16634315323;29;3799.05464202964
08;2021-01-03;0;0;0;2701.8582062647;1896.52641413317;39;4598.38462039786
08;2021-01-03;0;1;1;3151.45861023308;2460.52498233809;49;5611.98359257117
08;2021-01-03;0;0;0;2620.29868333099;2422.23566154656;59;5042.53434487755
08;2021-01-03;0;0;0;1621.44173420671;1438.58325779464;69;3060.02499200135
08;2021-01-03;1;0;1;626.575909335673;526.358467843651;79;1152.93437717932
08;2021-01-03;0;0;0;205.018522985054;140.993639349697;89;346.012162334751
08;2021-01-03;0;0;0;50.0325684687745;20.62259870351;90;70.6551671722846
08;2021-01-03;1;2;3;18551.3174743414;16782.6825256586;0;35334
11;2021-01-03;11;5;17;783071;811785;09;1594856
11;2021-01-03;37;32;69;761456;784653;19;1546109
11;2021-01-03;62;72;134;850145;801772;29;1651917
11;2021-01-03;67;50;117;914360;843488;39;1757848
11;2021-01-03;42;51;93;845609;826202;49;1671811
11;2021-01-03;39;32;71;793566;745070;59;1538636
11;2021-01-03;21;37;59;628649;549192;69;1177841
11;2021-01-03;23;23;46;434606;358356;79;792962
11;2021-01-03;18;10;28;261425;162933;89;424358
11;2021-01-03;15;6;21;89253;32619;90;121872
11;2021-01-03;335;319;656;6362140;5916070;0;12278210
24;2021-01-03;0;0;0;139720;144686;09;284406
24;2021-01-03;2;1;3;152979;161185;19;314164
24;2021-01-03;8;2;10;122237;126536;29;248773
24;2021-01-03;5;4;9;150359;142009;39;292368
24;2021-01-03;5;9;14;161829;158758;49;320587
24;2021-01-03;7;3;10;172552;168011;59;340563
24;2021-01-03;4;1;5;172509;158177;69;330686
24;2021-01-03;8;1;9;129428;110593;79;240021
24;2021-01-03;10;5;15;87342;56882;89;144224
24;2021-01-03;1;1;2;31210;12071;90;43281
24;2021-01-03;50;27;77;1320165;1238908;0;2559073
27;2021-01-03;3;1;4;143373;149679;09;293052
27;2021-01-03;8;13;21;160962;173003;19;333965
27;2021-01-03;13;10;23;133746;142254;29;276000
27;2021-01-03;9;12;21;160004;155407;39;315411
27;2021-01-03;14;13;27;172333;169564;49;341897
27;2021-01-03;9;6;15;189979;183788;59;373767
27;2021-01-03;4;12;16;192591;178206;69;370797
27;2021-01-03;1;3;4;146876;127546;79;274422
27;2021-01-03;9;9;18;96896;61575;89;158471
27;2021-01-03;10;5;15;33148;12109;90;45257
27;2021-01-03;80;84;164;1429908;1353131;0;2783039
28;2021-01-03;2;3;5;180735;186856;09;367591
28;2021-01-03;4;3;8;200125;213621;19;413746
28;2021-01-03;11;13;24;168922;173007;29;341929
28;2021-01-03;8;11;19;196628;188487;39;385115
28;2021-01-03;12;12;24;205396;201699;49;407095
28;2021-01-03;9;8;17;222002;213866;59;435868
28;2021-01-03;3;9;12;224688;203758;69;428446
28;2021-01-03;3;11;14;163192;135543;79;298735
28;2021-01-03;9;12;21;109691;65377;89;175068
28;2021-01-03;5;3;8;37222;12685;90;49907
28;2021-01-03;66;85;152;1708601;1594899;0;3303500
32;2021-01-03;3;8;11;358062;373689;09;731751
32;2021-01-03;18;8;26;387045;406742;19;793787
32;2021-01-03;18;23;41;342304;348587;29;690891
32;2021-01-03;34;17;51;382485;369972;39;752457
32;2021-01-03;21;13;34;382510;376716;49;759226
32;2021-01-03;25;18;43;386937;376527;59;763464
32;2021-01-03;7;3;10;371211;330938;69;702149
32;2021-01-03;5;5;10;250542;201459;79;452001
32;2021-01-03;15;10;25;163399;89786;89;253185
32;2021-01-03;9;1;10;48384;15367;90;63751
32;2021-01-03;155;106;261;3072879;2889783;0;5962662
44;2021-01-03;2;2;4;291525;306839;09;598364
44;2021-01-03;13;6;19;320255;339504;19;659759
44;2021-01-03;23;12;35;302020;314428;29;616448
44;2021-01-03;8;19;27;342222;333292;39;675514
44;2021-01-03;9;10;19;349727;344491;49;694218
44;2021-01-03;14;11;25;381371;373239;59;754610
44;2021-01-03;15;13;28;367165;335850;69;703015
44;2021-01-03;7;11;18;250387;215436;79;465823
44;2021-01-03;24;13;37;170825;105192;89;276017
44;2021-01-03;13;6;19;51248;16731;90;67979
44;2021-01-03;128;103;231;2826745;2685002;0;5511747
52;2021-01-03;2;2;4;213594;223900;09;437494
52;2021-01-03;9;21;30;240818;255197;19;496015
52;2021-01-03;12;8;20;197010;200630;29;397640
52;2021-01-03;19;11;30;231204;224885;39;456089
52;2021-01-03;15;17;32;243874;243418;49;487292
52;2021-01-03;10;9;19;244100;239116;59;483216
52;2021-01-03;9;3;12;241796;221345;69;463141
52;2021-01-03;5;9;14;177805;149903;79;327708
52;2021-01-03;7;4;11;119561;75822;89;195383
52;2021-01-03;3;0;3;42559;15260;90;57819
52;2021-01-03;91;84;175;1952321;1849476;0;3801797
53;2021-01-03;1;1;2;173813;182358;09;356171
53;2021-01-03;2;5;7;202720;214740;19;417460
53;2021-01-03;6;9;15;163116;173196;29;336312
53;2021-01-03;2;4;6;190526;187674;39;378200
53;2021-01-03;2;1;3;212098;212015;49;424113
53;2021-01-03;7;4;11;223699;219176;59;442875
53;2021-01-03;2;2;4;227435;209274;69;436709
53;2021-01-03;0;0;0;169992;140910;79;310902
53;2021-01-03;5;3;8;118117;69883;89;188000
53;2021-01-03;3;0;3;37370;12267;90;49637
53;2021-01-03;30;29;59;1718886;1621493;0;3340379
75;2021-01-03;3;3;6;293104;305291;09;598395
75;2021-01-03;8;6;14;337141;357785;19;694926
75;2021-01-03;12;11;23;295024;300618;29;595642
75;2021-01-03;12;9;21;347871;331233;39;679104
75;2021-01-03;8;11;19;384742;372771;49;757513
75;2021-01-03;6;7;13;413361;390880;59;804241
75;2021-01-03;5;2;7;425623;384060;69;809683
75;2021-01-03;10;6;16;325086;276298;79;601384
75;2021-01-03;12;10;22;213986;139308;89;353294
75;2021-01-03;13;3;16;77600;28200;90;105800
75;2021-01-03;89;68;157;3113538;2886444;0;5999982
76;2021-01-03;3;1;4;305956;318589;09;624545
76;2021-01-03;15;11;26;338942;356969;19;695911
76;2021-01-03;16;12;28;316210;319570;29;635780
76;2021-01-03;18;12;30;356758;337587;39;694345
76;2021-01-03;14;12;26;376541;363812;49;740353
76;2021-01-03;13;9;22;402608;383750;59;786358
76;2021-01-03;7;7;14;394889;358997;69;753886
76;2021-01-03;5;13;18;308664;263806;79;572470
76;2021-01-03;12;8;20;195838;129272;89;325110
76;2021-01-03;8;0;8;69372;26728;90;96100
76;2021-01-03;111;85;196;3065778;2859080;0;5924858
84;2021-01-03;0;5;5;459549;481088;09;940637
84;2021-01-03;15;12;27;487711;511905;19;999616
84;2021-01-03;27;19;46;443824;451094;29;894918
84;2021-01-03;34;16;50;512522;493262;39;1005784
84;2021-01-03;11;21;32;520248;515106;49;1035354
84;2021-01-03;22;17;39;529611;514848;59;1044459
84;2021-01-03;13;14;27;486720;439940;69;926660
84;2021-01-03;13;17;30;372151;315211;79;687362
84;2021-01-03;32;16;48;237198;150524;89;387722
84;2021-01-03;18;7;25;81185;28680;90;109865
84;2021-01-03;185;144;329;4130719;3901658;0;8032377
93;2021-01-03;6;6;12;268834;283093;09;551927
93;2021-01-03;20;24;44;280751;296087;19;576838
93;2021-01-03;24;36;60;254404;255552;29;509956
93;2021-01-03;29;29;58;310704;288398;39;599102
93;2021-01-03;29;24;53;325559;305827;49;631386
93;2021-01-03;28;22;50;353104;325389;59;678493
93;2021-01-03;18;17;35;336327;296459;69;632786
93;2021-01-03;11;28;39;279820;229699;79;509519
93;2021-01-03;17;17;34;171274;113716;89;284990
93;2021-01-03;26;4;30;58896;21758;90;80654
93;2021-01-03;208;207;415;2639673;2415978;0;5055651
94;2021-01-03;0;0;0;16311;17433;09;33744
94;2021-01-03;0;0;0;16679;18132;19;34811
94;2021-01-03;1;0;1;16782;16579;29;33361
94;2021-01-03;1;0;1;23044;20580;39;43624
94;2021-01-03;0;0;0;23065;22140;49;45205
94;2021-01-03;1;0;1;24549;23421;59;47970
94;2021-01-03;1;0;1;23212;21883;69;45095
94;2021-01-03;1;1;2;19544;17141;79;36685
94;2021-01-03;0;0;0;11227;8178;89;19405
94;2021-01-03;0;0;0;3332;1447;90;4779
94;2021-01-03;5;1;6;177745;166934;0;344679
01;2021-01-04;0;0;0;19979;20155;09;40134
01;2021-01-04;0;3;3;24994;25489;19;50483
01;2021-01-04;2;1;3;17868;16690;29;34558
01;2021-01-04;2;3;5;22328;14821;39;37149
01;2021-01-04;2;2;4;28652;20276;49;48928
01;2021-01-04;3;0;3;33264;27260;59;60524
01;2021-01-04;0;0;0;27135;23978;69;51113
01;2021-01-04;0;0;0;18401;14661;79;33062
01;2021-01-04;1;1;2;9633;6375;89;16008
01;2021-01-04;0;0;0;3410;1510;90;4920
01;2021-01-04;10;10;20;205664;171215;0;376879
02;2021-01-04;0;1;1;16881;17110;09;33991
02;2021-01-04;1;0;1;21410;21604;19;43014
02;2021-01-04;0;2;2;16017;15479;29;31496
02;2021-01-04;2;0;2;19825;14455;39;34280
02;2021-01-04;3;0;3;24719;18248;49;42967
02;2021-01-04;2;5;7;34361;28310;59;62671
02;2021-01-04;2;2;4;28061;24495;69;52556
02;2021-01-04;0;0;0;18231;15278;79;33509
02;2021-01-04;1;0;1;11090;7677;89;18767
02;2021-01-04;0;0;0;3992;1506;90;5498
02;2021-01-04;11;10;21;194587;164162;0;358749
03;2021-01-04;3;1;4;31123;30920;09;62043
03;2021-01-04;14;8;22;29370;29268;19;58638
03;2021-01-04;12;15;27;21458;18963;29;40421
03;2021-01-04;25;11;36;21276;18326;39;39602
03;2021-01-04;16;10;26;18164;16593;49;34757
03;2021-01-04;10;9;19;13469;13557;59;27026
03;2021-01-04;6;5;11;8776;8670;69;17446
03;2021-01-04;0;3;3;3777;3591;79;7368
03;2021-01-04;0;1;1;1649;1072;89;2721
03;2021-01-04;0;0;0;485;184;90;669
03;2021-01-04;86;63;149;149547;141144;0;290691
04;2021-01-04;1;1;2;60314;61377;09;121691
04;2021-01-04;4;3;7;66065;68387;19;134452
04;2021-01-04;4;7;11;51059;47156;29;98215
04;2021-01-04;7;6;13;58788;45780;39;104568
04;2021-01-04;4;5;9;61408;52207;49;113615
04;2021-01-04;0;5;5;64838;60759;59;125597
04;2021-01-04;1;3;4;47008;42843;69;89851
04;2021-01-04;3;2;5;25509;21184;79;46693
04;2021-01-04;0;1;1;13168;7647;89;20815
04;2021-01-04;0;0;0;3209;1253;90;4462
04;2021-01-04;24;33;57;451366;408593;0;859959
05;2021-01-04;0;0;0;362.366008612902;341.338819562748;09;703.704828175651
05;2021-01-04;0;0;0;353.376145114279;370.349735405642;19;723.725880519921
05;2021-01-04;0;0;0;218.593559489256;256.539602589476;29;475.133162078732
05;2021-01-04;0;0;0;404.225408693299;360.321910454353;39;764.547319147651
05;2021-01-04;0;0;0;520.067953604221;497.108383964256;49;1017.17633756848
05;2021-01-04;0;0;0;468.146063921917;510.087601910415;59;978.233665832332
05;2021-01-04;0;0;0;340.368470050554;334.366842191253;69;674.735312241807
05;2021-01-04;0;0;0;212.598666888387;192.597753227106;79;405.196420115493
05;2021-01-04;0;0;0;148.727797095705;61.8681715431829;89;210.595968638888
05;2021-01-04;0;0;0;32.9601271090696;10.9909785719784;90;43.9511056810479
05;2021-01-04;0;0;0;3061.43020057959;2935.56979942041;0;5997
06;2021-01-04;0;0;0;42583;42380;09;84963
06;2021-01-04;3;2;5;33369;31925;19;65294
06;2021-01-04;9;5;14;21571;15080;29;36651
06;2021-01-04;14;4;18;21550;16147;39;37697
06;2021-01-04;7;11;18;14193;13939;49;28132
06;2021-01-04;6;3;9;7171;7597;59;14768
06;2021-01-04;4;1;5;3629;4117;69;7746
06;2021-01-04;0;0;0;1577;1457;79;3034
06;2021-01-04;0;0;0;531;474;89;1005
06;2021-01-04;0;0;0;88;93;90;181
06;2021-01-04;43;26;69;146262;133209;0;279471
07;2021-01-04;0;0;0;485;549;09;1034
07;2021-01-04;0;0;0;403;432;19;835
07;2021-01-04;1;0;1;764;841;29;1605
07;2021-01-04;0;1;1;824;928;39;1752
07;2021-01-04;0;0;0;788;1020;49;1808
07;2021-01-04;0;0;0;678;870;59;1548
07;2021-01-04;0;0;0;360;382;69;742
07;2021-01-04;1;0;1;231;190;79;421
07;2021-01-04;0;0;0;114;67;89;181
07;2021-01-04;0;0;0;24;11;90;35
07;2021-01-04;2;1;3;4671;5290;0;9961
08;2021-01-04;0;0;0;2715.22592983026;2997.75551488675;09;5712.98144471701
08;2021-01-04;2;1;3;2778.51901080978;3160.9156459093;19;5939.43465671908
08;2021-01-04;1;1;2;2080.8882988764;1718.16634315323;29;3799.05464202964
08;2021-01-04;2;4;6;2701.8582062647;1896.52641413317;39;4598.38462039786
08;2021-01-04;0;1;1;3151.45861023308;2460.52498233809;49;5611.98359257117
08;2021-01-04;1;1;2;2620.29868333099;2422.23566154656;59;5042.53434487755
08;2021-01-04;0;0;0;1621.44173420671;1438.58325779464;69;3060.02499200135
08;2021-01-04;0;0;0;626.575909335673;526.358467843651;79;1152.93437717932
08;2021-01-04;0;0;0;205.018522985054;140.993639349697;89;346.012162334751
08;2021-01-04;0;0;0;50.0325684687745;20.62259870351;90;70.6551671722846
08;2021-01-04;6;8;14;18551.3174743414;16782.6825256586;0;35334
11;2021-01-04;67;79;152;783071;811785;09;1594856
11;2021-01-04;290;259;555;761456;784653;19;1546109
11;2021-01-04;564;453;1021;850145;801772;29;1651917
11;2021-01-04;550;466;1019;914360;843488;39;1757848
11;2021-01-04;414;347;765;845609;826202;49;1671811
11;2021-01-04;343;287;633;793566;745070;59;1538636
11;2021-01-04;212;161;373;628649;549192;69;1177841
11;2021-01-04;121;120;241;434606;358356;79;792962
11;2021-01-04;81;60;141;261425;162933;89;424358
11;2021-01-04;51;16;67;89253;32619;90;121872
11;2021-01-04;2693;2249;4968;6362140;5916070;0;12278210
24;2021-01-04;10;9;19;139720;144686;09;284406
24;2021-01-04;59;50;109;152979;161185;19;314164
24;2021-01-04;88;59;147;122237;126536;29;248773
24;2021-01-04;87;58;145;150359;142009;39;292368
24;2021-01-04;75;75;150;161829;158758;49;320587
24;2021-01-04;99;47;146;172552;168011;59;340563
24;2021-01-04;35;38;73;172509;158177;69;330686
24;2021-01-04;39;27;66;129428;110593;79;240021
24;2021-01-04;50;20;70;87342;56882;89;144224
24;2021-01-04;61;12;73;31210;12071;90;43281
24;2021-01-04;603;395;998;1320165;1238908;0;2559073
27;2021-01-04;31;30;61;143373;149679;09;293052
27;2021-01-04;100;115;215;160962;173003;19;333965
27;2021-01-04;157;141;298;133746;142254;29;276000
27;2021-01-04;162;112;274;160004;155407;39;315411
27;2021-01-04;145;95;240;172333;169564;49;341897
27;2021-01-04;137;143;280;189979;183788;59;373767
27;2021-01-04;102;68;170;192591;178206;69;370797
27;2021-01-04;77;79;156;146876;127546;79;274422
27;2021-01-04;92;60;152;96896;61575;89;158471
27;2021-01-04;69;21;90;33148;12109;90;45257
27;2021-01-04;1072;865;1937;1429908;1353131;0;2783039
28;2021-01-04;9;17;26;180735;186856;09;367591
28;2021-01-04;62;73;138;200125;213621;19;413746
28;2021-01-04;111;87;198;168922;173007;29;341929
28;2021-01-04;111;72;183;196628;188487;39;385115
28;2021-01-04;103;65;168;205396;201699;49;407095
28;2021-01-04;99;86;185;222002;213866;59;435868
28;2021-01-04;62;66;128;224688;203758;69;428446
28;2021-01-04;39;34;73;163192;135543;79;298735
28;2021-01-04;38;18;56;109691;65377;89;175068
28;2021-01-04;10;6;16;37222;12685;90;49907
28;2021-01-04;644;524;1171;1708601;1594899;0;3303500
32;2021-01-04;28;33;62;358062;373689;09;731751
32;2021-01-04;131;109;240;387045;406742;19;793787
32;2021-01-04;204;162;366;342304;348587;29;690891
32;2021-01-04;221;178;399;382485;369972;39;752457
32;2021-01-04;160;132;292;382510;376716;49;759226
32;2021-01-04;179;145;324;386937;376527;59;763464
32;2021-01-04;114;95;209;371211;330938;69;702149
32;2021-01-04;84;80;164;250542;201459;79;452001
32;2021-01-04;83;31;114;163399;89786;89;253185
32;2021-01-04;60;17;77;48384;15367;90;63751
32;2021-01-04;1264;982;2247;3072879;2889783;0;5962662
44;2021-01-04;48;46;95;291525;306839;09;598364
44;2021-01-04;177;171;353;320255;339504;19;659759
44;2021-01-04;263;233;496;302020;314428;29;616448
44;2021-01-04;270;201;473;342222;333292;39;675514
44;2021-01-04;251;197;451;349727;344491;49;694218
44;2021-01-04;225;229;455;381371;373239;59;754610
44;2021-01-04;183;167;351;367165;335850;69;703015
44;2021-01-04;121;116;237;250387;215436;79;465823
44;2021-01-04;132;87;223;170825;105192;89;276017
44;2021-01-04;69;30;99;51248;16731;90;67979
44;2021-01-04;1740;1477;3234;2826745;2685002;0;5511747
52;2021-01-04;11;18;29;213594;223900;09;437494
52;2021-01-04;68;78;149;240818;255197;19;496015
52;2021-01-04;86;95;181;197010;200630;29;397640
52;2021-01-04;65;67;132;231204;224885;39;456089
52;2021-01-04;90;73;163;243874;243418;49;487292
52;2021-01-04;86;72;162;244100;239116;59;483216
52;2021-01-04;54;60;115;241796;221345;69;463141
52;2021-01-04;37;37;75;177805;149903;79;327708
52;2021-01-04;35;23;58;119561;75822;89;195383
52;2021-01-04;27;14;41;42559;15260;90;57819
52;2021-01-04;559;537;1105;1952321;1849476;0;3801797
53;2021-01-04;7;10;17;173813;182358;09;356171
53;2021-01-04;34;39;73;202720;214740;19;417460
53;2021-01-04;44;53;99;163116;173196;29;336312
53;2021-01-04;43;38;81;190526;187674;39;378200
53;2021-01-04;44;33;77;212098;212015;49;424113
53;2021-01-04;46;34;80;223699;219176;59;442875
53;2021-01-04;28;28;56;227435;209274;69;436709
53;2021-01-04;19;15;34;169992;140910;79;310902
53;2021-01-04;20;14;34;118117;69883;89;188000
53;2021-01-04;11;4;15;37370;12267;90;49637
53;2021-01-04;296;268;566;1718886;1621493;0;3340379
75;2021-01-04;33;29;62;293104;305291;09;598395
75;2021-01-04;103;80;185;337141;357785;19;694926
75;2021-01-04;141;132;273;295024;300618;29;595642
75;2021-01-04;133;117;250;347871;331233;39;679104
75;2021-01-04;160;127;287;384742;372771;49;757513
75;2021-01-04;144;109;253;413361;390880;59;804241
75;2021-01-04;104;89;193;425623;384060;69;809683
75;2021-01-04;62;58;121;325086;276298;79;601384
75;2021-01-04;67;36;103;213986;139308;89;353294
75;2021-01-04;52;16;69;77600;28200;90;105800
75;2021-01-04;999;793;1796;3113538;2886444;0;5999982
76;2021-01-04;29;27;58;305956;318589;09;624545
76;2021-01-04;162;141;306;338942;356969;19;695911
76;2021-01-04;220;180;401;316210;319570;29;635780
76;2021-01-04;198;157;355;356758;337587;39;694345
76;2021-01-04;156;157;313;376541;363812;49;740353
76;2021-01-04;183;138;321;402608;383750;59;786358
76;2021-01-04;128;114;242;394889;358997;69;753886
76;2021-01-04;81;78;159;308664;263806;79;572470
76;2021-01-04;73;48;121;195838;129272;89;325110
76;2021-01-04;46;18;64;69372;26728;90;96100
76;2021-01-04;1278;1058;2342;3065778;2859080;0;5924858
84;2021-01-04;77;68;146;459549;481088;09;940637
84;2021-01-04;233;264;498;487711;511905;19;999616
84;2021-01-04;383;342;726;443824;451094;29;894918
84;2021-01-04;393;367;761;512522;493262;39;1005784
84;2021-01-04;299;300;599;520248;515106;49;1035354
84;2021-01-04;300;274;574;529611;514848;59;1044459
84;2021-01-04;244;212;457;486720;439940;69;926660
84;2021-01-04;166;147;313;372151;315211;79;687362
84;2021-01-04;121;91;212;237198;150524;89;387722
84;2021-01-04;86;25;111;81185;28680;90;109865
84;2021-01-04;2302;2090;4399;4130719;3901658;0;8032377
93;2021-01-04;44;44;88;268834;283093;09;551927
93;2021-01-04;202;182;387;280751;296087;19;576838
93;2021-01-04;310;250;561;254404;255552;29;509956
93;2021-01-04;296;293;589;310704;288398;39;599102
93;2021-01-04;281;242;523;325559;305827;49;631386
93;2021-01-04;262;252;517;353104;325389;59;678493
93;2021-01-04;217;197;415;336327;296459;69;632786
93;2021-01-04;142;116;258;279820;229699;79;509519
93;2021-01-04;124;83;207;171274;113716;89;284990
93;2021-01-04;96;35;131;58896;21758;90;80654
93;2021-01-04;1974;1694;3676;2639673;2415978;0;5055651
94;2021-01-04;4;1;5;16311;17433;09;33744
94;2021-01-04;5;3;8;16679;18132;19;34811
94;2021-01-04;4;0;4;16782;16579;29;33361
94;2021-01-04;8;6;14;23044;20580;39;43624
94;2021-01-04;6;4;10;23065;22140;49;45205
94;2021-01-04;6;9;15;24549;23421;59;47970
94;2021-01-04;3;8;11;23212;21883;69;45095
94;2021-01-04;4;1;5;19544;17141;79;36685
94;2021-01-04;1;0;1;11227;8178;89;19405
94;2021-01-04;0;0;0;3332;1447;90;4779
94;2021-01-04;41;32;73;177745;166934;0;344679
01;2021-01-05;0;0;0;19979;20155;09;40134
01;2021-01-05;1;0;1;24994;25489;19;50483
01;2021-01-05;2;2;4;17868;16690;29;34558
01;2021-01-05;1;2;3;22328;14821;39;37149
01;2021-01-05;4;0;4;28652;20276;49;48928
01;2021-01-05;3;4;7;33264;27260;59;60524
01;2021-01-05;1;1;2;27135;23978;69;51113
01;2021-01-05;0;1;1;18401;14661;79;33062
01;2021-01-05;0;0;0;9633;6375;89;16008
01;2021-01-05;0;0;0;3410;1510;90;4920
01;2021-01-05;12;10;22;205664;171215;0;376879
02;2021-01-05;1;0;1;16881;17110;09;33991
02;2021-01-05;0;1;1;21410;21604;19;43014
02;2021-01-05;3;2;5;16017;15479;29;31496
02;2021-01-05;1;0;1;19825;14455;39;34280
02;2021-01-05;0;2;2;24719;18248;49;42967
02;2021-01-05;1;0;1;34361;28310;59;62671
02;2021-01-05;0;1;1;28061;24495;69;52556
02;2021-01-05;0;0;0;18231;15278;79;33509
02;2021-01-05;1;0;1;11090;7677;89;18767
02;2021-01-05;0;0;0;3992;1506;90;5498
02;2021-01-05;7;6;13;194587;164162;0;358749
03;2021-01-05;3;1;4;31123;30920;09;62043
03;2021-01-05;15;6;22;29370;29268;19;58638
03;2021-01-05;20;19;40;21458;18963;29;40421
03;2021-01-05;16;12;29;21276;18326;39;39602
03;2021-01-05;15;11;26;18164;16593;49;34757
03;2021-01-05;16;5;22;13469;13557;59;27026
03;2021-01-05;6;6;12;8776;8670;69;17446
03;2021-01-05;2;3;5;3777;3591;79;7368
03;2021-01-05;1;0;1;1649;1072;89;2721
03;2021-01-05;0;0;0;485;184;90;669
03;2021-01-05;94;63;161;149547;141144;0;290691
04;2021-01-05;0;0;0;60314;61377;09;121691
04;2021-01-05;3;1;4;66065;68387;19;134452
04;2021-01-05;5;3;8;51059;47156;29;98215
04;2021-01-05;4;1;5;58788;45780;39;104568
04;2021-01-05;4;2;6;61408;52207;49;113615
04;2021-01-05;3;3;6;64838;60759;59;125597
04;2021-01-05;0;2;2;47008;42843;69;89851
04;2021-01-05;0;0;0;25509;21184;79;46693
04;2021-01-05;0;1;1;13168;7647;89;20815
04;2021-01-05;0;0;0;3209;1253;90;4462
04;2021-01-05;19;13;32;451366;408593;0;859959
05;2021-01-05;0;0;0;362.366008612902;341.338819562748;09;703.704828175651
05;2021-01-05;0;0;0;353.376145114279;370.349735405642;19;723.725880519921
05;2021-01-05;0;0;0;218.593559489256;256.539602589476;29;475.133162078732
05;2021-01-05;0;0;0;404.225408693299;360.321910454353;39;764.547319147651
05;2021-01-05;0;0;0;520.067953604221;497.108383964256;49;1017.17633756848
05;2021-01-05;0;0;0;468.146063921917;510.087601910415;59;978.233665832332
05;2021-01-05;0;0;0;340.368470050554;334.366842191253;69;674.735312241807
05;2021-01-05;0;0;0;212.598666888387;192.597753227106;79;405.196420115493
05;2021-01-05;0;0;0;148.727797095705;61.8681715431829;89;210.595968638888
05;2021-01-05;0;0;0;32.9601271090696;10.9909785719784;90;43.9511056810479
05;2021-01-05;0;0;0;3061.43020057959;2935.56979942041;0;5997
06;2021-01-05;0;0;0;42583;42380;09;84963
06;2021-01-05;0;4;4;33369;31925;19;65294
06;2021-01-05;6;4;10;21571;15080;29;36651
06;2021-01-05;1;1;2;21550;16147;39;37697
06;2021-01-05;6;2;8;14193;13939;49;28132
06;2021-01-05;6;5;11;7171;7597;59;14768
06;2021-01-05;1;1;2;3629;4117;69;7746
06;2021-01-05;0;1;1;1577;1457;79;3034
06;2021-01-05;0;0;0;531;474;89;1005
06;2021-01-05;0;0;0;88;93;90;181
06;2021-01-05;20;18;38;146262;133209;0;279471
07;2021-01-05;0;0;0;485;549;09;1034
07;2021-01-05;0;0;0;403;432;19;835
07;2021-01-05;0;0;0;764;841;29;1605
07;2021-01-05;1;1;2;824;928;39;1752
07;2021-01-05;2;1;3;788;1020;49;1808
07;2021-01-05;0;0;0;678;870;59;1548
07;2021-01-05;0;0;0;360;382;69;742
07;2021-01-05;0;0;0;231;190;79;421
07;2021-01-05;0;1;1;114;67;89;181
07;2021-01-05;0;0;0;24;11;90;35
07;2021-01-05;3;3;6;4671;5290;0;9961
08;2021-01-05;0;0;0;2715.22592983026;2997.75551488675;09;5712.98144471701
08;2021-01-05;1;1;2;2778.51901080978;3160.9156459093;19;5939.43465671908
08;2021-01-05;0;0;0;2080.8882988764;1718.16634315323;29;3799.05464202964
08;2021-01-05;0;3;3;2701.8582062647;1896.52641413317;39;4598.38462039786
08;2021-01-05;0;0;0;3151.45861023308;2460.52498233809;49;5611.98359257117
08;2021-01-05;0;0;0;2620.29868333099;2422.23566154656;59;5042.53434487755
08;2021-01-05;0;0;0;1621.44173420671;1438.58325779464;69;3060.02499200135
08;2021-01-05;1;0;1;626.575909335673;526.358467843651;79;1152.93437717932
08;2021-01-05;0;0;0;205.018522985054;140.993639349697;89;346.012162334751
08;2021-01-05;0;0;0;50.0325684687745;20.62259870351;90;70.6551671722846
08;2021-01-05;2;4;6;18551.3174743414;16782.6825256586;0;35334
11;2021-01-05;50;53;105;783071;811785;09;1594856
11;2021-01-05;228;203;443;761456;784653;19;1546109
11;2021-01-05;479;343;827;850145;801772;29;1651917
11;2021-01-05;379;344;725;914360;843488;39;1757848
11;2021-01-05;298;290;593;845609;826202;49;1671811
11;2021-01-05;273;224;498;793566;745070;59;1538636
11;2021-01-05;172;173;347;628649;549192;69;1177841
11;2021-01-05;124;86;210;434606;358356;79;792962
11;2021-01-05;94;53;147;261425;162933;89;424358
11;2021-01-05;54;17;71;89253;32619;90;121872
11;2021-01-05;2151;1786;3966;6362140;5916070;0;12278210
24;2021-01-05;5;13;19;139720;144686;09;284406
24;2021-01-05;49;29;78;152979;161185;19;314164
24;2021-01-05;63;51;114;122237;126536;29;248773
24;2021-01-05;65;58;123;150359;142009;39;292368
24;2021-01-05;60;48;108;161829;158758;49;320587
24;2021-01-05;69;50;119;172552;168011;59;340563
24;2021-01-05;39;55;94;172509;158177;69;330686
24;2021-01-05;38;30;68;129428;110593;79;240021
24;2021-01-05;47;22;69;87342;56882;89;144224
24;2021-01-05;29;8;37;31210;12071;90;43281
24;2021-01-05;464;365;830;1320165;1238908;0;2559073
27;2021-01-05;16;20;36;143373;149679;09;293052
27;2021-01-05;90;107;197;160962;173003;19;333965
27;2021-01-05;100;99;199;133746;142254;29;276000
27;2021-01-05;111;80;191;160004;155407;39;315411
27;2021-01-05;113;82;195;172333;169564;49;341897
27;2021-01-05;109;93;202;189979;183788;59;373767
27;2021-01-05;81;84;165;192591;178206;69;370797
27;2021-01-05;49;63;112;146876;127546;79;274422
27;2021-01-05;69;48;117;96896;61575;89;158471
27;2021-01-05;54;19;73;33148;12109;90;45257
27;2021-01-05;792;695;1487;1429908;1353131;0;2783039
28;2021-01-05;16;19;35;180735;186856;09;367591
28;2021-01-05;77;69;146;200125;213621;19;413746
28;2021-01-05;124;98;222;168922;173007;29;341929
28;2021-01-05;74;71;145;196628;188487;39;385115
28;2021-01-05;75;69;144;205396;201699;49;407095
28;2021-01-05;64;67;131;222002;213866;59;435868
28;2021-01-05;61;60;121;224688;203758;69;428446
28;2021-01-05;37;31;68;163192;135543;79;298735
28;2021-01-05;51;20;71;109691;65377;89;175068
28;2021-01-05;33;9;42;37222;12685;90;49907
28;2021-01-05;612;513;1125;1708601;1594899;0;3303500
32;2021-01-05;27;39;66;358062;373689;09;731751
32;2021-01-05;110;97;208;387045;406742;19;793787
32;2021-01-05;180;141;321;342304;348587;29;690891
32;2021-01-05;153;134;287;382485;369972;39;752457
32;2021-01-05;122;122;244;382510;376716;49;759226
32;2021-01-05;130;128;258;386937;376527;59;763464
32;2021-01-05;104;89;193;371211;330938;69;702149
32;2021-01-05;69;59;128;250542;201459;79;452001
32;2021-01-05;75;42;117;163399;89786;89;253185
32;2021-01-05;59;15;74;48384;15367;90;63751
32;2021-01-05;1030;867;1898;3072879;2889783;0;5962662
44;2021-01-05;41;48;90;291525;306839;09;598364
44;2021-01-05;146;137;283;320255;339504;19;659759
44;2021-01-05;196;191;387;302020;314428;29;616448
44;2021-01-05;200;145;347;342222;333292;39;675514
44;2021-01-05;172;151;324;349727;344491;49;694218
44;2021-01-05;147;162;310;381371;373239;59;754610
44;2021-01-05;152;133;286;367165;335850;69;703015
44;2021-01-05;103;72;176;250387;215436;79;465823
44;2021-01-05;142;62;204;170825;105192;89;276017
44;2021-01-05;78;35;113;51248;16731;90;67979
44;2021-01-05;1377;1136;2520;2826745;2685002;0;5511747
52;2021-01-05;10;17;27;213594;223900;09;437494
52;2021-01-05;54;54;111;240818;255197;19;496015
52;2021-01-05;65;65;130;197010;200630;29;397640
52;2021-01-05;52;45;97;231204;224885;39;456089
52;2021-01-05;62;42;105;243874;243418;49;487292
52;2021-01-05;57;47;104;244100;239116;59;483216
52;2021-01-05;49;44;95;241796;221345;69;463141
52;2021-01-05;32;36;70;177805;149903;79;327708
52;2021-01-05;26;24;50;119561;75822;89;195383
52;2021-01-05;29;8;37;42559;15260;90;57819
52;2021-01-05;436;382;826;1952321;1849476;0;3801797
53;2021-01-05;9;5;14;173813;182358;09;356171
53;2021-01-05;33;34;68;202720;214740;19;417460
53;2021-01-05;60;42;103;163116;173196;29;336312
53;2021-01-05;51;32;83;190526;187674;39;378200
53;2021-01-05;37;32;69;212098;212015;49;424113
53;2021-01-05;36;35;71;223699;219176;59;442875
53;2021-01-05;26;29;55;227435;209274;69;436709
53;2021-01-05;12;18;30;169992;140910;79;310902
53;2021-01-05;18;5;23;118117;69883;89;188000
53;2021-01-05;14;4;19;37370;12267;90;49637
53;2021-01-05;296;236;535;1718886;1621493;0;3340379
75;2021-01-05;15;23;38;293104;305291;09;598395
75;2021-01-05;89;89;178;337141;357785;19;694926
75;2021-01-05;114;107;221;295024;300618;29;595642
75;2021-01-05;102;87;189;347871;331233;39;679104
75;2021-01-05;121;104;225;384742;372771;49;757513
75;2021-01-05;90;82;172;413361;390880;59;804241
75;2021-01-05;78;74;153;425623;384060;69;809683
75;2021-01-05;45;55;100;325086;276298;79;601384
75;2021-01-05;91;41;134;213986;139308;89;353294
75;2021-01-05;75;21;96;77600;28200;90;105800
75;2021-01-05;821;683;1507;3113538;2886444;0;5999982
76;2021-01-05;20;21;41;305956;318589;09;624545
76;2021-01-05;119;111;235;338942;356969;19;695911
76;2021-01-05;168;146;314;316210;319570;29;635780
76;2021-01-05;137;114;251;356758;337587;39;694345
76;2021-01-05;135;123;258;376541;363812;49;740353
76;2021-01-05;156;99;255;402608;383750;59;786358
76;2021-01-05;90;89;180;394889;358997;69;753886
76;2021-01-05;65;57;122;308664;263806;79;572470
76;2021-01-05;92;41;133;195838;129272;89;325110
76;2021-01-05;74;25;99;69372;26728;90;96100
76;2021-01-05;1057;826;1889;3065778;2859080;0;5924858
84;2021-01-05;52;59;111;459549;481088;09;940637
84;2021-01-05;223;232;456;487711;511905;19;999616
84;2021-01-05;256;244;500;443824;451094;29;894918
84;2021-01-05;291;226;517;512522;493262;39;1005784
84;2021-01-05;241;186;427;520248;515106;49;1035354
84;2021-01-05;232;205;438;529611;514848;59;1044459
84;2021-01-05;151;157;308;486720;439940;69;926660
84;2021-01-05;110;111;222;372151;315211;79;687362
84;2021-01-05;101;57;158;237198;150524;89;387722
84;2021-01-05;65;33;98;81185;28680;90;109865
84;2021-01-05;1722;1511;3236;4130719;3901658;0;8032377
93;2021-01-05;28;43;72;268834;283093;09;551927
93;2021-01-05;142;161;303;280751;296087;19;576838
93;2021-01-05;248;220;469;254404;255552;29;509956
93;2021-01-05;244;194;439;310704;288398;39;599102
93;2021-01-05;191;179;370;325559;305827;49;631386
93;2021-01-05;238;186;425;353104;325389;59;678493
93;2021-01-05;163;139;302;336327;296459;69;632786
93;2021-01-05;127;97;224;279820;229699;79;509519
93;2021-01-05;108;72;180;171274;113716;89;284990
93;2021-01-05;93;28;121;58896;21758;90;80654
93;2021-01-05;1583;1319;2906;2639673;2415978;0;5055651
94;2021-01-05;1;1;2;16311;17433;09;33744
94;2021-01-05;1;4;5;16679;18132;19;34811
94;2021-01-05;6;2;8;16782;16579;29;33361
94;2021-01-05;1;2;3;23044;20580;39;43624
94;2021-01-05;3;4;7;23065;22140;49;45205
94;2021-01-05;5;4;9;24549;23421;59;47970
94;2021-01-05;1;2;3;23212;21883;69;45095
94;2021-01-05;2;3;5;19544;17141;79;36685
94;2021-01-05;0;0;0;11227;8178;89;19405
94;2021-01-05;0;1;1;3332;1447;90;4779
94;2021-01-05;20;23;43;177745;166934;0;344679
01;2021-01-06;0;0;0;19979;20155;09;40134
01;2021-01-06;1;2;3;24994;25489;19;50483
01;2021-01-06;4;0;4;17868;16690;29;34558
01;2021-01-06;3;1;4;22328;14821;39;37149
01;2021-01-06;0;1;1;28652;20276;49;48928
01;2021-01-06;3;0;3;33264;27260;59;60524
01;2021-01-06;2;2;4;27135;23978;69;51113
01;2021-01-06;0;1;1;18401;14661;79;33062
01;2021-01-06;0;0;0;9633;6375;89;16008
01;2021-01-06;0;0;0;3410;1510;90;4920
01;2021-01-06;13;7;20;205664;171215;0;376879
02;2021-01-06;0;0;0;16881;17110;09;33991
02;2021-01-06;0;1;1;21410;21604;19;43014
02;2021-01-06;1;1;2;16017;15479;29;31496
02;2021-01-06;0;0;0;19825;14455;39;34280
02;2021-01-06;1;1;2;24719;18248;49;42967
02;2021-01-06;1;0;1;34361;28310;59;62671
02;2021-01-06;0;1;1;28061;24495;69;52556
02;2021-01-06;1;0;1;18231;15278;79;33509
02;2021-01-06;0;0;0;11090;7677;89;18767
02;2021-01-06;0;0;0;3992;1506;90;5498
02;2021-01-06;4;4;8;194587;164162;0;358749
03;2021-01-06;2;2;4;31123;30920;09;62043
03;2021-01-06;11;15;26;29370;29268;19;58638
03;2021-01-06;21;16;37;21458;18963;29;40421
03;2021-01-06;21;8;29;21276;18326;39;39602
03;2021-01-06;12;11;23;18164;16593;49;34757
03;2021-01-06;12;8;20;13469;13557;59;27026
03;2021-01-06;8;14;22;8776;8670;69;17446
03;2021-01-06;4;3;7;3777;3591;79;7368
03;2021-01-06;0;0;0;1649;1072;89;2721
03;2021-01-06;0;0;0;485;184;90;669
03;2021-01-06;91;77;168;149547;141144;0;290691
04;2021-01-06;2;1;3;60314;61377;09;121691
04;2021-01-06;3;5;8;66065;68387;19;134452
04;2021-01-06;3;6;9;51059;47156;29;98215
04;2021-01-06;6;7;13;58788;45780;39;104568
04;2021-01-06;3;3;6;61408;52207;49;113615
04;2021-01-06;5;7;12;64838;60759;59;125597
04;2021-01-06;2;4;6;47008;42843;69;89851
04;2021-01-06;1;0;1;25509;21184;79;46693
04;2021-01-06;0;0;0;13168;7647;89;20815
04;2021-01-06;0;0;0;3209;1253;90;4462
04;2021-01-06;25;33;58;451366;408593;0;859959
05;2021-01-06;0;0;0;362.366008612902;341.338819562748;09;703.704828175651
05;2021-01-06;0;0;0;353.376145114279;370.349735405642;19;723.725880519921
05;2021-01-06;0;0;0;218.593559489256;256.539602589476;29;475.133162078732
05;2021-01-06;0;0;0;404.225408693299;360.321910454353;39;764.547319147651
05;2021-01-06;0;0;0;520.067953604221;497.108383964256;49;1017.17633756848
05;2021-01-06;0;0;0;468.146063921917;510.087601910415;59;978.233665832332
05;2021-01-06;0;0;0;340.368470050554;334.366842191253;69;674.735312241807
05;2021-01-06;0;0;0;212.598666888387;192.597753227106;79;405.196420115493
05;2021-01-06;0;0;0;148.727797095705;61.8681715431829;89;210.595968638888
05;2021-01-06;0;0;0;32.9601271090696;10.9909785719784;90;43.9511056810479
05;2021-01-06;0;0;0;3061.43020057959;2935.56979942041;0;5997
06;2021-01-06;0;0;0;42583;42380;09;84963
06;2021-01-06;3;0;3;33369;31925;19;65294
06;2021-01-06;8;2;10;21571;15080;29;36651
06;2021-01-06;11;2;13;21550;16147;39;37697
06;2021-01-06;5;4;9;14193;13939;49;28132
06;2021-01-06;5;3;8;7171;7597;59;14768
06;2021-01-06;1;1;2;3629;4117;69;7746
06;2021-01-06;0;1;1;1577;1457;79;3034
06;2021-01-06;0;1;1;531;474;89;1005
06;2021-01-06;0;0;0;88;93;90;181
06;2021-01-06;33;14;47;146262;133209;0;279471
07;2021-01-06;0;0;0;485;549;09;1034
07;2021-01-06;0;0;0;403;432;19;835
07;2021-01-06;1;0;1;764;841;29;1605
07;2021-01-06;3;0;3;824;928;39;1752
07;2021-01-06;0;2;2;788;1020;49;1808
07;2021-01-06;0;0;0;678;870;59;1548
07;2021-01-06;0;0;0;360;382;69;742
07;2021-01-06;0;0;0;231;190;79;421
07;2021-01-06;0;0;0;114;67;89;181
07;2021-01-06;0;0;0;24;11;90;35
07;2021-01-06;4;2;6;4671;5290;0;9961
08;2021-01-06;0;0;0;2715.22592983026;2997.75551488675;09;5712.98144471701
08;2021-01-06;0;0;0;2778.51901080978;3160.9156459093;19;5939.43465671908
08;2021-01-06;0;0;0;2080.8882988764;1718.16634315323;29;3799.05464202964
08;2021-01-06;0;1;1;2701.8582062647;1896.52641413317;39;4598.38462039786
08;2021-01-06;0;1;1;3151.45861023308;2460.52498233809;49;5611.98359257117
08;2021-01-06;1;2;3;2620.29868333099;2422.23566154656;59;5042.53434487755
08;2021-01-06;0;0;0;1621.44173420671;1438.58325779464;69;3060.02499200135
08;2021-01-06;0;0;0;626.575909335673;526.358467843651;79;1152.93437717932
08;2021-01-06;0;0;0;205.018522985054;140.993639349697;89;346.012162334751
08;2021-01-06;0;0;0;50.0325684687745;20.62259870351;90;70.6551671722846
08;2021-01-06;1;4;5;18551.3174743414;16782.6825256586;0;35334
11;2021-01-06;58;55;119;783071;811785;09;1594856
11;2021-01-06;241;189;442;761456;784653;19;1546109
11;2021-01-06;403;348;754;850145;801772;29;1651917
11;2021-01-06;335;298;634;914360;843488;39;1757848
11;2021-01-06;290;222;514;845609;826202;49;1671811
11;2021-01-06;240;206;447;793566;745070;59;1538636
11;2021-01-06;182;158;344;628649;549192;69;1177841
11;2021-01-06;88;97;185;434606;358356;79;792962
11;2021-01-06;91;46;138;261425;162933;89;424358
11;2021-01-06;68;16;84;89253;32619;90;121872
11;2021-01-06;1996;1637;3664;6362140;5916070;0;12278210
24;2021-01-06;9;11;20;139720;144686;09;284406
24;2021-01-06;50;38;88;152979;161185;19;314164
24;2021-01-06;65;66;131;122237;126536;29;248773
24;2021-01-06;45;47;92;150359;142009;39;292368
24;2021-01-06;50;38;88;161829;158758;49;320587
24;2021-01-06;59;45;104;172552;168011;59;340563
24;2021-01-06;48;39;87;172509;158177;69;330686
24;2021-01-06;23;23;46;129428;110593;79;240021
24;2021-01-06;24;20;44;87342;56882;89;144224
24;2021-01-06;17;11;28;31210;12071;90;43281
24;2021-01-06;390;338;728;1320165;1238908;0;2559073
27;2021-01-06;22;27;49;143373;149679;09;293052
27;2021-01-06;85;110;196;160962;173003;19;333965
27;2021-01-06;77;89;166;133746;142254;29;276000
27;2021-01-06;71;73;144;160004;155407;39;315411
27;2021-01-06;82;74;156;172333;169564;49;341897
27;2021-01-06;99;78;177;189979;183788;59;373767
27;2021-01-06;64;59;123;192591;178206;69;370797
27;2021-01-06;42;44;86;146876;127546;79;274422
27;2021-01-06;56;31;87;96896;61575;89;158471
27;2021-01-06;39;13;52;33148;12109;90;45257
27;2021-01-06;637;598;1236;1429908;1353131;0;2783039
28;2021-01-06;12;19;33;180735;186856;09;367591
28;2021-01-06;57;40;97;200125;213621;19;413746
28;2021-01-06;85;84;169;168922;173007;29;341929
28;2021-01-06;68;55;123;196628;188487;39;385115
28;2021-01-06;71;42;113;205396;201699;49;407095
28;2021-01-06;59;51;110;222002;213866;59;435868
28;2021-01-06;47;43;90;224688;203758;69;428446
28;2021-01-06;26;24;50;163192;135543;79;298735
28;2021-01-06;51;24;75;109691;65377;89;175068
28;2021-01-06;26;10;36;37222;12685;90;49907
28;2021-01-06;502;392;896;1708601;1594899;0;3303500
32;2021-01-06;24;31;55;358062;373689;09;731751
32;2021-01-06;136;104;240;387045;406742;19;793787
32;2021-01-06;146;119;265;342304;348587;29;690891
32;2021-01-06;138;108;246;382485;369972;39;752457
32;2021-01-06;122;117;240;382510;376716;49;759226
32;2021-01-06;146;104;250;386937;376527;59;763464
32;2021-01-06;84;76;160;371211;330938;69;702149
32;2021-01-06;65;53;118;250542;201459;79;452001
32;2021-01-06;80;30;110;163399;89786;89;253185
32;2021-01-06;58;14;72;48384;15367;90;63751
32;2021-01-06;999;756;1756;3072879;2889783;0;5962662
44;2021-01-06;42;39;84;291525;306839;09;598364
44;2021-01-06;131;104;239;320255;339504;19;659759
44;2021-01-06;186;146;333;302020;314428;29;616448
44;2021-01-06;144;123;269;342222;333292;39;675514
44;2021-01-06;145;124;271;349727;344491;49;694218
44;2021-01-06;121;134;255;381371;373239;59;754610
44;2021-01-06;113;80;194;367165;335850;69;703015
44;2021-01-06;74;74;149;250387;215436;79;465823
44;2021-01-06;103;54;157;170825;105192;89;276017
44;2021-01-06;53;20;73;51248;16731;90;67979
44;2021-01-06;1112;898;2024;2826745;2685002;0;5511747
52;2021-01-06;15;4;19;213594;223900;09;437494
52;2021-01-06;57;49;107;240818;255197;19;496015
52;2021-01-06;66;42;108;197010;200630;29;397640
52;2021-01-06;46;49;95;231204;224885;39;456089
52;2021-01-06;52;45;97;243874;243418;49;487292
52;2021-01-06;54;39;94;244100;239116;59;483216
52;2021-01-06;35;24;60;241796;221345;69;463141
52;2021-01-06;17;30;48;177805;149903;79;327708
52;2021-01-06;29;10;40;119561;75822;89;195383
52;2021-01-06;21;8;29;42559;15260;90;57819
52;2021-01-06;392;300;697;1952321;1849476;0;3801797
53;2021-01-06;9;6;16;173813;182358;09;356171
53;2021-01-06;35;31;67;202720;214740;19;417460
53;2021-01-06;44;59;103;163116;173196;29;336312
53;2021-01-06;27;22;49;190526;187674;39;378200
53;2021-01-06;23;38;61;212098;212015;49;424113
53;2021-01-06;35;29;64;223699;219176;59;442875
53;2021-01-06;15;16;31;227435;209274;69;436709
53;2021-01-06;26;13;39;169992;140910;79;310902
53;2021-01-06;16;12;28;118117;69883;89;188000
53;2021-01-06;17;1;18;37370;12267;90;49637
53;2021-01-06;247;227;476;1718886;1621493;0;3340379
75;2021-01-06;21;25;47;293104;305291;09;598395
75;2021-01-06;88;90;179;337141;357785;19;694926
75;2021-01-06;108;99;207;295024;300618;29;595642
75;2021-01-06;103;80;183;347871;331233;39;679104
75;2021-01-06;113;77;190;384742;372771;49;757513
75;2021-01-06;96;72;169;413361;390880;59;804241
75;2021-01-06;61;81;144;425623;384060;69;809683
75;2021-01-06;46;33;79;325086;276298;79;601384
75;2021-01-06;53;30;83;213986;139308;89;353294
75;2021-01-06;49;21;70;77600;28200;90;105800
75;2021-01-06;738;609;1352;3113538;2886444;0;5999982
76;2021-01-06;21;22;44;305956;318589;09;624545
76;2021-01-06;119;114;235;338942;356969;19;695911
76;2021-01-06;155;131;286;316210;319570;29;635780
76;2021-01-06;130;107;237;356758;337587;39;694345
76;2021-01-06;152;122;274;376541;363812;49;740353
76;2021-01-06;107;84;191;402608;383750;59;786358
76;2021-01-06;77;72;149;394889;358997;69;753886
76;2021-01-06;72;64;136;308664;263806;79;572470
76;2021-01-06;75;45;120;195838;129272;89;325110
76;2021-01-06;62;18;80;69372;26728;90;96100
76;2021-01-06;971;780;1754;3065778;2859080;0;5924858
84;2021-01-06;50;41;91;459549;481088;09;940637
84;2021-01-06;197;181;378;487711;511905;19;999616
84;2021-01-06;278;231;509;443824;451094;29;894918
84;2021-01-06;205;184;390;512522;493262;39;1005784
84;2021-01-06;200;192;392;520248;515106;49;1035354
84;2021-01-06;203;197;401;529611;514848;59;1044459
84;2021-01-06;115;121;236;486720;439940;69;926660
84;2021-01-06;91;94;185;372151;315211;79;687362
84;2021-01-06;101;51;153;237198;150524;89;387722
84;2021-01-06;100;29;129;81185;28680;90;109865
84;2021-01-06;1540;1322;2865;4130719;3901658;0;8032377
93;2021-01-06;23;30;53;268834;283093;09;551927
93;2021-01-06;169;166;336;280751;296087;19;576838
93;2021-01-06;209;169;378;254404;255552;29;509956
93;2021-01-06;182;149;332;310704;288398;39;599102
93;2021-01-06;204;153;358;325559;305827;49;631386
93;2021-01-06;198;143;342;353104;325389;59;678493
93;2021-01-06;152;121;274;336327;296459;69;632786
93;2021-01-06;125;87;212;279820;229699;79;509519
93;2021-01-06;106;64;170;171274;113716;89;284990
93;2021-01-06;101;23;124;58896;21758;90;80654
93;2021-01-06;1469;1106;2580;2639673;2415978;0;5055651
94;2021-01-06;2;1;3;16311;17433;09;33744
94;2021-01-06;1;2;3;16679;18132;19;34811
94;2021-01-06;12;10;22;16782;16579;29;33361
94;2021-01-06;6;3;9;23044;20580;39;43624
94;2021-01-06;3;7;10;23065;22140;49;45205
94;2021-01-06;1;2;3;24549;23421;59;47970
94;2021-01-06;3;2;5;23212;21883;69;45095
94;2021-01-06;1;2;3;19544;17141;79;36685
94;2021-01-06;1;0;1;11227;8178;89;19405
94;2021-01-06;1;0;1;3332;1447;90;4779
94;2021-01-06;31;29;60;177745;166934;0;344679
01;2021-01-07;0;0;0;19979;20155;09;40134
01;2021-01-07;0;1;1;24994;25489;19;50483
01;2021-01-07;2;1;3;17868;16690;29;34558
01;2021-01-07;1;2;3;22328;14821;39;37149
01;2021-01-07;4;2;6;28652;20276;49;48928
01;2021-01-07;5;1;6;33264;27260;59;60524
01;2021-01-07;0;1;1;27135;23978;69;51113
01;2021-01-07;0;0;0;18401;14661;79;33062
01;2021-01-07;2;1;3;9633;6375;89;16008
01;2021-01-07;0;0;0;3410;1510;90;4920
01;2021-01-07;14;9;23;205664;171215;0;376879
02;2021-01-07;1;0;1;16881;17110;09;33991
02;2021-01-07;1;0;1;21410;21604;19;43014
02;2021-01-07;2;0;2;16017;15479;29;31496
02;2021-01-07;3;1;4;19825;14455;39;34280
02;2021-01-07;2;3;5;24719;18248;49;42967
02;2021-01-07;2;1;3;34361;28310;59;62671
02;2021-01-07;1;1;2;28061;24495;69;52556
02;2021-01-07;2;1;3;18231;15278;79;33509
02;2021-01-07;0;0;0;11090;7677;89;18767
02;2021-01-07;0;0;0;3992;1506;90;5498
02;2021-01-07;14;7;21;194587;164162;0;358749
03;2021-01-07;0;3;3;31123;30920;09;62043
03;2021-01-07;9;9;18;29370;29268;19;58638
03;2021-01-07;25;10;35;21458;18963;29;40421
03;2021-01-07;24;13;37;21276;18326;39;39602
03;2021-01-07;15;14;29;18164;16593;49;34757
03;2021-01-07;9;8;17;13469;13557;59;27026
03;2021-01-07;9;8;17;8776;8670;69;17446
03;2021-01-07;2;0;2;3777;3591;79;7368
03;2021-01-07;1;0;1;1649;1072;89;2721
03;2021-01-07;0;0;0;485;184;90;669
03;2021-01-07;94;65;159;149547;141144;0;290691
04;2021-01-07;0;1;1;60314;61377;09;121691
04;2021-01-07;4;6;10;66065;68387;19;134452
04;2021-01-07;3;3;6;51059;47156;29;98215
04;2021-01-07;7;5;12;58788;45780;39;104568
04;2021-01-07;1;5;6;61408;52207;49;113615
04;2021-01-07;7;5;12;64838;60759;59;125597
04;2021-01-07;0;2;2;47008;42843;69;89851
04;2021-01-07;0;0;0;25509;21184;79;46693
04;2021-01-07;0;0;0;13168;7647;89;20815
04;2021-01-07;0;0;0;3209;1253;90;4462
04;2021-01-07;22;27;49;451366;408593;0;859959
05;2021-01-07;0;0;0;362.366008612902;341.338819562748;09;703.704828175651
05;2021-01-07;0;0;0;353.376145114279;370.349735405642;19;723.725880519921
05;2021-01-07;0;0;0;218.593559489256;256.539602589476;29;475.133162078732
05;2021-01-07;0;0;0;404.225408693299;360.321910454353;39;764.547319147651
05;2021-01-07;0;0;0;520.067953604221;497.108383964256;49;1017.17633756848
05;2021-01-07;0;0;0;468.146063921917;510.087601910415;59;978.233665832332
05;2021-01-07;0;0;0;340.368470050554;334.366842191253;69;674.735312241807
05;2021-01-07;0;0;0;212.598666888387;192.597753227106;79;405.196420115493
05;2021-01-07;0;0;0;148.727797095705;61.8681715431829;89;210.595968638888
05;2021-01-07;0;0;0;32.9601271090696;10.9909785719784;90;43.9511056810479
05;2021-01-07;0;0;0;3061.43020057959;2935.56979942041;0;5997
06;2021-01-07;0;0;0;42583;42380;09;84963
06;2021-01-07;4;2;6;33369;31925;19;65294
06;2021-01-07;5;4;9;21571;15080;29;36651
06;2021-01-07;8;4;12;21550;16147;39;37697
06;2021-01-07;7;3;10;14193;13939;49;28132
06;2021-01-07;2;4;6;7171;7597;59;14768
06;2021-01-07;3;0;3;3629;4117;69;7746
06;2021-01-07;1;0;1;1577;1457;79;3034
06;2021-01-07;0;0;0;531;474;89;1005
06;2021-01-07;0;0;0;88;93;90;181
06;2021-01-07;30;17;47;146262;133209;0;279471
07;2021-01-07;0;0;0;485;549;09;1034
07;2021-01-07;0;1;1;403;432;19;835
07;2021-01-07;3;2;5;764;841;29;1605
07;2021-01-07;3;4;7;824;928;39;1752
07;2021-01-07;2;2;4;788;1020;49;1808
07;2021-01-07;2;1;3;678;870;59;1548
07;2021-01-07;0;0;0;360;382;69;742
07;2021-01-07;0;0;0;231;190;79;421
07;2021-01-07;0;0;0;114;67;89;181
07;2021-01-07;0;0;0;24;11;90;35
07;2021-01-07;10;10;20;4671;5290;0;9961
08;2021-01-07;0;0;0;2715.22592983026;2997.75551488675;09;5712.98144471701
08;2021-01-07;0;1;1;2778.51901080978;3160.9156459093;19;5939.43465671908
08;2021-01-07;1;0;1;2080.8882988764;1718.16634315323;29;3799.05464202964
08;2021-01-07;0;0;0;2701.8582062647;1896.52641413317;39;4598.38462039786
08;2021-01-07;0;0;0;3151.45861023308;2460.52498233809;49;5611.98359257117
08;2021-01-07;0;1;1;2620.29868333099;2422.23566154656;59;5042.53434487755
08;2021-01-07;0;1;1;1621.44173420671;1438.58325779464;69;3060.02499200135
08;2021-01-07;0;0;0;626.575909335673;526.358467843651;79;1152.93437717932
08;2021-01-07;0;0;0;205.018522985054;140.993639349697;89;346.012162334751
08;2021-01-07;0;0;0;50.0325684687745;20.62259870351;90;70.6551671722846
08;2021-01-07;1;3;4;18551.3174743414;16782.6825256586;0;35334
11;2021-01-07;43;57;104;783071;811785;09;1594856
11;2021-01-07;215;211;435;761456;784653;19;1546109
11;2021-01-07;408;360;774;850145;801772;29;1651917
11;2021-01-07;357;312;670;914360;843488;39;1757848
11;2021-01-07;270;225;499;845609;826202;49;1671811
11;2021-01-07;250;233;485;793566;745070;59;1538636
11;2021-01-07;151;147;300;628649;549192;69;1177841
11;2021-01-07;89;74;163;434606;358356;79;792962
11;2021-01-07;70;48;118;261425;162933;89;424358
11;2021-01-07;48;14;62;89253;32619;90;121872
11;2021-01-07;1901;1681;3611;6362140;5916070;0;12278210
24;2021-01-07;8;6;14;139720;144686;09;284406
24;2021-01-07;51;41;92;152979;161185;19;314164
24;2021-01-07;60;55;115;122237;126536;29;248773
24;2021-01-07;54;47;101;150359;142009;39;292368
24;2021-01-07;41;37;78;161829;158758;49;320587
24;2021-01-07;60;57;117;172552;168011;59;340563
24;2021-01-07;37;53;90;172509;158177;69;330686
24;2021-01-07;40;26;66;129428;110593;79;240021
24;2021-01-07;29;11;40;87342;56882;89;144224
24;2021-01-07;24;17;41;31210;12071;90;43281
24;2021-01-07;404;350;754;1320165;1238908;0;2559073
27;2021-01-07;21;23;44;143373;149679;09;293052
27;2021-01-07;89;85;175;160962;173003;19;333965
27;2021-01-07;83;73;156;133746;142254;29;276000
27;2021-01-07;91;70;161;160004;155407;39;315411
27;2021-01-07;82;78;160;172333;169564;49;341897
27;2021-01-07;74;68;142;189979;183788;59;373767
27;2021-01-07;57;56;113;192591;178206;69;370797
27;2021-01-07;48;57;105;146876;127546;79;274422
27;2021-01-07;49;30;79;96896;61575;89;158471
27;2021-01-07;38;15;53;33148;12109;90;45257
27;2021-01-07;633;555;1189;1429908;1353131;0;2783039
28;2021-01-07;18;21;40;180735;186856;09;367591
28;2021-01-07;55;54;110;200125;213621;19;413746
28;2021-01-07;82;63;145;168922;173007;29;341929
28;2021-01-07;58;56;114;196628;188487;39;385115
28;2021-01-07;55;48;103;205396;201699;49;407095
28;2021-01-07;65;41;106;222002;213866;59;435868
28;2021-01-07;45;53;98;224688;203758;69;428446
28;2021-01-07;39;34;73;163192;135543;79;298735
28;2021-01-07;31;30;61;109691;65377;89;175068
28;2021-01-07;16;2;18;37222;12685;90;49907
28;2021-01-07;464;402;868;1708601;1594899;0;3303500
32;2021-01-07;24;33;57;358062;373689;09;731751
32;2021-01-07;118;96;215;387045;406742;19;793787
32;2021-01-07;153;128;282;342304;348587;29;690891
32;2021-01-07;129;126;255;382485;369972;39;752457
32;2021-01-07;135;97;232;382510;376716;49;759226
32;2021-01-07;109;94;203;386937;376527;59;763464
32;2021-01-07;98;87;186;371211;330938;69;702149
32;2021-01-07;53;48;101;250542;201459;79;452001
32;2021-01-07;82;36;118;163399;89786;89;253185
32;2021-01-07;47;16;63;48384;15367;90;63751
32;2021-01-07;948;761;1712;3072879;2889783;0;5962662
44;2021-01-07;29;33;62;291525;306839;09;598364
44;2021-01-07;102;100;203;320255;339504;19;659759
44;2021-01-07;174;151;325;302020;314428;29;616448
44;2021-01-07;141;109;252;342222;333292;39;675514
44;2021-01-07;131;117;249;349727;344491;49;694218
44;2021-01-07;127;101;228;381371;373239;59;754610
44;2021-01-07;90;106;197;367165;335850;69;703015
44;2021-01-07;68;59;132;250387;215436;79;465823
44;2021-01-07;93;50;143;170825;105192;89;276017
44;2021-01-07;52;23;75;51248;16731;90;67979
44;2021-01-07;1007;849;1866;2826745;2685002;0;5511747
52;2021-01-07;18;10;28;213594;223900;09;437494
52;2021-01-07;44;49;95;240818;255197;19;496015
52;2021-01-07;64;64;128;197010;200630;29;397640
52;2021-01-07;52;43;95;231204;224885;39;456089
52;2021-01-07;45;41;86;243874;243418;49;487292
52;2021-01-07;56;34;90;244100;239116;59;483216
52;2021-01-07;37;33;70;241796;221345;69;463141
52;2021-01-07;26;19;45;177805;149903;79;327708
52;2021-01-07;40;23;63;119561;75822;89;195383
52;2021-01-07;44;9;53;42559;15260;90;57819
52;2021-01-07;426;325;753;1952321;1849476;0;3801797
53;2021-01-07;10;11;21;173813;182358;09;356171
53;2021-01-07;25;21;47;202720;214740;19;417460
53;2021-01-07;47;43;92;163116;173196;29;336312
53;2021-01-07;35;21;56;190526;187674;39;378200
53;2021-01-07;33;20;53;212098;212015;49;424113
53;2021-01-07;29;31;60;223699;219176;59;442875
53;2021-01-07;19;23;42;227435;209274;69;436709
53;2021-01-07;15;9;24;169992;140910;79;310902
53;2021-01-07;12;10;22;118117;69883;89;188000
53;2021-01-07;11;2;13;37370;12267;90;49637
53;2021-01-07;236;191;430;1718886;1621493;0;3340379
75;2021-01-07;18;28;47;293104;305291;09;598395
75;2021-01-07;81;75;156;337141;357785;19;694926
75;2021-01-07;131;86;218;295024;300618;29;595642
75;2021-01-07;98;91;189;347871;331233;39;679104
75;2021-01-07;125;106;231;384742;372771;49;757513
75;2021-01-07;82;93;175;413361;390880;59;804241
75;2021-01-07;55;65;121;425623;384060;69;809683
75;2021-01-07;36;42;78;325086;276298;79;601384
75;2021-01-07;48;28;76;213986;139308;89;353294
75;2021-01-07;33;20;53;77600;28200;90;105800
75;2021-01-07;707;634;1344;3113538;2886444;0;5999982
76;2021-01-07;18;24;42;305956;318589;09;624545
76;2021-01-07;101;73;175;338942;356969;19;695911
76;2021-01-07;126;124;251;316210;319570;29;635780
76;2021-01-07;118;87;205;356758;337587;39;694345
76;2021-01-07;106;97;203;376541;363812;49;740353
76;2021-01-07;105;100;205;402608;383750;59;786358
76;2021-01-07;86;79;166;394889;358997;69;753886
76;2021-01-07;63;44;107;308664;263806;79;572470
76;2021-01-07;52;28;80;195838;129272;89;325110
76;2021-01-07;34;13;47;69372;26728;90;96100
76;2021-01-07;810;670;1483;3065778;2859080;0;5924858
84;2021-01-07;49;38;88;459549;481088;09;940637
84;2021-01-07;203;176;379;487711;511905;19;999616
84;2021-01-07;248;244;492;443824;451094;29;894918
84;2021-01-07;212;157;369;512522;493262;39;1005784
84;2021-01-07;193;165;358;520248;515106;49;1035354
84;2021-01-07;230;185;415;529611;514848;59;1044459
84;2021-01-07;145;133;278;486720;439940;69;926660
84;2021-01-07;101;100;201;372151;315211;79;687362
84;2021-01-07;109;62;171;237198;150524;89;387722
84;2021-01-07;71;27;98;81185;28680;90;109865
84;2021-01-07;1561;1287;2850;4130719;3901658;0;8032377
93;2021-01-07;26;47;73;268834;283093;09;551927
93;2021-01-07;133;135;270;280751;296087;19;576838
93;2021-01-07;212;173;385;254404;255552;29;509956
93;2021-01-07;204;170;376;310704;288398;39;599102
93;2021-01-07;193;152;346;325559;305827;49;631386
93;2021-01-07;189;147;336;353104;325389;59;678493
93;2021-01-07;143;129;274;336327;296459;69;632786
93;2021-01-07;105;88;193;279820;229699;79;509519
93;2021-01-07;104;54;158;171274;113716;89;284990
93;2021-01-07;82;22;104;58896;21758;90;80654
93;2021-01-07;1391;1117;2515;2639673;2415978;0;5055651
94;2021-01-07;0;0;0;16311;17433;09;33744
94;2021-01-07;2;4;6;16679;18132;19;34811
94;2021-01-07;2;2;4;16782;16579;29;33361
94;2021-01-07;3;1;4;23044;20580;39;43624
94;2021-01-07;4;2;6;23065;22140;49;45205
94;2021-01-07;1;1;2;24549;23421;59;47970
94;2021-01-07;2;2;4;23212;21883;69;45095
94;2021-01-07;2;0;2;19544;17141;79;36685
94;2021-01-07;2;0;2;11227;8178;89;19405
94;2021-01-07;0;0;0;3332;1447;90;4779
94;2021-01-07;18;12;30;177745;166934;0;344679
01;2021-01-08;0;0;0;19979;20155;09;40134
01;2021-01-08;0;1;1;24994;25489;19;50483
01;2021-01-08;2;0;2;17868;16690;29;34558
01;2021-01-08;1;2;3;22328;14821;39;37149
01;2021-01-08;5;1;6;28652;20276;49;48928
01;2021-01-08;1;1;2;33264;27260;59;60524
01;2021-01-08;3;1;4;27135;23978;69;51113
01;2021-01-08;2;1;3;18401;14661;79;33062
01;2021-01-08;0;0;0;9633;6375;89;16008
01;2021-01-08;0;0;0;3410;1510;90;4920
01;2021-01-08;14;7;21;205664;171215;0;376879
02;2021-01-08;0;0;0;16881;17110;09;33991
02;2021-01-08;1;0;1;21410;21604;19;43014
02;2021-01-08;1;0;1;16017;15479;29;31496
02;2021-01-08;0;1;1;19825;14455;39;34280
02;2021-01-08;1;1;2;24719;18248;49;42967
02;2021-01-08;0;1;1;34361;28310;59;62671
02;2021-01-08;1;0;1;28061;24495;69;52556
02;2021-01-08;1;1;2;18231;15278;79;33509
02;2021-01-08;0;0;0;11090;7677;89;18767
02;2021-01-08;0;0;0;3992;1506;90;5498
02;2021-01-08;5;4;9;194587;164162;0;358749
03;2021-01-08;1;2;3;31123;30920;09;62043
03;2021-01-08;14;11;26;29370;29268;19;58638
03;2021-01-08;19;11;30;21458;18963;29;40421
03;2021-01-08;19;11;30;21276;18326;39;39602
03;2021-01-08;13;10;23;18164;16593;49;34757
03;2021-01-08;9;7;16;13469;13557;59;27026
03;2021-01-08;1;7;8;8776;8670;69;17446
03;2021-01-08;2;0;2;3777;3591;79;7368
03;2021-01-08;0;0;0;1649;1072;89;2721
03;2021-01-08;0;1;1;485;184;90;669
03;2021-01-08;78;60;139;149547;141144;0;290691
04;2021-01-08;2;1;3;60314;61377;09;121691
04;2021-01-08;3;0;3;66065;68387;19;134452
04;2021-01-08;5;5;10;51059;47156;29;98215
04;2021-01-08;3;3;6;58788;45780;39;104568
04;2021-01-08;2;4;6;61408;52207;49;113615
04;2021-01-08;10;5;15;64838;60759;59;125597
04;2021-01-08;1;2;3;47008;42843;69;89851
04;2021-01-08;1;2;3;25509;21184;79;46693
04;2021-01-08;1;0;1;13168;7647;89;20815
04;2021-01-08;0;0;0;3209;1253;90;4462
04;2021-01-08;28;22;50;451366;408593;0;859959
05;2021-01-08;0;0;0;362.366008612902;341.338819562748;09;703.704828175651
05;2021-01-08;0;0;0;353.376145114279;370.349735405642;19;723.725880519921
05;2021-01-08;0;0;0;218.593559489256;256.539602589476;29;475.133162078732
05;2021-01-08;0;0;0;404.225408693299;360.321910454353;39;764.547319147651
05;2021-01-08;0;0;0;520.067953604221;497.108383964256;49;1017.17633756848
05;2021-01-08;0;0;0;468.146063921917;510.087601910415;59;978.233665832332
05;2021-01-08;0;0;0;340.368470050554;334.366842191253;69;674.735312241807
05;2021-01-08;0;0;0;212.598666888387;192.597753227106;79;405.196420115493
05;2021-01-08;0;0;0;148.727797095705;61.8681715431829;89;210.595968638888
05;2021-01-08;0;0;0;32.9601271090696;10.9909785719784;90;43.9511056810479
05;2021-01-08;0;0;0;3061.43020057959;2935.56979942041;0;5997
06;2021-01-08;0;0;0;42583;42380;09;84963
06;2021-01-08;4;0;4;33369;31925;19;65294
06;2021-01-08;3;1;4;21571;15080;29;36651
06;2021-01-08;7;4;11;21550;16147;39;37697
06;2021-01-08;6;4;10;14193;13939;49;28132
06;2021-01-08;2;2;4;7171;7597;59;14768
06;2021-01-08;1;0;1;3629;4117;69;7746
06;2021-01-08;1;0;1;1577;1457;79;3034
06;2021-01-08;0;0;0;531;474;89;1005
06;2021-01-08;0;0;0;88;93;90;181
06;2021-01-08;24;11;35;146262;133209;0;279471
07;2021-01-08;0;0;0;485;549;09;1034
07;2021-01-08;0;0;0;403;432;19;835
07;2021-01-08;1;0;1;764;841;29;1605
07;2021-01-08;0;0;0;824;928;39;1752
07;2021-01-08;0;1;1;788;1020;49;1808
07;2021-01-08;0;1;1;678;870;59;1548
07;2021-01-08;0;0;0;360;382;69;742
07;2021-01-08;0;0;0;231;190;79;421
07;2021-01-08;0;0;0;114;67;89;181
07;2021-01-08;0;0;0;24;11;90;35
07;2021-01-08;1;2;3;4671;5290;0;9961
08;2021-01-08;0;0;0;2715.22592983026;2997.75551488675;09;5712.98144471701
08;2021-01-08;0;0;0;2778.51901080978;3160.9156459093;19;5939.43465671908
08;2021-01-08;0;1;1;2080.8882988764;1718.16634315323;29;3799.05464202964
08;2021-01-08;0;3;3;2701.8582062647;1896.52641413317;39;4598.38462039786
08;2021-01-08;3;0;3;3151.45861023308;2460.52498233809;49;5611.98359257117
08;2021-01-08;2;1;3;2620.29868333099;2422.23566154656;59;5042.53434487755
08;2021-01-08;0;0;0;1621.44173420671;1438.58325779464;69;3060.02499200135
08;2021-01-08;0;1;1;626.575909335673;526.358467843651;79;1152.93437717932
08;2021-01-08;0;0;0;205.018522985054;140.993639349697;89;346.012162334751
08;2021-01-08;0;0;0;50.0325684687745;20.62259870351;90;70.6551671722846
08;2021-01-08;5;6;11;18551.3174743414;16782.6825256586;0;35334
11;2021-01-08;46;63;114;783071;811785;09;1594856
11;2021-01-08;225;232;467;761456;784653;19;1546109
11;2021-01-08;425;345;772;850145;801772;29;1651917
11;2021-01-08;362;338;704;914360;843488;39;1757848
11;2021-01-08;291;277;568;845609;826202;49;1671811
11;2021-01-08;223;220;443;793566;745070;59;1538636
11;2021-01-08;177;160;339;628649;549192;69;1177841
11;2021-01-08;76;75;151;434606;358356;79;792962
11;2021-01-08;75;48;123;261425;162933;89;424358
11;2021-01-08;64;18;82;89253;32619;90;121872
11;2021-01-08;1965;1776;3764;6362140;5916070;0;12278210
24;2021-01-08;13;14;27;139720;144686;09;284406
24;2021-01-08;54;45;100;152979;161185;19;314164
24;2021-01-08;53;43;96;122237;126536;29;248773
24;2021-01-08;72;40;112;150359;142009;39;292368
24;2021-01-08;57;48;105;161829;158758;49;320587
24;2021-01-08;60;43;103;172552;168011;59;340563
24;2021-01-08;41;54;95;172509;158177;69;330686
24;2021-01-08;13;19;32;129428;110593;79;240021
24;2021-01-08;33;22;55;87342;56882;89;144224
24;2021-01-08;23;5;28;31210;12071;90;43281
24;2021-01-08;419;333;753;1320165;1238908;0;2559073
27;2021-01-08;17;24;41;143373;149679;09;293052
27;2021-01-08;76;79;155;160962;173003;19;333965
27;2021-01-08;82;85;167;133746;142254;29;276000
27;2021-01-08;92;61;153;160004;155407;39;315411
27;2021-01-08;74;90;164;172333;169564;49;341897
27;2021-01-08;77;64;141;189979;183788;59;373767
27;2021-01-08;66;54;120;192591;178206;69;370797
27;2021-01-08;61;51;112;146876;127546;79;274422
27;2021-01-08;49;35;84;96896;61575;89;158471
27;2021-01-08;47;11;58;33148;12109;90;45257
27;2021-01-08;641;554;1195;1429908;1353131;0;2783039
28;2021-01-08;15;17;34;180735;186856;09;367591
28;2021-01-08;60;53;113;200125;213621;19;413746
28;2021-01-08;62;78;140;168922;173007;29;341929
28;2021-01-08;60;46;106;196628;188487;39;385115
28;2021-01-08;70;53;123;205396;201699;49;407095
28;2021-01-08;85;61;146;222002;213866;59;435868
28;2021-01-08;44;57;101;224688;203758;69;428446
28;2021-01-08;33;33;66;163192;135543;79;298735
28;2021-01-08;27;21;48;109691;65377;89;175068
28;2021-01-08;12;10;22;37222;12685;90;49907
28;2021-01-08;468;429;899;1708601;1594899;0;3303500
32;2021-01-08;30;41;71;358062;373689;09;731751
32;2021-01-08;113;114;228;387045;406742;19;793787
32;2021-01-08;155;118;274;342304;348587;29;690891
32;2021-01-08;148;133;281;382485;369972;39;752457
32;2021-01-08;119;109;228;382510;376716;49;759226
32;2021-01-08;115;115;230;386937;376527;59;763464
32;2021-01-08;96;88;184;371211;330938;69;702149
32;2021-01-08;58;58;116;250542;201459;79;452001
32;2021-01-08;67;21;88;163399;89786;89;253185
32;2021-01-08;36;18;54;48384;15367;90;63751
32;2021-01-08;937;815;1754;3072879;2889783;0;5962662
44;2021-01-08;42;41;83;291525;306839;09;598364
44;2021-01-08;127;117;245;320255;339504;19;659759
44;2021-01-08;204;151;355;302020;314428;29;616448
44;2021-01-08;175;151;327;342222;333292;39;675514
44;2021-01-08;124;118;243;349727;344491;49;694218
44;2021-01-08;168;91;260;381371;373239;59;754610
44;2021-01-08;131;109;241;367165;335850;69;703015
44;2021-01-08;76;91;168;250387;215436;79;465823
44;2021-01-08;72;51;123;170825;105192;89;276017
44;2021-01-08;35;7;42;51248;16731;90;67979
44;2021-01-08;1154;927;2087;2826745;2685002;0;5511747
52;2021-01-08;8;14;22;213594;223900;09;437494
52;2021-01-08;51;57;109;240818;255197;19;496015
52;2021-01-08;56;58;114;197010;200630;29;397640
52;2021-01-08;59;36;98;231204;224885;39;456089
52;2021-01-08;53;34;87;243874;243418;49;487292
52;2021-01-08;56;42;99;244100;239116;59;483216
52;2021-01-08;25;34;60;241796;221345;69;463141
52;2021-01-08;35;23;59;177805;149903;79;327708
52;2021-01-08;39;25;64;119561;75822;89;195383
52;2021-01-08;19;12;31;42559;15260;90;57819
52;2021-01-08;401;335;743;1952321;1849476;0;3801797
53;2021-01-08;3;9;12;173813;182358;09;356171
53;2021-01-08;30;33;65;202720;214740;19;417460
53;2021-01-08;52;51;103;163116;173196;29;336312
53;2021-01-08;29;22;51;190526;187674;39;378200
53;2021-01-08;40;28;68;212098;212015;49;424113
53;2021-01-08;33;21;54;223699;219176;59;442875
53;2021-01-08;26;22;48;227435;209274;69;436709
53;2021-01-08;18;12;30;169992;140910;79;310902
53;2021-01-08;14;6;20;118117;69883;89;188000
53;2021-01-08;9;1;10;37370;12267;90;49637
53;2021-01-08;254;205;461;1718886;1621493;0;3340379
75;2021-01-08;22;29;54;293104;305291;09;598395
75;2021-01-08;104;83;191;337141;357785;19;694926
75;2021-01-08;119;87;206;295024;300618;29;595642
75;2021-01-08;105;80;186;347871;331233;39;679104
75;2021-01-08;114;104;219;384742;372771;49;757513
75;2021-01-08;87;71;158;413361;390880;59;804241
75;2021-01-08;62;72;134;425623;384060;69;809683
75;2021-01-08;45;41;86;325086;276298;79;601384
75;2021-01-08;43;23;66;213986;139308;89;353294
75;2021-01-08;31;13;44;77600;28200;90;105800
75;2021-01-08;732;603;1344;3113538;2886444;0;5999982
76;2021-01-08;21;31;55;305956;318589;09;624545
76;2021-01-08;109;112;227;338942;356969;19;695911
76;2021-01-08;152;120;273;316210;319570;29;635780
76;2021-01-08;133;101;234;356758;337587;39;694345
76;2021-01-08;118;116;235;376541;363812;49;740353
76;2021-01-08;111;100;211;402608;383750;59;786358
76;2021-01-08;95;96;191;394889;358997;69;753886
76;2021-01-08;64;59;123;308664;263806;79;572470
76;2021-01-08;39;29;68;195838;129272;89;325110
76;2021-01-08;41;11;52;69372;26728;90;96100
76;2021-01-08;883;777;1671;3065778;2859080;0;5924858
84;2021-01-08;40;45;88;459549;481088;09;940637
84;2021-01-08;184;192;378;487711;511905;19;999616
84;2021-01-08;215;218;434;443824;451094;29;894918
84;2021-01-08;213;177;390;512522;493262;39;1005784
84;2021-01-08;204;181;385;520248;515106;49;1035354
84;2021-01-08;216;170;386;529611;514848;59;1044459
84;2021-01-08;164;165;329;486720;439940;69;926660
84;2021-01-08;111;100;211;372151;315211;79;687362
84;2021-01-08;93;58;151;237198;150524;89;387722
84;2021-01-08;66;20;86;81185;28680;90;109865
84;2021-01-08;1506;1326;2839;4130719;3901658;0;8032377
93;2021-01-08;37;33;71;268834;283093;09;551927
93;2021-01-08;165;154;319;280751;296087;19;576838
93;2021-01-08;207;190;399;254404;255552;29;509956
93;2021-01-08;221;198;422;310704;288398;39;599102
93;2021-01-08;209;163;373;325559;305827;49;631386
93;2021-01-08;238;161;400;353104;325389;59;678493
93;2021-01-08;152;148;300;336327;296459;69;632786
93;2021-01-08;96;78;174;279820;229699;79;509519
93;2021-01-08;94;46;140;171274;113716;89;284990
93;2021-01-08;51;18;69;58896;21758;90;80654
93;2021-01-08;1471;1189;2668;2639673;2415978;0;5055651
94;2021-01-08;1;0;1;16311;17433;09;33744
94;2021-01-08;3;0;3;16679;18132;19;34811
94;2021-01-08;4;5;9;16782;16579;29;33361
94;2021-01-08;6;1;7;23044;20580;39;43624
94;2021-01-08;2;1;3;23065;22140;49;45205
94;2021-01-08;2;5;7;24549;23421;59;47970
94;2021-01-08;2;2;4;23212;21883;69;45095
94;2021-01-08;3;5;8;19544;17141;79;36685
94;2021-01-08;1;0;1;11227;8178;89;19405
94;2021-01-08;0;0;0;3332;1447;90;4779
94;2021-01-08;24;19;43;177745;166934;0;344679
01;2021-01-09;0;0;0;19979;20155;09;40134
01;2021-01-09;0;0;0;24994;25489;19;50483
01;2021-01-09;1;0;1;17868;16690;29;34558
01;2021-01-09;2;1;3;22328;14821;39;37149
01;2021-01-09;0;1;1;28652;20276;49;48928
01;2021-01-09;2;1;3;33264;27260;59;60524
01;2021-01-09;2;2;4;27135;23978;69;51113
01;2021-01-09;0;0;0;18401;14661;79;33062
01;2021-01-09;0;0;0;9633;6375;89;16008
01;2021-01-09;0;0;0;3410;1510;90;4920
01;2021-01-09;7;5;12;205664;171215;0;376879
02;2021-01-09;0;0;0;16881;17110;09;33991
02;2021-01-09;0;0;0;21410;21604;19;43014
02;2021-01-09;2;1;3;16017;15479;29;31496
02;2021-01-09;0;0;0;19825;14455;39;34280
02;2021-01-09;0;2;2;24719;18248;49;42967
02;2021-01-09;0;1;1;34361;28310;59;62671
02;2021-01-09;0;0;0;28061;24495;69;52556
02;2021-01-09;0;0;0;18231;15278;79;33509
02;2021-01-09;0;0;0;11090;7677;89;18767
02;2021-01-09;0;0;0;3992;1506;90;5498
02;2021-01-09;2;4;6;194587;164162;0;358749
03;2021-01-09;1;0;1;31123;30920;09;62043
03;2021-01-09;9;7;16;29370;29268;19;58638
03;2021-01-09;10;5;15;21458;18963;29;40421
03;2021-01-09;8;6;14;21276;18326;39;39602
03;2021-01-09;8;5;13;18164;16593;49;34757
03;2021-01-09;2;2;4;13469;13557;59;27026
03;2021-01-09;5;4;9;8776;8670;69;17446
03;2021-01-09;0;1;1;3777;3591;79;7368
03;2021-01-09;0;0;0;1649;1072;89;2721
03;2021-01-09;0;0;0;485;184;90;669
03;2021-01-09;43;30;73;149547;141144;0;290691
04;2021-01-09;1;0;1;60314;61377;09;121691
04;2021-01-09;1;2;3;66065;68387;19;134452
04;2021-01-09;1;1;2;51059;47156;29;98215
04;2021-01-09;2;3;5;58788;45780;39;104568
04;2021-01-09;3;5;8;61408;52207;49;113615
04;2021-01-09;2;2;4;64838;60759;59;125597
04;2021-01-09;2;3;5;47008;42843;69;89851
04;2021-01-09;1;0;1;25509;21184;79;46693
04;2021-01-09;0;1;1;13168;7647;89;20815
04;2021-01-09;0;0;0;3209;1253;90;4462
04;2021-01-09;13;17;30;451366;408593;0;859959
05;2021-01-09;0;0;0;362.366008612902;341.338819562748;09;703.704828175651
05;2021-01-09;0;0;0;353.376145114279;370.349735405642;19;723.725880519921
05;2021-01-09;0;0;0;218.593559489256;256.539602589476;29;475.133162078732
05;2021-01-09;0;0;0;404.225408693299;360.321910454353;39;764.547319147651
05;2021-01-09;0;0;0;520.067953604221;497.108383964256;49;1017.17633756848
05;2021-01-09;0;0;0;468.146063921917;510.087601910415;59;978.233665832332
05;2021-01-09;0;0;0;340.368470050554;334.366842191253;69;674.735312241807
05;2021-01-09;0;0;0;212.598666888387;192.597753227106;79;405.196420115493
05;2021-01-09;0;0;0;148.727797095705;61.8681715431829;89;210.595968638888
05;2021-01-09;0;0;0;32.9601271090696;10.9909785719784;90;43.9511056810479
05;2021-01-09;0;0;0;3061.43020057959;2935.56979942041;0;5997
06;2021-01-09;1;0;1;42583;42380;09;84963
06;2021-01-09;1;2;3;33369;31925;19;65294
06;2021-01-09;4;0;4;21571;15080;29;36651
06;2021-01-09;2;2;4;21550;16147;39;37697
06;2021-01-09;0;1;1;14193;13939;49;28132
06;2021-01-09;3;1;4;7171;7597;59;14768
06;2021-01-09;1;2;3;3629;4117;69;7746
06;2021-01-09;0;0;0;1577;1457;79;3034
06;2021-01-09;0;0;0;531;474;89;1005
06;2021-01-09;0;0;0;88;93;90;181
06;2021-01-09;12;8;20;146262;133209;0;279471
07;2021-01-09;0;0;0;485;549;09;1034
07;2021-01-09;0;0;0;403;432;19;835
07;2021-01-09;1;0;1;764;841;29;1605
07;2021-01-09;0;0;0;824;928;39;1752
07;2021-01-09;1;0;1;788;1020;49;1808
07;2021-01-09;0;1;1;678;870;59;1548
07;2021-01-09;0;0;0;360;382;69;742
07;2021-01-09;0;0;0;231;190;79;421
07;2021-01-09;0;0;0;114;67;89;181
07;2021-01-09;0;0;0;24;11;90;35
07;2021-01-09;2;1;3;4671;5290;0;9961
08;2021-01-09;0;0;0;2715.22592983026;2997.75551488675;09;5712.98144471701
08;2021-01-09;2;0;2;2778.51901080978;3160.9156459093;19;5939.43465671908
08;2021-01-09;1;0;1;2080.8882988764;1718.16634315323;29;3799.05464202964
08;2021-01-09;0;2;2;2701.8582062647;1896.52641413317;39;4598.38462039786
08;2021-01-09;1;0;1;3151.45861023308;2460.52498233809;49;5611.98359257117
08;2021-01-09;1;0;1;2620.29868333099;2422.23566154656;59;5042.53434487755
08;2021-01-09;0;0;0;1621.44173420671;1438.58325779464;69;3060.02499200135
08;2021-01-09;0;0;0;626.575909335673;526.358467843651;79;1152.93437717932
08;2021-01-09;0;0;0;205.018522985054;140.993639349697;89;346.012162334751
08;2021-01-09;0;0;0;50.0325684687745;20.62259870351;90;70.6551671722846
08;2021-01-09;5;2;7;18551.3174743414;16782.6825256586;0;35334
11;2021-01-09;38;36;79;783071;811785;09;1594856
11;2021-01-09;135;152;297;761456;784653;19;1546109
11;2021-01-09;273;231;505;850145;801772;29;1651917
11;2021-01-09;207;196;404;914360;843488;39;1757848
11;2021-01-09;155;156;312;845609;826202;49;1671811
11;2021-01-09;180;146;329;793566;745070;59;1538636
11;2021-01-09;107;84;193;628649;549192;69;1177841
11;2021-01-09;49;44;93;434606;358356;79;792962
11;2021-01-09;45;35;81;261425;162933;89;424358
11;2021-01-09;20;9;29;89253;32619;90;121872
11;2021-01-09;1209;1089;2323;6362140;5916070;0;12278210
24;2021-01-09;8;5;13;139720;144686;09;284406
24;2021-01-09;17;30;47;152979;161185;19;314164
24;2021-01-09;40;26;66;122237;126536;29;248773
24;2021-01-09;40;21;61;150359;142009;39;292368
24;2021-01-09;39;20;59;161829;158758;49;320587
24;2021-01-09;30;30;60;172552;168011;59;340563
24;2021-01-09;19;22;41;172509;158177;69;330686
24;2021-01-09;10;10;20;129428;110593;79;240021
24;2021-01-09;12;6;18;87342;56882;89;144224
24;2021-01-09;3;2;5;31210;12071;90;43281
24;2021-01-09;218;172;390;1320165;1238908;0;2559073
27;2021-01-09;15;16;31;143373;149679;09;293052
27;2021-01-09;55;53;109;160962;173003;19;333965
27;2021-01-09;53;49;102;133746;142254;29;276000
27;2021-01-09;63;38;101;160004;155407;39;315411
27;2021-01-09;54;49;103;172333;169564;49;341897
27;2021-01-09;64;59;123;189979;183788;59;373767
27;2021-01-09;34;42;76;192591;178206;69;370797
27;2021-01-09;28;33;61;146876;127546;79;274422
27;2021-01-09;32;18;50;96896;61575;89;158471
27;2021-01-09;18;5;23;33148;12109;90;45257
27;2021-01-09;416;362;779;1429908;1353131;0;2783039
28;2021-01-09;6;6;12;180735;186856;09;367591
28;2021-01-09;34;28;62;200125;213621;19;413746
28;2021-01-09;42;41;83;168922;173007;29;341929
28;2021-01-09;31;31;62;196628;188487;39;385115
28;2021-01-09;29;48;77;205396;201699;49;407095
28;2021-01-09;31;33;64;222002;213866;59;435868
28;2021-01-09;26;24;50;224688;203758;69;428446
28;2021-01-09;18;15;33;163192;135543;79;298735
28;2021-01-09;17;16;33;109691;65377;89;175068
28;2021-01-09;5;2;7;37222;12685;90;49907
28;2021-01-09;239;244;483;1708601;1594899;0;3303500
32;2021-01-09;26;28;54;358062;373689;09;731751
32;2021-01-09;84;67;151;387045;406742;19;793787
32;2021-01-09;85;78;163;342304;348587;29;690891
32;2021-01-09;98;85;183;382485;369972;39;752457
32;2021-01-09;94;87;181;382510;376716;49;759226
32;2021-01-09;97;77;174;386937;376527;59;763464
32;2021-01-09;60;45;105;371211;330938;69;702149
32;2021-01-09;40;43;83;250542;201459;79;452001
32;2021-01-09;45;26;71;163399;89786;89;253185
32;2021-01-09;28;10;38;48384;15367;90;63751
32;2021-01-09;657;547;1204;3072879;2889783;0;5962662
44;2021-01-09;25;21;46;291525;306839;09;598364
44;2021-01-09;68;76;144;320255;339504;19;659759
44;2021-01-09;96;83;179;302020;314428;29;616448
44;2021-01-09;111;74;186;342222;333292;39;675514
44;2021-01-09;103;80;183;349727;344491;49;694218
44;2021-01-09;94;96;190;381371;373239;59;754610
44;2021-01-09;71;73;144;367165;335850;69;703015
44;2021-01-09;52;56;108;250387;215436;79;465823
44;2021-01-09;39;29;68;170825;105192;89;276017
44;2021-01-09;20;5;25;51248;16731;90;67979
44;2021-01-09;679;593;1273;2826745;2685002;0;5511747
52;2021-01-09;8;12;20;213594;223900;09;437494
52;2021-01-09;32;22;55;240818;255197;19;496015
52;2021-01-09;37;23;60;197010;200630;29;397640
52;2021-01-09;21;24;45;231204;224885;39;456089
52;2021-01-09;29;35;64;243874;243418;49;487292
52;2021-01-09;37;28;65;244100;239116;59;483216
52;2021-01-09;11;22;33;241796;221345;69;463141
52;2021-01-09;9;15;24;177805;149903;79;327708
52;2021-01-09;15;10;25;119561;75822;89;195383
52;2021-01-09;6;3;9;42559;15260;90;57819
52;2021-01-09;205;194;400;1952321;1849476;0;3801797
53;2021-01-09;9;9;19;173813;182358;09;356171
53;2021-01-09;18;26;44;202720;214740;19;417460
53;2021-01-09;33;32;65;163116;173196;29;336312
53;2021-01-09;21;17;38;190526;187674;39;378200
53;2021-01-09;22;22;44;212098;212015;49;424113
53;2021-01-09;18;20;38;223699;219176;59;442875
53;2021-01-09;10;12;22;227435;209274;69;436709
53;2021-01-09;10;9;19;169992;140910;79;310902
53;2021-01-09;14;7;21;118117;69883;89;188000
53;2021-01-09;11;9;20;37370;12267;90;49637
53;2021-01-09;166;163;330;1718886;1621493;0;3340379
75;2021-01-09;12;9;21;293104;305291;09;598395
75;2021-01-09;52;51;103;337141;357785;19;694926
75;2021-01-09;65;40;105;295024;300618;29;595642
75;2021-01-09;49;45;94;347871;331233;39;679104
75;2021-01-09;58;57;115;384742;372771;49;757513
75;2021-01-09;44;48;92;413361;390880;59;804241
75;2021-01-09;29;30;59;425623;384060;69;809683
75;2021-01-09;18;25;43;325086;276298;79;601384
75;2021-01-09;26;11;37;213986;139308;89;353294
75;2021-01-09;10;3;13;77600;28200;90;105800
75;2021-01-09;363;319;682;3113538;2886444;0;5999982
76;2021-01-09;16;8;24;305956;318589;09;624545
76;2021-01-09;59;47;107;338942;356969;19;695911
76;2021-01-09;90;66;156;316210;319570;29;635780
76;2021-01-09;59;65;124;356758;337587;39;694345
76;2021-01-09;75;44;119;376541;363812;49;740353
76;2021-01-09;64;55;119;402608;383750;59;786358
76;2021-01-09;37;41;78;394889;358997;69;753886
76;2021-01-09;28;23;51;308664;263806;79;572470
76;2021-01-09;25;17;42;195838;129272;89;325110
76;2021-01-09;13;2;15;69372;26728;90;96100
76;2021-01-09;466;369;836;3065778;2859080;0;5924858
84;2021-01-09;21;25;48;459549;481088;09;940637
84;2021-01-09;102;101;204;487711;511905;19;999616
84;2021-01-09;111;123;234;443824;451094;29;894918
84;2021-01-09;102;94;198;512522;493262;39;1005784
84;2021-01-09;120;105;225;520248;515106;49;1035354
84;2021-01-09;98;105;203;529611;514848;59;1044459
84;2021-01-09;65;79;144;486720;439940;69;926660
84;2021-01-09;46;47;93;372151;315211;79;687362
84;2021-01-09;49;37;86;237198;150524;89;387722
84;2021-01-09;28;6;34;81185;28680;90;109865
84;2021-01-09;742;722;1469;4130719;3901658;0;8032377
93;2021-01-09;14;11;25;268834;283093;09;551927
93;2021-01-09;86;65;151;280751;296087;19;576838
93;2021-01-09;84;81;165;254404;255552;29;509956
93;2021-01-09;105;79;184;310704;288398;39;599102
93;2021-01-09;105;81;186;325559;305827;49;631386
93;2021-01-09;110;96;206;353104;325389;59;678493
93;2021-01-09;68;53;121;336327;296459;69;632786
93;2021-01-09;46;37;83;279820;229699;79;509519
93;2021-01-09;33;31;64;171274;113716;89;284990
93;2021-01-09;23;8;31;58896;21758;90;80654
93;2021-01-09;674;542;1217;2639673;2415978;0;5055651
94;2021-01-09;0;0;0;16311;17433;09;33744
94;2021-01-09;0;2;2;16679;18132;19;34811
94;2021-01-09;1;6;7;16782;16579;29;33361
94;2021-01-09;5;1;6;23044;20580;39;43624
94;2021-01-09;0;2;2;23065;22140;49;45205
94;2021-01-09;1;2;3;24549;23421;59;47970
94;2021-01-09;0;1;1;23212;21883;69;45095
94;2021-01-09;2;3;5;19544;17141;79;36685
94;2021-01-09;0;0;0;11227;8178;89;19405
94;2021-01-09;0;0;0;3332;1447;90;4779
94;2021-01-09;9;17;26;177745;166934;0;344679
01;2021-01-10;0;0;0;19979;20155;09;40134
01;2021-01-10;0;0;0;24994;25489;19;50483
01;2021-01-10;0;1;1;17868;16690;29;34558
01;2021-01-10;0;0;0;22328;14821;39;37149
01;2021-01-10;0;0;0;28652;20276;49;48928
01;2021-01-10;0;0;0;33264;27260;59;60524
01;2021-01-10;0;0;0;27135;23978;69;51113
01;2021-01-10;0;1;1;18401;14661;79;33062
01;2021-01-10;0;0;0;9633;6375;89;16008
01;2021-01-10;0;0;0;3410;1510;90;4920
01;2021-01-10;0;2;2;205664;171215;0;376879
02;2021-01-10;0;0;0;16881;17110;09;33991
02;2021-01-10;0;0;0;21410;21604;19;43014
02;2021-01-10;0;0;0;16017;15479;29;31496
02;2021-01-10;0;0;0;19825;14455;39;34280
02;2021-01-10;0;0;0;24719;18248;49;42967
02;2021-01-10;0;0;0;34361;28310;59;62671
02;2021-01-10;0;0;0;28061;24495;69;52556
02;2021-01-10;0;0;0;18231;15278;79;33509
02;2021-01-10;0;0;0;11090;7677;89;18767
02;2021-01-10;0;0;0;3992;1506;90;5498
02;2021-01-10;0;0;0;194587;164162;0;358749
03;2021-01-10;1;0;1;31123;30920;09;62043
03;2021-01-10;1;2;3;29370;29268;19;58638
03;2021-01-10;0;1;1;21458;18963;29;40421
03;2021-01-10;2;0;2;21276;18326;39;39602
03;2021-01-10;1;0;1;18164;16593;49;34757
03;2021-01-10;2;0;2;13469;13557;59;27026
03;2021-01-10;0;2;2;8776;8670;69;17446
03;2021-01-10;1;1;2;3777;3591;79;7368
03;2021-01-10;0;0;0;1649;1072;89;2721
03;2021-01-10;0;0;0;485;184;90;669
03;2021-01-10;8;6;14;149547;141144;0;290691
04;2021-01-10;0;1;1;60314;61377;09;121691
04;2021-01-10;0;0;0;66065;68387;19;134452
04;2021-01-10;0;0;0;51059;47156;29;98215
04;2021-01-10;0;1;1;58788;45780;39;104568
04;2021-01-10;0;0;0;61408;52207;49;113615
04;2021-01-10;0;0;0;64838;60759;59;125597
04;2021-01-10;0;0;0;47008;42843;69;89851
04;2021-01-10;0;0;0;25509;21184;79;46693
04;2021-01-10;0;0;0;13168;7647;89;20815
04;2021-01-10;0;0;0;3209;1253;90;4462
04;2021-01-10;0;2;2;451366;408593;0;859959
05;2021-01-10;0;0;0;362.366008612902;341.338819562748;09;703.704828175651
05;2021-01-10;0;0;0;353.376145114279;370.349735405642;19;723.725880519921
05;2021-01-10;0;0;0;218.593559489256;256.539602589476;29;475.133162078732
05;2021-01-10;0;0;0;404.225408693299;360.321910454353;39;764.547319147651
05;2021-01-10;0;0;0;520.067953604221;497.108383964256;49;1017.17633756848
05;2021-01-10;0;0;0;468.146063921917;510.087601910415;59;978.233665832332
05;2021-01-10;0;0;0;340.368470050554;334.366842191253;69;674.735312241807
05;2021-01-10;0;0;0;212.598666888387;192.597753227106;79;405.196420115493
05;2021-01-10;0;0;0;148.727797095705;61.8681715431829;89;210.595968638888
05;2021-01-10;0;0;0;32.9601271090696;10.9909785719784;90;43.9511056810479
05;2021-01-10;0;0;0;3061.43020057959;2935.56979942041;0;5997
06;2021-01-10;0;0;0;42583;42380;09;84963
06;2021-01-10;0;0;0;33369;31925;19;65294
06;2021-01-10;1;0;1;21571;15080;29;36651
06;2021-01-10;2;0;2;21550;16147;39;37697
06;2021-01-10;0;1;1;14193;13939;49;28132
06;2021-01-10;1;1;2;7171;7597;59;14768
06;2021-01-10;0;0;0;3629;4117;69;7746
06;2021-01-10;0;0;0;1577;1457;79;3034
06;2021-01-10;0;0;0;531;474;89;1005
06;2021-01-10;0;0;0;88;93;90;181
06;2021-01-10;4;2;6;146262;133209;0;279471
07;2021-01-10;0;0;0;485;549;09;1034
07;2021-01-10;0;0;0;403;432;19;835
07;2021-01-10;1;0;1;764;841;29;1605
07;2021-01-10;0;0;0;824;928;39;1752
07;2021-01-10;0;1;1;788;1020;49;1808
07;2021-01-10;0;0;0;678;870;59;1548
07;2021-01-10;0;0;0;360;382;69;742
07;2021-01-10;0;0;0;231;190;79;421
07;2021-01-10;0;0;0;114;67;89;181
07;2021-01-10;0;0;0;24;11;90;35
07;2021-01-10;1;1;2;4671;5290;0;9961
08;2021-01-10;0;0;0;2715.22592983026;2997.75551488675;09;5712.98144471701
08;2021-01-10;0;0;0;2778.51901080978;3160.9156459093;19;5939.43465671908
08;2021-01-10;0;0;0;2080.8882988764;1718.16634315323;29;3799.05464202964
08;2021-01-10;0;0;0;2701.8582062647;1896.52641413317;39;4598.38462039786
08;2021-01-10;0;0;0;3151.45861023308;2460.52498233809;49;5611.98359257117
08;2021-01-10;0;0;0;2620.29868333099;2422.23566154656;59;5042.53434487755
08;2021-01-10;0;0;0;1621.44173420671;1438.58325779464;69;3060.02499200135
08;2021-01-10;0;0;0;626.575909335673;526.358467843651;79;1152.93437717932
08;2021-01-10;0;0;0;205.018522985054;140.993639349697;89;346.012162334751
08;2021-01-10;0;0;0;50.0325684687745;20.62259870351;90;70.6551671722846
08;2021-01-10;0;0;0;18551.3174743414;16782.6825256586;0;35334
11;2021-01-10;8;13;21;783071;811785;09;1594856
11;2021-01-10;24;29;53;761456;784653;19;1546109
11;2021-01-10;74;49;123;850145;801772;29;1651917
11;2021-01-10;53;72;126;914360;843488;39;1757848
11;2021-01-10;48;53;103;845609;826202;49;1671811
11;2021-01-10;42;50;92;793566;745070;59;1538636
11;2021-01-10;32;29;62;628649;549192;69;1177841
11;2021-01-10;19;16;35;434606;358356;79;792962
11;2021-01-10;24;12;36;261425;162933;89;424358
11;2021-01-10;13;6;19;89253;32619;90;121872
11;2021-01-10;337;329;670;6362140;5916070;0;12278210
24;2021-01-10;1;1;2;139720;144686;09;284406
24;2021-01-10;1;4;5;152979;161185;19;314164
24;2021-01-10;1;4;5;122237;126536;29;248773
24;2021-01-10;4;2;6;150359;142009;39;292368
24;2021-01-10;2;1;3;161829;158758;49;320587
24;2021-01-10;9;2;11;172552;168011;59;340563
24;2021-01-10;1;0;1;172509;158177;69;330686
24;2021-01-10;6;0;6;129428;110593;79;240021
24;2021-01-10;13;6;19;87342;56882;89;144224
24;2021-01-10;5;1;6;31210;12071;90;43281
24;2021-01-10;43;21;64;1320165;1238908;0;2559073
27;2021-01-10;1;1;2;143373;149679;09;293052
27;2021-01-10;3;5;8;160962;173003;19;333965
27;2021-01-10;6;4;10;133746;142254;29;276000
27;2021-01-10;5;8;13;160004;155407;39;315411
27;2021-01-10;6;7;13;172333;169564;49;341897
27;2021-01-10;6;7;13;189979;183788;59;373767
27;2021-01-10;5;8;13;192591;178206;69;370797
27;2021-01-10;11;8;19;146876;127546;79;274422
27;2021-01-10;7;7;14;96896;61575;89;158471
27;2021-01-10;4;5;9;33148;12109;90;45257
27;2021-01-10;54;60;114;1429908;1353131;0;2783039
28;2021-01-10;2;0;2;180735;186856;09;367591
28;2021-01-10;4;7;11;200125;213621;19;413746
28;2021-01-10;11;12;23;168922;173007;29;341929
28;2021-01-10;13;10;23;196628;188487;39;385115
28;2021-01-10;16;10;26;205396;201699;49;407095
28;2021-01-10;8;10;18;222002;213866;59;435868
28;2021-01-10;7;11;18;224688;203758;69;428446
28;2021-01-10;6;7;13;163192;135543;79;298735
28;2021-01-10;16;8;24;109691;65377;89;175068
28;2021-01-10;6;3;9;37222;12685;90;49907
28;2021-01-10;89;78;167;1708601;1594899;0;3303500
32;2021-01-10;5;5;10;358062;373689;09;731751
32;2021-01-10;13;11;24;387045;406742;19;793787
32;2021-01-10;23;20;43;342304;348587;29;690891
32;2021-01-10;28;25;53;382485;369972;39;752457
32;2021-01-10;16;12;28;382510;376716;49;759226
32;2021-01-10;7;17;24;386937;376527;59;763464
32;2021-01-10;13;8;21;371211;330938;69;702149
32;2021-01-10;7;9;16;250542;201459;79;452001
32;2021-01-10;9;10;19;163399;89786;89;253185
32;2021-01-10;8;4;12;48384;15367;90;63751
32;2021-01-10;129;121;250;3072879;2889783;0;5962662
44;2021-01-10;4;4;8;291525;306839;09;598364
44;2021-01-10;7;8;16;320255;339504;19;659759
44;2021-01-10;8;6;14;302020;314428;29;616448
44;2021-01-10;15;11;26;342222;333292;39;675514
44;2021-01-10;14;8;22;349727;344491;49;694218
44;2021-01-10;10;9;19;381371;373239;59;754610
44;2021-01-10;10;10;20;367165;335850;69;703015
44;2021-01-10;14;10;25;250387;215436;79;465823
44;2021-01-10;28;10;38;170825;105192;89;276017
44;2021-01-10;11;3;14;51248;16731;90;67979
44;2021-01-10;121;79;202;2826745;2685002;0;5511747
52;2021-01-10;0;1;1;213594;223900;09;437494
52;2021-01-10;8;9;17;240818;255197;19;496015
52;2021-01-10;23;8;31;197010;200630;29;397640
52;2021-01-10;12;9;21;231204;224885;39;456089
52;2021-01-10;9;6;15;243874;243418;49;487292
52;2021-01-10;9;6;15;244100;239116;59;483216
52;2021-01-10;6;2;8;241796;221345;69;463141
52;2021-01-10;5;6;11;177805;149903;79;327708
52;2021-01-10;7;5;12;119561;75822;89;195383
52;2021-01-10;4;4;8;42559;15260;90;57819
52;2021-01-10;83;56;139;1952321;1849476;0;3801797
53;2021-01-10;2;0;2;173813;182358;09;356171
53;2021-01-10;8;5;13;202720;214740;19;417460
53;2021-01-10;6;4;10;163116;173196;29;336312
53;2021-01-10;1;3;4;190526;187674;39;378200
53;2021-01-10;6;8;14;212098;212015;49;424113
53;2021-01-10;5;4;9;223699;219176;59;442875
53;2021-01-10;4;4;8;227435;209274;69;436709
53;2021-01-10;2;5;7;169992;140910;79;310902
53;2021-01-10;2;3;5;118117;69883;89;188000
53;2021-01-10;2;2;4;37370;12267;90;49637
53;2021-01-10;38;38;76;1718886;1621493;0;3340379
75;2021-01-10;0;0;0;293104;305291;09;598395
75;2021-01-10;4;7;11;337141;357785;19;694926
75;2021-01-10;19;13;32;295024;300618;29;595642
75;2021-01-10;14;7;21;347871;331233;39;679104
75;2021-01-10;10;9;19;384742;372771;49;757513
75;2021-01-10;9;6;15;413361;390880;59;804241
75;2021-01-10;5;6;11;425623;384060;69;809683
75;2021-01-10;4;7;11;325086;276298;79;601384
75;2021-01-10;7;8;15;213986;139308;89;353294
75;2021-01-10;2;2;4;77600;28200;90;105800
75;2021-01-10;74;65;139;3113538;2886444;0;5999982
76;2021-01-10;5;6;11;305956;318589;09;624545
76;2021-01-10;12;5;17;338942;356969;19;695911
76;2021-01-10;16;13;29;316210;319570;29;635780
76;2021-01-10;20;11;31;356758;337587;39;694345
76;2021-01-10;13;15;28;376541;363812;49;740353
76;2021-01-10;16;11;27;402608;383750;59;786358
76;2021-01-10;7;11;18;394889;358997;69;753886
76;2021-01-10;8;10;18;308664;263806;79;572470
76;2021-01-10;14;15;29;195838;129272;89;325110
76;2021-01-10;12;5;17;69372;26728;90;96100
76;2021-01-10;123;102;225;3065778;2859080;0;5924858
84;2021-01-10;4;7;11;459549;481088;09;940637
84;2021-01-10;8;9;17;487711;511905;19;999616
84;2021-01-10;26;19;45;443824;451094;29;894918
84;2021-01-10;23;17;40;512522;493262;39;1005784
84;2021-01-10;22;9;31;520248;515106;49;1035354
84;2021-01-10;15;21;36;529611;514848;59;1044459
84;2021-01-10;16;13;29;486720;439940;69;926660
84;2021-01-10;18;14;32;372151;315211;79;687362
84;2021-01-10;28;20;48;237198;150524;89;387722
84;2021-01-10;12;8;20;81185;28680;90;109865
84;2021-01-10;172;137;309;4130719;3901658;0;8032377
93;2021-01-10;4;2;6;268834;283093;09;551927
93;2021-01-10;20;13;33;280751;296087;19;576838
93;2021-01-10;23;17;40;254404;255552;29;509956
93;2021-01-10;14;15;29;310704;288398;39;599102
93;2021-01-10;24;24;48;325559;305827;49;631386
93;2021-01-10;13;13;26;353104;325389;59;678493
93;2021-01-10;15;14;29;336327;296459;69;632786
93;2021-01-10;9;10;19;279820;229699;79;509519
93;2021-01-10;21;18;39;171274;113716;89;284990
93;2021-01-10;21;7;28;58896;21758;90;80654
93;2021-01-10;164;133;297;2639673;2415978;0;5055651
94;2021-01-10;0;0;0;16311;17433;09;33744
94;2021-01-10;0;0;0;16679;18132;19;34811
94;2021-01-10;0;0;0;16782;16579;29;33361
94;2021-01-10;2;1;3;23044;20580;39;43624
94;2021-01-10;0;0;0;23065;22140;49;45205
94;2021-01-10;2;0;2;24549;23421;59;47970
94;2021-01-10;0;2;2;23212;21883;69;45095
94;2021-01-10;0;1;1;19544;17141;79;36685
94;2021-01-10;0;1;1;11227;8178;89;19405
94;2021-01-10;0;0;0;3332;1447;90;4779
94;2021-01-10;4;5;9;177745;166934;0;344679
01;2021-01-11;0;0;0;19979;20155;09;40134
01;2021-01-11;1;1;2;24994;25489;19;50483
01;2021-01-11;5;1;6;17868;16690;29;34558
01;2021-01-11;3;2;5;22328;14821;39;37149
01;2021-01-11;2;1;3;28652;20276;49;48928
01;2021-01-11;0;1;1;33264;27260;59;60524
01;2021-01-11;1;0;1;27135;23978;69;51113
01;2021-01-11;2;0;2;18401;14661;79;33062
01;2021-01-11;2;0;2;9633;6375;89;16008
01;2021-01-11;0;0;0;3410;1510;90;4920
01;2021-01-11;16;6;22;205664;171215;0;376879
02;2021-01-11;0;0;0;16881;17110;09;33991
02;2021-01-11;0;1;1;21410;21604;19;43014
02;2021-01-11;3;1;4;16017;15479;29;31496
02;2021-01-11;1;2;3;19825;14455;39;34280
02;2021-01-11;0;0;0;24719;18248;49;42967
02;2021-01-11;3;2;5;34361;28310;59;62671
02;2021-01-11;0;2;2;28061;24495;69;52556
02;2021-01-11;2;1;3;18231;15278;79;33509
02;2021-01-11;0;0;0;11090;7677;89;18767
02;2021-01-11;0;0;0;3992;1506;90;5498
02;2021-01-11;9;9;18;194587;164162;0;358749
03;2021-01-11;0;1;1;31123;30920;09;62043
03;2021-01-11;16;17;33;29370;29268;19;58638
03;2021-01-11;25;17;42;21458;18963;29;40421
03;2021-01-11;20;11;31;21276;18326;39;39602
03;2021-01-11;27;18;45;18164;16593;49;34757
03;2021-01-11;11;11;22;13469;13557;59;27026
03;2021-01-11;9;16;25;8776;8670;69;17446
03;2021-01-11;0;4;4;3777;3591;79;7368
03;2021-01-11;0;1;1;1649;1072;89;2721
03;2021-01-11;1;0;1;485;184;90;669
03;2021-01-11;109;96;205;149547;141144;0;290691
04;2021-01-11;1;0;2;60314;61377;09;121691
04;2021-01-11;6;3;9;66065;68387;19;134452
04;2021-01-11;7;3;10;51059;47156;29;98215
04;2021-01-11;6;3;9;58788;45780;39;104568
04;2021-01-11;5;1;6;61408;52207;49;113615
04;2021-01-11;2;5;7;64838;60759;59;125597
04;2021-01-11;3;2;5;47008;42843;69;89851
04;2021-01-11;0;0;0;25509;21184;79;46693
04;2021-01-11;1;0;1;13168;7647;89;20815
04;2021-01-11;0;0;0;3209;1253;90;4462
04;2021-01-11;31;17;49;451366;408593;0;859959
05;2021-01-11;0;0;0;362.366008612902;341.338819562748;09;703.704828175651
05;2021-01-11;0;0;0;353.376145114279;370.349735405642;19;723.725880519921
05;2021-01-11;0;0;0;218.593559489256;256.539602589476;29;475.133162078732
05;2021-01-11;0;0;0;404.225408693299;360.321910454353;39;764.547319147651
05;2021-01-11;0;0;0;520.067953604221;497.108383964256;49;1017.17633756848
05;2021-01-11;0;0;0;468.146063921917;510.087601910415;59;978.233665832332
05;2021-01-11;0;0;0;340.368470050554;334.366842191253;69;674.735312241807
05;2021-01-11;0;0;0;212.598666888387;192.597753227106;79;405.196420115493
05;2021-01-11;0;0;0;148.727797095705;61.8681715431829;89;210.595968638888
05;2021-01-11;0;0;0;32.9601271090696;10.9909785719784;90;43.9511056810479
05;2021-01-11;0;0;0;3061.43020057959;2935.56979942041;0;5997
06;2021-01-11;1;0;1;42583;42380;09;84963
06;2021-01-11;7;8;15;33369;31925;19;65294
06;2021-01-11;12;7;19;21571;15080;29;36651
06;2021-01-11;8;6;14;21550;16147;39;37697
06;2021-01-11;16;7;23;14193;13939;49;28132
06;2021-01-11;8;15;23;7171;7597;59;14768
06;2021-01-11;2;2;4;3629;4117;69;7746
06;2021-01-11;0;1;1;1577;1457;79;3034
06;2021-01-11;0;0;0;531;474;89;1005
06;2021-01-11;0;0;0;88;93;90;181
06;2021-01-11;54;46;100;146262;133209;0;279471
07;2021-01-11;0;0;0;485;549;09;1034
07;2021-01-11;0;0;0;403;432;19;835
07;2021-01-11;2;1;3;764;841;29;1605
07;2021-01-11;0;1;1;824;928;39;1752
07;2021-01-11;2;2;4;788;1020;49;1808
07;2021-01-11;0;0;0;678;870;59;1548
07;2021-01-11;0;0;0;360;382;69;742
07;2021-01-11;0;0;0;231;190;79;421
07;2021-01-11;0;0;0;114;67;89;181
07;2021-01-11;0;0;0;24;11;90;35
07;2021-01-11;4;4;8;4671;5290;0;9961
08;2021-01-11;0;0;0;2715.22592983026;2997.75551488675;09;5712.98144471701
08;2021-01-11;0;0;0;2778.51901080978;3160.9156459093;19;5939.43465671908
08;2021-01-11;2;1;3;2080.8882988764;1718.16634315323;29;3799.05464202964
08;2021-01-11;4;1;5;2701.8582062647;1896.52641413317;39;4598.38462039786
08;2021-01-11;1;1;2;3151.45861023308;2460.52498233809;49;5611.98359257117
08;2021-01-11;2;1;3;2620.29868333099;2422.23566154656;59;5042.53434487755
08;2021-01-11;0;5;5;1621.44173420671;1438.58325779464;69;3060.02499200135
08;2021-01-11;1;2;3;626.575909335673;526.358467843651;79;1152.93437717932
08;2021-01-11;0;0;0;205.018522985054;140.993639349697;89;346.012162334751
08;2021-01-11;0;0;0;50.0325684687745;20.62259870351;90;70.6551671722846
08;2021-01-11;10;11;21;18551.3174743414;16782.6825256586;0;35334
11;2021-01-11;67;78;149;783071;811785;09;1594856
11;2021-01-11;291;260;557;761456;784653;19;1546109
11;2021-01-11;533;407;945;850145;801772;29;1651917
11;2021-01-11;458;434;895;914360;843488;39;1757848
11;2021-01-11;411;393;806;845609;826202;49;1671811
11;2021-01-11;368;307;676;793566;745070;59;1538636
11;2021-01-11;260;203;466;628649;549192;69;1177841
11;2021-01-11;130;115;245;434606;358356;79;792962
11;2021-01-11;124;59;184;261425;162933;89;424358
11;2021-01-11;51;25;76;89253;32619;90;121872
11;2021-01-11;2693;2283;5001;6362140;5916070;0;12278210
24;2021-01-11;12;12;24;139720;144686;09;284406
24;2021-01-11;46;45;93;152979;161185;19;314164
24;2021-01-11;73;53;126;122237;126536;29;248773
24;2021-01-11;71;60;131;150359;142009;39;292368
24;2021-01-11;65;59;124;161829;158758;49;320587
24;2021-01-11;78;47;125;172552;168011;59;340563
24;2021-01-11;36;43;79;172509;158177;69;330686
24;2021-01-11;38;28;66;129428;110593;79;240021
24;2021-01-11;55;26;81;87342;56882;89;144224
24;2021-01-11;50;7;57;31210;12071;90;43281
24;2021-01-11;524;380;906;1320165;1238908;0;2559073
27;2021-01-11;22;20;42;143373;149679;09;293052
27;2021-01-11;97;81;178;160962;173003;19;333965
27;2021-01-11;101;81;182;133746;142254;29;276000
27;2021-01-11;97;76;173;160004;155407;39;315411
27;2021-01-11;109;111;220;172333;169564;49;341897
27;2021-01-11;141;124;265;189979;183788;59;373767
27;2021-01-11;85;82;167;192591;178206;69;370797
27;2021-01-11;77;70;147;146876;127546;79;274422
27;2021-01-11;108;47;155;96896;61575;89;158471
27;2021-01-11;94;22;116;33148;12109;90;45257
27;2021-01-11;931;714;1645;1429908;1353131;0;2783039
28;2021-01-11;19;20;40;180735;186856;09;367591
28;2021-01-11;40;73;115;200125;213621;19;413746
28;2021-01-11;87;73;160;168922;173007;29;341929
28;2021-01-11;92;80;172;196628;188487;39;385115
28;2021-01-11;87;73;160;205396;201699;49;407095
28;2021-01-11;98;77;175;222002;213866;59;435868
28;2021-01-11;63;69;132;224688;203758;69;428446
28;2021-01-11;45;61;106;163192;135543;79;298735
28;2021-01-11;43;16;59;109691;65377;89;175068
28;2021-01-11;41;4;45;37222;12685;90;49907
28;2021-01-11;616;546;1165;1708601;1594899;0;3303500
32;2021-01-11;42;38;81;358062;373689;09;731751
32;2021-01-11;147;143;290;387045;406742;19;793787
32;2021-01-11;209;134;343;342304;348587;29;690891
32;2021-01-11;220;162;382;382485;369972;39;752457
32;2021-01-11;177;162;339;382510;376716;49;759226
32;2021-01-11;170;146;316;386937;376527;59;763464
32;2021-01-11;127;141;268;371211;330938;69;702149
32;2021-01-11;97;79;176;250542;201459;79;452001
32;2021-01-11;107;62;169;163399;89786;89;253185
32;2021-01-11;65;23;88;48384;15367;90;63751
32;2021-01-11;1361;1090;2452;3072879;2889783;0;5962662
44;2021-01-11;49;59;108;291525;306839;09;598364
44;2021-01-11;177;169;346;320255;339504;19;659759
44;2021-01-11;210;177;387;302020;314428;29;616448
44;2021-01-11;204;187;391;342222;333292;39;675514
44;2021-01-11;179;157;337;349727;344491;49;694218
44;2021-01-11;203;162;366;381371;373239;59;754610
44;2021-01-11;145;134;279;367165;335850;69;703015
44;2021-01-11;87;84;172;250387;215436;79;465823
44;2021-01-11;142;66;210;170825;105192;89;276017
44;2021-01-11;94;26;120;51248;16731;90;67979
44;2021-01-11;1490;1221;2716;2826745;2685002;0;5511747
52;2021-01-11;5;10;15;213594;223900;09;437494
52;2021-01-11;46;55;101;240818;255197;19;496015
52;2021-01-11;68;84;152;197010;200630;29;397640
52;2021-01-11;54;47;101;231204;224885;39;456089
52;2021-01-11;80;60;140;243874;243418;49;487292
52;2021-01-11;80;54;134;244100;239116;59;483216
52;2021-01-11;41;41;83;241796;221345;69;463141
52;2021-01-11;33;31;64;177805;149903;79;327708
52;2021-01-11;31;26;57;119561;75822;89;195383
52;2021-01-11;13;3;16;42559;15260;90;57819
52;2021-01-11;451;411;863;1952321;1849476;0;3801797
53;2021-01-11;15;17;33;173813;182358;09;356171
53;2021-01-11;44;43;87;202720;214740;19;417460
53;2021-01-11;51;60;118;163116;173196;29;336312
53;2021-01-11;46;48;94;190526;187674;39;378200
53;2021-01-11;39;38;78;212098;212015;49;424113
53;2021-01-11;51;47;98;223699;219176;59;442875
53;2021-01-11;35;31;66;227435;209274;69;436709
53;2021-01-11;21;30;51;169992;140910;79;310902
53;2021-01-11;25;20;45;118117;69883;89;188000
53;2021-01-11;24;9;34;37370;12267;90;49637
53;2021-01-11;351;343;704;1718886;1621493;0;3340379
75;2021-01-11;24;27;53;293104;305291;09;598395
75;2021-01-11;85;99;187;337141;357785;19;694926
75;2021-01-11;145;119;264;295024;300618;29;595642
75;2021-01-11;150;95;245;347871;331233;39;679104
75;2021-01-11;160;98;258;384742;372771;49;757513
75;2021-01-11;144;109;255;413361;390880;59;804241
75;2021-01-11;89;86;175;425623;384060;69;809683
75;2021-01-11;70;64;134;325086;276298;79;601384
75;2021-01-11;77;60;137;213986;139308;89;353294
75;2021-01-11;96;19;117;77600;28200;90;105800
75;2021-01-11;1040;776;1825;3113538;2886444;0;5999982
76;2021-01-11;37;39;78;305956;318589;09;624545
76;2021-01-11;143;127;278;338942;356969;19;695911
76;2021-01-11;195;160;355;316210;319570;29;635780
76;2021-01-11;190;148;338;356758;337587;39;694345
76;2021-01-11;172;153;325;376541;363812;49;740353
76;2021-01-11;192;161;353;402608;383750;59;786358
76;2021-01-11;124;109;233;394889;358997;69;753886
76;2021-01-11;80;78;158;308664;263806;79;572470
76;2021-01-11;99;63;162;195838;129272;89;325110
76;2021-01-11;70;30;100;69372;26728;90;96100
76;2021-01-11;1303;1069;2382;3065778;2859080;0;5924858
84;2021-01-11;51;48;99;459549;481088;09;940637
84;2021-01-11;233;178;414;487711;511905;19;999616
84;2021-01-11;289;219;508;443824;451094;29;894918
84;2021-01-11;296;257;553;512522;493262;39;1005784
84;2021-01-11;282;227;509;520248;515106;49;1035354
84;2021-01-11;271;217;488;529611;514848;59;1044459
84;2021-01-11;176;187;364;486720;439940;69;926660
84;2021-01-11;151;162;313;372151;315211;79;687362
84;2021-01-11;134;87;221;237198;150524;89;387722
84;2021-01-11;93;28;121;81185;28680;90;109865
84;2021-01-11;1976;1610;3591;4130719;3901658;0;8032377
93;2021-01-11;41;48;91;268834;283093;09;551927
93;2021-01-11;200;221;421;280751;296087;19;576838
93;2021-01-11;305;235;540;254404;255552;29;509956
93;2021-01-11;298;226;524;310704;288398;39;599102
93;2021-01-11;313;253;567;325559;305827;49;631386
93;2021-01-11;315;282;598;353104;325389;59;678493
93;2021-01-11;180;188;368;336327;296459;69;632786
93;2021-01-11;145;116;261;279820;229699;79;509519
93;2021-01-11;173;88;261;171274;113716;89;284990
93;2021-01-11;167;48;216;58896;21758;90;80654
93;2021-01-11;2138;1706;3849;2639673;2415978;0;5055651
94;2021-01-11;0;0;0;16311;17433;09;33744
94;2021-01-11;2;10;12;16679;18132;19;34811
94;2021-01-11;4;3;7;16782;16579;29;33361
94;2021-01-11;3;6;9;23044;20580;39;43624
94;2021-01-11;3;6;9;23065;22140;49;45205
94;2021-01-11;2;9;11;24549;23421;59;47970
94;2021-01-11;7;3;10;23212;21883;69;45095
94;2021-01-11;2;2;4;19544;17141;79;36685
94;2021-01-11;4;0;4;11227;8178;89;19405
94;2021-01-11;0;0;0;3332;1447;90;4779
94;2021-01-11;27;39;66;177745;166934;0;344679
01;2021-01-12;0;1;1;19979;20155;09;40134
01;2021-01-12;2;2;4;24994;25489;19;50483
01;2021-01-12;1;1;2;17868;16690;29;34558
01;2021-01-12;1;1;2;22328;14821;39;37149
01;2021-01-12;3;2;5;28652;20276;49;48928
01;2021-01-12;2;2;4;33264;27260;59;60524
01;2021-01-12;0;1;1;27135;23978;69;51113
01;2021-01-12;0;4;4;18401;14661;79;33062
01;2021-01-12;0;0;0;9633;6375;89;16008
01;2021-01-12;0;0;0;3410;1510;90;4920
01;2021-01-12;9;14;23;205664;171215;0;376879
02;2021-01-12;0;0;0;16881;17110;09;33991
02;2021-01-12;0;0;0;21410;21604;19;43014
02;2021-01-12;2;1;3;16017;15479;29;31496
02;2021-01-12;0;0;0;19825;14455;39;34280
02;2021-01-12;0;1;1;24719;18248;49;42967
02;2021-01-12;2;1;3;34361;28310;59;62671
02;2021-01-12;4;3;7;28061;24495;69;52556
02;2021-01-12;1;0;1;18231;15278;79;33509
02;2021-01-12;0;0;0;11090;7677;89;18767
02;2021-01-12;0;0;0;3992;1506;90;5498
02;2021-01-12;9;6;15;194587;164162;0;358749
03;2021-01-12;0;2;2;31123;30920;09;62043
03;2021-01-12;11;9;20;29370;29268;19;58638
03;2021-01-12;22;9;31;21458;18963;29;40421
03;2021-01-12;12;11;23;21276;18326;39;39602
03;2021-01-12;19;5;24;18164;16593;49;34757
03;2021-01-12;12;16;28;13469;13557;59;27026
03;2021-01-12;10;6;16;8776;8670;69;17446
03;2021-01-12;2;2;4;3777;3591;79;7368
03;2021-01-12;1;1;2;1649;1072;89;2721
03;2021-01-12;0;0;0;485;184;90;669
03;2021-01-12;89;62;151;149547;141144;0;290691
04;2021-01-12;0;0;0;60314;61377;09;121691
04;2021-01-12;4;2;6;66065;68387;19;134452
04;2021-01-12;0;3;3;51059;47156;29;98215
04;2021-01-12;3;2;5;58788;45780;39;104568
04;2021-01-12;2;2;4;61408;52207;49;113615
04;2021-01-12;2;4;6;64838;60759;59;125597
04;2021-01-12;2;1;3;47008;42843;69;89851
04;2021-01-12;0;0;0;25509;21184;79;46693
04;2021-01-12;1;0;1;13168;7647;89;20815
04;2021-01-12;0;0;0;3209;1253;90;4462
04;2021-01-12;14;14;28;451366;408593;0;859959
05;2021-01-12;0;0;0;362.366008612902;341.338819562748;09;703.704828175651
05;2021-01-12;0;0;0;353.376145114279;370.349735405642;19;723.725880519921
05;2021-01-12;0;0;0;218.593559489256;256.539602589476;29;475.133162078732
05;2021-01-12;0;0;0;404.225408693299;360.321910454353;39;764.547319147651
05;2021-01-12;0;0;0;520.067953604221;497.108383964256;49;1017.17633756848
05;2021-01-12;1;0;1;468.146063921917;510.087601910415;59;978.233665832332
05;2021-01-12;0;0;0;340.368470050554;334.366842191253;69;674.735312241807
05;2021-01-12;0;0;0;212.598666888387;192.597753227106;79;405.196420115493
05;2021-01-12;0;0;0;148.727797095705;61.8681715431829;89;210.595968638888
05;2021-01-12;0;0;0;32.9601271090696;10.9909785719784;90;43.9511056810479
05;2021-01-12;1;0;1;3061.43020057959;2935.56979942041;0;5997
06;2021-01-12;0;0;0;42583;42380;09;84963
06;2021-01-12;16;9;25;33369;31925;19;65294
06;2021-01-12;9;6;15;21571;15080;29;36651
06;2021-01-12;13;8;21;21550;16147;39;37697
06;2021-01-12;11;11;22;14193;13939;49;28132
06;2021-01-12;4;9;13;7171;7597;59;14768
06;2021-01-12;0;3;3;3629;4117;69;7746
06;2021-01-12;0;1;1;1577;1457;79;3034
06;2021-01-12;0;0;0;531;474;89;1005
06;2021-01-12;0;0;0;88;93;90;181
06;2021-01-12;53;47;100;146262;133209;0;279471
07;2021-01-12;0;0;0;485;549;09;1034
07;2021-01-12;1;1;2;403;432;19;835
07;2021-01-12;1;0;1;764;841;29;1605
07;2021-01-12;0;0;0;824;928;39;1752
07;2021-01-12;0;1;1;788;1020;49;1808
07;2021-01-12;0;0;0;678;870;59;1548
07;2021-01-12;0;0;0;360;382;69;742
07;2021-01-12;0;0;0;231;190;79;421
07;2021-01-12;0;0;0;114;67;89;181
07;2021-01-12;0;0;0;24;11;90;35
07;2021-01-12;2;2;4;4671;5290;0;9961
08;2021-01-12;0;0;0;2715.22592983026;2997.75551488675;09;5712.98144471701
08;2021-01-12;0;0;0;2778.51901080978;3160.9156459093;19;5939.43465671908
08;2021-01-12;2;0;2;2080.8882988764;1718.16634315323;29;3799.05464202964
08;2021-01-12;2;2;4;2701.8582062647;1896.52641413317;39;4598.38462039786
08;2021-01-12;0;0;0;3151.45861023308;2460.52498233809;49;5611.98359257117
08;2021-01-12;1;1;2;2620.29868333099;2422.23566154656;59;5042.53434487755
08;2021-01-12;0;3;3;1621.44173420671;1438.58325779464;69;3060.02499200135
08;2021-01-12;0;1;1;626.575909335673;526.358467843651;79;1152.93437717932
08;2021-01-12;0;0;0;205.018522985054;140.993639349697;89;346.012162334751
08;2021-01-12;0;0;0;50.0325684687745;20.62259870351;90;70.6551671722846
08;2021-01-12;5;7;12;18551.3174743414;16782.6825256586;0;35334
11;2021-01-12;56;69;132;783071;811785;09;1594856
11;2021-01-12;238;228;475;761456;784653;19;1546109
11;2021-01-12;363;334;698;850145;801772;29;1651917
11;2021-01-12;361;330;694;914360;843488;39;1757848
11;2021-01-12;343;288;634;845609;826202;49;1671811
11;2021-01-12;258;235;496;793566;745070;59;1538636
11;2021-01-12;194;146;343;628649;549192;69;1177841
11;2021-01-12;98;97;197;434606;358356;79;792962
11;2021-01-12;90;60;151;261425;162933;89;424358
11;2021-01-12;81;17;98;89253;32619;90;121872
11;2021-01-12;2082;1807;3928;6362140;5916070;0;12278210
24;2021-01-12;8;10;18;139720;144686;09;284406
24;2021-01-12;35;41;76;152979;161185;19;314164
24;2021-01-12;60;49;109;122237;126536;29;248773
24;2021-01-12;66;39;105;150359;142009;39;292368
24;2021-01-12;49;47;96;161829;158758;49;320587
24;2021-01-12;53;56;109;172552;168011;59;340563
24;2021-01-12;50;43;93;172509;158177;69;330686
24;2021-01-12;31;28;59;129428;110593;79;240021
24;2021-01-12;45;38;83;87342;56882;89;144224
24;2021-01-12;58;12;70;31210;12071;90;43281
24;2021-01-12;456;363;819;1320165;1238908;0;2559073
27;2021-01-12;14;21;35;143373;149679;09;293052
27;2021-01-12;69;74;143;160962;173003;19;333965
27;2021-01-12;77;56;133;133746;142254;29;276000
27;2021-01-12;61;63;124;160004;155407;39;315411
27;2021-01-12;72;67;139;172333;169564;49;341897
27;2021-01-12;88;67;155;189979;183788;59;373767
27;2021-01-12;57;45;102;192591;178206;69;370797
27;2021-01-12;37;42;79;146876;127546;79;274422
27;2021-01-12;54;38;92;96896;61575;89;158471
27;2021-01-12;38;14;52;33148;12109;90;45257
27;2021-01-12;567;487;1054;1429908;1353131;0;2783039
28;2021-01-12;26;20;47;180735;186856;09;367591
28;2021-01-12;71;54;126;200125;213621;19;413746
28;2021-01-12;100;71;172;168922;173007;29;341929
28;2021-01-12;94;46;140;196628;188487;39;385115
28;2021-01-12;75;72;147;205396;201699;49;407095
28;2021-01-12;66;68;134;222002;213866;59;435868
28;2021-01-12;55;65;120;224688;203758;69;428446
28;2021-01-12;52;49;101;163192;135543;79;298735
28;2021-01-12;36;25;61;109691;65377;89;175068
28;2021-01-12;23;11;34;37222;12685;90;49907
28;2021-01-12;598;481;1082;1708601;1594899;0;3303500
32;2021-01-12;25;36;61;358062;373689;09;731751
32;2021-01-12;119;113;233;387045;406742;19;793787
32;2021-01-12;150;121;271;342304;348587;29;690891
32;2021-01-12;166;128;294;382485;369972;39;752457
32;2021-01-12;158;106;264;382510;376716;49;759226
32;2021-01-12;146;120;266;386937;376527;59;763464
32;2021-01-12;112;90;202;371211;330938;69;702149
32;2021-01-12;87;71;159;250542;201459;79;452001
32;2021-01-12;85;35;120;163399;89786;89;253185
32;2021-01-12;66;19;85;48384;15367;90;63751
32;2021-01-12;1114;839;1955;3072879;2889783;0;5962662
44;2021-01-12;38;32;71;291525;306839;09;598364
44;2021-01-12;121;103;227;320255;339504;19;659759
44;2021-01-12;144;124;269;302020;314428;29;616448
44;2021-01-12;132;120;254;342222;333292;39;675514
44;2021-01-12;140;106;248;349727;344491;49;694218
44;2021-01-12;125;128;256;381371;373239;59;754610
44;2021-01-12;91;88;182;367165;335850;69;703015
44;2021-01-12;92;67;159;250387;215436;79;465823
44;2021-01-12;101;54;157;170825;105192;89;276017
44;2021-01-12;76;24;101;51248;16731;90;67979
44;2021-01-12;1060;846;1924;2826745;2685002;0;5511747
52;2021-01-12;13;18;35;213594;223900;09;437494
52;2021-01-12;55;68;124;240818;255197;19;496015
52;2021-01-12;55;44;99;197010;200630;29;397640
52;2021-01-12;75;45;120;231204;224885;39;456089
52;2021-01-12;72;62;135;243874;243418;49;487292
52;2021-01-12;75;57;132;244100;239116;59;483216
52;2021-01-12;47;49;96;241796;221345;69;463141
52;2021-01-12;30;32;62;177805;149903;79;327708
52;2021-01-12;55;24;80;119561;75822;89;195383
52;2021-01-12;47;10;57;42559;15260;90;57819
52;2021-01-12;524;409;940;1952321;1849476;0;3801797
53;2021-01-12;6;13;19;173813;182358;09;356171
53;2021-01-12;35;29;66;202720;214740;19;417460
53;2021-01-12;42;37;80;163116;173196;29;336312
53;2021-01-12;26;36;62;190526;187674;39;378200
53;2021-01-12;40;31;71;212098;212015;49;424113
53;2021-01-12;36;23;59;223699;219176;59;442875
53;2021-01-12;19;27;46;227435;209274;69;436709
53;2021-01-12;21;8;29;169992;140910;79;310902
53;2021-01-12;33;16;49;118117;69883;89;188000
53;2021-01-12;27;7;36;37370;12267;90;49637
53;2021-01-12;285;227;517;1718886;1621493;0;3340379
75;2021-01-12;17;19;37;293104;305291;09;598395
75;2021-01-12;77;87;165;337141;357785;19;694926
75;2021-01-12;101;94;195;295024;300618;29;595642
75;2021-01-12;103;81;184;347871;331233;39;679104
75;2021-01-12;141;103;245;384742;372771;49;757513
75;2021-01-12;97;100;198;413361;390880;59;804241
75;2021-01-12;80;69;149;425623;384060;69;809683
75;2021-01-12;63;54;117;325086;276298;79;601384
75;2021-01-12;90;51;142;213986;139308;89;353294
75;2021-01-12;67;24;91;77600;28200;90;105800
75;2021-01-12;836;682;1523;3113538;2886444;0;5999982
76;2021-01-12;29;27;57;305956;318589;09;624545
76;2021-01-12;114;112;227;338942;356969;19;695911
76;2021-01-12;158;105;263;316210;319570;29;635780
76;2021-01-12;162;105;267;356758;337587;39;694345
76;2021-01-12;152;91;243;376541;363812;49;740353
76;2021-01-12;137;126;264;402608;383750;59;786358
76;2021-01-12;100;91;191;394889;358997;69;753886
76;2021-01-12;66;62;128;308664;263806;79;572470
76;2021-01-12;79;51;130;195838;129272;89;325110
76;2021-01-12;85;30;115;69372;26728;90;96100
76;2021-01-12;1085;800;1888;3065778;2859080;0;5924858
84;2021-01-12;47;46;94;459549;481088;09;940637
84;2021-01-12;163;191;354;487711;511905;19;999616
84;2021-01-12;201;200;401;443824;451094;29;894918
84;2021-01-12;230;166;396;512522;493262;39;1005784
84;2021-01-12;203;184;387;520248;515106;49;1035354
84;2021-01-12;208;185;393;529611;514848;59;1044459
84;2021-01-12;141;123;265;486720;439940;69;926660
84;2021-01-12;117;111;228;372151;315211;79;687362
84;2021-01-12;125;78;203;237198;150524;89;387722
84;2021-01-12;87;26;113;81185;28680;90;109865
84;2021-01-12;1524;1310;2836;4130719;3901658;0;8032377
93;2021-01-12;40;40;80;268834;283093;09;551927
93;2021-01-12;145;154;300;280751;296087;19;576838
93;2021-01-12;222;154;376;254404;255552;29;509956
93;2021-01-12;203;157;360;310704;288398;39;599102
93;2021-01-12;224;190;414;325559;305827;49;631386
93;2021-01-12;239;181;420;353104;325389;59;678493
93;2021-01-12;133;153;286;336327;296459;69;632786
93;2021-01-12;116;103;219;279820;229699;79;509519
93;2021-01-12;139;70;212;171274;113716;89;284990
93;2021-01-12;111;18;129;58896;21758;90;80654
93;2021-01-12;1572;1221;2797;2639673;2415978;0;5055651
94;2021-01-12;1;0;1;16311;17433;09;33744
94;2021-01-12;1;7;8;16679;18132;19;34811
94;2021-01-12;6;5;11;16782;16579;29;33361
94;2021-01-12;7;6;13;23044;20580;39;43624
94;2021-01-12;5;5;10;23065;22140;49;45205
94;2021-01-12;2;4;6;24549;23421;59;47970
94;2021-01-12;4;1;5;23212;21883;69;45095
94;2021-01-12;0;1;1;19544;17141;79;36685
94;2021-01-12;1;3;4;11227;8178;89;19405
94;2021-01-12;1;1;2;3332;1447;90;4779
94;2021-01-12;28;33;61;177745;166934;0;344679
01;2021-01-13;1;0;1;19979;20155;09;40134
01;2021-01-13;0;2;2;24994;25489;19;50483
01;2021-01-13;0;2;2;17868;16690;29;34558
01;2021-01-13;1;1;2;22328;14821;39;37149
01;2021-01-13;4;1;5;28652;20276;49;48928
01;2021-01-13;2;2;4;33264;27260;59;60524
01;2021-01-13;0;1;1;27135;23978;69;51113
01;2021-01-13;0;1;1;18401;14661;79;33062
01;2021-01-13;2;0;2;9633;6375;89;16008
01;2021-01-13;1;0;1;3410;1510;90;4920
01;2021-01-13;11;10;21;205664;171215;0;376879
02;2021-01-13;0;0;0;16881;17110;09;33991
02;2021-01-13;2;0;2;21410;21604;19;43014
02;2021-01-13;3;0;3;16017;15479;29;31496
02;2021-01-13;1;1;2;19825;14455;39;34280
02;2021-01-13;1;0;1;24719;18248;49;42967
02;2021-01-13;1;2;3;34361;28310;59;62671
02;2021-01-13;0;0;0;28061;24495;69;52556
02;2021-01-13;0;0;0;18231;15278;79;33509
02;2021-01-13;1;0;1;11090;7677;89;18767
02;2021-01-13;0;0;0;3992;1506;90;5498
02;2021-01-13;9;3;12;194587;164162;0;358749
03;2021-01-13;1;2;3;31123;30920;09;62043
03;2021-01-13;10;4;14;29370;29268;19;58638
03;2021-01-13;21;8;29;21458;18963;29;40421
03;2021-01-13;16;6;22;21276;18326;39;39602
03;2021-01-13;11;5;16;18164;16593;49;34757
03;2021-01-13;6;9;15;13469;13557;59;27026
03;2021-01-13;6;4;10;8776;8670;69;17446
03;2021-01-13;0;1;1;3777;3591;79;7368
03;2021-01-13;0;0;0;1649;1072;89;2721
03;2021-01-13;0;0;0;485;184;90;669
03;2021-01-13;71;39;110;149547;141144;0;290691
04;2021-01-13;0;0;0;60314;61377;09;121691
04;2021-01-13;3;1;4;66065;68387;19;134452
04;2021-01-13;1;1;2;51059;47156;29;98215
04;2021-01-13;4;2;6;58788;45780;39;104568
04;2021-01-13;4;4;8;61408;52207;49;113615
04;2021-01-13;4;1;5;64838;60759;59;125597
04;2021-01-13;1;3;4;47008;42843;69;89851
04;2021-01-13;1;1;2;25509;21184;79;46693
04;2021-01-13;0;0;0;13168;7647;89;20815
04;2021-01-13;0;0;0;3209;1253;90;4462
04;2021-01-13;18;13;31;451366;408593;0;859959
05;2021-01-13;0;0;0;362.366008612902;341.338819562748;09;703.704828175651
05;2021-01-13;0;0;0;353.376145114279;370.349735405642;19;723.725880519921
05;2021-01-13;0;0;0;218.593559489256;256.539602589476;29;475.133162078732
05;2021-01-13;0;0;0;404.225408693299;360.321910454353;39;764.547319147651
05;2021-01-13;0;0;0;520.067953604221;497.108383964256;49;1017.17633756848
05;2021-01-13;0;0;0;468.146063921917;510.087601910415;59;978.233665832332
05;2021-01-13;0;1;1;340.368470050554;334.366842191253;69;674.735312241807
05;2021-01-13;0;0;0;212.598666888387;192.597753227106;79;405.196420115493
05;2021-01-13;0;0;0;148.727797095705;61.8681715431829;89;210.595968638888
05;2021-01-13;0;0;0;32.9601271090696;10.9909785719784;90;43.9511056810479
05;2021-01-13;0;1;1;3061.43020057959;2935.56979942041;0;5997
06;2021-01-13;1;0;1;42583;42380;09;84963
06;2021-01-13;8;7;15;33369;31925;19;65294
06;2021-01-13;10;8;18;21571;15080;29;36651
06;2021-01-13;13;9;22;21550;16147;39;37697
06;2021-01-13;12;10;22;14193;13939;49;28132
06;2021-01-13;3;2;5;7171;7597;59;14768
06;2021-01-13;3;2;5;3629;4117;69;7746
06;2021-01-13;0;0;0;1577;1457;79;3034
06;2021-01-13;0;0;0;531;474;89;1005
06;2021-01-13;0;0;0;88;93;90;181
06;2021-01-13;50;38;88;146262;133209;0;279471
07;2021-01-13;0;0;0;485;549;09;1034
07;2021-01-13;0;0;0;403;432;19;835
07;2021-01-13;1;0;1;764;841;29;1605
07;2021-01-13;1;2;3;824;928;39;1752
07;2021-01-13;0;0;0;788;1020;49;1808
07;2021-01-13;0;0;0;678;870;59;1548
07;2021-01-13;1;0;1;360;382;69;742
07;2021-01-13;0;0;0;231;190;79;421
07;2021-01-13;0;0;0;114;67;89;181
07;2021-01-13;0;0;0;24;11;90;35
07;2021-01-13;3;2;5;4671;5290;0;9961
08;2021-01-13;0;0;0;2715.22592983026;2997.75551488675;09;5712.98144471701
08;2021-01-13;1;0;1;2778.51901080978;3160.9156459093;19;5939.43465671908
08;2021-01-13;3;0;3;2080.8882988764;1718.16634315323;29;3799.05464202964
08;2021-01-13;3;1;4;2701.8582062647;1896.52641413317;39;4598.38462039786
08;2021-01-13;1;0;1;3151.45861023308;2460.52498233809;49;5611.98359257117
08;2021-01-13;1;1;2;2620.29868333099;2422.23566154656;59;5042.53434487755
08;2021-01-13;2;1;3;1621.44173420671;1438.58325779464;69;3060.02499200135
08;2021-01-13;0;0;0;626.575909335673;526.358467843651;79;1152.93437717932
08;2021-01-13;0;0;0;205.018522985054;140.993639349697;89;346.012162334751
08;2021-01-13;0;0;0;50.0325684687745;20.62259870351;90;70.6551671722846
08;2021-01-13;11;3;14;18551.3174743414;16782.6825256586;0;35334
11;2021-01-13;78;59;144;783071;811785;09;1594856
11;2021-01-13;259;246;522;761456;784653;19;1546109
11;2021-01-13;393;338;734;850145;801772;29;1651917
11;2021-01-13;368;352;723;914360;843488;39;1757848
11;2021-01-13;340;265;606;845609;826202;49;1671811
11;2021-01-13;277;241;518;793566;745070;59;1538636
11;2021-01-13;151;163;315;628649;549192;69;1177841
11;2021-01-13;69;95;164;434606;358356;79;792962
11;2021-01-13;69;52;121;261425;162933;89;424358
11;2021-01-13;47;15;62;89253;32619;90;121872
11;2021-01-13;2051;1829;3912;6362140;5916070;0;12278210
24;2021-01-13;9;11;20;139720;144686;09;284406
24;2021-01-13;52;59;115;152979;161185;19;314164
24;2021-01-13;52;51;103;122237;126536;29;248773
24;2021-01-13;56;33;89;150359;142009;39;292368
24;2021-01-13;51;34;85;161829;158758;49;320587
24;2021-01-13;60;59;119;172552;168011;59;340563
24;2021-01-13;34;35;69;172509;158177;69;330686
24;2021-01-13;26;23;49;129428;110593;79;240021
24;2021-01-13;42;15;57;87342;56882;89;144224
24;2021-01-13;21;6;27;31210;12071;90;43281
24;2021-01-13;403;326;733;1320165;1238908;0;2559073
27;2021-01-13;21;19;40;143373;149679;09;293052
27;2021-01-13;82;65;148;160962;173003;19;333965
27;2021-01-13;82;45;127;133746;142254;29;276000
27;2021-01-13;59;35;94;160004;155407;39;315411
27;2021-01-13;90;51;141;172333;169564;49;341897
27;2021-01-13;79;59;138;189979;183788;59;373767
27;2021-01-13;59;57;116;192591;178206;69;370797
27;2021-01-13;56;45;101;146876;127546;79;274422
27;2021-01-13;49;31;80;96896;61575;89;158471
27;2021-01-13;21;12;33;33148;12109;90;45257
27;2021-01-13;598;419;1018;1429908;1353131;0;2783039
28;2021-01-13;22;23;45;180735;186856;09;367591
28;2021-01-13;74;48;122;200125;213621;19;413746
28;2021-01-13;61;70;131;168922;173007;29;341929
28;2021-01-13;71;56;127;196628;188487;39;385115
28;2021-01-13;85;61;146;205396;201699;49;407095
28;2021-01-13;71;53;124;222002;213866;59;435868
28;2021-01-13;44;55;99;224688;203758;69;428446
28;2021-01-13;31;31;62;163192;135543;79;298735
28;2021-01-13;55;13;68;109691;65377;89;175068
28;2021-01-13;42;7;49;37222;12685;90;49907
28;2021-01-13;556;417;973;1708601;1594899;0;3303500
32;2021-01-13;27;34;63;358062;373689;09;731751
32;2021-01-13;128;118;246;387045;406742;19;793787
32;2021-01-13;163;114;277;342304;348587;29;690891
32;2021-01-13;147;132;279;382485;369972;39;752457
32;2021-01-13;138;123;261;382510;376716;49;759226
32;2021-01-13;143;124;267;386937;376527;59;763464
32;2021-01-13;94;79;173;371211;330938;69;702149
32;2021-01-13;62;55;117;250542;201459;79;452001
32;2021-01-13;76;40;116;163399;89786;89;253185
32;2021-01-13;55;18;73;48384;15367;90;63751
32;2021-01-13;1033;837;1872;3072879;2889783;0;5962662
44;2021-01-13;23;22;46;291525;306839;09;598364
44;2021-01-13;111;135;249;320255;339504;19;659759
44;2021-01-13;119;114;233;302020;314428;29;616448
44;2021-01-13;117;105;223;342222;333292;39;675514
44;2021-01-13;124;98;223;349727;344491;49;694218
44;2021-01-13;113;106;219;381371;373239;59;754610
44;2021-01-13;76;82;160;367165;335850;69;703015
44;2021-01-13;61;71;132;250387;215436;79;465823
44;2021-01-13;83;52;136;170825;105192;89;276017
44;2021-01-13;58;14;73;51248;16731;90;67979
44;2021-01-13;885;799;1694;2826745;2685002;0;5511747
52;2021-01-13;9;13;23;213594;223900;09;437494
52;2021-01-13;65;54;121;240818;255197;19;496015
52;2021-01-13;80;58;139;197010;200630;29;397640
52;2021-01-13;73;52;125;231204;224885;39;456089
52;2021-01-13;73;68;142;243874;243418;49;487292
52;2021-01-13;71;68;139;244100;239116;59;483216
52;2021-01-13;47;62;109;241796;221345;69;463141
52;2021-01-13;37;35;72;177805;149903;79;327708
52;2021-01-13;90;34;124;119561;75822;89;195383
52;2021-01-13;76;20;96;42559;15260;90;57819
52;2021-01-13;621;464;1090;1952321;1849476;0;3801797
53;2021-01-13;10;11;22;173813;182358;09;356171
53;2021-01-13;33;40;74;202720;214740;19;417460
53;2021-01-13;48;36;84;163116;173196;29;336312
53;2021-01-13;41;21;62;190526;187674;39;378200
53;2021-01-13;38;41;79;212098;212015;49;424113
53;2021-01-13;36;27;63;223699;219176;59;442875
53;2021-01-13;22;21;43;227435;209274;69;436709
53;2021-01-13;16;17;33;169992;140910;79;310902
53;2021-01-13;23;10;33;118117;69883;89;188000
53;2021-01-13;31;8;39;37370;12267;90;49637
53;2021-01-13;298;232;532;1718886;1621493;0;3340379
75;2021-01-13;34;30;64;293104;305291;09;598395
75;2021-01-13;101;91;192;337141;357785;19;694926
75;2021-01-13;115;92;207;295024;300618;29;595642
75;2021-01-13;108;99;207;347871;331233;39;679104
75;2021-01-13;134;99;233;384742;372771;49;757513
75;2021-01-13;95;102;197;413361;390880;59;804241
75;2021-01-13;80;68;149;425623;384060;69;809683
75;2021-01-13;48;54;102;325086;276298;79;601384
75;2021-01-13;74;45;119;213986;139308;89;353294
75;2021-01-13;85;23;108;77600;28200;90;105800
75;2021-01-13;874;703;1578;3113538;2886444;0;5999982
76;2021-01-13;25;35;61;305956;318589;09;624545
76;2021-01-13;94;118;214;338942;356969;19;695911
76;2021-01-13;137;111;248;316210;319570;29;635780
76;2021-01-13;126;103;229;356758;337587;39;694345
76;2021-01-13;145;116;261;376541;363812;49;740353
76;2021-01-13;119;112;231;402608;383750;59;786358
76;2021-01-13;95;76;171;394889;358997;69;753886
76;2021-01-13;74;55;129;308664;263806;79;572470
76;2021-01-13;87;50;137;195838;129272;89;325110
76;2021-01-13;54;32;86;69372;26728;90;96100
76;2021-01-13;956;809;1768;3065778;2859080;0;5924858
84;2021-01-13;46;34;81;459549;481088;09;940637
84;2021-01-13;158;206;366;487711;511905;19;999616
84;2021-01-13;213;182;396;443824;451094;29;894918
84;2021-01-13;187;180;368;512522;493262;39;1005784
84;2021-01-13;207;167;374;520248;515106;49;1035354
84;2021-01-13;206;184;390;529611;514848;59;1044459
84;2021-01-13;124;116;240;486720;439940;69;926660
84;2021-01-13;100;99;199;372151;315211;79;687362
84;2021-01-13;105;69;174;237198;150524;89;387722
84;2021-01-13;116;29;145;81185;28680;90;109865
84;2021-01-13;1462;1267;2734;4130719;3901658;0;8032377
93;2021-01-13;23;43;66;268834;283093;09;551927
93;2021-01-13;141;173;315;280751;296087;19;576838
93;2021-01-13;203;185;388;254404;255552;29;509956
93;2021-01-13;191;160;352;310704;288398;39;599102
93;2021-01-13;200;161;361;325559;305827;49;631386
93;2021-01-13;225;181;407;353104;325389;59;678493
93;2021-01-13;150;134;284;336327;296459;69;632786
93;2021-01-13;88;74;163;279820;229699;79;509519
93;2021-01-13;94;59;153;171274;113716;89;284990
93;2021-01-13;90;25;115;58896;21758;90;80654
93;2021-01-13;1405;1195;2604;2639673;2415978;0;5055651
94;2021-01-13;1;1;2;16311;17433;09;33744
94;2021-01-13;2;7;9;16679;18132;19;34811
94;2021-01-13;2;7;9;16782;16579;29;33361
94;2021-01-13;2;4;6;23044;20580;39;43624
94;2021-01-13;3;2;5;23065;22140;49;45205
94;2021-01-13;2;1;3;24549;23421;59;47970
94;2021-01-13;2;2;4;23212;21883;69;45095
94;2021-01-13;3;7;10;19544;17141;79;36685
94;2021-01-13;2;2;4;11227;8178;89;19405
94;2021-01-13;1;0;1;3332;1447;90;4779
94;2021-01-13;20;33;53;177745;166934;0;344679
01;2021-01-14;0;1;1;19979;20155;09;40134
01;2021-01-14;0;1;1;24994;25489;19;50483
01;2021-01-14;1;1;2;17868;16690;29;34558
01;2021-01-14;0;0;0;22328;14821;39;37149
01;2021-01-14;0;1;1;28652;20276;49;48928
01;2021-01-14;2;1;3;33264;27260;59;60524
01;2021-01-14;0;1;1;27135;23978;69;51113
01;2021-01-14;1;2;3;18401;14661;79;33062
01;2021-01-14;0;1;1;9633;6375;89;16008
01;2021-01-14;0;0;0;3410;1510;90;4920
01;2021-01-14;4;9;13;205664;171215;0;376879
02;2021-01-14;0;0;0;16881;17110;09;33991
02;2021-01-14;0;0;0;21410;21604;19;43014
02;2021-01-14;1;1;2;16017;15479;29;31496
02;2021-01-14;0;0;0;19825;14455;39;34280
02;2021-01-14;0;0;0;24719;18248;49;42967
02;2021-01-14;1;2;3;34361;28310;59;62671
02;2021-01-14;0;2;2;28061;24495;69;52556
02;2021-01-14;0;0;0;18231;15278;79;33509
02;2021-01-14;0;0;0;11090;7677;89;18767
02;2021-01-14;0;0;0;3992;1506;90;5498
02;2021-01-14;2;5;7;194587;164162;0;358749
03;2021-01-14;0;1;1;31123;30920;09;62043
03;2021-01-14;15;10;25;29370;29268;19;58638
03;2021-01-14;13;9;23;21458;18963;29;40421
03;2021-01-14;26;11;37;21276;18326;39;39602
03;2021-01-14;11;9;20;18164;16593;49;34757
03;2021-01-14;7;6;13;13469;13557;59;27026
03;2021-01-14;6;4;10;8776;8670;69;17446
03;2021-01-14;1;0;1;3777;3591;79;7368
03;2021-01-14;0;1;1;1649;1072;89;2721
03;2021-01-14;1;0;1;485;184;90;669
03;2021-01-14;80;51;132;149547;141144;0;290691
04;2021-01-14;0;2;2;60314;61377;09;121691
04;2021-01-14;6;3;9;66065;68387;19;134452
04;2021-01-14;3;2;5;51059;47156;29;98215
04;2021-01-14;4;0;4;58788;45780;39;104568
04;2021-01-14;7;4;11;61408;52207;49;113615
04;2021-01-14;4;2;6;64838;60759;59;125597
04;2021-01-14;3;1;4;47008;42843;69;89851
04;2021-01-14;0;0;0;25509;21184;79;46693
04;2021-01-14;0;0;0;13168;7647;89;20815
04;2021-01-14;0;0;0;3209;1253;90;4462
04;2021-01-14;27;14;41;451366;408593;0;859959
05;2021-01-14;0;0;0;362.366008612902;341.338819562748;09;703.704828175651
05;2021-01-14;0;0;0;353.376145114279;370.349735405642;19;723.725880519921
05;2021-01-14;0;0;0;218.593559489256;256.539602589476;29;475.133162078732
05;2021-01-14;0;0;0;404.225408693299;360.321910454353;39;764.547319147651
05;2021-01-14;0;0;0;520.067953604221;497.108383964256;49;1017.17633756848
05;2021-01-14;0;0;0;468.146063921917;510.087601910415;59;978.233665832332
05;2021-01-14;0;0;0;340.368470050554;334.366842191253;69;674.735312241807
05;2021-01-14;0;0;0;212.598666888387;192.597753227106;79;405.196420115493
05;2021-01-14;0;0;0;148.727797095705;61.8681715431829;89;210.595968638888
05;2021-01-14;0;0;0;32.9601271090696;10.9909785719784;90;43.9511056810479
05;2021-01-14;0;0;0;3061.43020057959;2935.56979942041;0;5997
06;2021-01-14;1;0;1;42583;42380;09;84963
06;2021-01-14;5;3;8;33369;31925;19;65294
06;2021-01-14;7;7;14;21571;15080;29;36651
06;2021-01-14;9;7;16;21550;16147;39;37697
06;2021-01-14;9;15;24;14193;13939;49;28132
06;2021-01-14;3;13;16;7171;7597;59;14768
06;2021-01-14;1;7;8;3629;4117;69;7746
06;2021-01-14;3;0;3;1577;1457;79;3034
06;2021-01-14;1;0;1;531;474;89;1005
06;2021-01-14;0;0;0;88;93;90;181
06;2021-01-14;39;52;91;146262;133209;0;279471
07;2021-01-14;0;0;0;485;549;09;1034
07;2021-01-14;0;1;1;403;432;19;835
07;2021-01-14;2;0;2;764;841;29;1605
07;2021-01-14;0;2;2;824;928;39;1752
07;2021-01-14;0;7;7;788;1020;49;1808
07;2021-01-14;2;0;2;678;870;59;1548
07;2021-01-14;0;2;2;360;382;69;742
07;2021-01-14;0;0;0;231;190;79;421
07;2021-01-14;0;0;0;114;67;89;181
07;2021-01-14;0;0;0;24;11;90;35
07;2021-01-14;4;12;16;4671;5290;0;9961
08;2021-01-14;0;0;0;2715.22592983026;2997.75551488675;09;5712.98144471701
08;2021-01-14;0;0;0;2778.51901080978;3160.9156459093;19;5939.43465671908
08;2021-01-14;1;1;2;2080.8882988764;1718.16634315323;29;3799.05464202964
08;2021-01-14;1;1;2;2701.8582062647;1896.52641413317;39;4598.38462039786
08;2021-01-14;2;2;4;3151.45861023308;2460.52498233809;49;5611.98359257117
08;2021-01-14;1;2;3;2620.29868333099;2422.23566154656;59;5042.53434487755
08;2021-01-14;1;0;1;1621.44173420671;1438.58325779464;69;3060.02499200135
08;2021-01-14;0;0;0;626.575909335673;526.358467843651;79;1152.93437717932
08;2021-01-14;0;0;0;205.018522985054;140.993639349697;89;346.012162334751
08;2021-01-14;0;0;0;50.0325684687745;20.62259870351;90;70.6551671722846
08;2021-01-14;6;6;12;18551.3174743414;16782.6825256586;0;35334
11;2021-01-14;52;61;116;783071;811785;09;1594856
11;2021-01-14;224;241;486;761456;784653;19;1546109
11;2021-01-14;382;328;714;850145;801772;29;1651917
11;2021-01-14;395;345;741;914360;843488;39;1757848
11;2021-01-14;320;284;605;845609;826202;49;1671811
11;2021-01-14;275;213;490;793566;745070;59;1538636
11;2021-01-14;170;167;340;628649;549192;69;1177841
11;2021-01-14;78;94;172;434606;358356;79;792962
11;2021-01-14;91;45;136;261425;162933;89;424358
11;2021-01-14;64;16;80;89253;32619;90;121872
11;2021-01-14;2053;1796;3885;6362140;5916070;0;12278210
24;2021-01-14;8;4;12;139720;144686;09;284406
24;2021-01-14;51;50;101;152979;161185;19;314164
24;2021-01-14;55;33;88;122237;126536;29;248773
24;2021-01-14;63;52;115;150359;142009;39;292368
24;2021-01-14;62;44;106;161829;158758;49;320587
24;2021-01-14;71;44;115;172552;168011;59;340563
24;2021-01-14;25;36;61;172509;158177;69;330686
24;2021-01-14;42;30;72;129428;110593;79;240021
24;2021-01-14;21;18;39;87342;56882;89;144224
24;2021-01-14;17;10;27;31210;12071;90;43281
24;2021-01-14;415;321;736;1320165;1238908;0;2559073
27;2021-01-14;14;15;29;143373;149679;09;293052
27;2021-01-14;78;63;141;160962;173003;19;333965
27;2021-01-14;68;61;129;133746;142254;29;276000
27;2021-01-14;65;59;124;160004;155407;39;315411
27;2021-01-14;78;64;142;172333;169564;49;341897
27;2021-01-14;67;81;148;189979;183788;59;373767
27;2021-01-14;57;61;118;192591;178206;69;370797
27;2021-01-14;55;43;98;146876;127546;79;274422
27;2021-01-14;48;38;86;96896;61575;89;158471
27;2021-01-14;44;7;51;33148;12109;90;45257
27;2021-01-14;574;492;1066;1429908;1353131;0;2783039
28;2021-01-14;15;12;29;180735;186856;09;367591
28;2021-01-14;55;57;112;200125;213621;19;413746
28;2021-01-14;90;60;150;168922;173007;29;341929
28;2021-01-14;77;62;139;196628;188487;39;385115
28;2021-01-14;70;53;123;205396;201699;49;407095
28;2021-01-14;74;62;136;222002;213866;59;435868
28;2021-01-14;46;51;97;224688;203758;69;428446
28;2021-01-14;39;36;75;163192;135543;79;298735
28;2021-01-14;63;37;100;109691;65377;89;175068
28;2021-01-14;54;9;63;37222;12685;90;49907
28;2021-01-14;583;439;1024;1708601;1594899;0;3303500
32;2021-01-14;29;48;78;358062;373689;09;731751
32;2021-01-14;132;127;260;387045;406742;19;793787
32;2021-01-14;162;125;287;342304;348587;29;690891
32;2021-01-14;145;143;290;382485;369972;39;752457
32;2021-01-14;157;139;296;382510;376716;49;759226
32;2021-01-14;148;144;292;386937;376527;59;763464
32;2021-01-14;103;86;189;371211;330938;69;702149
32;2021-01-14;74;68;142;250542;201459;79;452001
32;2021-01-14;89;44;133;163399;89786;89;253185
32;2021-01-14;53;15;68;48384;15367;90;63751
32;2021-01-14;1092;939;2035;3072879;2889783;0;5962662
44;2021-01-14;29;37;66;291525;306839;09;598364
44;2021-01-14;99;101;201;320255;339504;19;659759
44;2021-01-14;157;127;285;302020;314428;29;616448
44;2021-01-14;140;102;246;342222;333292;39;675514
44;2021-01-14;131;92;223;349727;344491;49;694218
44;2021-01-14;143;103;246;381371;373239;59;754610
44;2021-01-14;73;94;167;367165;335850;69;703015
44;2021-01-14;56;61;117;250387;215436;79;465823
44;2021-01-14;90;51;141;170825;105192;89;276017
44;2021-01-14;75;20;95;51248;16731;90;67979
44;2021-01-14;993;788;1799;2826745;2685002;0;5511747
52;2021-01-14;12;16;30;213594;223900;09;437494
52;2021-01-14;55;49;105;240818;255197;19;496015
52;2021-01-14;87;56;143;197010;200630;29;397640
52;2021-01-14;73;47;120;231204;224885;39;456089
52;2021-01-14;65;62;127;243874;243418;49;487292
52;2021-01-14;61;47;108;244100;239116;59;483216
52;2021-01-14;56;52;108;241796;221345;69;463141
52;2021-01-14;38;38;77;177805;149903;79;327708
52;2021-01-14;38;24;62;119561;75822;89;195383
52;2021-01-14;35;10;45;42559;15260;90;57819
52;2021-01-14;520;401;925;1952321;1849476;0;3801797
53;2021-01-14;10;11;21;173813;182358;09;356171
53;2021-01-14;25;42;67;202720;214740;19;417460
53;2021-01-14;53;42;100;163116;173196;29;336312
53;2021-01-14;40;34;74;190526;187674;39;378200
53;2021-01-14;40;23;63;212098;212015;49;424113
53;2021-01-14;31;38;69;223699;219176;59;442875
53;2021-01-14;22;18;40;227435;209274;69;436709
53;2021-01-14;12;15;27;169992;140910;79;310902
53;2021-01-14;14;7;21;118117;69883;89;188000
53;2021-01-14;17;4;24;37370;12267;90;49637
53;2021-01-14;264;234;506;1718886;1621493;0;3340379
75;2021-01-14;31;32;63;293104;305291;09;598395
75;2021-01-14;82;105;187;337141;357785;19;694926
75;2021-01-14;124;108;232;295024;300618;29;595642
75;2021-01-14;123;87;210;347871;331233;39;679104
75;2021-01-14;121;73;194;384742;372771;49;757513
75;2021-01-14;128;87;215;413361;390880;59;804241
75;2021-01-14;67;71;138;425623;384060;69;809683
75;2021-01-14;52;53;105;325086;276298;79;601384
75;2021-01-14;63;45;108;213986;139308;89;353294
75;2021-01-14;43;16;59;77600;28200;90;105800
75;2021-01-14;834;677;1511;3113538;2886444;0;5999982
76;2021-01-14;25;24;51;305956;318589;09;624545
76;2021-01-14;97;88;188;338942;356969;19;695911
76;2021-01-14;130;112;242;316210;319570;29;635780
76;2021-01-14;136;121;257;356758;337587;39;694345
76;2021-01-14;146;113;259;376541;363812;49;740353
76;2021-01-14;141;95;236;402608;383750;59;786358
76;2021-01-14;92;91;183;394889;358997;69;753886
76;2021-01-14;73;75;148;308664;263806;79;572470
76;2021-01-14;101;49;150;195838;129272;89;325110
76;2021-01-14;95;34;129;69372;26728;90;96100
76;2021-01-14;1036;803;1844;3065778;2859080;0;5924858
84;2021-01-14;42;47;89;459549;481088;09;940637
84;2021-01-14;152;166;319;487711;511905;19;999616
84;2021-01-14;200;184;384;443824;451094;29;894918
84;2021-01-14;202;199;401;512522;493262;39;1005784
84;2021-01-14;207;170;377;520248;515106;49;1035354
84;2021-01-14;177;185;362;529611;514848;59;1044459
84;2021-01-14;104;126;230;486720;439940;69;926660
84;2021-01-14;125;80;205;372151;315211;79;687362
84;2021-01-14;91;67;158;237198;150524;89;387722
84;2021-01-14;76;26;102;81185;28680;90;109865
84;2021-01-14;1376;1250;2627;4130719;3901658;0;8032377
93;2021-01-14;41;32;75;268834;283093;09;551927
93;2021-01-14;160;146;307;280751;296087;19;576838
93;2021-01-14;215;153;369;254404;255552;29;509956
93;2021-01-14;224;172;396;310704;288398;39;599102
93;2021-01-14;217;185;403;325559;305827;49;631386
93;2021-01-14;226;190;417;353104;325389;59;678493
93;2021-01-14;132;137;270;336327;296459;69;632786
93;2021-01-14;100;86;187;279820;229699;79;509519
93;2021-01-14;112;69;182;171274;113716;89;284990
93;2021-01-14;115;37;153;58896;21758;90;80654
93;2021-01-14;1543;1208;2825;2639673;2415978;0;5055651
94;2021-01-14;1;0;1;16311;17433;09;33744
94;2021-01-14;0;4;4;16679;18132;19;34811
94;2021-01-14;3;1;4;16782;16579;29;33361
94;2021-01-14;2;6;8;23044;20580;39;43624
94;2021-01-14;1;1;2;23065;22140;49;45205
94;2021-01-14;4;5;9;24549;23421;59;47970
94;2021-01-14;3;3;6;23212;21883;69;45095
94;2021-01-14;3;0;3;19544;17141;79;36685
94;2021-01-14;2;4;6;11227;8178;89;19405
94;2021-01-14;1;0;1;3332;1447;90;4779
94;2021-01-14;20;24;44;177745;166934;0;344679
01;2021-01-15;0;0;0;19979;20155;09;40134
01;2021-01-15;0;2;2;24994;25489;19;50483
01;2021-01-15;1;0;1;17868;16690;29;34558
01;2021-01-15;0;0;0;22328;14821;39;37149
01;2021-01-15;2;1;3;28652;20276;49;48928
01;2021-01-15;2;1;3;33264;27260;59;60524
01;2021-01-15;0;0;0;27135;23978;69;51113
01;2021-01-15;0;0;0;18401;14661;79;33062
01;2021-01-15;0;0;0;9633;6375;89;16008
01;2021-01-15;1;0;1;3410;1510;90;4920
01;2021-01-15;6;4;10;205664;171215;0;376879
02;2021-01-15;0;0;0;16881;17110;09;33991
02;2021-01-15;1;2;3;21410;21604;19;43014
02;2021-01-15;0;1;1;16017;15479;29;31496
02;2021-01-15;1;2;3;19825;14455;39;34280
02;2021-01-15;2;2;4;24719;18248;49;42967
02;2021-01-15;2;0;2;34361;28310;59;62671
02;2021-01-15;1;0;1;28061;24495;69;52556
02;2021-01-15;0;0;0;18231;15278;79;33509
02;2021-01-15;1;0;1;11090;7677;89;18767
02;2021-01-15;0;0;0;3992;1506;90;5498
02;2021-01-15;8;7;15;194587;164162;0;358749
03;2021-01-15;3;3;6;31123;30920;09;62043
03;2021-01-15;23;9;32;29370;29268;19;58638
03;2021-01-15;18;14;32;21458;18963;29;40421
03;2021-01-15;14;11;25;21276;18326;39;39602
03;2021-01-15;13;13;26;18164;16593;49;34757
03;2021-01-15;8;16;24;13469;13557;59;27026
03;2021-01-15;9;4;13;8776;8670;69;17446
03;2021-01-15;1;0;1;3777;3591;79;7368
03;2021-01-15;0;1;1;1649;1072;89;2721
03;2021-01-15;0;0;0;485;184;90;669
03;2021-01-15;89;71;160;149547;141144;0;290691
04;2021-01-15;0;2;2;60314;61377;09;121691
04;2021-01-15;5;1;6;66065;68387;19;134452
04;2021-01-15;5;4;9;51059;47156;29;98215
04;2021-01-15;1;3;4;58788;45780;39;104568
04;2021-01-15;4;2;6;61408;52207;49;113615
04;2021-01-15;2;4;6;64838;60759;59;125597
04;2021-01-15;1;3;4;47008;42843;69;89851
04;2021-01-15;1;0;1;25509;21184;79;46693
04;2021-01-15;1;0;1;13168;7647;89;20815
04;2021-01-15;0;0;0;3209;1253;90;4462
04;2021-01-15;20;19;39;451366;408593;0;859959
05;2021-01-15;0;0;0;362.366008612902;341.338819562748;09;703.704828175651
05;2021-01-15;0;0;0;353.376145114279;370.349735405642;19;723.725880519921
05;2021-01-15;0;0;0;218.593559489256;256.539602589476;29;475.133162078732
05;2021-01-15;0;0;0;404.225408693299;360.321910454353;39;764.547319147651
05;2021-01-15;0;0;0;520.067953604221;497.108383964256;49;1017.17633756848
05;2021-01-15;0;0;0;468.146063921917;510.087601910415;59;978.233665832332
05;2021-01-15;0;0;0;340.368470050554;334.366842191253;69;674.735312241807
05;2021-01-15;0;0;0;212.598666888387;192.597753227106;79;405.196420115493
05;2021-01-15;0;0;0;148.727797095705;61.8681715431829;89;210.595968638888
05;2021-01-15;0;0;0;32.9601271090696;10.9909785719784;90;43.9511056810479
05;2021-01-15;0;0;0;3061.43020057959;2935.56979942041;0;5997
06;2021-01-15;0;0;0;42583;42380;09;84963
06;2021-01-15;6;8;14;33369;31925;19;65294
06;2021-01-15;9;6;15;21571;15080;29;36651
06;2021-01-15;17;6;23;21550;16147;39;37697
06;2021-01-15;6;12;18;14193;13939;49;28132
06;2021-01-15;9;4;13;7171;7597;59;14768
06;2021-01-15;2;5;7;3629;4117;69;7746
06;2021-01-15;0;2;2;1577;1457;79;3034
06;2021-01-15;0;0;0;531;474;89;1005
06;2021-01-15;1;0;1;88;93;90;181
06;2021-01-15;50;43;93;146262;133209;0;279471
07;2021-01-15;0;0;0;485;549;09;1034
07;2021-01-15;0;0;0;403;432;19;835
07;2021-01-15;0;3;3;764;841;29;1605
07;2021-01-15;3;1;4;824;928;39;1752
07;2021-01-15;0;0;0;788;1020;49;1808
07;2021-01-15;4;0;4;678;870;59;1548
07;2021-01-15;0;1;1;360;382;69;742
07;2021-01-15;0;0;0;231;190;79;421
07;2021-01-15;0;0;0;114;67;89;181
07;2021-01-15;0;0;0;24;11;90;35
07;2021-01-15;7;5;12;4671;5290;0;9961
08;2021-01-15;0;0;0;2715.22592983026;2997.75551488675;09;5712.98144471701
08;2021-01-15;1;0;1;2778.51901080978;3160.9156459093;19;5939.43465671908
08;2021-01-15;3;1;4;2080.8882988764;1718.16634315323;29;3799.05464202964
08;2021-01-15;2;4;6;2701.8582062647;1896.52641413317;39;4598.38462039786
08;2021-01-15;1;0;1;3151.45861023308;2460.52498233809;49;5611.98359257117
08;2021-01-15;1;0;1;2620.29868333099;2422.23566154656;59;5042.53434487755
08;2021-01-15;2;2;4;1621.44173420671;1438.58325779464;69;3060.02499200135
08;2021-01-15;0;0;0;626.575909335673;526.358467843651;79;1152.93437717932
08;2021-01-15;0;0;0;205.018522985054;140.993639349697;89;346.012162334751
08;2021-01-15;0;0;0;50.0325684687745;20.62259870351;90;70.6551671722846
08;2021-01-15;10;7;17;18551.3174743414;16782.6825256586;0;35334
11;2021-01-15;89;87;189;783071;811785;09;1594856
11;2021-01-15;257;271;552;761456;784653;19;1546109
11;2021-01-15;416;346;764;850145;801772;29;1651917
11;2021-01-15;382;346;732;914360;843488;39;1757848
11;2021-01-15;333;286;623;845609;826202;49;1671811
11;2021-01-15;268;249;517;793566;745070;59;1538636
11;2021-01-15;206;173;381;628649;549192;69;1177841
11;2021-01-15;116;85;201;434606;358356;79;792962
11;2021-01-15;80;62;142;261425;162933;89;424358
11;2021-01-15;49;28;77;89253;32619;90;121872
11;2021-01-15;2196;1934;4179;6362140;5916070;0;12278210
24;2021-01-15;10;13;25;139720;144686;09;284406
24;2021-01-15;55;56;112;152979;161185;19;314164
24;2021-01-15;51;45;96;122237;126536;29;248773
24;2021-01-15;71;42;113;150359;142009;39;292368
24;2021-01-15;75;50;125;161829;158758;49;320587
24;2021-01-15;58;62;120;172552;168011;59;340563
24;2021-01-15;40;53;93;172509;158177;69;330686
24;2021-01-15;42;37;79;129428;110593;79;240021
24;2021-01-15;35;19;54;87342;56882;89;144224
24;2021-01-15;23;13;36;31210;12071;90;43281
24;2021-01-15;460;390;853;1320165;1238908;0;2559073
27;2021-01-15;18;21;39;143373;149679;09;293052
27;2021-01-15;86;92;178;160962;173003;19;333965
27;2021-01-15;70;56;126;133746;142254;29;276000
27;2021-01-15;81;59;140;160004;155407;39;315411
27;2021-01-15;77;63;140;172333;169564;49;341897
27;2021-01-15;98;103;201;189979;183788;59;373767
27;2021-01-15;56;68;124;192591;178206;69;370797
27;2021-01-15;49;53;102;146876;127546;79;274422
27;2021-01-15;43;23;66;96896;61575;89;158471
27;2021-01-15;46;14;60;33148;12109;90;45257
27;2021-01-15;624;552;1176;1429908;1353131;0;2783039
28;2021-01-15;22;15;38;180735;186856;09;367591
28;2021-01-15;51;49;102;200125;213621;19;413746
28;2021-01-15;66;68;135;168922;173007;29;341929
28;2021-01-15;82;60;142;196628;188487;39;385115
28;2021-01-15;69;61;131;205396;201699;49;407095
28;2021-01-15;64;81;145;222002;213866;59;435868
28;2021-01-15;51;77;128;224688;203758;69;428446
28;2021-01-15;41;32;73;163192;135543;79;298735
28;2021-01-15;42;22;64;109691;65377;89;175068
28;2021-01-15;29;5;34;37222;12685;90;49907
28;2021-01-15;517;470;992;1708601;1594899;0;3303500
32;2021-01-15;44;42;86;358062;373689;09;731751
32;2021-01-15;174;145;320;387045;406742;19;793787
32;2021-01-15;132;125;257;342304;348587;29;690891
32;2021-01-15;172;127;299;382485;369972;39;752457
32;2021-01-15;147;125;272;382510;376716;49;759226
32;2021-01-15;164;150;315;386937;376527;59;763464
32;2021-01-15;82;77;159;371211;330938;69;702149
32;2021-01-15;82;57;139;250542;201459;79;452001
32;2021-01-15;76;52;128;163399;89786;89;253185
32;2021-01-15;43;14;57;48384;15367;90;63751
32;2021-01-15;1117;914;2033;3072879;2889783;0;5962662
44;2021-01-15;44;41;86;291525;306839;09;598364
44;2021-01-15;132;131;263;320255;339504;19;659759
44;2021-01-15;137;119;257;302020;314428;29;616448
44;2021-01-15;140;95;239;342222;333292;39;675514
44;2021-01-15;138;98;238;349727;344491;49;694218
44;2021-01-15;134;132;268;381371;373239;59;754610
44;2021-01-15;89;85;177;367165;335850;69;703015
44;2021-01-15;50;39;89;250387;215436;79;465823
44;2021-01-15;71;46;117;170825;105192;89;276017
44;2021-01-15;29;15;44;51248;16731;90;67979
44;2021-01-15;964;801;1779;2826745;2685002;0;5511747
52;2021-01-15;26;24;53;213594;223900;09;437494
52;2021-01-15;65;76;142;240818;255197;19;496015
52;2021-01-15;79;73;153;197010;200630;29;397640
52;2021-01-15;68;56;124;231204;224885;39;456089
52;2021-01-15;70;73;144;243874;243418;49;487292
52;2021-01-15;68;78;146;244100;239116;59;483216
52;2021-01-15;43;50;93;241796;221345;69;463141
52;2021-01-15;28;28;56;177805;149903;79;327708
52;2021-01-15;32;19;51;119561;75822;89;195383
52;2021-01-15;9;8;17;42559;15260;90;57819
52;2021-01-15;488;485;979;1952321;1849476;0;3801797
53;2021-01-15;9;16;26;173813;182358;09;356171
53;2021-01-15;44;42;86;202720;214740;19;417460
53;2021-01-15;46;43;91;163116;173196;29;336312
53;2021-01-15;49;39;88;190526;187674;39;378200
53;2021-01-15;38;34;72;212098;212015;49;424113
53;2021-01-15;52;32;84;223699;219176;59;442875
53;2021-01-15;26;35;61;227435;209274;69;436709
53;2021-01-15;25;22;47;169992;140910;79;310902
53;2021-01-15;19;11;30;118117;69883;89;188000
53;2021-01-15;8;8;16;37370;12267;90;49637
53;2021-01-15;316;282;601;1718886;1621493;0;3340379
75;2021-01-15;32;39;72;293104;305291;09;598395
75;2021-01-15;93;99;192;337141;357785;19;694926
75;2021-01-15;121;111;232;295024;300618;29;595642
75;2021-01-15;128;93;221;347871;331233;39;679104
75;2021-01-15;114;103;218;384742;372771;49;757513
75;2021-01-15;118;105;223;413361;390880;59;804241
75;2021-01-15;99;94;193;425623;384060;69;809683
75;2021-01-15;62;47;109;325086;276298;79;601384
75;2021-01-15;53;23;76;213986;139308;89;353294
75;2021-01-15;40;21;61;77600;28200;90;105800
75;2021-01-15;861;736;1599;3113538;2886444;0;5999982
76;2021-01-15;28;47;77;305956;318589;09;624545
76;2021-01-15;124;117;243;338942;356969;19;695911
76;2021-01-15;156;140;296;316210;319570;29;635780
76;2021-01-15;136;127;263;356758;337587;39;694345
76;2021-01-15;163;115;278;376541;363812;49;740353
76;2021-01-15;165;130;295;402608;383750;59;786358
76;2021-01-15;91;89;180;394889;358997;69;753886
76;2021-01-15;65;58;123;308664;263806;79;572470
76;2021-01-15;54;48;102;195838;129272;89;325110
76;2021-01-15;33;14;47;69372;26728;90;96100
76;2021-01-15;1015;885;1904;3065778;2859080;0;5924858
84;2021-01-15;64;49;113;459549;481088;09;940637
84;2021-01-15;171;224;395;487711;511905;19;999616
84;2021-01-15;224;177;401;443824;451094;29;894918
84;2021-01-15;232;174;406;512522;493262;39;1005784
84;2021-01-15;248;205;453;520248;515106;49;1035354
84;2021-01-15;215;180;395;529611;514848;59;1044459
84;2021-01-15;129;149;278;486720;439940;69;926660
84;2021-01-15;112;110;222;372151;315211;79;687362
84;2021-01-15;102;64;166;237198;150524;89;387722
84;2021-01-15;101;21;122;81185;28680;90;109865
84;2021-01-15;1598;1353;2951;4130719;3901658;0;8032377
93;2021-01-15;46;50;96;268834;283093;09;551927
93;2021-01-15;191;176;370;280751;296087;19;576838
93;2021-01-15;210;178;388;254404;255552;29;509956
93;2021-01-15;243;185;430;310704;288398;39;599102
93;2021-01-15;230;202;432;325559;305827;49;631386
93;2021-01-15;219;186;405;353104;325389;59;678493
93;2021-01-15;146;137;283;336327;296459;69;632786
93;2021-01-15;98;102;200;279820;229699;79;509519
93;2021-01-15;85;60;146;171274;113716;89;284990
93;2021-01-15;73;26;99;58896;21758;90;80654
93;2021-01-15;1541;1302;2850;2639673;2415978;0;5055651
94;2021-01-15;1;0;1;16311;17433;09;33744
94;2021-01-15;3;5;8;16679;18132;19;34811
94;2021-01-15;3;1;4;16782;16579;29;33361
94;2021-01-15;2;3;5;23044;20580;39;43624
94;2021-01-15;1;4;5;23065;22140;49;45205
94;2021-01-15;3;6;9;24549;23421;59;47970
94;2021-01-15;4;2;6;23212;21883;69;45095
94;2021-01-15;1;0;1;19544;17141;79;36685
94;2021-01-15;3;1;4;11227;8178;89;19405
94;2021-01-15;2;0;2;3332;1447;90;4779
94;2021-01-15;23;22;45;177745;166934;0;344679
01;2021-01-16;0;0;0;19979;20155;09;40134
01;2021-01-16;1;1;2;24994;25489;19;50483
01;2021-01-16;0;2;2;17868;16690;29;34558
01;2021-01-16;0;1;1;22328;14821;39;37149
01;2021-01-16;0;2;2;28652;20276;49;48928
01;2021-01-16;0;1;1;33264;27260;59;60524
01;2021-01-16;0;1;1;27135;23978;69;51113
01;2021-01-16;2;0;2;18401;14661;79;33062
01;2021-01-16;0;0;0;9633;6375;89;16008
01;2021-01-16;0;0;0;3410;1510;90;4920
01;2021-01-16;3;8;11;205664;171215;0;376879
02;2021-01-16;0;0;0;16881;17110;09;33991
02;2021-01-16;0;0;0;21410;21604;19;43014
02;2021-01-16;1;0;1;16017;15479;29;31496
02;2021-01-16;0;0;0;19825;14455;39;34280
02;2021-01-16;1;0;1;24719;18248;49;42967
02;2021-01-16;0;0;0;34361;28310;59;62671
02;2021-01-16;0;2;2;28061;24495;69;52556
02;2021-01-16;1;0;1;18231;15278;79;33509
02;2021-01-16;0;0;0;11090;7677;89;18767
02;2021-01-16;0;0;0;3992;1506;90;5498
02;2021-01-16;3;2;5;194587;164162;0;358749
03;2021-01-16;0;0;0;31123;30920;09;62043
03;2021-01-16;10;2;12;29370;29268;19;58638
03;2021-01-16;1;3;4;21458;18963;29;40421
03;2021-01-16;5;5;10;21276;18326;39;39602
03;2021-01-16;7;6;13;18164;16593;49;34757
03;2021-01-16;4;3;7;13469;13557;59;27026
03;2021-01-16;3;1;4;8776;8670;69;17446
03;2021-01-16;2;0;2;3777;3591;79;7368
03;2021-01-16;0;0;0;1649;1072;89;2721
03;2021-01-16;0;0;0;485;184;90;669
03;2021-01-16;32;20;52;149547;141144;0;290691
04;2021-01-16;1;0;1;60314;61377;09;121691
04;2021-01-16;2;2;4;66065;68387;19;134452
04;2021-01-16;5;1;6;51059;47156;29;98215
04;2021-01-16;2;2;4;58788;45780;39;104568
04;2021-01-16;3;3;6;61408;52207;49;113615
04;2021-01-16;3;1;4;64838;60759;59;125597
04;2021-01-16;2;1;3;47008;42843;69;89851
04;2021-01-16;0;1;1;25509;21184;79;46693
04;2021-01-16;0;0;0;13168;7647;89;20815
04;2021-01-16;0;0;0;3209;1253;90;4462
04;2021-01-16;18;11;29;451366;408593;0;859959
05;2021-01-16;0;0;0;362.366008612902;341.338819562748;09;703.704828175651
05;2021-01-16;0;0;0;353.376145114279;370.349735405642;19;723.725880519921
05;2021-01-16;0;0;0;218.593559489256;256.539602589476;29;475.133162078732
05;2021-01-16;0;0;0;404.225408693299;360.321910454353;39;764.547319147651
05;2021-01-16;0;0;0;520.067953604221;497.108383964256;49;1017.17633756848
05;2021-01-16;0;0;0;468.146063921917;510.087601910415;59;978.233665832332
05;2021-01-16;0;0;0;340.368470050554;334.366842191253;69;674.735312241807
05;2021-01-16;0;0;0;212.598666888387;192.597753227106;79;405.196420115493
05;2021-01-16;0;0;0;148.727797095705;61.8681715431829;89;210.595968638888
05;2021-01-16;0;0;0;32.9601271090696;10.9909785719784;90;43.9511056810479
05;2021-01-16;0;0;0;3061.43020057959;2935.56979942041;0;5997
06;2021-01-16;1;0;1;42583;42380;09;84963
06;2021-01-16;7;3;10;33369;31925;19;65294
06;2021-01-16;9;2;11;21571;15080;29;36651
06;2021-01-16;8;6;14;21550;16147;39;37697
06;2021-01-16;4;4;8;14193;13939;49;28132
06;2021-01-16;3;7;10;7171;7597;59;14768
06;2021-01-16;2;4;6;3629;4117;69;7746
06;2021-01-16;0;1;1;1577;1457;79;3034
06;2021-01-16;2;0;2;531;474;89;1005
06;2021-01-16;0;0;0;88;93;90;181
06;2021-01-16;36;27;63;146262;133209;0;279471
07;2021-01-16;0;0;0;485;549;09;1034
07;2021-01-16;0;0;0;403;432;19;835
07;2021-01-16;1;0;1;764;841;29;1605
07;2021-01-16;2;1;3;824;928;39;1752
07;2021-01-16;0;0;0;788;1020;49;1808
07;2021-01-16;0;0;0;678;870;59;1548
07;2021-01-16;0;2;2;360;382;69;742
07;2021-01-16;0;0;0;231;190;79;421
07;2021-01-16;0;0;0;114;67;89;181
07;2021-01-16;0;0;0;24;11;90;35
07;2021-01-16;3;3;6;4671;5290;0;9961
08;2021-01-16;0;0;0;2715.22592983026;2997.75551488675;09;5712.98144471701
08;2021-01-16;0;1;1;2778.51901080978;3160.9156459093;19;5939.43465671908
08;2021-01-16;0;0;0;2080.8882988764;1718.16634315323;29;3799.05464202964
08;2021-01-16;1;0;1;2701.8582062647;1896.52641413317;39;4598.38462039786
08;2021-01-16;2;0;2;3151.45861023308;2460.52498233809;49;5611.98359257117
08;2021-01-16;0;0;0;2620.29868333099;2422.23566154656;59;5042.53434487755
08;2021-01-16;0;1;1;1621.44173420671;1438.58325779464;69;3060.02499200135
08;2021-01-16;0;0;0;626.575909335673;526.358467843651;79;1152.93437717932
08;2021-01-16;0;0;0;205.018522985054;140.993639349697;89;346.012162334751
08;2021-01-16;0;0;0;50.0325684687745;20.62259870351;90;70.6551671722846
08;2021-01-16;3;2;5;18551.3174743414;16782.6825256586;0;35334
11;2021-01-16;56;57;118;783071;811785;09;1594856
11;2021-01-16;166;154;328;761456;784653;19;1546109
11;2021-01-16;236;182;418;850145;801772;29;1651917
11;2021-01-16;264;212;478;914360;843488;39;1757848
11;2021-01-16;173;171;346;845609;826202;49;1671811
11;2021-01-16;165;173;339;793566;745070;59;1538636
11;2021-01-16;109;111;223;628649;549192;69;1177841
11;2021-01-16;59;80;140;434606;358356;79;792962
11;2021-01-16;44;35;79;261425;162933;89;424358
11;2021-01-16;25;13;38;89253;32619;90;121872
11;2021-01-16;1297;1188;2507;6362140;5916070;0;12278210
24;2021-01-16;10;8;18;139720;144686;09;284406
24;2021-01-16;32;42;75;152979;161185;19;314164
24;2021-01-16;38;26;64;122237;126536;29;248773
24;2021-01-16;29;32;61;150359;142009;39;292368
24;2021-01-16;38;40;78;161829;158758;49;320587
24;2021-01-16;29;33;63;172552;168011;59;340563
24;2021-01-16;22;21;43;172509;158177;69;330686
24;2021-01-16;11;13;24;129428;110593;79;240021
24;2021-01-16;11;8;19;87342;56882;89;144224
24;2021-01-16;11;4;15;31210;12071;90;43281
24;2021-01-16;231;227;460;1320165;1238908;0;2559073
27;2021-01-16;16;12;29;143373;149679;09;293052
27;2021-01-16;44;53;99;160962;173003;19;333965
27;2021-01-16;32;36;68;133746;142254;29;276000
27;2021-01-16;49;45;94;160004;155407;39;315411
27;2021-01-16;59;41;100;172333;169564;49;341897
27;2021-01-16;55;41;96;189979;183788;59;373767
27;2021-01-16;30;54;84;192591;178206;69;370797
27;2021-01-16;42;30;72;146876;127546;79;274422
27;2021-01-16;27;12;39;96896;61575;89;158471
27;2021-01-16;17;5;22;33148;12109;90;45257
27;2021-01-16;371;329;703;1429908;1353131;0;2783039
28;2021-01-16;18;7;27;180735;186856;09;367591
28;2021-01-16;40;25;66;200125;213621;19;413746
28;2021-01-16;39;33;72;168922;173007;29;341929
28;2021-01-16;37;30;67;196628;188487;39;385115
28;2021-01-16;27;27;54;205396;201699;49;407095
28;2021-01-16;39;30;69;222002;213866;59;435868
28;2021-01-16;21;31;53;224688;203758;69;428446
28;2021-01-16;25;21;46;163192;135543;79;298735
28;2021-01-16;14;17;31;109691;65377;89;175068
28;2021-01-16;14;2;16;37222;12685;90;49907
28;2021-01-16;274;223;501;1708601;1594899;0;3303500
32;2021-01-16;31;26;57;358062;373689;09;731751
32;2021-01-16;86;93;179;387045;406742;19;793787
32;2021-01-16;96;86;182;342304;348587;29;690891
32;2021-01-16;79;78;157;382485;369972;39;752457
32;2021-01-16;98;79;177;382510;376716;49;759226
32;2021-01-16;73;76;149;386937;376527;59;763464
32;2021-01-16;54;47;101;371211;330938;69;702149
32;2021-01-16;35;39;74;250542;201459;79;452001
32;2021-01-16;33;22;55;163399;89786;89;253185
32;2021-01-16;17;4;21;48384;15367;90;63751
32;2021-01-16;602;550;1152;3072879;2889783;0;5962662
44;2021-01-16;25;24;49;291525;306839;09;598364
44;2021-01-16;75;77;152;320255;339504;19;659759
44;2021-01-16;94;75;169;302020;314428;29;616448
44;2021-01-16;86;84;170;342222;333292;39;675514
44;2021-01-16;85;62;147;349727;344491;49;694218
44;2021-01-16;94;101;195;381371;373239;59;754610
44;2021-01-16;64;50;114;367165;335850;69;703015
44;2021-01-16;47;37;84;250387;215436;79;465823
44;2021-01-16;35;26;61;170825;105192;89;276017
44;2021-01-16;18;13;31;51248;16731;90;67979
44;2021-01-16;623;549;1172;2826745;2685002;0;5511747
52;2021-01-16;12;9;23;213594;223900;09;437494
52;2021-01-16;22;50;72;240818;255197;19;496015
52;2021-01-16;37;34;71;197010;200630;29;397640
52;2021-01-16;40;33;73;231204;224885;39;456089
52;2021-01-16;48;47;95;243874;243418;49;487292
52;2021-01-16;49;26;75;244100;239116;59;483216
52;2021-01-16;25;25;50;241796;221345;69;463141
52;2021-01-16;20;21;41;177805;149903;79;327708
52;2021-01-16;18;15;33;119561;75822;89;195383
52;2021-01-16;12;5;17;42559;15260;90;57819
52;2021-01-16;283;265;550;1952321;1849476;0;3801797
53;2021-01-16;5;7;12;173813;182358;09;356171
53;2021-01-16;24;21;46;202720;214740;19;417460
53;2021-01-16;22;15;37;163116;173196;29;336312
53;2021-01-16;18;17;35;190526;187674;39;378200
53;2021-01-16;26;28;54;212098;212015;49;424113
53;2021-01-16;22;15;37;223699;219176;59;442875
53;2021-01-16;14;18;32;227435;209274;69;436709
53;2021-01-16;5;13;18;169992;140910;79;310902
53;2021-01-16;9;9;18;118117;69883;89;188000
53;2021-01-16;4;2;6;37370;12267;90;49637
53;2021-01-16;149;145;295;1718886;1621493;0;3340379
75;2021-01-16;22;22;44;293104;305291;09;598395
75;2021-01-16;62;60;123;337141;357785;19;694926
75;2021-01-16;70;63;133;295024;300618;29;595642
75;2021-01-16;71;59;130;347871;331233;39;679104
75;2021-01-16;91;56;147;384742;372771;49;757513
75;2021-01-16;57;51;108;413361;390880;59;804241
75;2021-01-16;41;39;80;425623;384060;69;809683
75;2021-01-16;27;25;52;325086;276298;79;601384
75;2021-01-16;25;20;45;213986;139308;89;353294
75;2021-01-16;16;6;22;77600;28200;90;105800
75;2021-01-16;482;401;884;3113538;2886444;0;5999982
76;2021-01-16;19;19;38;305956;318589;09;624545
76;2021-01-16;74;66;142;338942;356969;19;695911
76;2021-01-16;84;77;161;316210;319570;29;635780
76;2021-01-16;114;77;191;356758;337587;39;694345
76;2021-01-16;74;88;162;376541;363812;49;740353
76;2021-01-16;66;65;131;402608;383750;59;786358
76;2021-01-16;45;51;96;394889;358997;69;753886
76;2021-01-16;33;19;52;308664;263806;79;572470
76;2021-01-16;34;25;59;195838;129272;89;325110
76;2021-01-16;15;8;23;69372;26728;90;96100
76;2021-01-16;559;495;1056;3065778;2859080;0;5924858
84;2021-01-16;35;36;73;459549;481088;09;940637
84;2021-01-16;114;97;212;487711;511905;19;999616
84;2021-01-16;140;95;235;443824;451094;29;894918
84;2021-01-16;115;104;219;512522;493262;39;1005784
84;2021-01-16;131;120;251;520248;515106;49;1035354
84;2021-01-16;106;101;207;529611;514848;59;1044459
84;2021-01-16;68;76;144;486720;439940;69;926660
84;2021-01-16;45;47;92;372151;315211;79;687362
84;2021-01-16;53;38;91;237198;150524;89;387722
84;2021-01-16;22;20;42;81185;28680;90;109865
84;2021-01-16;829;734;1566;4130719;3901658;0;8032377
93;2021-01-16;30;21;51;268834;283093;09;551927
93;2021-01-16;100;107;207;280751;296087;19;576838
93;2021-01-16;107;84;191;254404;255552;29;509956
93;2021-01-16;125;107;232;310704;288398;39;599102
93;2021-01-16;104;125;229;325559;305827;49;631386
93;2021-01-16;117;111;228;353104;325389;59;678493
93;2021-01-16;75;72;147;336327;296459;69;632786
93;2021-01-16;50;54;104;279820;229699;79;509519
93;2021-01-16;30;24;54;171274;113716;89;284990
93;2021-01-16;14;4;18;58896;21758;90;80654
93;2021-01-16;752;709;1461;2639673;2415978;0;5055651
94;2021-01-16;0;0;0;16311;17433;09;33744
94;2021-01-16;0;0;0;16679;18132;19;34811
94;2021-01-16;1;2;3;16782;16579;29;33361
94;2021-01-16;3;1;4;23044;20580;39;43624
94;2021-01-16;2;2;4;23065;22140;49;45205
94;2021-01-16;1;1;2;24549;23421;59;47970
94;2021-01-16;1;1;2;23212;21883;69;45095
94;2021-01-16;2;0;2;19544;17141;79;36685
94;2021-01-16;0;0;0;11227;8178;89;19405
94;2021-01-16;0;0;0;3332;1447;90;4779
94;2021-01-16;10;7;17;177745;166934;0;344679
01;2021-01-17;0;0;0;19979;20155;09;40134
01;2021-01-17;0;0;0;24994;25489;19;50483
01;2021-01-17;1;0;1;17868;16690;29;34558
01;2021-01-17;0;0;0;22328;14821;39;37149
01;2021-01-17;0;0;0;28652;20276;49;48928
01;2021-01-17;0;0;0;33264;27260;59;60524
01;2021-01-17;0;0;0;27135;23978;69;51113
01;2021-01-17;0;0;0;18401;14661;79;33062
01;2021-01-17;0;0;0;9633;6375;89;16008
01;2021-01-17;0;0;0;3410;1510;90;4920
01;2021-01-17;1;0;1;205664;171215;0;376879
02;2021-01-17;0;0;0;16881;17110;09;33991
02;2021-01-17;0;0;0;21410;21604;19;43014
02;2021-01-17;1;0;1;16017;15479;29;31496
02;2021-01-17;0;0;0;19825;14455;39;34280
02;2021-01-17;0;0;0;24719;18248;49;42967
02;2021-01-17;0;0;0;34361;28310;59;62671
02;2021-01-17;0;0;0;28061;24495;69;52556
02;2021-01-17;0;0;0;18231;15278;79;33509
02;2021-01-17;0;0;0;11090;7677;89;18767
02;2021-01-17;0;0;0;3992;1506;90;5498
02;2021-01-17;1;0;1;194587;164162;0;358749
03;2021-01-17;0;0;0;31123;30920;09;62043
03;2021-01-17;0;1;1;29370;29268;19;58638
03;2021-01-17;0;0;0;21458;18963;29;40421
03;2021-01-17;2;1;3;21276;18326;39;39602
03;2021-01-17;1;1;2;18164;16593;49;34757
03;2021-01-17;0;0;0;13469;13557;59;27026
03;2021-01-17;0;1;1;8776;8670;69;17446
03;2021-01-17;1;0;1;3777;3591;79;7368
03;2021-01-17;0;0;0;1649;1072;89;2721
03;2021-01-17;0;0;0;485;184;90;669
03;2021-01-17;4;4;8;149547;141144;0;290691
04;2021-01-17;0;0;0;60314;61377;09;121691
04;2021-01-17;0;0;0;66065;68387;19;134452
04;2021-01-17;2;1;3;51059;47156;29;98215
04;2021-01-17;1;3;4;58788;45780;39;104568
04;2021-01-17;2;1;3;61408;52207;49;113615
04;2021-01-17;0;2;2;64838;60759;59;125597
04;2021-01-17;0;0;0;47008;42843;69;89851
04;2021-01-17;0;0;0;25509;21184;79;46693
04;2021-01-17;0;0;0;13168;7647;89;20815
04;2021-01-17;0;0;0;3209;1253;90;4462
04;2021-01-17;5;7;12;451366;408593;0;859959
05;2021-01-17;0;0;0;362.366008612902;341.338819562748;09;703.704828175651
05;2021-01-17;0;0;0;353.376145114279;370.349735405642;19;723.725880519921
05;2021-01-17;0;0;0;218.593559489256;256.539602589476;29;475.133162078732
05;2021-01-17;0;0;0;404.225408693299;360.321910454353;39;764.547319147651
05;2021-01-17;0;0;0;520.067953604221;497.108383964256;49;1017.17633756848
05;2021-01-17;0;0;0;468.146063921917;510.087601910415;59;978.233665832332
05;2021-01-17;0;0;0;340.368470050554;334.366842191253;69;674.735312241807
05;2021-01-17;0;0;0;212.598666888387;192.597753227106;79;405.196420115493
05;2021-01-17;0;0;0;148.727797095705;61.8681715431829;89;210.595968638888
05;2021-01-17;0;0;0;32.9601271090696;10.9909785719784;90;43.9511056810479
05;2021-01-17;0;0;0;3061.43020057959;2935.56979942041;0;5997
06;2021-01-17;0;0;0;42583;42380;09;84963
06;2021-01-17;0;0;0;33369;31925;19;65294
06;2021-01-17;0;4;4;21571;15080;29;36651
06;2021-01-17;0;2;2;21550;16147;39;37697
06;2021-01-17;1;2;3;14193;13939;49;28132
06;2021-01-17;0;0;0;7171;7597;59;14768
06;2021-01-17;1;0;1;3629;4117;69;7746
06;2021-01-17;0;0;0;1577;1457;79;3034
06;2021-01-17;0;0;0;531;474;89;1005
06;2021-01-17;0;0;0;88;93;90;181
06;2021-01-17;2;8;10;146262;133209;0;279471
07;2021-01-17;0;0;0;485;549;09;1034
07;2021-01-17;0;0;0;403;432;19;835
07;2021-01-17;0;0;0;764;841;29;1605
07;2021-01-17;0;0;0;824;928;39;1752
07;2021-01-17;0;0;0;788;1020;49;1808
07;2021-01-17;0;0;0;678;870;59;1548
07;2021-01-17;0;0;0;360;382;69;742
07;2021-01-17;0;0;0;231;190;79;421
07;2021-01-17;0;0;0;114;67;89;181
07;2021-01-17;0;0;0;24;11;90;35
07;2021-01-17;0;0;0;4671;5290;0;9961
08;2021-01-17;0;0;0;2715.22592983026;2997.75551488675;09;5712.98144471701
08;2021-01-17;0;0;0;2778.51901080978;3160.9156459093;19;5939.43465671908
08;2021-01-17;0;0;0;2080.8882988764;1718.16634315323;29;3799.05464202964
08;2021-01-17;0;0;0;2701.8582062647;1896.52641413317;39;4598.38462039786
08;2021-01-17;0;0;0;3151.45861023308;2460.52498233809;49;5611.98359257117
08;2021-01-17;0;0;0;2620.29868333099;2422.23566154656;59;5042.53434487755
08;2021-01-17;0;0;0;1621.44173420671;1438.58325779464;69;3060.02499200135
08;2021-01-17;0;0;0;626.575909335673;526.358467843651;79;1152.93437717932
08;2021-01-17;0;0;0;205.018522985054;140.993639349697;89;346.012162334751
08;2021-01-17;0;0;0;50.0325684687745;20.62259870351;90;70.6551671722846
08;2021-01-17;0;0;0;18551.3174743414;16782.6825256586;0;35334
11;2021-01-17;7;15;22;783071;811785;09;1594856
11;2021-01-17;45;35;81;761456;784653;19;1546109
11;2021-01-17;78;59;137;850145;801772;29;1651917
11;2021-01-17;68;86;154;914360;843488;39;1757848
11;2021-01-17;46;46;92;845609;826202;49;1671811
11;2021-01-17;33;44;77;793566;745070;59;1538636
11;2021-01-17;22;47;70;628649;549192;69;1177841
11;2021-01-17;18;25;43;434606;358356;79;792962
11;2021-01-17;18;10;28;261425;162933;89;424358
11;2021-01-17;18;5;23;89253;32619;90;121872
11;2021-01-17;353;372;727;6362140;5916070;0;12278210
24;2021-01-17;2;0;2;139720;144686;09;284406
24;2021-01-17;2;3;5;152979;161185;19;314164
24;2021-01-17;4;6;10;122237;126536;29;248773
24;2021-01-17;8;3;11;150359;142009;39;292368
24;2021-01-17;9;6;15;161829;158758;49;320587
24;2021-01-17;3;1;4;172552;168011;59;340563
24;2021-01-17;2;8;10;172509;158177;69;330686
24;2021-01-17;2;4;6;129428;110593;79;240021
24;2021-01-17;11;8;19;87342;56882;89;144224
24;2021-01-17;7;3;10;31210;12071;90;43281
24;2021-01-17;50;42;92;1320165;1238908;0;2559073
27;2021-01-17;0;4;4;143373;149679;09;293052
27;2021-01-17;3;5;8;160962;173003;19;333965
27;2021-01-17;7;1;8;133746;142254;29;276000
27;2021-01-17;7;7;14;160004;155407;39;315411
27;2021-01-17;7;7;14;172333;169564;49;341897
27;2021-01-17;8;9;17;189979;183788;59;373767
27;2021-01-17;2;5;7;192591;178206;69;370797
27;2021-01-17;6;6;12;146876;127546;79;274422
27;2021-01-17;9;11;20;96896;61575;89;158471
27;2021-01-17;5;2;7;33148;12109;90;45257
27;2021-01-17;54;57;111;1429908;1353131;0;2783039
28;2021-01-17;3;5;8;180735;186856;09;367591
28;2021-01-17;10;8;18;200125;213621;19;413746
28;2021-01-17;15;7;22;168922;173007;29;341929
28;2021-01-17;17;7;24;196628;188487;39;385115
28;2021-01-17;10;10;20;205396;201699;49;407095
28;2021-01-17;13;8;21;222002;213866;59;435868
28;2021-01-17;6;11;17;224688;203758;69;428446
28;2021-01-17;1;5;6;163192;135543;79;298735
28;2021-01-17;14;7;21;109691;65377;89;175068
28;2021-01-17;6;4;10;37222;12685;90;49907
28;2021-01-17;95;72;167;1708601;1594899;0;3303500
32;2021-01-17;6;5;11;358062;373689;09;731751
32;2021-01-17;13;13;26;387045;406742;19;793787
32;2021-01-17;21;20;41;342304;348587;29;690891
32;2021-01-17;18;15;33;382485;369972;39;752457
32;2021-01-17;24;18;42;382510;376716;49;759226
32;2021-01-17;21;18;39;386937;376527;59;763464
32;2021-01-17;6;10;16;371211;330938;69;702149
32;2021-01-17;6;15;21;250542;201459;79;452001
32;2021-01-17;12;12;24;163399;89786;89;253185
32;2021-01-17;9;1;10;48384;15367;90;63751
32;2021-01-17;136;127;263;3072879;2889783;0;5962662
44;2021-01-17;2;5;7;291525;306839;09;598364
44;2021-01-17;4;5;9;320255;339504;19;659759
44;2021-01-17;11;10;21;302020;314428;29;616448
44;2021-01-17;11;6;17;342222;333292;39;675514
44;2021-01-17;15;11;26;349727;344491;49;694218
44;2021-01-17;15;9;24;381371;373239;59;754610
44;2021-01-17;3;12;15;367165;335850;69;703015
44;2021-01-17;11;19;30;250387;215436;79;465823
44;2021-01-17;20;17;37;170825;105192;89;276017
44;2021-01-17;7;3;10;51248;16731;90;67979
44;2021-01-17;99;97;196;2826745;2685002;0;5511747
52;2021-01-17;5;3;8;213594;223900;09;437494
52;2021-01-17;13;10;23;240818;255197;19;496015
52;2021-01-17;23;12;35;197010;200630;29;397640
52;2021-01-17;21;13;34;231204;224885;39;456089
52;2021-01-17;21;11;32;243874;243418;49;487292
52;2021-01-17;14;6;20;244100;239116;59;483216
52;2021-01-17;10;10;20;241796;221345;69;463141
52;2021-01-17;6;5;11;177805;149903;79;327708
52;2021-01-17;9;7;16;119561;75822;89;195383
52;2021-01-17;6;1;7;42559;15260;90;57819
52;2021-01-17;128;78;206;1952321;1849476;0;3801797
53;2021-01-17;2;1;3;173813;182358;09;356171
53;2021-01-17;5;1;6;202720;214740;19;417460
53;2021-01-17;4;3;7;163116;173196;29;336312
53;2021-01-17;7;4;11;190526;187674;39;378200
53;2021-01-17;3;3;6;212098;212015;49;424113
53;2021-01-17;6;6;12;223699;219176;59;442875
53;2021-01-17;3;4;7;227435;209274;69;436709
53;2021-01-17;3;2;5;169992;140910;79;310902
53;2021-01-17;6;3;9;118117;69883;89;188000
53;2021-01-17;3;3;6;37370;12267;90;49637
53;2021-01-17;42;30;72;1718886;1621493;0;3340379
75;2021-01-17;2;3;5;293104;305291;09;598395
75;2021-01-17;5;1;6;337141;357785;19;694926
75;2021-01-17;13;7;20;295024;300618;29;595642
75;2021-01-17;15;12;27;347871;331233;39;679104
75;2021-01-17;13;13;26;384742;372771;49;757513
75;2021-01-17;6;10;16;413361;390880;59;804241
75;2021-01-17;5;11;16;425623;384060;69;809683
75;2021-01-17;9;15;24;325086;276298;79;601384
75;2021-01-17;18;5;23;213986;139308;89;353294
75;2021-01-17;9;9;18;77600;28200;90;105800
75;2021-01-17;95;86;181;3113538;2886444;0;5999982
76;2021-01-17;3;4;7;305956;318589;09;624545
76;2021-01-17;6;10;16;338942;356969;19;695911
76;2021-01-17;17;16;33;316210;319570;29;635780
76;2021-01-17;19;17;36;356758;337587;39;694345
76;2021-01-17;16;16;32;376541;363812;49;740353
76;2021-01-17;17;13;30;402608;383750;59;786358
76;2021-01-17;9;10;19;394889;358997;69;753886
76;2021-01-17;6;2;8;308664;263806;79;572470
76;2021-01-17;14;7;21;195838;129272;89;325110
76;2021-01-17;13;4;17;69372;26728;90;96100
76;2021-01-17;120;99;219;3065778;2859080;0;5924858
84;2021-01-17;1;4;5;459549;481088;09;940637
84;2021-01-17;18;20;38;487711;511905;19;999616
84;2021-01-17;28;18;46;443824;451094;29;894918
84;2021-01-17;21;17;38;512522;493262;39;1005784
84;2021-01-17;23;18;41;520248;515106;49;1035354
84;2021-01-17;25;11;36;529611;514848;59;1044459
84;2021-01-17;14;10;24;486720;439940;69;926660
84;2021-01-17;21;16;37;372151;315211;79;687362
84;2021-01-17;24;17;41;237198;150524;89;387722
84;2021-01-17;17;9;26;81185;28680;90;109865
84;2021-01-17;192;140;332;4130719;3901658;0;8032377
93;2021-01-17;6;8;14;268834;283093;09;551927
93;2021-01-17;17;16;33;280751;296087;19;576838
93;2021-01-17;25;20;45;254404;255552;29;509956
93;2021-01-17;45;30;75;310704;288398;39;599102
93;2021-01-17;38;25;63;325559;305827;49;631386
93;2021-01-17;15;20;35;353104;325389;59;678493
93;2021-01-17;24;12;36;336327;296459;69;632786
93;2021-01-17;13;16;29;279820;229699;79;509519
93;2021-01-17;27;16;43;171274;113716;89;284990
93;2021-01-17;26;12;38;58896;21758;90;80654
93;2021-01-17;236;175;411;2639673;2415978;0;5055651
94;2021-01-17;0;0;0;16311;17433;09;33744
94;2021-01-17;0;0;0;16679;18132;19;34811
94;2021-01-17;0;0;0;16782;16579;29;33361
94;2021-01-17;0;0;0;23044;20580;39;43624
94;2021-01-17;0;1;1;23065;22140;49;45205
94;2021-01-17;0;1;1;24549;23421;59;47970
94;2021-01-17;0;0;0;23212;21883;69;45095
94;2021-01-17;0;1;1;19544;17141;79;36685
94;2021-01-17;0;2;2;11227;8178;89;19405
94;2021-01-17;0;1;1;3332;1447;90;4779
94;2021-01-17;0;6;6;177745;166934;0;344679
01;2021-01-18;0;0;0;19979;20155;09;40134
01;2021-01-18;3;4;7;24994;25489;19;50483
01;2021-01-18;1;1;2;17868;16690;29;34558
01;2021-01-18;3;3;6;22328;14821;39;37149
01;2021-01-18;2;2;4;28652;20276;49;48928
01;2021-01-18;2;3;5;33264;27260;59;60524
01;2021-01-18;3;0;3;27135;23978;69;51113
01;2021-01-18;0;0;0;18401;14661;79;33062
01;2021-01-18;0;1;1;9633;6375;89;16008
01;2021-01-18;0;0;0;3410;1510;90;4920
01;2021-01-18;14;14;28;205664;171215;0;376879
02;2021-01-18;3;0;3;16881;17110;09;33991
02;2021-01-18;0;0;0;21410;21604;19;43014
02;2021-01-18;0;2;2;16017;15479;29;31496
02;2021-01-18;4;1;5;19825;14455;39;34280
02;2021-01-18;2;0;2;24719;18248;49;42967
02;2021-01-18;1;1;2;34361;28310;59;62671
02;2021-01-18;3;0;3;28061;24495;69;52556
02;2021-01-18;0;0;0;18231;15278;79;33509
02;2021-01-18;0;1;1;11090;7677;89;18767
02;2021-01-18;0;0;0;3992;1506;90;5498
02;2021-01-18;13;5;18;194587;164162;0;358749
03;2021-01-18;5;1;7;31123;30920;09;62043
03;2021-01-18;14;10;25;29370;29268;19;58638
03;2021-01-18;20;15;35;21458;18963;29;40421
03;2021-01-18;14;12;26;21276;18326;39;39602
03;2021-01-18;9;14;23;18164;16593;49;34757
03;2021-01-18;13;4;17;13469;13557;59;27026
03;2021-01-18;6;13;19;8776;8670;69;17446
03;2021-01-18;1;4;5;3777;3591;79;7368
03;2021-01-18;0;1;1;1649;1072;89;2721
03;2021-01-18;0;0;0;485;184;90;669
03;2021-01-18;82;74;158;149547;141144;0;290691
04;2021-01-18;0;1;1;60314;61377;09;121691
04;2021-01-18;4;3;8;66065;68387;19;134452
04;2021-01-18;3;3;6;51059;47156;29;98215
04;2021-01-18;4;3;7;58788;45780;39;104568
04;2021-01-18;5;9;14;61408;52207;49;113615
04;2021-01-18;6;9;15;64838;60759;59;125597
04;2021-01-18;5;2;7;47008;42843;69;89851
04;2021-01-18;2;1;3;25509;21184;79;46693
04;2021-01-18;0;0;0;13168;7647;89;20815
04;2021-01-18;0;0;0;3209;1253;90;4462
04;2021-01-18;29;31;61;451366;408593;0;859959
05;2021-01-18;0;0;0;362.366008612902;341.338819562748;09;703.704828175651
05;2021-01-18;0;0;0;353.376145114279;370.349735405642;19;723.725880519921
05;2021-01-18;0;0;0;218.593559489256;256.539602589476;29;475.133162078732
05;2021-01-18;0;0;0;404.225408693299;360.321910454353;39;764.547319147651
05;2021-01-18;0;0;0;520.067953604221;497.108383964256;49;1017.17633756848
05;2021-01-18;0;0;0;468.146063921917;510.087601910415;59;978.233665832332
05;2021-01-18;0;0;0;340.368470050554;334.366842191253;69;674.735312241807
05;2021-01-18;0;0;0;212.598666888387;192.597753227106;79;405.196420115493
05;2021-01-18;0;0;0;148.727797095705;61.8681715431829;89;210.595968638888
05;2021-01-18;0;0;0;32.9601271090696;10.9909785719784;90;43.9511056810479
05;2021-01-18;0;0;0;3061.43020057959;2935.56979942041;0;5997
06;2021-01-18;1;3;4;42583;42380;09;84963
06;2021-01-18;13;18;31;33369;31925;19;65294
06;2021-01-18;13;10;23;21571;15080;29;36651
06;2021-01-18;12;13;25;21550;16147;39;37697
06;2021-01-18;14;16;30;14193;13939;49;28132
06;2021-01-18;4;9;13;7171;7597;59;14768
06;2021-01-18;1;8;9;3629;4117;69;7746
06;2021-01-18;1;2;3;1577;1457;79;3034
06;2021-01-18;0;1;1;531;474;89;1005
06;2021-01-18;0;1;1;88;93;90;181
06;2021-01-18;59;81;140;146262;133209;0;279471
07;2021-01-18;0;0;0;485;549;09;1034
07;2021-01-18;1;0;1;403;432;19;835
07;2021-01-18;3;5;8;764;841;29;1605
07;2021-01-18;1;3;4;824;928;39;1752
07;2021-01-18;0;0;0;788;1020;49;1808
07;2021-01-18;1;1;2;678;870;59;1548
07;2021-01-18;0;0;0;360;382;69;742
07;2021-01-18;1;0;1;231;190;79;421
07;2021-01-18;0;1;1;114;67;89;181
07;2021-01-18;0;0;0;24;11;90;35
07;2021-01-18;7;10;17;4671;5290;0;9961
08;2021-01-18;0;0;0;2715.22592983026;2997.75551488675;09;5712.98144471701
08;2021-01-18;1;0;1;2778.51901080978;3160.9156459093;19;5939.43465671908
08;2021-01-18;0;2;2;2080.8882988764;1718.16634315323;29;3799.05464202964
08;2021-01-18;4;3;7;2701.8582062647;1896.52641413317;39;4598.38462039786
08;2021-01-18;1;0;1;3151.45861023308;2460.52498233809;49;5611.98359257117
08;2021-01-18;1;0;1;2620.29868333099;2422.23566154656;59;5042.53434487755
08;2021-01-18;1;1;2;1621.44173420671;1438.58325779464;69;3060.02499200135
08;2021-01-18;1;0;1;626.575909335673;526.358467843651;79;1152.93437717932
08;2021-01-18;0;0;0;205.018522985054;140.993639349697;89;346.012162334751
08;2021-01-18;0;0;0;50.0325684687745;20.62259870351;90;70.6551671722846
08;2021-01-18;9;6;15;18551.3174743414;16782.6825256586;0;35334
11;2021-01-18;107;110;226;783071;811785;09;1594856
11;2021-01-18;339;324;676;761456;784653;19;1546109
11;2021-01-18;499;419;919;850145;801772;29;1651917
11;2021-01-18;546;456;1004;914360;843488;39;1757848
11;2021-01-18;466;413;879;845609;826202;49;1671811
11;2021-01-18;401;356;757;793566;745070;59;1538636
11;2021-01-18;242;293;543;628649;549192;69;1177841
11;2021-01-18;131;133;264;434606;358356;79;792962
11;2021-01-18;108;62;170;261425;162933;89;424358
11;2021-01-18;71;21;92;89253;32619;90;121872
11;2021-01-18;2910;2588;5531;6362140;5916070;0;12278210
24;2021-01-18;21;12;33;139720;144686;09;284406
24;2021-01-18;68;76;146;152979;161185;19;314164
24;2021-01-18;70;52;122;122237;126536;29;248773
24;2021-01-18;85;69;154;150359;142009;39;292368
24;2021-01-18;101;58;159;161829;158758;49;320587
24;2021-01-18;92;63;155;172552;168011;59;340563
24;2021-01-18;54;56;110;172509;158177;69;330686
24;2021-01-18;42;40;82;129428;110593;79;240021
24;2021-01-18;55;29;84;87342;56882;89;144224
24;2021-01-18;63;17;80;31210;12071;90;43281
24;2021-01-18;651;472;1125;1320165;1238908;0;2559073
27;2021-01-18;36;33;69;143373;149679;09;293052
27;2021-01-18;94;94;189;160962;173003;19;333965
27;2021-01-18;95;63;158;133746;142254;29;276000
27;2021-01-18;97;74;171;160004;155407;39;315411
27;2021-01-18;133;87;220;172333;169564;49;341897
27;2021-01-18;109;106;215;189979;183788;59;373767
27;2021-01-18;92;68;161;192591;178206;69;370797
27;2021-01-18;57;61;118;146876;127546;79;274422
27;2021-01-18;61;40;101;96896;61575;89;158471
27;2021-01-18;43;18;61;33148;12109;90;45257
27;2021-01-18;817;644;1463;1429908;1353131;0;2783039
28;2021-01-18;29;31;61;180735;186856;09;367591
28;2021-01-18;73;69;143;200125;213621;19;413746
28;2021-01-18;121;76;197;168922;173007;29;341929
28;2021-01-18;105;78;184;196628;188487;39;385115
28;2021-01-18;110;89;199;205396;201699;49;407095
28;2021-01-18;113;90;203;222002;213866;59;435868
28;2021-01-18;73;57;130;224688;203758;69;428446
28;2021-01-18;38;45;83;163192;135543;79;298735
28;2021-01-18;67;37;104;109691;65377;89;175068
28;2021-01-18;38;15;53;37222;12685;90;49907
28;2021-01-18;767;587;1357;1708601;1594899;0;3303500
32;2021-01-18;54;60;114;358062;373689;09;731751
32;2021-01-18;158;186;344;387045;406742;19;793787
32;2021-01-18;216;170;386;342304;348587;29;690891
32;2021-01-18;210;163;373;382485;369972;39;752457
32;2021-01-18;223;195;418;382510;376716;49;759226
32;2021-01-18;192;177;369;386937;376527;59;763464
32;2021-01-18;133;135;268;371211;330938;69;702149
32;2021-01-18;117;85;202;250542;201459;79;452001
32;2021-01-18;108;55;163;163399;89786;89;253185
32;2021-01-18;82;12;94;48384;15367;90;63751
32;2021-01-18;1494;1238;2732;3072879;2889783;0;5962662
44;2021-01-18;62;54;118;291525;306839;09;598364
44;2021-01-18;156;133;292;320255;339504;19;659759
44;2021-01-18;211;164;375;302020;314428;29;616448
44;2021-01-18;212;169;384;342222;333292;39;675514
44;2021-01-18;223;166;392;349727;344491;49;694218
44;2021-01-18;240;200;440;381371;373239;59;754610
44;2021-01-18;143;137;282;367165;335850;69;703015
44;2021-01-18;107;101;208;250387;215436;79;465823
44;2021-01-18;135;68;204;170825;105192;89;276017
44;2021-01-18;112;28;140;51248;16731;90;67979
44;2021-01-18;1601;1220;2835;2826745;2685002;0;5511747
52;2021-01-18;27;21;48;213594;223900;09;437494
52;2021-01-18;86;67;154;240818;255197;19;496015
52;2021-01-18;97;63;160;197010;200630;29;397640
52;2021-01-18;94;84;178;231204;224885;39;456089
52;2021-01-18;97;63;160;243874;243418;49;487292
52;2021-01-18;111;83;197;244100;239116;59;483216
52;2021-01-18;67;72;139;241796;221345;69;463141
52;2021-01-18;55;53;108;177805;149903;79;327708
52;2021-01-18;59;42;101;119561;75822;89;195383
52;2021-01-18;53;9;62;42559;15260;90;57819
52;2021-01-18;746;557;1307;1952321;1849476;0;3801797
53;2021-01-18;22;19;44;173813;182358;09;356171
53;2021-01-18;57;41;99;202720;214740;19;417460
53;2021-01-18;48;38;91;163116;173196;29;336312
53;2021-01-18;45;44;89;190526;187674;39;378200
53;2021-01-18;49;40;89;212098;212015;49;424113
53;2021-01-18;42;47;89;223699;219176;59;442875
53;2021-01-18;38;30;68;227435;209274;69;436709
53;2021-01-18;18;25;43;169992;140910;79;310902
53;2021-01-18;30;16;46;118117;69883;89;188000
53;2021-01-18;26;7;33;37370;12267;90;49637
53;2021-01-18;375;307;691;1718886;1621493;0;3340379
75;2021-01-18;43;44;88;293104;305291;09;598395
75;2021-01-18;128;143;273;337141;357785;19;694926
75;2021-01-18;161;141;302;295024;300618;29;595642
75;2021-01-18;144;135;279;347871;331233;39;679104
75;2021-01-18;179;161;341;384742;372771;49;757513
75;2021-01-18;144;134;278;413361;390880;59;804241
75;2021-01-18;99;106;205;425623;384060;69;809683
75;2021-01-18;80;75;155;325086;276298;79;601384
75;2021-01-18;90;46;136;213986;139308;89;353294
75;2021-01-18;68;22;91;77600;28200;90;105800
75;2021-01-18;1136;1007;2148;3113538;2886444;0;5999982
76;2021-01-18;49;49;98;305956;318589;09;624545
76;2021-01-18;143;146;292;338942;356969;19;695911
76;2021-01-18;193;157;351;316210;319570;29;635780
76;2021-01-18;198;145;343;356758;337587;39;694345
76;2021-01-18;266;176;443;376541;363812;49;740353
76;2021-01-18;215;165;380;402608;383750;59;786358
76;2021-01-18;155;135;290;394889;358997;69;753886
76;2021-01-18;111;87;198;308664;263806;79;572470
76;2021-01-18;113;61;174;195838;129272;89;325110
76;2021-01-18;115;27;142;69372;26728;90;96100
76;2021-01-18;1558;1148;2711;3065778;2859080;0;5924858
84;2021-01-18;78;84;163;459549;481088;09;940637
84;2021-01-18;253;255;509;487711;511905;19;999616
84;2021-01-18;305;257;563;443824;451094;29;894918
84;2021-01-18;320;263;583;512522;493262;39;1005784
84;2021-01-18;334;260;594;520248;515106;49;1035354
84;2021-01-18;322;287;610;529611;514848;59;1044459
84;2021-01-18;187;202;389;486720;439940;69;926660
84;2021-01-18;133;132;265;372151;315211;79;687362
84;2021-01-18;133;96;229;237198;150524;89;387722
84;2021-01-18;88;32;120;81185;28680;90;109865
84;2021-01-18;2154;1868;4026;4130719;3901658;0;8032377
93;2021-01-18;64;57;123;268834;283093;09;551927
93;2021-01-18;254;251;507;280751;296087;19;576838
93;2021-01-18;312;245;559;254404;255552;29;509956
93;2021-01-18;369;246;615;310704;288398;39;599102
93;2021-01-18;379;297;679;325559;305827;49;631386
93;2021-01-18;324;272;597;353104;325389;59;678493
93;2021-01-18;219;192;411;336327;296459;69;632786
93;2021-01-18;151;149;301;279820;229699;79;509519
93;2021-01-18;182;95;277;171274;113716;89;284990
93;2021-01-18;161;38;199;58896;21758;90;80654
93;2021-01-18;2415;1843;4269;2639673;2415978;0;5055651
94;2021-01-18;0;0;0;16311;17433;09;33744
94;2021-01-18;2;2;4;16679;18132;19;34811
94;2021-01-18;4;6;10;16782;16579;29;33361
94;2021-01-18;10;2;12;23044;20580;39;43624
94;2021-01-18;5;1;6;23065;22140;49;45205
94;2021-01-18;7;3;10;24549;23421;59;47970
94;2021-01-18;3;3;6;23212;21883;69;45095
94;2021-01-18;7;5;12;19544;17141;79;36685
94;2021-01-18;3;5;8;11227;8178;89;19405
94;2021-01-18;4;1;5;3332;1447;90;4779
94;2021-01-18;45;28;73;177745;166934;0;344679
01;2021-01-19;0;1;1;19979;20155;09;40134
01;2021-01-19;1;0;1;24994;25489;19;50483
01;2021-01-19;1;0;1;17868;16690;29;34558
01;2021-01-19;1;1;2;22328;14821;39;37149
01;2021-01-19;0;1;1;28652;20276;49;48928
01;2021-01-19;3;2;5;33264;27260;59;60524
01;2021-01-19;3;1;4;27135;23978;69;51113
01;2021-01-19;2;0;2;18401;14661;79;33062
01;2021-01-19;1;0;1;9633;6375;89;16008
01;2021-01-19;0;0;0;3410;1510;90;4920
01;2021-01-19;12;6;18;205664;171215;0;376879
02;2021-01-19;0;0;2;16881;17110;09;33991
02;2021-01-19;0;0;0;21410;21604;19;43014
02;2021-01-19;1;1;2;16017;15479;29;31496
02;2021-01-19;0;0;0;19825;14455;39;34280
02;2021-01-19;0;0;0;24719;18248;49;42967
02;2021-01-19;2;2;4;34361;28310;59;62671
02;2021-01-19;1;1;2;28061;24495;69;52556
02;2021-01-19;0;0;0;18231;15278;79;33509
02;2021-01-19;1;0;1;11090;7677;89;18767
02;2021-01-19;0;1;1;3992;1506;90;5498
02;2021-01-19;5;5;12;194587;164162;0;358749
03;2021-01-19;4;4;8;31123;30920;09;62043
03;2021-01-19;14;11;25;29370;29268;19;58638
03;2021-01-19;14;5;20;21458;18963;29;40421
03;2021-01-19;16;11;27;21276;18326;39;39602
03;2021-01-19;8;5;13;18164;16593;49;34757
03;2021-01-19;14;6;20;13469;13557;59;27026
03;2021-01-19;4;12;16;8776;8670;69;17446
03;2021-01-19;1;0;1;3777;3591;79;7368
03;2021-01-19;0;2;2;1649;1072;89;2721
03;2021-01-19;0;1;1;485;184;90;669
03;2021-01-19;75;57;133;149547;141144;0;290691
04;2021-01-19;1;0;2;60314;61377;09;121691
04;2021-01-19;6;5;11;66065;68387;19;134452
04;2021-01-19;7;4;11;51059;47156;29;98215
04;2021-01-19;7;7;14;58788;45780;39;104568
04;2021-01-19;3;6;9;61408;52207;49;113615
04;2021-01-19;9;3;12;64838;60759;59;125597
04;2021-01-19;1;2;3;47008;42843;69;89851
04;2021-01-19;3;2;5;25509;21184;79;46693
04;2021-01-19;0;0;0;13168;7647;89;20815
04;2021-01-19;1;0;1;3209;1253;90;4462
04;2021-01-19;38;29;68;451366;408593;0;859959
05;2021-01-19;0;0;0;362.366008612902;341.338819562748;09;703.704828175651
05;2021-01-19;0;0;0;353.376145114279;370.349735405642;19;723.725880519921
05;2021-01-19;0;0;0;218.593559489256;256.539602589476;29;475.133162078732
05;2021-01-19;0;0;0;404.225408693299;360.321910454353;39;764.547319147651
05;2021-01-19;0;0;0;520.067953604221;497.108383964256;49;1017.17633756848
05;2021-01-19;0;0;0;468.146063921917;510.087601910415;59;978.233665832332
05;2021-01-19;0;0;0;340.368470050554;334.366842191253;69;674.735312241807
05;2021-01-19;0;0;0;212.598666888387;192.597753227106;79;405.196420115493
05;2021-01-19;0;0;0;148.727797095705;61.8681715431829;89;210.595968638888
05;2021-01-19;0;0;0;32.9601271090696;10.9909785719784;90;43.9511056810479
05;2021-01-19;0;0;0;3061.43020057959;2935.56979942041;0;5997
06;2021-01-19;1;1;2;42583;42380;09;84963
06;2021-01-19;10;10;21;33369;31925;19;65294
06;2021-01-19;17;7;24;21571;15080;29;36651
06;2021-01-19;16;10;26;21550;16147;39;37697
06;2021-01-19;17;13;30;14193;13939;49;28132
06;2021-01-19;3;9;12;7171;7597;59;14768
06;2021-01-19;4;6;10;3629;4117;69;7746
06;2021-01-19;1;4;5;1577;1457;79;3034
06;2021-01-19;0;1;1;531;474;89;1005
06;2021-01-19;0;0;0;88;93;90;181
06;2021-01-19;69;61;131;146262;133209;0;279471
07;2021-01-19;0;0;0;485;549;09;1034
07;2021-01-19;0;0;0;403;432;19;835
07;2021-01-19;0;0;0;764;841;29;1605
07;2021-01-19;1;2;3;824;928;39;1752
07;2021-01-19;0;0;0;788;1020;49;1808
07;2021-01-19;1;2;3;678;870;59;1548
07;2021-01-19;0;0;0;360;382;69;742
07;2021-01-19;0;0;0;231;190;79;421
07;2021-01-19;0;0;0;114;67;89;181
07;2021-01-19;0;0;0;24;11;90;35
07;2021-01-19;2;4;6;4671;5290;0;9961
08;2021-01-19;0;0;0;2715.22592983026;2997.75551488675;09;5712.98144471701
08;2021-01-19;1;0;1;2778.51901080978;3160.9156459093;19;5939.43465671908
08;2021-01-19;1;0;1;2080.8882988764;1718.16634315323;29;3799.05464202964
08;2021-01-19;0;0;0;2701.8582062647;1896.52641413317;39;4598.38462039786
08;2021-01-19;1;1;2;3151.45861023308;2460.52498233809;49;5611.98359257117
08;2021-01-19;0;2;2;2620.29868333099;2422.23566154656;59;5042.53434487755
08;2021-01-19;0;0;0;1621.44173420671;1438.58325779464;69;3060.02499200135
08;2021-01-19;0;0;0;626.575909335673;526.358467843651;79;1152.93437717932
08;2021-01-19;1;0;1;205.018522985054;140.993639349697;89;346.012162334751
08;2021-01-19;0;0;0;50.0325684687745;20.62259870351;90;70.6551671722846
08;2021-01-19;4;3;7;18551.3174743414;16782.6825256586;0;35334
11;2021-01-19;62;80;150;783071;811785;09;1594856
11;2021-01-19;275;262;548;761456;784653;19;1546109
11;2021-01-19;392;370;762;850145;801772;29;1651917
11;2021-01-19;367;317;685;914360;843488;39;1757848
11;2021-01-19;371;332;703;845609;826202;49;1671811
11;2021-01-19;298;308;607;793566;745070;59;1538636
11;2021-01-19;182;170;355;628649;549192;69;1177841
11;2021-01-19;109;96;205;434606;358356;79;792962
11;2021-01-19;73;56;129;261425;162933;89;424358
11;2021-01-19;44;15;59;89253;32619;90;121872
11;2021-01-19;2175;2010;4209;6362140;5916070;0;12278210
24;2021-01-19;15;8;24;139720;144686;09;284406
24;2021-01-19;62;67;130;152979;161185;19;314164
24;2021-01-19;70;43;113;122237;126536;29;248773
24;2021-01-19;66;39;105;150359;142009;39;292368
24;2021-01-19;73;63;136;161829;158758;49;320587
24;2021-01-19;72;55;127;172552;168011;59;340563
24;2021-01-19;49;37;86;172509;158177;69;330686
24;2021-01-19;27;36;63;129428;110593;79;240021
24;2021-01-19;42;24;66;87342;56882;89;144224
24;2021-01-19;42;12;54;31210;12071;90;43281
24;2021-01-19;518;385;905;1320165;1238908;0;2559073
27;2021-01-19;17;17;34;143373;149679;09;293052
27;2021-01-19;76;100;176;160962;173003;19;333965
27;2021-01-19;68;62;130;133746;142254;29;276000
27;2021-01-19;77;46;123;160004;155407;39;315411
27;2021-01-19;84;70;154;172333;169564;49;341897
27;2021-01-19;104;91;195;189979;183788;59;373767
27;2021-01-19;70;68;138;192591;178206;69;370797
27;2021-01-19;58;49;107;146876;127546;79;274422
27;2021-01-19;78;48;126;96896;61575;89;158471
27;2021-01-19;80;18;98;33148;12109;90;45257
27;2021-01-19;712;569;1281;1429908;1353131;0;2783039
28;2021-01-19;16;23;39;180735;186856;09;367591
28;2021-01-19;54;53;109;200125;213621;19;413746
28;2021-01-19;84;57;141;168922;173007;29;341929
28;2021-01-19;85;65;150;196628;188487;39;385115
28;2021-01-19;87;69;156;205396;201699;49;407095
28;2021-01-19;82;56;138;222002;213866;59;435868
28;2021-01-19;56;60;116;224688;203758;69;428446
28;2021-01-19;41;52;93;163192;135543;79;298735
28;2021-01-19;62;25;87;109691;65377;89;175068
28;2021-01-19;65;9;74;37222;12685;90;49907
28;2021-01-19;632;469;1103;1708601;1594899;0;3303500
32;2021-01-19;34;41;75;358062;373689;09;731751
32;2021-01-19;122;164;286;387045;406742;19;793787
32;2021-01-19;153;134;287;342304;348587;29;690891
32;2021-01-19;184;107;291;382485;369972;39;752457
32;2021-01-19;167;142;309;382510;376716;49;759226
32;2021-01-19;153;134;287;386937;376527;59;763464
32;2021-01-19;115;79;194;371211;330938;69;702149
32;2021-01-19;84;56;140;250542;201459;79;452001
32;2021-01-19;78;38;116;163399;89786;89;253185
32;2021-01-19;56;19;75;48384;15367;90;63751
32;2021-01-19;1146;914;2060;3072879;2889783;0;5962662
44;2021-01-19;45;51;96;291525;306839;09;598364
44;2021-01-19;125;131;257;320255;339504;19;659759
44;2021-01-19;165;128;293;302020;314428;29;616448
44;2021-01-19;168;114;282;342222;333292;39;675514
44;2021-01-19;150;123;273;349727;344491;49;694218
44;2021-01-19;153;143;299;381371;373239;59;754610
44;2021-01-19;87;89;176;367165;335850;69;703015
44;2021-01-19;67;67;135;250387;215436;79;465823
44;2021-01-19;83;47;130;170825;105192;89;276017
44;2021-01-19;52;13;65;51248;16731;90;67979
44;2021-01-19;1095;906;2006;2826745;2685002;0;5511747
52;2021-01-19;13;13;27;213594;223900;09;437494
52;2021-01-19;53;80;135;240818;255197;19;496015
52;2021-01-19;70;68;138;197010;200630;29;397640
52;2021-01-19;78;55;133;231204;224885;39;456089
52;2021-01-19;72;64;137;243874;243418;49;487292
52;2021-01-19;74;71;145;244100;239116;59;483216
52;2021-01-19;53;55;108;241796;221345;69;463141
52;2021-01-19;47;45;92;177805;149903;79;327708
52;2021-01-19;55;34;89;119561;75822;89;195383
52;2021-01-19;57;17;74;42559;15260;90;57819
52;2021-01-19;572;502;1078;1952321;1849476;0;3801797
53;2021-01-19;13;15;28;173813;182358;09;356171
53;2021-01-19;34;40;75;202720;214740;19;417460
53;2021-01-19;45;37;83;163116;173196;29;336312
53;2021-01-19;50;30;80;190526;187674;39;378200
53;2021-01-19;45;35;80;212098;212015;49;424113
53;2021-01-19;34;32;66;223699;219176;59;442875
53;2021-01-19;30;34;64;227435;209274;69;436709
53;2021-01-19;29;19;48;169992;140910;79;310902
53;2021-01-19;29;19;48;118117;69883;89;188000
53;2021-01-19;33;4;37;37370;12267;90;49637
53;2021-01-19;342;265;609;1718886;1621493;0;3340379
75;2021-01-19;26;45;71;293104;305291;09;598395
75;2021-01-19;82;121;203;337141;357785;19;694926
75;2021-01-19;123;97;220;295024;300618;29;595642
75;2021-01-19;143;95;238;347871;331233;39;679104
75;2021-01-19;151;119;270;384742;372771;49;757513
75;2021-01-19;131;110;241;413361;390880;59;804241
75;2021-01-19;71;80;151;425623;384060;69;809683
75;2021-01-19;64;63;127;325086;276298;79;601384
75;2021-01-19;80;46;126;213986;139308;89;353294
75;2021-01-19;82;35;119;77600;28200;90;105800
75;2021-01-19;953;812;1767;3113538;2886444;0;5999982
76;2021-01-19;32;40;75;305956;318589;09;624545
76;2021-01-19;140;138;281;338942;356969;19;695911
76;2021-01-19;154;109;263;316210;319570;29;635780
76;2021-01-19;176;142;318;356758;337587;39;694345
76;2021-01-19;184;143;328;376541;363812;49;740353
76;2021-01-19;182;130;312;402608;383750;59;786358
76;2021-01-19;115;99;214;394889;358997;69;753886
76;2021-01-19;82;93;175;308664;263806;79;572470
76;2021-01-19;101;53;154;195838;129272;89;325110
76;2021-01-19;80;32;112;69372;26728;90;96100
76;2021-01-19;1246;980;2233;3065778;2859080;0;5924858
84;2021-01-19;54;68;123;459549;481088;09;940637
84;2021-01-19;205;224;433;487711;511905;19;999616
84;2021-01-19;224;186;410;443824;451094;29;894918
84;2021-01-19;250;185;435;512522;493262;39;1005784
84;2021-01-19;273;191;464;520248;515106;49;1035354
84;2021-01-19;215;206;421;529611;514848;59;1044459
84;2021-01-19;155;150;305;486720;439940;69;926660
84;2021-01-19;110;89;199;372151;315211;79;687362
84;2021-01-19;116;68;184;237198;150524;89;387722
84;2021-01-19;121;23;144;81185;28680;90;109865
84;2021-01-19;1724;1391;3120;4130719;3901658;0;8032377
93;2021-01-19;45;65;111;268834;283093;09;551927
93;2021-01-19;204;188;392;280751;296087;19;576838
93;2021-01-19;244;213;457;254404;255552;29;509956
93;2021-01-19;272;186;458;310704;288398;39;599102
93;2021-01-19;275;190;467;325559;305827;49;631386
93;2021-01-19;275;198;474;353104;325389;59;678493
93;2021-01-19;149;152;301;336327;296459;69;632786
93;2021-01-19;129;97;226;279820;229699;79;509519
93;2021-01-19;139;91;230;171274;113716;89;284990
93;2021-01-19;116;33;149;58896;21758;90;80654
93;2021-01-19;1848;1413;3265;2639673;2415978;0;5055651
94;2021-01-19;0;0;0;16311;17433;09;33744
94;2021-01-19;5;3;8;16679;18132;19;34811
94;2021-01-19;2;1;3;16782;16579;29;33361
94;2021-01-19;3;5;8;23044;20580;39;43624
94;2021-01-19;4;5;9;23065;22140;49;45205
94;2021-01-19;5;5;10;24549;23421;59;47970
94;2021-01-19;5;3;8;23212;21883;69;45095
94;2021-01-19;4;5;9;19544;17141;79;36685
94;2021-01-19;1;0;1;11227;8178;89;19405
94;2021-01-19;0;1;1;3332;1447;90;4779
94;2021-01-19;29;28;57;177745;166934;0;344679
01;2021-01-20;0;0;0;19979;20155;09;40134
01;2021-01-20;0;0;0;24994;25489;19;50483
01;2021-01-20;1;0;1;17868;16690;29;34558
01;2021-01-20;2;2;4;22328;14821;39;37149
01;2021-01-20;1;1;2;28652;20276;49;48928
01;2021-01-20;1;1;2;33264;27260;59;60524
01;2021-01-20;0;0;0;27135;23978;69;51113
01;2021-01-20;2;1;3;18401;14661;79;33062
01;2021-01-20;2;2;4;9633;6375;89;16008
01;2021-01-20;2;2;4;3410;1510;90;4920
01;2021-01-20;11;9;20;205664;171215;0;376879
02;2021-01-20;0;0;0;16881;17110;09;33991
02;2021-01-20;2;0;2;21410;21604;19;43014
02;2021-01-20;3;0;3;16017;15479;29;31496
02;2021-01-20;1;0;1;19825;14455;39;34280
02;2021-01-20;1;1;2;24719;18248;49;42967
02;2021-01-20;2;2;4;34361;28310;59;62671
02;2021-01-20;1;3;4;28061;24495;69;52556
02;2021-01-20;0;1;1;18231;15278;79;33509
02;2021-01-20;0;1;1;11090;7677;89;18767
02;2021-01-20;0;0;0;3992;1506;90;5498
02;2021-01-20;10;8;18;194587;164162;0;358749
03;2021-01-20;3;4;7;31123;30920;09;62043
03;2021-01-20;8;11;20;29370;29268;19;58638
03;2021-01-20;18;7;25;21458;18963;29;40421
03;2021-01-20;17;9;26;21276;18326;39;39602
03;2021-01-20;6;8;14;18164;16593;49;34757
03;2021-01-20;6;4;10;13469;13557;59;27026
03;2021-01-20;5;11;16;8776;8670;69;17446
03;2021-01-20;2;2;4;3777;3591;79;7368
03;2021-01-20;0;0;0;1649;1072;89;2721
03;2021-01-20;1;1;2;485;184;90;669
03;2021-01-20;66;57;124;149547;141144;0;290691
04;2021-01-20;4;4;8;60314;61377;09;121691
04;2021-01-20;9;6;15;66065;68387;19;134452
04;2021-01-20;7;10;17;51059;47156;29;98215
04;2021-01-20;2;6;8;58788;45780;39;104568
04;2021-01-20;6;4;10;61408;52207;49;113615
04;2021-01-20;1;2;3;64838;60759;59;125597
04;2021-01-20;2;2;4;47008;42843;69;89851
04;2021-01-20;2;2;4;25509;21184;79;46693
04;2021-01-20;1;2;3;13168;7647;89;20815
04;2021-01-20;0;0;0;3209;1253;90;4462
04;2021-01-20;34;38;72;451366;408593;0;859959
05;2021-01-20;0;0;0;362.366008612902;341.338819562748;09;703.704828175651
05;2021-01-20;0;0;0;353.376145114279;370.349735405642;19;723.725880519921
05;2021-01-20;0;0;0;218.593559489256;256.539602589476;29;475.133162078732
05;2021-01-20;0;0;0;404.225408693299;360.321910454353;39;764.547319147651
05;2021-01-20;0;0;0;520.067953604221;497.108383964256;49;1017.17633756848
05;2021-01-20;0;0;0;468.146063921917;510.087601910415;59;978.233665832332
05;2021-01-20;0;0;0;340.368470050554;334.366842191253;69;674.735312241807
05;2021-01-20;0;0;0;212.598666888387;192.597753227106;79;405.196420115493
05;2021-01-20;0;0;0;148.727797095705;61.8681715431829;89;210.595968638888
05;2021-01-20;0;0;0;32.9601271090696;10.9909785719784;90;43.9511056810479
05;2021-01-20;0;0;0;3061.43020057959;2935.56979942041;0;5997
06;2021-01-20;0;0;0;42583;42380;09;84963
06;2021-01-20;11;8;20;33369;31925;19;65294
06;2021-01-20;14;10;24;21571;15080;29;36651
06;2021-01-20;8;6;14;21550;16147;39;37697
06;2021-01-20;9;7;16;14193;13939;49;28132
06;2021-01-20;5;7;12;7171;7597;59;14768
06;2021-01-20;2;3;5;3629;4117;69;7746
06;2021-01-20;2;3;5;1577;1457;79;3034
06;2021-01-20;0;0;0;531;474;89;1005
06;2021-01-20;0;0;0;88;93;90;181
06;2021-01-20;51;44;96;146262;133209;0;279471
07;2021-01-20;0;0;0;485;549;09;1034
07;2021-01-20;0;0;0;403;432;19;835
07;2021-01-20;0;1;1;764;841;29;1605
07;2021-01-20;2;2;4;824;928;39;1752
07;2021-01-20;2;0;2;788;1020;49;1808
07;2021-01-20;1;0;1;678;870;59;1548
07;2021-01-20;0;1;1;360;382;69;742
07;2021-01-20;0;0;0;231;190;79;421
07;2021-01-20;0;0;0;114;67;89;181
07;2021-01-20;0;0;0;24;11;90;35
07;2021-01-20;5;4;9;4671;5290;0;9961
08;2021-01-20;0;0;0;2715.22592983026;2997.75551488675;09;5712.98144471701
08;2021-01-20;1;0;1;2778.51901080978;3160.9156459093;19;5939.43465671908
08;2021-01-20;1;2;3;2080.8882988764;1718.16634315323;29;3799.05464202964
08;2021-01-20;3;3;6;2701.8582062647;1896.52641413317;39;4598.38462039786
08;2021-01-20;3;2;5;3151.45861023308;2460.52498233809;49;5611.98359257117
08;2021-01-20;0;2;2;2620.29868333099;2422.23566154656;59;5042.53434487755
08;2021-01-20;1;0;1;1621.44173420671;1438.58325779464;69;3060.02499200135
08;2021-01-20;0;0;0;626.575909335673;526.358467843651;79;1152.93437717932
08;2021-01-20;0;0;0;205.018522985054;140.993639349697;89;346.012162334751
08;2021-01-20;0;0;0;50.0325684687745;20.62259870351;90;70.6551671722846
08;2021-01-20;9;9;18;18551.3174743414;16782.6825256586;0;35334
11;2021-01-20;113;97;218;783071;811785;09;1594856
11;2021-01-20;283;296;592;761456;784653;19;1546109
11;2021-01-20;411;347;760;850145;801772;29;1651917
11;2021-01-20;355;309;668;914360;843488;39;1757848
11;2021-01-20;324;303;628;845609;826202;49;1671811
11;2021-01-20;287;256;543;793566;745070;59;1538636
11;2021-01-20;195;178;381;628649;549192;69;1177841
11;2021-01-20;107;105;212;434606;358356;79;792962
11;2021-01-20;95;60;155;261425;162933;89;424358
11;2021-01-20;65;17;83;89253;32619;90;121872
11;2021-01-20;2236;1970;4248;6362140;5916070;0;12278210
24;2021-01-20;22;16;38;139720;144686;09;284406
24;2021-01-20;78;79;157;152979;161185;19;314164
24;2021-01-20;63;48;111;122237;126536;29;248773
24;2021-01-20;70;43;113;150359;142009;39;292368
24;2021-01-20;72;52;125;161829;158758;49;320587
24;2021-01-20;49;52;101;172552;168011;59;340563
24;2021-01-20;39;39;78;172509;158177;69;330686
24;2021-01-20;31;31;62;129428;110593;79;240021
24;2021-01-20;37;20;57;87342;56882;89;144224
24;2021-01-20;33;7;40;31210;12071;90;43281
24;2021-01-20;494;387;882;1320165;1238908;0;2559073
27;2021-01-20;20;19;40;143373;149679;09;293052
27;2021-01-20;71;90;161;160962;173003;19;333965
27;2021-01-20;78;45;123;133746;142254;29;276000
27;2021-01-20;69;54;123;160004;155407;39;315411
27;2021-01-20;78;57;135;172333;169564;49;341897
27;2021-01-20;69;84;153;189979;183788;59;373767
27;2021-01-20;43;52;95;192591;178206;69;370797
27;2021-01-20;38;30;68;146876;127546;79;274422
27;2021-01-20;61;32;93;96896;61575;89;158471
27;2021-01-20;31;3;34;33148;12109;90;45257
27;2021-01-20;558;466;1027;1429908;1353131;0;2783039
28;2021-01-20;17;20;37;180735;186856;09;367591
28;2021-01-20;53;63;118;200125;213621;19;413746
28;2021-01-20;74;53;127;168922;173007;29;341929
28;2021-01-20;81;60;141;196628;188487;39;385115
28;2021-01-20;90;68;158;205396;201699;49;407095
28;2021-01-20;84;66;150;222002;213866;59;435868
28;2021-01-20;61;53;114;224688;203758;69;428446
28;2021-01-20;45;38;83;163192;135543;79;298735
28;2021-01-20;60;30;90;109691;65377;89;175068
28;2021-01-20;43;13;56;37222;12685;90;49907
28;2021-01-20;608;464;1075;1708601;1594899;0;3303500
32;2021-01-20;42;52;96;358062;373689;09;731751
32;2021-01-20;163;142;307;387045;406742;19;793787
32;2021-01-20;149;121;270;342304;348587;29;690891
32;2021-01-20;170;115;285;382485;369972;39;752457
32;2021-01-20;139;143;282;382510;376716;49;759226
32;2021-01-20;123;127;250;386937;376527;59;763464
32;2021-01-20;82;100;182;371211;330938;69;702149
32;2021-01-20;74;61;135;250542;201459;79;452001
32;2021-01-20;62;42;104;163399;89786;89;253185
32;2021-01-20;26;17;43;48384;15367;90;63751
32;2021-01-20;1030;921;1960;3072879;2889783;0;5962662
44;2021-01-20;40;39;80;291525;306839;09;598364
44;2021-01-20;140;149;291;320255;339504;19;659759
44;2021-01-20;163;118;282;302020;314428;29;616448
44;2021-01-20;168;119;288;342222;333292;39;675514
44;2021-01-20;145;141;286;349727;344491;49;694218
44;2021-01-20;136;115;254;381371;373239;59;754610
44;2021-01-20;78;73;151;367165;335850;69;703015
44;2021-01-20;63;56;120;250387;215436;79;465823
44;2021-01-20;83;52;137;170825;105192;89;276017
44;2021-01-20;61;16;77;51248;16731;90;67979
44;2021-01-20;1077;878;1969;2826745;2685002;0;5511747
52;2021-01-20;14;21;38;213594;223900;09;437494
52;2021-01-20;51;61;115;240818;255197;19;496015
52;2021-01-20;65;95;160;197010;200630;29;397640
52;2021-01-20;85;75;162;231204;224885;39;456089
52;2021-01-20;83;68;151;243874;243418;49;487292
52;2021-01-20;68;55;124;244100;239116;59;483216
52;2021-01-20;51;51;103;241796;221345;69;463141
52;2021-01-20;26;37;63;177805;149903;79;327708
52;2021-01-20;50;31;81;119561;75822;89;195383
52;2021-01-20;31;9;40;42559;15260;90;57819
52;2021-01-20;524;503;1037;1952321;1849476;0;3801797
53;2021-01-20;16;14;30;173813;182358;09;356171
53;2021-01-20;41;41;82;202720;214740;19;417460
53;2021-01-20;46;38;88;163116;173196;29;336312
53;2021-01-20;39;35;74;190526;187674;39;378200
53;2021-01-20;41;39;80;212098;212015;49;424113
53;2021-01-20;27;37;64;223699;219176;59;442875
53;2021-01-20;28;27;55;227435;209274;69;436709
53;2021-01-20;11;13;24;169992;140910;79;310902
53;2021-01-20;32;13;45;118117;69883;89;188000
53;2021-01-20;11;7;19;37370;12267;90;49637
53;2021-01-20;292;264;561;1718886;1621493;0;3340379
75;2021-01-20;33;29;64;293104;305291;09;598395
75;2021-01-20;108;99;209;337141;357785;19;694926
75;2021-01-20;124;103;227;295024;300618;29;595642
75;2021-01-20;116;81;197;347871;331233;39;679104
75;2021-01-20;121;112;233;384742;372771;49;757513
75;2021-01-20;126;111;237;413361;390880;59;804241
75;2021-01-20;96;83;179;425623;384060;69;809683
75;2021-01-20;54;53;107;325086;276298;79;601384
75;2021-01-20;54;28;83;213986;139308;89;353294
75;2021-01-20;42;16;58;77600;28200;90;105800
75;2021-01-20;874;716;1597;3113538;2886444;0;5999982
76;2021-01-20;38;44;84;305956;318589;09;624545
76;2021-01-20;120;137;259;338942;356969;19;695911
76;2021-01-20;145;119;264;316210;319570;29;635780
76;2021-01-20;161;119;280;356758;337587;39;694345
76;2021-01-20;150;129;279;376541;363812;49;740353
76;2021-01-20;147;150;297;402608;383750;59;786358
76;2021-01-20;92;74;166;394889;358997;69;753886
76;2021-01-20;79;63;142;308664;263806;79;572470
76;2021-01-20;68;53;122;195838;129272;89;325110
76;2021-01-20;60;21;81;69372;26728;90;96100
76;2021-01-20;1060;912;1977;3065778;2859080;0;5924858
84;2021-01-20;63;75;138;459549;481088;09;940637
84;2021-01-20;211;218;430;487711;511905;19;999616
84;2021-01-20;213;194;407;443824;451094;29;894918
84;2021-01-20;225;192;417;512522;493262;39;1005784
84;2021-01-20;256;207;463;520248;515106;49;1035354
84;2021-01-20;211;199;411;529611;514848;59;1044459
84;2021-01-20;129;121;250;486720;439940;69;926660
84;2021-01-20;109;77;186;372151;315211;79;687362
84;2021-01-20;88;60;148;237198;150524;89;387722
84;2021-01-20;88;27;115;81185;28680;90;109865
84;2021-01-20;1593;1371;2967;4130719;3901658;0;8032377
93;2021-01-20;53;55;109;268834;283093;09;551927
93;2021-01-20;191;173;366;280751;296087;19;576838
93;2021-01-20;229;163;393;254404;255552;29;509956
93;2021-01-20;227;186;413;310704;288398;39;599102
93;2021-01-20;267;203;470;325559;305827;49;631386
93;2021-01-20;268;219;488;353104;325389;59;678493
93;2021-01-20;151;147;298;336327;296459;69;632786
93;2021-01-20;98;92;190;279820;229699;79;509519
93;2021-01-20;107;76;183;171274;113716;89;284990
93;2021-01-20;87;16;104;58896;21758;90;80654
93;2021-01-20;1678;1330;3015;2639673;2415978;0;5055651
94;2021-01-20;0;0;0;16311;17433;09;33744
94;2021-01-20;2;4;6;16679;18132;19;34811
94;2021-01-20;3;2;5;16782;16579;29;33361
94;2021-01-20;1;1;2;23044;20580;39;43624
94;2021-01-20;3;1;4;23065;22140;49;45205
94;2021-01-20;1;2;3;24549;23421;59;47970
94;2021-01-20;5;4;9;23212;21883;69;45095
94;2021-01-20;2;3;5;19544;17141;79;36685
94;2021-01-20;1;1;2;11227;8178;89;19405
94;2021-01-20;2;1;3;3332;1447;90;4779
94;2021-01-20;20;19;39;177745;166934;0;344679
01;2021-01-21;0;0;0;19979;20155;09;40134
01;2021-01-21;1;1;2;24994;25489;19;50483
01;2021-01-21;0;3;3;17868;16690;29;34558
01;2021-01-21;0;0;0;22328;14821;39;37149
01;2021-01-21;2;0;2;28652;20276;49;48928
01;2021-01-21;1;1;2;33264;27260;59;60524
01;2021-01-21;1;4;5;27135;23978;69;51113
01;2021-01-21;0;0;0;18401;14661;79;33062
01;2021-01-21;1;0;1;9633;6375;89;16008
01;2021-01-21;0;0;0;3410;1510;90;4920
01;2021-01-21;6;9;15;205664;171215;0;376879
02;2021-01-21;0;0;0;16881;17110;09;33991
02;2021-01-21;0;0;0;21410;21604;19;43014
02;2021-01-21;0;0;0;16017;15479;29;31496
02;2021-01-21;0;1;1;19825;14455;39;34280
02;2021-01-21;1;1;2;24719;18248;49;42967
02;2021-01-21;1;0;1;34361;28310;59;62671
02;2021-01-21;1;1;2;28061;24495;69;52556
02;2021-01-21;0;0;0;18231;15278;79;33509
02;2021-01-21;0;0;0;11090;7677;89;18767
02;2021-01-21;0;0;0;3992;1506;90;5498
02;2021-01-21;3;3;6;194587;164162;0;358749
03;2021-01-21;4;0;4;31123;30920;09;62043
03;2021-01-21;10;9;19;29370;29268;19;58638
03;2021-01-21;5;13;18;21458;18963;29;40421
03;2021-01-21;12;2;14;21276;18326;39;39602
03;2021-01-21;7;6;13;18164;16593;49;34757
03;2021-01-21;8;6;14;13469;13557;59;27026
03;2021-01-21;4;8;12;8776;8670;69;17446
03;2021-01-21;0;1;1;3777;3591;79;7368
03;2021-01-21;0;0;0;1649;1072;89;2721
03;2021-01-21;1;0;1;485;184;90;669
03;2021-01-21;51;45;96;149547;141144;0;290691
04;2021-01-21;1;0;1;60314;61377;09;121691
04;2021-01-21;5;3;9;66065;68387;19;134452
04;2021-01-21;7;5;12;51059;47156;29;98215
04;2021-01-21;2;1;3;58788;45780;39;104568
04;2021-01-21;5;4;9;61408;52207;49;113615
04;2021-01-21;3;4;7;64838;60759;59;125597
04;2021-01-21;3;2;5;47008;42843;69;89851
04;2021-01-21;2;0;2;25509;21184;79;46693
04;2021-01-21;0;3;3;13168;7647;89;20815
04;2021-01-21;0;0;0;3209;1253;90;4462
04;2021-01-21;28;22;51;451366;408593;0;859959
05;2021-01-21;0;0;0;362.366008612902;341.338819562748;09;703.704828175651
05;2021-01-21;0;0;0;353.376145114279;370.349735405642;19;723.725880519921
05;2021-01-21;0;0;0;218.593559489256;256.539602589476;29;475.133162078732
05;2021-01-21;0;0;0;404.225408693299;360.321910454353;39;764.547319147651
05;2021-01-21;0;0;0;520.067953604221;497.108383964256;49;1017.17633756848
05;2021-01-21;0;0;0;468.146063921917;510.087601910415;59;978.233665832332
05;2021-01-21;0;1;1;340.368470050554;334.366842191253;69;674.735312241807
05;2021-01-21;0;0;0;212.598666888387;192.597753227106;79;405.196420115493
05;2021-01-21;0;0;0;148.727797095705;61.8681715431829;89;210.595968638888
05;2021-01-21;0;0;0;32.9601271090696;10.9909785719784;90;43.9511056810479
05;2021-01-21;0;1;1;3061.43020057959;2935.56979942041;0;5997
06;2021-01-21;2;0;2;42583;42380;09;84963
06;2021-01-21;16;10;27;33369;31925;19;65294
06;2021-01-21;16;12;28;21571;15080;29;36651
06;2021-01-21;16;12;28;21550;16147;39;37697
06;2021-01-21;18;17;35;14193;13939;49;28132
06;2021-01-21;11;5;16;7171;7597;59;14768
06;2021-01-21;0;7;7;3629;4117;69;7746
06;2021-01-21;3;2;5;1577;1457;79;3034
06;2021-01-21;0;0;0;531;474;89;1005
06;2021-01-21;0;0;0;88;93;90;181
06;2021-01-21;82;65;148;146262;133209;0;279471
07;2021-01-21;0;0;0;485;549;09;1034
07;2021-01-21;0;0;0;403;432;19;835
07;2021-01-21;4;0;4;764;841;29;1605
07;2021-01-21;1;1;2;824;928;39;1752
07;2021-01-21;1;1;2;788;1020;49;1808
07;2021-01-21;0;1;1;678;870;59;1548
07;2021-01-21;0;0;0;360;382;69;742
07;2021-01-21;0;0;0;231;190;79;421
07;2021-01-21;0;0;0;114;67;89;181
07;2021-01-21;0;0;0;24;11;90;35
07;2021-01-21;6;3;9;4671;5290;0;9961
08;2021-01-21;0;0;0;2715.22592983026;2997.75551488675;09;5712.98144471701
08;2021-01-21;0;3;3;2778.51901080978;3160.9156459093;19;5939.43465671908
08;2021-01-21;0;2;2;2080.8882988764;1718.16634315323;29;3799.05464202964
08;2021-01-21;6;0;6;2701.8582062647;1896.52641413317;39;4598.38462039786
08;2021-01-21;0;0;0;3151.45861023308;2460.52498233809;49;5611.98359257117
08;2021-01-21;2;1;3;2620.29868333099;2422.23566154656;59;5042.53434487755
08;2021-01-21;2;2;4;1621.44173420671;1438.58325779464;69;3060.02499200135
08;2021-01-21;0;1;1;626.575909335673;526.358467843651;79;1152.93437717932
08;2021-01-21;0;0;0;205.018522985054;140.993639349697;89;346.012162334751
08;2021-01-21;0;0;0;50.0325684687745;20.62259870351;90;70.6551671722846
08;2021-01-21;10;9;19;18551.3174743414;16782.6825256586;0;35334
11;2021-01-21;83;106;201;783071;811785;09;1594856
11;2021-01-21;280;271;564;761456;784653;19;1546109
11;2021-01-21;397;365;765;850145;801772;29;1651917
11;2021-01-21;407;372;780;914360;843488;39;1757848
11;2021-01-21;358;327;685;845609;826202;49;1671811
11;2021-01-21;297;273;570;793566;745070;59;1538636
11;2021-01-21;204;210;415;628649;549192;69;1177841
11;2021-01-21;94;91;187;434606;358356;79;792962
11;2021-01-21;92;63;155;261425;162933;89;424358
11;2021-01-21;55;12;67;89253;32619;90;121872
11;2021-01-21;2267;2091;4394;6362140;5916070;0;12278210
24;2021-01-21;13;12;26;139720;144686;09;284406
24;2021-01-21;56;65;122;152979;161185;19;314164
24;2021-01-21;61;38;99;122237;126536;29;248773
24;2021-01-21;73;51;124;150359;142009;39;292368
24;2021-01-21;69;51;120;161829;158758;49;320587
24;2021-01-21;55;41;96;172552;168011;59;340563
24;2021-01-21;47;38;85;172509;158177;69;330686
24;2021-01-21;27;22;49;129428;110593;79;240021
24;2021-01-21;30;25;55;87342;56882;89;144224
24;2021-01-21;14;8;22;31210;12071;90;43281
24;2021-01-21;445;351;798;1320165;1238908;0;2559073
27;2021-01-21;20;18;38;143373;149679;09;293052
27;2021-01-21;67;76;145;160962;173003;19;333965
27;2021-01-21;69;53;122;133746;142254;29;276000
27;2021-01-21;73;49;122;160004;155407;39;315411
27;2021-01-21;90;67;157;172333;169564;49;341897
27;2021-01-21;78;73;151;189979;183788;59;373767
27;2021-01-21;56;61;117;192591;178206;69;370797
27;2021-01-21;58;52;110;146876;127546;79;274422
27;2021-01-21;41;29;71;96896;61575;89;158471
27;2021-01-21;47;17;64;33148;12109;90;45257
27;2021-01-21;599;495;1097;1429908;1353131;0;2783039
28;2021-01-21;18;14;33;180735;186856;09;367591
28;2021-01-21;58;54;116;200125;213621;19;413746
28;2021-01-21;86;58;144;168922;173007;29;341929
28;2021-01-21;66;66;132;196628;188487;39;385115
28;2021-01-21;76;52;128;205396;201699;49;407095
28;2021-01-21;61;73;134;222002;213866;59;435868
28;2021-01-21;51;45;96;224688;203758;69;428446
28;2021-01-21;40;22;62;163192;135543;79;298735
28;2021-01-21;48;22;70;109691;65377;89;175068
28;2021-01-21;35;11;46;37222;12685;90;49907
28;2021-01-21;539;417;962;1708601;1594899;0;3303500
32;2021-01-21;41;44;86;358062;373689;09;731751
32;2021-01-21;123;147;271;387045;406742;19;793787
32;2021-01-21;146;119;265;342304;348587;29;690891
32;2021-01-21;176;110;286;382485;369972;39;752457
32;2021-01-21;169;133;302;382510;376716;49;759226
32;2021-01-21;143;124;267;386937;376527;59;763464
32;2021-01-21;112;104;216;371211;330938;69;702149
32;2021-01-21;67;69;136;250542;201459;79;452001
32;2021-01-21;81;43;124;163399;89786;89;253185
32;2021-01-21;32;8;40;48384;15367;90;63751
32;2021-01-21;1090;902;1994;3072879;2889783;0;5962662
44;2021-01-21;48;43;93;291525;306839;09;598364
44;2021-01-21;146;142;288;320255;339504;19;659759
44;2021-01-21;164;115;280;302020;314428;29;616448
44;2021-01-21;169;113;282;342222;333292;39;675514
44;2021-01-21;131;131;263;349727;344491;49;694218
44;2021-01-21;150;132;283;381371;373239;59;754610
44;2021-01-21;98;110;208;367165;335850;69;703015
44;2021-01-21;68;52;120;250387;215436;79;465823
44;2021-01-21;85;54;139;170825;105192;89;276017
44;2021-01-21;57;17;74;51248;16731;90;67979
44;2021-01-21;1116;909;2030;2826745;2685002;0;5511747
52;2021-01-21;12;15;29;213594;223900;09;437494
52;2021-01-21;50;55;105;240818;255197;19;496015
52;2021-01-21;61;65;127;197010;200630;29;397640
52;2021-01-21;86;57;144;231204;224885;39;456089
52;2021-01-21;83;60;145;243874;243418;49;487292
52;2021-01-21;72;66;139;244100;239116;59;483216
52;2021-01-21;52;58;110;241796;221345;69;463141
52;2021-01-21;34;23;57;177805;149903;79;327708
52;2021-01-21;39;20;59;119561;75822;89;195383
52;2021-01-21;28;10;38;42559;15260;90;57819
52;2021-01-21;517;429;953;1952321;1849476;0;3801797
53;2021-01-21;13;14;27;173813;182358;09;356171
53;2021-01-21;30;39;70;202720;214740;19;417460
53;2021-01-21;56;36;93;163116;173196;29;336312
53;2021-01-21;38;37;75;190526;187674;39;378200
53;2021-01-21;51;33;84;212098;212015;49;424113
53;2021-01-21;31;32;63;223699;219176;59;442875
53;2021-01-21;20;22;42;227435;209274;69;436709
53;2021-01-21;13;14;27;169992;140910;79;310902
53;2021-01-21;28;15;43;118117;69883;89;188000
53;2021-01-21;20;3;27;37370;12267;90;49637
53;2021-01-21;300;245;552;1718886;1621493;0;3340379
75;2021-01-21;46;47;93;293104;305291;09;598395
75;2021-01-21;93;113;206;337141;357785;19;694926
75;2021-01-21;104;102;206;295024;300618;29;595642
75;2021-01-21;128;114;242;347871;331233;39;679104
75;2021-01-21;113;94;207;384742;372771;49;757513
75;2021-01-21;120;104;224;413361;390880;59;804241
75;2021-01-21;81;101;182;425623;384060;69;809683
75;2021-01-21;46;50;96;325086;276298;79;601384
75;2021-01-21;101;41;142;213986;139308;89;353294
75;2021-01-21;72;25;97;77600;28200;90;105800
75;2021-01-21;904;791;1697;3113538;2886444;0;5999982
76;2021-01-21;34;37;75;305956;318589;09;624545
76;2021-01-21;123;127;256;338942;356969;19;695911
76;2021-01-21;149;131;280;316210;319570;29;635780
76;2021-01-21;165;132;297;356758;337587;39;694345
76;2021-01-21;176;117;293;376541;363812;49;740353
76;2021-01-21;150;124;276;402608;383750;59;786358
76;2021-01-21;90;105;195;394889;358997;69;753886
76;2021-01-21;65;54;119;308664;263806;79;572470
76;2021-01-21;99;55;154;195838;129272;89;325110
76;2021-01-21;86;20;106;69372;26728;90;96100
76;2021-01-21;1137;903;2052;3065778;2859080;0;5924858
84;2021-01-21;65;74;140;459549;481088;09;940637
84;2021-01-21;188;203;394;487711;511905;19;999616
84;2021-01-21;215;170;386;443824;451094;29;894918
84;2021-01-21;245;208;454;512522;493262;39;1005784
84;2021-01-21;267;211;478;520248;515106;49;1035354
84;2021-01-21;243;211;454;529611;514848;59;1044459
84;2021-01-21;124;125;249;486720;439940;69;926660
84;2021-01-21;97;88;185;372151;315211;79;687362
84;2021-01-21;95;58;153;237198;150524;89;387722
84;2021-01-21;67;24;91;81185;28680;90;109865
84;2021-01-21;1606;1372;2990;4130719;3901658;0;8032377
93;2021-01-21;51;49;104;268834;283093;09;551927
93;2021-01-21;152;160;312;280751;296087;19;576838
93;2021-01-21;237;176;414;254404;255552;29;509956
93;2021-01-21;263;210;473;310704;288398;39;599102
93;2021-01-21;216;216;433;325559;305827;49;631386
93;2021-01-21;258;224;482;353104;325389;59;678493
93;2021-01-21;152;160;313;336327;296459;69;632786
93;2021-01-21;154;110;264;279820;229699;79;509519
93;2021-01-21;153;89;242;171274;113716;89;284990
93;2021-01-21;156;38;194;58896;21758;90;80654
93;2021-01-21;1793;1432;3232;2639673;2415978;0;5055651
94;2021-01-21;1;1;2;16311;17433;09;33744
94;2021-01-21;2;5;7;16679;18132;19;34811
94;2021-01-21;6;4;10;16782;16579;29;33361
94;2021-01-21;2;5;7;23044;20580;39;43624
94;2021-01-21;4;3;7;23065;22140;49;45205
94;2021-01-21;3;5;8;24549;23421;59;47970
94;2021-01-21;1;6;7;23212;21883;69;45095
94;2021-01-21;2;3;5;19544;17141;79;36685
94;2021-01-21;4;2;6;11227;8178;89;19405
94;2021-01-21;4;1;5;3332;1447;90;4779
94;2021-01-21;29;35;64;177745;166934;0;344679
01;2021-01-22;1;1;2;19979;20155;09;40134
01;2021-01-22;0;2;2;24994;25489;19;50483
01;2021-01-22;0;2;2;17868;16690;29;34558
01;2021-01-22;3;1;4;22328;14821;39;37149
01;2021-01-22;1;4;5;28652;20276;49;48928
01;2021-01-22;2;3;5;33264;27260;59;60524
01;2021-01-22;0;1;1;27135;23978;69;51113
01;2021-01-22;2;0;2;18401;14661;79;33062
01;2021-01-22;0;0;0;9633;6375;89;16008
01;2021-01-22;0;0;0;3410;1510;90;4920
01;2021-01-22;9;14;23;205664;171215;0;376879
02;2021-01-22;0;0;0;16881;17110;09;33991
02;2021-01-22;0;0;0;21410;21604;19;43014
02;2021-01-22;1;0;1;16017;15479;29;31496
02;2021-01-22;2;0;2;19825;14455;39;34280
02;2021-01-22;3;1;4;24719;18248;49;42967
02;2021-01-22;1;4;5;34361;28310;59;62671
02;2021-01-22;0;1;1;28061;24495;69;52556
02;2021-01-22;2;1;3;18231;15278;79;33509
02;2021-01-22;0;0;0;11090;7677;89;18767
02;2021-01-22;0;0;0;3992;1506;90;5498
02;2021-01-22;9;7;16;194587;164162;0;358749
03;2021-01-22;1;1;2;31123;30920;09;62043
03;2021-01-22;8;7;15;29370;29268;19;58638
03;2021-01-22;14;9;23;21458;18963;29;40421
03;2021-01-22;7;7;14;21276;18326;39;39602
03;2021-01-22;3;7;10;18164;16593;49;34757
03;2021-01-22;4;8;12;13469;13557;59;27026
03;2021-01-22;4;4;8;8776;8670;69;17446
03;2021-01-22;1;1;2;3777;3591;79;7368
03;2021-01-22;0;0;0;1649;1072;89;2721
03;2021-01-22;0;0;0;485;184;90;669
03;2021-01-22;42;44;86;149547;141144;0;290691
04;2021-01-22;0;2;2;60314;61377;09;121691
04;2021-01-22;2;5;7;66065;68387;19;134452
04;2021-01-22;4;6;10;51059;47156;29;98215
04;2021-01-22;4;3;7;58788;45780;39;104568
04;2021-01-22;5;6;11;61408;52207;49;113615
04;2021-01-22;1;3;4;64838;60759;59;125597
04;2021-01-22;2;7;9;47008;42843;69;89851
04;2021-01-22;0;1;1;25509;21184;79;46693
04;2021-01-22;0;0;0;13168;7647;89;20815
04;2021-01-22;1;0;1;3209;1253;90;4462
04;2021-01-22;19;33;52;451366;408593;0;859959
05;2021-01-22;0;0;0;362.366008612902;341.338819562748;09;703.704828175651
05;2021-01-22;0;0;0;353.376145114279;370.349735405642;19;723.725880519921
05;2021-01-22;0;0;0;218.593559489256;256.539602589476;29;475.133162078732
05;2021-01-22;0;0;0;404.225408693299;360.321910454353;39;764.547319147651
05;2021-01-22;0;0;0;520.067953604221;497.108383964256;49;1017.17633756848
05;2021-01-22;0;0;0;468.146063921917;510.087601910415;59;978.233665832332
05;2021-01-22;0;0;0;340.368470050554;334.366842191253;69;674.735312241807
05;2021-01-22;0;0;0;212.598666888387;192.597753227106;79;405.196420115493
05;2021-01-22;0;0;0;148.727797095705;61.8681715431829;89;210.595968638888
05;2021-01-22;0;0;0;32.9601271090696;10.9909785719784;90;43.9511056810479
05;2021-01-22;0;0;0;3061.43020057959;2935.56979942041;0;5997
06;2021-01-22;5;0;5;42583;42380;09;84963
06;2021-01-22;7;6;15;33369;31925;19;65294
06;2021-01-22;15;7;22;21571;15080;29;36651
06;2021-01-22;11;14;25;21550;16147;39;37697
06;2021-01-22;7;5;12;14193;13939;49;28132
06;2021-01-22;6;8;14;7171;7597;59;14768
06;2021-01-22;16;14;31;3629;4117;69;7746
06;2021-01-22;3;1;4;1577;1457;79;3034
06;2021-01-22;1;0;1;531;474;89;1005
06;2021-01-22;0;0;0;88;93;90;181
06;2021-01-22;71;55;129;146262;133209;0;279471
07;2021-01-22;0;0;0;485;549;09;1034
07;2021-01-22;1;0;1;403;432;19;835
07;2021-01-22;0;0;0;764;841;29;1605
07;2021-01-22;3;2;5;824;928;39;1752
07;2021-01-22;0;2;2;788;1020;49;1808
07;2021-01-22;2;0;2;678;870;59;1548
07;2021-01-22;1;0;1;360;382;69;742
07;2021-01-22;0;1;1;231;190;79;421
07;2021-01-22;0;0;0;114;67;89;181
07;2021-01-22;0;0;0;24;11;90;35
07;2021-01-22;7;5;12;4671;5290;0;9961
08;2021-01-22;0;0;0;2715.22592983026;2997.75551488675;09;5712.98144471701
08;2021-01-22;1;2;3;2778.51901080978;3160.9156459093;19;5939.43465671908
08;2021-01-22;1;1;2;2080.8882988764;1718.16634315323;29;3799.05464202964
08;2021-01-22;3;0;3;2701.8582062647;1896.52641413317;39;4598.38462039786
08;2021-01-22;0;0;0;3151.45861023308;2460.52498233809;49;5611.98359257117
08;2021-01-22;5;0;5;2620.29868333099;2422.23566154656;59;5042.53434487755
08;2021-01-22;0;1;1;1621.44173420671;1438.58325779464;69;3060.02499200135
08;2021-01-22;0;0;0;626.575909335673;526.358467843651;79;1152.93437717932
08;2021-01-22;0;0;0;205.018522985054;140.993639349697;89;346.012162334751
08;2021-01-22;0;0;0;50.0325684687745;20.62259870351;90;70.6551671722846
08;2021-01-22;10;4;14;18551.3174743414;16782.6825256586;0;35334
11;2021-01-22;114;122;253;783071;811785;09;1594856
11;2021-01-22;303;349;675;761456;784653;19;1546109
11;2021-01-22;416;340;756;850145;801772;29;1651917
11;2021-01-22;412;367;782;914360;843488;39;1757848
11;2021-01-22;374;316;692;845609;826202;49;1671811
11;2021-01-22;285;315;601;793566;745070;59;1538636
11;2021-01-22;201;200;404;628649;549192;69;1177841
11;2021-01-22;116;114;230;434606;358356;79;792962
11;2021-01-22;95;56;151;261425;162933;89;424358
11;2021-01-22;65;27;92;89253;32619;90;121872
11;2021-01-22;2381;2207;4638;6362140;5916070;0;12278210
24;2021-01-22;18;17;36;139720;144686;09;284406
24;2021-01-22;68;67;137;152979;161185;19;314164
24;2021-01-22;52;39;91;122237;126536;29;248773
24;2021-01-22;59;52;111;150359;142009;39;292368
24;2021-01-22;64;61;125;161829;158758;49;320587
24;2021-01-22;65;46;111;172552;168011;59;340563
24;2021-01-22;39;35;74;172509;158177;69;330686
24;2021-01-22;35;26;61;129428;110593;79;240021
24;2021-01-22;23;16;39;87342;56882;89;144224
24;2021-01-22;11;6;17;31210;12071;90;43281
24;2021-01-22;434;365;804;1320165;1238908;0;2559073
27;2021-01-22;28;24;52;143373;149679;09;293052
27;2021-01-22;74;90;169;160962;173003;19;333965
27;2021-01-22;76;59;135;133746;142254;29;276000
27;2021-01-22;80;64;144;160004;155407;39;315411
27;2021-01-22;85;69;154;172333;169564;49;341897
27;2021-01-22;100;82;182;189979;183788;59;373767
27;2021-01-22;62;59;121;192591;178206;69;370797
27;2021-01-22;56;54;110;146876;127546;79;274422
27;2021-01-22;48;35;83;96896;61575;89;158471
27;2021-01-22;37;8;45;33148;12109;90;45257
27;2021-01-22;646;544;1195;1429908;1353131;0;2783039
28;2021-01-22;31;25;56;180735;186856;09;367591
28;2021-01-22;66;60;126;200125;213621;19;413746
28;2021-01-22;86;54;140;168922;173007;29;341929
28;2021-01-22;62;70;132;196628;188487;39;385115
28;2021-01-22;83;74;157;205396;201699;49;407095
28;2021-01-22;100;72;172;222002;213866;59;435868
28;2021-01-22;60;64;124;224688;203758;69;428446
28;2021-01-22;44;40;84;163192;135543;79;298735
28;2021-01-22;44;20;64;109691;65377;89;175068
28;2021-01-22;26;19;45;37222;12685;90;49907
28;2021-01-22;602;498;1100;1708601;1594899;0;3303500
32;2021-01-22;67;58;125;358062;373689;09;731751
32;2021-01-22;151;152;305;387045;406742;19;793787
32;2021-01-22;153;134;287;342304;348587;29;690891
32;2021-01-22;164;150;314;382485;369972;39;752457
32;2021-01-22;170;155;325;382510;376716;49;759226
32;2021-01-22;163;151;314;386937;376527;59;763464
32;2021-01-22;96;106;202;371211;330938;69;702149
32;2021-01-22;87;87;174;250542;201459;79;452001
32;2021-01-22;81;38;120;163399;89786;89;253185
32;2021-01-22;39;6;45;48384;15367;90;63751
32;2021-01-22;1171;1037;2211;3072879;2889783;0;5962662
44;2021-01-22;49;49;99;291525;306839;09;598364
44;2021-01-22;159;137;296;320255;339504;19;659759
44;2021-01-22;157;154;312;302020;314428;29;616448
44;2021-01-22;152;149;301;342222;333292;39;675514
44;2021-01-22;153;120;273;349727;344491;49;694218
44;2021-01-22;158;127;287;381371;373239;59;754610
44;2021-01-22;92;103;196;367165;335850;69;703015
44;2021-01-22;53;61;115;250387;215436;79;465823
44;2021-01-22;92;46;138;170825;105192;89;276017
44;2021-01-22;52;13;66;51248;16731;90;67979
44;2021-01-22;1117;960;2084;2826745;2685002;0;5511747
52;2021-01-22;22;18;41;213594;223900;09;437494
52;2021-01-22;70;76;147;240818;255197;19;496015
52;2021-01-22;80;84;164;197010;200630;29;397640
52;2021-01-22;75;60;136;231204;224885;39;456089
52;2021-01-22;73;60;134;243874;243418;49;487292
52;2021-01-22;67;76;143;244100;239116;59;483216
52;2021-01-22;60;44;106;241796;221345;69;463141
52;2021-01-22;35;43;78;177805;149903;79;327708
52;2021-01-22;44;21;65;119561;75822;89;195383
52;2021-01-22;31;9;40;42559;15260;90;57819
52;2021-01-22;557;491;1054;1952321;1849476;0;3801797
53;2021-01-22;15;15;30;173813;182358;09;356171
53;2021-01-22;45;32;79;202720;214740;19;417460
53;2021-01-22;41;42;83;163116;173196;29;336312
53;2021-01-22;45;29;74;190526;187674;39;378200
53;2021-01-22;33;37;70;212098;212015;49;424113
53;2021-01-22;39;29;68;223699;219176;59;442875
53;2021-01-22;31;35;66;227435;209274;69;436709
53;2021-01-22;19;17;36;169992;140910;79;310902
53;2021-01-22;19;14;33;118117;69883;89;188000
53;2021-01-22;8;5;13;37370;12267;90;49637
53;2021-01-22;295;255;552;1718886;1621493;0;3340379
75;2021-01-22;39;41;81;293104;305291;09;598395
75;2021-01-22;128;138;267;337141;357785;19;694926
75;2021-01-22;104;91;195;295024;300618;29;595642
75;2021-01-22;104;98;202;347871;331233;39;679104
75;2021-01-22;156;111;267;384742;372771;49;757513
75;2021-01-22;136;117;254;413361;390880;59;804241
75;2021-01-22;79;91;170;425623;384060;69;809683
75;2021-01-22;53;57;110;325086;276298;79;601384
75;2021-01-22;59;36;95;213986;139308;89;353294
75;2021-01-22;54;14;68;77600;28200;90;105800
75;2021-01-22;913;794;1710;3113538;2886444;0;5999982
76;2021-01-22;48;48;100;305956;318589;09;624545
76;2021-01-22;150;173;329;338942;356969;19;695911
76;2021-01-22;144;107;252;316210;319570;29;635780
76;2021-01-22;174;132;306;356758;337587;39;694345
76;2021-01-22;158;139;297;376541;363812;49;740353
76;2021-01-22;156;156;312;402608;383750;59;786358
76;2021-01-22;130;125;255;394889;358997;69;753886
76;2021-01-22;77;69;146;308664;263806;79;572470
76;2021-01-22;72;45;117;195838;129272;89;325110
76;2021-01-22;57;15;72;69372;26728;90;96100
76;2021-01-22;1166;1009;2186;3065778;2859080;0;5924858
84;2021-01-22;84;72;157;459549;481088;09;940637
84;2021-01-22;247;229;477;487711;511905;19;999616
84;2021-01-22;258;181;440;443824;451094;29;894918
84;2021-01-22;268;229;497;512522;493262;39;1005784
84;2021-01-22;227;218;446;520248;515106;49;1035354
84;2021-01-22;216;184;400;529611;514848;59;1044459
84;2021-01-22;155;145;300;486720;439940;69;926660
84;2021-01-22;114;103;217;372151;315211;79;687362
84;2021-01-22;105;52;157;237198;150524;89;387722
84;2021-01-22;66;23;89;81185;28680;90;109865
84;2021-01-22;1740;1436;3180;4130719;3901658;0;8032377
93;2021-01-22;56;61;117;268834;283093;09;551927
93;2021-01-22;223;201;425;280751;296087;19;576838
93;2021-01-22;232;196;428;254404;255552;29;509956
93;2021-01-22;254;229;483;310704;288398;39;599102
93;2021-01-22;280;231;511;325559;305827;49;631386
93;2021-01-22;276;216;493;353104;325389;59;678493
93;2021-01-22;167;159;326;336327;296459;69;632786
93;2021-01-22;122;102;224;279820;229699;79;509519
93;2021-01-22;103;79;182;171274;113716;89;284990
93;2021-01-22;47;18;66;58896;21758;90;80654
93;2021-01-22;1760;1492;3256;2639673;2415978;0;5055651
94;2021-01-22;2;0;2;16311;17433;09;33744
94;2021-01-22;3;6;9;16679;18132;19;34811
94;2021-01-22;2;4;6;16782;16579;29;33361
94;2021-01-22;4;3;7;23044;20580;39;43624
94;2021-01-22;3;6;9;23065;22140;49;45205
94;2021-01-22;6;4;10;24549;23421;59;47970
94;2021-01-22;6;6;12;23212;21883;69;45095
94;2021-01-22;3;2;5;19544;17141;79;36685
94;2021-01-22;2;1;3;11227;8178;89;19405
94;2021-01-22;3;0;3;3332;1447;90;4779
94;2021-01-22;34;32;66;177745;166934;0;344679
01;2021-01-23;0;0;0;19979;20155;09;40134
01;2021-01-23;1;0;1;24994;25489;19;50483
01;2021-01-23;2;0;2;17868;16690;29;34558
01;2021-01-23;0;1;1;22328;14821;39;37149
01;2021-01-23;1;0;1;28652;20276;49;48928
01;2021-01-23;2;0;2;33264;27260;59;60524
01;2021-01-23;1;2;3;27135;23978;69;51113
01;2021-01-23;1;0;1;18401;14661;79;33062
01;2021-01-23;0;0;0;9633;6375;89;16008
01;2021-01-23;0;0;0;3410;1510;90;4920
01;2021-01-23;8;3;11;205664;171215;0;376879
02;2021-01-23;0;0;0;16881;17110;09;33991
02;2021-01-23;0;0;0;21410;21604;19;43014
02;2021-01-23;0;0;0;16017;15479;29;31496
02;2021-01-23;0;0;0;19825;14455;39;34280
02;2021-01-23;0;1;1;24719;18248;49;42967
02;2021-01-23;1;0;1;34361;28310;59;62671
02;2021-01-23;2;0;2;28061;24495;69;52556
02;2021-01-23;0;0;0;18231;15278;79;33509
02;2021-01-23;0;0;0;11090;7677;89;18767
02;2021-01-23;0;0;0;3992;1506;90;5498
02;2021-01-23;3;1;4;194587;164162;0;358749
03;2021-01-23;2;1;3;31123;30920;09;62043
03;2021-01-23;2;2;4;29370;29268;19;58638
03;2021-01-23;3;2;5;21458;18963;29;40421
03;2021-01-23;2;1;4;21276;18326;39;39602
03;2021-01-23;2;5;7;18164;16593;49;34757
03;2021-01-23;1;3;4;13469;13557;59;27026
03;2021-01-23;1;1;2;8776;8670;69;17446
03;2021-01-23;0;1;1;3777;3591;79;7368
03;2021-01-23;1;0;1;1649;1072;89;2721
03;2021-01-23;0;0;0;485;184;90;669
03;2021-01-23;14;16;31;149547;141144;0;290691
04;2021-01-23;0;0;0;60314;61377;09;121691
04;2021-01-23;4;1;5;66065;68387;19;134452
04;2021-01-23;2;1;3;51059;47156;29;98215
04;2021-01-23;5;2;7;58788;45780;39;104568
04;2021-01-23;5;7;12;61408;52207;49;113615
04;2021-01-23;2;6;8;64838;60759;59;125597
04;2021-01-23;1;1;2;47008;42843;69;89851
04;2021-01-23;1;1;2;25509;21184;79;46693
04;2021-01-23;0;0;0;13168;7647;89;20815
04;2021-01-23;0;0;0;3209;1253;90;4462
04;2021-01-23;20;19;39;451366;408593;0;859959
05;2021-01-23;0;0;0;362.366008612902;341.338819562748;09;703.704828175651
05;2021-01-23;0;0;0;353.376145114279;370.349735405642;19;723.725880519921
05;2021-01-23;0;0;0;218.593559489256;256.539602589476;29;475.133162078732
05;2021-01-23;0;0;0;404.225408693299;360.321910454353;39;764.547319147651
05;2021-01-23;0;0;0;520.067953604221;497.108383964256;49;1017.17633756848
05;2021-01-23;0;0;0;468.146063921917;510.087601910415;59;978.233665832332
05;2021-01-23;0;0;0;340.368470050554;334.366842191253;69;674.735312241807
05;2021-01-23;0;0;0;212.598666888387;192.597753227106;79;405.196420115493
05;2021-01-23;0;0;0;148.727797095705;61.8681715431829;89;210.595968638888
05;2021-01-23;0;0;0;32.9601271090696;10.9909785719784;90;43.9511056810479
05;2021-01-23;0;0;0;3061.43020057959;2935.56979942041;0;5997
06;2021-01-23;1;0;1;42583;42380;09;84963
06;2021-01-23;10;8;18;33369;31925;19;65294
06;2021-01-23;9;5;14;21571;15080;29;36651
06;2021-01-23;6;11;17;21550;16147;39;37697
06;2021-01-23;7;9;16;14193;13939;49;28132
06;2021-01-23;7;1;8;7171;7597;59;14768
06;2021-01-23;4;4;8;3629;4117;69;7746
06;2021-01-23;1;3;4;1577;1457;79;3034
06;2021-01-23;0;1;1;531;474;89;1005
06;2021-01-23;0;0;0;88;93;90;181
06;2021-01-23;45;42;87;146262;133209;0;279471
07;2021-01-23;0;0;0;485;549;09;1034
07;2021-01-23;0;0;0;403;432;19;835
07;2021-01-23;0;1;1;764;841;29;1605
07;2021-01-23;1;1;2;824;928;39;1752
07;2021-01-23;1;1;2;788;1020;49;1808
07;2021-01-23;0;0;0;678;870;59;1548
07;2021-01-23;0;0;0;360;382;69;742
07;2021-01-23;0;0;0;231;190;79;421
07;2021-01-23;0;0;0;114;67;89;181
07;2021-01-23;0;0;0;24;11;90;35
07;2021-01-23;2;3;5;4671;5290;0;9961
08;2021-01-23;0;1;1;2715.22592983026;2997.75551488675;09;5712.98144471701
08;2021-01-23;1;0;1;2778.51901080978;3160.9156459093;19;5939.43465671908
08;2021-01-23;0;0;0;2080.8882988764;1718.16634315323;29;3799.05464202964
08;2021-01-23;1;0;1;2701.8582062647;1896.52641413317;39;4598.38462039786
08;2021-01-23;1;0;1;3151.45861023308;2460.52498233809;49;5611.98359257117
08;2021-01-23;2;1;3;2620.29868333099;2422.23566154656;59;5042.53434487755
08;2021-01-23;1;0;1;1621.44173420671;1438.58325779464;69;3060.02499200135
08;2021-01-23;0;0;0;626.575909335673;526.358467843651;79;1152.93437717932
08;2021-01-23;0;0;0;205.018522985054;140.993639349697;89;346.012162334751
08;2021-01-23;0;0;0;50.0325684687745;20.62259870351;90;70.6551671722846
08;2021-01-23;6;2;8;18551.3174743414;16782.6825256586;0;35334
11;2021-01-23;64;76;147;783071;811785;09;1594856
11;2021-01-23;185;199;399;761456;784653;19;1546109
11;2021-01-23;259;173;434;850145;801772;29;1651917
11;2021-01-23;256;215;471;914360;843488;39;1757848
11;2021-01-23;239;200;439;845609;826202;49;1671811
11;2021-01-23;184;159;343;793566;745070;59;1538636
11;2021-01-23;107;109;221;628649;549192;69;1177841
11;2021-01-23;55;42;97;434606;358356;79;792962
11;2021-01-23;36;26;62;261425;162933;89;424358
11;2021-01-23;24;14;38;89253;32619;90;121872
11;2021-01-23;1409;1213;2651;6362140;5916070;0;12278210
24;2021-01-23;7;8;15;139720;144686;09;284406
24;2021-01-23;40;43;84;152979;161185;19;314164
24;2021-01-23;30;31;61;122237;126536;29;248773
24;2021-01-23;37;33;70;150359;142009;39;292368
24;2021-01-23;29;30;59;161829;158758;49;320587
24;2021-01-23;43;31;74;172552;168011;59;340563
24;2021-01-23;25;18;43;172509;158177;69;330686
24;2021-01-23;13;19;32;129428;110593;79;240021
24;2021-01-23;12;14;26;87342;56882;89;144224
24;2021-01-23;11;6;17;31210;12071;90;43281
24;2021-01-23;247;233;481;1320165;1238908;0;2559073
27;2021-01-23;8;9;17;143373;149679;09;293052
27;2021-01-23;45;57;102;160962;173003;19;333965
27;2021-01-23;51;36;87;133746;142254;29;276000
27;2021-01-23;57;39;96;160004;155407;39;315411
27;2021-01-23;52;45;97;172333;169564;49;341897
27;2021-01-23;52;45;97;189979;183788;59;373767
27;2021-01-23;35;40;75;192591;178206;69;370797
27;2021-01-23;30;36;66;146876;127546;79;274422
27;2021-01-23;22;24;46;96896;61575;89;158471
27;2021-01-23;16;4;20;33148;12109;90;45257
27;2021-01-23;368;335;703;1429908;1353131;0;2783039
28;2021-01-23;19;19;38;180735;186856;09;367591
28;2021-01-23;32;35;69;200125;213621;19;413746
28;2021-01-23;35;21;56;168922;173007;29;341929
28;2021-01-23;47;22;69;196628;188487;39;385115
28;2021-01-23;37;26;63;205396;201699;49;407095
28;2021-01-23;31;30;61;222002;213866;59;435868
28;2021-01-23;43;26;69;224688;203758;69;428446
28;2021-01-23;24;18;42;163192;135543;79;298735
28;2021-01-23;26;17;43;109691;65377;89;175068
28;2021-01-23;12;6;18;37222;12685;90;49907
28;2021-01-23;306;220;528;1708601;1594899;0;3303500
32;2021-01-23;27;31;58;358062;373689;09;731751
32;2021-01-23;94;86;180;387045;406742;19;793787
32;2021-01-23;91;82;173;342304;348587;29;690891
32;2021-01-23;95;88;183;382485;369972;39;752457
32;2021-01-23;100;87;187;382510;376716;49;759226
32;2021-01-23;98;92;190;386937;376527;59;763464
32;2021-01-23;76;52;128;371211;330938;69;702149
32;2021-01-23;46;47;93;250542;201459;79;452001
32;2021-01-23;36;24;60;163399;89786;89;253185
32;2021-01-23;21;4;25;48384;15367;90;63751
32;2021-01-23;684;593;1277;3072879;2889783;0;5962662
44;2021-01-23;32;28;61;291525;306839;09;598364
44;2021-01-23;77;70;148;320255;339504;19;659759
44;2021-01-23;99;99;198;302020;314428;29;616448
44;2021-01-23;105;73;178;342222;333292;39;675514
44;2021-01-23;105;95;200;349727;344491;49;694218
44;2021-01-23;101;100;201;381371;373239;59;754610
44;2021-01-23;60;64;124;367165;335850;69;703015
44;2021-01-23;53;50;103;250387;215436;79;465823
44;2021-01-23;33;28;61;170825;105192;89;276017
44;2021-01-23;21;4;26;51248;16731;90;67979
44;2021-01-23;686;611;1300;2826745;2685002;0;5511747
52;2021-01-23;20;15;36;213594;223900;09;437494
52;2021-01-23;51;37;88;240818;255197;19;496015
52;2021-01-23;50;40;90;197010;200630;29;397640
52;2021-01-23;47;33;81;231204;224885;39;456089
52;2021-01-23;61;40;101;243874;243418;49;487292
52;2021-01-23;45;49;96;244100;239116;59;483216
52;2021-01-23;22;31;53;241796;221345;69;463141
52;2021-01-23;26;16;42;177805;149903;79;327708
52;2021-01-23;33;18;51;119561;75822;89;195383
52;2021-01-23;7;7;14;42559;15260;90;57819
52;2021-01-23;362;286;652;1952321;1849476;0;3801797
53;2021-01-23;7;9;18;173813;182358;09;356171
53;2021-01-23;26;21;47;202720;214740;19;417460
53;2021-01-23;15;20;35;163116;173196;29;336312
53;2021-01-23;26;19;45;190526;187674;39;378200
53;2021-01-23;31;30;61;212098;212015;49;424113
53;2021-01-23;22;20;42;223699;219176;59;442875
53;2021-01-23;22;11;33;227435;209274;69;436709
53;2021-01-23;15;15;30;169992;140910;79;310902
53;2021-01-23;5;7;12;118117;69883;89;188000
53;2021-01-23;7;0;7;37370;12267;90;49637
53;2021-01-23;176;152;330;1718886;1621493;0;3340379
75;2021-01-23;19;19;38;293104;305291;09;598395
75;2021-01-23;44;59;103;337141;357785;19;694926
75;2021-01-23;71;71;142;295024;300618;29;595642
75;2021-01-23;78;51;129;347871;331233;39;679104
75;2021-01-23;82;77;159;384742;372771;49;757513
75;2021-01-23;78;61;139;413361;390880;59;804241
75;2021-01-23;47;45;92;425623;384060;69;809683
75;2021-01-23;34;32;66;325086;276298;79;601384
75;2021-01-23;26;19;45;213986;139308;89;353294
75;2021-01-23;18;8;26;77600;28200;90;105800
75;2021-01-23;497;442;939;3113538;2886444;0;5999982
76;2021-01-23;26;30;56;305956;318589;09;624545
76;2021-01-23;77;72;151;338942;356969;19;695911
76;2021-01-23;92;66;158;316210;319570;29;635780
76;2021-01-23;92;68;160;356758;337587;39;694345
76;2021-01-23;81;74;156;376541;363812;49;740353
76;2021-01-23;82;69;151;402608;383750;59;786358
76;2021-01-23;59;50;109;394889;358997;69;753886
76;2021-01-23;35;25;60;308664;263806;79;572470
76;2021-01-23;23;25;48;195838;129272;89;325110
76;2021-01-23;19;8;28;69372;26728;90;96100
76;2021-01-23;586;487;1077;3065778;2859080;0;5924858
84;2021-01-23;39;45;84;459549;481088;09;940637
84;2021-01-23;132;123;256;487711;511905;19;999616
84;2021-01-23;120;103;223;443824;451094;29;894918
84;2021-01-23;166;119;285;512522;493262;39;1005784
84;2021-01-23;138;125;263;520248;515106;49;1035354
84;2021-01-23;118;115;233;529611;514848;59;1044459
84;2021-01-23;85;85;170;486720;439940;69;926660
84;2021-01-23;57;53;110;372151;315211;79;687362
84;2021-01-23;62;32;94;237198;150524;89;387722
84;2021-01-23;27;11;38;81185;28680;90;109865
84;2021-01-23;944;811;1756;4130719;3901658;0;8032377
93;2021-01-23;34;28;62;268834;283093;09;551927
93;2021-01-23;122;98;220;280751;296087;19;576838
93;2021-01-23;138;98;236;254404;255552;29;509956
93;2021-01-23;146;115;261;310704;288398;39;599102
93;2021-01-23;148;113;261;325559;305827;49;631386
93;2021-01-23;110;102;212;353104;325389;59;678493
93;2021-01-23;79;86;165;336327;296459;69;632786
93;2021-01-23;51;47;98;279820;229699;79;509519
93;2021-01-23;48;47;95;171274;113716;89;284990
93;2021-01-23;32;18;50;58896;21758;90;80654
93;2021-01-23;908;752;1660;2639673;2415978;0;5055651
94;2021-01-23;1;0;1;16311;17433;09;33744
94;2021-01-23;0;0;0;16679;18132;19;34811
94;2021-01-23;6;3;9;16782;16579;29;33361
94;2021-01-23;1;4;5;23044;20580;39;43624
94;2021-01-23;3;5;8;23065;22140;49;45205
94;2021-01-23;4;4;8;24549;23421;59;47970
94;2021-01-23;1;3;4;23212;21883;69;45095
94;2021-01-23;2;1;3;19544;17141;79;36685
94;2021-01-23;2;1;3;11227;8178;89;19405
94;2021-01-23;1;0;1;3332;1447;90;4779
94;2021-01-23;21;21;42;177745;166934;0;344679
01;2021-01-24;0;0;0;19979;20155;09;40134
01;2021-01-24;0;0;0;24994;25489;19;50483
01;2021-01-24;1;0;1;17868;16690;29;34558
01;2021-01-24;0;0;0;22328;14821;39;37149
01;2021-01-24;1;1;2;28652;20276;49;48928
01;2021-01-24;0;0;0;33264;27260;59;60524
01;2021-01-24;0;0;0;27135;23978;69;51113
01;2021-01-24;0;0;0;18401;14661;79;33062
01;2021-01-24;0;0;0;9633;6375;89;16008
01;2021-01-24;0;0;0;3410;1510;90;4920
01;2021-01-24;2;1;3;205664;171215;0;376879
02;2021-01-24;0;0;0;16881;17110;09;33991
02;2021-01-24;0;0;0;21410;21604;19;43014
02;2021-01-24;0;0;0;16017;15479;29;31496
02;2021-01-24;0;0;0;19825;14455;39;34280
02;2021-01-24;0;1;1;24719;18248;49;42967
02;2021-01-24;0;0;0;34361;28310;59;62671
02;2021-01-24;0;0;0;28061;24495;69;52556
02;2021-01-24;0;0;0;18231;15278;79;33509
02;2021-01-24;0;0;0;11090;7677;89;18767
02;2021-01-24;0;0;0;3992;1506;90;5498
02;2021-01-24;0;1;1;194587;164162;0;358749
03;2021-01-24;0;0;0;31123;30920;09;62043
03;2021-01-24;3;1;4;29370;29268;19;58638
03;2021-01-24;0;0;0;21458;18963;29;40421
03;2021-01-24;0;1;1;21276;18326;39;39602
03;2021-01-24;1;2;3;18164;16593;49;34757
03;2021-01-24;0;1;1;13469;13557;59;27026
03;2021-01-24;0;1;1;8776;8670;69;17446
03;2021-01-24;0;0;0;3777;3591;79;7368
03;2021-01-24;0;0;0;1649;1072;89;2721
03;2021-01-24;0;0;0;485;184;90;669
03;2021-01-24;4;6;10;149547;141144;0;290691
04;2021-01-24;0;0;0;60314;61377;09;121691
04;2021-01-24;0;1;1;66065;68387;19;134452
04;2021-01-24;0;0;0;51059;47156;29;98215
04;2021-01-24;1;0;1;58788;45780;39;104568
04;2021-01-24;0;2;2;61408;52207;49;113615
04;2021-01-24;0;1;1;64838;60759;59;125597
04;2021-01-24;0;1;1;47008;42843;69;89851
04;2021-01-24;0;0;0;25509;21184;79;46693
04;2021-01-24;0;0;0;13168;7647;89;20815
04;2021-01-24;0;0;0;3209;1253;90;4462
04;2021-01-24;1;5;6;451366;408593;0;859959
05;2021-01-24;0;0;0;362.366008612902;341.338819562748;09;703.704828175651
05;2021-01-24;0;0;0;353.376145114279;370.349735405642;19;723.725880519921
05;2021-01-24;0;0;0;218.593559489256;256.539602589476;29;475.133162078732
05;2021-01-24;0;0;0;404.225408693299;360.321910454353;39;764.547319147651
05;2021-01-24;0;0;0;520.067953604221;497.108383964256;49;1017.17633756848
05;2021-01-24;0;0;0;468.146063921917;510.087601910415;59;978.233665832332
05;2021-01-24;0;0;0;340.368470050554;334.366842191253;69;674.735312241807
05;2021-01-24;0;0;0;212.598666888387;192.597753227106;79;405.196420115493
05;2021-01-24;0;0;0;148.727797095705;61.8681715431829;89;210.595968638888
05;2021-01-24;0;0;0;32.9601271090696;10.9909785719784;90;43.9511056810479
05;2021-01-24;0;0;0;3061.43020057959;2935.56979942041;0;5997
06;2021-01-24;0;2;2;42583;42380;09;84963
06;2021-01-24;0;0;0;33369;31925;19;65294
06;2021-01-24;3;6;9;21571;15080;29;36651
06;2021-01-24;3;0;3;21550;16147;39;37697
06;2021-01-24;2;1;3;14193;13939;49;28132
06;2021-01-24;3;0;3;7171;7597;59;14768
06;2021-01-24;0;2;2;3629;4117;69;7746
06;2021-01-24;0;1;1;1577;1457;79;3034
06;2021-01-24;0;0;0;531;474;89;1005
06;2021-01-24;0;0;0;88;93;90;181
06;2021-01-24;11;12;23;146262;133209;0;279471
07;2021-01-24;0;0;0;485;549;09;1034
07;2021-01-24;0;0;0;403;432;19;835
07;2021-01-24;0;0;0;764;841;29;1605
07;2021-01-24;0;0;0;824;928;39;1752
07;2021-01-24;0;1;1;788;1020;49;1808
07;2021-01-24;0;0;0;678;870;59;1548
07;2021-01-24;0;0;0;360;382;69;742
07;2021-01-24;0;0;0;231;190;79;421
07;2021-01-24;0;0;0;114;67;89;181
07;2021-01-24;0;0;0;24;11;90;35
07;2021-01-24;0;1;1;4671;5290;0;9961
08;2021-01-24;0;0;0;2715.22592983026;2997.75551488675;09;5712.98144471701
08;2021-01-24;0;0;0;2778.51901080978;3160.9156459093;19;5939.43465671908
08;2021-01-24;0;0;0;2080.8882988764;1718.16634315323;29;3799.05464202964
08;2021-01-24;0;0;0;2701.8582062647;1896.52641413317;39;4598.38462039786
08;2021-01-24;0;0;0;3151.45861023308;2460.52498233809;49;5611.98359257117
08;2021-01-24;0;0;0;2620.29868333099;2422.23566154656;59;5042.53434487755
08;2021-01-24;0;0;0;1621.44173420671;1438.58325779464;69;3060.02499200135
08;2021-01-24;0;0;0;626.575909335673;526.358467843651;79;1152.93437717932
08;2021-01-24;0;0;0;205.018522985054;140.993639349697;89;346.012162334751
08;2021-01-24;0;0;0;50.0325684687745;20.62259870351;90;70.6551671722846
08;2021-01-24;0;0;0;18551.3174743414;16782.6825256586;0;35334
11;2021-01-24;19;11;30;783071;811785;09;1594856
11;2021-01-24;37;40;77;761456;784653;19;1546109
11;2021-01-24;48;46;94;850145;801772;29;1651917
11;2021-01-24;56;56;112;914360;843488;39;1757848
11;2021-01-24;54;47;101;845609;826202;49;1671811
11;2021-01-24;39;43;82;793566;745070;59;1538636
11;2021-01-24;28;30;58;628649;549192;69;1177841
11;2021-01-24;21;24;45;434606;358356;79;792962
11;2021-01-24;28;18;46;261425;162933;89;424358
11;2021-01-24;13;5;18;89253;32619;90;121872
11;2021-01-24;344;320;664;6362140;5916070;0;12278210
24;2021-01-24;1;1;2;139720;144686;09;284406
24;2021-01-24;3;0;3;152979;161185;19;314164
24;2021-01-24;6;5;11;122237;126536;29;248773
24;2021-01-24;9;0;9;150359;142009;39;292368
24;2021-01-24;4;4;8;161829;158758;49;320587
24;2021-01-24;2;5;7;172552;168011;59;340563
24;2021-01-24;5;5;10;172509;158177;69;330686
24;2021-01-24;5;5;10;129428;110593;79;240021
24;2021-01-24;7;5;12;87342;56882;89;144224
24;2021-01-24;2;0;2;31210;12071;90;43281
24;2021-01-24;44;30;74;1320165;1238908;0;2559073
27;2021-01-24;0;1;1;143373;149679;09;293052
27;2021-01-24;4;4;8;160962;173003;19;333965
27;2021-01-24;4;4;8;133746;142254;29;276000
27;2021-01-24;8;4;12;160004;155407;39;315411
27;2021-01-24;3;5;8;172333;169564;49;341897
27;2021-01-24;3;2;5;189979;183788;59;373767
27;2021-01-24;5;5;10;192591;178206;69;370797
27;2021-01-24;8;2;10;146876;127546;79;274422
27;2021-01-24;8;7;15;96896;61575;89;158471
27;2021-01-24;10;2;12;33148;12109;90;45257
27;2021-01-24;53;36;89;1429908;1353131;0;2783039
28;2021-01-24;4;5;9;180735;186856;09;367591
28;2021-01-24;4;4;8;200125;213621;19;413746
28;2021-01-24;8;9;17;168922;173007;29;341929
28;2021-01-24;11;7;18;196628;188487;39;385115
28;2021-01-24;10;7;17;205396;201699;49;407095
28;2021-01-24;7;3;10;222002;213866;59;435868
28;2021-01-24;3;9;12;224688;203758;69;428446
28;2021-01-24;3;10;13;163192;135543;79;298735
28;2021-01-24;3;4;7;109691;65377;89;175068
28;2021-01-24;5;3;8;37222;12685;90;49907
28;2021-01-24;58;61;119;1708601;1594899;0;3303500
32;2021-01-24;4;8;12;358062;373689;09;731751
32;2021-01-24;9;17;26;387045;406742;19;793787
32;2021-01-24;22;23;45;342304;348587;29;690891
32;2021-01-24;23;14;37;382485;369972;39;752457
32;2021-01-24;23;20;43;382510;376716;49;759226
32;2021-01-24;18;22;40;386937;376527;59;763464
32;2021-01-24;16;2;18;371211;330938;69;702149
32;2021-01-24;13;11;24;250542;201459;79;452001
32;2021-01-24;15;9;24;163399;89786;89;253185
32;2021-01-24;8;1;9;48384;15367;90;63751
32;2021-01-24;151;127;278;3072879;2889783;0;5962662
44;2021-01-24;3;4;7;291525;306839;09;598364
44;2021-01-24;4;13;17;320255;339504;19;659759
44;2021-01-24;10;9;19;302020;314428;29;616448
44;2021-01-24;17;6;23;342222;333292;39;675514
44;2021-01-24;13;7;21;349727;344491;49;694218
44;2021-01-24;10;13;23;381371;373239;59;754610
44;2021-01-24;8;11;19;367165;335850;69;703015
44;2021-01-24;6;13;19;250387;215436;79;465823
44;2021-01-24;17;5;22;170825;105192;89;276017
44;2021-01-24;6;3;9;51248;16731;90;67979
44;2021-01-24;94;84;179;2826745;2685002;0;5511747
52;2021-01-24;3;3;6;213594;223900;09;437494
52;2021-01-24;10;12;22;240818;255197;19;496015
52;2021-01-24;18;5;23;197010;200630;29;397640
52;2021-01-24;14;8;22;231204;224885;39;456089
52;2021-01-24;14;18;32;243874;243418;49;487292
52;2021-01-24;15;12;27;244100;239116;59;483216
52;2021-01-24;4;9;13;241796;221345;69;463141
52;2021-01-24;6;4;10;177805;149903;79;327708
52;2021-01-24;17;5;22;119561;75822;89;195383
52;2021-01-24;3;5;8;42559;15260;90;57819
52;2021-01-24;104;81;185;1952321;1849476;0;3801797
53;2021-01-24;2;3;5;173813;182358;09;356171
53;2021-01-24;7;4;12;202720;214740;19;417460
53;2021-01-24;3;3;6;163116;173196;29;336312
53;2021-01-24;9;2;11;190526;187674;39;378200
53;2021-01-24;6;9;15;212098;212015;49;424113
53;2021-01-24;2;5;7;223699;219176;59;442875
53;2021-01-24;4;2;6;227435;209274;69;436709
53;2021-01-24;1;1;2;169992;140910;79;310902
53;2021-01-24;4;4;8;118117;69883;89;188000
53;2021-01-24;3;1;4;37370;12267;90;49637
53;2021-01-24;41;34;76;1718886;1621493;0;3340379
75;2021-01-24;7;2;9;293104;305291;09;598395
75;2021-01-24;6;6;12;337141;357785;19;694926
75;2021-01-24;11;7;18;295024;300618;29;595642
75;2021-01-24;12;12;24;347871;331233;39;679104
75;2021-01-24;13;12;25;384742;372771;49;757513
75;2021-01-24;10;5;15;413361;390880;59;804241
75;2021-01-24;4;11;15;425623;384060;69;809683
75;2021-01-24;14;6;20;325086;276298;79;601384
75;2021-01-24;18;12;30;213986;139308;89;353294
75;2021-01-24;3;3;6;77600;28200;90;105800
75;2021-01-24;98;76;174;3113538;2886444;0;5999982
76;2021-01-24;4;6;10;305956;318589;09;624545
76;2021-01-24;12;9;21;338942;356969;19;695911
76;2021-01-24;15;13;28;316210;319570;29;635780
76;2021-01-24;22;9;31;356758;337587;39;694345
76;2021-01-24;16;17;33;376541;363812;49;740353
76;2021-01-24;10;13;23;402608;383750;59;786358
76;2021-01-24;10;11;21;394889;358997;69;753886
76;2021-01-24;14;14;28;308664;263806;79;572470
76;2021-01-24;9;15;24;195838;129272;89;325110
76;2021-01-24;14;7;21;69372;26728;90;96100
76;2021-01-24;126;114;240;3065778;2859080;0;5924858
84;2021-01-24;7;7;14;459549;481088;09;940637
84;2021-01-24;9;16;25;487711;511905;19;999616
84;2021-01-24;21;15;36;443824;451094;29;894918
84;2021-01-24;29;13;42;512522;493262;39;1005784
84;2021-01-24;26;29;55;520248;515106;49;1035354
84;2021-01-24;24;20;44;529611;514848;59;1044459
84;2021-01-24;9;11;20;486720;439940;69;926660
84;2021-01-24;14;19;33;372151;315211;79;687362
84;2021-01-24;22;16;38;237198;150524;89;387722
84;2021-01-24;14;7;21;81185;28680;90;109865
84;2021-01-24;175;153;328;4130719;3901658;0;8032377
93;2021-01-24;6;8;14;268834;283093;09;551927
93;2021-01-24;26;17;43;280751;296087;19;576838
93;2021-01-24;41;20;61;254404;255552;29;509956
93;2021-01-24;39;39;78;310704;288398;39;599102
93;2021-01-24;33;34;67;325559;305827;49;631386
93;2021-01-24;37;31;68;353104;325389;59;678493
93;2021-01-24;19;32;51;336327;296459;69;632786
93;2021-01-24;17;20;37;279820;229699;79;509519
93;2021-01-24;24;24;48;171274;113716;89;284990
93;2021-01-24;26;14;40;58896;21758;90;80654
93;2021-01-24;268;239;509;2639673;2415978;0;5055651
94;2021-01-24;0;0;0;16311;17433;09;33744
94;2021-01-24;1;1;2;16679;18132;19;34811
94;2021-01-24;0;0;0;16782;16579;29;33361
94;2021-01-24;1;2;3;23044;20580;39;43624
94;2021-01-24;1;1;2;23065;22140;49;45205
94;2021-01-24;0;2;2;24549;23421;59;47970
94;2021-01-24;0;0;0;23212;21883;69;45095
94;2021-01-24;0;3;3;19544;17141;79;36685
94;2021-01-24;0;1;1;11227;8178;89;19405
94;2021-01-24;1;0;1;3332;1447;90;4779
94;2021-01-24;4;10;14;177745;166934;0;344679
01;2021-01-25;0;0;0;19979;20155;09;40134
01;2021-01-25;0;1;1;24994;25489;19;50483
01;2021-01-25;1;3;4;17868;16690;29;34558
01;2021-01-25;2;2;4;22328;14821;39;37149
01;2021-01-25;3;1;4;28652;20276;49;48928
01;2021-01-25;6;1;8;33264;27260;59;60524
01;2021-01-25;2;1;4;27135;23978;69;51113
01;2021-01-25;1;0;1;18401;14661;79;33062
01;2021-01-25;2;0;2;9633;6375;89;16008
01;2021-01-25;0;0;0;3410;1510;90;4920
01;2021-01-25;17;9;28;205664;171215;0;376879
02;2021-01-25;0;0;0;16881;17110;09;33991
02;2021-01-25;1;2;3;21410;21604;19;43014
02;2021-01-25;1;0;1;16017;15479;29;31496
02;2021-01-25;0;0;0;19825;14455;39;34280
02;2021-01-25;3;1;4;24719;18248;49;42967
02;2021-01-25;0;1;1;34361;28310;59;62671
02;2021-01-25;0;3;3;28061;24495;69;52556
02;2021-01-25;0;0;0;18231;15278;79;33509
02;2021-01-25;0;0;0;11090;7677;89;18767
02;2021-01-25;0;0;0;3992;1506;90;5498
02;2021-01-25;5;7;12;194587;164162;0;358749
03;2021-01-25;2;0;2;31123;30920;09;62043
03;2021-01-25;13;11;24;29370;29268;19;58638
03;2021-01-25;5;7;12;21458;18963;29;40421
03;2021-01-25;10;4;14;21276;18326;39;39602
03;2021-01-25;9;10;19;18164;16593;49;34757
03;2021-01-25;7;6;13;13469;13557;59;27026
03;2021-01-25;8;7;15;8776;8670;69;17446
03;2021-01-25;1;0;1;3777;3591;79;7368
03;2021-01-25;2;0;2;1649;1072;89;2721
03;2021-01-25;0;0;0;485;184;90;669
03;2021-01-25;57;45;102;149547;141144;0;290691
04;2021-01-25;4;2;6;60314;61377;09;121691
04;2021-01-25;7;4;11;66065;68387;19;134452
04;2021-01-25;8;6;14;51059;47156;29;98215
04;2021-01-25;8;2;10;58788;45780;39;104568
04;2021-01-25;5;2;7;61408;52207;49;113615
04;2021-01-25;6;0;6;64838;60759;59;125597
04;2021-01-25;4;1;5;47008;42843;69;89851
04;2021-01-25;1;2;3;25509;21184;79;46693
04;2021-01-25;0;0;0;13168;7647;89;20815
04;2021-01-25;0;0;0;3209;1253;90;4462
04;2021-01-25;43;19;62;451366;408593;0;859959
05;2021-01-25;0;0;0;362.366008612902;341.338819562748;09;703.704828175651
05;2021-01-25;0;0;0;353.376145114279;370.349735405642;19;723.725880519921
05;2021-01-25;0;0;0;218.593559489256;256.539602589476;29;475.133162078732
05;2021-01-25;0;0;0;404.225408693299;360.321910454353;39;764.547319147651
05;2021-01-25;0;0;0;520.067953604221;497.108383964256;49;1017.17633756848
05;2021-01-25;0;0;0;468.146063921917;510.087601910415;59;978.233665832332
05;2021-01-25;0;0;0;340.368470050554;334.366842191253;69;674.735312241807
05;2021-01-25;0;0;0;212.598666888387;192.597753227106;79;405.196420115493
05;2021-01-25;0;0;0;148.727797095705;61.8681715431829;89;210.595968638888
05;2021-01-25;0;0;0;32.9601271090696;10.9909785719784;90;43.9511056810479
05;2021-01-25;0;0;0;3061.43020057959;2935.56979942041;0;5997
06;2021-01-25;0;3;3;42583;42380;09;84963
06;2021-01-25;15;11;26;33369;31925;19;65294
06;2021-01-25;38;15;53;21571;15080;29;36651
06;2021-01-25;36;18;54;21550;16147;39;37697
06;2021-01-25;23;28;51;14193;13939;49;28132
06;2021-01-25;10;11;21;7171;7597;59;14768
06;2021-01-25;15;9;27;3629;4117;69;7746
06;2021-01-25;2;2;4;1577;1457;79;3034
06;2021-01-25;1;0;1;531;474;89;1005
06;2021-01-25;0;0;0;88;93;90;181
06;2021-01-25;140;97;240;146262;133209;0;279471
07;2021-01-25;0;0;0;485;549;09;1034
07;2021-01-25;0;2;2;403;432;19;835
07;2021-01-25;2;1;3;764;841;29;1605
07;2021-01-25;1;2;3;824;928;39;1752
07;2021-01-25;0;0;0;788;1020;49;1808
07;2021-01-25;0;0;0;678;870;59;1548
07;2021-01-25;0;0;0;360;382;69;742
07;2021-01-25;0;0;0;231;190;79;421
07;2021-01-25;0;0;0;114;67;89;181
07;2021-01-25;0;0;0;24;11;90;35
07;2021-01-25;3;5;8;4671;5290;0;9961
08;2021-01-25;1;0;1;2715.22592983026;2997.75551488675;09;5712.98144471701
08;2021-01-25;6;0;6;2778.51901080978;3160.9156459093;19;5939.43465671908
08;2021-01-25;1;1;2;2080.8882988764;1718.16634315323;29;3799.05464202964
08;2021-01-25;3;2;5;2701.8582062647;1896.52641413317;39;4598.38462039786
08;2021-01-25;3;2;5;3151.45861023308;2460.52498233809;49;5611.98359257117
08;2021-01-25;3;1;4;2620.29868333099;2422.23566154656;59;5042.53434487755
08;2021-01-25;0;1;1;1621.44173420671;1438.58325779464;69;3060.02499200135
08;2021-01-25;2;2;4;626.575909335673;526.358467843651;79;1152.93437717932
08;2021-01-25;0;0;0;205.018522985054;140.993639349697;89;346.012162334751
08;2021-01-25;0;0;0;50.0325684687745;20.62259870351;90;70.6551671722846
08;2021-01-25;19;9;28;18551.3174743414;16782.6825256586;0;35334
11;2021-01-25;116;127;257;783071;811785;09;1594856
11;2021-01-25;370;407;797;761456;784653;19;1546109
11;2021-01-25;503;413;919;850145;801772;29;1651917
11;2021-01-25;553;460;1018;914360;843488;39;1757848
11;2021-01-25;546;409;959;845609;826202;49;1671811
11;2021-01-25;409;373;785;793566;745070;59;1538636
11;2021-01-25;263;249;515;628649;549192;69;1177841
11;2021-01-25;125;150;276;434606;358356;79;792962
11;2021-01-25;107;68;175;261425;162933;89;424358
11;2021-01-25;45;23;68;89253;32619;90;121872
11;2021-01-25;3038;2680;5771;6362140;5916070;0;12278210
24;2021-01-25;15;12;28;139720;144686;09;284406
24;2021-01-25;62;82;149;152979;161185;19;314164
24;2021-01-25;85;58;143;122237;126536;29;248773
24;2021-01-25;70;66;136;150359;142009;39;292368
24;2021-01-25;103;76;180;161829;158758;49;320587
24;2021-01-25;72;82;154;172552;168011;59;340563
24;2021-01-25;65;59;124;172509;158177;69;330686
24;2021-01-25;46;43;89;129428;110593;79;240021
24;2021-01-25;47;42;89;87342;56882;89;144224
24;2021-01-25;45;12;57;31210;12071;90;43281
24;2021-01-25;610;534;1151;1320165;1238908;0;2559073
27;2021-01-25;17;21;38;143373;149679;09;293052
27;2021-01-25;79;97;176;160962;173003;19;333965
27;2021-01-25;97;79;176;133746;142254;29;276000
27;2021-01-25;107;81;188;160004;155407;39;315411
27;2021-01-25;105;94;199;172333;169564;49;341897
27;2021-01-25;103;93;196;189979;183788;59;373767
27;2021-01-25;80;88;168;192591;178206;69;370797
27;2021-01-25;65;58;123;146876;127546;79;274422
27;2021-01-25;70;43;113;96896;61575;89;158471
27;2021-01-25;69;20;89;33148;12109;90;45257
27;2021-01-25;792;674;1466;1429908;1353131;0;2783039
28;2021-01-25;22;27;51;180735;186856;09;367591
28;2021-01-25;64;52;117;200125;213621;19;413746
28;2021-01-25;68;49;117;168922;173007;29;341929
28;2021-01-25;97;67;164;196628;188487;39;385115
28;2021-01-25;93;69;162;205396;201699;49;407095
28;2021-01-25;106;60;166;222002;213866;59;435868
28;2021-01-25;74;56;130;224688;203758;69;428446
28;2021-01-25;44;39;83;163192;135543;79;298735
28;2021-01-25;54;37;91;109691;65377;89;175068
28;2021-01-25;35;10;45;37222;12685;90;49907
28;2021-01-25;657;467;1127;1708601;1594899;0;3303500
32;2021-01-25;56;69;125;358062;373689;09;731751
32;2021-01-25;179;193;372;387045;406742;19;793787
32;2021-01-25;198;158;356;342304;348587;29;690891
32;2021-01-25;208;162;370;382485;369972;39;752457
32;2021-01-25;241;189;430;382510;376716;49;759226
32;2021-01-25;205;170;375;386937;376527;59;763464
32;2021-01-25;143;138;281;371211;330938;69;702149
32;2021-01-25;101;87;188;250542;201459;79;452001
32;2021-01-25;96;76;172;163399;89786;89;253185
32;2021-01-25;64;18;82;48384;15367;90;63751
32;2021-01-25;1491;1260;2751;3072879;2889783;0;5962662
44;2021-01-25;55;61;118;291525;306839;09;598364
44;2021-01-25;198;176;376;320255;339504;19;659759
44;2021-01-25;214;193;407;302020;314428;29;616448
44;2021-01-25;220;179;399;342222;333292;39;675514
44;2021-01-25;256;176;434;349727;344491;49;694218
44;2021-01-25;220;171;392;381371;373239;59;754610
44;2021-01-25;158;141;299;367165;335850;69;703015
44;2021-01-25;94;78;173;250387;215436;79;465823
44;2021-01-25;131;74;206;170825;105192;89;276017
44;2021-01-25;77;33;110;51248;16731;90;67979
44;2021-01-25;1623;1282;2914;2826745;2685002;0;5511747
52;2021-01-25;15;27;43;213594;223900;09;437494
52;2021-01-25;69;64;135;240818;255197;19;496015
52;2021-01-25;89;75;165;197010;200630;29;397640
52;2021-01-25;96;74;170;231204;224885;39;456089
52;2021-01-25;117;85;202;243874;243418;49;487292
52;2021-01-25;101;80;181;244100;239116;59;483216
52;2021-01-25;76;68;145;241796;221345;69;463141
52;2021-01-25;46;54;100;177805;149903;79;327708
52;2021-01-25;93;46;139;119561;75822;89;195383
52;2021-01-25;107;26;133;42559;15260;90;57819
52;2021-01-25;809;599;1413;1952321;1849476;0;3801797
53;2021-01-25;14;15;30;173813;182358;09;356171
53;2021-01-25;56;48;105;202720;214740;19;417460
53;2021-01-25;54;52;109;163116;173196;29;336312
53;2021-01-25;55;37;92;190526;187674;39;378200
53;2021-01-25;54;43;97;212098;212015;49;424113
53;2021-01-25;69;41;110;223699;219176;59;442875
53;2021-01-25;36;46;82;227435;209274;69;436709
53;2021-01-25;19;22;41;169992;140910;79;310902
53;2021-01-25;27;27;54;118117;69883;89;188000
53;2021-01-25;12;7;20;37370;12267;90;49637
53;2021-01-25;396;338;740;1718886;1621493;0;3340379
75;2021-01-25;43;44;89;293104;305291;09;598395
75;2021-01-25;124;126;251;337141;357785;19;694926
75;2021-01-25;144;109;253;295024;300618;29;595642
75;2021-01-25;198;130;328;347871;331233;39;679104
75;2021-01-25;191;132;324;384742;372771;49;757513
75;2021-01-25;183;137;320;413361;390880;59;804241
75;2021-01-25;110;103;213;425623;384060;69;809683
75;2021-01-25;89;80;169;325086;276298;79;601384
75;2021-01-25;125;61;186;213986;139308;89;353294
75;2021-01-25;125;29;154;77600;28200;90;105800
75;2021-01-25;1332;951;2287;3113538;2886444;0;5999982
76;2021-01-25;67;68;137;305956;318589;09;624545
76;2021-01-25;183;180;371;338942;356969;19;695911
76;2021-01-25;190;144;334;316210;319570;29;635780
76;2021-01-25;218;179;397;356758;337587;39;694345
76;2021-01-25;266;193;459;376541;363812;49;740353
76;2021-01-25;232;187;419;402608;383750;59;786358
76;2021-01-25;157;120;277;394889;358997;69;753886
76;2021-01-25;107;107;214;308664;263806;79;572470
76;2021-01-25;125;71;196;195838;129272;89;325110
76;2021-01-25;105;30;135;69372;26728;90;96100
76;2021-01-25;1651;1280;2941;3065778;2859080;0;5924858
84;2021-01-25;82;94;180;459549;481088;09;940637
84;2021-01-25;273;285;560;487711;511905;19;999616
84;2021-01-25;287;240;527;443824;451094;29;894918
84;2021-01-25;356;292;648;512522;493262;39;1005784
84;2021-01-25;339;289;628;520248;515106;49;1035354
84;2021-01-25;298;280;578;529611;514848;59;1044459
84;2021-01-25;203;180;383;486720;439940;69;926660
84;2021-01-25;142;141;283;372151;315211;79;687362
84;2021-01-25;152;112;264;237198;150524;89;387722
84;2021-01-25;114;35;149;81185;28680;90;109865
84;2021-01-25;2246;1948;4200;4130719;3901658;0;8032377
93;2021-01-25;61;75;137;268834;283093;09;551927
93;2021-01-25;229;268;499;280751;296087;19;576838
93;2021-01-25;306;214;520;254404;255552;29;509956
93;2021-01-25;366;251;618;310704;288398;39;599102
93;2021-01-25;372;312;684;325559;305827;49;631386
93;2021-01-25;324;284;608;353104;325389;59;678493
93;2021-01-25;233;222;455;336327;296459;69;632786
93;2021-01-25;170;166;336;279820;229699;79;509519
93;2021-01-25;180;108;288;171274;113716;89;284990
93;2021-01-25;173;44;217;58896;21758;90;80654
93;2021-01-25;2414;1944;4362;2639673;2415978;0;5055651
94;2021-01-25;2;3;5;16311;17433;09;33744
94;2021-01-25;1;5;7;16679;18132;19;34811
94;2021-01-25;9;4;13;16782;16579;29;33361
94;2021-01-25;3;10;13;23044;20580;39;43624
94;2021-01-25;12;8;20;23065;22140;49;45205
94;2021-01-25;8;6;14;24549;23421;59;47970
94;2021-01-25;11;5;16;23212;21883;69;45095
94;2021-01-25;7;4;11;19544;17141;79;36685
94;2021-01-25;5;5;10;11227;8178;89;19405
94;2021-01-25;5;4;9;3332;1447;90;4779
94;2021-01-25;63;54;118;177745;166934;0;344679
01;2021-01-26;0;0;1;19979;20155;09;40134
01;2021-01-26;1;1;2;24994;25489;19;50483
01;2021-01-26;1;1;2;17868;16690;29;34558
01;2021-01-26;2;2;4;22328;14821;39;37149
01;2021-01-26;1;0;1;28652;20276;49;48928
01;2021-01-26;1;2;3;33264;27260;59;60524
01;2021-01-26;2;0;2;27135;23978;69;51113
01;2021-01-26;0;0;0;18401;14661;79;33062
01;2021-01-26;0;0;0;9633;6375;89;16008
01;2021-01-26;0;0;0;3410;1510;90;4920
01;2021-01-26;8;6;15;205664;171215;0;376879
02;2021-01-26;0;0;0;16881;17110;09;33991
02;2021-01-26;0;0;0;21410;21604;19;43014
02;2021-01-26;1;1;2;16017;15479;29;31496
02;2021-01-26;1;1;2;19825;14455;39;34280
02;2021-01-26;4;1;5;24719;18248;49;42967
02;2021-01-26;1;2;3;34361;28310;59;62671
02;2021-01-26;2;0;2;28061;24495;69;52556
02;2021-01-26;1;0;1;18231;15278;79;33509
02;2021-01-26;0;0;0;11090;7677;89;18767
02;2021-01-26;0;0;0;3992;1506;90;5498
02;2021-01-26;10;5;15;194587;164162;0;358749
03;2021-01-26;1;1;2;31123;30920;09;62043
03;2021-01-26;14;11;25;29370;29268;19;58638
03;2021-01-26;11;8;19;21458;18963;29;40421
03;2021-01-26;5;8;13;21276;18326;39;39602
03;2021-01-26;7;5;12;18164;16593;49;34757
03;2021-01-26;10;4;14;13469;13557;59;27026
03;2021-01-26;5;8;13;8776;8670;69;17446
03;2021-01-26;0;0;0;3777;3591;79;7368
03;2021-01-26;0;0;0;1649;1072;89;2721
03;2021-01-26;0;0;0;485;184;90;669
03;2021-01-26;53;45;98;149547;141144;0;290691
04;2021-01-26;0;3;3;60314;61377;09;121691
04;2021-01-26;5;4;9;66065;68387;19;134452
04;2021-01-26;9;4;13;51059;47156;29;98215
04;2021-01-26;6;4;10;58788;45780;39;104568
04;2021-01-26;1;2;3;61408;52207;49;113615
04;2021-01-26;4;3;7;64838;60759;59;125597
04;2021-01-26;4;1;5;47008;42843;69;89851
04;2021-01-26;0;0;0;25509;21184;79;46693
04;2021-01-26;0;0;0;13168;7647;89;20815
04;2021-01-26;0;0;0;3209;1253;90;4462
04;2021-01-26;29;21;50;451366;408593;0;859959
05;2021-01-26;0;0;0;362.366008612902;341.338819562748;09;703.704828175651
05;2021-01-26;0;0;0;353.376145114279;370.349735405642;19;723.725880519921
05;2021-01-26;0;0;0;218.593559489256;256.539602589476;29;475.133162078732
05;2021-01-26;0;0;0;404.225408693299;360.321910454353;39;764.547319147651
05;2021-01-26;0;0;0;520.067953604221;497.108383964256;49;1017.17633756848
05;2021-01-26;0;0;0;468.146063921917;510.087601910415;59;978.233665832332
05;2021-01-26;0;0;0;340.368470050554;334.366842191253;69;674.735312241807
05;2021-01-26;0;0;0;212.598666888387;192.597753227106;79;405.196420115493
05;2021-01-26;0;0;0;148.727797095705;61.8681715431829;89;210.595968638888
05;2021-01-26;0;0;0;32.9601271090696;10.9909785719784;90;43.9511056810479
05;2021-01-26;0;0;0;3061.43020057959;2935.56979942041;0;5997
06;2021-01-26;0;1;1;42583;42380;09;84963
06;2021-01-26;21;21;43;33369;31925;19;65294
06;2021-01-26;20;19;39;21571;15080;29;36651
06;2021-01-26;24;16;40;21550;16147;39;37697
06;2021-01-26;12;19;31;14193;13939;49;28132
06;2021-01-26;14;12;26;7171;7597;59;14768
06;2021-01-26;6;3;9;3629;4117;69;7746
06;2021-01-26;1;1;2;1577;1457;79;3034
06;2021-01-26;0;0;0;531;474;89;1005
06;2021-01-26;0;0;0;88;93;90;181
06;2021-01-26;98;92;191;146262;133209;0;279471
07;2021-01-26;0;0;0;485;549;09;1034
07;2021-01-26;0;1;1;403;432;19;835
07;2021-01-26;1;3;4;764;841;29;1605
07;2021-01-26;1;3;4;824;928;39;1752
07;2021-01-26;0;3;3;788;1020;49;1808
07;2021-01-26;0;1;1;678;870;59;1548
07;2021-01-26;0;0;0;360;382;69;742
07;2021-01-26;0;0;0;231;190;79;421
07;2021-01-26;0;0;0;114;67;89;181
07;2021-01-26;0;0;0;24;11;90;35
07;2021-01-26;2;11;13;4671;5290;0;9961
08;2021-01-26;1;0;1;2715.22592983026;2997.75551488675;09;5712.98144471701
08;2021-01-26;0;0;0;2778.51901080978;3160.9156459093;19;5939.43465671908
08;2021-01-26;0;0;0;2080.8882988764;1718.16634315323;29;3799.05464202964
08;2021-01-26;1;2;3;2701.8582062647;1896.52641413317;39;4598.38462039786
08;2021-01-26;3;1;4;3151.45861023308;2460.52498233809;49;5611.98359257117
08;2021-01-26;2;2;4;2620.29868333099;2422.23566154656;59;5042.53434487755
08;2021-01-26;0;0;0;1621.44173420671;1438.58325779464;69;3060.02499200135
08;2021-01-26;0;0;0;626.575909335673;526.358467843651;79;1152.93437717932
08;2021-01-26;0;0;0;205.018522985054;140.993639349697;89;346.012162334751
08;2021-01-26;0;0;0;50.0325684687745;20.62259870351;90;70.6551671722846
08;2021-01-26;7;5;12;18551.3174743414;16782.6825256586;0;35334
11;2021-01-26;86;92;189;783071;811785;09;1594856
11;2021-01-26;286;296;603;761456;784653;19;1546109
11;2021-01-26;432;367;802;850145;801772;29;1651917
11;2021-01-26;394;372;769;914360;843488;39;1757848
11;2021-01-26;383;294;678;845609;826202;49;1671811
11;2021-01-26;304;279;585;793566;745070;59;1538636
11;2021-01-26;209;228;446;628649;549192;69;1177841
11;2021-01-26;107;100;209;434606;358356;79;792962
11;2021-01-26;93;61;156;261425;162933;89;424358
11;2021-01-26;53;17;70;89253;32619;90;121872
11;2021-01-26;2348;2107;4511;6362140;5916070;0;12278210
24;2021-01-26;10;17;27;139720;144686;09;284406
24;2021-01-26;61;57;119;152979;161185;19;314164
24;2021-01-26;71;43;114;122237;126536;29;248773
24;2021-01-26;71;48;119;150359;142009;39;292368
24;2021-01-26;63;51;114;161829;158758;49;320587
24;2021-01-26;68;68;136;172552;168011;59;340563
24;2021-01-26;42;31;73;172509;158177;69;330686
24;2021-01-26;29;30;59;129428;110593;79;240021
24;2021-01-26;43;15;58;87342;56882;89;144224
24;2021-01-26;34;12;46;31210;12071;90;43281
24;2021-01-26;492;372;866;1320165;1238908;0;2559073
27;2021-01-26;18;24;42;143373;149679;09;293052
27;2021-01-26;67;54;121;160962;173003;19;333965
27;2021-01-26;72;63;135;133746;142254;29;276000
27;2021-01-26;67;51;118;160004;155407;39;315411
27;2021-01-26;74;57;131;172333;169564;49;341897
27;2021-01-26;86;59;145;189979;183788;59;373767
27;2021-01-26;66;52;118;192591;178206;69;370797
27;2021-01-26;56;49;105;146876;127546;79;274422
27;2021-01-26;57;37;94;96896;61575;89;158471
27;2021-01-26;56;15;71;33148;12109;90;45257
27;2021-01-26;620;461;1081;1429908;1353131;0;2783039
28;2021-01-26;19;17;36;180735;186856;09;367591
28;2021-01-26;55;50;107;200125;213621;19;413746
28;2021-01-26;71;49;120;168922;173007;29;341929
28;2021-01-26;78;46;124;196628;188487;39;385115
28;2021-01-26;63;57;120;205396;201699;49;407095
28;2021-01-26;69;48;117;222002;213866;59;435868
28;2021-01-26;55;49;104;224688;203758;69;428446
28;2021-01-26;33;33;66;163192;135543;79;298735
28;2021-01-26;57;35;93;109691;65377;89;175068
28;2021-01-26;38;10;48;37222;12685;90;49907
28;2021-01-26;538;394;935;1708601;1594899;0;3303500
32;2021-01-26;55;52;107;358062;373689;09;731751
32;2021-01-26;139;134;273;387045;406742;19;793787
32;2021-01-26;170;122;292;342304;348587;29;690891
32;2021-01-26;177;123;300;382485;369972;39;752457
32;2021-01-26;154;152;306;382510;376716;49;759226
32;2021-01-26;148;139;287;386937;376527;59;763464
32;2021-01-26;92;91;183;371211;330938;69;702149
32;2021-01-26;101;67;168;250542;201459;79;452001
32;2021-01-26;85;47;132;163399;89786;89;253185
32;2021-01-26;61;14;75;48384;15367;90;63751
32;2021-01-26;1183;942;2128;3072879;2889783;0;5962662
44;2021-01-26;50;57;107;291525;306839;09;598364
44;2021-01-26;153;135;293;320255;339504;19;659759
44;2021-01-26;159;150;309;302020;314428;29;616448
44;2021-01-26;163;134;297;342222;333292;39;675514
44;2021-01-26;166;146;313;349727;344491;49;694218
44;2021-01-26;146;122;269;381371;373239;59;754610
44;2021-01-26;108;121;229;367165;335850;69;703015
44;2021-01-26;71;65;136;250387;215436;79;465823
44;2021-01-26;71;46;120;170825;105192;89;276017
44;2021-01-26;49;17;66;51248;16731;90;67979
44;2021-01-26;1136;993;2139;2826745;2685002;0;5511747
52;2021-01-26;22;12;35;213594;223900;09;437494
52;2021-01-26;63;62;126;240818;255197;19;496015
52;2021-01-26;61;45;107;197010;200630;29;397640
52;2021-01-26;56;50;106;231204;224885;39;456089
52;2021-01-26;80;76;156;243874;243418;49;487292
52;2021-01-26;71;60;131;244100;239116;59;483216
52;2021-01-26;51;39;90;241796;221345;69;463141
52;2021-01-26;39;36;77;177805;149903;79;327708
52;2021-01-26;53;24;77;119561;75822;89;195383
52;2021-01-26;44;13;57;42559;15260;90;57819
52;2021-01-26;540;417;962;1952321;1849476;0;3801797
53;2021-01-26;9;13;22;173813;182358;09;356171
53;2021-01-26;31;32;65;202720;214740;19;417460
53;2021-01-26;37;35;73;163116;173196;29;336312
53;2021-01-26;39;25;64;190526;187674;39;378200
53;2021-01-26;44;29;73;212098;212015;49;424113
53;2021-01-26;39;34;73;223699;219176;59;442875
53;2021-01-26;22;19;41;227435;209274;69;436709
53;2021-01-26;21;15;36;169992;140910;79;310902
53;2021-01-26;28;18;46;118117;69883;89;188000
53;2021-01-26;17;2;19;37370;12267;90;49637
53;2021-01-26;287;222;512;1718886;1621493;0;3340379
75;2021-01-26;42;49;92;293104;305291;09;598395
75;2021-01-26;101;97;200;337141;357785;19;694926
75;2021-01-26;119;96;215;295024;300618;29;595642
75;2021-01-26;153;91;244;347871;331233;39;679104
75;2021-01-26;150;130;280;384742;372771;49;757513
75;2021-01-26;140;115;255;413361;390880;59;804241
75;2021-01-26;80;77;157;425623;384060;69;809683
75;2021-01-26;69;71;140;325086;276298;79;601384
75;2021-01-26;80;48;130;213986;139308;89;353294
75;2021-01-26;78;22;100;77600;28200;90;105800
75;2021-01-26;1012;796;1813;3113538;2886444;0;5999982
76;2021-01-26;51;51;106;305956;318589;09;624545
76;2021-01-26;149;151;305;338942;356969;19;695911
76;2021-01-26;181;114;295;316210;319570;29;635780
76;2021-01-26;182;103;286;356758;337587;39;694345
76;2021-01-26;174;139;313;376541;363812;49;740353
76;2021-01-26;165;144;309;402608;383750;59;786358
76;2021-01-26;108;97;205;394889;358997;69;753886
76;2021-01-26;89;89;179;308664;263806;79;572470
76;2021-01-26;94;58;152;195838;129272;89;325110
76;2021-01-26;99;27;126;69372;26728;90;96100
76;2021-01-26;1294;973;2278;3065778;2859080;0;5924858
84;2021-01-26;69;84;155;459549;481088;09;940637
84;2021-01-26;204;211;418;487711;511905;19;999616
84;2021-01-26;212;198;410;443824;451094;29;894918
84;2021-01-26;259;188;447;512522;493262;39;1005784
84;2021-01-26;200;194;394;520248;515106;49;1035354
84;2021-01-26;190;181;372;529611;514848;59;1044459
84;2021-01-26;135;150;285;486720;439940;69;926660
84;2021-01-26;116;103;220;372151;315211;79;687362
84;2021-01-26;118;68;186;237198;150524;89;387722
84;2021-01-26;79;24;103;81185;28680;90;109865
84;2021-01-26;1582;1401;2990;4130719;3901658;0;8032377
93;2021-01-26;40;57;97;268834;283093;09;551927
93;2021-01-26;173;157;332;280751;296087;19;576838
93;2021-01-26;236;171;407;254404;255552;29;509956
93;2021-01-26;248;171;419;310704;288398;39;599102
93;2021-01-26;251;208;459;325559;305827;49;631386
93;2021-01-26;264;264;528;353104;325389;59;678493
93;2021-01-26;159;169;328;336327;296459;69;632786
93;2021-01-26;130;109;239;279820;229699;79;509519
93;2021-01-26;150;81;231;171274;113716;89;284990
93;2021-01-26;102;29;131;58896;21758;90;80654
93;2021-01-26;1753;1416;3171;2639673;2415978;0;5055651
94;2021-01-26;1;4;5;16311;17433;09;33744
94;2021-01-26;2;0;2;16679;18132;19;34811
94;2021-01-26;2;2;4;16782;16579;29;33361
94;2021-01-26;11;5;16;23044;20580;39;43624
94;2021-01-26;2;12;14;23065;22140;49;45205
94;2021-01-26;6;7;13;24549;23421;59;47970
94;2021-01-26;4;8;12;23212;21883;69;45095
94;2021-01-26;4;5;9;19544;17141;79;36685
94;2021-01-26;2;1;3;11227;8178;89;19405
94;2021-01-26;5;0;5;3332;1447;90;4779
94;2021-01-26;39;45;84;177745;166934;0;344679
01;2021-01-27;0;0;0;19979;20155;09;40134
01;2021-01-27;2;1;3;24994;25489;19;50483
01;2021-01-27;1;0;1;17868;16690;29;34558
01;2021-01-27;3;0;3;22328;14821;39;37149
01;2021-01-27;1;0;1;28652;20276;49;48928
01;2021-01-27;1;3;4;33264;27260;59;60524
01;2021-01-27;0;0;0;27135;23978;69;51113
01;2021-01-27;0;0;0;18401;14661;79;33062
01;2021-01-27;0;0;0;9633;6375;89;16008
01;2021-01-27;0;0;0;3410;1510;90;4920
01;2021-01-27;8;4;12;205664;171215;0;376879
02;2021-01-27;0;0;0;16881;17110;09;33991
02;2021-01-27;0;0;1;21410;21604;19;43014
02;2021-01-27;0;0;0;16017;15479;29;31496
02;2021-01-27;2;2;4;19825;14455;39;34280
02;2021-01-27;1;0;1;24719;18248;49;42967
02;2021-01-27;3;0;3;34361;28310;59;62671
02;2021-01-27;1;1;2;28061;24495;69;52556
02;2021-01-27;0;2;2;18231;15278;79;33509
02;2021-01-27;0;0;0;11090;7677;89;18767
02;2021-01-27;0;0;0;3992;1506;90;5498
02;2021-01-27;7;5;13;194587;164162;0;358749
03;2021-01-27;2;1;3;31123;30920;09;62043
03;2021-01-27;7;6;13;29370;29268;19;58638
03;2021-01-27;9;6;15;21458;18963;29;40421
03;2021-01-27;12;7;19;21276;18326;39;39602
03;2021-01-27;9;8;18;18164;16593;49;34757
03;2021-01-27;2;4;6;13469;13557;59;27026
03;2021-01-27;2;3;5;8776;8670;69;17446
03;2021-01-27;1;2;3;3777;3591;79;7368
03;2021-01-27;2;1;3;1649;1072;89;2721
03;2021-01-27;0;0;0;485;184;90;669
03;2021-01-27;46;38;85;149547;141144;0;290691
04;2021-01-27;0;0;0;60314;61377;09;121691
04;2021-01-27;3;1;4;66065;68387;19;134452
04;2021-01-27;9;7;16;51059;47156;29;98215
04;2021-01-27;6;3;9;58788;45780;39;104568
04;2021-01-27;2;4;6;61408;52207;49;113615
04;2021-01-27;3;3;6;64838;60759;59;125597
04;2021-01-27;2;1;3;47008;42843;69;89851
04;2021-01-27;2;0;2;25509;21184;79;46693
04;2021-01-27;0;0;0;13168;7647;89;20815
04;2021-01-27;1;0;1;3209;1253;90;4462
04;2021-01-27;28;19;47;451366;408593;0;859959
05;2021-01-27;0;0;0;362.366008612902;341.338819562748;09;703.704828175651
05;2021-01-27;0;0;0;353.376145114279;370.349735405642;19;723.725880519921
05;2021-01-27;0;0;0;218.593559489256;256.539602589476;29;475.133162078732
05;2021-01-27;1;0;1;404.225408693299;360.321910454353;39;764.547319147651
05;2021-01-27;0;0;0;520.067953604221;497.108383964256;49;1017.17633756848
05;2021-01-27;0;0;0;468.146063921917;510.087601910415;59;978.233665832332
05;2021-01-27;0;0;0;340.368470050554;334.366842191253;69;674.735312241807
05;2021-01-27;0;0;0;212.598666888387;192.597753227106;79;405.196420115493
05;2021-01-27;0;0;0;148.727797095705;61.8681715431829;89;210.595968638888
05;2021-01-27;0;0;0;32.9601271090696;10.9909785719784;90;43.9511056810479
05;2021-01-27;1;0;1;3061.43020057959;2935.56979942041;0;5997
06;2021-01-27;1;3;4;42583;42380;09;84963
06;2021-01-27;25;7;32;33369;31925;19;65294
06;2021-01-27;33;26;59;21571;15080;29;36651
06;2021-01-27;24;25;49;21550;16147;39;37697
06;2021-01-27;17;12;29;14193;13939;49;28132
06;2021-01-27;9;10;19;7171;7597;59;14768
06;2021-01-27;16;14;30;3629;4117;69;7746
06;2021-01-27;1;0;1;1577;1457;79;3034
06;2021-01-27;1;1;2;531;474;89;1005
06;2021-01-27;0;0;0;88;93;90;181
06;2021-01-27;127;98;225;146262;133209;0;279471
07;2021-01-27;0;0;0;485;549;09;1034
07;2021-01-27;0;0;0;403;432;19;835
07;2021-01-27;0;1;1;764;841;29;1605
07;2021-01-27;2;0;2;824;928;39;1752
07;2021-01-27;0;0;0;788;1020;49;1808
07;2021-01-27;0;2;2;678;870;59;1548
07;2021-01-27;0;0;0;360;382;69;742
07;2021-01-27;1;0;1;231;190;79;421
07;2021-01-27;0;0;0;114;67;89;181
07;2021-01-27;0;0;0;24;11;90;35
07;2021-01-27;3;3;6;4671;5290;0;9961
08;2021-01-27;0;0;0;2715.22592983026;2997.75551488675;09;5712.98144471701
08;2021-01-27;1;0;1;2778.51901080978;3160.9156459093;19;5939.43465671908
08;2021-01-27;0;0;0;2080.8882988764;1718.16634315323;29;3799.05464202964
08;2021-01-27;0;3;3;2701.8582062647;1896.52641413317;39;4598.38462039786
08;2021-01-27;4;0;4;3151.45861023308;2460.52498233809;49;5611.98359257117
08;2021-01-27;5;3;8;2620.29868333099;2422.23566154656;59;5042.53434487755
08;2021-01-27;2;1;3;1621.44173420671;1438.58325779464;69;3060.02499200135
08;2021-01-27;0;0;0;626.575909335673;526.358467843651;79;1152.93437717932
08;2021-01-27;0;0;0;205.018522985054;140.993639349697;89;346.012162334751
08;2021-01-27;0;0;0;50.0325684687745;20.62259870351;90;70.6551671722846
08;2021-01-27;12;7;19;18551.3174743414;16782.6825256586;0;35334
11;2021-01-27;120;105;242;783071;811785;09;1594856
11;2021-01-27;282;330;635;761456;784653;19;1546109
11;2021-01-27;414;333;752;850145;801772;29;1651917
11;2021-01-27;434;356;792;914360;843488;39;1757848
11;2021-01-27;345;316;664;845609;826202;49;1671811
11;2021-01-27;295;272;569;793566;745070;59;1538636
11;2021-01-27;193;184;381;628649;549192;69;1177841
11;2021-01-27;107;107;214;434606;358356;79;792962
11;2021-01-27;89;58;147;261425;162933;89;424358
11;2021-01-27;54;17;71;89253;32619;90;121872
11;2021-01-27;2337;2080;4473;6362140;5916070;0;12278210
24;2021-01-27;12;13;26;139720;144686;09;284406
24;2021-01-27;55;67;122;152979;161185;19;314164
24;2021-01-27;64;37;101;122237;126536;29;248773
24;2021-01-27;71;41;112;150359;142009;39;292368
24;2021-01-27;77;46;123;161829;158758;49;320587
24;2021-01-27;63;48;111;172552;168011;59;340563
24;2021-01-27;34;34;68;172509;158177;69;330686
24;2021-01-27;37;28;65;129428;110593;79;240021
24;2021-01-27;48;19;67;87342;56882;89;144224
24;2021-01-27;46;7;53;31210;12071;90;43281
24;2021-01-27;507;340;848;1320165;1238908;0;2559073
27;2021-01-27;22;20;42;143373;149679;09;293052
27;2021-01-27;71;63;134;160962;173003;19;333965
27;2021-01-27;72;43;115;133746;142254;29;276000
27;2021-01-27;70;45;115;160004;155407;39;315411
27;2021-01-27;59;49;108;172333;169564;49;341897
27;2021-01-27;70;58;128;189979;183788;59;373767
27;2021-01-27;43;49;92;192591;178206;69;370797
27;2021-01-27;41;32;73;146876;127546;79;274422
27;2021-01-27;38;27;65;96896;61575;89;158471
27;2021-01-27;32;3;35;33148;12109;90;45257
27;2021-01-27;518;389;907;1429908;1353131;0;2783039
28;2021-01-27;26;20;49;180735;186856;09;367591
28;2021-01-27;61;44;106;200125;213621;19;413746
28;2021-01-27;61;45;106;168922;173007;29;341929
28;2021-01-27;87;45;132;196628;188487;39;385115
28;2021-01-27;79;54;133;205396;201699;49;407095
28;2021-01-27;66;52;118;222002;213866;59;435868
28;2021-01-27;60;46;106;224688;203758;69;428446
28;2021-01-27;36;38;74;163192;135543;79;298735
28;2021-01-27;62;32;94;109691;65377;89;175068
28;2021-01-27;49;8;57;37222;12685;90;49907
28;2021-01-27;587;385;976;1708601;1594899;0;3303500
32;2021-01-27;49;50;99;358062;373689;09;731751
32;2021-01-27;129;169;298;387045;406742;19;793787
32;2021-01-27;139;121;260;342304;348587;29;690891
32;2021-01-27;171;159;330;382485;369972;39;752457
32;2021-01-27;124;131;255;382510;376716;49;759226
32;2021-01-27;126;114;240;386937;376527;59;763464
32;2021-01-27;76;66;142;371211;330938;69;702149
32;2021-01-27;60;77;137;250542;201459;79;452001
32;2021-01-27;67;34;101;163399;89786;89;253185
32;2021-01-27;51;13;64;48384;15367;90;63751
32;2021-01-27;993;934;1927;3072879;2889783;0;5962662
44;2021-01-27;58;66;124;291525;306839;09;598364
44;2021-01-27;152;124;278;320255;339504;19;659759
44;2021-01-27;137;126;264;302020;314428;29;616448
44;2021-01-27;153;132;285;342222;333292;39;675514
44;2021-01-27;134;114;248;349727;344491;49;694218
44;2021-01-27;139;120;263;381371;373239;59;754610
44;2021-01-27;85;109;194;367165;335850;69;703015
44;2021-01-27;65;44;111;250387;215436;79;465823
44;2021-01-27;75;32;111;170825;105192;89;276017
44;2021-01-27;36;15;51;51248;16731;90;67979
44;2021-01-27;1034;882;1929;2826745;2685002;0;5511747
52;2021-01-27;26;16;43;213594;223900;09;437494
52;2021-01-27;58;73;133;240818;255197;19;496015
52;2021-01-27;65;76;141;197010;200630;29;397640
52;2021-01-27;84;50;135;231204;224885;39;456089
52;2021-01-27;81;71;152;243874;243418;49;487292
52;2021-01-27;58;64;122;244100;239116;59;483216
52;2021-01-27;37;46;83;241796;221345;69;463141
52;2021-01-27;49;31;82;177805;149903;79;327708
52;2021-01-27;51;31;82;119561;75822;89;195383
52;2021-01-27;47;11;58;42559;15260;90;57819
52;2021-01-27;556;469;1031;1952321;1849476;0;3801797
53;2021-01-27;11;17;29;173813;182358;09;356171
53;2021-01-27;32;53;85;202720;214740;19;417460
53;2021-01-27;51;46;104;163116;173196;29;336312
53;2021-01-27;45;30;75;190526;187674;39;378200
53;2021-01-27;35;27;62;212098;212015;49;424113
53;2021-01-27;29;28;57;223699;219176;59;442875
53;2021-01-27;17;17;34;227435;209274;69;436709
53;2021-01-27;24;20;44;169992;140910;79;310902
53;2021-01-27;27;20;47;118117;69883;89;188000
53;2021-01-27;20;5;26;37370;12267;90;49637
53;2021-01-27;291;263;563;1718886;1621493;0;3340379
75;2021-01-27;38;40;79;293104;305291;09;598395
75;2021-01-27;100;103;203;337141;357785;19;694926
75;2021-01-27;131;104;236;295024;300618;29;595642
75;2021-01-27;127;121;248;347871;331233;39;679104
75;2021-01-27;113;113;226;384742;372771;49;757513
75;2021-01-27;125;94;219;413361;390880;59;804241
75;2021-01-27;76;68;144;425623;384060;69;809683
75;2021-01-27;68;62;130;325086;276298;79;601384
75;2021-01-27;57;47;104;213986;139308;89;353294
75;2021-01-27;50;16;66;77600;28200;90;105800
75;2021-01-27;885;769;1656;3113538;2886444;0;5999982
76;2021-01-27;38;39;79;305956;318589;09;624545
76;2021-01-27;128;165;295;338942;356969;19;695911
76;2021-01-27;166;129;295;316210;319570;29;635780
76;2021-01-27;155;99;254;356758;337587;39;694345
76;2021-01-27;160;131;291;376541;363812;49;740353
76;2021-01-27;161;138;299;402608;383750;59;786358
76;2021-01-27;93;98;191;394889;358997;69;753886
76;2021-01-27;66;83;149;308664;263806;79;572470
76;2021-01-27;99;50;149;195838;129272;89;325110
76;2021-01-27;65;20;85;69372;26728;90;96100
76;2021-01-27;1131;952;2087;3065778;2859080;0;5924858
84;2021-01-27;86;69;156;459549;481088;09;940637
84;2021-01-27;204;228;437;487711;511905;19;999616
84;2021-01-27;193;178;372;443824;451094;29;894918
84;2021-01-27;232;158;390;512522;493262;39;1005784
84;2021-01-27;242;187;429;520248;515106;49;1035354
84;2021-01-27;190;171;361;529611;514848;59;1044459
84;2021-01-27;150;120;270;486720;439940;69;926660
84;2021-01-27;98;96;194;372151;315211;79;687362
84;2021-01-27;82;52;134;237198;150524;89;387722
84;2021-01-27;70;23;93;81185;28680;90;109865
84;2021-01-27;1547;1282;2836;4130719;3901658;0;8032377
93;2021-01-27;49;46;95;268834;283093;09;551927
93;2021-01-27;202;188;391;280751;296087;19;576838
93;2021-01-27;210;166;376;254404;255552;29;509956
93;2021-01-27;225;187;413;310704;288398;39;599102
93;2021-01-27;249;181;431;325559;305827;49;631386
93;2021-01-27;212;185;397;353104;325389;59;678493
93;2021-01-27;149;150;299;336327;296459;69;632786
93;2021-01-27;114;99;213;279820;229699;79;509519
93;2021-01-27;104;81;185;171274;113716;89;284990
93;2021-01-27;94;19;113;58896;21758;90;80654
93;2021-01-27;1609;1302;2914;2639673;2415978;0;5055651
94;2021-01-27;1;0;1;16311;17433;09;33744
94;2021-01-27;5;2;7;16679;18132;19;34811
94;2021-01-27;2;3;5;16782;16579;29;33361
94;2021-01-27;4;5;9;23044;20580;39;43624
94;2021-01-27;4;1;5;23065;22140;49;45205
94;2021-01-27;5;2;7;24549;23421;59;47970
94;2021-01-27;2;4;6;23212;21883;69;45095
94;2021-01-27;3;0;3;19544;17141;79;36685
94;2021-01-27;2;0;2;11227;8178;89;19405
94;2021-01-27;2;0;2;3332;1447;90;4779
94;2021-01-27;30;17;47;177745;166934;0;344679
01;2021-01-28;0;0;0;19979;20155;09;40134
01;2021-01-28;0;1;1;24994;25489;19;50483
01;2021-01-28;2;0;2;17868;16690;29;34558
01;2021-01-28;1;1;2;22328;14821;39;37149
01;2021-01-28;1;2;3;28652;20276;49;48928
01;2021-01-28;1;4;5;33264;27260;59;60524
01;2021-01-28;1;4;5;27135;23978;69;51113
01;2021-01-28;0;3;3;18401;14661;79;33062
01;2021-01-28;0;0;0;9633;6375;89;16008
01;2021-01-28;0;0;0;3410;1510;90;4920
01;2021-01-28;6;15;21;205664;171215;0;376879
02;2021-01-28;1;0;1;16881;17110;09;33991
02;2021-01-28;1;2;3;21410;21604;19;43014
02;2021-01-28;1;1;2;16017;15479;29;31496
02;2021-01-28;1;2;3;19825;14455;39;34280
02;2021-01-28;1;1;2;24719;18248;49;42967
02;2021-01-28;0;3;3;34361;28310;59;62671
02;2021-01-28;0;1;1;28061;24495;69;52556
02;2021-01-28;0;0;0;18231;15278;79;33509
02;2021-01-28;0;0;0;11090;7677;89;18767
02;2021-01-28;0;0;0;3992;1506;90;5498
02;2021-01-28;5;10;15;194587;164162;0;358749
03;2021-01-28;0;0;0;31123;30920;09;62043
03;2021-01-28;8;7;15;29370;29268;19;58638
03;2021-01-28;9;3;13;21458;18963;29;40421
03;2021-01-28;10;2;12;21276;18326;39;39602
03;2021-01-28;5;5;10;18164;16593;49;34757
03;2021-01-28;2;3;5;13469;13557;59;27026
03;2021-01-28;10;2;12;8776;8670;69;17446
03;2021-01-28;1;0;1;3777;3591;79;7368
03;2021-01-28;1;0;1;1649;1072;89;2721
03;2021-01-28;0;0;0;485;184;90;669
03;2021-01-28;46;22;69;149547;141144;0;290691
04;2021-01-28;3;1;5;60314;61377;09;121691
04;2021-01-28;5;5;10;66065;68387;19;134452
04;2021-01-28;5;8;13;51059;47156;29;98215
04;2021-01-28;7;7;14;58788;45780;39;104568
04;2021-01-28;6;4;10;61408;52207;49;113615
04;2021-01-28;3;3;6;64838;60759;59;125597
04;2021-01-28;4;2;6;47008;42843;69;89851
04;2021-01-28;0;0;0;25509;21184;79;46693
04;2021-01-28;1;1;2;13168;7647;89;20815
04;2021-01-28;1;0;1;3209;1253;90;4462
04;2021-01-28;35;31;67;451366;408593;0;859959
05;2021-01-28;0;0;0;362.366008612902;341.338819562748;09;703.704828175651
05;2021-01-28;0;0;0;353.376145114279;370.349735405642;19;723.725880519921
05;2021-01-28;0;0;0;218.593559489256;256.539602589476;29;475.133162078732
05;2021-01-28;0;0;0;404.225408693299;360.321910454353;39;764.547319147651
05;2021-01-28;0;0;0;520.067953604221;497.108383964256;49;1017.17633756848
05;2021-01-28;0;0;0;468.146063921917;510.087601910415;59;978.233665832332
05;2021-01-28;0;0;0;340.368470050554;334.366842191253;69;674.735312241807
05;2021-01-28;0;0;0;212.598666888387;192.597753227106;79;405.196420115493
05;2021-01-28;0;0;0;148.727797095705;61.8681715431829;89;210.595968638888
05;2021-01-28;0;0;0;32.9601271090696;10.9909785719784;90;43.9511056810479
05;2021-01-28;0;0;0;3061.43020057959;2935.56979942041;0;5997
06;2021-01-28;2;0;2;42583;42380;09;84963
06;2021-01-28;24;15;39;33369;31925;19;65294
06;2021-01-28;25;21;46;21571;15080;29;36651
06;2021-01-28;34;18;52;21550;16147;39;37697
06;2021-01-28;23;15;38;14193;13939;49;28132
06;2021-01-28;13;9;22;7171;7597;59;14768
06;2021-01-28;2;11;13;3629;4117;69;7746
06;2021-01-28;0;3;3;1577;1457;79;3034
06;2021-01-28;0;0;0;531;474;89;1005
06;2021-01-28;0;0;0;88;93;90;181
06;2021-01-28;123;92;215;146262;133209;0;279471
07;2021-01-28;0;0;0;485;549;09;1034
07;2021-01-28;0;0;0;403;432;19;835
07;2021-01-28;0;2;2;764;841;29;1605
07;2021-01-28;1;2;3;824;928;39;1752
07;2021-01-28;0;1;1;788;1020;49;1808
07;2021-01-28;0;0;0;678;870;59;1548
07;2021-01-28;0;1;1;360;382;69;742
07;2021-01-28;0;0;0;231;190;79;421
07;2021-01-28;0;0;0;114;67;89;181
07;2021-01-28;0;0;0;24;11;90;35
07;2021-01-28;1;6;7;4671;5290;0;9961
08;2021-01-28;0;0;0;2715.22592983026;2997.75551488675;09;5712.98144471701
08;2021-01-28;2;1;3;2778.51901080978;3160.9156459093;19;5939.43465671908
08;2021-01-28;0;1;1;2080.8882988764;1718.16634315323;29;3799.05464202964
08;2021-01-28;1;2;3;2701.8582062647;1896.52641413317;39;4598.38462039786
08;2021-01-28;3;1;4;3151.45861023308;2460.52498233809;49;5611.98359257117
08;2021-01-28;1;5;6;2620.29868333099;2422.23566154656;59;5042.53434487755
08;2021-01-28;1;1;2;1621.44173420671;1438.58325779464;69;3060.02499200135
08;2021-01-28;1;0;1;626.575909335673;526.358467843651;79;1152.93437717932
08;2021-01-28;0;1;1;205.018522985054;140.993639349697;89;346.012162334751
08;2021-01-28;0;0;0;50.0325684687745;20.62259870351;90;70.6551671722846
08;2021-01-28;9;12;21;18551.3174743414;16782.6825256586;0;35334
11;2021-01-28;99;101;212;783071;811785;09;1594856
11;2021-01-28;282;289;591;761456;784653;19;1546109
11;2021-01-28;452;367;823;850145;801772;29;1651917
11;2021-01-28;459;396;859;914360;843488;39;1757848
11;2021-01-28;402;373;775;845609;826202;49;1671811
11;2021-01-28;353;282;636;793566;745070;59;1538636
11;2021-01-28;203;200;408;628649;549192;69;1177841
11;2021-01-28;98;112;212;434606;358356;79;792962
11;2021-01-28;97;68;166;261425;162933;89;424358
11;2021-01-28;64;24;88;89253;32619;90;121872
11;2021-01-28;2509;2212;4770;6362140;5916070;0;12278210
24;2021-01-28;11;13;26;139720;144686;09;284406
24;2021-01-28;48;57;105;152979;161185;19;314164
24;2021-01-28;69;49;118;122237;126536;29;248773
24;2021-01-28;67;49;116;150359;142009;39;292368
24;2021-01-28;72;43;115;161829;158758;49;320587
24;2021-01-28;64;50;114;172552;168011;59;340563
24;2021-01-28;47;29;76;172509;158177;69;330686
24;2021-01-28;31;33;64;129428;110593;79;240021
24;2021-01-28;48;25;73;87342;56882;89;144224
24;2021-01-28;35;9;44;31210;12071;90;43281
24;2021-01-28;492;357;851;1320165;1238908;0;2559073
27;2021-01-28;26;14;40;143373;149679;09;293052
27;2021-01-28;60;61;121;160962;173003;19;333965
27;2021-01-28;68;51;119;133746;142254;29;276000
27;2021-01-28;65;56;121;160004;155407;39;315411
27;2021-01-28;67;45;112;172333;169564;49;341897
27;2021-01-28;87;67;154;189979;183788;59;373767
27;2021-01-28;50;53;103;192591;178206;69;370797
27;2021-01-28;40;46;86;146876;127546;79;274422
27;2021-01-28;45;32;77;96896;61575;89;158471
27;2021-01-28;36;15;51;33148;12109;90;45257
27;2021-01-28;544;440;984;1429908;1353131;0;2783039
28;2021-01-28;10;17;28;180735;186856;09;367591
28;2021-01-28;46;70;116;200125;213621;19;413746
28;2021-01-28;77;55;132;168922;173007;29;341929
28;2021-01-28;60;62;122;196628;188487;39;385115
28;2021-01-28;75;63;138;205396;201699;49;407095
28;2021-01-28;69;51;120;222002;213866;59;435868
28;2021-01-28;52;61;113;224688;203758;69;428446
28;2021-01-28;42;35;77;163192;135543;79;298735
28;2021-01-28;48;18;66;109691;65377;89;175068
28;2021-01-28;45;13;58;37222;12685;90;49907
28;2021-01-28;524;445;970;1708601;1594899;0;3303500
32;2021-01-28;31;51;82;358062;373689;09;731751
32;2021-01-28;128;141;271;387045;406742;19;793787
32;2021-01-28;170;149;319;342304;348587;29;690891
32;2021-01-28;169;120;289;382485;369972;39;752457
32;2021-01-28;160;131;291;382510;376716;49;759226
32;2021-01-28;137;114;251;386937;376527;59;763464
32;2021-01-28;112;103;215;371211;330938;69;702149
32;2021-01-28;81;78;159;250542;201459;79;452001
32;2021-01-28;64;38;102;163399;89786;89;253185
32;2021-01-28;32;13;45;48384;15367;90;63751
32;2021-01-28;1084;939;2025;3072879;2889783;0;5962662
44;2021-01-28;44;46;93;291525;306839;09;598364
44;2021-01-28;141;150;292;320255;339504;19;659759
44;2021-01-28;130;132;262;302020;314428;29;616448
44;2021-01-28;153;146;299;342222;333292;39;675514
44;2021-01-28;149;123;273;349727;344491;49;694218
44;2021-01-28;141;125;270;381371;373239;59;754610
44;2021-01-28;97;93;190;367165;335850;69;703015
44;2021-01-28;58;70;128;250387;215436;79;465823
44;2021-01-28;93;48;144;170825;105192;89;276017
44;2021-01-28;61;10;73;51248;16731;90;67979
44;2021-01-28;1067;943;2024;2826745;2685002;0;5511747
52;2021-01-28;14;22;39;213594;223900;09;437494
52;2021-01-28;72;89;163;240818;255197;19;496015
52;2021-01-28;78;73;151;197010;200630;29;397640
52;2021-01-28;76;52;128;231204;224885;39;456089
52;2021-01-28;90;64;154;243874;243418;49;487292
52;2021-01-28;67;55;123;244100;239116;59;483216
52;2021-01-28;48;49;100;241796;221345;69;463141
52;2021-01-28;39;38;77;177805;149903;79;327708
52;2021-01-28;52;28;80;119561;75822;89;195383
52;2021-01-28;46;9;55;42559;15260;90;57819
52;2021-01-28;582;479;1070;1952321;1849476;0;3801797
53;2021-01-28;16;14;31;173813;182358;09;356171
53;2021-01-28;41;42;86;202720;214740;19;417460
53;2021-01-28;56;41;102;163116;173196;29;336312
53;2021-01-28;47;41;88;190526;187674;39;378200
53;2021-01-28;54;34;88;212098;212015;49;424113
53;2021-01-28;47;38;85;223699;219176;59;442875
53;2021-01-28;23;35;58;227435;209274;69;436709
53;2021-01-28;26;21;47;169992;140910;79;310902
53;2021-01-28;46;19;65;118117;69883;89;188000
53;2021-01-28;30;12;43;37370;12267;90;49637
53;2021-01-28;386;297;693;1718886;1621493;0;3340379
75;2021-01-28;45;31;80;293104;305291;09;598395
75;2021-01-28;104;105;209;337141;357785;19;694926
75;2021-01-28;152;108;260;295024;300618;29;595642
75;2021-01-28;146;102;248;347871;331233;39;679104
75;2021-01-28;140;120;260;384742;372771;49;757513
75;2021-01-28;124;100;224;413361;390880;59;804241
75;2021-01-28;106;103;209;425623;384060;69;809683
75;2021-01-28;59;72;131;325086;276298;79;601384
75;2021-01-28;96;48;144;213986;139308;89;353294
75;2021-01-28;93;23;116;77600;28200;90;105800
75;2021-01-28;1065;812;1881;3113538;2886444;0;5999982
76;2021-01-28;30;50;81;305956;318589;09;624545
76;2021-01-28;127;161;294;338942;356969;19;695911
76;2021-01-28;155;126;281;316210;319570;29;635780
76;2021-01-28;201;137;338;356758;337587;39;694345
76;2021-01-28;194;128;322;376541;363812;49;740353
76;2021-01-28;135;157;292;402608;383750;59;786358
76;2021-01-28;103;93;196;394889;358997;69;753886
76;2021-01-28;98;95;193;308664;263806;79;572470
76;2021-01-28;88;51;139;195838;129272;89;325110
76;2021-01-28;104;23;127;69372;26728;90;96100
76;2021-01-28;1235;1022;2264;3065778;2859080;0;5924858
84;2021-01-28;56;52;109;459549;481088;09;940637
84;2021-01-28;176;207;385;487711;511905;19;999616
84;2021-01-28;210;166;377;443824;451094;29;894918
84;2021-01-28;228;197;425;512522;493262;39;1005784
84;2021-01-28;231;210;442;520248;515106;49;1035354
84;2021-01-28;173;178;351;529611;514848;59;1044459
84;2021-01-28;135;132;267;486720;439940;69;926660
84;2021-01-28;108;85;193;372151;315211;79;687362
84;2021-01-28;94;52;146;237198;150524;89;387722
84;2021-01-28;84;16;100;81185;28680;90;109865
84;2021-01-28;1495;1295;2795;4130719;3901658;0;8032377
93;2021-01-28;60;59;119;268834;283093;09;551927
93;2021-01-28;199;181;381;280751;296087;19;576838
93;2021-01-28;228;167;395;254404;255552;29;509956
93;2021-01-28;268;205;473;310704;288398;39;599102
93;2021-01-28;236;189;425;325559;305827;49;631386
93;2021-01-28;244;229;475;353104;325389;59;678493
93;2021-01-28;180;164;344;336327;296459;69;632786
93;2021-01-28;113;116;229;279820;229699;79;509519
93;2021-01-28;121;73;194;171274;113716;89;284990
93;2021-01-28;113;28;141;58896;21758;90;80654
93;2021-01-28;1763;1411;3177;2639673;2415978;0;5055651
94;2021-01-28;2;0;2;16311;17433;09;33744
94;2021-01-28;0;0;0;16679;18132;19;34811
94;2021-01-28;1;2;3;16782;16579;29;33361
94;2021-01-28;3;5;8;23044;20580;39;43624
94;2021-01-28;1;1;2;23065;22140;49;45205
94;2021-01-28;7;2;9;24549;23421;59;47970
94;2021-01-28;3;4;7;23212;21883;69;45095
94;2021-01-28;4;4;8;19544;17141;79;36685
94;2021-01-28;1;1;2;11227;8178;89;19405
94;2021-01-28;4;2;6;3332;1447;90;4779
94;2021-01-28;26;21;47;177745;166934;0;344679
01;2021-01-29;0;0;0;19979;20155;09;40134
01;2021-01-29;0;1;1;24994;25489;19;50483
01;2021-01-29;0;2;2;17868;16690;29;34558
01;2021-01-29;4;4;8;22328;14821;39;37149
01;2021-01-29;1;1;2;28652;20276;49;48928
01;2021-01-29;2;0;2;33264;27260;59;60524
01;2021-01-29;1;1;2;27135;23978;69;51113
01;2021-01-29;1;1;2;18401;14661;79;33062
01;2021-01-29;0;0;0;9633;6375;89;16008
01;2021-01-29;0;0;0;3410;1510;90;4920
01;2021-01-29;9;12;21;205664;171215;0;376879
02;2021-01-29;0;0;0;16881;17110;09;33991
02;2021-01-29;2;1;3;21410;21604;19;43014
02;2021-01-29;0;1;1;16017;15479;29;31496
02;2021-01-29;3;0;3;19825;14455;39;34280
02;2021-01-29;1;1;2;24719;18248;49;42967
02;2021-01-29;2;3;5;34361;28310;59;62671
02;2021-01-29;3;1;4;28061;24495;69;52556
02;2021-01-29;0;1;1;18231;15278;79;33509
02;2021-01-29;0;0;0;11090;7677;89;18767
02;2021-01-29;0;0;0;3992;1506;90;5498
02;2021-01-29;11;8;19;194587;164162;0;358749
03;2021-01-29;0;1;1;31123;30920;09;62043
03;2021-01-29;5;3;8;29370;29268;19;58638
03;2021-01-29;4;3;7;21458;18963;29;40421
03;2021-01-29;2;4;6;21276;18326;39;39602
03;2021-01-29;3;7;10;18164;16593;49;34757
03;2021-01-29;3;3;6;13469;13557;59;27026
03;2021-01-29;7;6;13;8776;8670;69;17446
03;2021-01-29;3;3;6;3777;3591;79;7368
03;2021-01-29;0;0;0;1649;1072;89;2721
03;2021-01-29;0;0;0;485;184;90;669
03;2021-01-29;27;30;57;149547;141144;0;290691
04;2021-01-29;2;0;2;60314;61377;09;121691
04;2021-01-29;11;4;15;66065;68387;19;134452
04;2021-01-29;8;5;13;51059;47156;29;98215
04;2021-01-29;4;4;8;58788;45780;39;104568
04;2021-01-29;8;2;10;61408;52207;49;113615
04;2021-01-29;4;10;14;64838;60759;59;125597
04;2021-01-29;7;2;9;47008;42843;69;89851
04;2021-01-29;2;0;2;25509;21184;79;46693
04;2021-01-29;0;0;0;13168;7647;89;20815
04;2021-01-29;0;0;0;3209;1253;90;4462
04;2021-01-29;46;27;73;451366;408593;0;859959
05;2021-01-29;0;0;0;362.366008612902;341.338819562748;09;703.704828175651
05;2021-01-29;0;0;0;353.376145114279;370.349735405642;19;723.725880519921
05;2021-01-29;0;0;0;218.593559489256;256.539602589476;29;475.133162078732
05;2021-01-29;0;0;0;404.225408693299;360.321910454353;39;764.547319147651
05;2021-01-29;0;0;0;520.067953604221;497.108383964256;49;1017.17633756848
05;2021-01-29;0;0;0;468.146063921917;510.087601910415;59;978.233665832332
05;2021-01-29;0;0;0;340.368470050554;334.366842191253;69;674.735312241807
05;2021-01-29;0;0;0;212.598666888387;192.597753227106;79;405.196420115493
05;2021-01-29;0;0;0;148.727797095705;61.8681715431829;89;210.595968638888
05;2021-01-29;0;0;0;32.9601271090696;10.9909785719784;90;43.9511056810479
05;2021-01-29;0;0;0;3061.43020057959;2935.56979942041;0;5997
06;2021-01-29;0;3;3;42583;42380;09;84963
06;2021-01-29;38;14;53;33369;31925;19;65294
06;2021-01-29;30;19;49;21571;15080;29;36651
06;2021-01-29;27;15;42;21550;16147;39;37697
06;2021-01-29;18;21;39;14193;13939;49;28132
06;2021-01-29;10;21;31;7171;7597;59;14768
06;2021-01-29;21;23;45;3629;4117;69;7746
06;2021-01-29;3;2;5;1577;1457;79;3034
06;2021-01-29;1;1;2;531;474;89;1005
06;2021-01-29;1;0;1;88;93;90;181
06;2021-01-29;149;119;270;146262;133209;0;279471
07;2021-01-29;0;0;0;485;549;09;1034
07;2021-01-29;1;0;1;403;432;19;835
07;2021-01-29;2;0;2;764;841;29;1605
07;2021-01-29;1;1;2;824;928;39;1752
07;2021-01-29;0;0;0;788;1020;49;1808
07;2021-01-29;0;1;1;678;870;59;1548
07;2021-01-29;0;0;0;360;382;69;742
07;2021-01-29;0;0;0;231;190;79;421
07;2021-01-29;0;0;0;114;67;89;181
07;2021-01-29;0;0;0;24;11;90;35
07;2021-01-29;4;2;6;4671;5290;0;9961
08;2021-01-29;0;0;0;2715.22592983026;2997.75551488675;09;5712.98144471701
08;2021-01-29;0;1;1;2778.51901080978;3160.9156459093;19;5939.43465671908
08;2021-01-29;1;1;2;2080.8882988764;1718.16634315323;29;3799.05464202964
08;2021-01-29;2;4;6;2701.8582062647;1896.52641413317;39;4598.38462039786
08;2021-01-29;2;3;5;3151.45861023308;2460.52498233809;49;5611.98359257117
08;2021-01-29;2;2;4;2620.29868333099;2422.23566154656;59;5042.53434487755
08;2021-01-29;1;2;3;1621.44173420671;1438.58325779464;69;3060.02499200135
08;2021-01-29;0;0;0;626.575909335673;526.358467843651;79;1152.93437717932
08;2021-01-29;0;0;0;205.018522985054;140.993639349697;89;346.012162334751
08;2021-01-29;0;0;0;50.0325684687745;20.62259870351;90;70.6551671722846
08;2021-01-29;8;13;21;18551.3174743414;16782.6825256586;0;35334
11;2021-01-29;112;143;275;783071;811785;09;1594856
11;2021-01-29;335;322;689;761456;784653;19;1546109
11;2021-01-29;453;331;785;850145;801772;29;1651917
11;2021-01-29;475;366;845;914360;843488;39;1757848
11;2021-01-29;406;350;759;845609;826202;49;1671811
11;2021-01-29;352;308;661;793566;745070;59;1538636
11;2021-01-29;219;200;426;628649;549192;69;1177841
11;2021-01-29;119;123;242;434606;358356;79;792962
11;2021-01-29;101;65;166;261425;162933;89;424358
11;2021-01-29;69;25;94;89253;32619;90;121872
11;2021-01-29;2642;2233;4944;6362140;5916070;0;12278210
24;2021-01-29;12;19;32;139720;144686;09;284406
24;2021-01-29;69;70;140;152979;161185;19;314164
24;2021-01-29;55;42;97;122237;126536;29;248773
24;2021-01-29;78;39;117;150359;142009;39;292368
24;2021-01-29;86;64;150;161829;158758;49;320587
24;2021-01-29;54;42;96;172552;168011;59;340563
24;2021-01-29;33;38;71;172509;158177;69;330686
24;2021-01-29;24;38;62;129428;110593;79;240021
24;2021-01-29;43;18;61;87342;56882;89;144224
24;2021-01-29;43;14;57;31210;12071;90;43281
24;2021-01-29;497;384;883;1320165;1238908;0;2559073
27;2021-01-29;31;18;49;143373;149679;09;293052
27;2021-01-29;85;95;181;160962;173003;19;333965
27;2021-01-29;79;53;132;133746;142254;29;276000
27;2021-01-29;79;59;138;160004;155407;39;315411
27;2021-01-29;97;63;160;172333;169564;49;341897
27;2021-01-29;75;64;139;189979;183788;59;373767
27;2021-01-29;60;52;112;192591;178206;69;370797
27;2021-01-29;45;39;84;146876;127546;79;274422
27;2021-01-29;35;20;55;96896;61575;89;158471
27;2021-01-29;13;7;20;33148;12109;90;45257
27;2021-01-29;599;470;1070;1429908;1353131;0;2783039
28;2021-01-29;22;23;45;180735;186856;09;367591
28;2021-01-29;65;58;124;200125;213621;19;413746
28;2021-01-29;69;57;126;168922;173007;29;341929
28;2021-01-29;77;61;138;196628;188487;39;385115
28;2021-01-29;68;65;133;205396;201699;49;407095
28;2021-01-29;60;68;128;222002;213866;59;435868
28;2021-01-29;58;59;117;224688;203758;69;428446
28;2021-01-29;33;35;68;163192;135543;79;298735
28;2021-01-29;43;26;69;109691;65377;89;175068
28;2021-01-29;30;4;34;37222;12685;90;49907
28;2021-01-29;525;456;982;1708601;1594899;0;3303500
32;2021-01-29;50;59;109;358062;373689;09;731751
32;2021-01-29;181;201;382;387045;406742;19;793787
32;2021-01-29;154;153;307;342304;348587;29;690891
32;2021-01-29;190;147;337;382485;369972;39;752457
32;2021-01-29;185;160;345;382510;376716;49;759226
32;2021-01-29;158;157;315;386937;376527;59;763464
32;2021-01-29;101;103;204;371211;330938;69;702149
32;2021-01-29;74;76;150;250542;201459;79;452001
32;2021-01-29;83;44;127;163399;89786;89;253185
32;2021-01-29;48;9;57;48384;15367;90;63751
32;2021-01-29;1225;1111;2336;3072879;2889783;0;5962662
44;2021-01-29;27;52;80;291525;306839;09;598364
44;2021-01-29;148;156;306;320255;339504;19;659759
44;2021-01-29;144;118;263;302020;314428;29;616448
44;2021-01-29;175;135;310;342222;333292;39;675514
44;2021-01-29;149;125;274;349727;344491;49;694218
44;2021-01-29;138;132;272;381371;373239;59;754610
44;2021-01-29;92;100;194;367165;335850;69;703015
44;2021-01-29;61;63;125;250387;215436;79;465823
44;2021-01-29;74;49;124;170825;105192;89;276017
44;2021-01-29;37;15;52;51248;16731;90;67979
44;2021-01-29;1045;945;2000;2826745;2685002;0;5511747
52;2021-01-29;18;23;45;213594;223900;09;437494
52;2021-01-29;79;79;159;240818;255197;19;496015
52;2021-01-29;75;91;166;197010;200630;29;397640
52;2021-01-29;82;72;156;231204;224885;39;456089
52;2021-01-29;105;65;170;243874;243418;49;487292
52;2021-01-29;71;53;124;244100;239116;59;483216
52;2021-01-29;50;45;95;241796;221345;69;463141
52;2021-01-29;40;32;72;177805;149903;79;327708
52;2021-01-29;52;39;91;119561;75822;89;195383
52;2021-01-29;31;12;43;42559;15260;90;57819
52;2021-01-29;603;511;1121;1952321;1849476;0;3801797
53;2021-01-29;13;16;30;173813;182358;09;356171
53;2021-01-29;35;35;72;202720;214740;19;417460
53;2021-01-29;49;41;97;163116;173196;29;336312
53;2021-01-29;54;42;96;190526;187674;39;378200
53;2021-01-29;49;33;82;212098;212015;49;424113
53;2021-01-29;51;44;95;223699;219176;59;442875
53;2021-01-29;33;23;56;227435;209274;69;436709
53;2021-01-29;30;29;59;169992;140910;79;310902
53;2021-01-29;20;16;36;118117;69883;89;188000
53;2021-01-29;7;6;14;37370;12267;90;49637
53;2021-01-29;341;285;637;1718886;1621493;0;3340379
75;2021-01-29;51;47;98;293104;305291;09;598395
75;2021-01-29;102;121;228;337141;357785;19;694926
75;2021-01-29;134;105;239;295024;300618;29;595642
75;2021-01-29;148;91;239;347871;331233;39;679104
75;2021-01-29;140;119;259;384742;372771;49;757513
75;2021-01-29;129;109;238;413361;390880;59;804241
75;2021-01-29;105;99;204;425623;384060;69;809683
75;2021-01-29;70;74;144;325086;276298;79;601384
75;2021-01-29;74;57;131;213986;139308;89;353294
75;2021-01-29;68;26;94;77600;28200;90;105800
75;2021-01-29;1021;848;1874;3113538;2886444;0;5999982
76;2021-01-29;37;48;86;305956;318589;09;624545
76;2021-01-29;137;185;325;338942;356969;19;695911
76;2021-01-29;153;139;292;316210;319570;29;635780
76;2021-01-29;159;126;285;356758;337587;39;694345
76;2021-01-29;166;143;309;376541;363812;49;740353
76;2021-01-29;190;144;334;402608;383750;59;786358
76;2021-01-29;109;96;205;394889;358997;69;753886
76;2021-01-29;76;63;139;308664;263806;79;572470
76;2021-01-29;73;46;119;195838;129272;89;325110
76;2021-01-29;48;19;67;69372;26728;90;96100
76;2021-01-29;1149;1010;2163;3065778;2859080;0;5924858
84;2021-01-29;62;89;153;459549;481088;09;940637
84;2021-01-29;240;226;466;487711;511905;19;999616
84;2021-01-29;223;206;429;443824;451094;29;894918
84;2021-01-29;254;195;450;512522;493262;39;1005784
84;2021-01-29;230;187;417;520248;515106;49;1035354
84;2021-01-29;212;181;395;529611;514848;59;1044459
84;2021-01-29;156;145;301;486720;439940;69;926660
84;2021-01-29;98;100;198;372151;315211;79;687362
84;2021-01-29;104;60;164;237198;150524;89;387722
84;2021-01-29;59;20;79;81185;28680;90;109865
84;2021-01-29;1638;1409;3052;4130719;3901658;0;8032377
93;2021-01-29;66;64;131;268834;283093;09;551927
93;2021-01-29;185;179;364;280751;296087;19;576838
93;2021-01-29;248;188;436;254404;255552;29;509956
93;2021-01-29;296;198;494;310704;288398;39;599102
93;2021-01-29;248;228;476;325559;305827;49;631386
93;2021-01-29;231;245;476;353104;325389;59;678493
93;2021-01-29;163;184;347;336327;296459;69;632786
93;2021-01-29;134;123;258;279820;229699;79;509519
93;2021-01-29;96;74;170;171274;113716;89;284990
93;2021-01-29;68;23;91;58896;21758;90;80654
93;2021-01-29;1736;1506;3244;2639673;2415978;0;5055651
94;2021-01-29;0;1;1;16311;17433;09;33744
94;2021-01-29;0;3;3;16679;18132;19;34811
94;2021-01-29;4;3;7;16782;16579;29;33361
94;2021-01-29;2;4;6;23044;20580;39;43624
94;2021-01-29;2;5;7;23065;22140;49;45205
94;2021-01-29;7;5;12;24549;23421;59;47970
94;2021-01-29;0;2;2;23212;21883;69;45095
94;2021-01-29;2;6;8;19544;17141;79;36685
94;2021-01-29;2;4;6;11227;8178;89;19405
94;2021-01-29;2;1;3;3332;1447;90;4779
94;2021-01-29;21;34;55;177745;166934;0;344679
01;2021-01-30;1;0;1;19979;20155;09;40134
01;2021-01-30;0;0;0;24994;25489;19;50483
01;2021-01-30;0;3;3;17868;16690;29;34558
01;2021-01-30;0;1;1;22328;14821;39;37149
01;2021-01-30;1;1;2;28652;20276;49;48928
01;2021-01-30;1;2;3;33264;27260;59;60524
01;2021-01-30;1;0;1;27135;23978;69;51113
01;2021-01-30;2;1;3;18401;14661;79;33062
01;2021-01-30;0;0;0;9633;6375;89;16008
01;2021-01-30;0;0;0;3410;1510;90;4920
01;2021-01-30;6;8;14;205664;171215;0;376879
02;2021-01-30;0;0;0;16881;17110;09;33991
02;2021-01-30;1;0;1;21410;21604;19;43014
02;2021-01-30;0;0;0;16017;15479;29;31496
02;2021-01-30;2;0;2;19825;14455;39;34280
02;2021-01-30;0;0;0;24719;18248;49;42967
02;2021-01-30;0;0;0;34361;28310;59;62671
02;2021-01-30;1;0;1;28061;24495;69;52556
02;2021-01-30;0;0;0;18231;15278;79;33509
02;2021-01-30;0;0;0;11090;7677;89;18767
02;2021-01-30;0;0;0;3992;1506;90;5498
02;2021-01-30;4;0;4;194587;164162;0;358749
03;2021-01-30;1;0;1;31123;30920;09;62043
03;2021-01-30;1;1;2;29370;29268;19;58638
03;2021-01-30;4;4;8;21458;18963;29;40421
03;2021-01-30;3;0;3;21276;18326;39;39602
03;2021-01-30;5;5;10;18164;16593;49;34757
03;2021-01-30;2;1;3;13469;13557;59;27026
03;2021-01-30;1;0;1;8776;8670;69;17446
03;2021-01-30;0;1;1;3777;3591;79;7368
03;2021-01-30;0;0;0;1649;1072;89;2721
03;2021-01-30;0;0;0;485;184;90;669
03;2021-01-30;17;12;29;149547;141144;0;290691
04;2021-01-30;1;3;4;60314;61377;09;121691
04;2021-01-30;3;8;11;66065;68387;19;134452
04;2021-01-30;6;2;8;51059;47156;29;98215
04;2021-01-30;4;3;7;58788;45780;39;104568
04;2021-01-30;9;5;14;61408;52207;49;113615
04;2021-01-30;4;6;10;64838;60759;59;125597
04;2021-01-30;1;0;1;47008;42843;69;89851
04;2021-01-30;1;0;1;25509;21184;79;46693
04;2021-01-30;0;0;0;13168;7647;89;20815
04;2021-01-30;0;0;0;3209;1253;90;4462
04;2021-01-30;29;27;56;451366;408593;0;859959
05;2021-01-30;0;0;0;362.366008612902;341.338819562748;09;703.704828175651
05;2021-01-30;0;0;0;353.376145114279;370.349735405642;19;723.725880519921
05;2021-01-30;0;0;0;218.593559489256;256.539602589476;29;475.133162078732
05;2021-01-30;0;0;0;404.225408693299;360.321910454353;39;764.547319147651
05;2021-01-30;0;0;0;520.067953604221;497.108383964256;49;1017.17633756848
05;2021-01-30;0;0;0;468.146063921917;510.087601910415;59;978.233665832332
05;2021-01-30;0;0;0;340.368470050554;334.366842191253;69;674.735312241807
05;2021-01-30;0;0;0;212.598666888387;192.597753227106;79;405.196420115493
05;2021-01-30;0;0;0;148.727797095705;61.8681715431829;89;210.595968638888
05;2021-01-30;0;0;0;32.9601271090696;10.9909785719784;90;43.9511056810479
05;2021-01-30;0;0;0;3061.43020057959;2935.56979942041;0;5997
06;2021-01-30;2;2;4;42583;42380;09;84963
06;2021-01-30;16;8;24;33369;31925;19;65294
06;2021-01-30;15;8;23;21571;15080;29;36651
06;2021-01-30;14;11;25;21550;16147;39;37697
06;2021-01-30;13;14;27;14193;13939;49;28132
06;2021-01-30;11;8;19;7171;7597;59;14768
06;2021-01-30;0;10;10;3629;4117;69;7746
06;2021-01-30;0;2;2;1577;1457;79;3034
06;2021-01-30;0;0;0;531;474;89;1005
06;2021-01-30;0;0;0;88;93;90;181
06;2021-01-30;71;63;134;146262;133209;0;279471
07;2021-01-30;0;0;0;485;549;09;1034
07;2021-01-30;0;0;0;403;432;19;835
07;2021-01-30;1;2;3;764;841;29;1605
07;2021-01-30;0;1;1;824;928;39;1752
07;2021-01-30;0;0;0;788;1020;49;1808
07;2021-01-30;1;2;3;678;870;59;1548
07;2021-01-30;0;1;1;360;382;69;742
07;2021-01-30;0;0;0;231;190;79;421
07;2021-01-30;0;0;0;114;67;89;181
07;2021-01-30;0;0;0;24;11;90;35
07;2021-01-30;2;6;8;4671;5290;0;9961
08;2021-01-30;0;0;0;2715.22592983026;2997.75551488675;09;5712.98144471701
08;2021-01-30;0;0;0;2778.51901080978;3160.9156459093;19;5939.43465671908
08;2021-01-30;0;5;5;2080.8882988764;1718.16634315323;29;3799.05464202964
08;2021-01-30;0;1;1;2701.8582062647;1896.52641413317;39;4598.38462039786
08;2021-01-30;1;0;1;3151.45861023308;2460.52498233809;49;5611.98359257117
08;2021-01-30;1;3;4;2620.29868333099;2422.23566154656;59;5042.53434487755
08;2021-01-30;0;0;0;1621.44173420671;1438.58325779464;69;3060.02499200135
08;2021-01-30;0;0;0;626.575909335673;526.358467843651;79;1152.93437717932
08;2021-01-30;0;0;0;205.018522985054;140.993639349697;89;346.012162334751
08;2021-01-30;0;0;0;50.0325684687745;20.62259870351;90;70.6551671722846
08;2021-01-30;2;9;11;18551.3174743414;16782.6825256586;0;35334
11;2021-01-30;66;67;144;783071;811785;09;1594856
11;2021-01-30;206;198;423;761456;784653;19;1546109
11;2021-01-30;247;201;449;850145;801772;29;1651917
11;2021-01-30;284;230;514;914360;843488;39;1757848
11;2021-01-30;254;258;512;845609;826202;49;1671811
11;2021-01-30;185;198;384;793566;745070;59;1538636
11;2021-01-30;131;110;245;628649;549192;69;1177841
11;2021-01-30;65;84;149;434606;358356;79;792962
11;2021-01-30;74;42;116;261425;162933;89;424358
11;2021-01-30;24;25;49;89253;32619;90;121872
11;2021-01-30;1536;1414;2986;6362140;5916070;0;12278210
24;2021-01-30;7;10;18;139720;144686;09;284406
24;2021-01-30;30;31;61;152979;161185;19;314164
24;2021-01-30;21;22;43;122237;126536;29;248773
24;2021-01-30;31;29;60;150359;142009;39;292368
24;2021-01-30;48;38;86;161829;158758;49;320587
24;2021-01-30;32;27;59;172552;168011;59;340563
24;2021-01-30;21;18;39;172509;158177;69;330686
24;2021-01-30;19;15;34;129428;110593;79;240021
24;2021-01-30;17;16;33;87342;56882;89;144224
24;2021-01-30;12;6;18;31210;12071;90;43281
24;2021-01-30;238;212;451;1320165;1238908;0;2559073
27;2021-01-30;11;18;29;143373;149679;09;293052
27;2021-01-30;35;34;69;160962;173003;19;333965
27;2021-01-30;30;39;69;133746;142254;29;276000
27;2021-01-30;55;43;98;160004;155407;39;315411
27;2021-01-30;56;36;92;172333;169564;49;341897
27;2021-01-30;51;49;100;189979;183788;59;373767
27;2021-01-30;38;43;81;192591;178206;69;370797
27;2021-01-30;19;22;41;146876;127546;79;274422
27;2021-01-30;22;20;42;96896;61575;89;158471
27;2021-01-30;17;4;21;33148;12109;90;45257
27;2021-01-30;334;308;642;1429908;1353131;0;2783039
28;2021-01-30;16;19;38;180735;186856;09;367591
28;2021-01-30;32;37;70;200125;213621;19;413746
28;2021-01-30;42;39;81;168922;173007;29;341929
28;2021-01-30;55;40;95;196628;188487;39;385115
28;2021-01-30;51;48;100;205396;201699;49;407095
28;2021-01-30;35;29;64;222002;213866;59;435868
28;2021-01-30;29;33;62;224688;203758;69;428446
28;2021-01-30;27;24;51;163192;135543;79;298735
28;2021-01-30;23;14;37;109691;65377;89;175068
28;2021-01-30;15;2;17;37222;12685;90;49907
28;2021-01-30;325;285;615;1708601;1594899;0;3303500
32;2021-01-30;38;36;74;358062;373689;09;731751
32;2021-01-30;96;104;201;387045;406742;19;793787
32;2021-01-30;113;85;198;342304;348587;29;690891
32;2021-01-30;113;106;219;382485;369972;39;752457
32;2021-01-30;114;79;193;382510;376716;49;759226
32;2021-01-30;95;99;194;386937;376527;59;763464
32;2021-01-30;66;46;112;371211;330938;69;702149
32;2021-01-30;48;44;92;250542;201459;79;452001
32;2021-01-30;27;27;54;163399;89786;89;253185
32;2021-01-30;17;3;20;48384;15367;90;63751
32;2021-01-30;727;630;1358;3072879;2889783;0;5962662
44;2021-01-30;33;20;53;291525;306839;09;598364
44;2021-01-30;87;75;162;320255;339504;19;659759
44;2021-01-30;87;63;150;302020;314428;29;616448
44;2021-01-30;110;93;203;342222;333292;39;675514
44;2021-01-30;86;78;164;349727;344491;49;694218
44;2021-01-30;85;78;163;381371;373239;59;754610
44;2021-01-30;62;55;117;367165;335850;69;703015
44;2021-01-30;34;19;53;250387;215436;79;465823
44;2021-01-30;35;23;58;170825;105192;89;276017
44;2021-01-30;12;3;15;51248;16731;90;67979
44;2021-01-30;631;507;1138;2826745;2685002;0;5511747
52;2021-01-30;13;12;25;213594;223900;09;437494
52;2021-01-30;31;55;86;240818;255197;19;496015
52;2021-01-30;56;48;104;197010;200630;29;397640
52;2021-01-30;49;38;87;231204;224885;39;456089
52;2021-01-30;60;54;115;243874;243418;49;487292
52;2021-01-30;31;57;88;244100;239116;59;483216
52;2021-01-30;29;22;51;241796;221345;69;463141
52;2021-01-30;21;17;38;177805;149903;79;327708
52;2021-01-30;16;17;33;119561;75822;89;195383
52;2021-01-30;17;5;22;42559;15260;90;57819
52;2021-01-30;323;325;649;1952321;1849476;0;3801797
53;2021-01-30;10;11;21;173813;182358;09;356171
53;2021-01-30;23;23;46;202720;214740;19;417460
53;2021-01-30;23;27;51;163116;173196;29;336312
53;2021-01-30;29;27;56;190526;187674;39;378200
53;2021-01-30;36;20;56;212098;212015;49;424113
53;2021-01-30;26;23;49;223699;219176;59;442875
53;2021-01-30;10;12;22;227435;209274;69;436709
53;2021-01-30;14;7;21;169992;140910;79;310902
53;2021-01-30;14;6;20;118117;69883;89;188000
53;2021-01-30;13;7;20;37370;12267;90;49637
53;2021-01-30;198;163;362;1718886;1621493;0;3340379
75;2021-01-30;18;17;35;293104;305291;09;598395
75;2021-01-30;63;47;110;337141;357785;19;694926
75;2021-01-30;64;69;133;295024;300618;29;595642
75;2021-01-30;87;47;134;347871;331233;39;679104
75;2021-01-30;81;79;160;384742;372771;49;757513
75;2021-01-30;80;66;146;413361;390880;59;804241
75;2021-01-30;38;46;84;425623;384060;69;809683
75;2021-01-30;29;36;65;325086;276298;79;601384
75;2021-01-30;43;31;74;213986;139308;89;353294
75;2021-01-30;51;9;60;77600;28200;90;105800
75;2021-01-30;554;447;1001;3113538;2886444;0;5999982
76;2021-01-30;23;18;41;305956;318589;09;624545
76;2021-01-30;82;78;162;338942;356969;19;695911
76;2021-01-30;86;56;142;316210;319570;29;635780
76;2021-01-30;78;65;143;356758;337587;39;694345
76;2021-01-30;91;69;160;376541;363812;49;740353
76;2021-01-30;85;76;161;402608;383750;59;786358
76;2021-01-30;74;56;130;394889;358997;69;753886
76;2021-01-30;45;38;83;308664;263806;79;572470
76;2021-01-30;36;30;66;195838;129272;89;325110
76;2021-01-30;21;11;32;69372;26728;90;96100
76;2021-01-30;622;497;1121;3065778;2859080;0;5924858
84;2021-01-30;40;29;70;459549;481088;09;940637
84;2021-01-30;100;109;210;487711;511905;19;999616
84;2021-01-30;123;112;235;443824;451094;29;894918
84;2021-01-30;109;99;208;512522;493262;39;1005784
84;2021-01-30;139;120;259;520248;515106;49;1035354
84;2021-01-30;105;110;215;529611;514848;59;1044459
84;2021-01-30;87;66;153;486720;439940;69;926660
84;2021-01-30;58;52;110;372151;315211;79;687362
84;2021-01-30;37;31;68;237198;150524;89;387722
84;2021-01-30;21;8;29;81185;28680;90;109865
84;2021-01-30;819;736;1557;4130719;3901658;0;8032377
93;2021-01-30;26;20;46;268834;283093;09;551927
93;2021-01-30;91;100;192;280751;296087;19;576838
93;2021-01-30;128;107;237;254404;255552;29;509956
93;2021-01-30;134;115;250;310704;288398;39;599102
93;2021-01-30;128;111;240;325559;305827;49;631386
93;2021-01-30;106;107;214;353104;325389;59;678493
93;2021-01-30;75;83;161;336327;296459;69;632786
93;2021-01-30;74;48;123;279820;229699;79;509519
93;2021-01-30;61;33;94;171274;113716;89;284990
93;2021-01-30;32;14;46;58896;21758;90;80654
93;2021-01-30;855;738;1603;2639673;2415978;0;5055651
94;2021-01-30;0;0;1;16311;17433;09;33744
94;2021-01-30;0;1;1;16679;18132;19;34811
94;2021-01-30;1;3;4;16782;16579;29;33361
94;2021-01-30;2;4;6;23044;20580;39;43624
94;2021-01-30;1;2;3;23065;22140;49;45205
94;2021-01-30;2;2;4;24549;23421;59;47970
94;2021-01-30;4;3;7;23212;21883;69;45095
94;2021-01-30;1;0;1;19544;17141;79;36685
94;2021-01-30;2;0;2;11227;8178;89;19405
94;2021-01-30;1;0;1;3332;1447;90;4779
94;2021-01-30;14;15;30;177745;166934;0;344679
01;2021-01-31;0;0;0;19979;20155;09;40134
01;2021-01-31;0;1;1;24994;25489;19;50483
01;2021-01-31;2;0;2;17868;16690;29;34558
01;2021-01-31;0;1;1;22328;14821;39;37149
01;2021-01-31;0;0;0;28652;20276;49;48928
01;2021-01-31;0;1;1;33264;27260;59;60524
01;2021-01-31;0;1;1;27135;23978;69;51113
01;2021-01-31;0;0;0;18401;14661;79;33062
01;2021-01-31;0;0;0;9633;6375;89;16008
01;2021-01-31;0;0;0;3410;1510;90;4920
01;2021-01-31;2;4;6;205664;171215;0;376879
02;2021-01-31;1;0;1;16881;17110;09;33991
02;2021-01-31;0;0;0;21410;21604;19;43014
02;2021-01-31;0;0;0;16017;15479;29;31496
02;2021-01-31;0;0;0;19825;14455;39;34280
02;2021-01-31;0;0;0;24719;18248;49;42967
02;2021-01-31;0;0;0;34361;28310;59;62671
02;2021-01-31;0;0;0;28061;24495;69;52556
02;2021-01-31;0;0;0;18231;15278;79;33509
02;2021-01-31;0;0;0;11090;7677;89;18767
02;2021-01-31;0;0;0;3992;1506;90;5498
02;2021-01-31;1;0;1;194587;164162;0;358749
03;2021-01-31;0;0;0;31123;30920;09;62043
03;2021-01-31;2;0;3;29370;29268;19;58638
03;2021-01-31;1;2;5;21458;18963;29;40421
03;2021-01-31;1;0;1;21276;18326;39;39602
03;2021-01-31;0;0;0;18164;16593;49;34757
03;2021-01-31;0;0;0;13469;13557;59;27026
03;2021-01-31;1;1;2;8776;8670;69;17446
03;2021-01-31;0;0;0;3777;3591;79;7368
03;2021-01-31;0;0;0;1649;1072;89;2721
03;2021-01-31;0;0;0;485;184;90;669
03;2021-01-31;5;3;11;149547;141144;0;290691
04;2021-01-31;1;0;1;60314;61377;09;121691
04;2021-01-31;1;1;2;66065;68387;19;134452
04;2021-01-31;2;1;3;51059;47156;29;98215
04;2021-01-31;1;2;3;58788;45780;39;104568
04;2021-01-31;2;2;4;61408;52207;49;113615
04;2021-01-31;1;1;2;64838;60759;59;125597
04;2021-01-31;1;0;1;47008;42843;69;89851
04;2021-01-31;0;0;0;25509;21184;79;46693
04;2021-01-31;0;0;0;13168;7647;89;20815
04;2021-01-31;0;0;0;3209;1253;90;4462
04;2021-01-31;9;7;16;451366;408593;0;859959
05;2021-01-31;0;0;0;362.366008612902;341.338819562748;09;703.704828175651
05;2021-01-31;0;0;0;353.376145114279;370.349735405642;19;723.725880519921
05;2021-01-31;0;0;0;218.593559489256;256.539602589476;29;475.133162078732
05;2021-01-31;0;0;0;404.225408693299;360.321910454353;39;764.547319147651
05;2021-01-31;0;0;0;520.067953604221;497.108383964256;49;1017.17633756848
05;2021-01-31;0;0;0;468.146063921917;510.087601910415;59;978.233665832332
05;2021-01-31;0;0;0;340.368470050554;334.366842191253;69;674.735312241807
05;2021-01-31;0;0;0;212.598666888387;192.597753227106;79;405.196420115493
05;2021-01-31;0;0;0;148.727797095705;61.8681715431829;89;210.595968638888
05;2021-01-31;0;0;0;32.9601271090696;10.9909785719784;90;43.9511056810479
05;2021-01-31;0;0;0;3061.43020057959;2935.56979942041;0;5997
06;2021-01-31;1;1;2;42583;42380;09;84963
06;2021-01-31;1;3;4;33369;31925;19;65294
06;2021-01-31;9;4;13;21571;15080;29;36651
06;2021-01-31;4;2;6;21550;16147;39;37697
06;2021-01-31;3;2;5;14193;13939;49;28132
06;2021-01-31;2;2;4;7171;7597;59;14768
06;2021-01-31;11;7;18;3629;4117;69;7746
06;2021-01-31;2;4;6;1577;1457;79;3034
06;2021-01-31;0;0;0;531;474;89;1005
06;2021-01-31;1;0;1;88;93;90;181
06;2021-01-31;34;25;60;146262;133209;0;279471
07;2021-01-31;0;0;0;485;549;09;1034
07;2021-01-31;0;0;0;403;432;19;835
07;2021-01-31;0;0;0;764;841;29;1605
07;2021-01-31;0;0;0;824;928;39;1752
07;2021-01-31;0;0;0;788;1020;49;1808
07;2021-01-31;0;0;0;678;870;59;1548
07;2021-01-31;0;0;0;360;382;69;742
07;2021-01-31;0;0;0;231;190;79;421
07;2021-01-31;0;0;0;114;67;89;181
07;2021-01-31;0;0;0;24;11;90;35
07;2021-01-31;0;0;0;4671;5290;0;9961
08;2021-01-31;0;0;0;2715.22592983026;2997.75551488675;09;5712.98144471701
08;2021-01-31;0;0;0;2778.51901080978;3160.9156459093;19;5939.43465671908
08;2021-01-31;0;0;0;2080.8882988764;1718.16634315323;29;3799.05464202964
08;2021-01-31;0;0;0;2701.8582062647;1896.52641413317;39;4598.38462039786
08;2021-01-31;0;1;1;3151.45861023308;2460.52498233809;49;5611.98359257117
08;2021-01-31;0;0;0;2620.29868333099;2422.23566154656;59;5042.53434487755
08;2021-01-31;0;0;0;1621.44173420671;1438.58325779464;69;3060.02499200135
08;2021-01-31;0;0;0;626.575909335673;526.358467843651;79;1152.93437717932
08;2021-01-31;0;0;0;205.018522985054;140.993639349697;89;346.012162334751
08;2021-01-31;0;0;0;50.0325684687745;20.62259870351;90;70.6551671722846
08;2021-01-31;0;1;1;18551.3174743414;16782.6825256586;0;35334
11;2021-01-31;17;14;31;783071;811785;09;1594856
11;2021-01-31;48;46;95;761456;784653;19;1546109
11;2021-01-31;68;54;122;850145;801772;29;1651917
11;2021-01-31;74;67;141;914360;843488;39;1757848
11;2021-01-31;52;63;115;845609;826202;49;1671811
11;2021-01-31;48;50;98;793566;745070;59;1538636
11;2021-01-31;31;27;58;628649;549192;69;1177841
11;2021-01-31;28;26;54;434606;358356;79;792962
11;2021-01-31;29;19;48;261425;162933;89;424358
11;2021-01-31;24;9;33;89253;32619;90;121872
11;2021-01-31;419;376;796;6362140;5916070;0;12278210
24;2021-01-31;2;0;2;139720;144686;09;284406
24;2021-01-31;11;5;16;152979;161185;19;314164
24;2021-01-31;7;4;11;122237;126536;29;248773
24;2021-01-31;10;3;13;150359;142009;39;292368
24;2021-01-31;12;4;16;161829;158758;49;320587
24;2021-01-31;2;8;10;172552;168011;59;340563
24;2021-01-31;2;7;9;172509;158177;69;330686
24;2021-01-31;2;3;5;129428;110593;79;240021
24;2021-01-31;8;10;18;87342;56882;89;144224
24;2021-01-31;4;1;5;31210;12071;90;43281
24;2021-01-31;60;45;105;1320165;1238908;0;2559073
27;2021-01-31;1;3;4;143373;149679;09;293052
27;2021-01-31;3;1;4;160962;173003;19;333965
27;2021-01-31;6;4;10;133746;142254;29;276000
27;2021-01-31;6;5;11;160004;155407;39;315411
27;2021-01-31;9;7;16;172333;169564;49;341897
27;2021-01-31;7;6;13;189979;183788;59;373767
27;2021-01-31;5;5;10;192591;178206;69;370797
27;2021-01-31;3;8;11;146876;127546;79;274422
27;2021-01-31;6;8;14;96896;61575;89;158471
27;2021-01-31;5;3;8;33148;12109;90;45257
27;2021-01-31;51;50;101;1429908;1353131;0;2783039
28;2021-01-31;3;0;3;180735;186856;09;367591
28;2021-01-31;2;7;9;200125;213621;19;413746
28;2021-01-31;12;2;14;168922;173007;29;341929
28;2021-01-31;15;13;28;196628;188487;39;385115
28;2021-01-31;9;8;17;205396;201699;49;407095
28;2021-01-31;11;5;16;222002;213866;59;435868
28;2021-01-31;7;9;16;224688;203758;69;428446
28;2021-01-31;10;13;23;163192;135543;79;298735
28;2021-01-31;14;8;22;109691;65377;89;175068
28;2021-01-31;6;5;11;37222;12685;90;49907
28;2021-01-31;89;70;159;1708601;1594899;0;3303500
32;2021-01-31;4;10;14;358062;373689;09;731751
32;2021-01-31;13;16;29;387045;406742;19;793787
32;2021-01-31;11;25;36;342304;348587;29;690891
32;2021-01-31;19;23;42;382485;369972;39;752457
32;2021-01-31;27;30;57;382510;376716;49;759226
32;2021-01-31;14;19;33;386937;376527;59;763464
32;2021-01-31;11;16;27;371211;330938;69;702149
32;2021-01-31;7;13;20;250542;201459;79;452001
32;2021-01-31;16;15;31;163399;89786;89;253185
32;2021-01-31;12;5;17;48384;15367;90;63751
32;2021-01-31;134;172;306;3072879;2889783;0;5962662
44;2021-01-31;2;5;7;291525;306839;09;598364
44;2021-01-31;4;2;6;320255;339504;19;659759
44;2021-01-31;11;9;21;302020;314428;29;616448
44;2021-01-31;17;13;30;342222;333292;39;675514
44;2021-01-31;14;17;31;349727;344491;49;694218
44;2021-01-31;14;16;30;381371;373239;59;754610
44;2021-01-31;10;5;15;367165;335850;69;703015
44;2021-01-31;5;12;17;250387;215436;79;465823
44;2021-01-31;17;12;30;170825;105192;89;276017
44;2021-01-31;8;5;13;51248;16731;90;67979
44;2021-01-31;102;96;200;2826745;2685002;0;5511747
52;2021-01-31;5;5;11;213594;223900;09;437494
52;2021-01-31;14;10;24;240818;255197;19;496015
52;2021-01-31;18;12;30;197010;200630;29;397640
52;2021-01-31;9;8;17;231204;224885;39;456089
52;2021-01-31;19;7;26;243874;243418;49;487292
52;2021-01-31;12;14;26;244100;239116;59;483216
52;2021-01-31;6;6;12;241796;221345;69;463141
52;2021-01-31;7;5;12;177805;149903;79;327708
52;2021-01-31;11;9;20;119561;75822;89;195383
52;2021-01-31;8;2;10;42559;15260;90;57819
52;2021-01-31;109;78;188;1952321;1849476;0;3801797
53;2021-01-31;0;1;1;173813;182358;09;356171
53;2021-01-31;2;4;6;202720;214740;19;417460
53;2021-01-31;8;7;15;163116;173196;29;336312
53;2021-01-31;4;3;7;190526;187674;39;378200
53;2021-01-31;8;4;12;212098;212015;49;424113
53;2021-01-31;8;4;12;223699;219176;59;442875
53;2021-01-31;3;1;4;227435;209274;69;436709
53;2021-01-31;4;1;5;169992;140910;79;310902
53;2021-01-31;7;5;12;118117;69883;89;188000
53;2021-01-31;3;2;5;37370;12267;90;49637
53;2021-01-31;47;32;79;1718886;1621493;0;3340379
75;2021-01-31;4;4;8;293104;305291;09;598395
75;2021-01-31;11;9;20;337141;357785;19;694926
75;2021-01-31;16;12;28;295024;300618;29;595642
75;2021-01-31;13;11;24;347871;331233;39;679104
75;2021-01-31;10;13;23;384742;372771;49;757513
75;2021-01-31;14;13;27;413361;390880;59;804241
75;2021-01-31;7;11;18;425623;384060;69;809683
75;2021-01-31;6;8;14;325086;276298;79;601384
75;2021-01-31;16;9;25;213986;139308;89;353294
75;2021-01-31;13;8;21;77600;28200;90;105800
75;2021-01-31;110;98;208;3113538;2886444;0;5999982
76;2021-01-31;13;10;23;305956;318589;09;624545
76;2021-01-31;30;22;52;338942;356969;19;695911
76;2021-01-31;40;28;68;316210;319570;29;635780
76;2021-01-31;31;27;59;356758;337587;39;694345
76;2021-01-31;35;24;59;376541;363812;49;740353
76;2021-01-31;20;24;44;402608;383750;59;786358
76;2021-01-31;16;22;38;394889;358997;69;753886
76;2021-01-31;14;7;21;308664;263806;79;572470
76;2021-01-31;24;12;36;195838;129272;89;325110
76;2021-01-31;11;4;15;69372;26728;90;96100
76;2021-01-31;234;180;415;3065778;2859080;0;5924858
84;2021-01-31;8;9;17;459549;481088;09;940637
84;2021-01-31;13;15;28;487711;511905;19;999616
84;2021-01-31;28;17;45;443824;451094;29;894918
84;2021-01-31;23;23;46;512522;493262;39;1005784
84;2021-01-31;25;18;44;520248;515106;49;1035354
84;2021-01-31;17;20;37;529611;514848;59;1044459
84;2021-01-31;12;10;22;486720;439940;69;926660
84;2021-01-31;12;16;28;372151;315211;79;687362
84;2021-01-31;20;20;40;237198;150524;89;387722
84;2021-01-31;9;9;18;81185;28680;90;109865
84;2021-01-31;167;157;325;4130719;3901658;0;8032377
93;2021-01-31;8;9;17;268834;283093;09;551927
93;2021-01-31;17;24;41;280751;296087;19;576838
93;2021-01-31;28;15;43;254404;255552;29;509956
93;2021-01-31;41;33;74;310704;288398;39;599102
93;2021-01-31;42;29;71;325559;305827;49;631386
93;2021-01-31;34;24;58;353104;325389;59;678493
93;2021-01-31;20;20;40;336327;296459;69;632786
93;2021-01-31;14;19;33;279820;229699;79;509519
93;2021-01-31;24;15;39;171274;113716;89;284990
93;2021-01-31;9;6;15;58896;21758;90;80654
93;2021-01-31;237;194;431;2639673;2415978;0;5055651
94;2021-01-31;0;0;0;16311;17433;09;33744
94;2021-01-31;0;0;0;16679;18132;19;34811
94;2021-01-31;0;1;1;16782;16579;29;33361
94;2021-01-31;0;0;0;23044;20580;39;43624
94;2021-01-31;0;0;0;23065;22140;49;45205
94;2021-01-31;0;0;0;24549;23421;59;47970
94;2021-01-31;0;0;0;23212;21883;69;45095
94;2021-01-31;0;0;0;19544;17141;79;36685
94;2021-01-31;1;0;1;11227;8178;89;19405
94;2021-01-31;1;1;2;3332;1447;90;4779
94;2021-01-31;2;2;4;177745;166934;0;344679
01;2021-02-01;0;0;0;19979;20155;09;40134
01;2021-02-01;1;2;3;24994;25489;19;50483
01;2021-02-01;3;4;7;17868;16690;29;34558
01;2021-02-01;3;0;3;22328;14821;39;37149
01;2021-02-01;4;1;5;28652;20276;49;48928
01;2021-02-01;2;1;3;33264;27260;59;60524
01;2021-02-01;2;1;3;27135;23978;69;51113
01;2021-02-01;0;1;1;18401;14661;79;33062
01;2021-02-01;2;1;3;9633;6375;89;16008
01;2021-02-01;0;0;0;3410;1510;90;4920
01;2021-02-01;17;11;28;205664;171215;0;376879
02;2021-02-01;0;0;0;16881;17110;09;33991
02;2021-02-01;1;1;2;21410;21604;19;43014
02;2021-02-01;0;1;1;16017;15479;29;31496
02;2021-02-01;0;0;0;19825;14455;39;34280
02;2021-02-01;2;1;3;24719;18248;49;42967
02;2021-02-01;1;0;1;34361;28310;59;62671
02;2021-02-01;3;1;4;28061;24495;69;52556
02;2021-02-01;0;0;0;18231;15278;79;33509
02;2021-02-01;1;0;1;11090;7677;89;18767
02;2021-02-01;0;0;0;3992;1506;90;5498
02;2021-02-01;8;4;12;194587;164162;0;358749
03;2021-02-01;1;1;2;31123;30920;09;62043
03;2021-02-01;6;2;8;29370;29268;19;58638
03;2021-02-01;9;4;13;21458;18963;29;40421
03;2021-02-01;3;6;9;21276;18326;39;39602
03;2021-02-01;4;5;9;18164;16593;49;34757
03;2021-02-01;2;3;5;13469;13557;59;27026
03;2021-02-01;5;4;9;8776;8670;69;17446
03;2021-02-01;0;1;1;3777;3591;79;7368
03;2021-02-01;0;0;0;1649;1072;89;2721
03;2021-02-01;0;0;0;485;184;90;669
03;2021-02-01;30;26;56;149547;141144;0;290691
04;2021-02-01;2;4;6;60314;61377;09;121691
04;2021-02-01;12;10;22;66065;68387;19;134452
04;2021-02-01;8;5;13;51059;47156;29;98215
04;2021-02-01;15;9;24;58788;45780;39;104568
04;2021-02-01;11;7;18;61408;52207;49;113615
04;2021-02-01;13;5;18;64838;60759;59;125597
04;2021-02-01;6;4;10;47008;42843;69;89851
04;2021-02-01;0;0;0;25509;21184;79;46693
04;2021-02-01;0;0;0;13168;7647;89;20815
04;2021-02-01;0;0;0;3209;1253;90;4462
04;2021-02-01;67;44;111;451366;408593;0;859959
05;2021-02-01;0;0;0;362.366008612902;341.338819562748;09;703.704828175651
05;2021-02-01;0;0;0;353.376145114279;370.349735405642;19;723.725880519921
05;2021-02-01;0;0;0;218.593559489256;256.539602589476;29;475.133162078732
05;2021-02-01;0;0;0;404.225408693299;360.321910454353;39;764.547319147651
05;2021-02-01;0;0;0;520.067953604221;497.108383964256;49;1017.17633756848
05;2021-02-01;0;0;0;468.146063921917;510.087601910415;59;978.233665832332
05;2021-02-01;0;0;0;340.368470050554;334.366842191253;69;674.735312241807
05;2021-02-01;0;0;0;212.598666888387;192.597753227106;79;405.196420115493
05;2021-02-01;0;0;0;148.727797095705;61.8681715431829;89;210.595968638888
05;2021-02-01;0;0;0;32.9601271090696;10.9909785719784;90;43.9511056810479
05;2021-02-01;0;0;0;3061.43020057959;2935.56979942041;0;5997
06;2021-02-01;4;1;5;42583;42380;09;84963
06;2021-02-01;38;27;66;33369;31925;19;65294
06;2021-02-01;47;30;77;21571;15080;29;36651
06;2021-02-01;67;40;107;21550;16147;39;37697
06;2021-02-01;38;41;79;14193;13939;49;28132
06;2021-02-01;27;32;59;7171;7597;59;14768
06;2021-02-01;17;22;42;3629;4117;69;7746
06;2021-02-01;3;2;5;1577;1457;79;3034
06;2021-02-01;0;0;0;531;474;89;1005
06;2021-02-01;0;0;0;88;93;90;181
06;2021-02-01;241;195;440;146262;133209;0;279471
07;2021-02-01;0;0;0;485;549;09;1034
07;2021-02-01;0;0;0;403;432;19;835
07;2021-02-01;0;2;2;764;841;29;1605
07;2021-02-01;3;1;4;824;928;39;1752
07;2021-02-01;3;2;5;788;1020;49;1808
07;2021-02-01;1;2;3;678;870;59;1548
07;2021-02-01;1;1;2;360;382;69;742
07;2021-02-01;0;0;0;231;190;79;421
07;2021-02-01;0;0;0;114;67;89;181
07;2021-02-01;0;0;0;24;11;90;35
07;2021-02-01;8;8;16;4671;5290;0;9961
08;2021-02-01;0;0;0;2715.22592983026;2997.75551488675;09;5712.98144471701
08;2021-02-01;3;2;5;2778.51901080978;3160.9156459093;19;5939.43465671908
08;2021-02-01;4;0;4;2080.8882988764;1718.16634315323;29;3799.05464202964
08;2021-02-01;1;1;2;2701.8582062647;1896.52641413317;39;4598.38462039786
08;2021-02-01;4;2;6;3151.45861023308;2460.52498233809;49;5611.98359257117
08;2021-02-01;2;2;4;2620.29868333099;2422.23566154656;59;5042.53434487755
08;2021-02-01;2;1;3;1621.44173420671;1438.58325779464;69;3060.02499200135
08;2021-02-01;0;0;0;626.575909335673;526.358467843651;79;1152.93437717932
08;2021-02-01;0;0;0;205.018522985054;140.993639349697;89;346.012162334751
08;2021-02-01;0;0;0;50.0325684687745;20.62259870351;90;70.6551671722846
08;2021-02-01;16;8;24;18551.3174743414;16782.6825256586;0;35334
11;2021-02-01;126;141;283;783071;811785;09;1594856
11;2021-02-01;424;471;926;761456;784653;19;1546109
11;2021-02-01;518;483;1003;850145;801772;29;1651917
11;2021-02-01;571;508;1083;914360;843488;39;1757848
11;2021-02-01;536;467;1006;845609;826202;49;1671811
11;2021-02-01;441;402;849;793566;745070;59;1538636
11;2021-02-01;297;282;584;628649;549192;69;1177841
11;2021-02-01;144;154;299;434606;358356;79;792962
11;2021-02-01;103;80;183;261425;162933;89;424358
11;2021-02-01;67;28;95;89253;32619;90;121872
11;2021-02-01;3233;3027;6328;6362140;5916070;0;12278210
24;2021-02-01;14;21;36;139720;144686;09;284406
24;2021-02-01;68;58;127;152979;161185;19;314164
24;2021-02-01;62;56;118;122237;126536;29;248773
24;2021-02-01;90;55;145;150359;142009;39;292368
24;2021-02-01;97;70;167;161829;158758;49;320587
24;2021-02-01;96;73;169;172552;168011;59;340563
24;2021-02-01;47;45;92;172509;158177;69;330686
24;2021-02-01;52;42;94;129428;110593;79;240021
24;2021-02-01;47;38;86;87342;56882;89;144224
24;2021-02-01;42;8;50;31210;12071;90;43281
24;2021-02-01;616;466;1085;1320165;1238908;0;2559073
27;2021-02-01;22;28;50;143373;149679;09;293052
27;2021-02-01;75;79;154;160962;173003;19;333965
27;2021-02-01;81;49;130;133746;142254;29;276000
27;2021-02-01;91;80;171;160004;155407;39;315411
27;2021-02-01;112;91;203;172333;169564;49;341897
27;2021-02-01;104;92;196;189979;183788;59;373767
27;2021-02-01;70;64;134;192591;178206;69;370797
27;2021-02-01;70;49;119;146876;127546;79;274422
27;2021-02-01;61;50;111;96896;61575;89;158471
27;2021-02-01;50;16;66;33148;12109;90;45257
27;2021-02-01;736;598;1334;1429908;1353131;0;2783039
28;2021-02-01;23;28;51;180735;186856;09;367591
28;2021-02-01;56;62;119;200125;213621;19;413746
28;2021-02-01;84;62;146;168922;173007;29;341929
28;2021-02-01;121;73;194;196628;188487;39;385115
28;2021-02-01;93;85;178;205396;201699;49;407095
28;2021-02-01;103;58;161;222002;213866;59;435868
28;2021-02-01;68;73;141;224688;203758;69;428446
28;2021-02-01;57;51;108;163192;135543;79;298735
28;2021-02-01;58;28;86;109691;65377;89;175068
28;2021-02-01;44;11;55;37222;12685;90;49907
28;2021-02-01;707;531;1239;1708601;1594899;0;3303500
32;2021-02-01;45;71;117;358062;373689;09;731751
32;2021-02-01;185;197;382;387045;406742;19;793787
32;2021-02-01;230;172;402;342304;348587;29;690891
32;2021-02-01;232;188;420;382485;369972;39;752457
32;2021-02-01;267;201;468;382510;376716;49;759226
32;2021-02-01;189;210;399;386937;376527;59;763464
32;2021-02-01;157;137;294;371211;330938;69;702149
32;2021-02-01;106;97;203;250542;201459;79;452001
32;2021-02-01;124;54;178;163399;89786;89;253185
32;2021-02-01;79;13;92;48384;15367;90;63751
32;2021-02-01;1614;1340;2955;3072879;2889783;0;5962662
44;2021-02-01;59;74;134;291525;306839;09;598364
44;2021-02-01;184;187;372;320255;339504;19;659759
44;2021-02-01;186;163;351;302020;314428;29;616448
44;2021-02-01;222;196;419;342222;333292;39;675514
44;2021-02-01;181;178;361;349727;344491;49;694218
44;2021-02-01;201;207;411;381371;373239;59;754610
44;2021-02-01;140;103;244;367165;335850;69;703015
44;2021-02-01;68;80;149;250387;215436;79;465823
44;2021-02-01;113;61;175;170825;105192;89;276017
44;2021-02-01;83;26;110;51248;16731;90;67979
44;2021-02-01;1437;1276;2727;2826745;2685002;0;5511747
52;2021-02-01;30;23;55;213594;223900;09;437494
52;2021-02-01;76;75;155;240818;255197;19;496015
52;2021-02-01;105;88;194;197010;200630;29;397640
52;2021-02-01;100;72;172;231204;224885;39;456089
52;2021-02-01;112;79;191;243874;243418;49;487292
52;2021-02-01;100;78;178;244100;239116;59;483216
52;2021-02-01;58;45;105;241796;221345;69;463141
52;2021-02-01;42;40;82;177805;149903;79;327708
52;2021-02-01;67;29;97;119561;75822;89;195383
52;2021-02-01;46;6;52;42559;15260;90;57819
52;2021-02-01;736;535;1281;1952321;1849476;0;3801797
53;2021-02-01;14;16;30;173813;182358;09;356171
53;2021-02-01;47;33;80;202720;214740;19;417460
53;2021-02-01;63;52;125;163116;173196;29;336312
53;2021-02-01;48;35;83;190526;187674;39;378200
53;2021-02-01;74;61;136;212098;212015;49;424113
53;2021-02-01;50;58;108;223699;219176;59;442875
53;2021-02-01;41;34;75;227435;209274;69;436709
53;2021-02-01;30;33;63;169992;140910;79;310902
53;2021-02-01;44;33;77;118117;69883;89;188000
53;2021-02-01;27;16;43;37370;12267;90;49637
53;2021-02-01;439;371;821;1718886;1621493;0;3340379
75;2021-02-01;39;42;82;293104;305291;09;598395
75;2021-02-01;104;109;213;337141;357785;19;694926
75;2021-02-01;156;116;272;295024;300618;29;595642
75;2021-02-01;163;147;310;347871;331233;39;679104
75;2021-02-01;181;143;324;384742;372771;49;757513
75;2021-02-01;174;136;310;413361;390880;59;804241
75;2021-02-01;138;115;253;425623;384060;69;809683
75;2021-02-01;86;67;153;325086;276298;79;601384
75;2021-02-01;126;72;198;213986;139308;89;353294
75;2021-02-01;109;36;145;77600;28200;90;105800
75;2021-02-01;1277;983;2261;3113538;2886444;0;5999982
76;2021-02-01;56;59;119;305956;318589;09;624545
76;2021-02-01;162;190;358;338942;356969;19;695911
76;2021-02-01;220;156;377;316210;319570;29;635780
76;2021-02-01;227;160;387;356758;337587;39;694345
76;2021-02-01;243;205;448;376541;363812;49;740353
76;2021-02-01;209;168;377;402608;383750;59;786358
76;2021-02-01;148;147;295;394889;358997;69;753886
76;2021-02-01;119;87;206;308664;263806;79;572470
76;2021-02-01;97;77;174;195838;129272;89;325110
76;2021-02-01;77;34;111;69372;26728;90;96100
76;2021-02-01;1559;1283;2853;3065778;2859080;0;5924858
84;2021-02-01;66;72;139;459549;481088;09;940637
84;2021-02-01;286;251;537;487711;511905;19;999616
84;2021-02-01;270;234;504;443824;451094;29;894918
84;2021-02-01;336;257;593;512522;493262;39;1005784
84;2021-02-01;351;280;631;520248;515106;49;1035354
84;2021-02-01;274;286;560;529611;514848;59;1044459
84;2021-02-01;201;194;395;486720;439940;69;926660
84;2021-02-01;141;158;299;372151;315211;79;687362
84;2021-02-01;132;82;214;237198;150524;89;387722
84;2021-02-01;125;35;160;81185;28680;90;109865
84;2021-02-01;2182;1849;4033;4130719;3901658;0;8032377
93;2021-02-01;62;85;148;268834;283093;09;551927
93;2021-02-01;259;251;512;280751;296087;19;576838
93;2021-02-01;277;242;520;254404;255552;29;509956
93;2021-02-01;352;258;610;310704;288398;39;599102
93;2021-02-01;371;284;655;325559;305827;49;631386
93;2021-02-01;334;319;654;353104;325389;59;678493
93;2021-02-01;227;217;444;336327;296459;69;632786
93;2021-02-01;151;145;296;279820;229699;79;509519
93;2021-02-01;157;105;262;171274;113716;89;284990
93;2021-02-01;133;38;171;58896;21758;90;80654
93;2021-02-01;2323;1944;4272;2639673;2415978;0;5055651
94;2021-02-01;2;2;4;16311;17433;09;33744
94;2021-02-01;1;2;3;16679;18132;19;34811
94;2021-02-01;2;8;10;16782;16579;29;33361
94;2021-02-01;8;5;13;23044;20580;39;43624
94;2021-02-01;10;3;13;23065;22140;49;45205
94;2021-02-01;9;6;15;24549;23421;59;47970
94;2021-02-01;7;6;13;23212;21883;69;45095
94;2021-02-01;6;3;9;19544;17141;79;36685
94;2021-02-01;4;3;7;11227;8178;89;19405
94;2021-02-01;3;2;5;3332;1447;90;4779
94;2021-02-01;52;40;92;177745;166934;0;344679
01;2021-02-02;0;0;0;19979;20155;09;40134
01;2021-02-02;1;0;1;24994;25489;19;50483
01;2021-02-02;3;2;5;17868;16690;29;34558
01;2021-02-02;2;3;5;22328;14821;39;37149
01;2021-02-02;1;2;3;28652;20276;49;48928
01;2021-02-02;1;0;1;33264;27260;59;60524
01;2021-02-02;4;2;6;27135;23978;69;51113
01;2021-02-02;2;0;2;18401;14661;79;33062
01;2021-02-02;0;0;0;9633;6375;89;16008
01;2021-02-02;0;0;0;3410;1510;90;4920
01;2021-02-02;14;9;23;205664;171215;0;376879
02;2021-02-02;0;0;0;16881;17110;09;33991
02;2021-02-02;0;0;0;21410;21604;19;43014
02;2021-02-02;0;1;1;16017;15479;29;31496
02;2021-02-02;2;1;3;19825;14455;39;34280
02;2021-02-02;1;2;3;24719;18248;49;42967
02;2021-02-02;2;3;5;34361;28310;59;62671
02;2021-02-02;0;1;1;28061;24495;69;52556
02;2021-02-02;1;0;1;18231;15278;79;33509
02;2021-02-02;0;0;0;11090;7677;89;18767
02;2021-02-02;0;0;0;3992;1506;90;5498
02;2021-02-02;6;8;14;194587;164162;0;358749
03;2021-02-02;0;0;0;31123;30920;09;62043
03;2021-02-02;1;2;3;29370;29268;19;58638
03;2021-02-02;1;4;5;21458;18963;29;40421
03;2021-02-02;2;3;5;21276;18326;39;39602
03;2021-02-02;1;1;2;18164;16593;49;34757
03;2021-02-02;1;2;3;13469;13557;59;27026
03;2021-02-02;4;4;8;8776;8670;69;17446
03;2021-02-02;0;1;1;3777;3591;79;7368
03;2021-02-02;0;0;0;1649;1072;89;2721
03;2021-02-02;0;0;0;485;184;90;669
03;2021-02-02;10;17;27;149547;141144;0;290691
04;2021-02-02;2;2;4;60314;61377;09;121691
04;2021-02-02;10;7;17;66065;68387;19;134452
04;2021-02-02;3;6;9;51059;47156;29;98215
04;2021-02-02;8;8;16;58788;45780;39;104568
04;2021-02-02;15;8;23;61408;52207;49;113615
04;2021-02-02;8;6;14;64838;60759;59;125597
04;2021-02-02;4;1;5;47008;42843;69;89851
04;2021-02-02;0;2;2;25509;21184;79;46693
04;2021-02-02;1;2;3;13168;7647;89;20815
04;2021-02-02;0;0;0;3209;1253;90;4462
04;2021-02-02;51;42;93;451366;408593;0;859959
05;2021-02-02;0;0;0;362.366008612902;341.338819562748;09;703.704828175651
05;2021-02-02;0;0;0;353.376145114279;370.349735405642;19;723.725880519921
05;2021-02-02;0;0;0;218.593559489256;256.539602589476;29;475.133162078732
05;2021-02-02;0;0;0;404.225408693299;360.321910454353;39;764.547319147651
05;2021-02-02;0;0;0;520.067953604221;497.108383964256;49;1017.17633756848
05;2021-02-02;0;0;0;468.146063921917;510.087601910415;59;978.233665832332
05;2021-02-02;0;0;0;340.368470050554;334.366842191253;69;674.735312241807
05;2021-02-02;0;0;0;212.598666888387;192.597753227106;79;405.196420115493
05;2021-02-02;0;0;0;148.727797095705;61.8681715431829;89;210.595968638888
05;2021-02-02;0;0;0;32.9601271090696;10.9909785719784;90;43.9511056810479
05;2021-02-02;0;0;0;3061.43020057959;2935.56979942041;0;5997
06;2021-02-02;5;0;5;42583;42380;09;84963
06;2021-02-02;42;32;76;33369;31925;19;65294
06;2021-02-02;47;39;86;21571;15080;29;36651
06;2021-02-02;47;39;86;21550;16147;39;37697
06;2021-02-02;48;39;87;14193;13939;49;28132
06;2021-02-02;23;30;53;7171;7597;59;14768
06;2021-02-02;7;14;21;3629;4117;69;7746
06;2021-02-02;2;3;5;1577;1457;79;3034
06;2021-02-02;2;0;2;531;474;89;1005
06;2021-02-02;0;0;0;88;93;90;181
06;2021-02-02;224;196;422;146262;133209;0;279471
07;2021-02-02;0;0;0;485;549;09;1034
07;2021-02-02;1;0;1;403;432;19;835
07;2021-02-02;3;1;4;764;841;29;1605
07;2021-02-02;1;2;3;824;928;39;1752
07;2021-02-02;0;0;0;788;1020;49;1808
07;2021-02-02;0;0;0;678;870;59;1548
07;2021-02-02;0;0;0;360;382;69;742
07;2021-02-02;0;0;0;231;190;79;421
07;2021-02-02;0;0;0;114;67;89;181
07;2021-02-02;0;0;0;24;11;90;35
07;2021-02-02;5;3;8;4671;5290;0;9961
08;2021-02-02;2;0;2;2715.22592983026;2997.75551488675;09;5712.98144471701
08;2021-02-02;1;0;1;2778.51901080978;3160.9156459093;19;5939.43465671908
08;2021-02-02;2;1;3;2080.8882988764;1718.16634315323;29;3799.05464202964
08;2021-02-02;4;1;5;2701.8582062647;1896.52641413317;39;4598.38462039786
08;2021-02-02;3;1;4;3151.45861023308;2460.52498233809;49;5611.98359257117
08;2021-02-02;0;0;0;2620.29868333099;2422.23566154656;59;5042.53434487755
08;2021-02-02;0;1;1;1621.44173420671;1438.58325779464;69;3060.02499200135
08;2021-02-02;0;0;0;626.575909335673;526.358467843651;79;1152.93437717932
08;2021-02-02;0;0;0;205.018522985054;140.993639349697;89;346.012162334751
08;2021-02-02;0;0;0;50.0325684687745;20.62259870351;90;70.6551671722846
08;2021-02-02;12;4;16;18551.3174743414;16782.6825256586;0;35334
11;2021-02-02;111;120;249;783071;811785;09;1594856
11;2021-02-02;346;381;752;761456;784653;19;1546109
11;2021-02-02;473;377;854;850145;801772;29;1651917
11;2021-02-02;450;400;855;914360;843488;39;1757848
11;2021-02-02;469;384;857;845609;826202;49;1671811
11;2021-02-02;349;350;700;793566;745070;59;1538636
11;2021-02-02;233;245;485;628649;549192;69;1177841
11;2021-02-02;111;110;222;434606;358356;79;792962
11;2021-02-02;108;75;184;261425;162933;89;424358
11;2021-02-02;41;22;63;89253;32619;90;121872
11;2021-02-02;2691;2465;5222;6362140;5916070;0;12278210
24;2021-02-02;12;12;25;139720;144686;09;284406
24;2021-02-02;48;62;113;152979;161185;19;314164
24;2021-02-02;51;40;91;122237;126536;29;248773
24;2021-02-02;68;43;111;150359;142009;39;292368
24;2021-02-02;63;57;120;161829;158758;49;320587
24;2021-02-02;62;47;109;172552;168011;59;340563
24;2021-02-02;35;30;65;172509;158177;69;330686
24;2021-02-02;40;43;83;129428;110593;79;240021
24;2021-02-02;38;22;60;87342;56882;89;144224
24;2021-02-02;43;12;55;31210;12071;90;43281
24;2021-02-02;460;368;832;1320165;1238908;0;2559073
27;2021-02-02;12;11;23;143373;149679;09;293052
27;2021-02-02;54;44;98;160962;173003;19;333965
27;2021-02-02;67;52;119;133746;142254;29;276000
27;2021-02-02;62;42;104;160004;155407;39;315411
27;2021-02-02;69;68;137;172333;169564;49;341897
27;2021-02-02;73;66;139;189979;183788;59;373767
27;2021-02-02;55;52;107;192591;178206;69;370797
27;2021-02-02;40;51;92;146876;127546;79;274422
27;2021-02-02;37;32;69;96896;61575;89;158471
27;2021-02-02;52;16;68;33148;12109;90;45257
27;2021-02-02;521;434;956;1429908;1353131;0;2783039
28;2021-02-02;30;20;50;180735;186856;09;367591
28;2021-02-02;58;55;118;200125;213621;19;413746
28;2021-02-02;58;44;102;168922;173007;29;341929
28;2021-02-02;61;61;122;196628;188487;39;385115
28;2021-02-02;66;66;132;205396;201699;49;407095
28;2021-02-02;76;56;132;222002;213866;59;435868
28;2021-02-02;55;64;119;224688;203758;69;428446
28;2021-02-02;40;33;73;163192;135543;79;298735
28;2021-02-02;42;25;67;109691;65377;89;175068
28;2021-02-02;26;12;38;37222;12685;90;49907
28;2021-02-02;512;436;953;1708601;1594899;0;3303500
32;2021-02-02;49;51;100;358062;373689;09;731751
32;2021-02-02;171;165;336;387045;406742;19;793787
32;2021-02-02;164;125;289;342304;348587;29;690891
32;2021-02-02;166;122;288;382485;369972;39;752457
32;2021-02-02;170;155;325;382510;376716;49;759226
32;2021-02-02;174;162;336;386937;376527;59;763464
32;2021-02-02;131;111;242;371211;330938;69;702149
32;2021-02-02;98;76;174;250542;201459;79;452001
32;2021-02-02;77;42;119;163399;89786;89;253185
32;2021-02-02;64;12;76;48384;15367;90;63751
32;2021-02-02;1265;1021;2288;3072879;2889783;0;5962662
44;2021-02-02;57;52;110;291525;306839;09;598364
44;2021-02-02;144;122;267;320255;339504;19;659759
44;2021-02-02;148;127;277;302020;314428;29;616448
44;2021-02-02;170;115;288;342222;333292;39;675514
44;2021-02-02;132;120;253;349727;344491;49;694218
44;2021-02-02;138;120;258;381371;373239;59;754610
44;2021-02-02;83;91;175;367165;335850;69;703015
44;2021-02-02;81;69;150;250387;215436;79;465823
44;2021-02-02;59;46;105;170825;105192;89;276017
44;2021-02-02;38;8;46;51248;16731;90;67979
44;2021-02-02;1050;870;1929;2826745;2685002;0;5511747
52;2021-02-02;20;16;38;213594;223900;09;437494
52;2021-02-02;40;50;92;240818;255197;19;496015
52;2021-02-02;70;61;131;197010;200630;29;397640
52;2021-02-02;68;54;123;231204;224885;39;456089
52;2021-02-02;71;57;128;243874;243418;49;487292
52;2021-02-02;45;53;98;244100;239116;59;483216
52;2021-02-02;46;39;85;241796;221345;69;463141
52;2021-02-02;28;32;61;177805;149903;79;327708
52;2021-02-02;29;25;54;119561;75822;89;195383
52;2021-02-02;39;15;54;42559;15260;90;57819
52;2021-02-02;456;402;864;1952321;1849476;0;3801797
53;2021-02-02;18;18;36;173813;182358;09;356171
53;2021-02-02;49;39;91;202720;214740;19;417460
53;2021-02-02;37;51;91;163116;173196;29;336312
53;2021-02-02;44;36;80;190526;187674;39;378200
53;2021-02-02;50;44;94;212098;212015;49;424113
53;2021-02-02;49;39;88;223699;219176;59;442875
53;2021-02-02;28;24;52;227435;209274;69;436709
53;2021-02-02;27;26;53;169992;140910;79;310902
53;2021-02-02;28;22;50;118117;69883;89;188000
53;2021-02-02;28;9;37;37370;12267;90;49637
53;2021-02-02;358;308;672;1718886;1621493;0;3340379
75;2021-02-02;32;36;69;293104;305291;09;598395
75;2021-02-02;107;98;206;337141;357785;19;694926
75;2021-02-02;139;96;235;295024;300618;29;595642
75;2021-02-02;131;90;221;347871;331233;39;679104
75;2021-02-02;136;107;243;384742;372771;49;757513
75;2021-02-02;132;108;240;413361;390880;59;804241
75;2021-02-02;88;100;188;425623;384060;69;809683
75;2021-02-02;83;52;135;325086;276298;79;601384
75;2021-02-02;88;50;138;213986;139308;89;353294
75;2021-02-02;98;29;127;77600;28200;90;105800
75;2021-02-02;1034;768;1804;3113538;2886444;0;5999982
76;2021-02-02;34;43;78;305956;318589;09;624545
76;2021-02-02;117;133;251;338942;356969;19;695911
76;2021-02-02;156;131;287;316210;319570;29;635780
76;2021-02-02;160;112;272;356758;337587;39;694345
76;2021-02-02;200;132;332;376541;363812;49;740353
76;2021-02-02;177;130;307;402608;383750;59;786358
76;2021-02-02;104;100;204;394889;358997;69;753886
76;2021-02-02;67;83;150;308664;263806;79;572470
76;2021-02-02;83;45;128;195838;129272;89;325110
76;2021-02-02;78;25;103;69372;26728;90;96100
76;2021-02-02;1177;935;2114;3065778;2859080;0;5924858
84;2021-02-02;56;53;109;459549;481088;09;940637
84;2021-02-02;196;192;389;487711;511905;19;999616
84;2021-02-02;201;170;371;443824;451094;29;894918
84;2021-02-02;212;205;417;512522;493262;39;1005784
84;2021-02-02;241;186;427;520248;515106;49;1035354
84;2021-02-02;215;193;408;529611;514848;59;1044459
84;2021-02-02;124;140;264;486720;439940;69;926660
84;2021-02-02;98;89;187;372151;315211;79;687362
84;2021-02-02;111;66;177;237198;150524;89;387722
84;2021-02-02;78;39;117;81185;28680;90;109865
84;2021-02-02;1532;1334;2872;4130719;3901658;0;8032377
93;2021-02-02;60;48;108;268834;283093;09;551927
93;2021-02-02;172;191;364;280751;296087;19;576838
93;2021-02-02;254;183;437;254404;255552;29;509956
93;2021-02-02;235;195;430;310704;288398;39;599102
93;2021-02-02;264;213;480;325559;305827;49;631386
93;2021-02-02;246;214;461;353104;325389;59;678493
93;2021-02-02;188;169;357;336327;296459;69;632786
93;2021-02-02;147;107;254;279820;229699;79;509519
93;2021-02-02;155;83;238;171274;113716;89;284990
93;2021-02-02;98;26;124;58896;21758;90;80654
93;2021-02-02;1819;1429;3253;2639673;2415978;0;5055651
94;2021-02-02;2;0;2;16311;17433;09;33744
94;2021-02-02;1;1;2;16679;18132;19;34811
94;2021-02-02;4;2;6;16782;16579;29;33361
94;2021-02-02;3;4;7;23044;20580;39;43624
94;2021-02-02;8;4;12;23065;22140;49;45205
94;2021-02-02;7;8;15;24549;23421;59;47970
94;2021-02-02;7;5;12;23212;21883;69;45095
94;2021-02-02;3;4;7;19544;17141;79;36685
94;2021-02-02;6;2;8;11227;8178;89;19405
94;2021-02-02;2;0;2;3332;1447;90;4779
94;2021-02-02;43;30;73;177745;166934;0;344679
01;2021-02-03;0;1;1;19979;20155;09;40134
01;2021-02-03;2;0;2;24994;25489;19;50483
01;2021-02-03;1;1;2;17868;16690;29;34558
01;2021-02-03;4;0;4;22328;14821;39;37149
01;2021-02-03;7;2;9;28652;20276;49;48928
01;2021-02-03;0;2;2;33264;27260;59;60524
01;2021-02-03;3;2;5;27135;23978;69;51113
01;2021-02-03;0;3;3;18401;14661;79;33062
01;2021-02-03;0;0;0;9633;6375;89;16008
01;2021-02-03;0;0;0;3410;1510;90;4920
01;2021-02-03;17;11;28;205664;171215;0;376879
02;2021-02-03;0;0;0;16881;17110;09;33991
02;2021-02-03;0;2;2;21410;21604;19;43014
02;2021-02-03;1;4;5;16017;15479;29;31496
02;2021-02-03;0;1;1;19825;14455;39;34280
02;2021-02-03;0;2;2;24719;18248;49;42967
02;2021-02-03;1;0;1;34361;28310;59;62671
02;2021-02-03;2;0;2;28061;24495;69;52556
02;2021-02-03;0;0;0;18231;15278;79;33509
02;2021-02-03;0;0;0;11090;7677;89;18767
02;2021-02-03;0;0;0;3992;1506;90;5498
02;2021-02-03;4;9;13;194587;164162;0;358749
03;2021-02-03;1;0;1;31123;30920;09;62043
03;2021-02-03;7;2;9;29370;29268;19;58638
03;2021-02-03;2;8;10;21458;18963;29;40421
03;2021-02-03;4;2;6;21276;18326;39;39602
03;2021-02-03;2;4;6;18164;16593;49;34757
03;2021-02-03;5;1;6;13469;13557;59;27026
03;2021-02-03;3;1;4;8776;8670;69;17446
03;2021-02-03;0;0;0;3777;3591;79;7368
03;2021-02-03;0;0;0;1649;1072;89;2721
03;2021-02-03;0;0;0;485;184;90;669
03;2021-02-03;24;18;42;149547;141144;0;290691
04;2021-02-03;0;2;2;60314;61377;09;121691
04;2021-02-03;7;7;14;66065;68387;19;134452
04;2021-02-03;7;5;12;51059;47156;29;98215
04;2021-02-03;6;3;9;58788;45780;39;104568
04;2021-02-03;11;4;15;61408;52207;49;113615
04;2021-02-03;10;7;17;64838;60759;59;125597
04;2021-02-03;5;2;7;47008;42843;69;89851
04;2021-02-03;0;1;1;25509;21184;79;46693
04;2021-02-03;0;0;0;13168;7647;89;20815
04;2021-02-03;1;0;1;3209;1253;90;4462
04;2021-02-03;47;31;78;451366;408593;0;859959
05;2021-02-03;0;0;0;362.366008612902;341.338819562748;09;703.704828175651
05;2021-02-03;0;0;0;353.376145114279;370.349735405642;19;723.725880519921
05;2021-02-03;0;0;0;218.593559489256;256.539602589476;29;475.133162078732
05;2021-02-03;0;0;0;404.225408693299;360.321910454353;39;764.547319147651
05;2021-02-03;0;0;0;520.067953604221;497.108383964256;49;1017.17633756848
05;2021-02-03;0;0;0;468.146063921917;510.087601910415;59;978.233665832332
05;2021-02-03;0;0;0;340.368470050554;334.366842191253;69;674.735312241807
05;2021-02-03;0;0;0;212.598666888387;192.597753227106;79;405.196420115493
05;2021-02-03;0;0;0;148.727797095705;61.8681715431829;89;210.595968638888
05;2021-02-03;0;0;0;32.9601271090696;10.9909785719784;90;43.9511056810479
05;2021-02-03;0;0;0;3061.43020057959;2935.56979942041;0;5997
06;2021-02-03;3;1;4;42583;42380;09;84963
06;2021-02-03;44;25;71;33369;31925;19;65294
06;2021-02-03;42;34;76;21571;15080;29;36651
06;2021-02-03;40;46;86;21550;16147;39;37697
06;2021-02-03;43;31;74;14193;13939;49;28132
06;2021-02-03;22;25;47;7171;7597;59;14768
06;2021-02-03;12;17;31;3629;4117;69;7746
06;2021-02-03;2;2;4;1577;1457;79;3034
06;2021-02-03;1;2;3;531;474;89;1005
06;2021-02-03;0;0;0;88;93;90;181
06;2021-02-03;209;183;396;146262;133209;0;279471
07;2021-02-03;0;0;0;485;549;09;1034
07;2021-02-03;0;0;0;403;432;19;835
07;2021-02-03;0;0;0;764;841;29;1605
07;2021-02-03;1;0;1;824;928;39;1752
07;2021-02-03;0;3;3;788;1020;49;1808
07;2021-02-03;2;1;3;678;870;59;1548
07;2021-02-03;1;1;2;360;382;69;742
07;2021-02-03;0;0;0;231;190;79;421
07;2021-02-03;0;0;0;114;67;89;181
07;2021-02-03;0;0;0;24;11;90;35
07;2021-02-03;4;5;9;4671;5290;0;9961
08;2021-02-03;0;0;0;2715.22592983026;2997.75551488675;09;5712.98144471701
08;2021-02-03;1;0;1;2778.51901080978;3160.9156459093;19;5939.43465671908
08;2021-02-03;0;1;1;2080.8882988764;1718.16634315323;29;3799.05464202964
08;2021-02-03;2;1;3;2701.8582062647;1896.52641413317;39;4598.38462039786
08;2021-02-03;1;1;2;3151.45861023308;2460.52498233809;49;5611.98359257117
08;2021-02-03;1;0;1;2620.29868333099;2422.23566154656;59;5042.53434487755
08;2021-02-03;0;0;0;1621.44173420671;1438.58325779464;69;3060.02499200135
08;2021-02-03;0;0;0;626.575909335673;526.358467843651;79;1152.93437717932
08;2021-02-03;0;0;0;205.018522985054;140.993639349697;89;346.012162334751
08;2021-02-03;0;0;0;50.0325684687745;20.62259870351;90;70.6551671722846
08;2021-02-03;5;3;8;18551.3174743414;16782.6825256586;0;35334
11;2021-02-03;117;96;222;783071;811785;09;1594856
11;2021-02-03;361;337;716;761456;784653;19;1546109
11;2021-02-03;457;395;854;850145;801772;29;1651917
11;2021-02-03;402;361;767;914360;843488;39;1757848
11;2021-02-03;365;304;670;845609;826202;49;1671811
11;2021-02-03;312;283;595;793566;745070;59;1538636
11;2021-02-03;198;208;416;628649;549192;69;1177841
11;2021-02-03;105;100;205;434606;358356;79;792962
11;2021-02-03;95;76;171;261425;162933;89;424358
11;2021-02-03;67;14;82;89253;32619;90;121872
11;2021-02-03;2479;2174;4698;6362140;5916070;0;12278210
24;2021-02-03;14;10;24;139720;144686;09;284406
24;2021-02-03;56;53;110;152979;161185;19;314164
24;2021-02-03;54;41;96;122237;126536;29;248773
24;2021-02-03;67;32;99;150359;142009;39;292368
24;2021-02-03;69;49;118;161829;158758;49;320587
24;2021-02-03;55;44;99;172552;168011;59;340563
24;2021-02-03;32;28;60;172509;158177;69;330686
24;2021-02-03;24;22;46;129428;110593;79;240021
24;2021-02-03;31;26;57;87342;56882;89;144224
24;2021-02-03;31;8;39;31210;12071;90;43281
24;2021-02-03;433;314;749;1320165;1238908;0;2559073
27;2021-02-03;21;12;33;143373;149679;09;293052
27;2021-02-03;55;52;107;160962;173003;19;333965
27;2021-02-03;42;59;101;133746;142254;29;276000
27;2021-02-03;60;35;95;160004;155407;39;315411
27;2021-02-03;73;47;120;172333;169564;49;341897
27;2021-02-03;54;44;98;189979;183788;59;373767
27;2021-02-03;34;43;77;192591;178206;69;370797
27;2021-02-03;30;33;63;146876;127546;79;274422
27;2021-02-03;25;21;46;96896;61575;89;158471
27;2021-02-03;19;9;28;33148;12109;90;45257
27;2021-02-03;413;355;768;1429908;1353131;0;2783039
28;2021-02-03;19;21;40;180735;186856;09;367591
28;2021-02-03;53;67;120;200125;213621;19;413746
28;2021-02-03;70;57;127;168922;173007;29;341929
28;2021-02-03;80;59;139;196628;188487;39;385115
28;2021-02-03;79;53;132;205396;201699;49;407095
28;2021-02-03;70;50;120;222002;213866;59;435868
28;2021-02-03;36;47;83;224688;203758;69;428446
28;2021-02-03;43;34;77;163192;135543;79;298735
28;2021-02-03;34;29;63;109691;65377;89;175068
28;2021-02-03;37;4;41;37222;12685;90;49907
28;2021-02-03;521;421;942;1708601;1594899;0;3303500
32;2021-02-03;50;31;81;358062;373689;09;731751
32;2021-02-03;129;151;280;387045;406742;19;793787
32;2021-02-03;146;120;266;342304;348587;29;690891
32;2021-02-03;161;136;297;382485;369972;39;752457
32;2021-02-03;157;144;301;382510;376716;49;759226
32;2021-02-03;121;146;267;386937;376527;59;763464
32;2021-02-03;111;102;213;371211;330938;69;702149
32;2021-02-03;80;54;134;250542;201459;79;452001
32;2021-02-03;75;40;115;163399;89786;89;253185
32;2021-02-03;44;13;57;48384;15367;90;63751
32;2021-02-03;1074;938;2012;3072879;2889783;0;5962662
44;2021-02-03;60;59;120;291525;306839;09;598364
44;2021-02-03;112;142;254;320255;339504;19;659759
44;2021-02-03;139;107;246;302020;314428;29;616448
44;2021-02-03;141;95;236;342222;333292;39;675514
44;2021-02-03;140;105;246;349727;344491;49;694218
44;2021-02-03;109;90;200;381371;373239;59;754610
44;2021-02-03;82;85;168;367165;335850;69;703015
44;2021-02-03;59;53;112;250387;215436;79;465823
44;2021-02-03;63;44;107;170825;105192;89;276017
44;2021-02-03;41;5;46;51248;16731;90;67979
44;2021-02-03;946;785;1735;2826745;2685002;0;5511747
52;2021-02-03;13;25;39;213594;223900;09;437494
52;2021-02-03;55;58;113;240818;255197;19;496015
52;2021-02-03;64;71;135;197010;200630;29;397640
52;2021-02-03;63;48;111;231204;224885;39;456089
52;2021-02-03;69;58;127;243874;243418;49;487292
52;2021-02-03;53;52;105;244100;239116;59;483216
52;2021-02-03;35;33;69;241796;221345;69;463141
52;2021-02-03;29;30;59;177805;149903;79;327708
52;2021-02-03;39;28;67;119561;75822;89;195383
52;2021-02-03;28;8;36;42559;15260;90;57819
52;2021-02-03;448;411;861;1952321;1849476;0;3801797
53;2021-02-03;18;12;30;173813;182358;09;356171
53;2021-02-03;47;31;78;202720;214740;19;417460
53;2021-02-03;41;44;86;163116;173196;29;336312
53;2021-02-03;43;25;68;190526;187674;39;378200
53;2021-02-03;50;34;84;212098;212015;49;424113
53;2021-02-03;49;45;94;223699;219176;59;442875
53;2021-02-03;29;22;51;227435;209274;69;436709
53;2021-02-03;25;13;38;169992;140910;79;310902
53;2021-02-03;34;15;49;118117;69883;89;188000
53;2021-02-03;15;8;23;37370;12267;90;49637
53;2021-02-03;351;249;601;1718886;1621493;0;3340379
75;2021-02-03;35;40;75;293104;305291;09;598395
75;2021-02-03;99;94;193;337141;357785;19;694926
75;2021-02-03;108;91;199;295024;300618;29;595642
75;2021-02-03;111;71;182;347871;331233;39;679104
75;2021-02-03;124;73;197;384742;372771;49;757513
75;2021-02-03;117;87;204;413361;390880;59;804241
75;2021-02-03;74;75;149;425623;384060;69;809683
75;2021-02-03;61;56;117;325086;276298;79;601384
75;2021-02-03;44;32;76;213986;139308;89;353294
75;2021-02-03;57;20;77;77600;28200;90;105800
75;2021-02-03;830;640;1470;3113538;2886444;0;5999982
76;2021-02-03;38;33;71;305956;318589;09;624545
76;2021-02-03;115;148;268;338942;356969;19;695911
76;2021-02-03;156;96;253;316210;319570;29;635780
76;2021-02-03;150;124;274;356758;337587;39;694345
76;2021-02-03;163;128;291;376541;363812;49;740353
76;2021-02-03;155;135;290;402608;383750;59;786358
76;2021-02-03;96;95;192;394889;358997;69;753886
76;2021-02-03;64;66;130;308664;263806;79;572470
76;2021-02-03;82;49;131;195838;129272;89;325110
76;2021-02-03;55;15;70;69372;26728;90;96100
76;2021-02-03;1074;890;1971;3065778;2859080;0;5924858
84;2021-02-03;57;67;124;459549;481088;09;940637
84;2021-02-03;193;212;409;487711;511905;19;999616
84;2021-02-03;222;169;391;443824;451094;29;894918
84;2021-02-03;205;184;389;512522;493262;39;1005784
84;2021-02-03;231;186;417;520248;515106;49;1035354
84;2021-02-03;199;169;369;529611;514848;59;1044459
84;2021-02-03;109;131;240;486720;439940;69;926660
84;2021-02-03;89;88;177;372151;315211;79;687362
84;2021-02-03;118;58;176;237198;150524;89;387722
84;2021-02-03;67;14;81;81185;28680;90;109865
84;2021-02-03;1490;1279;2775;4130719;3901658;0;8032377
93;2021-02-03;47;41;88;268834;283093;09;551927
93;2021-02-03;207;182;393;280751;296087;19;576838
93;2021-02-03;239;181;421;254404;255552;29;509956
93;2021-02-03;235;183;418;310704;288398;39;599102
93;2021-02-03;249;184;434;325559;305827;49;631386
93;2021-02-03;252;197;449;353104;325389;59;678493
93;2021-02-03;154;158;312;336327;296459;69;632786
93;2021-02-03;127;85;212;279820;229699;79;509519
93;2021-02-03;87;52;140;171274;113716;89;284990
93;2021-02-03;45;20;65;58896;21758;90;80654
93;2021-02-03;1642;1285;2934;2639673;2415978;0;5055651
94;2021-02-03;0;0;0;16311;17433;09;33744
94;2021-02-03;1;4;5;16679;18132;19;34811
94;2021-02-03;6;5;11;16782;16579;29;33361
94;2021-02-03;0;4;4;23044;20580;39;43624
94;2021-02-03;8;5;13;23065;22140;49;45205
94;2021-02-03;2;5;7;24549;23421;59;47970
94;2021-02-03;3;3;6;23212;21883;69;45095
94;2021-02-03;3;3;6;19544;17141;79;36685
94;2021-02-03;2;3;5;11227;8178;89;19405
94;2021-02-03;1;0;1;3332;1447;90;4779
94;2021-02-03;26;32;58;177745;166934;0;344679
01;2021-02-04;1;0;1;19979;20155;09;40134
01;2021-02-04;0;0;0;24994;25489;19;50483
01;2021-02-04;1;2;3;17868;16690;29;34558
01;2021-02-04;3;0;3;22328;14821;39;37149
01;2021-02-04;4;1;5;28652;20276;49;48928
01;2021-02-04;2;3;5;33264;27260;59;60524
01;2021-02-04;3;3;6;27135;23978;69;51113
01;2021-02-04;1;1;2;18401;14661;79;33062
01;2021-02-04;0;0;0;9633;6375;89;16008
01;2021-02-04;0;0;0;3410;1510;90;4920
01;2021-02-04;16;10;26;205664;171215;0;376879
02;2021-02-04;0;0;0;16881;17110;09;33991
02;2021-02-04;0;0;0;21410;21604;19;43014
02;2021-02-04;2;2;4;16017;15479;29;31496
02;2021-02-04;1;0;1;19825;14455;39;34280
02;2021-02-04;0;1;1;24719;18248;49;42967
02;2021-02-04;2;1;3;34361;28310;59;62671
02;2021-02-04;3;1;4;28061;24495;69;52556
02;2021-02-04;0;1;1;18231;15278;79;33509
02;2021-02-04;0;0;0;11090;7677;89;18767
02;2021-02-04;0;0;0;3992;1506;90;5498
02;2021-02-04;8;6;14;194587;164162;0;358749
03;2021-02-04;0;0;0;31123;30920;09;62043
03;2021-02-04;1;4;5;29370;29268;19;58638
03;2021-02-04;3;1;4;21458;18963;29;40421
03;2021-02-04;6;1;7;21276;18326;39;39602
03;2021-02-04;2;0;2;18164;16593;49;34757
03;2021-02-04;2;2;4;13469;13557;59;27026
03;2021-02-04;2;3;5;8776;8670;69;17446
03;2021-02-04;0;0;0;3777;3591;79;7368
03;2021-02-04;0;0;0;1649;1072;89;2721
03;2021-02-04;0;0;0;485;184;90;669
03;2021-02-04;16;11;27;149547;141144;0;290691
04;2021-02-04;2;3;5;60314;61377;09;121691
04;2021-02-04;13;7;20;66065;68387;19;134452
04;2021-02-04;9;8;17;51059;47156;29;98215
04;2021-02-04;9;6;15;58788;45780;39;104568
04;2021-02-04;6;6;12;61408;52207;49;113615
04;2021-02-04;11;6;17;64838;60759;59;125597
04;2021-02-04;7;3;10;47008;42843;69;89851
04;2021-02-04;3;1;4;25509;21184;79;46693
04;2021-02-04;1;0;1;13168;7647;89;20815
04;2021-02-04;0;0;0;3209;1253;90;4462
04;2021-02-04;61;40;101;451366;408593;0;859959
05;2021-02-04;0;0;0;362.366008612902;341.338819562748;09;703.704828175651
05;2021-02-04;0;0;0;353.376145114279;370.349735405642;19;723.725880519921
05;2021-02-04;0;1;1;218.593559489256;256.539602589476;29;475.133162078732
05;2021-02-04;0;0;0;404.225408693299;360.321910454353;39;764.547319147651
05;2021-02-04;0;0;0;520.067953604221;497.108383964256;49;1017.17633756848
05;2021-02-04;0;0;0;468.146063921917;510.087601910415;59;978.233665832332
05;2021-02-04;0;0;0;340.368470050554;334.366842191253;69;674.735312241807
05;2021-02-04;0;0;0;212.598666888387;192.597753227106;79;405.196420115493
05;2021-02-04;0;0;0;148.727797095705;61.8681715431829;89;210.595968638888
05;2021-02-04;0;0;0;32.9601271090696;10.9909785719784;90;43.9511056810479
05;2021-02-04;0;1;1;3061.43020057959;2935.56979942041;0;5997
06;2021-02-04;4;0;5;42583;42380;09;84963
06;2021-02-04;49;51;102;33369;31925;19;65294
06;2021-02-04;51;46;97;21571;15080;29;36651
06;2021-02-04;73;47;120;21550;16147;39;37697
06;2021-02-04;60;33;93;14193;13939;49;28132
06;2021-02-04;21;23;44;7171;7597;59;14768
06;2021-02-04;12;7;19;3629;4117;69;7746
06;2021-02-04;1;4;5;1577;1457;79;3034
06;2021-02-04;2;0;2;531;474;89;1005
06;2021-02-04;0;0;0;88;93;90;181
06;2021-02-04;273;211;487;146262;133209;0;279471
07;2021-02-04;0;0;0;485;549;09;1034
07;2021-02-04;0;0;0;403;432;19;835
07;2021-02-04;1;0;1;764;841;29;1605
07;2021-02-04;1;1;2;824;928;39;1752
07;2021-02-04;0;1;1;788;1020;49;1808
07;2021-02-04;1;1;2;678;870;59;1548
07;2021-02-04;0;0;0;360;382;69;742
07;2021-02-04;0;1;1;231;190;79;421
07;2021-02-04;0;0;0;114;67;89;181
07;2021-02-04;0;0;0;24;11;90;35
07;2021-02-04;3;4;7;4671;5290;0;9961
08;2021-02-04;0;0;0;2715.22592983026;2997.75551488675;09;5712.98144471701
08;2021-02-04;1;0;1;2778.51901080978;3160.9156459093;19;5939.43465671908
08;2021-02-04;2;0;2;2080.8882988764;1718.16634315323;29;3799.05464202964
08;2021-02-04;0;1;1;2701.8582062647;1896.52641413317;39;4598.38462039786
08;2021-02-04;0;1;1;3151.45861023308;2460.52498233809;49;5611.98359257117
08;2021-02-04;2;1;3;2620.29868333099;2422.23566154656;59;5042.53434487755
08;2021-02-04;0;0;0;1621.44173420671;1438.58325779464;69;3060.02499200135
08;2021-02-04;0;0;0;626.575909335673;526.358467843651;79;1152.93437717932
08;2021-02-04;0;0;0;205.018522985054;140.993639349697;89;346.012162334751
08;2021-02-04;0;0;0;50.0325684687745;20.62259870351;90;70.6551671722846
08;2021-02-04;5;3;8;18551.3174743414;16782.6825256586;0;35334
11;2021-02-04;102;129;246;783071;811785;09;1594856
11;2021-02-04;287;326;630;761456;784653;19;1546109
11;2021-02-04;455;344;799;850145;801772;29;1651917
11;2021-02-04;436;362;799;914360;843488;39;1757848
11;2021-02-04;413;342;756;845609;826202;49;1671811
11;2021-02-04;301;269;572;793566;745070;59;1538636
11;2021-02-04;219;204;430;628649;549192;69;1177841
11;2021-02-04;107;94;202;434606;358356;79;792962
11;2021-02-04;126;65;191;261425;162933;89;424358
11;2021-02-04;87;27;114;89253;32619;90;121872
11;2021-02-04;2534;2163;4741;6362140;5916070;0;12278210
24;2021-02-04;16;12;31;139720;144686;09;284406
24;2021-02-04;58;47;106;152979;161185;19;314164
24;2021-02-04;67;44;111;122237;126536;29;248773
24;2021-02-04;50;35;85;150359;142009;39;292368
24;2021-02-04;51;43;94;161829;158758;49;320587
24;2021-02-04;47;45;92;172552;168011;59;340563
24;2021-02-04;25;48;73;172509;158177;69;330686
24;2021-02-04;34;28;62;129428;110593;79;240021
24;2021-02-04;31;13;44;87342;56882;89;144224
24;2021-02-04;23;12;35;31210;12071;90;43281
24;2021-02-04;403;327;736;1320165;1238908;0;2559073
27;2021-02-04;12;11;23;143373;149679;09;293052
27;2021-02-04;42;44;87;160962;173003;19;333965
27;2021-02-04;65;54;119;133746;142254;29;276000
27;2021-02-04;59;44;104;160004;155407;39;315411
27;2021-02-04;59;50;109;172333;169564;49;341897
27;2021-02-04;71;76;147;189979;183788;59;373767
27;2021-02-04;43;49;92;192591;178206;69;370797
27;2021-02-04;34;30;64;146876;127546;79;274422
27;2021-02-04;34;16;50;96896;61575;89;158471
27;2021-02-04;34;12;46;33148;12109;90;45257
27;2021-02-04;453;386;841;1429908;1353131;0;2783039
28;2021-02-04;20;17;37;180735;186856;09;367591
28;2021-02-04;57;54;111;200125;213621;19;413746
28;2021-02-04;60;58;119;168922;173007;29;341929
28;2021-02-04;81;42;123;196628;188487;39;385115
28;2021-02-04;77;61;138;205396;201699;49;407095
28;2021-02-04;71;48;119;222002;213866;59;435868
28;2021-02-04;34;35;69;224688;203758;69;428446
28;2021-02-04;31;26;57;163192;135543;79;298735
28;2021-02-04;31;21;52;109691;65377;89;175068
28;2021-02-04;25;8;33;37222;12685;90;49907
28;2021-02-04;487;370;858;1708601;1594899;0;3303500
32;2021-02-04;43;43;88;358062;373689;09;731751
32;2021-02-04;143;134;277;387045;406742;19;793787
32;2021-02-04;151;132;283;342304;348587;29;690891
32;2021-02-04;174;147;321;382485;369972;39;752457
32;2021-02-04;152;169;321;382510;376716;49;759226
32;2021-02-04;135;131;266;386937;376527;59;763464
32;2021-02-04;102;107;209;371211;330938;69;702149
32;2021-02-04;55;72;127;250542;201459;79;452001
32;2021-02-04;86;46;132;163399;89786;89;253185
32;2021-02-04;57;13;70;48384;15367;90;63751
32;2021-02-04;1098;996;2096;3072879;2889783;0;5962662
44;2021-02-04;42;38;81;291525;306839;09;598364
44;2021-02-04;96;105;202;320255;339504;19;659759
44;2021-02-04;123;105;228;302020;314428;29;616448
44;2021-02-04;149;111;260;342222;333292;39;675514
44;2021-02-04;121;101;222;349727;344491;49;694218
44;2021-02-04;125;118;243;381371;373239;59;754610
44;2021-02-04;74;68;143;367165;335850;69;703015
44;2021-02-04;51;44;95;250387;215436;79;465823
44;2021-02-04;42;36;78;170825;105192;89;276017
44;2021-02-04;30;13;43;51248;16731;90;67979
44;2021-02-04;853;739;1596;2826745;2685002;0;5511747
52;2021-02-04;20;11;31;213594;223900;09;437494
52;2021-02-04;65;47;112;240818;255197;19;496015
52;2021-02-04;68;65;133;197010;200630;29;397640
52;2021-02-04;54;55;109;231204;224885;39;456089
52;2021-02-04;56;57;114;243874;243418;49;487292
52;2021-02-04;62;49;111;244100;239116;59;483216
52;2021-02-04;39;26;65;241796;221345;69;463141
52;2021-02-04;22;28;50;177805;149903;79;327708
52;2021-02-04;36;24;60;119561;75822;89;195383
52;2021-02-04;35;7;42;42559;15260;90;57819
52;2021-02-04;457;369;827;1952321;1849476;0;3801797
53;2021-02-04;23;16;39;173813;182358;09;356171
53;2021-02-04;30;30;60;202720;214740;19;417460
53;2021-02-04;59;32;93;163116;173196;29;336312
53;2021-02-04;45;37;82;190526;187674;39;378200
53;2021-02-04;34;39;73;212098;212015;49;424113
53;2021-02-04;33;35;68;223699;219176;59;442875
53;2021-02-04;22;21;43;227435;209274;69;436709
53;2021-02-04;27;16;43;169992;140910;79;310902
53;2021-02-04;40;12;52;118117;69883;89;188000
53;2021-02-04;16;4;20;37370;12267;90;49637
53;2021-02-04;329;242;573;1718886;1621493;0;3340379
75;2021-02-04;30;32;63;293104;305291;09;598395
75;2021-02-04;66;96;162;337141;357785;19;694926
75;2021-02-04;102;87;189;295024;300618;29;595642
75;2021-02-04;92;103;197;347871;331233;39;679104
75;2021-02-04;118;109;227;384742;372771;49;757513
75;2021-02-04;105;105;210;413361;390880;59;804241
75;2021-02-04;83;69;152;425623;384060;69;809683
75;2021-02-04;50;56;106;325086;276298;79;601384
75;2021-02-04;72;29;101;213986;139308;89;353294
75;2021-02-04;45;11;56;77600;28200;90;105800
75;2021-02-04;764;697;1464;3113538;2886444;0;5999982
76;2021-02-04;26;40;66;305956;318589;09;624545
76;2021-02-04;117;130;249;338942;356969;19;695911
76;2021-02-04;148;116;264;316210;319570;29;635780
76;2021-02-04;138;118;256;356758;337587;39;694345
76;2021-02-04;152;138;290;376541;363812;49;740353
76;2021-02-04;136;104;240;402608;383750;59;786358
76;2021-02-04;109;105;214;394889;358997;69;753886
76;2021-02-04;64;54;118;308664;263806;79;572470
76;2021-02-04;89;42;131;195838;129272;89;325110
76;2021-02-04;57;20;77;69372;26728;90;96100
76;2021-02-04;1036;867;1905;3065778;2859080;0;5924858
84;2021-02-04;65;64;129;459549;481088;09;940637
84;2021-02-04;171;186;359;487711;511905;19;999616
84;2021-02-04;218;173;391;443824;451094;29;894918
84;2021-02-04;203;167;370;512522;493262;39;1005784
84;2021-02-04;220;200;421;520248;515106;49;1035354
84;2021-02-04;181;166;347;529611;514848;59;1044459
84;2021-02-04;142;130;273;486720;439940;69;926660
84;2021-02-04;98;94;192;372151;315211;79;687362
84;2021-02-04;88;59;147;237198;150524;89;387722
84;2021-02-04;63;15;78;81185;28680;90;109865
84;2021-02-04;1450;1254;2711;4130719;3901658;0;8032377
93;2021-02-04;33;56;89;268834;283093;09;551927
93;2021-02-04;174;189;364;280751;296087;19;576838
93;2021-02-04;236;187;423;254404;255552;29;509956
93;2021-02-04;241;181;422;310704;288398;39;599102
93;2021-02-04;242;204;447;325559;305827;49;631386
93;2021-02-04;240;216;457;353104;325389;59;678493
93;2021-02-04;160;184;345;336327;296459;69;632786
93;2021-02-04;132;119;251;279820;229699;79;509519
93;2021-02-04;133;78;211;171274;113716;89;284990
93;2021-02-04;98;28;126;58896;21758;90;80654
93;2021-02-04;1690;1442;3136;2639673;2415978;0;5055651
94;2021-02-04;1;1;2;16311;17433;09;33744
94;2021-02-04;0;2;2;16679;18132;19;34811
94;2021-02-04;4;4;8;16782;16579;29;33361
94;2021-02-04;5;0;5;23044;20580;39;43624
94;2021-02-04;6;4;10;23065;22140;49;45205
94;2021-02-04;5;6;11;24549;23421;59;47970
94;2021-02-04;4;5;9;23212;21883;69;45095
94;2021-02-04;1;1;2;19544;17141;79;36685
94;2021-02-04;4;1;5;11227;8178;89;19405
94;2021-02-04;1;0;1;3332;1447;90;4779
94;2021-02-04;31;24;55;177745;166934;0;344679
01;2021-02-05;0;0;0;19979;20155;09;40134
01;2021-02-05;1;1;2;24994;25489;19;50483
01;2021-02-05;1;2;3;17868;16690;29;34558
01;2021-02-05;4;1;5;22328;14821;39;37149
01;2021-02-05;2;1;3;28652;20276;49;48928
01;2021-02-05;3;2;5;33264;27260;59;60524
01;2021-02-05;2;1;3;27135;23978;69;51113
01;2021-02-05;0;3;3;18401;14661;79;33062
01;2021-02-05;0;0;0;9633;6375;89;16008
01;2021-02-05;0;0;0;3410;1510;90;4920
01;2021-02-05;13;11;24;205664;171215;0;376879
02;2021-02-05;0;0;0;16881;17110;09;33991
02;2021-02-05;0;1;1;21410;21604;19;43014
02;2021-02-05;1;2;3;16017;15479;29;31496
02;2021-02-05;3;1;4;19825;14455;39;34280
02;2021-02-05;0;0;0;24719;18248;49;42967
02;2021-02-05;3;1;4;34361;28310;59;62671
02;2021-02-05;1;0;1;28061;24495;69;52556
02;2021-02-05;0;0;0;18231;15278;79;33509
02;2021-02-05;0;0;0;11090;7677;89;18767
02;2021-02-05;0;0;0;3992;1506;90;5498
02;2021-02-05;8;5;13;194587;164162;0;358749
03;2021-02-05;0;1;1;31123;30920;09;62043
03;2021-02-05;4;4;8;29370;29268;19;58638
03;2021-02-05;5;2;7;21458;18963;29;40421
03;2021-02-05;3;2;5;21276;18326;39;39602
03;2021-02-05;3;2;5;18164;16593;49;34757
03;2021-02-05;1;3;4;13469;13557;59;27026
03;2021-02-05;2;3;5;8776;8670;69;17446
03;2021-02-05;1;0;1;3777;3591;79;7368
03;2021-02-05;0;0;0;1649;1072;89;2721
03;2021-02-05;0;0;0;485;184;90;669
03;2021-02-05;19;17;36;149547;141144;0;290691
04;2021-02-05;3;1;4;60314;61377;09;121691
04;2021-02-05;6;7;13;66065;68387;19;134452
04;2021-02-05;9;7;16;51059;47156;29;98215
04;2021-02-05;10;10;20;58788;45780;39;104568
04;2021-02-05;8;5;13;61408;52207;49;113615
04;2021-02-05;14;8;22;64838;60759;59;125597
04;2021-02-05;6;6;12;47008;42843;69;89851
04;2021-02-05;1;3;4;25509;21184;79;46693
04;2021-02-05;0;0;0;13168;7647;89;20815
04;2021-02-05;0;0;0;3209;1253;90;4462
04;2021-02-05;57;47;104;451366;408593;0;859959
05;2021-02-05;0;0;0;362.366008612902;341.338819562748;09;703.704828175651
05;2021-02-05;0;0;0;353.376145114279;370.349735405642;19;723.725880519921
05;2021-02-05;0;0;0;218.593559489256;256.539602589476;29;475.133162078732
05;2021-02-05;0;0;0;404.225408693299;360.321910454353;39;764.547319147651
05;2021-02-05;0;0;0;520.067953604221;497.108383964256;49;1017.17633756848
05;2021-02-05;0;0;0;468.146063921917;510.087601910415;59;978.233665832332
05;2021-02-05;0;0;0;340.368470050554;334.366842191253;69;674.735312241807
05;2021-02-05;0;0;0;212.598666888387;192.597753227106;79;405.196420115493
05;2021-02-05;0;0;0;148.727797095705;61.8681715431829;89;210.595968638888
05;2021-02-05;0;0;0;32.9601271090696;10.9909785719784;90;43.9511056810479
05;2021-02-05;0;0;0;3061.43020057959;2935.56979942041;0;5997
06;2021-02-05;3;6;10;42583;42380;09;84963
06;2021-02-05;40;32;76;33369;31925;19;65294
06;2021-02-05;61;35;96;21571;15080;29;36651
06;2021-02-05;62;41;103;21550;16147;39;37697
06;2021-02-05;37;30;67;14193;13939;49;28132
06;2021-02-05;18;26;44;7171;7597;59;14768
06;2021-02-05;26;29;55;3629;4117;69;7746
06;2021-02-05;3;6;9;1577;1457;79;3034
06;2021-02-05;2;1;3;531;474;89;1005
06;2021-02-05;0;0;0;88;93;90;181
06;2021-02-05;252;206;463;146262;133209;0;279471
07;2021-02-05;0;0;0;485;549;09;1034
07;2021-02-05;0;0;0;403;432;19;835
07;2021-02-05;1;1;2;764;841;29;1605
07;2021-02-05;3;2;5;824;928;39;1752
07;2021-02-05;1;0;1;788;1020;49;1808
07;2021-02-05;2;1;3;678;870;59;1548
07;2021-02-05;0;1;1;360;382;69;742
07;2021-02-05;0;0;0;231;190;79;421
07;2021-02-05;0;0;0;114;67;89;181
07;2021-02-05;0;0;0;24;11;90;35
07;2021-02-05;7;5;12;4671;5290;0;9961
08;2021-02-05;0;0;0;2715.22592983026;2997.75551488675;09;5712.98144471701
08;2021-02-05;0;0;0;2778.51901080978;3160.9156459093;19;5939.43465671908
08;2021-02-05;1;1;2;2080.8882988764;1718.16634315323;29;3799.05464202964
08;2021-02-05;2;0;2;2701.8582062647;1896.52641413317;39;4598.38462039786
08;2021-02-05;1;1;2;3151.45861023308;2460.52498233809;49;5611.98359257117
08;2021-02-05;1;1;2;2620.29868333099;2422.23566154656;59;5042.53434487755
08;2021-02-05;1;1;2;1621.44173420671;1438.58325779464;69;3060.02499200135
08;2021-02-05;0;0;0;626.575909335673;526.358467843651;79;1152.93437717932
08;2021-02-05;0;0;0;205.018522985054;140.993639349697;89;346.012162334751
08;2021-02-05;0;0;0;50.0325684687745;20.62259870351;90;70.6551671722846
08;2021-02-05;6;4;10;18551.3174743414;16782.6825256586;0;35334
11;2021-02-05;136;131;279;783071;811785;09;1594856
11;2021-02-05;401;396;829;761456;784653;19;1546109
11;2021-02-05;453;374;829;850145;801772;29;1651917
11;2021-02-05;439;372;811;914360;843488;39;1757848
11;2021-02-05;394;368;763;845609;826202;49;1671811
11;2021-02-05;351;316;667;793566;745070;59;1538636
11;2021-02-05;210;205;419;628649;549192;69;1177841
11;2021-02-05;113;129;243;434606;358356;79;792962
11;2021-02-05;87;52;140;261425;162933;89;424358
11;2021-02-05;51;19;70;89253;32619;90;121872
11;2021-02-05;2635;2363;5051;6362140;5916070;0;12278210
24;2021-02-05;20;13;35;139720;144686;09;284406
24;2021-02-05;62;80;146;152979;161185;19;314164
24;2021-02-05;51;55;106;122237;126536;29;248773
24;2021-02-05;65;41;106;150359;142009;39;292368
24;2021-02-05;67;62;129;161829;158758;49;320587
24;2021-02-05;59;43;102;172552;168011;59;340563
24;2021-02-05;44;32;76;172509;158177;69;330686
24;2021-02-05;23;23;46;129428;110593;79;240021
24;2021-02-05;38;15;53;87342;56882;89;144224
24;2021-02-05;20;5;25;31210;12071;90;43281
24;2021-02-05;449;369;824;1320165;1238908;0;2559073
27;2021-02-05;16;18;34;143373;149679;09;293052
27;2021-02-05;55;59;114;160962;173003;19;333965
27;2021-02-05;53;65;118;133746;142254;29;276000
27;2021-02-05;60;52;112;160004;155407;39;315411
27;2021-02-05;72;51;123;172333;169564;49;341897
27;2021-02-05;66;53;119;189979;183788;59;373767
27;2021-02-05;52;46;98;192591;178206;69;370797
27;2021-02-05;33;38;71;146876;127546;79;274422
27;2021-02-05;36;24;60;96896;61575;89;158471
27;2021-02-05;26;11;37;33148;12109;90;45257
27;2021-02-05;469;417;886;1429908;1353131;0;2783039
28;2021-02-05;31;27;58;180735;186856;09;367591
28;2021-02-05;57;58;116;200125;213621;19;413746
28;2021-02-05;51;44;95;168922;173007;29;341929
28;2021-02-05;73;51;124;196628;188487;39;385115
28;2021-02-05;69;52;121;205396;201699;49;407095
28;2021-02-05;65;50;115;222002;213866;59;435868
28;2021-02-05;51;46;97;224688;203758;69;428446
28;2021-02-05;46;40;86;163192;135543;79;298735
28;2021-02-05;43;19;62;109691;65377;89;175068
28;2021-02-05;19;5;24;37222;12685;90;49907
28;2021-02-05;505;392;898;1708601;1594899;0;3303500
32;2021-02-05;47;67;114;358062;373689;09;731751
32;2021-02-05;160;140;301;387045;406742;19;793787
32;2021-02-05;182;151;334;342304;348587;29;690891
32;2021-02-05;189;149;338;382485;369972;39;752457
32;2021-02-05;186;146;332;382510;376716;49;759226
32;2021-02-05;146;145;291;386937;376527;59;763464
32;2021-02-05;121;107;228;371211;330938;69;702149
32;2021-02-05;93;66;159;250542;201459;79;452001
32;2021-02-05;73;38;112;163399;89786;89;253185
32;2021-02-05;46;7;53;48384;15367;90;63751
32;2021-02-05;1244;1016;2263;3072879;2889783;0;5962662
44;2021-02-05;50;41;91;291525;306839;09;598364
44;2021-02-05;173;177;351;320255;339504;19;659759
44;2021-02-05;127;118;246;302020;314428;29;616448
44;2021-02-05;159;133;292;342222;333292;39;675514
44;2021-02-05;148;112;260;349727;344491;49;694218
44;2021-02-05;137;131;268;381371;373239;59;754610
44;2021-02-05;76;83;161;367165;335850;69;703015
44;2021-02-05;62;61;124;250387;215436;79;465823
44;2021-02-05;57;37;95;170825;105192;89;276017
44;2021-02-05;20;10;32;51248;16731;90;67979
44;2021-02-05;1009;903;1923;2826745;2685002;0;5511747
52;2021-02-05;22;18;40;213594;223900;09;437494
52;2021-02-05;76;80;158;240818;255197;19;496015
52;2021-02-05;60;79;139;197010;200630;29;397640
52;2021-02-05;76;42;118;231204;224885;39;456089
52;2021-02-05;63;48;111;243874;243418;49;487292
52;2021-02-05;58;61;119;244100;239116;59;483216
52;2021-02-05;36;42;78;241796;221345;69;463141
52;2021-02-05;26;31;57;177805;149903;79;327708
52;2021-02-05;25;16;41;119561;75822;89;195383
52;2021-02-05;28;5;33;42559;15260;90;57819
52;2021-02-05;470;422;894;1952321;1849476;0;3801797
53;2021-02-05;18;17;36;173813;182358;09;356171
53;2021-02-05;55;53;109;202720;214740;19;417460
53;2021-02-05;57;45;104;163116;173196;29;336312
53;2021-02-05;36;31;67;190526;187674;39;378200
53;2021-02-05;40;40;80;212098;212015;49;424113
53;2021-02-05;38;35;73;223699;219176;59;442875
53;2021-02-05;29;21;50;227435;209274;69;436709
53;2021-02-05;17;18;35;169992;140910;79;310902
53;2021-02-05;25;13;38;118117;69883;89;188000
53;2021-02-05;12;6;18;37370;12267;90;49637
53;2021-02-05;327;279;610;1718886;1621493;0;3340379
75;2021-02-05;31;47;79;293104;305291;09;598395
75;2021-02-05;86;89;175;337141;357785;19;694926
75;2021-02-05;121;82;204;295024;300618;29;595642
75;2021-02-05;111;79;190;347871;331233;39;679104
75;2021-02-05;101;80;181;384742;372771;49;757513
75;2021-02-05;91;117;208;413361;390880;59;804241
75;2021-02-05;73;86;159;425623;384060;69;809683
75;2021-02-05;47;54;101;325086;276298;79;601384
75;2021-02-05;59;40;99;213986;139308;89;353294
75;2021-02-05;49;14;63;77600;28200;90;105800
75;2021-02-05;770;688;1460;3113538;2886444;0;5999982
76;2021-02-05;43;41;87;305956;318589;09;624545
76;2021-02-05;119;134;255;338942;356969;19;695911
76;2021-02-05;140;130;270;316210;319570;29;635780
76;2021-02-05;165;115;280;356758;337587;39;694345
76;2021-02-05;152;114;266;376541;363812;49;740353
76;2021-02-05;136;125;261;402608;383750;59;786358
76;2021-02-05;109;113;222;394889;358997;69;753886
76;2021-02-05;74;58;132;308664;263806;79;572470
76;2021-02-05;68;43;111;195838;129272;89;325110
76;2021-02-05;46;21;67;69372;26728;90;96100
76;2021-02-05;1052;894;1951;3065778;2859080;0;5924858
84;2021-02-05;58;59;117;459549;481088;09;940637
84;2021-02-05;212;209;422;487711;511905;19;999616
84;2021-02-05;212;193;405;443824;451094;29;894918
84;2021-02-05;204;180;384;512522;493262;39;1005784
84;2021-02-05;222;190;412;520248;515106;49;1035354
84;2021-02-05;180;183;363;529611;514848;59;1044459
84;2021-02-05;136;141;277;486720;439940;69;926660
84;2021-02-05;107;95;202;372151;315211;79;687362
84;2021-02-05;84;64;148;237198;150524;89;387722
84;2021-02-05;53;17;70;81185;28680;90;109865
84;2021-02-05;1468;1331;2800;4130719;3901658;0;8032377
93;2021-02-05;45;62;107;268834;283093;09;551927
93;2021-02-05;208;214;424;280751;296087;19;576838
93;2021-02-05;233;203;437;254404;255552;29;509956
93;2021-02-05;257;185;442;310704;288398;39;599102
93;2021-02-05;238;219;457;325559;305827;49;631386
93;2021-02-05;235;207;442;353104;325389;59;678493
93;2021-02-05;175;158;333;336327;296459;69;632786
93;2021-02-05;111;108;219;279820;229699;79;509519
93;2021-02-05;84;67;151;171274;113716;89;284990
93;2021-02-05;73;29;102;58896;21758;90;80654
93;2021-02-05;1659;1452;3114;2639673;2415978;0;5055651
94;2021-02-05;0;0;1;16311;17433;09;33744
94;2021-02-05;4;5;9;16679;18132;19;34811
94;2021-02-05;3;4;7;16782;16579;29;33361
94;2021-02-05;4;11;15;23044;20580;39;43624
94;2021-02-05;4;2;6;23065;22140;49;45205
94;2021-02-05;3;10;13;24549;23421;59;47970
94;2021-02-05;9;6;15;23212;21883;69;45095
94;2021-02-05;2;2;4;19544;17141;79;36685
94;2021-02-05;0;3;3;11227;8178;89;19405
94;2021-02-05;0;1;1;3332;1447;90;4779
94;2021-02-05;29;44;74;177745;166934;0;344679
01;2021-02-06;0;0;0;19979;20155;09;40134
01;2021-02-06;1;1;2;24994;25489;19;50483
01;2021-02-06;1;0;1;17868;16690;29;34558
01;2021-02-06;1;0;1;22328;14821;39;37149
01;2021-02-06;1;0;1;28652;20276;49;48928
01;2021-02-06;0;2;2;33264;27260;59;60524
01;2021-02-06;0;0;0;27135;23978;69;51113
01;2021-02-06;0;0;0;18401;14661;79;33062
01;2021-02-06;0;0;0;9633;6375;89;16008
01;2021-02-06;0;0;0;3410;1510;90;4920
01;2021-02-06;4;3;7;205664;171215;0;376879
02;2021-02-06;0;0;0;16881;17110;09;33991
02;2021-02-06;0;1;1;21410;21604;19;43014
02;2021-02-06;0;0;0;16017;15479;29;31496
02;2021-02-06;0;0;0;19825;14455;39;34280
02;2021-02-06;0;0;0;24719;18248;49;42967
02;2021-02-06;1;0;1;34361;28310;59;62671
02;2021-02-06;0;0;0;28061;24495;69;52556
02;2021-02-06;0;0;0;18231;15278;79;33509
02;2021-02-06;0;0;0;11090;7677;89;18767
02;2021-02-06;0;0;0;3992;1506;90;5498
02;2021-02-06;1;1;2;194587;164162;0;358749
03;2021-02-06;0;0;0;31123;30920;09;62043
03;2021-02-06;1;0;1;29370;29268;19;58638
03;2021-02-06;3;0;3;21458;18963;29;40421
03;2021-02-06;1;1;2;21276;18326;39;39602
03;2021-02-06;0;1;1;18164;16593;49;34757
03;2021-02-06;0;1;1;13469;13557;59;27026
03;2021-02-06;1;0;1;8776;8670;69;17446
03;2021-02-06;0;0;0;3777;3591;79;7368
03;2021-02-06;0;0;0;1649;1072;89;2721
03;2021-02-06;0;0;0;485;184;90;669
03;2021-02-06;6;3;9;149547;141144;0;290691
04;2021-02-06;1;2;3;60314;61377;09;121691
04;2021-02-06;10;6;16;66065;68387;19;134452
04;2021-02-06;6;5;11;51059;47156;29;98215
04;2021-02-06;4;2;6;58788;45780;39;104568
04;2021-02-06;7;4;11;61408;52207;49;113615
04;2021-02-06;4;0;4;64838;60759;59;125597
04;2021-02-06;1;3;4;47008;42843;69;89851
04;2021-02-06;0;0;0;25509;21184;79;46693
04;2021-02-06;0;0;0;13168;7647;89;20815
04;2021-02-06;1;0;1;3209;1253;90;4462
04;2021-02-06;34;22;56;451366;408593;0;859959
05;2021-02-06;0;0;0;362.366008612902;341.338819562748;09;703.704828175651
05;2021-02-06;0;0;0;353.376145114279;370.349735405642;19;723.725880519921
05;2021-02-06;0;0;0;218.593559489256;256.539602589476;29;475.133162078732
05;2021-02-06;0;0;0;404.225408693299;360.321910454353;39;764.547319147651
05;2021-02-06;0;0;0;520.067953604221;497.108383964256;49;1017.17633756848
05;2021-02-06;0;0;0;468.146063921917;510.087601910415;59;978.233665832332
05;2021-02-06;0;0;0;340.368470050554;334.366842191253;69;674.735312241807
05;2021-02-06;0;0;0;212.598666888387;192.597753227106;79;405.196420115493
05;2021-02-06;0;0;0;148.727797095705;61.8681715431829;89;210.595968638888
05;2021-02-06;0;0;0;32.9601271090696;10.9909785719784;90;43.9511056810479
05;2021-02-06;0;0;0;3061.43020057959;2935.56979942041;0;5997
06;2021-02-06;0;1;1;42583;42380;09;84963
06;2021-02-06;16;4;20;33369;31925;19;65294
06;2021-02-06;22;18;40;21571;15080;29;36651
06;2021-02-06;25;10;35;21550;16147;39;37697
06;2021-02-06;19;18;37;14193;13939;49;28132
06;2021-02-06;7;9;16;7171;7597;59;14768
06;2021-02-06;5;7;12;3629;4117;69;7746
06;2021-02-06;0;2;2;1577;1457;79;3034
06;2021-02-06;2;2;4;531;474;89;1005
06;2021-02-06;0;0;0;88;93;90;181
06;2021-02-06;96;71;167;146262;133209;0;279471
07;2021-02-06;0;0;0;485;549;09;1034
07;2021-02-06;0;0;0;403;432;19;835
07;2021-02-06;0;0;0;764;841;29;1605
07;2021-02-06;0;0;0;824;928;39;1752
07;2021-02-06;0;1;1;788;1020;49;1808
07;2021-02-06;3;0;3;678;870;59;1548
07;2021-02-06;0;0;0;360;382;69;742
07;2021-02-06;0;0;0;231;190;79;421
07;2021-02-06;0;0;0;114;67;89;181
07;2021-02-06;0;0;0;24;11;90;35
07;2021-02-06;3;1;4;4671;5290;0;9961
08;2021-02-06;0;0;0;2715.22592983026;2997.75551488675;09;5712.98144471701
08;2021-02-06;0;0;0;2778.51901080978;3160.9156459093;19;5939.43465671908
08;2021-02-06;1;2;3;2080.8882988764;1718.16634315323;29;3799.05464202964
08;2021-02-06;1;0;1;2701.8582062647;1896.52641413317;39;4598.38462039786
08;2021-02-06;0;1;1;3151.45861023308;2460.52498233809;49;5611.98359257117
08;2021-02-06;1;0;1;2620.29868333099;2422.23566154656;59;5042.53434487755
08;2021-02-06;1;0;1;1621.44173420671;1438.58325779464;69;3060.02499200135
08;2021-02-06;0;0;0;626.575909335673;526.358467843651;79;1152.93437717932
08;2021-02-06;0;0;0;205.018522985054;140.993639349697;89;346.012162334751
08;2021-02-06;0;0;0;50.0325684687745;20.62259870351;90;70.6551671722846
08;2021-02-06;4;3;7;18551.3174743414;16782.6825256586;0;35334
11;2021-02-06;86;82;174;783071;811785;09;1594856
11;2021-02-06;239;241;492;761456;784653;19;1546109
11;2021-02-06;225;199;424;850145;801772;29;1651917
11;2021-02-06;254;246;500;914360;843488;39;1757848
11;2021-02-06;224;217;441;845609;826202;49;1671811
11;2021-02-06;187;188;375;793566;745070;59;1538636
11;2021-02-06;139;115;261;628649;549192;69;1177841
11;2021-02-06;56;63;119;434606;358356;79;792962
11;2021-02-06;41;26;67;261425;162933;89;424358
11;2021-02-06;28;8;36;89253;32619;90;121872
11;2021-02-06;1480;1385;2890;6362140;5916070;0;12278210
24;2021-02-06;10;9;19;139720;144686;09;284406
24;2021-02-06;27;20;48;152979;161185;19;314164
24;2021-02-06;31;27;58;122237;126536;29;248773
24;2021-02-06;32;28;60;150359;142009;39;292368
24;2021-02-06;45;37;82;161829;158758;49;320587
24;2021-02-06;30;27;57;172552;168011;59;340563
24;2021-02-06;12;22;34;172509;158177;69;330686
24;2021-02-06;10;4;14;129428;110593;79;240021
24;2021-02-06;14;7;21;87342;56882;89;144224
24;2021-02-06;2;1;3;31210;12071;90;43281
24;2021-02-06;213;182;396;1320165;1238908;0;2559073
27;2021-02-06;5;19;24;143373;149679;09;293052
27;2021-02-06;29;32;61;160962;173003;19;333965
27;2021-02-06;43;23;66;133746;142254;29;276000
27;2021-02-06;37;31;68;160004;155407;39;315411
27;2021-02-06;35;31;66;172333;169564;49;341897
27;2021-02-06;35;43;78;189979;183788;59;373767
27;2021-02-06;24;28;52;192591;178206;69;370797
27;2021-02-06;17;25;42;146876;127546;79;274422
27;2021-02-06;20;16;36;96896;61575;89;158471
27;2021-02-06;10;6;16;33148;12109;90;45257
27;2021-02-06;255;254;509;1429908;1353131;0;2783039
28;2021-02-06;12;13;25;180735;186856;09;367591
28;2021-02-06;28;29;57;200125;213621;19;413746
28;2021-02-06;32;21;53;168922;173007;29;341929
28;2021-02-06;37;28;65;196628;188487;39;385115
28;2021-02-06;42;20;62;205396;201699;49;407095
28;2021-02-06;28;30;58;222002;213866;59;435868
28;2021-02-06;25;32;57;224688;203758;69;428446
28;2021-02-06;15;28;43;163192;135543;79;298735
28;2021-02-06;16;10;26;109691;65377;89;175068
28;2021-02-06;7;1;8;37222;12685;90;49907
28;2021-02-06;242;212;454;1708601;1594899;0;3303500
32;2021-02-06;39;53;92;358062;373689;09;731751
32;2021-02-06;110;101;211;387045;406742;19;793787
32;2021-02-06;116;87;203;342304;348587;29;690891
32;2021-02-06;127;128;255;382485;369972;39;752457
32;2021-02-06;133;119;252;382510;376716;49;759226
32;2021-02-06;100;98;198;386937;376527;59;763464
32;2021-02-06;86;71;157;371211;330938;69;702149
32;2021-02-06;63;48;111;250542;201459;79;452001
32;2021-02-06;32;15;48;163399;89786;89;253185
32;2021-02-06;16;5;21;48384;15367;90;63751
32;2021-02-06;823;725;1549;3072879;2889783;0;5962662
44;2021-02-06;29;43;72;291525;306839;09;598364
44;2021-02-06;89;92;181;320255;339504;19;659759
44;2021-02-06;92;96;188;302020;314428;29;616448
44;2021-02-06;92;87;179;342222;333292;39;675514
44;2021-02-06;103;74;177;349727;344491;49;694218
44;2021-02-06;77;91;168;381371;373239;59;754610
44;2021-02-06;56;54;110;367165;335850;69;703015
44;2021-02-06;35;27;62;250387;215436;79;465823
44;2021-02-06;27;18;45;170825;105192;89;276017
44;2021-02-06;19;7;26;51248;16731;90;67979
44;2021-02-06;619;589;1208;2826745;2685002;0;5511747
52;2021-02-06;20;11;31;213594;223900;09;437494
52;2021-02-06;40;35;78;240818;255197;19;496015
52;2021-02-06;37;36;73;197010;200630;29;397640
52;2021-02-06;40;29;69;231204;224885;39;456089
52;2021-02-06;38;41;79;243874;243418;49;487292
52;2021-02-06;33;42;75;244100;239116;59;483216
52;2021-02-06;28;26;54;241796;221345;69;463141
52;2021-02-06;17;22;39;177805;149903;79;327708
52;2021-02-06;20;15;35;119561;75822;89;195383
52;2021-02-06;4;2;6;42559;15260;90;57819
52;2021-02-06;277;259;539;1952321;1849476;0;3801797
53;2021-02-06;12;12;24;173813;182358;09;356171
53;2021-02-06;28;35;64;202720;214740;19;417460
53;2021-02-06;29;31;60;163116;173196;29;336312
53;2021-02-06;23;37;60;190526;187674;39;378200
53;2021-02-06;22;15;37;212098;212015;49;424113
53;2021-02-06;17;18;35;223699;219176;59;442875
53;2021-02-06;16;15;31;227435;209274;69;436709
53;2021-02-06;9;12;21;169992;140910;79;310902
53;2021-02-06;13;6;19;118117;69883;89;188000
53;2021-02-06;7;3;10;37370;12267;90;49637
53;2021-02-06;176;184;361;1718886;1621493;0;3340379
75;2021-02-06;23;18;41;293104;305291;09;598395
75;2021-02-06;42;53;96;337141;357785;19;694926
75;2021-02-06;55;46;101;295024;300618;29;595642
75;2021-02-06;56;60;116;347871;331233;39;679104
75;2021-02-06;56;66;122;384742;372771;49;757513
75;2021-02-06;52;58;110;413361;390880;59;804241
75;2021-02-06;32;41;73;425623;384060;69;809683
75;2021-02-06;27;17;44;325086;276298;79;601384
75;2021-02-06;28;15;43;213986;139308;89;353294
75;2021-02-06;19;8;27;77600;28200;90;105800
75;2021-02-06;390;382;773;3113538;2886444;0;5999982
76;2021-02-06;14;16;31;305956;318589;09;624545
76;2021-02-06;71;63;135;338942;356969;19;695911
76;2021-02-06;77;62;139;316210;319570;29;635780
76;2021-02-06;80;64;144;356758;337587;39;694345
76;2021-02-06;58;74;132;376541;363812;49;740353
76;2021-02-06;60;73;133;402608;383750;59;786358
76;2021-02-06;59;44;103;394889;358997;69;753886
76;2021-02-06;31;28;59;308664;263806;79;572470
76;2021-02-06;17;27;44;195838;129272;89;325110
76;2021-02-06;20;5;25;69372;26728;90;96100
76;2021-02-06;487;456;945;3065778;2859080;0;5924858
84;2021-02-06;23;38;61;459549;481088;09;940637
84;2021-02-06;119;111;230;487711;511905;19;999616
84;2021-02-06;115;103;218;443824;451094;29;894918
84;2021-02-06;147;117;264;512522;493262;39;1005784
84;2021-02-06;130;130;260;520248;515106;49;1035354
84;2021-02-06;95;99;194;529611;514848;59;1044459
84;2021-02-06;83;70;153;486720;439940;69;926660
84;2021-02-06;58;40;98;372151;315211;79;687362
84;2021-02-06;45;32;77;237198;150524;89;387722
84;2021-02-06;20;9;29;81185;28680;90;109865
84;2021-02-06;835;749;1584;4130719;3901658;0;8032377
93;2021-02-06;21;21;42;268834;283093;09;551927
93;2021-02-06;93;80;173;280751;296087;19;576838
93;2021-02-06;125;82;207;254404;255552;29;509956
93;2021-02-06;133;105;238;310704;288398;39;599102
93;2021-02-06;156;135;291;325559;305827;49;631386
93;2021-02-06;123;111;234;353104;325389;59;678493
93;2021-02-06;80;74;155;336327;296459;69;632786
93;2021-02-06;50;49;99;279820;229699;79;509519
93;2021-02-06;45;39;84;171274;113716;89;284990
93;2021-02-06;25;6;31;58896;21758;90;80654
93;2021-02-06;851;702;1554;2639673;2415978;0;5055651
94;2021-02-06;2;1;3;16311;17433;09;33744
94;2021-02-06;2;3;6;16679;18132;19;34811
94;2021-02-06;4;1;5;16782;16579;29;33361
94;2021-02-06;2;1;3;23044;20580;39;43624
94;2021-02-06;2;4;6;23065;22140;49;45205
94;2021-02-06;2;3;5;24549;23421;59;47970
94;2021-02-06;2;1;3;23212;21883;69;45095
94;2021-02-06;1;0;1;19544;17141;79;36685
94;2021-02-06;1;1;2;11227;8178;89;19405
94;2021-02-06;0;0;0;3332;1447;90;4779
94;2021-02-06;18;15;34;177745;166934;0;344679
01;2021-02-07;0;0;0;19979;20155;09;40134
01;2021-02-07;0;0;0;24994;25489;19;50483
01;2021-02-07;0;0;0;17868;16690;29;34558
01;2021-02-07;1;0;1;22328;14821;39;37149
01;2021-02-07;0;0;0;28652;20276;49;48928
01;2021-02-07;0;0;0;33264;27260;59;60524
01;2021-02-07;1;0;1;27135;23978;69;51113
01;2021-02-07;0;0;0;18401;14661;79;33062
01;2021-02-07;1;0;1;9633;6375;89;16008
01;2021-02-07;0;0;0;3410;1510;90;4920
01;2021-02-07;3;0;3;205664;171215;0;376879
02;2021-02-07;0;0;0;16881;17110;09;33991
02;2021-02-07;0;0;0;21410;21604;19;43014
02;2021-02-07;1;0;1;16017;15479;29;31496
02;2021-02-07;1;0;1;19825;14455;39;34280
02;2021-02-07;0;0;0;24719;18248;49;42967
02;2021-02-07;0;0;0;34361;28310;59;62671
02;2021-02-07;0;0;0;28061;24495;69;52556
02;2021-02-07;0;0;0;18231;15278;79;33509
02;2021-02-07;0;0;0;11090;7677;89;18767
02;2021-02-07;0;0;0;3992;1506;90;5498
02;2021-02-07;2;0;2;194587;164162;0;358749
03;2021-02-07;0;0;0;31123;30920;09;62043
03;2021-02-07;0;0;0;29370;29268;19;58638
03;2021-02-07;1;0;1;21458;18963;29;40421
03;2021-02-07;0;1;1;21276;18326;39;39602
03;2021-02-07;0;1;1;18164;16593;49;34757
03;2021-02-07;0;0;0;13469;13557;59;27026
03;2021-02-07;1;3;4;8776;8670;69;17446
03;2021-02-07;0;0;0;3777;3591;79;7368
03;2021-02-07;1;0;1;1649;1072;89;2721
03;2021-02-07;0;0;0;485;184;90;669
03;2021-02-07;3;5;8;149547;141144;0;290691
04;2021-02-07;0;1;1;60314;61377;09;121691
04;2021-02-07;3;1;4;66065;68387;19;134452
04;2021-02-07;0;4;4;51059;47156;29;98215
04;2021-02-07;1;1;2;58788;45780;39;104568
04;2021-02-07;0;3;3;61408;52207;49;113615
04;2021-02-07;0;1;1;64838;60759;59;125597
04;2021-02-07;1;2;3;47008;42843;69;89851
04;2021-02-07;0;0;0;25509;21184;79;46693
04;2021-02-07;1;0;1;13168;7647;89;20815
04;2021-02-07;0;0;0;3209;1253;90;4462
04;2021-02-07;6;13;19;451366;408593;0;859959
05;2021-02-07;0;0;0;362.366008612902;341.338819562748;09;703.704828175651
05;2021-02-07;0;0;0;353.376145114279;370.349735405642;19;723.725880519921
05;2021-02-07;0;0;0;218.593559489256;256.539602589476;29;475.133162078732
05;2021-02-07;0;0;0;404.225408693299;360.321910454353;39;764.547319147651
05;2021-02-07;0;0;0;520.067953604221;497.108383964256;49;1017.17633756848
05;2021-02-07;0;0;0;468.146063921917;510.087601910415;59;978.233665832332
05;2021-02-07;0;0;0;340.368470050554;334.366842191253;69;674.735312241807
05;2021-02-07;0;0;0;212.598666888387;192.597753227106;79;405.196420115493
05;2021-02-07;0;0;0;148.727797095705;61.8681715431829;89;210.595968638888
05;2021-02-07;0;0;0;32.9601271090696;10.9909785719784;90;43.9511056810479
05;2021-02-07;0;0;0;3061.43020057959;2935.56979942041;0;5997
06;2021-02-07;0;1;1;42583;42380;09;84963
06;2021-02-07;5;3;8;33369;31925;19;65294
06;2021-02-07;10;6;16;21571;15080;29;36651
06;2021-02-07;7;3;10;21550;16147;39;37697
06;2021-02-07;8;6;14;14193;13939;49;28132
06;2021-02-07;3;3;6;7171;7597;59;14768
06;2021-02-07;13;11;24;3629;4117;69;7746
06;2021-02-07;1;1;2;1577;1457;79;3034
06;2021-02-07;0;0;0;531;474;89;1005
06;2021-02-07;0;0;0;88;93;90;181
06;2021-02-07;47;34;81;146262;133209;0;279471
07;2021-02-07;0;0;0;485;549;09;1034
07;2021-02-07;0;0;0;403;432;19;835
07;2021-02-07;0;0;0;764;841;29;1605
07;2021-02-07;0;1;1;824;928;39;1752
07;2021-02-07;0;0;0;788;1020;49;1808
07;2021-02-07;0;0;0;678;870;59;1548
07;2021-02-07;0;0;0;360;382;69;742
07;2021-02-07;0;0;0;231;190;79;421
07;2021-02-07;0;0;0;114;67;89;181
07;2021-02-07;0;0;0;24;11;90;35
07;2021-02-07;0;1;1;4671;5290;0;9961
08;2021-02-07;0;0;0;2715.22592983026;2997.75551488675;09;5712.98144471701
08;2021-02-07;0;1;1;2778.51901080978;3160.9156459093;19;5939.43465671908
08;2021-02-07;0;0;0;2080.8882988764;1718.16634315323;29;3799.05464202964
08;2021-02-07;0;0;0;2701.8582062647;1896.52641413317;39;4598.38462039786
08;2021-02-07;0;0;0;3151.45861023308;2460.52498233809;49;5611.98359257117
08;2021-02-07;1;0;1;2620.29868333099;2422.23566154656;59;5042.53434487755
08;2021-02-07;0;0;0;1621.44173420671;1438.58325779464;69;3060.02499200135
08;2021-02-07;0;0;0;626.575909335673;526.358467843651;79;1152.93437717932
08;2021-02-07;0;0;0;205.018522985054;140.993639349697;89;346.012162334751
08;2021-02-07;0;0;0;50.0325684687745;20.62259870351;90;70.6551671722846
08;2021-02-07;1;1;2;18551.3174743414;16782.6825256586;0;35334
11;2021-02-07;19;19;38;783071;811785;09;1594856
11;2021-02-07;43;34;79;761456;784653;19;1546109
11;2021-02-07;63;63;126;850145;801772;29;1651917
11;2021-02-07;71;63;134;914360;843488;39;1757848
11;2021-02-07;63;63;126;845609;826202;49;1671811
11;2021-02-07;46;61;107;793566;745070;59;1538636
11;2021-02-07;24;42;66;628649;549192;69;1177841
11;2021-02-07;19;25;44;434606;358356;79;792962
11;2021-02-07;22;14;36;261425;162933;89;424358
11;2021-02-07;13;5;18;89253;32619;90;121872
11;2021-02-07;383;389;774;6362140;5916070;0;12278210
24;2021-02-07;1;0;1;139720;144686;09;284406
24;2021-02-07;8;1;9;152979;161185;19;314164
24;2021-02-07;5;2;7;122237;126536;29;248773
24;2021-02-07;7;6;13;150359;142009;39;292368
24;2021-02-07;9;8;17;161829;158758;49;320587
24;2021-02-07;3;4;7;172552;168011;59;340563
24;2021-02-07;8;3;11;172509;158177;69;330686
24;2021-02-07;4;6;10;129428;110593;79;240021
24;2021-02-07;8;1;9;87342;56882;89;144224
24;2021-02-07;4;1;5;31210;12071;90;43281
24;2021-02-07;57;32;89;1320165;1238908;0;2559073
27;2021-02-07;1;0;1;143373;149679;09;293052
27;2021-02-07;1;0;1;160962;173003;19;333965
27;2021-02-07;4;3;7;133746;142254;29;276000
27;2021-02-07;4;4;8;160004;155407;39;315411
27;2021-02-07;4;4;8;172333;169564;49;341897
27;2021-02-07;7;8;15;189979;183788;59;373767
27;2021-02-07;9;3;12;192591;178206;69;370797
27;2021-02-07;6;6;12;146876;127546;79;274422
27;2021-02-07;5;5;10;96896;61575;89;158471
27;2021-02-07;1;1;2;33148;12109;90;45257
27;2021-02-07;42;34;76;1429908;1353131;0;2783039
28;2021-02-07;2;2;4;180735;186856;09;367591
28;2021-02-07;4;5;9;200125;213621;19;413746
28;2021-02-07;3;5;8;168922;173007;29;341929
28;2021-02-07;6;6;12;196628;188487;39;385115
28;2021-02-07;9;3;12;205396;201699;49;407095
28;2021-02-07;1;5;6;222002;213866;59;435868
28;2021-02-07;4;6;10;224688;203758;69;428446
28;2021-02-07;4;2;6;163192;135543;79;298735
28;2021-02-07;2;4;6;109691;65377;89;175068
28;2021-02-07;3;2;5;37222;12685;90;49907
28;2021-02-07;38;40;78;1708601;1594899;0;3303500
32;2021-02-07;5;8;13;358062;373689;09;731751
32;2021-02-07;20;10;30;387045;406742;19;793787
32;2021-02-07;29;16;45;342304;348587;29;690891
32;2021-02-07;27;24;51;382485;369972;39;752457
32;2021-02-07;20;18;38;382510;376716;49;759226
32;2021-02-07;19;17;36;386937;376527;59;763464
32;2021-02-07;10;20;30;371211;330938;69;702149
32;2021-02-07;8;9;17;250542;201459;79;452001
32;2021-02-07;9;8;17;163399;89786;89;253185
32;2021-02-07;8;3;11;48384;15367;90;63751
32;2021-02-07;156;133;289;3072879;2889783;0;5962662
44;2021-02-07;3;3;6;291525;306839;09;598364
44;2021-02-07;6;8;14;320255;339504;19;659759
44;2021-02-07;6;12;18;302020;314428;29;616448
44;2021-02-07;22;11;33;342222;333292;39;675514
44;2021-02-07;9;6;15;349727;344491;49;694218
44;2021-02-07;10;13;23;381371;373239;59;754610
44;2021-02-07;5;15;20;367165;335850;69;703015
44;2021-02-07;6;15;21;250387;215436;79;465823
44;2021-02-07;11;10;21;170825;105192;89;276017
44;2021-02-07;8;2;10;51248;16731;90;67979
44;2021-02-07;86;95;181;2826745;2685002;0;5511747
52;2021-02-07;3;7;10;213594;223900;09;437494
52;2021-02-07;15;14;29;240818;255197;19;496015
52;2021-02-07;13;9;22;197010;200630;29;397640
52;2021-02-07;8;10;18;231204;224885;39;456089
52;2021-02-07;11;11;22;243874;243418;49;487292
52;2021-02-07;17;11;28;244100;239116;59;483216
52;2021-02-07;7;10;17;241796;221345;69;463141
52;2021-02-07;4;7;11;177805;149903;79;327708
52;2021-02-07;9;7;16;119561;75822;89;195383
52;2021-02-07;4;4;8;42559;15260;90;57819
52;2021-02-07;91;90;181;1952321;1849476;0;3801797
53;2021-02-07;0;6;6;173813;182358;09;356171
53;2021-02-07;5;3;8;202720;214740;19;417460
53;2021-02-07;4;4;8;163116;173196;29;336312
53;2021-02-07;1;7;8;190526;187674;39;378200
53;2021-02-07;4;4;8;212098;212015;49;424113
53;2021-02-07;5;3;8;223699;219176;59;442875
53;2021-02-07;3;4;7;227435;209274;69;436709
53;2021-02-07;2;0;2;169992;140910;79;310902
53;2021-02-07;4;3;7;118117;69883;89;188000
53;2021-02-07;0;0;0;37370;12267;90;49637
53;2021-02-07;28;34;62;1718886;1621493;0;3340379
75;2021-02-07;4;5;9;293104;305291;09;598395
75;2021-02-07;2;5;7;337141;357785;19;694926
75;2021-02-07;5;2;7;295024;300618;29;595642
75;2021-02-07;6;10;16;347871;331233;39;679104
75;2021-02-07;8;9;17;384742;372771;49;757513
75;2021-02-07;9;7;16;413361;390880;59;804241
75;2021-02-07;5;8;13;425623;384060;69;809683
75;2021-02-07;5;8;13;325086;276298;79;601384
75;2021-02-07;10;6;16;213986;139308;89;353294
75;2021-02-07;6;2;8;77600;28200;90;105800
75;2021-02-07;60;62;122;3113538;2886444;0;5999982
76;2021-02-07;6;5;11;305956;318589;09;624545
76;2021-02-07;12;13;25;338942;356969;19;695911
76;2021-02-07;21;15;36;316210;319570;29;635780
76;2021-02-07;19;14;33;356758;337587;39;694345
76;2021-02-07;19;17;36;376541;363812;49;740353
76;2021-02-07;12;12;24;402608;383750;59;786358
76;2021-02-07;5;10;15;394889;358997;69;753886
76;2021-02-07;9;6;15;308664;263806;79;572470
76;2021-02-07;9;7;16;195838;129272;89;325110
76;2021-02-07;10;4;14;69372;26728;90;96100
76;2021-02-07;122;103;225;3065778;2859080;0;5924858
84;2021-02-07;6;8;14;459549;481088;09;940637
84;2021-02-07;9;14;23;487711;511905;19;999616
84;2021-02-07;16;15;31;443824;451094;29;894918
84;2021-02-07;28;13;41;512522;493262;39;1005784
84;2021-02-07;11;21;32;520248;515106;49;1035354
84;2021-02-07;23;15;38;529611;514848;59;1044459
84;2021-02-07;13;8;21;486720;439940;69;926660
84;2021-02-07;7;15;22;372151;315211;79;687362
84;2021-02-07;25;15;40;237198;150524;89;387722
84;2021-02-07;14;7;21;81185;28680;90;109865
84;2021-02-07;152;131;283;4130719;3901658;0;8032377
93;2021-02-07;10;8;18;268834;283093;09;551927
93;2021-02-07;24;20;44;280751;296087;19;576838
93;2021-02-07;32;19;51;254404;255552;29;509956
93;2021-02-07;29;29;58;310704;288398;39;599102
93;2021-02-07;33;27;60;325559;305827;49;631386
93;2021-02-07;31;26;57;353104;325389;59;678493
93;2021-02-07;16;20;36;336327;296459;69;632786
93;2021-02-07;10;19;29;279820;229699;79;509519
93;2021-02-07;20;14;34;171274;113716;89;284990
93;2021-02-07;11;4;15;58896;21758;90;80654
93;2021-02-07;216;186;402;2639673;2415978;0;5055651
94;2021-02-07;1;0;1;16311;17433;09;33744
94;2021-02-07;0;0;0;16679;18132;19;34811
94;2021-02-07;1;4;5;16782;16579;29;33361
94;2021-02-07;1;1;2;23044;20580;39;43624
94;2021-02-07;0;1;1;23065;22140;49;45205
94;2021-02-07;0;0;0;24549;23421;59;47970
94;2021-02-07;0;0;0;23212;21883;69;45095
94;2021-02-07;0;0;0;19544;17141;79;36685
94;2021-02-07;0;0;0;11227;8178;89;19405
94;2021-02-07;0;0;0;3332;1447;90;4779
94;2021-02-07;3;6;9;177745;166934;0;344679
01;2021-02-08;0;0;0;19979;20155;09;40134
01;2021-02-08;0;0;0;24994;25489;19;50483
01;2021-02-08;6;3;9;17868;16690;29;34558
01;2021-02-08;3;2;5;22328;14821;39;37149
01;2021-02-08;2;3;5;28652;20276;49;48928
01;2021-02-08;4;5;9;33264;27260;59;60524
01;2021-02-08;0;3;3;27135;23978;69;51113
01;2021-02-08;1;0;1;18401;14661;79;33062
01;2021-02-08;0;0;0;9633;6375;89;16008
01;2021-02-08;0;0;0;3410;1510;90;4920
01;2021-02-08;16;16;32;205664;171215;0;376879
02;2021-02-08;0;0;0;16881;17110;09;33991
02;2021-02-08;1;2;3;21410;21604;19;43014
02;2021-02-08;2;0;2;16017;15479;29;31496
02;2021-02-08;1;0;1;19825;14455;39;34280
02;2021-02-08;0;1;1;24719;18248;49;42967
02;2021-02-08;2;0;2;34361;28310;59;62671
02;2021-02-08;2;1;3;28061;24495;69;52556
02;2021-02-08;1;0;1;18231;15278;79;33509
02;2021-02-08;0;0;0;11090;7677;89;18767
02;2021-02-08;0;0;0;3992;1506;90;5498
02;2021-02-08;9;4;13;194587;164162;0;358749
03;2021-02-08;0;0;0;31123;30920;09;62043
03;2021-02-08;1;1;2;29370;29268;19;58638
03;2021-02-08;2;1;3;21458;18963;29;40421
03;2021-02-08;0;3;3;21276;18326;39;39602
03;2021-02-08;4;4;8;18164;16593;49;34757
03;2021-02-08;1;4;5;13469;13557;59;27026
03;2021-02-08;4;2;6;8776;8670;69;17446
03;2021-02-08;0;1;1;3777;3591;79;7368
03;2021-02-08;0;1;1;1649;1072;89;2721
03;2021-02-08;0;0;0;485;184;90;669
03;2021-02-08;12;17;29;149547;141144;0;290691
04;2021-02-08;2;2;4;60314;61377;09;121691
04;2021-02-08;5;12;17;66065;68387;19;134452
04;2021-02-08;11;12;23;51059;47156;29;98215
04;2021-02-08;13;6;19;58788;45780;39;104568
04;2021-02-08;7;7;14;61408;52207;49;113615
04;2021-02-08;7;9;16;64838;60759;59;125597
04;2021-02-08;3;1;4;47008;42843;69;89851
04;2021-02-08;2;4;6;25509;21184;79;46693
04;2021-02-08;2;0;2;13168;7647;89;20815
04;2021-02-08;1;0;1;3209;1253;90;4462
04;2021-02-08;53;53;106;451366;408593;0;859959
05;2021-02-08;0;0;0;362.366008612902;341.338819562748;09;703.704828175651
05;2021-02-08;0;0;0;353.376145114279;370.349735405642;19;723.725880519921
05;2021-02-08;0;0;0;218.593559489256;256.539602589476;29;475.133162078732
05;2021-02-08;0;0;0;404.225408693299;360.321910454353;39;764.547319147651
05;2021-02-08;0;0;0;520.067953604221;497.108383964256;49;1017.17633756848
05;2021-02-08;0;0;0;468.146063921917;510.087601910415;59;978.233665832332
05;2021-02-08;0;0;0;340.368470050554;334.366842191253;69;674.735312241807
05;2021-02-08;0;0;0;212.598666888387;192.597753227106;79;405.196420115493
05;2021-02-08;0;0;0;148.727797095705;61.8681715431829;89;210.595968638888
05;2021-02-08;0;0;0;32.9601271090696;10.9909785719784;90;43.9511056810479
05;2021-02-08;0;0;0;3061.43020057959;2935.56979942041;0;5997
06;2021-02-08;1;5;6;42583;42380;09;84963
06;2021-02-08;19;15;34;33369;31925;19;65294
06;2021-02-08;55;48;103;21571;15080;29;36651
06;2021-02-08;62;54;116;21550;16147;39;37697
06;2021-02-08;47;43;90;14193;13939;49;28132
06;2021-02-08;31;38;69;7171;7597;59;14768
06;2021-02-08;32;20;55;3629;4117;69;7746
06;2021-02-08;4;11;15;1577;1457;79;3034
06;2021-02-08;2;0;2;531;474;89;1005
06;2021-02-08;0;1;1;88;93;90;181
06;2021-02-08;253;235;491;146262;133209;0;279471
07;2021-02-08;0;0;0;485;549;09;1034
07;2021-02-08;0;0;0;403;432;19;835
07;2021-02-08;0;4;4;764;841;29;1605
07;2021-02-08;0;2;2;824;928;39;1752
07;2021-02-08;2;0;2;788;1020;49;1808
07;2021-02-08;1;1;2;678;870;59;1548
07;2021-02-08;0;2;2;360;382;69;742
07;2021-02-08;0;0;0;231;190;79;421
07;2021-02-08;0;0;0;114;67;89;181
07;2021-02-08;0;0;0;24;11;90;35
07;2021-02-08;3;9;12;4671;5290;0;9961
08;2021-02-08;0;0;0;2715.22592983026;2997.75551488675;09;5712.98144471701
08;2021-02-08;1;2;3;2778.51901080978;3160.9156459093;19;5939.43465671908
08;2021-02-08;0;1;1;2080.8882988764;1718.16634315323;29;3799.05464202964
08;2021-02-08;2;1;3;2701.8582062647;1896.52641413317;39;4598.38462039786
08;2021-02-08;3;0;3;3151.45861023308;2460.52498233809;49;5611.98359257117
08;2021-02-08;4;1;5;2620.29868333099;2422.23566154656;59;5042.53434487755
08;2021-02-08;2;1;3;1621.44173420671;1438.58325779464;69;3060.02499200135
08;2021-02-08;0;0;0;626.575909335673;526.358467843651;79;1152.93437717932
08;2021-02-08;0;0;0;205.018522985054;140.993639349697;89;346.012162334751
08;2021-02-08;0;0;0;50.0325684687745;20.62259870351;90;70.6551671722846
08;2021-02-08;12;6;18;18551.3174743414;16782.6825256586;0;35334
11;2021-02-08;146;155;316;783071;811785;09;1594856
11;2021-02-08;432;438;890;761456;784653;19;1546109
11;2021-02-08;545;398;947;850145;801772;29;1651917
11;2021-02-08;591;507;1101;914360;843488;39;1757848
11;2021-02-08;535;463;998;845609;826202;49;1671811
11;2021-02-08;439;399;840;793566;745070;59;1538636
11;2021-02-08;283;296;589;628649;549192;69;1177841
11;2021-02-08;123;142;265;434606;358356;79;792962
11;2021-02-08;111;78;189;261425;162933;89;424358
11;2021-02-08;56;29;86;89253;32619;90;121872
11;2021-02-08;3261;2906;6223;6362140;5916070;0;12278210
24;2021-02-08;12;18;30;139720;144686;09;284406
24;2021-02-08;51;52;103;152979;161185;19;314164
24;2021-02-08;68;55;123;122237;126536;29;248773
24;2021-02-08;73;35;108;150359;142009;39;292368
24;2021-02-08;70;62;132;161829;158758;49;320587
24;2021-02-08;60;50;110;172552;168011;59;340563
24;2021-02-08;46;41;87;172509;158177;69;330686
24;2021-02-08;34;32;66;129428;110593;79;240021
24;2021-02-08;30;21;51;87342;56882;89;144224
24;2021-02-08;14;8;22;31210;12071;90;43281
24;2021-02-08;458;374;833;1320165;1238908;0;2559073
27;2021-02-08;20;30;50;143373;149679;09;293052
27;2021-02-08;54;57;111;160962;173003;19;333965
27;2021-02-08;74;63;137;133746;142254;29;276000
27;2021-02-08;77;53;130;160004;155407;39;315411
27;2021-02-08;90;75;165;172333;169564;49;341897
27;2021-02-08;79;66;145;189979;183788;59;373767
27;2021-02-08;68;53;121;192591;178206;69;370797
27;2021-02-08;59;42;101;146876;127546;79;274422
27;2021-02-08;49;33;82;96896;61575;89;158471
27;2021-02-08;42;7;49;33148;12109;90;45257
27;2021-02-08;612;479;1091;1429908;1353131;0;2783039
28;2021-02-08;24;29;54;180735;186856;09;367591
28;2021-02-08;77;70;148;200125;213621;19;413746
28;2021-02-08;67;60;127;168922;173007;29;341929
28;2021-02-08;83;58;141;196628;188487;39;385115
28;2021-02-08;76;73;149;205396;201699;49;407095
28;2021-02-08;67;62;129;222002;213866;59;435868
28;2021-02-08;65;43;108;224688;203758;69;428446
28;2021-02-08;34;23;57;163192;135543;79;298735
28;2021-02-08;31;16;47;109691;65377;89;175068
28;2021-02-08;24;7;31;37222;12685;90;49907
28;2021-02-08;548;441;991;1708601;1594899;0;3303500
32;2021-02-08;60;79;139;358062;373689;09;731751
32;2021-02-08;199;210;409;387045;406742;19;793787
32;2021-02-08;199;177;378;342304;348587;29;690891
32;2021-02-08;226;157;384;382485;369972;39;752457
32;2021-02-08;256;191;447;382510;376716;49;759226
32;2021-02-08;199;198;397;386937;376527;59;763464
32;2021-02-08;141;119;260;371211;330938;69;702149
32;2021-02-08;88;84;172;250542;201459;79;452001
32;2021-02-08;100;55;155;163399;89786;89;253185
32;2021-02-08;64;11;75;48384;15367;90;63751
32;2021-02-08;1532;1281;2816;3072879;2889783;0;5962662
44;2021-02-08;72;58;130;291525;306839;09;598364
44;2021-02-08;159;159;320;320255;339504;19;659759
44;2021-02-08;208;164;373;302020;314428;29;616448
44;2021-02-08;194;162;357;342222;333292;39;675514
44;2021-02-08;204;160;365;349727;344491;49;694218
44;2021-02-08;175;160;336;381371;373239;59;754610
44;2021-02-08;128;111;239;367165;335850;69;703015
44;2021-02-08;75;66;141;250387;215436;79;465823
44;2021-02-08;71;45;117;170825;105192;89;276017
44;2021-02-08;41;13;54;51248;16731;90;67979
44;2021-02-08;1327;1098;2432;2826745;2685002;0;5511747
52;2021-02-08;16;17;33;213594;223900;09;437494
52;2021-02-08;69;72;141;240818;255197;19;496015
52;2021-02-08;69;67;136;197010;200630;29;397640
52;2021-02-08;71;55;126;231204;224885;39;456089
52;2021-02-08;82;76;158;243874;243418;49;487292
52;2021-02-08;75;69;144;244100;239116;59;483216
52;2021-02-08;45;56;101;241796;221345;69;463141
52;2021-02-08;40;30;70;177805;149903;79;327708
52;2021-02-08;44;31;75;119561;75822;89;195383
52;2021-02-08;29;9;38;42559;15260;90;57819
52;2021-02-08;540;482;1023;1952321;1849476;0;3801797
53;2021-02-08;15;29;44;173813;182358;09;356171
53;2021-02-08;27;42;69;202720;214740;19;417460
53;2021-02-08;59;51;112;163116;173196;29;336312
53;2021-02-08;46;42;88;190526;187674;39;378200
53;2021-02-08;53;41;94;212098;212015;49;424113
53;2021-02-08;41;37;78;223699;219176;59;442875
53;2021-02-08;27;35;62;227435;209274;69;436709
53;2021-02-08;14;14;28;169992;140910;79;310902
53;2021-02-08;31;12;43;118117;69883;89;188000
53;2021-02-08;17;10;27;37370;12267;90;49637
53;2021-02-08;330;313;645;1718886;1621493;0;3340379
75;2021-02-08;33;33;66;293104;305291;09;598395
75;2021-02-08;80;83;163;337141;357785;19;694926
75;2021-02-08;113;82;195;295024;300618;29;595642
75;2021-02-08;113;84;197;347871;331233;39;679104
75;2021-02-08;134;100;234;384742;372771;49;757513
75;2021-02-08;131;104;235;413361;390880;59;804241
75;2021-02-08;79;75;154;425623;384060;69;809683
75;2021-02-08;62;53;115;325086;276298;79;601384
75;2021-02-08;78;51;129;213986;139308;89;353294
75;2021-02-08;56;26;82;77600;28200;90;105800
75;2021-02-08;880;691;1571;3113538;2886444;0;5999982
76;2021-02-08;38;40;83;305956;318589;09;624545
76;2021-02-08;112;128;244;338942;356969;19;695911
76;2021-02-08;173;124;297;316210;319570;29;635780
76;2021-02-08;186;143;329;356758;337587;39;694345
76;2021-02-08;215;158;373;376541;363812;49;740353
76;2021-02-08;190;167;357;402608;383750;59;786358
76;2021-02-08;108;126;234;394889;358997;69;753886
76;2021-02-08;89;98;187;308664;263806;79;572470
76;2021-02-08;93;65;158;195838;129272;89;325110
76;2021-02-08;71;25;96;69372;26728;90;96100
76;2021-02-08;1275;1075;2359;3065778;2859080;0;5924858
84;2021-02-08;72;51;124;459549;481088;09;940637
84;2021-02-08;197;195;396;487711;511905;19;999616
84;2021-02-08;265;250;515;443824;451094;29;894918
84;2021-02-08;291;255;547;512522;493262;39;1005784
84;2021-02-08;293;223;516;520248;515106;49;1035354
84;2021-02-08;260;226;486;529611;514848;59;1044459
84;2021-02-08;172;181;354;486720;439940;69;926660
84;2021-02-08;126;106;232;372151;315211;79;687362
84;2021-02-08;125;68;193;237198;150524;89;387722
84;2021-02-08;69;27;96;81185;28680;90;109865
84;2021-02-08;1870;1582;3459;4130719;3901658;0;8032377
93;2021-02-08;51;53;105;268834;283093;09;551927
93;2021-02-08;228;230;460;280751;296087;19;576838
93;2021-02-08;289;231;522;254404;255552;29;509956
93;2021-02-08;347;260;607;310704;288398;39;599102
93;2021-02-08;354;305;660;325559;305827;49;631386
93;2021-02-08;308;280;588;353104;325389;59;678493
93;2021-02-08;224;191;415;336327;296459;69;632786
93;2021-02-08;139;140;279;279820;229699;79;509519
93;2021-02-08;147;89;236;171274;113716;89;284990
93;2021-02-08;115;40;155;58896;21758;90;80654
93;2021-02-08;2202;1820;4036;2639673;2415978;0;5055651
94;2021-02-08;0;3;3;16311;17433;09;33744
94;2021-02-08;4;0;4;16679;18132;19;34811
94;2021-02-08;6;3;9;16782;16579;29;33361
94;2021-02-08;7;3;10;23044;20580;39;43624
94;2021-02-08;4;8;12;23065;22140;49;45205
94;2021-02-08;7;2;9;24549;23421;59;47970
94;2021-02-08;8;8;16;23212;21883;69;45095
94;2021-02-08;4;4;8;19544;17141;79;36685
94;2021-02-08;1;1;2;11227;8178;89;19405
94;2021-02-08;0;0;0;3332;1447;90;4779
94;2021-02-08;41;32;73;177745;166934;0;344679
01;2021-02-09;0;0;0;19979;20155;09;40134
01;2021-02-09;2;3;5;24994;25489;19;50483
01;2021-02-09;2;2;4;17868;16690;29;34558
01;2021-02-09;5;5;10;22328;14821;39;37149
01;2021-02-09;5;4;9;28652;20276;49;48928
01;2021-02-09;4;3;7;33264;27260;59;60524
01;2021-02-09;4;0;4;27135;23978;69;51113
01;2021-02-09;0;0;0;18401;14661;79;33062
01;2021-02-09;0;2;2;9633;6375;89;16008
01;2021-02-09;0;0;0;3410;1510;90;4920
01;2021-02-09;22;19;41;205664;171215;0;376879
02;2021-02-09;0;0;0;16881;17110;09;33991
02;2021-02-09;0;3;3;21410;21604;19;43014
02;2021-02-09;1;1;2;16017;15479;29;31496
02;2021-02-09;1;2;3;19825;14455;39;34280
02;2021-02-09;0;1;1;24719;18248;49;42967
02;2021-02-09;1;1;2;34361;28310;59;62671
02;2021-02-09;2;1;3;28061;24495;69;52556
02;2021-02-09;0;0;0;18231;15278;79;33509
02;2021-02-09;0;0;0;11090;7677;89;18767
02;2021-02-09;0;1;1;3992;1506;90;5498
02;2021-02-09;5;10;15;194587;164162;0;358749
03;2021-02-09;0;0;0;31123;30920;09;62043
03;2021-02-09;2;0;4;29370;29268;19;58638
03;2021-02-09;2;2;4;21458;18963;29;40421
03;2021-02-09;1;8;9;21276;18326;39;39602
03;2021-02-09;2;1;3;18164;16593;49;34757
03;2021-02-09;2;0;2;13469;13557;59;27026
03;2021-02-09;1;4;5;8776;8670;69;17446
03;2021-02-09;1;0;1;3777;3591;79;7368
03;2021-02-09;0;0;0;1649;1072;89;2721
03;2021-02-09;0;0;0;485;184;90;669
03;2021-02-09;11;15;28;149547;141144;0;290691
04;2021-02-09;1;3;4;60314;61377;09;121691
04;2021-02-09;6;8;14;66065;68387;19;134452
04;2021-02-09;12;8;20;51059;47156;29;98215
04;2021-02-09;8;15;23;58788;45780;39;104568
04;2021-02-09;12;11;23;61408;52207;49;113615
04;2021-02-09;6;8;15;64838;60759;59;125597
04;2021-02-09;5;11;16;47008;42843;69;89851
04;2021-02-09;3;0;3;25509;21184;79;46693
04;2021-02-09;0;0;0;13168;7647;89;20815
04;2021-02-09;0;0;0;3209;1253;90;4462
04;2021-02-09;53;64;118;451366;408593;0;859959
05;2021-02-09;0;0;0;362.366008612902;341.338819562748;09;703.704828175651
05;2021-02-09;0;0;0;353.376145114279;370.349735405642;19;723.725880519921
05;2021-02-09;0;0;0;218.593559489256;256.539602589476;29;475.133162078732
05;2021-02-09;0;0;0;404.225408693299;360.321910454353;39;764.547319147651
05;2021-02-09;0;0;0;520.067953604221;497.108383964256;49;1017.17633756848
05;2021-02-09;0;0;0;468.146063921917;510.087601910415;59;978.233665832332
05;2021-02-09;0;0;0;340.368470050554;334.366842191253;69;674.735312241807
05;2021-02-09;0;0;0;212.598666888387;192.597753227106;79;405.196420115493
05;2021-02-09;0;0;0;148.727797095705;61.8681715431829;89;210.595968638888
05;2021-02-09;0;0;0;32.9601271090696;10.9909785719784;90;43.9511056810479
05;2021-02-09;0;0;0;3061.43020057959;2935.56979942041;0;5997
06;2021-02-09;4;4;8;42583;42380;09;84963
06;2021-02-09;20;22;42;33369;31925;19;65294
06;2021-02-09;47;41;88;21571;15080;29;36651
06;2021-02-09;43;49;92;21550;16147;39;37697
06;2021-02-09;36;33;69;14193;13939;49;28132
06;2021-02-09;26;25;51;7171;7597;59;14768
06;2021-02-09;12;13;25;3629;4117;69;7746
06;2021-02-09;4;6;10;1577;1457;79;3034
06;2021-02-09;0;0;0;531;474;89;1005
06;2021-02-09;1;0;1;88;93;90;181
06;2021-02-09;193;193;386;146262;133209;0;279471
07;2021-02-09;0;0;0;485;549;09;1034
07;2021-02-09;0;0;0;403;432;19;835
07;2021-02-09;1;1;2;764;841;29;1605
07;2021-02-09;1;0;1;824;928;39;1752
07;2021-02-09;0;0;0;788;1020;49;1808
07;2021-02-09;1;1;2;678;870;59;1548
07;2021-02-09;1;0;1;360;382;69;742
07;2021-02-09;0;0;0;231;190;79;421
07;2021-02-09;0;0;0;114;67;89;181
07;2021-02-09;0;0;0;24;11;90;35
07;2021-02-09;4;2;6;4671;5290;0;9961
08;2021-02-09;0;0;0;2715.22592983026;2997.75551488675;09;5712.98144471701
08;2021-02-09;0;0;0;2778.51901080978;3160.9156459093;19;5939.43465671908
08;2021-02-09;1;0;1;2080.8882988764;1718.16634315323;29;3799.05464202964
08;2021-02-09;1;0;1;2701.8582062647;1896.52641413317;39;4598.38462039786
08;2021-02-09;0;1;1;3151.45861023308;2460.52498233809;49;5611.98359257117
08;2021-02-09;1;4;5;2620.29868333099;2422.23566154656;59;5042.53434487755
08;2021-02-09;1;1;2;1621.44173420671;1438.58325779464;69;3060.02499200135
08;2021-02-09;0;1;1;626.575909335673;526.358467843651;79;1152.93437717932
08;2021-02-09;0;0;0;205.018522985054;140.993639349697;89;346.012162334751
08;2021-02-09;0;0;0;50.0325684687745;20.62259870351;90;70.6551671722846
08;2021-02-09;4;7;11;18551.3174743414;16782.6825256586;0;35334
11;2021-02-09;145;124;288;783071;811785;09;1594856
11;2021-02-09;380;402;807;761456;784653;19;1546109
11;2021-02-09;473;380;856;850145;801772;29;1651917
11;2021-02-09;517;385;902;914360;843488;39;1757848
11;2021-02-09;486;380;867;845609;826202;49;1671811
11;2021-02-09;321;324;647;793566;745070;59;1538636
11;2021-02-09;220;204;433;628649;549192;69;1177841
11;2021-02-09;94;111;205;434606;358356;79;792962
11;2021-02-09;81;58;139;261425;162933;89;424358
11;2021-02-09;56;27;83;89253;32619;90;121872
11;2021-02-09;2773;2395;5227;6362140;5916070;0;12278210
24;2021-02-09;16;16;32;139720;144686;09;284406
24;2021-02-09;45;54;99;152979;161185;19;314164
24;2021-02-09;52;45;97;122237;126536;29;248773
24;2021-02-09;61;42;103;150359;142009;39;292368
24;2021-02-09;63;61;124;161829;158758;49;320587
24;2021-02-09;46;45;91;172552;168011;59;340563
24;2021-02-09;33;25;58;172509;158177;69;330686
24;2021-02-09;30;27;57;129428;110593;79;240021
24;2021-02-09;34;21;55;87342;56882;89;144224
24;2021-02-09;30;10;40;31210;12071;90;43281
24;2021-02-09;410;346;756;1320165;1238908;0;2559073
27;2021-02-09;10;16;26;143373;149679;09;293052
27;2021-02-09;34;43;78;160962;173003;19;333965
27;2021-02-09;51;33;84;133746;142254;29;276000
27;2021-02-09;53;43;96;160004;155407;39;315411
27;2021-02-09;62;48;110;172333;169564;49;341897
27;2021-02-09;47;49;96;189979;183788;59;373767
27;2021-02-09;47;42;89;192591;178206;69;370797
27;2021-02-09;33;35;68;146876;127546;79;274422
27;2021-02-09;49;29;78;96896;61575;89;158471
27;2021-02-09;37;8;45;33148;12109;90;45257
27;2021-02-09;423;346;770;1429908;1353131;0;2783039
28;2021-02-09;16;15;31;180735;186856;09;367591
28;2021-02-09;51;57;108;200125;213621;19;413746
28;2021-02-09;53;44;98;168922;173007;29;341929
28;2021-02-09;53;54;107;196628;188487;39;385115
28;2021-02-09;59;45;104;205396;201699;49;407095
28;2021-02-09;52;64;116;222002;213866;59;435868
28;2021-02-09;52;42;94;224688;203758;69;428446
28;2021-02-09;30;30;60;163192;135543;79;298735
28;2021-02-09;29;21;50;109691;65377;89;175068
28;2021-02-09;17;3;20;37222;12685;90;49907
28;2021-02-09;412;375;788;1708601;1594899;0;3303500
32;2021-02-09;64;62;126;358062;373689;09;731751
32;2021-02-09;140;157;298;387045;406742;19;793787
32;2021-02-09;187;146;333;342304;348587;29;690891
32;2021-02-09;191;162;353;382485;369972;39;752457
32;2021-02-09;183;163;346;382510;376716;49;759226
32;2021-02-09;161;140;301;386937;376527;59;763464
32;2021-02-09;126;112;238;371211;330938;69;702149
32;2021-02-09;96;81;177;250542;201459;79;452001
32;2021-02-09;83;40;123;163399;89786;89;253185
32;2021-02-09;59;21;80;48384;15367;90;63751
32;2021-02-09;1291;1084;2376;3072879;2889783;0;5962662
44;2021-02-09;59;38;99;291525;306839;09;598364
44;2021-02-09;119;109;230;320255;339504;19;659759
44;2021-02-09;134;115;249;302020;314428;29;616448
44;2021-02-09;142;126;269;342222;333292;39;675514
44;2021-02-09;124;118;242;349727;344491;49;694218
44;2021-02-09;107;107;217;381371;373239;59;754610
44;2021-02-09;90;72;164;367165;335850;69;703015
44;2021-02-09;50;44;94;250387;215436;79;465823
44;2021-02-09;58;32;90;170825;105192;89;276017
44;2021-02-09;40;9;49;51248;16731;90;67979
44;2021-02-09;923;770;1703;2826745;2685002;0;5511747
52;2021-02-09;20;16;36;213594;223900;09;437494
52;2021-02-09;42;50;93;240818;255197;19;496015
52;2021-02-09;55;63;118;197010;200630;29;397640
52;2021-02-09;68;34;102;231204;224885;39;456089
52;2021-02-09;64;50;114;243874;243418;49;487292
52;2021-02-09;65;37;102;244100;239116;59;483216
52;2021-02-09;40;37;77;241796;221345;69;463141
52;2021-02-09;29;22;51;177805;149903;79;327708
52;2021-02-09;33;16;49;119561;75822;89;195383
52;2021-02-09;15;4;19;42559;15260;90;57819
52;2021-02-09;431;329;761;1952321;1849476;0;3801797
53;2021-02-09;29;29;58;173813;182358;09;356171
53;2021-02-09;43;46;89;202720;214740;19;417460
53;2021-02-09;51;40;91;163116;173196;29;336312
53;2021-02-09;41;22;63;190526;187674;39;378200
53;2021-02-09;46;32;78;212098;212015;49;424113
53;2021-02-09;34;26;60;223699;219176;59;442875
53;2021-02-09;20;17;37;227435;209274;69;436709
53;2021-02-09;12;12;24;169992;140910;79;310902
53;2021-02-09;21;12;33;118117;69883;89;188000
53;2021-02-09;14;2;17;37370;12267;90;49637
53;2021-02-09;311;238;550;1718886;1621493;0;3340379
75;2021-02-09;23;20;44;293104;305291;09;598395
75;2021-02-09;52;61;113;337141;357785;19;694926
75;2021-02-09;99;78;177;295024;300618;29;595642
75;2021-02-09;98;74;172;347871;331233;39;679104
75;2021-02-09;113;86;199;384742;372771;49;757513
75;2021-02-09;90;95;185;413361;390880;59;804241
75;2021-02-09;70;60;130;425623;384060;69;809683
75;2021-02-09;46;46;92;325086;276298;79;601384
75;2021-02-09;45;24;69;213986;139308;89;353294
75;2021-02-09;26;10;36;77600;28200;90;105800
75;2021-02-09;662;554;1217;3113538;2886444;0;5999982
76;2021-02-09;29;44;78;305956;318589;09;624545
76;2021-02-09;100;111;216;338942;356969;19;695911
76;2021-02-09;125;85;210;316210;319570;29;635780
76;2021-02-09;172;93;265;356758;337587;39;694345
76;2021-02-09;133;120;253;376541;363812;49;740353
76;2021-02-09;158;126;284;402608;383750;59;786358
76;2021-02-09;87;88;175;394889;358997;69;753886
76;2021-02-09;50;42;92;308664;263806;79;572470
76;2021-02-09;64;34;98;195838;129272;89;325110
76;2021-02-09;31;21;52;69372;26728;90;96100
76;2021-02-09;950;765;1725;3065778;2859080;0;5924858
84;2021-02-09;56;40;96;459549;481088;09;940637
84;2021-02-09;146;156;303;487711;511905;19;999616
84;2021-02-09;205;173;378;443824;451094;29;894918
84;2021-02-09;236;185;421;512522;493262;39;1005784
84;2021-02-09;227;191;418;520248;515106;49;1035354
84;2021-02-09;189;183;372;529611;514848;59;1044459
84;2021-02-09;116;113;229;486720;439940;69;926660
84;2021-02-09;111;82;193;372151;315211;79;687362
84;2021-02-09;67;62;129;237198;150524;89;387722
84;2021-02-09;66;17;83;81185;28680;90;109865
84;2021-02-09;1420;1202;2623;4130719;3901658;0;8032377
93;2021-02-09;52;60;112;268834;283093;09;551927
93;2021-02-09;215;190;405;280751;296087;19;576838
93;2021-02-09;244;245;489;254404;255552;29;509956
93;2021-02-09;269;222;491;310704;288398;39;599102
93;2021-02-09;284;253;537;325559;305827;49;631386
93;2021-02-09;252;229;481;353104;325389;59;678493
93;2021-02-09;196;179;375;336327;296459;69;632786
93;2021-02-09;121;120;241;279820;229699;79;509519
93;2021-02-09;126;75;202;171274;113716;89;284990
93;2021-02-09;95;25;120;58896;21758;90;80654
93;2021-02-09;1855;1598;3454;2639673;2415978;0;5055651
94;2021-02-09;1;0;1;16311;17433;09;33744
94;2021-02-09;0;2;2;16679;18132;19;34811
94;2021-02-09;1;4;5;16782;16579;29;33361
94;2021-02-09;4;3;7;23044;20580;39;43624
94;2021-02-09;2;2;4;23065;22140;49;45205
94;2021-02-09;7;4;11;24549;23421;59;47970
94;2021-02-09;1;4;5;23212;21883;69;45095
94;2021-02-09;3;4;7;19544;17141;79;36685
94;2021-02-09;3;1;4;11227;8178;89;19405
94;2021-02-09;1;0;1;3332;1447;90;4779
94;2021-02-09;23;24;47;177745;166934;0;344679
01;2021-02-10;0;0;0;19979;20155;09;40134
01;2021-02-10;0;1;1;24994;25489;19;50483
01;2021-02-10;2;2;4;17868;16690;29;34558
01;2021-02-10;2;2;4;22328;14821;39;37149
01;2021-02-10;5;1;6;28652;20276;49;48928
01;2021-02-10;2;1;3;33264;27260;59;60524
01;2021-02-10;4;0;4;27135;23978;69;51113
01;2021-02-10;0;2;2;18401;14661;79;33062
01;2021-02-10;0;0;0;9633;6375;89;16008
01;2021-02-10;1;0;1;3410;1510;90;4920
01;2021-02-10;16;9;25;205664;171215;0;376879
02;2021-02-10;0;0;0;16881;17110;09;33991
02;2021-02-10;1;0;1;21410;21604;19;43014
02;2021-02-10;0;2;2;16017;15479;29;31496
02;2021-02-10;1;0;1;19825;14455;39;34280
02;2021-02-10;3;0;3;24719;18248;49;42967
02;2021-02-10;1;1;2;34361;28310;59;62671
02;2021-02-10;1;1;2;28061;24495;69;52556
02;2021-02-10;0;0;0;18231;15278;79;33509
02;2021-02-10;0;0;0;11090;7677;89;18767
02;2021-02-10;0;0;0;3992;1506;90;5498
02;2021-02-10;7;4;11;194587;164162;0;358749
03;2021-02-10;0;0;0;31123;30920;09;62043
03;2021-02-10;1;2;3;29370;29268;19;58638
03;2021-02-10;1;3;4;21458;18963;29;40421
03;2021-02-10;2;5;7;21276;18326;39;39602
03;2021-02-10;2;2;4;18164;16593;49;34757
03;2021-02-10;2;0;2;13469;13557;59;27026
03;2021-02-10;0;3;3;8776;8670;69;17446
03;2021-02-10;0;1;1;3777;3591;79;7368
03;2021-02-10;0;0;0;1649;1072;89;2721
03;2021-02-10;0;0;0;485;184;90;669
03;2021-02-10;8;16;24;149547;141144;0;290691
04;2021-02-10;4;2;6;60314;61377;09;121691
04;2021-02-10;9;9;18;66065;68387;19;134452
04;2021-02-10;10;14;24;51059;47156;29;98215
04;2021-02-10;8;7;15;58788;45780;39;104568
04;2021-02-10;12;7;19;61408;52207;49;113615
04;2021-02-10;8;7;15;64838;60759;59;125597
04;2021-02-10;3;2;5;47008;42843;69;89851
04;2021-02-10;3;2;5;25509;21184;79;46693
04;2021-02-10;0;1;1;13168;7647;89;20815
04;2021-02-10;0;0;0;3209;1253;90;4462
04;2021-02-10;57;51;108;451366;408593;0;859959
05;2021-02-10;0;0;0;362.366008612902;341.338819562748;09;703.704828175651
05;2021-02-10;0;0;0;353.376145114279;370.349735405642;19;723.725880519921
05;2021-02-10;0;0;0;218.593559489256;256.539602589476;29;475.133162078732
05;2021-02-10;0;0;0;404.225408693299;360.321910454353;39;764.547319147651
05;2021-02-10;0;0;0;520.067953604221;497.108383964256;49;1017.17633756848
05;2021-02-10;0;0;0;468.146063921917;510.087601910415;59;978.233665832332
05;2021-02-10;0;0;0;340.368470050554;334.366842191253;69;674.735312241807
05;2021-02-10;0;0;0;212.598666888387;192.597753227106;79;405.196420115493
05;2021-02-10;0;0;0;148.727797095705;61.8681715431829;89;210.595968638888
05;2021-02-10;0;0;0;32.9601271090696;10.9909785719784;90;43.9511056810479
05;2021-02-10;0;0;0;3061.43020057959;2935.56979942041;0;5997
06;2021-02-10;1;2;3;42583;42380;09;84963
06;2021-02-10;32;20;52;33369;31925;19;65294
06;2021-02-10;49;28;77;21571;15080;29;36651
06;2021-02-10;54;47;101;21550;16147;39;37697
06;2021-02-10;42;31;73;14193;13939;49;28132
06;2021-02-10;21;33;54;7171;7597;59;14768
06;2021-02-10;42;54;98;3629;4117;69;7746
06;2021-02-10;3;6;9;1577;1457;79;3034
06;2021-02-10;0;2;2;531;474;89;1005
06;2021-02-10;0;0;0;88;93;90;181
06;2021-02-10;244;223;469;146262;133209;0;279471
07;2021-02-10;0;0;0;485;549;09;1034
07;2021-02-10;0;0;0;403;432;19;835
07;2021-02-10;1;2;3;764;841;29;1605
07;2021-02-10;1;1;2;824;928;39;1752
07;2021-02-10;1;0;1;788;1020;49;1808
07;2021-02-10;1;6;7;678;870;59;1548
07;2021-02-10;0;0;0;360;382;69;742
07;2021-02-10;1;0;1;231;190;79;421
07;2021-02-10;0;0;0;114;67;89;181
07;2021-02-10;0;0;0;24;11;90;35
07;2021-02-10;5;9;14;4671;5290;0;9961
08;2021-02-10;0;0;0;2715.22592983026;2997.75551488675;09;5712.98144471701
08;2021-02-10;0;0;0;2778.51901080978;3160.9156459093;19;5939.43465671908
08;2021-02-10;1;1;2;2080.8882988764;1718.16634315323;29;3799.05464202964
08;2021-02-10;2;0;2;2701.8582062647;1896.52641413317;39;4598.38462039786
08;2021-02-10;4;0;4;3151.45861023308;2460.52498233809;49;5611.98359257117
08;2021-02-10;2;1;3;2620.29868333099;2422.23566154656;59;5042.53434487755
08;2021-02-10;2;2;4;1621.44173420671;1438.58325779464;69;3060.02499200135
08;2021-02-10;1;0;1;626.575909335673;526.358467843651;79;1152.93437717932
08;2021-02-10;0;0;0;205.018522985054;140.993639349697;89;346.012162334751
08;2021-02-10;0;0;0;50.0325684687745;20.62259870351;90;70.6551671722846
08;2021-02-10;12;4;16;18551.3174743414;16782.6825256586;0;35334
11;2021-02-10;110;143;270;783071;811785;09;1594856
11;2021-02-10;426;434;882;761456;784653;19;1546109
11;2021-02-10;417;356;774;850145;801772;29;1651917
11;2021-02-10;423;328;751;914360;843488;39;1757848
11;2021-02-10;378;362;740;845609;826202;49;1671811
11;2021-02-10;284;255;539;793566;745070;59;1538636
11;2021-02-10;172;194;371;628649;549192;69;1177841
11;2021-02-10;91;85;176;434606;358356;79;792962
11;2021-02-10;78;55;133;261425;162933;89;424358
11;2021-02-10;42;15;58;89253;32619;90;121872
11;2021-02-10;2421;2227;4697;6362140;5916070;0;12278210
24;2021-02-10;16;10;26;139720;144686;09;284406
24;2021-02-10;34;34;68;152979;161185;19;314164
24;2021-02-10;54;43;97;122237;126536;29;248773
24;2021-02-10;49;42;91;150359;142009;39;292368
24;2021-02-10;49;29;78;161829;158758;49;320587
24;2021-02-10;39;45;84;172552;168011;59;340563
24;2021-02-10;25;28;53;172509;158177;69;330686
24;2021-02-10;19;13;32;129428;110593;79;240021
24;2021-02-10;20;15;35;87342;56882;89;144224
24;2021-02-10;20;9;29;31210;12071;90;43281
24;2021-02-10;325;268;593;1320165;1238908;0;2559073
27;2021-02-10;8;13;21;143373;149679;09;293052
27;2021-02-10;42;41;83;160962;173003;19;333965
27;2021-02-10;53;54;107;133746;142254;29;276000
27;2021-02-10;57;44;101;160004;155407;39;315411
27;2021-02-10;57;49;106;172333;169564;49;341897
27;2021-02-10;61;48;109;189979;183788;59;373767
27;2021-02-10;48;61;109;192591;178206;69;370797
27;2021-02-10;25;29;54;146876;127546;79;274422
27;2021-02-10;31;24;55;96896;61575;89;158471
27;2021-02-10;31;8;39;33148;12109;90;45257
27;2021-02-10;413;371;784;1429908;1353131;0;2783039
28;2021-02-10;19;20;39;180735;186856;09;367591
28;2021-02-10;45;48;97;200125;213621;19;413746
28;2021-02-10;54;32;86;168922;173007;29;341929
28;2021-02-10;58;47;105;196628;188487;39;385115
28;2021-02-10;70;42;112;205396;201699;49;407095
28;2021-02-10;40;36;76;222002;213866;59;435868
28;2021-02-10;29;42;71;224688;203758;69;428446
28;2021-02-10;24;22;46;163192;135543;79;298735
28;2021-02-10;32;11;43;109691;65377;89;175068
28;2021-02-10;11;5;16;37222;12685;90;49907
28;2021-02-10;382;305;691;1708601;1594899;0;3303500
32;2021-02-10;71;66;137;358062;373689;09;731751
32;2021-02-10;162;158;320;387045;406742;19;793787
32;2021-02-10;189;143;332;342304;348587;29;690891
32;2021-02-10;207;166;373;382485;369972;39;752457
32;2021-02-10;178;159;337;382510;376716;49;759226
32;2021-02-10;158;149;307;386937;376527;59;763464
32;2021-02-10;113;94;207;371211;330938;69;702149
32;2021-02-10;76;59;135;250542;201459;79;452001
32;2021-02-10;74;47;121;163399;89786;89;253185
32;2021-02-10;38;9;47;48384;15367;90;63751
32;2021-02-10;1268;1051;2319;3072879;2889783;0;5962662
44;2021-02-10;58;42;100;291525;306839;09;598364
44;2021-02-10;114;129;246;320255;339504;19;659759
44;2021-02-10;99;128;227;302020;314428;29;616448
44;2021-02-10;131;122;255;342222;333292;39;675514
44;2021-02-10;111;85;196;349727;344491;49;694218
44;2021-02-10;90;91;184;381371;373239;59;754610
44;2021-02-10;77;65;142;367165;335850;69;703015
44;2021-02-10;35;47;82;250387;215436;79;465823
44;2021-02-10;57;26;85;170825;105192;89;276017
44;2021-02-10;32;12;44;51248;16731;90;67979
44;2021-02-10;804;747;1561;2826745;2685002;0;5511747
52;2021-02-10;25;18;44;213594;223900;09;437494
52;2021-02-10;48;55;104;240818;255197;19;496015
52;2021-02-10;63;49;112;197010;200630;29;397640
52;2021-02-10;48;39;87;231204;224885;39;456089
52;2021-02-10;49;51;100;243874;243418;49;487292
52;2021-02-10;47;54;101;244100;239116;59;483216
52;2021-02-10;32;31;63;241796;221345;69;463141
52;2021-02-10;24;12;36;177805;149903;79;327708
52;2021-02-10;28;11;39;119561;75822;89;195383
52;2021-02-10;27;11;38;42559;15260;90;57819
52;2021-02-10;391;331;724;1952321;1849476;0;3801797
53;2021-02-10;8;12;20;173813;182358;09;356171
53;2021-02-10;37;25;62;202720;214740;19;417460
53;2021-02-10;40;42;82;163116;173196;29;336312
53;2021-02-10;24;25;49;190526;187674;39;378200
53;2021-02-10;37;30;67;212098;212015;49;424113
53;2021-02-10;27;36;63;223699;219176;59;442875
53;2021-02-10;12;18;30;227435;209274;69;436709
53;2021-02-10;14;18;32;169992;140910;79;310902
53;2021-02-10;13;6;19;118117;69883;89;188000
53;2021-02-10;11;3;14;37370;12267;90;49637
53;2021-02-10;223;215;438;1718886;1621493;0;3340379
75;2021-02-10;21;23;45;293104;305291;09;598395
75;2021-02-10;69;64;133;337141;357785;19;694926
75;2021-02-10;87;66;153;295024;300618;29;595642
75;2021-02-10;95;73;168;347871;331233;39;679104
75;2021-02-10;98;88;186;384742;372771;49;757513
75;2021-02-10;93;75;168;413361;390880;59;804241
75;2021-02-10;52;58;110;425623;384060;69;809683
75;2021-02-10;47;36;83;325086;276298;79;601384
75;2021-02-10;57;32;89;213986;139308;89;353294
75;2021-02-10;51;13;64;77600;28200;90;105800
75;2021-02-10;670;528;1199;3113538;2886444;0;5999982
76;2021-02-10;29;29;61;305956;318589;09;624545
76;2021-02-10;117;111;234;338942;356969;19;695911
76;2021-02-10;128;104;232;316210;319570;29;635780
76;2021-02-10;130;91;221;356758;337587;39;694345
76;2021-02-10;156;113;269;376541;363812;49;740353
76;2021-02-10;131;124;255;402608;383750;59;786358
76;2021-02-10;83;83;166;394889;358997;69;753886
76;2021-02-10;39;54;93;308664;263806;79;572470
76;2021-02-10;51;33;84;195838;129272;89;325110
76;2021-02-10;44;12;56;69372;26728;90;96100
76;2021-02-10;908;754;1671;3065778;2859080;0;5924858
84;2021-02-10;45;54;99;459549;481088;09;940637
84;2021-02-10;160;179;342;487711;511905;19;999616
84;2021-02-10;190;163;353;443824;451094;29;894918
84;2021-02-10;211;163;374;512522;493262;39;1005784
84;2021-02-10;178;168;346;520248;515106;49;1035354
84;2021-02-10;180;150;330;529611;514848;59;1044459
84;2021-02-10;104;103;207;486720;439940;69;926660
84;2021-02-10;86;68;154;372151;315211;79;687362
84;2021-02-10;72;51;123;237198;150524;89;387722
84;2021-02-10;46;17;63;81185;28680;90;109865
84;2021-02-10;1272;1116;2392;4130719;3901658;0;8032377
93;2021-02-10;51;71;123;268834;283093;09;551927
93;2021-02-10;200;194;397;280751;296087;19;576838
93;2021-02-10;252;208;460;254404;255552;29;509956
93;2021-02-10;268;191;460;310704;288398;39;599102
93;2021-02-10;233;213;446;325559;305827;49;631386
93;2021-02-10;259;196;456;353104;325389;59;678493
93;2021-02-10;167;159;327;336327;296459;69;632786
93;2021-02-10;113;123;236;279820;229699;79;509519
93;2021-02-10;108;70;178;171274;113716;89;284990
93;2021-02-10;94;16;110;58896;21758;90;80654
93;2021-02-10;1745;1441;3193;2639673;2415978;0;5055651
94;2021-02-10;0;0;1;16311;17433;09;33744
94;2021-02-10;5;3;9;16679;18132;19;34811
94;2021-02-10;1;5;6;16782;16579;29;33361
94;2021-02-10;4;6;10;23044;20580;39;43624
94;2021-02-10;9;3;12;23065;22140;49;45205
94;2021-02-10;3;5;8;24549;23421;59;47970
94;2021-02-10;7;6;13;23212;21883;69;45095
94;2021-02-10;2;1;3;19544;17141;79;36685
94;2021-02-10;1;1;2;11227;8178;89;19405
94;2021-02-10;0;1;1;3332;1447;90;4779
94;2021-02-10;32;32;66;177745;166934;0;344679
01;2021-02-11;0;0;0;19979;20155;09;40134
01;2021-02-11;2;3;5;24994;25489;19;50483
01;2021-02-11;0;4;4;17868;16690;29;34558
01;2021-02-11;3;3;6;22328;14821;39;37149
01;2021-02-11;4;3;7;28652;20276;49;48928
01;2021-02-11;3;5;8;33264;27260;59;60524
01;2021-02-11;1;2;3;27135;23978;69;51113
01;2021-02-11;3;1;4;18401;14661;79;33062
01;2021-02-11;0;0;0;9633;6375;89;16008
01;2021-02-11;1;0;1;3410;1510;90;4920
01;2021-02-11;17;21;38;205664;171215;0;376879
02;2021-02-11;0;1;1;16881;17110;09;33991
02;2021-02-11;0;2;2;21410;21604;19;43014
02;2021-02-11;1;0;1;16017;15479;29;31496
02;2021-02-11;0;2;2;19825;14455;39;34280
02;2021-02-11;2;0;2;24719;18248;49;42967
02;2021-02-11;0;2;2;34361;28310;59;62671
02;2021-02-11;1;0;1;28061;24495;69;52556
02;2021-02-11;0;1;1;18231;15278;79;33509
02;2021-02-11;1;0;1;11090;7677;89;18767
02;2021-02-11;0;0;0;3992;1506;90;5498
02;2021-02-11;5;8;13;194587;164162;0;358749
03;2021-02-11;0;0;0;31123;30920;09;62043
03;2021-02-11;0;1;1;29370;29268;19;58638
03;2021-02-11;2;2;4;21458;18963;29;40421
03;2021-02-11;1;0;1;21276;18326;39;39602
03;2021-02-11;1;0;1;18164;16593;49;34757
03;2021-02-11;2;2;4;13469;13557;59;27026
03;2021-02-11;2;0;2;8776;8670;69;17446
03;2021-02-11;0;1;1;3777;3591;79;7368
03;2021-02-11;0;0;0;1649;1072;89;2721
03;2021-02-11;0;0;0;485;184;90;669
03;2021-02-11;8;6;14;149547;141144;0;290691
04;2021-02-11;1;4;5;60314;61377;09;121691
04;2021-02-11;6;7;13;66065;68387;19;134452
04;2021-02-11;6;3;9;51059;47156;29;98215
04;2021-02-11;13;7;20;58788;45780;39;104568
04;2021-02-11;5;12;17;61408;52207;49;113615
04;2021-02-11;1;8;9;64838;60759;59;125597
04;2021-02-11;4;2;6;47008;42843;69;89851
04;2021-02-11;2;2;4;25509;21184;79;46693
04;2021-02-11;1;2;3;13168;7647;89;20815
04;2021-02-11;0;0;0;3209;1253;90;4462
04;2021-02-11;39;47;86;451366;408593;0;859959
05;2021-02-11;0;0;0;362.366008612902;341.338819562748;09;703.704828175651
05;2021-02-11;0;0;0;353.376145114279;370.349735405642;19;723.725880519921
05;2021-02-11;0;0;0;218.593559489256;256.539602589476;29;475.133162078732
05;2021-02-11;0;0;0;404.225408693299;360.321910454353;39;764.547319147651
05;2021-02-11;0;0;0;520.067953604221;497.108383964256;49;1017.17633756848
05;2021-02-11;0;0;0;468.146063921917;510.087601910415;59;978.233665832332
05;2021-02-11;0;0;0;340.368470050554;334.366842191253;69;674.735312241807
05;2021-02-11;0;0;0;212.598666888387;192.597753227106;79;405.196420115493
05;2021-02-11;0;0;0;148.727797095705;61.8681715431829;89;210.595968638888
05;2021-02-11;0;0;0;32.9601271090696;10.9909785719784;90;43.9511056810479
05;2021-02-11;0;0;0;3061.43020057959;2935.56979942041;0;5997
06;2021-02-11;4;0;4;42583;42380;09;84963
06;2021-02-11;23;20;43;33369;31925;19;65294
06;2021-02-11;35;18;54;21571;15080;29;36651
06;2021-02-11;50;41;91;21550;16147;39;37697
06;2021-02-11;32;27;59;14193;13939;49;28132
06;2021-02-11;18;23;41;7171;7597;59;14768
06;2021-02-11;15;5;20;3629;4117;69;7746
06;2021-02-11;5;5;10;1577;1457;79;3034
06;2021-02-11;2;3;5;531;474;89;1005
06;2021-02-11;2;1;3;88;93;90;181
06;2021-02-11;186;143;331;146262;133209;0;279471
07;2021-02-11;0;0;0;485;549;09;1034
07;2021-02-11;0;0;0;403;432;19;835
07;2021-02-11;2;0;2;764;841;29;1605
07;2021-02-11;2;0;2;824;928;39;1752
07;2021-02-11;0;0;0;788;1020;49;1808
07;2021-02-11;0;0;0;678;870;59;1548
07;2021-02-11;1;0;1;360;382;69;742
07;2021-02-11;0;0;0;231;190;79;421
07;2021-02-11;0;0;0;114;67;89;181
07;2021-02-11;0;0;0;24;11;90;35
07;2021-02-11;5;0;5;4671;5290;0;9961
08;2021-02-11;0;0;0;2715.22592983026;2997.75551488675;09;5712.98144471701
08;2021-02-11;1;1;2;2778.51901080978;3160.9156459093;19;5939.43465671908
08;2021-02-11;1;0;1;2080.8882988764;1718.16634315323;29;3799.05464202964
08;2021-02-11;2;0;2;2701.8582062647;1896.52641413317;39;4598.38462039786
08;2021-02-11;1;0;1;3151.45861023308;2460.52498233809;49;5611.98359257117
08;2021-02-11;2;0;2;2620.29868333099;2422.23566154656;59;5042.53434487755
08;2021-02-11;1;1;2;1621.44173420671;1438.58325779464;69;3060.02499200135
08;2021-02-11;1;0;1;626.575909335673;526.358467843651;79;1152.93437717932
08;2021-02-11;0;0;0;205.018522985054;140.993639349697;89;346.012162334751
08;2021-02-11;0;0;0;50.0325684687745;20.62259870351;90;70.6551671722846
08;2021-02-11;9;2;11;18551.3174743414;16782.6825256586;0;35334
11;2021-02-11;91;117;225;783071;811785;09;1594856
11;2021-02-11;324;321;666;761456;784653;19;1546109
11;2021-02-11;418;331;750;850145;801772;29;1651917
11;2021-02-11;425;356;782;914360;843488;39;1757848
11;2021-02-11;418;353;772;845609;826202;49;1671811
11;2021-02-11;290;281;571;793566;745070;59;1538636
11;2021-02-11;224;209;437;628649;549192;69;1177841
11;2021-02-11;128;83;211;434606;358356;79;792962
11;2021-02-11;76;67;143;261425;162933;89;424358
11;2021-02-11;69;20;89;89253;32619;90;121872
11;2021-02-11;2463;2138;4646;6362140;5916070;0;12278210
24;2021-02-11;12;11;25;139720;144686;09;284406
24;2021-02-11;50;41;91;152979;161185;19;314164
24;2021-02-11;49;30;79;122237;126536;29;248773
24;2021-02-11;53;39;92;150359;142009;39;292368
24;2021-02-11;52;50;102;161829;158758;49;320587
24;2021-02-11;37;41;78;172552;168011;59;340563
24;2021-02-11;29;30;59;172509;158177;69;330686
24;2021-02-11;19;18;37;129428;110593;79;240021
24;2021-02-11;15;15;30;87342;56882;89;144224
24;2021-02-11;12;2;14;31210;12071;90;43281
24;2021-02-11;328;277;607;1320165;1238908;0;2559073
27;2021-02-11;10;11;21;143373;149679;09;293052
27;2021-02-11;39;41;83;160962;173003;19;333965
27;2021-02-11;58;32;90;133746;142254;29;276000
27;2021-02-11;52;38;90;160004;155407;39;315411
27;2021-02-11;53;43;96;172333;169564;49;341897
27;2021-02-11;59;48;107;189979;183788;59;373767
27;2021-02-11;38;51;89;192591;178206;69;370797
27;2021-02-11;27;33;60;146876;127546;79;274422
27;2021-02-11;26;19;45;96896;61575;89;158471
27;2021-02-11;27;7;34;33148;12109;90;45257
27;2021-02-11;389;323;715;1429908;1353131;0;2783039
28;2021-02-11;15;24;42;180735;186856;09;367591
28;2021-02-11;55;50;106;200125;213621;19;413746
28;2021-02-11;59;35;94;168922;173007;29;341929
28;2021-02-11;52;37;89;196628;188487;39;385115
28;2021-02-11;48;38;86;205396;201699;49;407095
28;2021-02-11;58;38;96;222002;213866;59;435868
28;2021-02-11;41;38;79;224688;203758;69;428446
28;2021-02-11;13;23;36;163192;135543;79;298735
28;2021-02-11;29;13;42;109691;65377;89;175068
28;2021-02-11;20;13;33;37222;12685;90;49907
28;2021-02-11;390;309;703;1708601;1594899;0;3303500
32;2021-02-11;68;64;132;358062;373689;09;731751
32;2021-02-11;161;185;347;387045;406742;19;793787
32;2021-02-11;151;157;308;342304;348587;29;690891
32;2021-02-11;213;153;366;382485;369972;39;752457
32;2021-02-11;171;152;323;382510;376716;49;759226
32;2021-02-11;163;162;327;386937;376527;59;763464
32;2021-02-11;115;110;225;371211;330938;69;702149
32;2021-02-11;72;62;134;250542;201459;79;452001
32;2021-02-11;77;35;112;163399;89786;89;253185
32;2021-02-11;63;9;72;48384;15367;90;63751
32;2021-02-11;1255;1089;2347;3072879;2889783;0;5962662
44;2021-02-11;47;43;91;291525;306839;09;598364
44;2021-02-11;112;100;212;320255;339504;19;659759
44;2021-02-11;115;77;194;302020;314428;29;616448
44;2021-02-11;117;101;219;342222;333292;39;675514
44;2021-02-11;87;82;170;349727;344491;49;694218
44;2021-02-11;99;88;189;381371;373239;59;754610
44;2021-02-11;62;62;125;367165;335850;69;703015
44;2021-02-11;43;39;82;250387;215436;79;465823
44;2021-02-11;42;25;68;170825;105192;89;276017
44;2021-02-11;24;11;35;51248;16731;90;67979
44;2021-02-11;749;628;1386;2826745;2685002;0;5511747
52;2021-02-11;10;14;25;213594;223900;09;437494
52;2021-02-11;41;50;91;240818;255197;19;496015
52;2021-02-11;55;59;114;197010;200630;29;397640
52;2021-02-11;53;41;94;231204;224885;39;456089
52;2021-02-11;55;59;114;243874;243418;49;487292
52;2021-02-11;45;41;86;244100;239116;59;483216
52;2021-02-11;24;44;68;241796;221345;69;463141
52;2021-02-11;27;26;53;177805;149903;79;327708
52;2021-02-11;27;11;38;119561;75822;89;195383
52;2021-02-11;29;11;40;42559;15260;90;57819
52;2021-02-11;366;356;723;1952321;1849476;0;3801797
53;2021-02-11;13;15;28;173813;182358;09;356171
53;2021-02-11;28;32;62;202720;214740;19;417460
53;2021-02-11;45;52;97;163116;173196;29;336312
53;2021-02-11;33;23;56;190526;187674;39;378200
53;2021-02-11;37;25;62;212098;212015;49;424113
53;2021-02-11;32;32;64;223699;219176;59;442875
53;2021-02-11;22;15;37;227435;209274;69;436709
53;2021-02-11;7;7;14;169992;140910;79;310902
53;2021-02-11;14;8;22;118117;69883;89;188000
53;2021-02-11;9;4;13;37370;12267;90;49637
53;2021-02-11;240;213;455;1718886;1621493;0;3340379
75;2021-02-11;21;20;41;293104;305291;09;598395
75;2021-02-11;56;49;105;337141;357785;19;694926
75;2021-02-11;66;97;163;295024;300618;29;595642
75;2021-02-11;69;55;124;347871;331233;39;679104
75;2021-02-11;89;70;159;384742;372771;49;757513
75;2021-02-11;82;67;149;413361;390880;59;804241
75;2021-02-11;46;50;96;425623;384060;69;809683
75;2021-02-11;36;29;65;325086;276298;79;601384
75;2021-02-11;43;26;69;213986;139308;89;353294
75;2021-02-11;35;14;49;77600;28200;90;105800
75;2021-02-11;543;477;1020;3113538;2886444;0;5999982
76;2021-02-11;38;32;74;305956;318589;09;624545
76;2021-02-11;110;122;239;338942;356969;19;695911
76;2021-02-11;97;96;193;316210;319570;29;635780
76;2021-02-11;152;94;246;356758;337587;39;694345
76;2021-02-11;118;78;196;376541;363812;49;740353
76;2021-02-11;137;107;244;402608;383750;59;786358
76;2021-02-11;88;86;174;394889;358997;69;753886
76;2021-02-11;52;60;112;308664;263806;79;572470
76;2021-02-11;48;44;92;195838;129272;89;325110
76;2021-02-11;32;18;50;69372;26728;90;96100
76;2021-02-11;874;737;1622;3065778;2859080;0;5924858
84;2021-02-11;53;49;104;459549;481088;09;940637
84;2021-02-11;167;151;320;487711;511905;19;999616
84;2021-02-11;196;142;339;443824;451094;29;894918
84;2021-02-11;211;149;360;512522;493262;39;1005784
84;2021-02-11;177;167;345;520248;515106;49;1035354
84;2021-02-11;151;167;318;529611;514848;59;1044459
84;2021-02-11;128;106;234;486720;439940;69;926660
84;2021-02-11;85;87;172;372151;315211;79;687362
84;2021-02-11;85;47;132;237198;150524;89;387722
84;2021-02-11;53;13;66;81185;28680;90;109865
84;2021-02-11;1306;1078;2390;4130719;3901658;0;8032377
93;2021-02-11;50;64;114;268834;283093;09;551927
93;2021-02-11;241;190;432;280751;296087;19;576838
93;2021-02-11;238;203;443;254404;255552;29;509956
93;2021-02-11;278;209;488;310704;288398;39;599102
93;2021-02-11;248;211;459;325559;305827;49;631386
93;2021-02-11;236;198;435;353104;325389;59;678493
93;2021-02-11;157;158;315;336327;296459;69;632786
93;2021-02-11;103;91;194;279820;229699;79;509519
93;2021-02-11;95;60;155;171274;113716;89;284990
93;2021-02-11;71;21;92;58896;21758;90;80654
93;2021-02-11;1718;1405;3128;2639673;2415978;0;5055651
94;2021-02-11;1;2;3;16311;17433;09;33744
94;2021-02-11;4;3;7;16679;18132;19;34811
94;2021-02-11;5;2;7;16782;16579;29;33361
94;2021-02-11;5;4;9;23044;20580;39;43624
94;2021-02-11;4;7;11;23065;22140;49;45205
94;2021-02-11;3;4;7;24549;23421;59;47970
94;2021-02-11;6;4;10;23212;21883;69;45095
94;2021-02-11;1;3;4;19544;17141;79;36685
94;2021-02-11;2;2;4;11227;8178;89;19405
94;2021-02-11;0;0;0;3332;1447;90;4779
94;2021-02-11;31;31;62;177745;166934;0;344679
01;2021-02-12;0;0;0;19979;20155;09;40134
01;2021-02-12;3;2;5;24994;25489;19;50483
01;2021-02-12;4;3;7;17868;16690;29;34558
01;2021-02-12;4;4;8;22328;14821;39;37149
01;2021-02-12;2;2;4;28652;20276;49;48928
01;2021-02-12;2;3;5;33264;27260;59;60524
01;2021-02-12;2;5;7;27135;23978;69;51113
01;2021-02-12;2;0;2;18401;14661;79;33062
01;2021-02-12;1;1;2;9633;6375;89;16008
01;2021-02-12;0;0;0;3410;1510;90;4920
01;2021-02-12;20;20;40;205664;171215;0;376879
02;2021-02-12;0;1;1;16881;17110;09;33991
02;2021-02-12;0;1;1;21410;21604;19;43014
02;2021-02-12;2;1;3;16017;15479;29;31496
02;2021-02-12;3;1;4;19825;14455;39;34280
02;2021-02-12;0;0;0;24719;18248;49;42967
02;2021-02-12;2;1;3;34361;28310;59;62671
02;2021-02-12;3;0;3;28061;24495;69;52556
02;2021-02-12;0;0;0;18231;15278;79;33509
02;2021-02-12;0;0;0;11090;7677;89;18767
02;2021-02-12;0;0;0;3992;1506;90;5498
02;2021-02-12;10;5;15;194587;164162;0;358749
03;2021-02-12;0;0;0;31123;30920;09;62043
03;2021-02-12;1;3;4;29370;29268;19;58638
03;2021-02-12;0;1;1;21458;18963;29;40421
03;2021-02-12;3;1;4;21276;18326;39;39602
03;2021-02-12;2;1;3;18164;16593;49;34757
03;2021-02-12;0;1;1;13469;13557;59;27026
03;2021-02-12;1;1;2;8776;8670;69;17446
03;2021-02-12;0;0;0;3777;3591;79;7368
03;2021-02-12;0;0;0;1649;1072;89;2721
03;2021-02-12;0;0;0;485;184;90;669
03;2021-02-12;7;8;15;149547;141144;0;290691
04;2021-02-12;6;2;8;60314;61377;09;121691
04;2021-02-12;9;12;21;66065;68387;19;134452
04;2021-02-12;11;9;20;51059;47156;29;98215
04;2021-02-12;21;7;28;58788;45780;39;104568
04;2021-02-12;13;12;25;61408;52207;49;113615
04;2021-02-12;7;8;15;64838;60759;59;125597
04;2021-02-12;8;6;14;47008;42843;69;89851
04;2021-02-12;1;2;3;25509;21184;79;46693
04;2021-02-12;1;0;1;13168;7647;89;20815
04;2021-02-12;0;0;0;3209;1253;90;4462
04;2021-02-12;77;58;135;451366;408593;0;859959
05;2021-02-12;0;0;0;362.366008612902;341.338819562748;09;703.704828175651
05;2021-02-12;0;0;0;353.376145114279;370.349735405642;19;723.725880519921
05;2021-02-12;0;0;0;218.593559489256;256.539602589476;29;475.133162078732
05;2021-02-12;0;0;0;404.225408693299;360.321910454353;39;764.547319147651
05;2021-02-12;0;0;0;520.067953604221;497.108383964256;49;1017.17633756848
05;2021-02-12;0;0;0;468.146063921917;510.087601910415;59;978.233665832332
05;2021-02-12;0;0;0;340.368470050554;334.366842191253;69;674.735312241807
05;2021-02-12;0;0;0;212.598666888387;192.597753227106;79;405.196420115493
05;2021-02-12;0;0;0;148.727797095705;61.8681715431829;89;210.595968638888
05;2021-02-12;0;0;0;32.9601271090696;10.9909785719784;90;43.9511056810479
05;2021-02-12;0;0;0;3061.43020057959;2935.56979942041;0;5997
06;2021-02-12;4;5;9;42583;42380;09;84963
06;2021-02-12;34;21;55;33369;31925;19;65294
06;2021-02-12;78;38;116;21571;15080;29;36651
06;2021-02-12;50;45;95;21550;16147;39;37697
06;2021-02-12;32;32;64;14193;13939;49;28132
06;2021-02-12;24;39;63;7171;7597;59;14768
06;2021-02-12;45;54;103;3629;4117;69;7746
06;2021-02-12;5;10;15;1577;1457;79;3034
06;2021-02-12;2;2;4;531;474;89;1005
06;2021-02-12;1;1;2;88;93;90;181
06;2021-02-12;275;247;526;146262;133209;0;279471
07;2021-02-12;0;0;0;485;549;09;1034
07;2021-02-12;1;0;1;403;432;19;835
07;2021-02-12;0;0;0;764;841;29;1605
07;2021-02-12;1;0;1;824;928;39;1752
07;2021-02-12;0;1;1;788;1020;49;1808
07;2021-02-12;1;0;1;678;870;59;1548
07;2021-02-12;0;1;1;360;382;69;742
07;2021-02-12;0;0;0;231;190;79;421
07;2021-02-12;0;0;0;114;67;89;181
07;2021-02-12;0;0;0;24;11;90;35
07;2021-02-12;3;2;5;4671;5290;0;9961
08;2021-02-12;0;0;0;2715.22592983026;2997.75551488675;09;5712.98144471701
08;2021-02-12;0;0;0;2778.51901080978;3160.9156459093;19;5939.43465671908
08;2021-02-12;1;0;1;2080.8882988764;1718.16634315323;29;3799.05464202964
08;2021-02-12;1;1;2;2701.8582062647;1896.52641413317;39;4598.38462039786
08;2021-02-12;1;0;1;3151.45861023308;2460.52498233809;49;5611.98359257117
08;2021-02-12;1;1;2;2620.29868333099;2422.23566154656;59;5042.53434487755
08;2021-02-12;0;1;1;1621.44173420671;1438.58325779464;69;3060.02499200135
08;2021-02-12;0;0;0;626.575909335673;526.358467843651;79;1152.93437717932
08;2021-02-12;0;0;0;205.018522985054;140.993639349697;89;346.012162334751
08;2021-02-12;0;0;0;50.0325684687745;20.62259870351;90;70.6551671722846
08;2021-02-12;4;3;7;18551.3174743414;16782.6825256586;0;35334
11;2021-02-12;117;101;290;783071;811785;09;1594856
11;2021-02-12;361;328;715;761456;784653;19;1546109
11;2021-02-12;429;351;783;850145;801772;29;1651917
11;2021-02-12;497;434;932;914360;843488;39;1757848
11;2021-02-12;457;399;857;845609;826202;49;1671811
11;2021-02-12;333;282;618;793566;745070;59;1538636
11;2021-02-12;234;233;474;628649;549192;69;1177841
11;2021-02-12;111;104;215;434606;358356;79;792962
11;2021-02-12;78;52;130;261425;162933;89;424358
11;2021-02-12;39;18;57;89253;32619;90;121872
11;2021-02-12;2656;2303;5073;6362140;5916070;0;12278210
24;2021-02-12;11;16;30;139720;144686;09;284406
24;2021-02-12;61;52;114;152979;161185;19;314164
24;2021-02-12;46;42;88;122237;126536;29;248773
24;2021-02-12;69;44;113;150359;142009;39;292368
24;2021-02-12;59;33;92;161829;158758;49;320587
24;2021-02-12;41;38;79;172552;168011;59;340563
24;2021-02-12;35;28;63;172509;158177;69;330686
24;2021-02-12;16;18;34;129428;110593;79;240021
24;2021-02-12;22;15;37;87342;56882;89;144224
24;2021-02-12;12;3;15;31210;12071;90;43281
24;2021-02-12;372;289;665;1320165;1238908;0;2559073
27;2021-02-12;12;17;29;143373;149679;09;293052
27;2021-02-12;42;50;92;160962;173003;19;333965
27;2021-02-12;51;47;98;133746;142254;29;276000
27;2021-02-12;67;51;118;160004;155407;39;315411
27;2021-02-12;41;40;81;172333;169564;49;341897
27;2021-02-12;62;49;111;189979;183788;59;373767
27;2021-02-12;35;44;79;192591;178206;69;370797
27;2021-02-12;19;29;48;146876;127546;79;274422
27;2021-02-12;35;19;54;96896;61575;89;158471
27;2021-02-12;20;7;27;33148;12109;90;45257
27;2021-02-12;384;353;737;1429908;1353131;0;2783039
28;2021-02-12;25;28;53;180735;186856;09;367591
28;2021-02-12;54;62;118;200125;213621;19;413746
28;2021-02-12;42;33;75;168922;173007;29;341929
28;2021-02-12;50;48;98;196628;188487;39;385115
28;2021-02-12;60;60;120;205396;201699;49;407095
28;2021-02-12;58;48;106;222002;213866;59;435868
28;2021-02-12;48;32;80;224688;203758;69;428446
28;2021-02-12;34;21;55;163192;135543;79;298735
28;2021-02-12;18;12;30;109691;65377;89;175068
28;2021-02-12;9;4;13;37222;12685;90;49907
28;2021-02-12;398;348;748;1708601;1594899;0;3303500
32;2021-02-12;68;93;162;358062;373689;09;731751
32;2021-02-12;186;205;391;387045;406742;19;793787
32;2021-02-12;190;143;333;342304;348587;29;690891
32;2021-02-12;234;151;386;382485;369972;39;752457
32;2021-02-12;189;168;357;382510;376716;49;759226
32;2021-02-12;160;175;335;386937;376527;59;763464
32;2021-02-12;113;107;220;371211;330938;69;702149
32;2021-02-12;97;71;168;250542;201459;79;452001
32;2021-02-12;64;46;110;163399;89786;89;253185
32;2021-02-12;41;9;50;48384;15367;90;63751
32;2021-02-12;1343;1168;2513;3072879;2889783;0;5962662
44;2021-02-12;46;50;96;291525;306839;09;598364
44;2021-02-12;115;123;239;320255;339504;19;659759
44;2021-02-12;111;107;219;302020;314428;29;616448
44;2021-02-12;137;111;249;342222;333292;39;675514
44;2021-02-12;115;105;222;349727;344491;49;694218
44;2021-02-12;99;84;185;381371;373239;59;754610
44;2021-02-12;76;56;133;367165;335850;69;703015
44;2021-02-12;45;42;87;250387;215436;79;465823
44;2021-02-12;40;30;70;170825;105192;89;276017
44;2021-02-12;30;9;39;51248;16731;90;67979
44;2021-02-12;814;717;1539;2826745;2685002;0;5511747
52;2021-02-12;13;19;34;213594;223900;09;437494
52;2021-02-12;64;63;127;240818;255197;19;496015
52;2021-02-12;77;70;147;197010;200630;29;397640
52;2021-02-12;52;45;98;231204;224885;39;456089
52;2021-02-12;57;39;96;243874;243418;49;487292
52;2021-02-12;45;49;94;244100;239116;59;483216
52;2021-02-12;32;28;60;241796;221345;69;463141
52;2021-02-12;20;23;43;177805;149903;79;327708
52;2021-02-12;18;12;30;119561;75822;89;195383
52;2021-02-12;14;2;16;42559;15260;90;57819
52;2021-02-12;392;350;745;1952321;1849476;0;3801797
53;2021-02-12;18;14;32;173813;182358;09;356171
53;2021-02-12;28;30;59;202720;214740;19;417460
53;2021-02-12;36;55;91;163116;173196;29;336312
53;2021-02-12;43;38;81;190526;187674;39;378200
53;2021-02-12;28;27;55;212098;212015;49;424113
53;2021-02-12;32;34;66;223699;219176;59;442875
53;2021-02-12;13;19;32;227435;209274;69;436709
53;2021-02-12;12;7;19;169992;140910;79;310902
53;2021-02-12;18;15;33;118117;69883;89;188000
53;2021-02-12;10;2;12;37370;12267;90;49637
53;2021-02-12;238;241;480;1718886;1621493;0;3340379
75;2021-02-12;21;17;39;293104;305291;09;598395
75;2021-02-12;69;60;129;337141;357785;19;694926
75;2021-02-12;85;89;175;295024;300618;29;595642
75;2021-02-12;84;63;148;347871;331233;39;679104
75;2021-02-12;76;68;144;384742;372771;49;757513
75;2021-02-12;60;68;128;413361;390880;59;804241
75;2021-02-12;51;50;101;425623;384060;69;809683
75;2021-02-12;43;35;78;325086;276298;79;601384
75;2021-02-12;52;33;85;213986;139308;89;353294
75;2021-02-12;35;13;48;77600;28200;90;105800
75;2021-02-12;576;496;1075;3113538;2886444;0;5999982
76;2021-02-12;29;41;72;305956;318589;09;624545
76;2021-02-12;119;119;239;338942;356969;19;695911
76;2021-02-12;159;125;284;316210;319570;29;635780
76;2021-02-12;129;117;246;356758;337587;39;694345
76;2021-02-12;147;108;255;376541;363812;49;740353
76;2021-02-12;134;99;233;402608;383750;59;786358
76;2021-02-12;83;101;184;394889;358997;69;753886
76;2021-02-12;55;46;101;308664;263806;79;572470
76;2021-02-12;43;31;74;195838;129272;89;325110
76;2021-02-12;24;10;34;69372;26728;90;96100
76;2021-02-12;922;797;1722;3065778;2859080;0;5924858
84;2021-02-12;48;62;110;459549;481088;09;940637
84;2021-02-12;190;142;334;487711;511905;19;999616
84;2021-02-12;177;186;364;443824;451094;29;894918
84;2021-02-12;190;173;363;512522;493262;39;1005784
84;2021-02-12;195;167;362;520248;515106;49;1035354
84;2021-02-12;177;164;341;529611;514848;59;1044459
84;2021-02-12;107;123;230;486720;439940;69;926660
84;2021-02-12;71;68;139;372151;315211;79;687362
84;2021-02-12;64;38;102;237198;150524;89;387722
84;2021-02-12;50;21;71;81185;28680;90;109865
84;2021-02-12;1269;1144;2417;4130719;3901658;0;8032377
93;2021-02-12;55;61;117;268834;283093;09;551927
93;2021-02-12;216;216;432;280751;296087;19;576838
93;2021-02-12;253;171;425;254404;255552;29;509956
93;2021-02-12;264;227;491;310704;288398;39;599102
93;2021-02-12;258;193;453;325559;305827;49;631386
93;2021-02-12;208;194;402;353104;325389;59;678493
93;2021-02-12;129;147;276;336327;296459;69;632786
93;2021-02-12;116;90;206;279820;229699;79;509519
93;2021-02-12;85;60;145;171274;113716;89;284990
93;2021-02-12;56;19;75;58896;21758;90;80654
93;2021-02-12;1640;1378;3022;2639673;2415978;0;5055651
94;2021-02-12;1;3;6;16311;17433;09;33744
94;2021-02-12;0;1;1;16679;18132;19;34811
94;2021-02-12;3;2;5;16782;16579;29;33361
94;2021-02-12;5;7;12;23044;20580;39;43624
94;2021-02-12;6;4;10;23065;22140;49;45205
94;2021-02-12;5;3;8;24549;23421;59;47970
94;2021-02-12;2;4;6;23212;21883;69;45095
94;2021-02-12;1;2;3;19544;17141;79;36685
94;2021-02-12;1;0;1;11227;8178;89;19405
94;2021-02-12;1;0;1;3332;1447;90;4779
94;2021-02-12;25;26;53;177745;166934;0;344679
01;2021-02-13;0;0;0;19979;20155;09;40134
01;2021-02-13;0;0;0;24994;25489;19;50483
01;2021-02-13;0;0;0;17868;16690;29;34558
01;2021-02-13;2;0;2;22328;14821;39;37149
01;2021-02-13;3;0;3;28652;20276;49;48928
01;2021-02-13;0;1;1;33264;27260;59;60524
01;2021-02-13;0;0;0;27135;23978;69;51113
01;2021-02-13;0;0;0;18401;14661;79;33062
01;2021-02-13;0;0;0;9633;6375;89;16008
01;2021-02-13;0;0;0;3410;1510;90;4920
01;2021-02-13;5;1;6;205664;171215;0;376879
02;2021-02-13;0;0;0;16881;17110;09;33991
02;2021-02-13;0;0;0;21410;21604;19;43014
02;2021-02-13;0;0;0;16017;15479;29;31496
02;2021-02-13;2;0;2;19825;14455;39;34280
02;2021-02-13;0;2;2;24719;18248;49;42967
02;2021-02-13;0;0;0;34361;28310;59;62671
02;2021-02-13;0;0;0;28061;24495;69;52556
02;2021-02-13;0;0;0;18231;15278;79;33509
02;2021-02-13;0;0;0;11090;7677;89;18767
02;2021-02-13;0;0;0;3992;1506;90;5498
02;2021-02-13;2;2;4;194587;164162;0;358749
03;2021-02-13;0;0;0;31123;30920;09;62043
03;2021-02-13;0;0;0;29370;29268;19;58638
03;2021-02-13;0;0;0;21458;18963;29;40421
03;2021-02-13;0;2;2;21276;18326;39;39602
03;2021-02-13;1;1;2;18164;16593;49;34757
03;2021-02-13;0;0;0;13469;13557;59;27026
03;2021-02-13;0;0;0;8776;8670;69;17446
03;2021-02-13;0;0;0;3777;3591;79;7368
03;2021-02-13;0;0;0;1649;1072;89;2721
03;2021-02-13;0;0;0;485;184;90;669
03;2021-02-13;1;3;4;149547;141144;0;290691
04;2021-02-13;3;0;3;60314;61377;09;121691
04;2021-02-13;6;7;13;66065;68387;19;134452
04;2021-02-13;2;7;9;51059;47156;29;98215
04;2021-02-13;5;6;11;58788;45780;39;104568
04;2021-02-13;3;2;5;61408;52207;49;113615
04;2021-02-13;4;6;10;64838;60759;59;125597
04;2021-02-13;1;3;4;47008;42843;69;89851
04;2021-02-13;0;0;0;25509;21184;79;46693
04;2021-02-13;0;0;0;13168;7647;89;20815
04;2021-02-13;0;0;0;3209;1253;90;4462
04;2021-02-13;24;31;55;451366;408593;0;859959
05;2021-02-13;0;0;0;362.366008612902;341.338819562748;09;703.704828175651
05;2021-02-13;0;0;0;353.376145114279;370.349735405642;19;723.725880519921
05;2021-02-13;0;0;0;218.593559489256;256.539602589476;29;475.133162078732
05;2021-02-13;0;0;0;404.225408693299;360.321910454353;39;764.547319147651
05;2021-02-13;0;0;0;520.067953604221;497.108383964256;49;1017.17633756848
05;2021-02-13;0;0;0;468.146063921917;510.087601910415;59;978.233665832332
05;2021-02-13;0;0;0;340.368470050554;334.366842191253;69;674.735312241807
05;2021-02-13;0;0;0;212.598666888387;192.597753227106;79;405.196420115493
05;2021-02-13;0;0;0;148.727797095705;61.8681715431829;89;210.595968638888
05;2021-02-13;0;0;0;32.9601271090696;10.9909785719784;90;43.9511056810479
05;2021-02-13;0;0;0;3061.43020057959;2935.56979942041;0;5997
06;2021-02-13;1;1;2;42583;42380;09;84963
06;2021-02-13;8;7;15;33369;31925;19;65294
06;2021-02-13;20;10;30;21571;15080;29;36651
06;2021-02-13;26;20;46;21550;16147;39;37697
06;2021-02-13;24;19;43;14193;13939;49;28132
06;2021-02-13;11;12;23;7171;7597;59;14768
06;2021-02-13;6;7;13;3629;4117;69;7746
06;2021-02-13;3;3;6;1577;1457;79;3034
06;2021-02-13;0;0;0;531;474;89;1005
06;2021-02-13;0;0;0;88;93;90;181
06;2021-02-13;99;79;178;146262;133209;0;279471
07;2021-02-13;0;0;0;485;549;09;1034
07;2021-02-13;0;0;0;403;432;19;835
07;2021-02-13;1;0;1;764;841;29;1605
07;2021-02-13;1;2;3;824;928;39;1752
07;2021-02-13;0;0;0;788;1020;49;1808
07;2021-02-13;1;0;1;678;870;59;1548
07;2021-02-13;0;0;0;360;382;69;742
07;2021-02-13;0;0;0;231;190;79;421
07;2021-02-13;0;0;0;114;67;89;181
07;2021-02-13;0;0;0;24;11;90;35
07;2021-02-13;3;2;5;4671;5290;0;9961
08;2021-02-13;0;0;0;2715.22592983026;2997.75551488675;09;5712.98144471701
08;2021-02-13;0;0;0;2778.51901080978;3160.9156459093;19;5939.43465671908
08;2021-02-13;3;1;4;2080.8882988764;1718.16634315323;29;3799.05464202964
08;2021-02-13;1;1;2;2701.8582062647;1896.52641413317;39;4598.38462039786
08;2021-02-13;3;1;4;3151.45861023308;2460.52498233809;49;5611.98359257117
08;2021-02-13;1;0;1;2620.29868333099;2422.23566154656;59;5042.53434487755
08;2021-02-13;2;0;2;1621.44173420671;1438.58325779464;69;3060.02499200135
08;2021-02-13;0;1;1;626.575909335673;526.358467843651;79;1152.93437717932
08;2021-02-13;0;1;1;205.018522985054;140.993639349697;89;346.012162334751
08;2021-02-13;0;0;0;50.0325684687745;20.62259870351;90;70.6551671722846
08;2021-02-13;10;5;15;18551.3174743414;16782.6825256586;0;35334
11;2021-02-13;81;77;170;783071;811785;09;1594856
11;2021-02-13;203;222;442;761456;784653;19;1546109
11;2021-02-13;257;200;457;850145;801772;29;1651917
11;2021-02-13;266;231;497;914360;843488;39;1757848
11;2021-02-13;250;240;491;845609;826202;49;1671811
11;2021-02-13;223;185;409;793566;745070;59;1538636
11;2021-02-13;127;107;238;628649;549192;69;1177841
11;2021-02-13;50;68;118;434606;358356;79;792962
11;2021-02-13;50;36;86;261425;162933;89;424358
11;2021-02-13;25;12;37;89253;32619;90;121872
11;2021-02-13;1532;1379;2946;6362140;5916070;0;12278210
24;2021-02-13;12;12;24;139720;144686;09;284406
24;2021-02-13;30;27;58;152979;161185;19;314164
24;2021-02-13;26;28;54;122237;126536;29;248773
24;2021-02-13;30;21;51;150359;142009;39;292368
24;2021-02-13;30;23;53;161829;158758;49;320587
24;2021-02-13;29;17;46;172552;168011;59;340563
24;2021-02-13;15;23;38;172509;158177;69;330686
24;2021-02-13;6;10;16;129428;110593;79;240021
24;2021-02-13;10;6;16;87342;56882;89;144224
24;2021-02-13;2;4;6;31210;12071;90;43281
24;2021-02-13;190;171;362;1320165;1238908;0;2559073
27;2021-02-13;9;8;17;143373;149679;09;293052
27;2021-02-13;18;27;45;160962;173003;19;333965
27;2021-02-13;35;27;62;133746;142254;29;276000
27;2021-02-13;32;16;48;160004;155407;39;315411
27;2021-02-13;35;44;79;172333;169564;49;341897
27;2021-02-13;26;37;63;189979;183788;59;373767
27;2021-02-13;23;19;42;192591;178206;69;370797
27;2021-02-13;15;15;30;146876;127546;79;274422
27;2021-02-13;6;12;18;96896;61575;89;158471
27;2021-02-13;8;3;11;33148;12109;90;45257
27;2021-02-13;207;208;415;1429908;1353131;0;2783039
28;2021-02-13;19;14;33;180735;186856;09;367591
28;2021-02-13;24;27;52;200125;213621;19;413746
28;2021-02-13;34;31;65;168922;173007;29;341929
28;2021-02-13;30;29;59;196628;188487;39;385115
28;2021-02-13;30;27;57;205396;201699;49;407095
28;2021-02-13;21;32;53;222002;213866;59;435868
28;2021-02-13;25;29;54;224688;203758;69;428446
28;2021-02-13;17;13;30;163192;135543;79;298735
28;2021-02-13;13;15;28;109691;65377;89;175068
28;2021-02-13;3;1;4;37222;12685;90;49907
28;2021-02-13;216;218;435;1708601;1594899;0;3303500
32;2021-02-13;41;44;85;358062;373689;09;731751
32;2021-02-13;123;137;260;387045;406742;19;793787
32;2021-02-13;156;87;243;342304;348587;29;690891
32;2021-02-13;143;118;261;382485;369972;39;752457
32;2021-02-13;115;120;235;382510;376716;49;759226
32;2021-02-13;97;116;213;386937;376527;59;763464
32;2021-02-13;92;80;172;371211;330938;69;702149
32;2021-02-13;49;45;94;250542;201459;79;452001
32;2021-02-13;37;24;61;163399;89786;89;253185
32;2021-02-13;24;9;34;48384;15367;90;63751
32;2021-02-13;878;780;1659;3072879;2889783;0;5962662
44;2021-02-13;34;32;66;291525;306839;09;598364
44;2021-02-13;75;87;162;320255;339504;19;659759
44;2021-02-13;89;67;156;302020;314428;29;616448
44;2021-02-13;76;80;156;342222;333292;39;675514
44;2021-02-13;66;54;120;349727;344491;49;694218
44;2021-02-13;72;67;139;381371;373239;59;754610
44;2021-02-13;48;48;96;367165;335850;69;703015
44;2021-02-13;19;17;36;250387;215436;79;465823
44;2021-02-13;21;19;40;170825;105192;89;276017
44;2021-02-13;12;7;19;51248;16731;90;67979
44;2021-02-13;512;478;990;2826745;2685002;0;5511747
52;2021-02-13;11;15;26;213594;223900;09;437494
52;2021-02-13;28;45;73;240818;255197;19;496015
52;2021-02-13;46;41;87;197010;200630;29;397640
52;2021-02-13;37;34;71;231204;224885;39;456089
52;2021-02-13;31;36;67;243874;243418;49;487292
52;2021-02-13;34;41;75;244100;239116;59;483216
52;2021-02-13;14;15;29;241796;221345;69;463141
52;2021-02-13;15;11;26;177805;149903;79;327708
52;2021-02-13;17;6;23;119561;75822;89;195383
52;2021-02-13;4;3;7;42559;15260;90;57819
52;2021-02-13;237;247;484;1952321;1849476;0;3801797
53;2021-02-13;11;18;29;173813;182358;09;356171
53;2021-02-13;23;32;55;202720;214740;19;417460
53;2021-02-13;29;35;64;163116;173196;29;336312
53;2021-02-13;19;24;43;190526;187674;39;378200
53;2021-02-13;24;29;53;212098;212015;49;424113
53;2021-02-13;27;22;49;223699;219176;59;442875
53;2021-02-13;18;18;36;227435;209274;69;436709
53;2021-02-13;3;7;10;169992;140910;79;310902
53;2021-02-13;4;9;13;118117;69883;89;188000
53;2021-02-13;0;1;1;37370;12267;90;49637
53;2021-02-13;158;195;353;1718886;1621493;0;3340379
75;2021-02-13;17;12;29;293104;305291;09;598395
75;2021-02-13;50;46;96;337141;357785;19;694926
75;2021-02-13;53;54;108;295024;300618;29;595642
75;2021-02-13;54;38;92;347871;331233;39;679104
75;2021-02-13;49;45;94;384742;372771;49;757513
75;2021-02-13;32;33;65;413361;390880;59;804241
75;2021-02-13;21;37;58;425623;384060;69;809683
75;2021-02-13;17;14;31;325086;276298;79;601384
75;2021-02-13;20;10;30;213986;139308;89;353294
75;2021-02-13;7;3;10;77600;28200;90;105800
75;2021-02-13;320;292;613;3113538;2886444;0;5999982
76;2021-02-13;18;15;34;305956;318589;09;624545
76;2021-02-13;51;48;100;338942;356969;19;695911
76;2021-02-13;81;54;135;316210;319570;29;635780
76;2021-02-13;77;63;140;356758;337587;39;694345
76;2021-02-13;67;47;114;376541;363812;49;740353
76;2021-02-13;56;67;123;402608;383750;59;786358
76;2021-02-13;43;49;92;394889;358997;69;753886
76;2021-02-13;27;18;45;308664;263806;79;572470
76;2021-02-13;29;19;48;195838;129272;89;325110
76;2021-02-13;22;7;29;69372;26728;90;96100
76;2021-02-13;471;387;860;3065778;2859080;0;5924858
84;2021-02-13;26;27;54;459549;481088;09;940637
84;2021-02-13;93;89;182;487711;511905;19;999616
84;2021-02-13;84;96;181;443824;451094;29;894918
84;2021-02-13;109;83;192;512522;493262;39;1005784
84;2021-02-13;98;97;195;520248;515106;49;1035354
84;2021-02-13;76;82;158;529611;514848;59;1044459
84;2021-02-13;60;53;113;486720;439940;69;926660
84;2021-02-13;43;33;76;372151;315211;79;687362
84;2021-02-13;31;29;60;237198;150524;89;387722
84;2021-02-13;25;3;29;81185;28680;90;109865
84;2021-02-13;645;592;1240;4130719;3901658;0;8032377
93;2021-02-13;37;30;67;268834;283093;09;551927
93;2021-02-13;114;97;212;280751;296087;19;576838
93;2021-02-13;133;90;224;254404;255552;29;509956
93;2021-02-13;142;112;254;310704;288398;39;599102
93;2021-02-13;119;98;217;325559;305827;49;631386
93;2021-02-13;100;108;208;353104;325389;59;678493
93;2021-02-13;67;69;136;336327;296459;69;632786
93;2021-02-13;60;42;102;279820;229699;79;509519
93;2021-02-13;47;33;80;171274;113716;89;284990
93;2021-02-13;8;4;12;58896;21758;90;80654
93;2021-02-13;827;683;1512;2639673;2415978;0;5055651
94;2021-02-13;0;0;1;16311;17433;09;33744
94;2021-02-13;0;2;2;16679;18132;19;34811
94;2021-02-13;1;2;3;16782;16579;29;33361
94;2021-02-13;4;3;7;23044;20580;39;43624
94;2021-02-13;3;5;8;23065;22140;49;45205
94;2021-02-13;1;1;2;24549;23421;59;47970
94;2021-02-13;0;2;2;23212;21883;69;45095
94;2021-02-13;2;0;2;19544;17141;79;36685
94;2021-02-13;0;0;0;11227;8178;89;19405
94;2021-02-13;0;0;0;3332;1447;90;4779
94;2021-02-13;11;15;27;177745;166934;0;344679
01;2021-02-14;0;0;0;19979;20155;09;40134
01;2021-02-14;1;0;1;24994;25489;19;50483
01;2021-02-14;1;1;2;17868;16690;29;34558
01;2021-02-14;0;1;1;22328;14821;39;37149
01;2021-02-14;1;1;2;28652;20276;49;48928
01;2021-02-14;1;0;1;33264;27260;59;60524
01;2021-02-14;2;0;2;27135;23978;69;51113
01;2021-02-14;0;1;1;18401;14661;79;33062
01;2021-02-14;0;0;0;9633;6375;89;16008
01;2021-02-14;0;0;0;3410;1510;90;4920
01;2021-02-14;6;4;10;205664;171215;0;376879
02;2021-02-14;0;0;0;16881;17110;09;33991
02;2021-02-14;0;0;0;21410;21604;19;43014
02;2021-02-14;1;0;1;16017;15479;29;31496
02;2021-02-14;0;0;0;19825;14455;39;34280
02;2021-02-14;0;0;0;24719;18248;49;42967
02;2021-02-14;0;0;0;34361;28310;59;62671
02;2021-02-14;0;0;0;28061;24495;69;52556
02;2021-02-14;0;0;0;18231;15278;79;33509
02;2021-02-14;0;0;0;11090;7677;89;18767
02;2021-02-14;0;0;0;3992;1506;90;5498
02;2021-02-14;1;0;1;194587;164162;0;358749
03;2021-02-14;0;0;0;31123;30920;09;62043
03;2021-02-14;0;0;0;29370;29268;19;58638
03;2021-02-14;0;1;1;21458;18963;29;40421
03;2021-02-14;0;0;0;21276;18326;39;39602
03;2021-02-14;0;0;0;18164;16593;49;34757
03;2021-02-14;1;0;1;13469;13557;59;27026
03;2021-02-14;0;0;0;8776;8670;69;17446
03;2021-02-14;0;0;0;3777;3591;79;7368
03;2021-02-14;0;0;0;1649;1072;89;2721
03;2021-02-14;0;0;0;485;184;90;669
03;2021-02-14;1;1;2;149547;141144;0;290691
04;2021-02-14;1;0;1;60314;61377;09;121691
04;2021-02-14;1;2;3;66065;68387;19;134452
04;2021-02-14;2;1;3;51059;47156;29;98215
04;2021-02-14;3;2;5;58788;45780;39;104568
04;2021-02-14;1;3;4;61408;52207;49;113615
04;2021-02-14;0;2;2;64838;60759;59;125597
04;2021-02-14;0;2;2;47008;42843;69;89851
04;2021-02-14;0;0;0;25509;21184;79;46693
04;2021-02-14;1;0;1;13168;7647;89;20815
04;2021-02-14;0;0;0;3209;1253;90;4462
04;2021-02-14;9;12;21;451366;408593;0;859959
05;2021-02-14;0;0;0;362.366008612902;341.338819562748;09;703.704828175651
05;2021-02-14;0;0;0;353.376145114279;370.349735405642;19;723.725880519921
05;2021-02-14;0;0;0;218.593559489256;256.539602589476;29;475.133162078732
05;2021-02-14;0;0;0;404.225408693299;360.321910454353;39;764.547319147651
05;2021-02-14;0;0;0;520.067953604221;497.108383964256;49;1017.17633756848
05;2021-02-14;0;0;0;468.146063921917;510.087601910415;59;978.233665832332
05;2021-02-14;0;0;0;340.368470050554;334.366842191253;69;674.735312241807
05;2021-02-14;0;0;0;212.598666888387;192.597753227106;79;405.196420115493
05;2021-02-14;0;0;0;148.727797095705;61.8681715431829;89;210.595968638888
05;2021-02-14;0;0;0;32.9601271090696;10.9909785719784;90;43.9511056810479
05;2021-02-14;0;0;0;3061.43020057959;2935.56979942041;0;5997
06;2021-02-14;0;1;1;42583;42380;09;84963
06;2021-02-14;1;4;5;33369;31925;19;65294
06;2021-02-14;16;8;24;21571;15080;29;36651
06;2021-02-14;6;8;14;21550;16147;39;37697
06;2021-02-14;6;5;11;14193;13939;49;28132
06;2021-02-14;3;6;9;7171;7597;59;14768
06;2021-02-14;21;22;47;3629;4117;69;7746
06;2021-02-14;2;3;5;1577;1457;79;3034
06;2021-02-14;0;3;3;531;474;89;1005
06;2021-02-14;0;1;1;88;93;90;181
06;2021-02-14;55;61;120;146262;133209;0;279471
07;2021-02-14;0;0;0;485;549;09;1034
07;2021-02-14;0;0;0;403;432;19;835
07;2021-02-14;0;0;0;764;841;29;1605
07;2021-02-14;0;0;0;824;928;39;1752
07;2021-02-14;0;0;0;788;1020;49;1808
07;2021-02-14;0;0;0;678;870;59;1548
07;2021-02-14;0;0;0;360;382;69;742
07;2021-02-14;0;0;0;231;190;79;421
07;2021-02-14;0;0;0;114;67;89;181
07;2021-02-14;0;0;0;24;11;90;35
07;2021-02-14;0;0;0;4671;5290;0;9961
08;2021-02-14;0;0;0;2715.22592983026;2997.75551488675;09;5712.98144471701
08;2021-02-14;0;0;0;2778.51901080978;3160.9156459093;19;5939.43465671908
08;2021-02-14;0;0;0;2080.8882988764;1718.16634315323;29;3799.05464202964
08;2021-02-14;0;0;0;2701.8582062647;1896.52641413317;39;4598.38462039786
08;2021-02-14;0;0;0;3151.45861023308;2460.52498233809;49;5611.98359257117
08;2021-02-14;0;0;0;2620.29868333099;2422.23566154656;59;5042.53434487755
08;2021-02-14;0;0;0;1621.44173420671;1438.58325779464;69;3060.02499200135
08;2021-02-14;0;0;0;626.575909335673;526.358467843651;79;1152.93437717932
08;2021-02-14;0;0;0;205.018522985054;140.993639349697;89;346.012162334751
08;2021-02-14;0;0;0;50.0325684687745;20.62259870351;90;70.6551671722846
08;2021-02-14;0;0;0;18551.3174743414;16782.6825256586;0;35334
11;2021-02-14;15;19;35;783071;811785;09;1594856
11;2021-02-14;40;50;91;761456;784653;19;1546109
11;2021-02-14;74;73;147;850145;801772;29;1651917
11;2021-02-14;55;56;112;914360;843488;39;1757848
11;2021-02-14;62;67;129;845609;826202;49;1671811
11;2021-02-14;43;46;89;793566;745070;59;1538636
11;2021-02-14;26;36;62;628649;549192;69;1177841
11;2021-02-14;21;21;42;434606;358356;79;792962
11;2021-02-14;32;16;48;261425;162933;89;424358
11;2021-02-14;11;12;23;89253;32619;90;121872
11;2021-02-14;380;396;779;6362140;5916070;0;12278210
24;2021-02-14;0;0;0;139720;144686;09;284406
24;2021-02-14;3;2;5;152979;161185;19;314164
24;2021-02-14;3;2;5;122237;126536;29;248773
24;2021-02-14;7;2;9;150359;142009;39;292368
24;2021-02-14;8;0;8;161829;158758;49;320587
24;2021-02-14;4;3;7;172552;168011;59;340563
24;2021-02-14;3;5;8;172509;158177;69;330686
24;2021-02-14;2;2;4;129428;110593;79;240021
24;2021-02-14;2;3;5;87342;56882;89;144224
24;2021-02-14;5;2;7;31210;12071;90;43281
24;2021-02-14;37;21;58;1320165;1238908;0;2559073
27;2021-02-14;0;2;2;143373;149679;09;293052
27;2021-02-14;1;1;2;160962;173003;19;333965
27;2021-02-14;4;1;5;133746;142254;29;276000
27;2021-02-14;6;4;10;160004;155407;39;315411
27;2021-02-14;2;4;6;172333;169564;49;341897
27;2021-02-14;5;4;9;189979;183788;59;373767
27;2021-02-14;1;5;6;192591;178206;69;370797
27;2021-02-14;3;2;5;146876;127546;79;274422
27;2021-02-14;10;12;22;96896;61575;89;158471
27;2021-02-14;6;2;8;33148;12109;90;45257
27;2021-02-14;38;37;75;1429908;1353131;0;2783039
28;2021-02-14;2;3;6;180735;186856;09;367591
28;2021-02-14;2;9;11;200125;213621;19;413746
28;2021-02-14;5;4;9;168922;173007;29;341929
28;2021-02-14;10;13;23;196628;188487;39;385115
28;2021-02-14;6;6;12;205396;201699;49;407095
28;2021-02-14;5;4;9;222002;213866;59;435868
28;2021-02-14;5;3;8;224688;203758;69;428446
28;2021-02-14;2;5;7;163192;135543;79;298735
28;2021-02-14;7;4;11;109691;65377;89;175068
28;2021-02-14;4;0;4;37222;12685;90;49907
28;2021-02-14;48;51;100;1708601;1594899;0;3303500
32;2021-02-14;19;9;28;358062;373689;09;731751
32;2021-02-14;20;21;41;387045;406742;19;793787
32;2021-02-14;36;19;55;342304;348587;29;690891
32;2021-02-14;48;31;79;382485;369972;39;752457
32;2021-02-14;37;38;75;382510;376716;49;759226
32;2021-02-14;21;31;52;386937;376527;59;763464
32;2021-02-14;9;10;19;371211;330938;69;702149
32;2021-02-14;11;17;28;250542;201459;79;452001
32;2021-02-14;13;12;25;163399;89786;89;253185
32;2021-02-14;15;4;19;48384;15367;90;63751
32;2021-02-14;229;192;421;3072879;2889783;0;5962662
44;2021-02-14;1;1;2;291525;306839;09;598364
44;2021-02-14;3;8;11;320255;339504;19;659759
44;2021-02-14;7;11;18;302020;314428;29;616448
44;2021-02-14;18;12;30;342222;333292;39;675514
44;2021-02-14;15;15;30;349727;344491;49;694218
44;2021-02-14;11;13;24;381371;373239;59;754610
44;2021-02-14;8;8;16;367165;335850;69;703015
44;2021-02-14;8;8;16;250387;215436;79;465823
44;2021-02-14;9;6;15;170825;105192;89;276017
44;2021-02-14;5;1;6;51248;16731;90;67979
44;2021-02-14;85;83;168;2826745;2685002;0;5511747
52;2021-02-14;3;8;11;213594;223900;09;437494
52;2021-02-14;6;11;17;240818;255197;19;496015
52;2021-02-14;7;6;13;197010;200630;29;397640
52;2021-02-14;8;7;15;231204;224885;39;456089
52;2021-02-14;7;14;21;243874;243418;49;487292
52;2021-02-14;8;12;20;244100;239116;59;483216
52;2021-02-14;7;7;14;241796;221345;69;463141
52;2021-02-14;5;6;11;177805;149903;79;327708
52;2021-02-14;5;5;10;119561;75822;89;195383
52;2021-02-14;3;1;4;42559;15260;90;57819
52;2021-02-14;59;77;136;1952321;1849476;0;3801797
53;2021-02-14;0;2;2;173813;182358;09;356171
53;2021-02-14;0;2;2;202720;214740;19;417460
53;2021-02-14;13;3;16;163116;173196;29;336312
53;2021-02-14;6;1;7;190526;187674;39;378200
53;2021-02-14;2;1;3;212098;212015;49;424113
53;2021-02-14;1;2;3;223699;219176;59;442875
53;2021-02-14;3;1;4;227435;209274;69;436709
53;2021-02-14;1;4;5;169992;140910;79;310902
53;2021-02-14;3;1;4;118117;69883;89;188000
53;2021-02-14;2;1;3;37370;12267;90;49637
53;2021-02-14;31;18;49;1718886;1621493;0;3340379
75;2021-02-14;0;2;2;293104;305291;09;598395
75;2021-02-14;8;5;13;337141;357785;19;694926
75;2021-02-14;12;7;19;295024;300618;29;595642
75;2021-02-14;9;4;13;347871;331233;39;679104
75;2021-02-14;15;7;22;384742;372771;49;757513
75;2021-02-14;10;10;20;413361;390880;59;804241
75;2021-02-14;1;7;8;425623;384060;69;809683
75;2021-02-14;2;3;5;325086;276298;79;601384
75;2021-02-14;9;5;14;213986;139308;89;353294
75;2021-02-14;12;4;16;77600;28200;90;105800
75;2021-02-14;78;54;132;3113538;2886444;0;5999982
76;2021-02-14;2;0;2;305956;318589;09;624545
76;2021-02-14;7;9;17;338942;356969;19;695911
76;2021-02-14;14;12;26;316210;319570;29;635780
76;2021-02-14;24;10;34;356758;337587;39;694345
76;2021-02-14;10;9;19;376541;363812;49;740353
76;2021-02-14;13;12;25;402608;383750;59;786358
76;2021-02-14;11;9;20;394889;358997;69;753886
76;2021-02-14;8;6;14;308664;263806;79;572470
76;2021-02-14;4;6;10;195838;129272;89;325110
76;2021-02-14;6;2;8;69372;26728;90;96100
76;2021-02-14;99;75;175;3065778;2859080;0;5924858
84;2021-02-14;3;7;10;459549;481088;09;940637
84;2021-02-14;15;14;29;487711;511905;19;999616
84;2021-02-14;9;14;23;443824;451094;29;894918
84;2021-02-14;17;24;41;512522;493262;39;1005784
84;2021-02-14;20;20;40;520248;515106;49;1035354
84;2021-02-14;18;16;34;529611;514848;59;1044459
84;2021-02-14;4;23;27;486720;439940;69;926660
84;2021-02-14;8;8;16;372151;315211;79;687362
84;2021-02-14;17;13;30;237198;150524;89;387722
84;2021-02-14;12;2;14;81185;28680;90;109865
84;2021-02-14;123;141;264;4130719;3901658;0;8032377
93;2021-02-14;5;6;11;268834;283093;09;551927
93;2021-02-14;17;19;36;280751;296087;19;576838
93;2021-02-14;21;22;43;254404;255552;29;509956
93;2021-02-14;40;31;71;310704;288398;39;599102
93;2021-02-14;32;28;60;325559;305827;49;631386
93;2021-02-14;19;20;39;353104;325389;59;678493
93;2021-02-14;16;17;33;336327;296459;69;632786
93;2021-02-14;15;9;24;279820;229699;79;509519
93;2021-02-14;16;13;29;171274;113716;89;284990
93;2021-02-14;19;6;25;58896;21758;90;80654
93;2021-02-14;200;171;371;2639673;2415978;0;5055651
94;2021-02-14;0;0;0;16311;17433;09;33744
94;2021-02-14;0;0;0;16679;18132;19;34811
94;2021-02-14;0;0;0;16782;16579;29;33361
94;2021-02-14;1;0;1;23044;20580;39;43624
94;2021-02-14;0;0;0;23065;22140;49;45205
94;2021-02-14;0;1;1;24549;23421;59;47970
94;2021-02-14;1;0;1;23212;21883;69;45095
94;2021-02-14;0;0;0;19544;17141;79;36685
94;2021-02-14;2;0;2;11227;8178;89;19405
94;2021-02-14;0;0;0;3332;1447;90;4779
94;2021-02-14;4;1;5;177745;166934;0;344679
01;2021-02-15;0;0;0;19979;20155;09;40134
01;2021-02-15;1;1;2;24994;25489;19;50483
01;2021-02-15;1;5;6;17868;16690;29;34558
01;2021-02-15;5;3;8;22328;14821;39;37149
01;2021-02-15;1;2;3;28652;20276;49;48928
01;2021-02-15;4;3;7;33264;27260;59;60524
01;2021-02-15;6;8;14;27135;23978;69;51113
01;2021-02-15;3;0;3;18401;14661;79;33062
01;2021-02-15;1;0;1;9633;6375;89;16008
01;2021-02-15;1;0;1;3410;1510;90;4920
01;2021-02-15;23;22;45;205664;171215;0;376879
02;2021-02-15;0;0;0;16881;17110;09;33991
02;2021-02-15;2;0;2;21410;21604;19;43014
02;2021-02-15;3;0;3;16017;15479;29;31496
02;2021-02-15;2;0;2;19825;14455;39;34280
02;2021-02-15;1;0;1;24719;18248;49;42967
02;2021-02-15;1;1;2;34361;28310;59;62671
02;2021-02-15;0;1;1;28061;24495;69;52556
02;2021-02-15;2;0;2;18231;15278;79;33509
02;2021-02-15;4;1;5;11090;7677;89;18767
02;2021-02-15;0;0;0;3992;1506;90;5498
02;2021-02-15;15;3;18;194587;164162;0;358749
03;2021-02-15;0;1;1;31123;30920;09;62043
03;2021-02-15;1;0;1;29370;29268;19;58638
03;2021-02-15;1;0;1;21458;18963;29;40421
03;2021-02-15;2;5;7;21276;18326;39;39602
03;2021-02-15;2;2;4;18164;16593;49;34757
03;2021-02-15;1;0;1;13469;13557;59;27026
03;2021-02-15;0;0;0;8776;8670;69;17446
03;2021-02-15;0;1;1;3777;3591;79;7368
03;2021-02-15;0;0;0;1649;1072;89;2721
03;2021-02-15;0;0;0;485;184;90;669
03;2021-02-15;7;9;16;149547;141144;0;290691
04;2021-02-15;2;6;8;60314;61377;09;121691
04;2021-02-15;9;16;25;66065;68387;19;134452
04;2021-02-15;15;13;28;51059;47156;29;98215
04;2021-02-15;23;4;27;58788;45780;39;104568
04;2021-02-15;24;5;29;61408;52207;49;113615
04;2021-02-15;9;7;16;64838;60759;59;125597
04;2021-02-15;5;6;11;47008;42843;69;89851
04;2021-02-15;1;2;3;25509;21184;79;46693
04;2021-02-15;1;3;4;13168;7647;89;20815
04;2021-02-15;1;0;1;3209;1253;90;4462
04;2021-02-15;90;62;152;451366;408593;0;859959
05;2021-02-15;0;0;0;362.366008612902;341.338819562748;09;703.704828175651
05;2021-02-15;0;0;0;353.376145114279;370.349735405642;19;723.725880519921
05;2021-02-15;0;0;0;218.593559489256;256.539602589476;29;475.133162078732
05;2021-02-15;0;0;0;404.225408693299;360.321910454353;39;764.547319147651
05;2021-02-15;0;0;0;520.067953604221;497.108383964256;49;1017.17633756848
05;2021-02-15;0;0;0;468.146063921917;510.087601910415;59;978.233665832332
05;2021-02-15;0;0;0;340.368470050554;334.366842191253;69;674.735312241807
05;2021-02-15;0;0;0;212.598666888387;192.597753227106;79;405.196420115493
05;2021-02-15;0;0;0;148.727797095705;61.8681715431829;89;210.595968638888
05;2021-02-15;0;0;0;32.9601271090696;10.9909785719784;90;43.9511056810479
05;2021-02-15;0;0;0;3061.43020057959;2935.56979942041;0;5997
06;2021-02-15;8;3;11;42583;42380;09;84963
06;2021-02-15;40;31;72;33369;31925;19;65294
06;2021-02-15;65;52;117;21571;15080;29;36651
06;2021-02-15;65;57;122;21550;16147;39;37697
06;2021-02-15;51;56;107;14193;13939;49;28132
06;2021-02-15;30;46;76;7171;7597;59;14768
06;2021-02-15;12;9;21;3629;4117;69;7746
06;2021-02-15;6;12;18;1577;1457;79;3034
06;2021-02-15;0;0;0;531;474;89;1005
06;2021-02-15;1;0;1;88;93;90;181
06;2021-02-15;278;266;545;146262;133209;0;279471
07;2021-02-15;0;0;0;485;549;09;1034
07;2021-02-15;0;0;0;403;432;19;835
07;2021-02-15;0;0;0;764;841;29;1605
07;2021-02-15;4;1;5;824;928;39;1752
07;2021-02-15;2;0;2;788;1020;49;1808
07;2021-02-15;0;0;0;678;870;59;1548
07;2021-02-15;0;1;1;360;382;69;742
07;2021-02-15;0;0;0;231;190;79;421
07;2021-02-15;0;0;0;114;67;89;181
07;2021-02-15;0;0;0;24;11;90;35
07;2021-02-15;6;2;8;4671;5290;0;9961
08;2021-02-15;0;0;0;2715.22592983026;2997.75551488675;09;5712.98144471701
08;2021-02-15;0;0;0;2778.51901080978;3160.9156459093;19;5939.43465671908
08;2021-02-15;0;0;0;2080.8882988764;1718.16634315323;29;3799.05464202964
08;2021-02-15;1;1;2;2701.8582062647;1896.52641413317;39;4598.38462039786
08;2021-02-15;3;3;6;3151.45861023308;2460.52498233809;49;5611.98359257117
08;2021-02-15;0;3;3;2620.29868333099;2422.23566154656;59;5042.53434487755
08;2021-02-15;1;1;2;1621.44173420671;1438.58325779464;69;3060.02499200135
08;2021-02-15;0;0;0;626.575909335673;526.358467843651;79;1152.93437717932
08;2021-02-15;0;0;0;205.018522985054;140.993639349697;89;346.012162334751
08;2021-02-15;0;0;0;50.0325684687745;20.62259870351;90;70.6551671722846
08;2021-02-15;5;8;13;18551.3174743414;16782.6825256586;0;35334
11;2021-02-15;133;148;300;783071;811785;09;1594856
11;2021-02-15;348;361;748;761456;784653;19;1546109
11;2021-02-15;562;502;1066;850145;801772;29;1651917
11;2021-02-15;673;509;1183;914360;843488;39;1757848
11;2021-02-15;612;582;1197;845609;826202;49;1671811
11;2021-02-15;445;404;851;793566;745070;59;1538636
11;2021-02-15;320;296;626;628649;549192;69;1177841
11;2021-02-15;132;161;293;434606;358356;79;792962
11;2021-02-15;94;78;172;261425;162933;89;424358
11;2021-02-15;59;23;83;89253;32619;90;121872
11;2021-02-15;3378;3066;6521;6362140;5916070;0;12278210
24;2021-02-15;16;11;27;139720;144686;09;284406
24;2021-02-15;46;46;92;152979;161185;19;314164
24;2021-02-15;73;49;122;122237;126536;29;248773
24;2021-02-15;70;46;116;150359;142009;39;292368
24;2021-02-15;74;68;142;161829;158758;49;320587
24;2021-02-15;68;55;124;172552;168011;59;340563
24;2021-02-15;49;43;92;172509;158177;69;330686
24;2021-02-15;24;35;59;129428;110593;79;240021
24;2021-02-15;32;23;56;87342;56882;89;144224
24;2021-02-15;31;8;39;31210;12071;90;43281
24;2021-02-15;483;384;870;1320165;1238908;0;2559073
27;2021-02-15;8;20;28;143373;149679;09;293052
27;2021-02-15;58;48;107;160962;173003;19;333965
27;2021-02-15;63;48;111;133746;142254;29;276000
27;2021-02-15;77;61;138;160004;155407;39;315411
27;2021-02-15;76;66;142;172333;169564;49;341897
27;2021-02-15;53;71;124;189979;183788;59;373767
27;2021-02-15;55;49;104;192591;178206;69;370797
27;2021-02-15;38;42;80;146876;127546;79;274422
27;2021-02-15;30;21;51;96896;61575;89;158471
27;2021-02-15;17;6;23;33148;12109;90;45257
27;2021-02-15;475;432;908;1429908;1353131;0;2783039
28;2021-02-15;19;21;41;180735;186856;09;367591
28;2021-02-15;66;68;135;200125;213621;19;413746
28;2021-02-15;70;63;133;168922;173007;29;341929
28;2021-02-15;83;59;143;196628;188487;39;385115
28;2021-02-15;79;60;140;205396;201699;49;407095
28;2021-02-15;68;75;143;222002;213866;59;435868
28;2021-02-15;61;63;124;224688;203758;69;428446
28;2021-02-15;37;36;73;163192;135543;79;298735
28;2021-02-15;35;25;60;109691;65377;89;175068
28;2021-02-15;13;10;23;37222;12685;90;49907
28;2021-02-15;531;480;1015;1708601;1594899;0;3303500
32;2021-02-15;70;76;146;358062;373689;09;731751
32;2021-02-15;237;213;451;387045;406742;19;793787
32;2021-02-15;257;202;459;342304;348587;29;690891
32;2021-02-15;313;280;593;382485;369972;39;752457
32;2021-02-15;283;254;537;382510;376716;49;759226
32;2021-02-15;219;247;467;386937;376527;59;763464
32;2021-02-15;177;154;331;371211;330938;69;702149
32;2021-02-15;102;80;182;250542;201459;79;452001
32;2021-02-15;114;54;168;163399;89786;89;253185
32;2021-02-15;77;16;93;48384;15367;90;63751
32;2021-02-15;1850;1576;3428;3072879;2889783;0;5962662
44;2021-02-15;69;71;144;291525;306839;09;598364
44;2021-02-15;144;167;313;320255;339504;19;659759
44;2021-02-15;185;199;385;302020;314428;29;616448
44;2021-02-15;183;173;357;342222;333292;39;675514
44;2021-02-15;171;164;338;349727;344491;49;694218
44;2021-02-15;170;149;319;381371;373239;59;754610
44;2021-02-15;121;113;235;367165;335850;69;703015
44;2021-02-15;73;60;134;250387;215436;79;465823
44;2021-02-15;70;33;103;170825;105192;89;276017
44;2021-02-15;41;13;55;51248;16731;90;67979
44;2021-02-15;1227;1142;2384;2826745;2685002;0;5511747
52;2021-02-15;20;23;44;213594;223900;09;437494
52;2021-02-15;46;81;129;240818;255197;19;496015
52;2021-02-15;61;52;113;197010;200630;29;397640
52;2021-02-15;77;48;125;231204;224885;39;456089
52;2021-02-15;85;70;155;243874;243418;49;487292
52;2021-02-15;68;59;127;244100;239116;59;483216
52;2021-02-15;48;56;104;241796;221345;69;463141
52;2021-02-15;33;33;66;177805;149903;79;327708
52;2021-02-15;34;23;57;119561;75822;89;195383
52;2021-02-15;33;8;41;42559;15260;90;57819
52;2021-02-15;506;454;963;1952321;1849476;0;3801797
53;2021-02-15;22;16;38;173813;182358;09;356171
53;2021-02-15;43;43;87;202720;214740;19;417460
53;2021-02-15;66;65;131;163116;173196;29;336312
53;2021-02-15;62;44;106;190526;187674;39;378200
53;2021-02-15;55;41;96;212098;212015;49;424113
53;2021-02-15;50;45;95;223699;219176;59;442875
53;2021-02-15;24;25;49;227435;209274;69;436709
53;2021-02-15;22;22;44;169992;140910;79;310902
53;2021-02-15;25;16;41;118117;69883;89;188000
53;2021-02-15;26;6;32;37370;12267;90;49637
53;2021-02-15;395;323;719;1718886;1621493;0;3340379
75;2021-02-15;34;27;61;293104;305291;09;598395
75;2021-02-15;84;64;149;337141;357785;19;694926
75;2021-02-15;86;80;166;295024;300618;29;595642
75;2021-02-15;125;86;211;347871;331233;39;679104
75;2021-02-15;129;84;214;384742;372771;49;757513
75;2021-02-15;85;96;181;413361;390880;59;804241
75;2021-02-15;55;51;106;425623;384060;69;809683
75;2021-02-15;51;47;98;325086;276298;79;601384
75;2021-02-15;43;31;74;213986;139308;89;353294
75;2021-02-15;51;18;69;77600;28200;90;105800
75;2021-02-15;743;584;1329;3113538;2886444;0;5999982
76;2021-02-15;37;49;86;305956;318589;09;624545
76;2021-02-15;110;106;216;338942;356969;19;695911
76;2021-02-15;145;127;272;316210;319570;29;635780
76;2021-02-15;173;143;316;356758;337587;39;694345
76;2021-02-15;178;144;322;376541;363812;49;740353
76;2021-02-15;146;149;295;402608;383750;59;786358
76;2021-02-15;89;92;181;394889;358997;69;753886
76;2021-02-15;66;70;136;308664;263806;79;572470
76;2021-02-15;75;47;122;195838;129272;89;325110
76;2021-02-15;59;19;78;69372;26728;90;96100
76;2021-02-15;1083;952;2035;3065778;2859080;0;5924858
84;2021-02-15;67;76;144;459549;481088;09;940637
84;2021-02-15;179;199;379;487711;511905;19;999616
84;2021-02-15;278;190;468;443824;451094;29;894918
84;2021-02-15;284;225;509;512522;493262;39;1005784
84;2021-02-15;267;263;530;520248;515106;49;1035354
84;2021-02-15;246;259;505;529611;514848;59;1044459
84;2021-02-15;156;127;284;486720;439940;69;926660
84;2021-02-15;98;126;224;372151;315211;79;687362
84;2021-02-15;110;65;175;237198;150524;89;387722
84;2021-02-15;58;23;81;81185;28680;90;109865
84;2021-02-15;1743;1553;3302;4130719;3901658;0;8032377
93;2021-02-15;80;77;158;268834;283093;09;551927
93;2021-02-15;264;266;532;280751;296087;19;576838
93;2021-02-15;310;241;552;254404;255552;29;509956
93;2021-02-15;340;272;614;310704;288398;39;599102
93;2021-02-15;338;289;628;325559;305827;49;631386
93;2021-02-15;306;259;566;353104;325389;59;678493
93;2021-02-15;218;195;413;336327;296459;69;632786
93;2021-02-15;154;127;281;279820;229699;79;509519
93;2021-02-15;105;72;177;171274;113716;89;284990
93;2021-02-15;77;25;102;58896;21758;90;80654
93;2021-02-15;2192;1823;4023;2639673;2415978;0;5055651
94;2021-02-15;1;0;1;16311;17433;09;33744
94;2021-02-15;2;1;3;16679;18132;19;34811
94;2021-02-15;5;6;11;16782;16579;29;33361
94;2021-02-15;2;3;5;23044;20580;39;43624
94;2021-02-15;4;7;11;23065;22140;49;45205
94;2021-02-15;8;3;11;24549;23421;59;47970
94;2021-02-15;9;3;12;23212;21883;69;45095
94;2021-02-15;4;4;8;19544;17141;79;36685
94;2021-02-15;1;4;5;11227;8178;89;19405
94;2021-02-15;0;0;0;3332;1447;90;4779
94;2021-02-15;36;31;67;177745;166934;0;344679
01;2021-02-16;0;0;0;19979;20155;09;40134
01;2021-02-16;1;0;1;24994;25489;19;50483
01;2021-02-16;2;2;4;17868;16690;29;34558
01;2021-02-16;1;0;1;22328;14821;39;37149
01;2021-02-16;0;1;1;28652;20276;49;48928
01;2021-02-16;1;1;2;33264;27260;59;60524
01;2021-02-16;0;0;0;27135;23978;69;51113
01;2021-02-16;0;0;0;18401;14661;79;33062
01;2021-02-16;0;0;0;9633;6375;89;16008
01;2021-02-16;0;0;0;3410;1510;90;4920
01;2021-02-16;5;4;9;205664;171215;0;376879
02;2021-02-16;0;0;0;16881;17110;09;33991
02;2021-02-16;0;0;0;21410;21604;19;43014
02;2021-02-16;1;0;1;16017;15479;29;31496
02;2021-02-16;0;0;0;19825;14455;39;34280
02;2021-02-16;0;0;0;24719;18248;49;42967
02;2021-02-16;0;0;0;34361;28310;59;62671
02;2021-02-16;0;1;1;28061;24495;69;52556
02;2021-02-16;0;0;0;18231;15278;79;33509
02;2021-02-16;0;1;1;11090;7677;89;18767
02;2021-02-16;0;0;0;3992;1506;90;5498
02;2021-02-16;1;2;3;194587;164162;0;358749
03;2021-02-16;1;0;1;31123;30920;09;62043
03;2021-02-16;3;0;3;29370;29268;19;58638
03;2021-02-16;2;2;4;21458;18963;29;40421
03;2021-02-16;3;0;3;21276;18326;39;39602
03;2021-02-16;1;1;2;18164;16593;49;34757
03;2021-02-16;1;2;3;13469;13557;59;27026
03;2021-02-16;1;1;2;8776;8670;69;17446
03;2021-02-16;0;0;0;3777;3591;79;7368
03;2021-02-16;0;0;0;1649;1072;89;2721
03;2021-02-16;1;0;1;485;184;90;669
03;2021-02-16;13;6;19;149547;141144;0;290691
04;2021-02-16;7;7;14;60314;61377;09;121691
04;2021-02-16;15;10;25;66065;68387;19;134452
04;2021-02-16;13;11;24;51059;47156;29;98215
04;2021-02-16;18;15;33;58788;45780;39;104568
04;2021-02-16;17;15;32;61408;52207;49;113615
04;2021-02-16;14;8;22;64838;60759;59;125597
04;2021-02-16;4;9;13;47008;42843;69;89851
04;2021-02-16;1;3;4;25509;21184;79;46693
04;2021-02-16;1;0;1;13168;7647;89;20815
04;2021-02-16;0;0;0;3209;1253;90;4462
04;2021-02-16;90;78;168;451366;408593;0;859959
05;2021-02-16;0;0;0;362.366008612902;341.338819562748;09;703.704828175651
05;2021-02-16;0;0;0;353.376145114279;370.349735405642;19;723.725880519921
05;2021-02-16;0;0;0;218.593559489256;256.539602589476;29;475.133162078732
05;2021-02-16;0;0;0;404.225408693299;360.321910454353;39;764.547319147651
05;2021-02-16;0;0;0;520.067953604221;497.108383964256;49;1017.17633756848
05;2021-02-16;0;0;0;468.146063921917;510.087601910415;59;978.233665832332
05;2021-02-16;0;0;0;340.368470050554;334.366842191253;69;674.735312241807
05;2021-02-16;0;0;0;212.598666888387;192.597753227106;79;405.196420115493
05;2021-02-16;0;0;0;148.727797095705;61.8681715431829;89;210.595968638888
05;2021-02-16;0;0;0;32.9601271090696;10.9909785719784;90;43.9511056810479
05;2021-02-16;0;0;0;3061.43020057959;2935.56979942041;0;5997
06;2021-02-16;2;1;3;42583;42380;09;84963
06;2021-02-16;24;14;39;33369;31925;19;65294
06;2021-02-16;38;39;77;21571;15080;29;36651
06;2021-02-16;64;43;107;21550;16147;39;37697
06;2021-02-16;27;46;73;14193;13939;49;28132
06;2021-02-16;28;26;54;7171;7597;59;14768
06;2021-02-16;12;6;18;3629;4117;69;7746
06;2021-02-16;4;2;6;1577;1457;79;3034
06;2021-02-16;1;2;3;531;474;89;1005
06;2021-02-16;0;2;2;88;93;90;181
06;2021-02-16;200;181;382;146262;133209;0;279471
07;2021-02-16;0;0;0;485;549;09;1034
07;2021-02-16;0;0;0;403;432;19;835
07;2021-02-16;1;0;1;764;841;29;1605
07;2021-02-16;0;0;0;824;928;39;1752
07;2021-02-16;0;0;0;788;1020;49;1808
07;2021-02-16;1;0;1;678;870;59;1548
07;2021-02-16;1;0;1;360;382;69;742
07;2021-02-16;0;0;0;231;190;79;421
07;2021-02-16;0;0;0;114;67;89;181
07;2021-02-16;0;0;0;24;11;90;35
07;2021-02-16;3;0;3;4671;5290;0;9961
08;2021-02-16;0;0;0;2715.22592983026;2997.75551488675;09;5712.98144471701
08;2021-02-16;0;0;0;2778.51901080978;3160.9156459093;19;5939.43465671908
08;2021-02-16;0;1;1;2080.8882988764;1718.16634315323;29;3799.05464202964
08;2021-02-16;0;0;0;2701.8582062647;1896.52641413317;39;4598.38462039786
08;2021-02-16;0;0;0;3151.45861023308;2460.52498233809;49;5611.98359257117
08;2021-02-16;1;0;1;2620.29868333099;2422.23566154656;59;5042.53434487755
08;2021-02-16;1;2;3;1621.44173420671;1438.58325779464;69;3060.02499200135
08;2021-02-16;0;0;0;626.575909335673;526.358467843651;79;1152.93437717932
08;2021-02-16;0;0;0;205.018522985054;140.993639349697;89;346.012162334751
08;2021-02-16;0;0;0;50.0325684687745;20.62259870351;90;70.6551671722846
08;2021-02-16;2;3;5;18551.3174743414;16782.6825256586;0;35334
11;2021-02-16;105;130;243;783071;811785;09;1594856
11;2021-02-16;303;346;671;761456;784653;19;1546109
11;2021-02-16;554;441;995;850145;801772;29;1651917
11;2021-02-16;521;457;978;914360;843488;39;1757848
11;2021-02-16;469;484;955;845609;826202;49;1671811
11;2021-02-16;409;349;758;793566;745070;59;1538636
11;2021-02-16;264;228;495;628649;549192;69;1177841
11;2021-02-16;155;113;269;434606;358356;79;792962
11;2021-02-16;102;72;174;261425;162933;89;424358
11;2021-02-16;63;18;81;89253;32619;90;121872
11;2021-02-16;2945;2643;5624;6362140;5916070;0;12278210
24;2021-02-16;11;7;19;139720;144686;09;284406
24;2021-02-16;35;42;77;152979;161185;19;314164
24;2021-02-16;58;47;105;122237;126536;29;248773
24;2021-02-16;68;47;115;150359;142009;39;292368
24;2021-02-16;58;35;93;161829;158758;49;320587
24;2021-02-16;62;30;92;172552;168011;59;340563
24;2021-02-16;24;41;65;172509;158177;69;330686
24;2021-02-16;29;30;59;129428;110593;79;240021
24;2021-02-16;26;20;46;87342;56882;89;144224
24;2021-02-16;33;14;47;31210;12071;90;43281
24;2021-02-16;404;313;718;1320165;1238908;0;2559073
27;2021-02-16;13;18;31;143373;149679;09;293052
27;2021-02-16;30;32;63;160962;173003;19;333965
27;2021-02-16;47;42;89;133746;142254;29;276000
27;2021-02-16;56;39;95;160004;155407;39;315411
27;2021-02-16;54;48;102;172333;169564;49;341897
27;2021-02-16;48;34;82;189979;183788;59;373767
27;2021-02-16;48;41;89;192591;178206;69;370797
27;2021-02-16;38;31;69;146876;127546;79;274422
27;2021-02-16;32;14;46;96896;61575;89;158471
27;2021-02-16;28;8;36;33148;12109;90;45257
27;2021-02-16;394;307;702;1429908;1353131;0;2783039
28;2021-02-16;21;16;38;180735;186856;09;367591
28;2021-02-16;61;70;131;200125;213621;19;413746
28;2021-02-16;57;41;98;168922;173007;29;341929
28;2021-02-16;61;61;122;196628;188487;39;385115
28;2021-02-16;61;57;118;205396;201699;49;407095
28;2021-02-16;52;62;114;222002;213866;59;435868
28;2021-02-16;48;34;82;224688;203758;69;428446
28;2021-02-16;30;27;57;163192;135543;79;298735
28;2021-02-16;24;28;52;109691;65377;89;175068
28;2021-02-16;12;3;15;37222;12685;90;49907
28;2021-02-16;427;399;827;1708601;1594899;0;3303500
32;2021-02-16;57;63;120;358062;373689;09;731751
32;2021-02-16;170;201;372;387045;406742;19;793787
32;2021-02-16;215;185;400;342304;348587;29;690891
32;2021-02-16;233;200;433;382485;369972;39;752457
32;2021-02-16;229;185;414;382510;376716;49;759226
32;2021-02-16;196;223;419;386937;376527;59;763464
32;2021-02-16;139;129;268;371211;330938;69;702149
32;2021-02-16;105;73;178;250542;201459;79;452001
32;2021-02-16;96;47;144;163399;89786;89;253185
32;2021-02-16;39;15;54;48384;15367;90;63751
32;2021-02-16;1479;1321;2802;3072879;2889783;0;5962662
44;2021-02-16;40;39;79;291525;306839;09;598364
44;2021-02-16;119;130;254;320255;339504;19;659759
44;2021-02-16;112;131;243;302020;314428;29;616448
44;2021-02-16;145;115;263;342222;333292;39;675514
44;2021-02-16;131;115;247;349727;344491;49;694218
44;2021-02-16;106;121;229;381371;373239;59;754610
44;2021-02-16;59;55;115;367165;335850;69;703015
44;2021-02-16;54;42;96;250387;215436;79;465823
44;2021-02-16;46;35;85;170825;105192;89;276017
44;2021-02-16;27;6;33;51248;16731;90;67979
44;2021-02-16;839;789;1644;2826745;2685002;0;5511747
52;2021-02-16;11;18;31;213594;223900;09;437494
52;2021-02-16;52;64;119;240818;255197;19;496015
52;2021-02-16;48;60;108;197010;200630;29;397640
52;2021-02-16;63;59;122;231204;224885;39;456089
52;2021-02-16;67;62;129;243874;243418;49;487292
52;2021-02-16;61;44;105;244100;239116;59;483216
52;2021-02-16;47;38;85;241796;221345;69;463141
52;2021-02-16;26;21;47;177805;149903;79;327708
52;2021-02-16;28;15;43;119561;75822;89;195383
52;2021-02-16;13;5;18;42559;15260;90;57819
52;2021-02-16;416;386;807;1952321;1849476;0;3801797
53;2021-02-16;16;19;35;173813;182358;09;356171
53;2021-02-16;21;49;70;202720;214740;19;417460
53;2021-02-16;60;42;102;163116;173196;29;336312
53;2021-02-16;49;35;84;190526;187674;39;378200
53;2021-02-16;47;38;85;212098;212015;49;424113
53;2021-02-16;25;19;44;223699;219176;59;442875
53;2021-02-16;16;19;35;227435;209274;69;436709
53;2021-02-16;19;11;30;169992;140910;79;310902
53;2021-02-16;21;8;29;118117;69883;89;188000
53;2021-02-16;13;6;19;37370;12267;90;49637
53;2021-02-16;287;246;535;1718886;1621493;0;3340379
75;2021-02-16;18;24;43;293104;305291;09;598395
75;2021-02-16;71;59;130;337141;357785;19;694926
75;2021-02-16;67;82;150;295024;300618;29;595642
75;2021-02-16;96;69;165;347871;331233;39;679104
75;2021-02-16;91;61;152;384742;372771;49;757513
75;2021-02-16;67;68;135;413361;390880;59;804241
75;2021-02-16;54;57;112;425623;384060;69;809683
75;2021-02-16;33;29;62;325086;276298;79;601384
75;2021-02-16;33;27;60;213986;139308;89;353294
75;2021-02-16;31;5;36;77600;28200;90;105800
75;2021-02-16;561;482;1046;3113538;2886444;0;5999982
76;2021-02-16;40;28;69;305956;318589;09;624545
76;2021-02-16;83;90;176;338942;356969;19;695911
76;2021-02-16;125;106;232;316210;319570;29;635780
76;2021-02-16;123;107;230;356758;337587;39;694345
76;2021-02-16;121;98;219;376541;363812;49;740353
76;2021-02-16;112;102;215;402608;383750;59;786358
76;2021-02-16;61;71;132;394889;358997;69;753886
76;2021-02-16;51;40;91;308664;263806;79;572470
76;2021-02-16;56;38;94;195838;129272;89;325110
76;2021-02-16;67;9;76;69372;26728;90;96100
76;2021-02-16;839;690;1536;3065778;2859080;0;5924858
84;2021-02-16;51;61;112;459549;481088;09;940637
84;2021-02-16;162;141;304;487711;511905;19;999616
84;2021-02-16;200;130;330;443824;451094;29;894918
84;2021-02-16;222;180;402;512522;493262;39;1005784
84;2021-02-16;185;166;351;520248;515106;49;1035354
84;2021-02-16;208;171;380;529611;514848;59;1044459
84;2021-02-16;119;108;227;486720;439940;69;926660
84;2021-02-16;89;86;175;372151;315211;79;687362
84;2021-02-16;71;59;130;237198;150524;89;387722
84;2021-02-16;65;21;86;81185;28680;90;109865
84;2021-02-16;1372;1123;2499;4130719;3901658;0;8032377
93;2021-02-16;43;59;103;268834;283093;09;551927
93;2021-02-16;216;219;436;280751;296087;19;576838
93;2021-02-16;262;192;455;254404;255552;29;509956
93;2021-02-16;258;228;488;310704;288398;39;599102
93;2021-02-16;271;201;473;325559;305827;49;631386
93;2021-02-16;257;219;477;353104;325389;59;678493
93;2021-02-16;134;136;270;336327;296459;69;632786
93;2021-02-16;119;103;222;279820;229699;79;509519
93;2021-02-16;89;57;146;171274;113716;89;284990
93;2021-02-16;72;23;95;58896;21758;90;80654
93;2021-02-16;1721;1437;3167;2639673;2415978;0;5055651
94;2021-02-16;1;0;1;16311;17433;09;33744
94;2021-02-16;3;2;5;16679;18132;19;34811
94;2021-02-16;3;2;5;16782;16579;29;33361
94;2021-02-16;3;5;8;23044;20580;39;43624
94;2021-02-16;5;1;6;23065;22140;49;45205
94;2021-02-16;7;5;12;24549;23421;59;47970
94;2021-02-16;6;6;12;23212;21883;69;45095
94;2021-02-16;1;1;2;19544;17141;79;36685
94;2021-02-16;0;3;3;11227;8178;89;19405
94;2021-02-16;0;0;0;3332;1447;90;4779
94;2021-02-16;29;25;54;177745;166934;0;344679
01;2021-02-17;0;0;0;19979;20155;09;40134
01;2021-02-17;1;0;1;24994;25489;19;50483
01;2021-02-17;3;1;4;17868;16690;29;34558
01;2021-02-17;0;0;0;22328;14821;39;37149
01;2021-02-17;1;0;1;28652;20276;49;48928
01;2021-02-17;1;0;1;33264;27260;59;60524
01;2021-02-17;1;1;2;27135;23978;69;51113
01;2021-02-17;1;0;1;18401;14661;79;33062
01;2021-02-17;0;0;0;9633;6375;89;16008
01;2021-02-17;0;0;0;3410;1510;90;4920
01;2021-02-17;8;2;10;205664;171215;0;376879
02;2021-02-17;0;0;0;16881;17110;09;33991
02;2021-02-17;0;0;0;21410;21604;19;43014
02;2021-02-17;0;0;0;16017;15479;29;31496
02;2021-02-17;0;0;0;19825;14455;39;34280
02;2021-02-17;1;0;1;24719;18248;49;42967
02;2021-02-17;1;0;1;34361;28310;59;62671
02;2021-02-17;1;0;1;28061;24495;69;52556
02;2021-02-17;0;0;0;18231;15278;79;33509
02;2021-02-17;0;0;0;11090;7677;89;18767
02;2021-02-17;0;0;0;3992;1506;90;5498
02;2021-02-17;3;0;3;194587;164162;0;358749
03;2021-02-17;0;0;0;31123;30920;09;62043
03;2021-02-17;2;0;2;29370;29268;19;58638
03;2021-02-17;0;1;1;21458;18963;29;40421
03;2021-02-17;0;1;1;21276;18326;39;39602
03;2021-02-17;2;2;4;18164;16593;49;34757
03;2021-02-17;0;0;0;13469;13557;59;27026
03;2021-02-17;0;0;0;8776;8670;69;17446
03;2021-02-17;0;0;0;3777;3591;79;7368
03;2021-02-17;1;0;1;1649;1072;89;2721
03;2021-02-17;0;0;0;485;184;90;669
03;2021-02-17;5;4;9;149547;141144;0;290691
04;2021-02-17;3;6;9;60314;61377;09;121691
04;2021-02-17;13;12;25;66065;68387;19;134452
04;2021-02-17;12;14;26;51059;47156;29;98215
04;2021-02-17;11;9;20;58788;45780;39;104568
04;2021-02-17;15;10;25;61408;52207;49;113615
04;2021-02-17;7;11;18;64838;60759;59;125597
04;2021-02-17;2;5;7;47008;42843;69;89851
04;2021-02-17;3;0;3;25509;21184;79;46693
04;2021-02-17;1;0;1;13168;7647;89;20815
04;2021-02-17;0;0;0;3209;1253;90;4462
04;2021-02-17;67;67;134;451366;408593;0;859959
05;2021-02-17;0;0;0;362.366008612902;341.338819562748;09;703.704828175651
05;2021-02-17;0;0;0;353.376145114279;370.349735405642;19;723.725880519921
05;2021-02-17;0;0;0;218.593559489256;256.539602589476;29;475.133162078732
05;2021-02-17;0;0;0;404.225408693299;360.321910454353;39;764.547319147651
05;2021-02-17;0;0;0;520.067953604221;497.108383964256;49;1017.17633756848
05;2021-02-17;0;0;0;468.146063921917;510.087601910415;59;978.233665832332
05;2021-02-17;0;0;0;340.368470050554;334.366842191253;69;674.735312241807
05;2021-02-17;0;0;0;212.598666888387;192.597753227106;79;405.196420115493
05;2021-02-17;0;0;0;148.727797095705;61.8681715431829;89;210.595968638888
05;2021-02-17;0;0;0;32.9601271090696;10.9909785719784;90;43.9511056810479
05;2021-02-17;0;0;0;3061.43020057959;2935.56979942041;0;5997
06;2021-02-17;3;2;6;42583;42380;09;84963
06;2021-02-17;35;14;50;33369;31925;19;65294
06;2021-02-17;49;39;88;21571;15080;29;36651
06;2021-02-17;60;40;100;21550;16147;39;37697
06;2021-02-17;41;34;75;14193;13939;49;28132
06;2021-02-17;25;38;63;7171;7597;59;14768
06;2021-02-17;48;45;95;3629;4117;69;7746
06;2021-02-17;4;6;10;1577;1457;79;3034
06;2021-02-17;2;1;3;531;474;89;1005
06;2021-02-17;1;1;2;88;93;90;181
06;2021-02-17;268;220;492;146262;133209;0;279471
07;2021-02-17;0;0;0;485;549;09;1034
07;2021-02-17;1;0;1;403;432;19;835
07;2021-02-17;6;0;6;764;841;29;1605
07;2021-02-17;2;2;4;824;928;39;1752
07;2021-02-17;2;0;2;788;1020;49;1808
07;2021-02-17;2;0;2;678;870;59;1548
07;2021-02-17;0;1;1;360;382;69;742
07;2021-02-17;0;0;0;231;190;79;421
07;2021-02-17;0;0;0;114;67;89;181
07;2021-02-17;0;0;0;24;11;90;35
07;2021-02-17;13;3;16;4671;5290;0;9961
08;2021-02-17;0;0;0;2715.22592983026;2997.75551488675;09;5712.98144471701
08;2021-02-17;1;0;1;2778.51901080978;3160.9156459093;19;5939.43465671908
08;2021-02-17;0;0;0;2080.8882988764;1718.16634315323;29;3799.05464202964
08;2021-02-17;0;2;2;2701.8582062647;1896.52641413317;39;4598.38462039786
08;2021-02-17;0;1;1;3151.45861023308;2460.52498233809;49;5611.98359257117
08;2021-02-17;1;0;1;2620.29868333099;2422.23566154656;59;5042.53434487755
08;2021-02-17;1;0;1;1621.44173420671;1438.58325779464;69;3060.02499200135
08;2021-02-17;0;0;0;626.575909335673;526.358467843651;79;1152.93437717932
08;2021-02-17;0;0;0;205.018522985054;140.993639349697;89;346.012162334751
08;2021-02-17;0;0;0;50.0325684687745;20.62259870351;90;70.6551671722846
08;2021-02-17;3;3;6;18551.3174743414;16782.6825256586;0;35334
11;2021-02-17;117;105;232;783071;811785;09;1594856
11;2021-02-17;327;347;697;761456;784653;19;1546109
11;2021-02-17;525;502;1028;850145;801772;29;1651917
11;2021-02-17;555;444;1004;914360;843488;39;1757848
11;2021-02-17;506;457;968;845609;826202;49;1671811
11;2021-02-17;387;367;755;793566;745070;59;1538636
11;2021-02-17;221;232;456;628649;549192;69;1177841
11;2021-02-17;115;107;222;434606;358356;79;792962
11;2021-02-17;103;69;173;261425;162933;89;424358
11;2021-02-17;39;14;53;89253;32619;90;121872
11;2021-02-17;2895;2644;5588;6362140;5916070;0;12278210
24;2021-02-17;10;8;19;139720;144686;09;284406
24;2021-02-17;40;54;95;152979;161185;19;314164
24;2021-02-17;64;47;111;122237;126536;29;248773
24;2021-02-17;55;41;96;150359;142009;39;292368
24;2021-02-17;62;46;108;161829;158758;49;320587
24;2021-02-17;46;43;89;172552;168011;59;340563
24;2021-02-17;45;36;81;172509;158177;69;330686
24;2021-02-17;22;30;52;129428;110593;79;240021
24;2021-02-17;12;21;33;87342;56882;89;144224
24;2021-02-17;11;3;14;31210;12071;90;43281
24;2021-02-17;367;329;698;1320165;1238908;0;2559073
27;2021-02-17;10;12;22;143373;149679;09;293052
27;2021-02-17;34;35;69;160962;173003;19;333965
27;2021-02-17;48;36;84;133746;142254;29;276000
27;2021-02-17;53;48;101;160004;155407;39;315411
27;2021-02-17;47;40;87;172333;169564;49;341897
27;2021-02-17;43;40;83;189979;183788;59;373767
27;2021-02-17;38;42;80;192591;178206;69;370797
27;2021-02-17;28;22;50;146876;127546;79;274422
27;2021-02-17;22;22;44;96896;61575;89;158471
27;2021-02-17;16;4;20;33148;12109;90;45257
27;2021-02-17;339;301;640;1429908;1353131;0;2783039
28;2021-02-17;22;17;39;180735;186856;09;367591
28;2021-02-17;68;62;130;200125;213621;19;413746
28;2021-02-17;72;52;125;168922;173007;29;341929
28;2021-02-17;77;57;134;196628;188487;39;385115
28;2021-02-17;76;49;125;205396;201699;49;407095
28;2021-02-17;63;58;121;222002;213866;59;435868
28;2021-02-17;41;39;80;224688;203758;69;428446
28;2021-02-17;26;27;53;163192;135543;79;298735
28;2021-02-17;25;17;42;109691;65377;89;175068
28;2021-02-17;18;4;22;37222;12685;90;49907
28;2021-02-17;488;382;871;1708601;1594899;0;3303500
32;2021-02-17;70;81;151;358062;373689;09;731751
32;2021-02-17;220;214;434;387045;406742;19;793787
32;2021-02-17;234;201;436;342304;348587;29;690891
32;2021-02-17;253;229;482;382485;369972;39;752457
32;2021-02-17;254;217;471;382510;376716;49;759226
32;2021-02-17;185;177;362;386937;376527;59;763464
32;2021-02-17;123;125;248;371211;330938;69;702149
32;2021-02-17;79;69;148;250542;201459;79;452001
32;2021-02-17;58;51;109;163399;89786;89;253185
32;2021-02-17;32;10;42;48384;15367;90;63751
32;2021-02-17;1509;1374;2884;3072879;2889783;0;5962662
44;2021-02-17;35;54;91;291525;306839;09;598364
44;2021-02-17;113;125;241;320255;339504;19;659759
44;2021-02-17;137;143;280;302020;314428;29;616448
44;2021-02-17;120;128;248;342222;333292;39;675514
44;2021-02-17;145;103;248;349727;344491;49;694218
44;2021-02-17;95;98;195;381371;373239;59;754610
44;2021-02-17;80;73;154;367165;335850;69;703015
44;2021-02-17;47;40;90;250387;215436;79;465823
44;2021-02-17;38;30;68;170825;105192;89;276017
44;2021-02-17;24;6;30;51248;16731;90;67979
44;2021-02-17;834;800;1646;2826745;2685002;0;5511747
52;2021-02-17;18;12;30;213594;223900;09;437494
52;2021-02-17;79;88;168;240818;255197;19;496015
52;2021-02-17;61;78;139;197010;200630;29;397640
52;2021-02-17;57;55;112;231204;224885;39;456089
52;2021-02-17;66;46;112;243874;243418;49;487292
52;2021-02-17;67;68;135;244100;239116;59;483216
52;2021-02-17;49;49;98;241796;221345;69;463141
52;2021-02-17;22;27;49;177805;149903;79;327708
52;2021-02-17;28;17;45;119561;75822;89;195383
52;2021-02-17;33;10;43;42559;15260;90;57819
52;2021-02-17;480;450;931;1952321;1849476;0;3801797
53;2021-02-17;30;16;46;173813;182358;09;356171
53;2021-02-17;52;45;99;202720;214740;19;417460
53;2021-02-17;52;65;119;163116;173196;29;336312
53;2021-02-17;42;39;81;190526;187674;39;378200
53;2021-02-17;35;42;77;212098;212015;49;424113
53;2021-02-17;56;40;96;223699;219176;59;442875
53;2021-02-17;12;17;29;227435;209274;69;436709
53;2021-02-17;14;9;23;169992;140910;79;310902
53;2021-02-17;16;12;28;118117;69883;89;188000
53;2021-02-17;8;4;13;37370;12267;90;49637
53;2021-02-17;317;289;611;1718886;1621493;0;3340379
75;2021-02-17;18;18;37;293104;305291;09;598395
75;2021-02-17;55;57;113;337141;357785;19;694926
75;2021-02-17;80;79;159;295024;300618;29;595642
75;2021-02-17;82;71;154;347871;331233;39;679104
75;2021-02-17;85;78;163;384742;372771;49;757513
75;2021-02-17;77;69;147;413361;390880;59;804241
75;2021-02-17;46;51;97;425623;384060;69;809683
75;2021-02-17;31;35;66;325086;276298;79;601384
75;2021-02-17;46;21;67;213986;139308;89;353294
75;2021-02-17;35;16;51;77600;28200;90;105800
75;2021-02-17;555;495;1054;3113538;2886444;0;5999982
76;2021-02-17;25;27;55;305956;318589;09;624545
76;2021-02-17;98;79;180;338942;356969;19;695911
76;2021-02-17;123;109;233;316210;319570;29;635780
76;2021-02-17;124;104;228;356758;337587;39;694345
76;2021-02-17;119;88;207;376541;363812;49;740353
76;2021-02-17;93;118;211;402608;383750;59;786358
76;2021-02-17;71;61;132;394889;358997;69;753886
76;2021-02-17;58;38;96;308664;263806;79;572470
76;2021-02-17;44;28;72;195838;129272;89;325110
76;2021-02-17;33;18;51;69372;26728;90;96100
76;2021-02-17;788;671;1466;3065778;2859080;0;5924858
84;2021-02-17;37;55;92;459549;481088;09;940637
84;2021-02-17;126;152;278;487711;511905;19;999616
84;2021-02-17;169;157;326;443824;451094;29;894918
84;2021-02-17;191;161;352;512522;493262;39;1005784
84;2021-02-17;212;157;370;520248;515106;49;1035354
84;2021-02-17;178;156;334;529611;514848;59;1044459
84;2021-02-17;138;120;258;486720;439940;69;926660
84;2021-02-17;87;82;169;372151;315211;79;687362
84;2021-02-17;81;48;129;237198;150524;89;387722
84;2021-02-17;57;14;71;81185;28680;90;109865
84;2021-02-17;1276;1102;2380;4130719;3901658;0;8032377
93;2021-02-17;37;57;96;268834;283093;09;551927
93;2021-02-17;213;200;415;280751;296087;19;576838
93;2021-02-17;239;205;446;254404;255552;29;509956
93;2021-02-17;241;217;459;310704;288398;39;599102
93;2021-02-17;247;201;448;325559;305827;49;631386
93;2021-02-17;224;184;408;353104;325389;59;678493
93;2021-02-17;138;151;289;336327;296459;69;632786
93;2021-02-17;108;104;212;279820;229699;79;509519
93;2021-02-17;76;49;125;171274;113716;89;284990
93;2021-02-17;38;21;59;58896;21758;90;80654
93;2021-02-17;1561;1390;2958;2639673;2415978;0;5055651
94;2021-02-17;1;2;3;16311;17433;09;33744
94;2021-02-17;3;1;4;16679;18132;19;34811
94;2021-02-17;4;2;6;16782;16579;29;33361
94;2021-02-17;7;5;12;23044;20580;39;43624
94;2021-02-17;1;4;5;23065;22140;49;45205
94;2021-02-17;5;4;9;24549;23421;59;47970
94;2021-02-17;5;2;7;23212;21883;69;45095
94;2021-02-17;3;1;4;19544;17141;79;36685
94;2021-02-17;0;0;0;11227;8178;89;19405
94;2021-02-17;0;0;0;3332;1447;90;4779
94;2021-02-17;29;21;50;177745;166934;0;344679
01;2021-02-18;0;1;1;19979;20155;09;40134
01;2021-02-18;3;3;6;24994;25489;19;50483
01;2021-02-18;7;2;9;17868;16690;29;34558
01;2021-02-18;6;6;12;22328;14821;39;37149
01;2021-02-18;7;7;14;28652;20276;49;48928
01;2021-02-18;4;6;10;33264;27260;59;60524
01;2021-02-18;0;4;4;27135;23978;69;51113
01;2021-02-18;2;0;2;18401;14661;79;33062
01;2021-02-18;0;1;1;9633;6375;89;16008
01;2021-02-18;0;0;0;3410;1510;90;4920
01;2021-02-18;29;30;59;205664;171215;0;376879
02;2021-02-18;0;0;0;16881;17110;09;33991
02;2021-02-18;0;1;1;21410;21604;19;43014
02;2021-02-18;1;0;1;16017;15479;29;31496
02;2021-02-18;1;1;3;19825;14455;39;34280
02;2021-02-18;1;0;1;24719;18248;49;42967
02;2021-02-18;1;1;2;34361;28310;59;62671
02;2021-02-18;1;1;2;28061;24495;69;52556
02;2021-02-18;0;2;2;18231;15278;79;33509
02;2021-02-18;0;0;0;11090;7677;89;18767
02;2021-02-18;0;0;0;3992;1506;90;5498
02;2021-02-18;5;6;12;194587;164162;0;358749
03;2021-02-18;0;0;0;31123;30920;09;62043
03;2021-02-18;2;0;2;29370;29268;19;58638
03;2021-02-18;0;2;2;21458;18963;29;40421
03;2021-02-18;2;0;2;21276;18326;39;39602
03;2021-02-18;2;2;4;18164;16593;49;34757
03;2021-02-18;1;1;2;13469;13557;59;27026
03;2021-02-18;0;0;0;8776;8670;69;17446
03;2021-02-18;0;0;0;3777;3591;79;7368
03;2021-02-18;0;0;0;1649;1072;89;2721
03;2021-02-18;0;0;0;485;184;90;669
03;2021-02-18;7;5;12;149547;141144;0;290691
04;2021-02-18;3;2;5;60314;61377;09;121691
04;2021-02-18;8;10;18;66065;68387;19;134452
04;2021-02-18;10;7;17;51059;47156;29;98215
04;2021-02-18;16;7;23;58788;45780;39;104568
04;2021-02-18;18;13;32;61408;52207;49;113615
04;2021-02-18;7;7;14;64838;60759;59;125597
04;2021-02-18;2;3;5;47008;42843;69;89851
04;2021-02-18;3;2;5;25509;21184;79;46693
04;2021-02-18;2;1;3;13168;7647;89;20815
04;2021-02-18;0;0;0;3209;1253;90;4462
04;2021-02-18;69;52;122;451366;408593;0;859959
05;2021-02-18;0;0;0;362.366008612902;341.338819562748;09;703.704828175651
05;2021-02-18;0;0;0;353.376145114279;370.349735405642;19;723.725880519921
05;2021-02-18;0;0;0;218.593559489256;256.539602589476;29;475.133162078732
05;2021-02-18;0;0;0;404.225408693299;360.321910454353;39;764.547319147651
05;2021-02-18;0;0;0;520.067953604221;497.108383964256;49;1017.17633756848
05;2021-02-18;0;0;0;468.146063921917;510.087601910415;59;978.233665832332
05;2021-02-18;0;0;0;340.368470050554;334.366842191253;69;674.735312241807
05;2021-02-18;0;0;0;212.598666888387;192.597753227106;79;405.196420115493
05;2021-02-18;0;0;0;148.727797095705;61.8681715431829;89;210.595968638888
05;2021-02-18;0;0;0;32.9601271090696;10.9909785719784;90;43.9511056810479
05;2021-02-18;0;0;0;3061.43020057959;2935.56979942041;0;5997
06;2021-02-18;5;5;12;42583;42380;09;84963
06;2021-02-18;25;31;57;33369;31925;19;65294
06;2021-02-18;42;32;74;21571;15080;29;36651
06;2021-02-18;54;27;82;21550;16147;39;37697
06;2021-02-18;26;37;63;14193;13939;49;28132
06;2021-02-18;14;21;35;7171;7597;59;14768
06;2021-02-18;15;11;26;3629;4117;69;7746
06;2021-02-18;2;4;6;1577;1457;79;3034
06;2021-02-18;0;2;2;531;474;89;1005
06;2021-02-18;0;0;0;88;93;90;181
06;2021-02-18;183;170;357;146262;133209;0;279471
07;2021-02-18;0;0;0;485;549;09;1034
07;2021-02-18;1;1;2;403;432;19;835
07;2021-02-18;0;2;2;764;841;29;1605
07;2021-02-18;2;0;2;824;928;39;1752
07;2021-02-18;1;2;3;788;1020;49;1808
07;2021-02-18;0;1;1;678;870;59;1548
07;2021-02-18;1;0;1;360;382;69;742
07;2021-02-18;0;0;0;231;190;79;421
07;2021-02-18;0;0;0;114;67;89;181
07;2021-02-18;0;0;0;24;11;90;35
07;2021-02-18;5;6;11;4671;5290;0;9961
08;2021-02-18;0;0;0;2715.22592983026;2997.75551488675;09;5712.98144471701
08;2021-02-18;0;0;0;2778.51901080978;3160.9156459093;19;5939.43465671908
08;2021-02-18;0;0;0;2080.8882988764;1718.16634315323;29;3799.05464202964
08;2021-02-18;0;1;1;2701.8582062647;1896.52641413317;39;4598.38462039786
08;2021-02-18;2;1;3;3151.45861023308;2460.52498233809;49;5611.98359257117
08;2021-02-18;3;1;4;2620.29868333099;2422.23566154656;59;5042.53434487755
08;2021-02-18;0;2;2;1621.44173420671;1438.58325779464;69;3060.02499200135
08;2021-02-18;1;0;1;626.575909335673;526.358467843651;79;1152.93437717932
08;2021-02-18;0;0;0;205.018522985054;140.993639349697;89;346.012162334751
08;2021-02-18;0;0;0;50.0325684687745;20.62259870351;90;70.6551671722846
08;2021-02-18;6;5;11;18551.3174743414;16782.6825256586;0;35334
11;2021-02-18;108;116;235;783071;811785;09;1594856
11;2021-02-18;365;352;740;761456;784653;19;1546109
11;2021-02-18;590;492;1093;850145;801772;29;1651917
11;2021-02-18;569;496;1072;914360;843488;39;1757848
11;2021-02-18;578;495;1078;845609;826202;49;1671811
11;2021-02-18;388;368;762;793566;745070;59;1538636
11;2021-02-18;249;234;495;628649;549192;69;1177841
11;2021-02-18;135;132;268;434606;358356;79;792962
11;2021-02-18;99;62;162;261425;162933;89;424358
11;2021-02-18;63;24;87;89253;32619;90;121872
11;2021-02-18;3144;2774;5999;6362140;5916070;0;12278210
24;2021-02-18;17;12;32;139720;144686;09;284406
24;2021-02-18;37;38;76;152979;161185;19;314164
24;2021-02-18;48;51;100;122237;126536;29;248773
24;2021-02-18;60;41;101;150359;142009;39;292368
24;2021-02-18;58;53;111;161829;158758;49;320587
24;2021-02-18;45;53;98;172552;168011;59;340563
24;2021-02-18;24;34;58;172509;158177;69;330686
24;2021-02-18;23;17;40;129428;110593;79;240021
24;2021-02-18;13;11;24;87342;56882;89;144224
24;2021-02-18;10;9;19;31210;12071;90;43281
24;2021-02-18;335;319;659;1320165;1238908;0;2559073
27;2021-02-18;17;13;30;143373;149679;09;293052
27;2021-02-18;41;45;87;160962;173003;19;333965
27;2021-02-18;54;41;95;133746;142254;29;276000
27;2021-02-18;53;44;97;160004;155407;39;315411
27;2021-02-18;50;42;92;172333;169564;49;341897
27;2021-02-18;52;43;95;189979;183788;59;373767
27;2021-02-18;38;38;76;192591;178206;69;370797
27;2021-02-18;28;22;50;146876;127546;79;274422
27;2021-02-18;30;17;47;96896;61575;89;158471
27;2021-02-18;19;10;29;33148;12109;90;45257
27;2021-02-18;382;315;698;1429908;1353131;0;2783039
28;2021-02-18;19;21;42;180735;186856;09;367591
28;2021-02-18;72;64;136;200125;213621;19;413746
28;2021-02-18;59;48;107;168922;173007;29;341929
28;2021-02-18;72;48;120;196628;188487;39;385115
28;2021-02-18;86;70;156;205396;201699;49;407095
28;2021-02-18;44;56;100;222002;213866;59;435868
28;2021-02-18;48;43;91;224688;203758;69;428446
28;2021-02-18;26;24;50;163192;135543;79;298735
28;2021-02-18;21;11;32;109691;65377;89;175068
28;2021-02-18;15;4;19;37222;12685;90;49907
28;2021-02-18;463;389;854;1708601;1594899;0;3303500
32;2021-02-18;73;67;141;358062;373689;09;731751
32;2021-02-18;220;230;450;387045;406742;19;793787
32;2021-02-18;246;196;443;342304;348587;29;690891
32;2021-02-18;250;213;463;382485;369972;39;752457
32;2021-02-18;272;252;525;382510;376716;49;759226
32;2021-02-18;209;205;414;386937;376527;59;763464
32;2021-02-18;142;158;300;371211;330938;69;702149
32;2021-02-18;114;101;215;250542;201459;79;452001
32;2021-02-18;107;54;161;163399;89786;89;253185
32;2021-02-18;43;12;55;48384;15367;90;63751
32;2021-02-18;1676;1488;3167;3072879;2889783;0;5962662
44;2021-02-18;35;51;87;291525;306839;09;598364
44;2021-02-18;127;155;282;320255;339504;19;659759
44;2021-02-18;130;147;278;302020;314428;29;616448
44;2021-02-18;135;125;260;342222;333292;39;675514
44;2021-02-18;147;108;256;349727;344491;49;694218
44;2021-02-18;113;94;208;381371;373239;59;754610
44;2021-02-18;65;75;140;367165;335850;69;703015
44;2021-02-18;52;46;99;250387;215436;79;465823
44;2021-02-18;51;30;82;170825;105192;89;276017
44;2021-02-18;21;7;28;51248;16731;90;67979
44;2021-02-18;876;838;1720;2826745;2685002;0;5511747
52;2021-02-18;22;15;38;213594;223900;09;437494
52;2021-02-18;74;73;147;240818;255197;19;496015
52;2021-02-18;90;65;156;197010;200630;29;397640
52;2021-02-18;71;58;129;231204;224885;39;456089
52;2021-02-18;71;61;132;243874;243418;49;487292
52;2021-02-18;55;68;123;244100;239116;59;483216
52;2021-02-18;41;30;71;241796;221345;69;463141
52;2021-02-18;31;20;51;177805;149903;79;327708
52;2021-02-18;34;20;54;119561;75822;89;195383
52;2021-02-18;26;10;36;42559;15260;90;57819
52;2021-02-18;515;420;937;1952321;1849476;0;3801797
53;2021-02-18;9;15;24;173813;182358;09;356171
53;2021-02-18;40;34;77;202720;214740;19;417460
53;2021-02-18;53;45;101;163116;173196;29;336312
53;2021-02-18;64;30;94;190526;187674;39;378200
53;2021-02-18;59;44;103;212098;212015;49;424113
53;2021-02-18;40;52;92;223699;219176;59;442875
53;2021-02-18;24;14;38;227435;209274;69;436709
53;2021-02-18;11;13;24;169992;140910;79;310902
53;2021-02-18;20;14;34;118117;69883;89;188000
53;2021-02-18;15;4;19;37370;12267;90;49637
53;2021-02-18;335;265;606;1718886;1621493;0;3340379
75;2021-02-18;20;17;37;293104;305291;09;598395
75;2021-02-18;61;72;135;337141;357785;19;694926
75;2021-02-18;108;104;213;295024;300618;29;595642
75;2021-02-18;78;90;168;347871;331233;39;679104
75;2021-02-18;75;67;143;384742;372771;49;757513
75;2021-02-18;79;65;145;413361;390880;59;804241
75;2021-02-18;43;51;94;425623;384060;69;809683
75;2021-02-18;35;35;70;325086;276298;79;601384
75;2021-02-18;30;31;61;213986;139308;89;353294
75;2021-02-18;24;12;36;77600;28200;90;105800
75;2021-02-18;553;544;1102;3113538;2886444;0;5999982
76;2021-02-18;19;26;46;305956;318589;09;624545
76;2021-02-18;100;93;198;338942;356969;19;695911
76;2021-02-18;132;120;254;316210;319570;29;635780
76;2021-02-18;120;96;216;356758;337587;39;694345
76;2021-02-18;123;98;221;376541;363812;49;740353
76;2021-02-18;112;97;210;402608;383750;59;786358
76;2021-02-18;59;70;129;394889;358997;69;753886
76;2021-02-18;38;36;74;308664;263806;79;572470
76;2021-02-18;39;27;66;195838;129272;89;325110
76;2021-02-18;26;10;36;69372;26728;90;96100
76;2021-02-18;769;673;1451;3065778;2859080;0;5924858
84;2021-02-18;52;57;109;459549;481088;09;940637
84;2021-02-18;155;165;320;487711;511905;19;999616
84;2021-02-18;187;171;358;443824;451094;29;894918
84;2021-02-18;188;157;345;512522;493262;39;1005784
84;2021-02-18;183;175;358;520248;515106;49;1035354
84;2021-02-18;169;170;339;529611;514848;59;1044459
84;2021-02-18;116;112;228;486720;439940;69;926660
84;2021-02-18;88;67;155;372151;315211;79;687362
84;2021-02-18;69;48;117;237198;150524;89;387722
84;2021-02-18;41;7;49;81185;28680;90;109865
84;2021-02-18;1248;1130;2379;4130719;3901658;0;8032377
93;2021-02-18;46;51;99;268834;283093;09;551927
93;2021-02-18;191;206;400;280751;296087;19;576838
93;2021-02-18;247;186;433;254404;255552;29;509956
93;2021-02-18;274;225;499;310704;288398;39;599102
93;2021-02-18;289;216;505;325559;305827;49;631386
93;2021-02-18;233;221;454;353104;325389;59;678493
93;2021-02-18;184;162;346;336327;296459;69;632786
93;2021-02-18;111;84;195;279820;229699;79;509519
93;2021-02-18;92;48;140;171274;113716;89;284990
93;2021-02-18;54;21;75;58896;21758;90;80654
93;2021-02-18;1721;1420;3146;2639673;2415978;0;5055651
94;2021-02-18;0;1;1;16311;17433;09;33744
94;2021-02-18;6;2;8;16679;18132;19;34811
94;2021-02-18;4;3;7;16782;16579;29;33361
94;2021-02-18;6;13;19;23044;20580;39;43624
94;2021-02-18;3;8;11;23065;22140;49;45205
94;2021-02-18;4;6;10;24549;23421;59;47970
94;2021-02-18;4;6;10;23212;21883;69;45095
94;2021-02-18;4;5;9;19544;17141;79;36685
94;2021-02-18;1;0;1;11227;8178;89;19405
94;2021-02-18;2;0;2;3332;1447;90;4779
94;2021-02-18;34;44;78;177745;166934;0;344679
01;2021-02-19;0;0;0;19979;20155;09;40134
01;2021-02-19;3;2;5;24994;25489;19;50483
01;2021-02-19;9;0;9;17868;16690;29;34558
01;2021-02-19;12;7;19;22328;14821;39;37149
01;2021-02-19;5;1;6;28652;20276;49;48928
01;2021-02-19;6;9;15;33264;27260;59;60524
01;2021-02-19;4;5;9;27135;23978;69;51113
01;2021-02-19;1;1;2;18401;14661;79;33062
01;2021-02-19;0;1;1;9633;6375;89;16008
01;2021-02-19;1;0;1;3410;1510;90;4920
01;2021-02-19;41;26;67;205664;171215;0;376879
02;2021-02-19;0;0;0;16881;17110;09;33991
02;2021-02-19;0;0;0;21410;21604;19;43014
02;2021-02-19;4;5;9;16017;15479;29;31496
02;2021-02-19;1;3;4;19825;14455;39;34280
02;2021-02-19;0;1;1;24719;18248;49;42967
02;2021-02-19;3;0;3;34361;28310;59;62671
02;2021-02-19;0;0;0;28061;24495;69;52556
02;2021-02-19;0;0;0;18231;15278;79;33509
02;2021-02-19;0;0;0;11090;7677;89;18767
02;2021-02-19;0;0;0;3992;1506;90;5498
02;2021-02-19;8;9;17;194587;164162;0;358749
03;2021-02-19;0;0;0;31123;30920;09;62043
03;2021-02-19;0;2;2;29370;29268;19;58638
03;2021-02-19;1;1;2;21458;18963;29;40421
03;2021-02-19;2;1;3;21276;18326;39;39602
03;2021-02-19;0;0;0;18164;16593;49;34757
03;2021-02-19;1;3;4;13469;13557;59;27026
03;2021-02-19;2;0;2;8776;8670;69;17446
03;2021-02-19;0;0;0;3777;3591;79;7368
03;2021-02-19;0;0;1;1649;1072;89;2721
03;2021-02-19;0;0;0;485;184;90;669
03;2021-02-19;6;7;14;149547;141144;0;290691
04;2021-02-19;4;5;9;60314;61377;09;121691
04;2021-02-19;7;12;19;66065;68387;19;134452
04;2021-02-19;12;11;23;51059;47156;29;98215
04;2021-02-19;24;8;32;58788;45780;39;104568
04;2021-02-19;18;10;28;61408;52207;49;113615
04;2021-02-19;13;10;23;64838;60759;59;125597
04;2021-02-19;5;3;8;47008;42843;69;89851
04;2021-02-19;0;3;3;25509;21184;79;46693
04;2021-02-19;0;1;1;13168;7647;89;20815
04;2021-02-19;0;0;0;3209;1253;90;4462
04;2021-02-19;83;63;146;451366;408593;0;859959
05;2021-02-19;0;0;0;362.366008612902;341.338819562748;09;703.704828175651
05;2021-02-19;0;0;0;353.376145114279;370.349735405642;19;723.725880519921
05;2021-02-19;0;0;0;218.593559489256;256.539602589476;29;475.133162078732
05;2021-02-19;0;0;0;404.225408693299;360.321910454353;39;764.547319147651
05;2021-02-19;0;0;0;520.067953604221;497.108383964256;49;1017.17633756848
05;2021-02-19;0;0;0;468.146063921917;510.087601910415;59;978.233665832332
05;2021-02-19;0;0;0;340.368470050554;334.366842191253;69;674.735312241807
05;2021-02-19;0;0;0;212.598666888387;192.597753227106;79;405.196420115493
05;2021-02-19;0;0;0;148.727797095705;61.8681715431829;89;210.595968638888
05;2021-02-19;0;0;0;32.9601271090696;10.9909785719784;90;43.9511056810479
05;2021-02-19;0;0;0;3061.43020057959;2935.56979942041;0;5997
06;2021-02-19;6;1;7;42583;42380;09;84963
06;2021-02-19;32;23;55;33369;31925;19;65294
06;2021-02-19;55;36;91;21571;15080;29;36651
06;2021-02-19;43;49;92;21550;16147;39;37697
06;2021-02-19;26;36;62;14193;13939;49;28132
06;2021-02-19;14;32;46;7171;7597;59;14768
06;2021-02-19;43;33;78;3629;4117;69;7746
06;2021-02-19;7;3;10;1577;1457;79;3034
06;2021-02-19;0;1;1;531;474;89;1005
06;2021-02-19;1;1;2;88;93;90;181
06;2021-02-19;227;215;444;146262;133209;0;279471
07;2021-02-19;0;0;0;485;549;09;1034
07;2021-02-19;2;1;3;403;432;19;835
07;2021-02-19;0;0;0;764;841;29;1605
07;2021-02-19;3;1;4;824;928;39;1752
07;2021-02-19;1;1;2;788;1020;49;1808
07;2021-02-19;1;2;3;678;870;59;1548
07;2021-02-19;0;0;0;360;382;69;742
07;2021-02-19;1;0;1;231;190;79;421
07;2021-02-19;0;0;0;114;67;89;181
07;2021-02-19;0;0;0;24;11;90;35
07;2021-02-19;8;5;13;4671;5290;0;9961
08;2021-02-19;0;0;0;2715.22592983026;2997.75551488675;09;5712.98144471701
08;2021-02-19;1;0;1;2778.51901080978;3160.9156459093;19;5939.43465671908
08;2021-02-19;1;1;2;2080.8882988764;1718.16634315323;29;3799.05464202964
08;2021-02-19;2;1;3;2701.8582062647;1896.52641413317;39;4598.38462039786
08;2021-02-19;2;0;2;3151.45861023308;2460.52498233809;49;5611.98359257117
08;2021-02-19;0;1;1;2620.29868333099;2422.23566154656;59;5042.53434487755
08;2021-02-19;2;0;2;1621.44173420671;1438.58325779464;69;3060.02499200135
08;2021-02-19;1;0;1;626.575909335673;526.358467843651;79;1152.93437717932
08;2021-02-19;0;0;0;205.018522985054;140.993639349697;89;346.012162334751
08;2021-02-19;0;0;0;50.0325684687745;20.62259870351;90;70.6551671722846
08;2021-02-19;9;3;12;18551.3174743414;16782.6825256586;0;35334
11;2021-02-19;143;168;323;783071;811785;09;1594856
11;2021-02-19;417;428;868;761456;784653;19;1546109
11;2021-02-19;599;548;1153;850145;801772;29;1651917
11;2021-02-19;630;565;1204;914360;843488;39;1757848
11;2021-02-19;532;511;1049;845609;826202;49;1671811
11;2021-02-19;469;434;909;793566;745070;59;1538636
11;2021-02-19;284;295;590;628649;549192;69;1177841
11;2021-02-19;154;139;294;434606;358356;79;792962
11;2021-02-19;101;63;165;261425;162933;89;424358
11;2021-02-19;49;12;61;89253;32619;90;121872
11;2021-02-19;3378;3164;6618;6362140;5916070;0;12278210
24;2021-02-19;12;19;32;139720;144686;09;284406
24;2021-02-19;60;63;124;152979;161185;19;314164
24;2021-02-19;45;54;99;122237;126536;29;248773
24;2021-02-19;47;52;99;150359;142009;39;292368
24;2021-02-19;71;49;120;161829;158758;49;320587
24;2021-02-19;49;58;108;172552;168011;59;340563
24;2021-02-19;43;47;90;172509;158177;69;330686
24;2021-02-19;12;21;33;129428;110593;79;240021
24;2021-02-19;14;12;26;87342;56882;89;144224
24;2021-02-19;10;7;17;31210;12071;90;43281
24;2021-02-19;363;382;748;1320165;1238908;0;2559073
27;2021-02-19;15;14;30;143373;149679;09;293052
27;2021-02-19;52;57;111;160962;173003;19;333965
27;2021-02-19;55;69;124;133746;142254;29;276000
27;2021-02-19;43;51;94;160004;155407;39;315411
27;2021-02-19;54;48;102;172333;169564;49;341897
27;2021-02-19;67;67;134;189979;183788;59;373767
27;2021-02-19;37;45;82;192591;178206;69;370797
27;2021-02-19;28;30;58;146876;127546;79;274422
27;2021-02-19;30;18;48;96896;61575;89;158471
27;2021-02-19;26;6;32;33148;12109;90;45257
27;2021-02-19;407;405;815;1429908;1353131;0;2783039
28;2021-02-19;19;21;42;180735;186856;09;367591
28;2021-02-19;83;66;152;200125;213621;19;413746
28;2021-02-19;79;63;142;168922;173007;29;341929
28;2021-02-19;67;54;121;196628;188487;39;385115
28;2021-02-19;65;71;136;205396;201699;49;407095
28;2021-02-19;72;59;131;222002;213866;59;435868
28;2021-02-19;60;46;106;224688;203758;69;428446
28;2021-02-19;28;30;58;163192;135543;79;298735
28;2021-02-19;19;9;28;109691;65377;89;175068
28;2021-02-19;2;4;6;37222;12685;90;49907
28;2021-02-19;494;423;922;1708601;1594899;0;3303500
32;2021-02-19;78;79;157;358062;373689;09;731751
32;2021-02-19;239;251;490;387045;406742;19;793787
32;2021-02-19;254;234;488;342304;348587;29;690891
32;2021-02-19;262;220;483;382485;369972;39;752457
32;2021-02-19;290;267;557;382510;376716;49;759226
32;2021-02-19;225;222;447;386937;376527;59;763464
32;2021-02-19;158;144;302;371211;330938;69;702149
32;2021-02-19;114;91;205;250542;201459;79;452001
32;2021-02-19;79;64;143;163399;89786;89;253185
32;2021-02-19;27;14;41;48384;15367;90;63751
32;2021-02-19;1726;1587;3314;3072879;2889783;0;5962662
44;2021-02-19;44;43;87;291525;306839;09;598364
44;2021-02-19;135;127;263;320255;339504;19;659759
44;2021-02-19;143;145;290;302020;314428;29;616448
44;2021-02-19;141;113;256;342222;333292;39;675514
44;2021-02-19;127;132;260;349727;344491;49;694218
44;2021-02-19;96;121;223;381371;373239;59;754610
44;2021-02-19;69;69;141;367165;335850;69;703015
44;2021-02-19;40;38;79;250387;215436;79;465823
44;2021-02-19;38;17;55;170825;105192;89;276017
44;2021-02-19;21;9;30;51248;16731;90;67979
44;2021-02-19;854;814;1684;2826745;2685002;0;5511747
52;2021-02-19;19;20;39;213594;223900;09;437494
52;2021-02-19;73;62;140;240818;255197;19;496015
52;2021-02-19;81;93;174;197010;200630;29;397640
52;2021-02-19;76;57;133;231204;224885;39;456089
52;2021-02-19;67;66;133;243874;243418;49;487292
52;2021-02-19;70;65;135;244100;239116;59;483216
52;2021-02-19;39;44;83;241796;221345;69;463141
52;2021-02-19;32;24;56;177805;149903;79;327708
52;2021-02-19;20;18;38;119561;75822;89;195383
52;2021-02-19;5;4;9;42559;15260;90;57819
52;2021-02-19;482;453;940;1952321;1849476;0;3801797
53;2021-02-19;24;16;43;173813;182358;09;356171
53;2021-02-19;48;32;81;202720;214740;19;417460
53;2021-02-19;47;44;91;163116;173196;29;336312
53;2021-02-19;39;43;82;190526;187674;39;378200
53;2021-02-19;46;32;78;212098;212015;49;424113
53;2021-02-19;35;52;87;223699;219176;59;442875
53;2021-02-19;32;35;67;227435;209274;69;436709
53;2021-02-19;11;17;28;169992;140910;79;310902
53;2021-02-19;29;13;42;118117;69883;89;188000
53;2021-02-19;15;5;20;37370;12267;90;49637
53;2021-02-19;326;289;619;1718886;1621493;0;3340379
75;2021-02-19;37;29;66;293104;305291;09;598395
75;2021-02-19;81;108;190;337141;357785;19;694926
75;2021-02-19;101;101;204;295024;300618;29;595642
75;2021-02-19;102;90;192;347871;331233;39;679104
75;2021-02-19;87;84;171;384742;372771;49;757513
75;2021-02-19;88;88;177;413361;390880;59;804241
75;2021-02-19;64;60;125;425623;384060;69;809683
75;2021-02-19;46;37;83;325086;276298;79;601384
75;2021-02-19;33;24;57;213986;139308;89;353294
75;2021-02-19;43;5;48;77600;28200;90;105800
75;2021-02-19;683;626;1314;3113538;2886444;0;5999982
76;2021-02-19;32;22;54;305956;318589;09;624545
76;2021-02-19;94;122;220;338942;356969;19;695911
76;2021-02-19;140;100;240;316210;319570;29;635780
76;2021-02-19;165;108;273;356758;337587;39;694345
76;2021-02-19;134;113;247;376541;363812;49;740353
76;2021-02-19;107;106;213;402608;383750;59;786358
76;2021-02-19;84;65;149;394889;358997;69;753886
76;2021-02-19;50;52;102;308664;263806;79;572470
76;2021-02-19;39;25;64;195838;129272;89;325110
76;2021-02-19;29;8;37;69372;26728;90;96100
76;2021-02-19;877;721;1602;3065778;2859080;0;5924858
84;2021-02-19;51;59;111;459549;481088;09;940637
84;2021-02-19;191;189;380;487711;511905;19;999616
84;2021-02-19;199;190;389;443824;451094;29;894918
84;2021-02-19;229;197;426;512522;493262;39;1005784
84;2021-02-19;185;195;382;520248;515106;49;1035354
84;2021-02-19;180;192;373;529611;514848;59;1044459
84;2021-02-19;132;132;264;486720;439940;69;926660
84;2021-02-19;120;93;213;372151;315211;79;687362
84;2021-02-19;78;47;125;237198;150524;89;387722
84;2021-02-19;47;15;62;81185;28680;90;109865
84;2021-02-19;1412;1309;2725;4130719;3901658;0;8032377
93;2021-02-19;67;58;125;268834;283093;09;551927
93;2021-02-19;200;199;400;280751;296087;19;576838
93;2021-02-19;277;226;505;254404;255552;29;509956
93;2021-02-19;296;241;537;310704;288398;39;599102
93;2021-02-19;302;224;526;325559;305827;49;631386
93;2021-02-19;233;218;451;353104;325389;59;678493
93;2021-02-19;168;169;337;336327;296459;69;632786
93;2021-02-19;103;107;211;279820;229699;79;509519
93;2021-02-19;76;58;134;171274;113716;89;284990
93;2021-02-19;50;16;66;58896;21758;90;80654
93;2021-02-19;1772;1516;3292;2639673;2415978;0;5055651
94;2021-02-19;2;1;3;16311;17433;09;33744
94;2021-02-19;2;8;10;16679;18132;19;34811
94;2021-02-19;7;6;13;16782;16579;29;33361
94;2021-02-19;2;8;10;23044;20580;39;43624
94;2021-02-19;5;5;10;23065;22140;49;45205
94;2021-02-19;5;4;9;24549;23421;59;47970
94;2021-02-19;5;5;10;23212;21883;69;45095
94;2021-02-19;2;2;4;19544;17141;79;36685
94;2021-02-19;2;0;2;11227;8178;89;19405
94;2021-02-19;0;1;1;3332;1447;90;4779
94;2021-02-19;32;40;72;177745;166934;0;344679
01;2021-02-20;0;0;0;19979;20155;09;40134
01;2021-02-20;1;1;2;24994;25489;19;50483
01;2021-02-20;2;2;4;17868;16690;29;34558
01;2021-02-20;3;2;5;22328;14821;39;37149
01;2021-02-20;4;0;4;28652;20276;49;48928
01;2021-02-20;3;2;5;33264;27260;59;60524
01;2021-02-20;1;2;3;27135;23978;69;51113
01;2021-02-20;0;1;1;18401;14661;79;33062
01;2021-02-20;0;0;0;9633;6375;89;16008
01;2021-02-20;0;0;0;3410;1510;90;4920
01;2021-02-20;14;10;24;205664;171215;0;376879
02;2021-02-20;0;0;0;16881;17110;09;33991
02;2021-02-20;2;0;2;21410;21604;19;43014
02;2021-02-20;1;0;1;16017;15479;29;31496
02;2021-02-20;0;0;0;19825;14455;39;34280
02;2021-02-20;1;2;3;24719;18248;49;42967
02;2021-02-20;0;0;0;34361;28310;59;62671
02;2021-02-20;0;0;0;28061;24495;69;52556
02;2021-02-20;1;0;1;18231;15278;79;33509
02;2021-02-20;0;0;0;11090;7677;89;18767
02;2021-02-20;0;0;0;3992;1506;90;5498
02;2021-02-20;5;2;7;194587;164162;0;358749
03;2021-02-20;0;0;0;31123;30920;09;62043
03;2021-02-20;0;0;0;29370;29268;19;58638
03;2021-02-20;0;2;2;21458;18963;29;40421
03;2021-02-20;0;0;0;21276;18326;39;39602
03;2021-02-20;0;4;4;18164;16593;49;34757
03;2021-02-20;1;0;1;13469;13557;59;27026
03;2021-02-20;1;1;2;8776;8670;69;17446
03;2021-02-20;0;0;0;3777;3591;79;7368
03;2021-02-20;0;0;0;1649;1072;89;2721
03;2021-02-20;0;0;0;485;184;90;669
03;2021-02-20;2;7;9;149547;141144;0;290691
04;2021-02-20;3;4;7;60314;61377;09;121691
04;2021-02-20;9;12;21;66065;68387;19;134452
04;2021-02-20;10;7;17;51059;47156;29;98215
04;2021-02-20;10;6;16;58788;45780;39;104568
04;2021-02-20;10;8;18;61408;52207;49;113615
04;2021-02-20;6;4;10;64838;60759;59;125597
04;2021-02-20;4;1;5;47008;42843;69;89851
04;2021-02-20;0;1;1;25509;21184;79;46693
04;2021-02-20;1;0;1;13168;7647;89;20815
04;2021-02-20;0;0;0;3209;1253;90;4462
04;2021-02-20;53;43;96;451366;408593;0;859959
05;2021-02-20;0;0;0;362.366008612902;341.338819562748;09;703.704828175651
05;2021-02-20;0;0;0;353.376145114279;370.349735405642;19;723.725880519921
05;2021-02-20;0;0;0;218.593559489256;256.539602589476;29;475.133162078732
05;2021-02-20;0;0;0;404.225408693299;360.321910454353;39;764.547319147651
05;2021-02-20;0;0;0;520.067953604221;497.108383964256;49;1017.17633756848
05;2021-02-20;0;0;0;468.146063921917;510.087601910415;59;978.233665832332
05;2021-02-20;0;0;0;340.368470050554;334.366842191253;69;674.735312241807
05;2021-02-20;0;0;0;212.598666888387;192.597753227106;79;405.196420115493
05;2021-02-20;0;0;0;148.727797095705;61.8681715431829;89;210.595968638888
05;2021-02-20;0;0;0;32.9601271090696;10.9909785719784;90;43.9511056810479
05;2021-02-20;0;0;0;3061.43020057959;2935.56979942041;0;5997
06;2021-02-20;1;3;4;42583;42380;09;84963
06;2021-02-20;6;0;6;33369;31925;19;65294
06;2021-02-20;13;6;19;21571;15080;29;36651
06;2021-02-20;11;13;24;21550;16147;39;37697
06;2021-02-20;15;7;22;14193;13939;49;28132
06;2021-02-20;4;9;13;7171;7597;59;14768
06;2021-02-20;2;7;9;3629;4117;69;7746
06;2021-02-20;2;2;4;1577;1457;79;3034
06;2021-02-20;0;1;1;531;474;89;1005
06;2021-02-20;0;0;0;88;93;90;181
06;2021-02-20;54;48;102;146262;133209;0;279471
07;2021-02-20;0;0;0;485;549;09;1034
07;2021-02-20;2;0;2;403;432;19;835
07;2021-02-20;0;0;0;764;841;29;1605
07;2021-02-20;1;0;1;824;928;39;1752
07;2021-02-20;0;2;2;788;1020;49;1808
07;2021-02-20;1;2;3;678;870;59;1548
07;2021-02-20;2;0;2;360;382;69;742
07;2021-02-20;0;0;0;231;190;79;421
07;2021-02-20;0;0;0;114;67;89;181
07;2021-02-20;0;0;0;24;11;90;35
07;2021-02-20;6;4;10;4671;5290;0;9961
08;2021-02-20;0;0;0;2715.22592983026;2997.75551488675;09;5712.98144471701
08;2021-02-20;0;0;0;2778.51901080978;3160.9156459093;19;5939.43465671908
08;2021-02-20;0;1;1;2080.8882988764;1718.16634315323;29;3799.05464202964
08;2021-02-20;0;0;0;2701.8582062647;1896.52641413317;39;4598.38462039786
08;2021-02-20;2;0;2;3151.45861023308;2460.52498233809;49;5611.98359257117
08;2021-02-20;0;1;1;2620.29868333099;2422.23566154656;59;5042.53434487755
08;2021-02-20;0;0;0;1621.44173420671;1438.58325779464;69;3060.02499200135
08;2021-02-20;0;0;0;626.575909335673;526.358467843651;79;1152.93437717932
08;2021-02-20;0;0;0;205.018522985054;140.993639349697;89;346.012162334751
08;2021-02-20;0;0;0;50.0325684687745;20.62259870351;90;70.6551671722846
08;2021-02-20;2;2;4;18551.3174743414;16782.6825256586;0;35334
11;2021-02-20;89;90;185;783071;811785;09;1594856
11;2021-02-20;209;247;464;761456;784653;19;1546109
11;2021-02-20;332;320;652;850145;801772;29;1651917
11;2021-02-20;357;321;679;914360;843488;39;1757848
11;2021-02-20;315;321;638;845609;826202;49;1671811
11;2021-02-20;249;270;519;793566;745070;59;1538636
11;2021-02-20;173;172;346;628649;549192;69;1177841
11;2021-02-20;75;83;159;434606;358356;79;792962
11;2021-02-20;60;45;105;261425;162933;89;424358
11;2021-02-20;20;7;27;89253;32619;90;121872
11;2021-02-20;1880;1876;3775;6362140;5916070;0;12278210
24;2021-02-20;5;5;11;139720;144686;09;284406
24;2021-02-20;33;30;64;152979;161185;19;314164
24;2021-02-20;26;33;59;122237;126536;29;248773
24;2021-02-20;31;24;55;150359;142009;39;292368
24;2021-02-20;34;31;65;161829;158758;49;320587
24;2021-02-20;37;25;62;172552;168011;59;340563
24;2021-02-20;29;24;53;172509;158177;69;330686
24;2021-02-20;14;16;30;129428;110593;79;240021
24;2021-02-20;9;7;16;87342;56882;89;144224
24;2021-02-20;5;2;7;31210;12071;90;43281
24;2021-02-20;223;197;422;1320165;1238908;0;2559073
27;2021-02-20;8;11;19;143373;149679;09;293052
27;2021-02-20;22;37;59;160962;173003;19;333965
27;2021-02-20;43;38;81;133746;142254;29;276000
27;2021-02-20;34;35;69;160004;155407;39;315411
27;2021-02-20;40;27;67;172333;169564;49;341897
27;2021-02-20;45;39;84;189979;183788;59;373767
27;2021-02-20;33;28;61;192591;178206;69;370797
27;2021-02-20;22;19;41;146876;127546;79;274422
27;2021-02-20;11;14;25;96896;61575;89;158471
27;2021-02-20;10;2;12;33148;12109;90;45257
27;2021-02-20;268;250;518;1429908;1353131;0;2783039
28;2021-02-20;6;11;17;180735;186856;09;367591
28;2021-02-20;37;41;79;200125;213621;19;413746
28;2021-02-20;35;35;70;168922;173007;29;341929
28;2021-02-20;52;43;95;196628;188487;39;385115
28;2021-02-20;46;37;83;205396;201699;49;407095
28;2021-02-20;37;33;70;222002;213866;59;435868
28;2021-02-20;34;20;54;224688;203758;69;428446
28;2021-02-20;15;20;35;163192;135543;79;298735
28;2021-02-20;11;10;21;109691;65377;89;175068
28;2021-02-20;7;0;7;37222;12685;90;49907
28;2021-02-20;280;250;531;1708601;1594899;0;3303500
32;2021-02-20;38;56;94;358062;373689;09;731751
32;2021-02-20;154;146;300;387045;406742;19;793787
32;2021-02-20;148;146;294;342304;348587;29;690891
32;2021-02-20;163;133;296;382485;369972;39;752457
32;2021-02-20;171;150;321;382510;376716;49;759226
32;2021-02-20;155;165;320;386937;376527;59;763464
32;2021-02-20;97;86;183;371211;330938;69;702149
32;2021-02-20;74;53;127;250542;201459;79;452001
32;2021-02-20;53;36;89;163399;89786;89;253185
32;2021-02-20;19;11;30;48384;15367;90;63751
32;2021-02-20;1075;983;2058;3072879;2889783;0;5962662
44;2021-02-20;29;23;52;291525;306839;09;598364
44;2021-02-20;59;73;132;320255;339504;19;659759
44;2021-02-20;84;67;151;302020;314428;29;616448
44;2021-02-20;71;72;143;342222;333292;39;675514
44;2021-02-20;68;83;151;349727;344491;49;694218
44;2021-02-20;73;75;148;381371;373239;59;754610
44;2021-02-20;55;44;99;367165;335850;69;703015
44;2021-02-20;23;39;62;250387;215436;79;465823
44;2021-02-20;22;23;45;170825;105192;89;276017
44;2021-02-20;8;5;13;51248;16731;90;67979
44;2021-02-20;492;504;996;2826745;2685002;0;5511747
52;2021-02-20;15;10;25;213594;223900;09;437494
52;2021-02-20;47;61;111;240818;255197;19;496015
52;2021-02-20;56;49;105;197010;200630;29;397640
52;2021-02-20;53;46;99;231204;224885;39;456089
52;2021-02-20;52;50;102;243874;243418;49;487292
52;2021-02-20;48;51;99;244100;239116;59;483216
52;2021-02-20;26;31;57;241796;221345;69;463141
52;2021-02-20;18;25;43;177805;149903;79;327708
52;2021-02-20;14;6;20;119561;75822;89;195383
52;2021-02-20;4;5;9;42559;15260;90;57819
52;2021-02-20;333;334;670;1952321;1849476;0;3801797
53;2021-02-20;11;9;20;173813;182358;09;356171
53;2021-02-20;29;32;62;202720;214740;19;417460
53;2021-02-20;34;20;54;163116;173196;29;336312
53;2021-02-20;37;19;56;190526;187674;39;378200
53;2021-02-20;23;24;47;212098;212015;49;424113
53;2021-02-20;22;27;49;223699;219176;59;442875
53;2021-02-20;6;10;16;227435;209274;69;436709
53;2021-02-20;7;8;15;169992;140910;79;310902
53;2021-02-20;15;3;18;118117;69883;89;188000
53;2021-02-20;5;3;8;37370;12267;90;49637
53;2021-02-20;189;155;345;1718886;1621493;0;3340379
75;2021-02-20;16;12;28;293104;305291;09;598395
75;2021-02-20;52;71;123;337141;357785;19;694926
75;2021-02-20;61;40;101;295024;300618;29;595642
75;2021-02-20;58;48;106;347871;331233;39;679104
75;2021-02-20;61;41;102;384742;372771;49;757513
75;2021-02-20;57;53;110;413361;390880;59;804241
75;2021-02-20;31;28;59;425623;384060;69;809683
75;2021-02-20;21;21;42;325086;276298;79;601384
75;2021-02-20;15;11;26;213986;139308;89;353294
75;2021-02-20;5;2;7;77600;28200;90;105800
75;2021-02-20;377;327;704;3113538;2886444;0;5999982
76;2021-02-20;15;19;34;305956;318589;09;624545
76;2021-02-20;53;66;119;338942;356969;19;695911
76;2021-02-20;69;62;131;316210;319570;29;635780
76;2021-02-20;65;68;133;356758;337587;39;694345
76;2021-02-20;58;40;98;376541;363812;49;740353
76;2021-02-20;63;51;114;402608;383750;59;786358
76;2021-02-20;38;41;79;394889;358997;69;753886
76;2021-02-20;18;21;39;308664;263806;79;572470
76;2021-02-20;23;17;40;195838;129272;89;325110
76;2021-02-20;19;10;29;69372;26728;90;96100
76;2021-02-20;422;395;817;3065778;2859080;0;5924858
84;2021-02-20;31;35;66;459549;481088;09;940637
84;2021-02-20;122;120;242;487711;511905;19;999616
84;2021-02-20;110;109;219;443824;451094;29;894918
84;2021-02-20;116;106;222;512522;493262;39;1005784
84;2021-02-20;127;108;235;520248;515106;49;1035354
84;2021-02-20;94;88;183;529611;514848;59;1044459
84;2021-02-20;58;63;121;486720;439940;69;926660
84;2021-02-20;31;34;65;372151;315211;79;687362
84;2021-02-20;32;26;58;237198;150524;89;387722
84;2021-02-20;11;8;19;81185;28680;90;109865
84;2021-02-20;732;697;1430;4130719;3901658;0;8032377
93;2021-02-20;42;49;91;268834;283093;09;551927
93;2021-02-20;111;114;225;280751;296087;19;576838
93;2021-02-20;134;134;268;254404;255552;29;509956
93;2021-02-20;144;124;269;310704;288398;39;599102
93;2021-02-20;146;134;280;325559;305827;49;631386
93;2021-02-20;137;125;263;353104;325389;59;678493
93;2021-02-20;80;84;165;336327;296459;69;632786
93;2021-02-20;52;45;97;279820;229699;79;509519
93;2021-02-20;28;28;56;171274;113716;89;284990
93;2021-02-20;18;10;28;58896;21758;90;80654
93;2021-02-20;892;847;1742;2639673;2415978;0;5055651
94;2021-02-20;1;1;2;16311;17433;09;33744
94;2021-02-20;4;5;9;16679;18132;19;34811
94;2021-02-20;3;0;3;16782;16579;29;33361
94;2021-02-20;6;1;7;23044;20580;39;43624
94;2021-02-20;3;5;8;23065;22140;49;45205
94;2021-02-20;3;8;11;24549;23421;59;47970
94;2021-02-20;2;2;4;23212;21883;69;45095
94;2021-02-20;0;0;0;19544;17141;79;36685
94;2021-02-20;0;1;1;11227;8178;89;19405
94;2021-02-20;0;0;0;3332;1447;90;4779
94;2021-02-20;22;23;45;177745;166934;0;344679
01;2021-02-21;0;0;0;19979;20155;09;40134
01;2021-02-21;0;0;0;24994;25489;19;50483
01;2021-02-21;0;0;0;17868;16690;29;34558
01;2021-02-21;0;0;0;22328;14821;39;37149
01;2021-02-21;0;0;0;28652;20276;49;48928
01;2021-02-21;2;0;2;33264;27260;59;60524
01;2021-02-21;0;1;1;27135;23978;69;51113
01;2021-02-21;0;1;1;18401;14661;79;33062
01;2021-02-21;0;0;0;9633;6375;89;16008
01;2021-02-21;0;0;0;3410;1510;90;4920
01;2021-02-21;2;2;4;205664;171215;0;376879
02;2021-02-21;0;0;0;16881;17110;09;33991
02;2021-02-21;0;0;0;21410;21604;19;43014
02;2021-02-21;0;0;0;16017;15479;29;31496
02;2021-02-21;0;0;0;19825;14455;39;34280
02;2021-02-21;0;0;0;24719;18248;49;42967
02;2021-02-21;0;0;0;34361;28310;59;62671
02;2021-02-21;0;0;0;28061;24495;69;52556
02;2021-02-21;0;0;0;18231;15278;79;33509
02;2021-02-21;2;0;2;11090;7677;89;18767
02;2021-02-21;0;0;0;3992;1506;90;5498
02;2021-02-21;2;0;2;194587;164162;0;358749
03;2021-02-21;0;0;0;31123;30920;09;62043
03;2021-02-21;1;0;1;29370;29268;19;58638
03;2021-02-21;2;0;2;21458;18963;29;40421
03;2021-02-21;0;1;1;21276;18326;39;39602
03;2021-02-21;0;0;0;18164;16593;49;34757
03;2021-02-21;1;1;2;13469;13557;59;27026
03;2021-02-21;0;0;0;8776;8670;69;17446
03;2021-02-21;0;0;0;3777;3591;79;7368
03;2021-02-21;0;0;0;1649;1072;89;2721
03;2021-02-21;0;0;0;485;184;90;669
03;2021-02-21;4;2;6;149547;141144;0;290691
04;2021-02-21;0;1;1;60314;61377;09;121691
04;2021-02-21;0;3;3;66065;68387;19;134452
04;2021-02-21;4;3;7;51059;47156;29;98215
04;2021-02-21;0;1;1;58788;45780;39;104568
04;2021-02-21;1;4;5;61408;52207;49;113615
04;2021-02-21;3;2;5;64838;60759;59;125597
04;2021-02-21;1;0;1;47008;42843;69;89851
04;2021-02-21;0;1;1;25509;21184;79;46693
04;2021-02-21;0;0;0;13168;7647;89;20815
04;2021-02-21;0;0;0;3209;1253;90;4462
04;2021-02-21;9;15;24;451366;408593;0;859959
05;2021-02-21;0;0;0;362.366008612902;341.338819562748;09;703.704828175651
05;2021-02-21;0;0;0;353.376145114279;370.349735405642;19;723.725880519921
05;2021-02-21;0;0;0;218.593559489256;256.539602589476;29;475.133162078732
05;2021-02-21;0;0;0;404.225408693299;360.321910454353;39;764.547319147651
05;2021-02-21;0;0;0;520.067953604221;497.108383964256;49;1017.17633756848
05;2021-02-21;0;0;0;468.146063921917;510.087601910415;59;978.233665832332
05;2021-02-21;0;0;0;340.368470050554;334.366842191253;69;674.735312241807
05;2021-02-21;0;0;0;212.598666888387;192.597753227106;79;405.196420115493
05;2021-02-21;0;0;0;148.727797095705;61.8681715431829;89;210.595968638888
05;2021-02-21;0;0;0;32.9601271090696;10.9909785719784;90;43.9511056810479
05;2021-02-21;0;0;0;3061.43020057959;2935.56979942041;0;5997
06;2021-02-21;1;1;2;42583;42380;09;84963
06;2021-02-21;4;0;4;33369;31925;19;65294
06;2021-02-21;7;7;14;21571;15080;29;36651
06;2021-02-21;11;2;13;21550;16147;39;37697
06;2021-02-21;10;8;18;14193;13939;49;28132
06;2021-02-21;3;7;10;7171;7597;59;14768
06;2021-02-21;17;12;30;3629;4117;69;7746
06;2021-02-21;2;1;3;1577;1457;79;3034
06;2021-02-21;1;0;1;531;474;89;1005
06;2021-02-21;0;0;0;88;93;90;181
06;2021-02-21;56;38;95;146262;133209;0;279471
07;2021-02-21;0;0;0;485;549;09;1034
07;2021-02-21;0;0;0;403;432;19;835
07;2021-02-21;0;0;0;764;841;29;1605
07;2021-02-21;1;1;2;824;928;39;1752
07;2021-02-21;0;0;0;788;1020;49;1808
07;2021-02-21;0;0;0;678;870;59;1548
07;2021-02-21;0;0;0;360;382;69;742
07;2021-02-21;0;0;0;231;190;79;421
07;2021-02-21;0;0;0;114;67;89;181
07;2021-02-21;0;0;0;24;11;90;35
07;2021-02-21;1;1;2;4671;5290;0;9961
08;2021-02-21;0;0;0;2715.22592983026;2997.75551488675;09;5712.98144471701
08;2021-02-21;0;0;0;2778.51901080978;3160.9156459093;19;5939.43465671908
08;2021-02-21;0;0;0;2080.8882988764;1718.16634315323;29;3799.05464202964
08;2021-02-21;0;0;0;2701.8582062647;1896.52641413317;39;4598.38462039786
08;2021-02-21;0;0;0;3151.45861023308;2460.52498233809;49;5611.98359257117
08;2021-02-21;0;0;0;2620.29868333099;2422.23566154656;59;5042.53434487755
08;2021-02-21;0;0;0;1621.44173420671;1438.58325779464;69;3060.02499200135
08;2021-02-21;0;0;0;626.575909335673;526.358467843651;79;1152.93437717932
08;2021-02-21;0;0;0;205.018522985054;140.993639349697;89;346.012162334751
08;2021-02-21;0;0;0;50.0325684687745;20.62259870351;90;70.6551671722846
08;2021-02-21;0;0;0;18551.3174743414;16782.6825256586;0;35334
11;2021-02-21;23;21;46;783071;811785;09;1594856
11;2021-02-21;52;64;116;761456;784653;19;1546109
11;2021-02-21;94;90;184;850145;801772;29;1651917
11;2021-02-21;109;88;197;914360;843488;39;1757848
11;2021-02-21;89;78;167;845609;826202;49;1671811
11;2021-02-21;61;51;112;793566;745070;59;1538636
11;2021-02-21;40;59;99;628649;549192;69;1177841
11;2021-02-21;36;34;70;434606;358356;79;792962
11;2021-02-21;30;26;56;261425;162933;89;424358
11;2021-02-21;11;3;14;89253;32619;90;121872
11;2021-02-21;545;514;1061;6362140;5916070;0;12278210
24;2021-02-21;1;2;3;139720;144686;09;284406
24;2021-02-21;5;2;7;152979;161185;19;314164
24;2021-02-21;3;2;5;122237;126536;29;248773
24;2021-02-21;5;5;10;150359;142009;39;292368
24;2021-02-21;5;8;13;161829;158758;49;320587
24;2021-02-21;4;2;6;172552;168011;59;340563
24;2021-02-21;2;4;6;172509;158177;69;330686
24;2021-02-21;2;3;5;129428;110593;79;240021
24;2021-02-21;7;4;11;87342;56882;89;144224
24;2021-02-21;4;1;5;31210;12071;90;43281
24;2021-02-21;38;33;71;1320165;1238908;0;2559073
27;2021-02-21;2;2;4;143373;149679;09;293052
27;2021-02-21;3;2;5;160962;173003;19;333965
27;2021-02-21;7;4;11;133746;142254;29;276000
27;2021-02-21;5;5;10;160004;155407;39;315411
27;2021-02-21;4;5;9;172333;169564;49;341897
27;2021-02-21;3;3;6;189979;183788;59;373767
27;2021-02-21;3;3;6;192591;178206;69;370797
27;2021-02-21;3;11;14;146876;127546;79;274422
27;2021-02-21;8;6;14;96896;61575;89;158471
27;2021-02-21;7;2;9;33148;12109;90;45257
27;2021-02-21;45;43;88;1429908;1353131;0;2783039
28;2021-02-21;1;2;3;180735;186856;09;367591
28;2021-02-21;1;5;6;200125;213621;19;413746
28;2021-02-21;7;7;14;168922;173007;29;341929
28;2021-02-21;7;6;13;196628;188487;39;385115
28;2021-02-21;10;10;20;205396;201699;49;407095
28;2021-02-21;10;6;16;222002;213866;59;435868
28;2021-02-21;4;8;12;224688;203758;69;428446
28;2021-02-21;3;3;6;163192;135543;79;298735
28;2021-02-21;1;2;3;109691;65377;89;175068
28;2021-02-21;1;0;1;37222;12685;90;49907
28;2021-02-21;45;49;94;1708601;1594899;0;3303500
32;2021-02-21;23;13;36;358062;373689;09;731751
32;2021-02-21;32;35;67;387045;406742;19;793787
32;2021-02-21;53;39;92;342304;348587;29;690891
32;2021-02-21;33;35;68;382485;369972;39;752457
32;2021-02-21;48;38;86;382510;376716;49;759226
32;2021-02-21;35;32;67;386937;376527;59;763464
32;2021-02-21;17;36;53;371211;330938;69;702149
32;2021-02-21;17;19;36;250542;201459;79;452001
32;2021-02-21;17;16;33;163399;89786;89;253185
32;2021-02-21;12;1;13;48384;15367;90;63751
32;2021-02-21;287;264;551;3072879;2889783;0;5962662
44;2021-02-21;5;2;7;291525;306839;09;598364
44;2021-02-21;11;8;19;320255;339504;19;659759
44;2021-02-21;11;4;15;302020;314428;29;616448
44;2021-02-21;9;12;21;342222;333292;39;675514
44;2021-02-21;15;16;31;349727;344491;49;694218
44;2021-02-21;9;13;22;381371;373239;59;754610
44;2021-02-21;9;6;15;367165;335850;69;703015
44;2021-02-21;10;6;16;250387;215436;79;465823
44;2021-02-21;11;4;15;170825;105192;89;276017
44;2021-02-21;5;1;6;51248;16731;90;67979
44;2021-02-21;95;72;167;2826745;2685002;0;5511747
52;2021-02-21;4;4;8;213594;223900;09;437494
52;2021-02-21;6;11;18;240818;255197;19;496015
52;2021-02-21;19;6;25;197010;200630;29;397640
52;2021-02-21;18;10;28;231204;224885;39;456089
52;2021-02-21;16;13;29;243874;243418;49;487292
52;2021-02-21;14;7;21;244100;239116;59;483216
52;2021-02-21;10;6;16;241796;221345;69;463141
52;2021-02-21;5;6;11;177805;149903;79;327708
52;2021-02-21;5;6;11;119561;75822;89;195383
52;2021-02-21;7;5;12;42559;15260;90;57819
52;2021-02-21;104;74;179;1952321;1849476;0;3801797
53;2021-02-21;1;3;4;173813;182358;09;356171
53;2021-02-21;5;6;11;202720;214740;19;417460
53;2021-02-21;7;1;8;163116;173196;29;336312
53;2021-02-21;3;5;8;190526;187674;39;378200
53;2021-02-21;7;7;14;212098;212015;49;424113
53;2021-02-21;6;7;13;223699;219176;59;442875
53;2021-02-21;4;3;7;227435;209274;69;436709
53;2021-02-21;2;3;5;169992;140910;79;310902
53;2021-02-21;0;4;4;118117;69883;89;188000
53;2021-02-21;5;0;5;37370;12267;90;49637
53;2021-02-21;40;39;79;1718886;1621493;0;3340379
75;2021-02-21;6;5;11;293104;305291;09;598395
75;2021-02-21;6;4;10;337141;357785;19;694926
75;2021-02-21;6;6;12;295024;300618;29;595642
75;2021-02-21;8;5;13;347871;331233;39;679104
75;2021-02-21;5;9;14;384742;372771;49;757513
75;2021-02-21;6;9;15;413361;390880;59;804241
75;2021-02-21;1;9;10;425623;384060;69;809683
75;2021-02-21;5;4;9;325086;276298;79;601384
75;2021-02-21;4;6;10;213986;139308;89;353294
75;2021-02-21;3;3;6;77600;28200;90;105800
75;2021-02-21;50;60;110;3113538;2886444;0;5999982
76;2021-02-21;3;4;7;305956;318589;09;624545
76;2021-02-21;5;12;17;338942;356969;19;695911
76;2021-02-21;17;10;27;316210;319570;29;635780
76;2021-02-21;12;14;26;356758;337587;39;694345
76;2021-02-21;19;16;35;376541;363812;49;740353
76;2021-02-21;10;15;25;402608;383750;59;786358
76;2021-02-21;17;8;25;394889;358997;69;753886
76;2021-02-21;4;8;12;308664;263806;79;572470
76;2021-02-21;7;7;14;195838;129272;89;325110
76;2021-02-21;7;1;8;69372;26728;90;96100
76;2021-02-21;101;95;196;3065778;2859080;0;5924858
84;2021-02-21;5;7;12;459549;481088;09;940637
84;2021-02-21;21;13;34;487711;511905;19;999616
84;2021-02-21;11;18;29;443824;451094;29;894918
84;2021-02-21;21;22;43;512522;493262;39;1005784
84;2021-02-21;20;20;40;520248;515106;49;1035354
84;2021-02-21;18;20;38;529611;514848;59;1044459
84;2021-02-21;12;8;20;486720;439940;69;926660
84;2021-02-21;12;19;31;372151;315211;79;687362
84;2021-02-21;19;12;31;237198;150524;89;387722
84;2021-02-21;11;0;11;81185;28680;90;109865
84;2021-02-21;150;139;289;4130719;3901658;0;8032377
93;2021-02-21;6;5;11;268834;283093;09;551927
93;2021-02-21;10;13;23;280751;296087;19;576838
93;2021-02-21;27;39;66;254404;255552;29;509956
93;2021-02-21;36;30;66;310704;288398;39;599102
93;2021-02-21;36;22;58;325559;305827;49;631386
93;2021-02-21;21;37;58;353104;325389;59;678493
93;2021-02-21;18;27;45;336327;296459;69;632786
93;2021-02-21;21;14;35;279820;229699;79;509519
93;2021-02-21;16;10;27;171274;113716;89;284990
93;2021-02-21;15;3;18;58896;21758;90;80654
93;2021-02-21;206;200;407;2639673;2415978;0;5055651
94;2021-02-21;0;0;0;16311;17433;09;33744
94;2021-02-21;0;0;0;16679;18132;19;34811
94;2021-02-21;1;0;1;16782;16579;29;33361
94;2021-02-21;2;0;2;23044;20580;39;43624
94;2021-02-21;1;0;1;23065;22140;49;45205
94;2021-02-21;0;1;1;24549;23421;59;47970
94;2021-02-21;2;0;2;23212;21883;69;45095
94;2021-02-21;0;1;1;19544;17141;79;36685
94;2021-02-21;2;0;2;11227;8178;89;19405
94;2021-02-21;0;0;0;3332;1447;90;4779
94;2021-02-21;8;2;10;177745;166934;0;344679
01;2021-02-22;0;1;1;19979;20155;09;40134
01;2021-02-22;5;6;11;24994;25489;19;50483
01;2021-02-22;8;8;16;17868;16690;29;34558
01;2021-02-22;11;4;15;22328;14821;39;37149
01;2021-02-22;14;6;20;28652;20276;49;48928
01;2021-02-22;9;7;16;33264;27260;59;60524
01;2021-02-22;4;10;14;27135;23978;69;51113
01;2021-02-22;3;1;4;18401;14661;79;33062
01;2021-02-22;0;0;0;9633;6375;89;16008
01;2021-02-22;1;0;1;3410;1510;90;4920
01;2021-02-22;55;43;98;205664;171215;0;376879
02;2021-02-22;0;0;0;16881;17110;09;33991
02;2021-02-22;1;0;1;21410;21604;19;43014
02;2021-02-22;2;3;5;16017;15479;29;31496
02;2021-02-22;1;4;5;19825;14455;39;34280
02;2021-02-22;4;2;6;24719;18248;49;42967
02;2021-02-22;3;3;6;34361;28310;59;62671
02;2021-02-22;0;1;1;28061;24495;69;52556
02;2021-02-22;0;0;1;18231;15278;79;33509
02;2021-02-22;0;0;0;11090;7677;89;18767
02;2021-02-22;1;0;1;3992;1506;90;5498
02;2021-02-22;12;13;26;194587;164162;0;358749
03;2021-02-22;0;1;1;31123;30920;09;62043
03;2021-02-22;2;2;4;29370;29268;19;58638
03;2021-02-22;4;1;5;21458;18963;29;40421
03;2021-02-22;0;1;1;21276;18326;39;39602
03;2021-02-22;0;1;1;18164;16593;49;34757
03;2021-02-22;2;2;4;13469;13557;59;27026
03;2021-02-22;3;1;4;8776;8670;69;17446
03;2021-02-22;1;1;2;3777;3591;79;7368
03;2021-02-22;1;0;1;1649;1072;89;2721
03;2021-02-22;0;0;0;485;184;90;669
03;2021-02-22;13;10;23;149547;141144;0;290691
04;2021-02-22;7;7;14;60314;61377;09;121691
04;2021-02-22;18;12;30;66065;68387;19;134452
04;2021-02-22;14;11;25;51059;47156;29;98215
04;2021-02-22;10;9;19;58788;45780;39;104568
04;2021-02-22;21;15;36;61408;52207;49;113615
04;2021-02-22;15;11;26;64838;60759;59;125597
04;2021-02-22;8;6;14;47008;42843;69;89851
04;2021-02-22;4;0;4;25509;21184;79;46693
04;2021-02-22;1;2;3;13168;7647;89;20815
04;2021-02-22;0;0;0;3209;1253;90;4462
04;2021-02-22;98;73;171;451366;408593;0;859959
05;2021-02-22;0;0;0;362.366008612902;341.338819562748;09;703.704828175651
05;2021-02-22;0;0;0;353.376145114279;370.349735405642;19;723.725880519921
05;2021-02-22;0;0;0;218.593559489256;256.539602589476;29;475.133162078732
05;2021-02-22;0;0;0;404.225408693299;360.321910454353;39;764.547319147651
05;2021-02-22;0;0;0;520.067953604221;497.108383964256;49;1017.17633756848
05;2021-02-22;0;0;0;468.146063921917;510.087601910415;59;978.233665832332
05;2021-02-22;0;0;0;340.368470050554;334.366842191253;69;674.735312241807
05;2021-02-22;0;0;0;212.598666888387;192.597753227106;79;405.196420115493
05;2021-02-22;0;0;0;148.727797095705;61.8681715431829;89;210.595968638888
05;2021-02-22;0;0;0;32.9601271090696;10.9909785719784;90;43.9511056810479
05;2021-02-22;0;0;0;3061.43020057959;2935.56979942041;0;5997
06;2021-02-22;2;3;5;42583;42380;09;84963
06;2021-02-22;15;14;29;33369;31925;19;65294
06;2021-02-22;31;21;52;21571;15080;29;36651
06;2021-02-22;32;34;66;21550;16147;39;37697
06;2021-02-22;32;32;64;14193;13939;49;28132
06;2021-02-22;22;23;45;7171;7597;59;14768
06;2021-02-22;19;22;41;3629;4117;69;7746
06;2021-02-22;4;7;11;1577;1457;79;3034
06;2021-02-22;3;5;8;531;474;89;1005
06;2021-02-22;0;0;0;88;93;90;181
06;2021-02-22;160;161;321;146262;133209;0;279471
07;2021-02-22;0;0;0;485;549;09;1034
07;2021-02-22;3;2;5;403;432;19;835
07;2021-02-22;4;0;4;764;841;29;1605
07;2021-02-22;1;3;4;824;928;39;1752
07;2021-02-22;3;0;3;788;1020;49;1808
07;2021-02-22;0;1;1;678;870;59;1548
07;2021-02-22;0;1;1;360;382;69;742
07;2021-02-22;0;1;1;231;190;79;421
07;2021-02-22;0;0;0;114;67;89;181
07;2021-02-22;0;0;0;24;11;90;35
07;2021-02-22;11;8;19;4671;5290;0;9961
08;2021-02-22;0;0;0;2715.22592983026;2997.75551488675;09;5712.98144471701
08;2021-02-22;0;0;0;2778.51901080978;3160.9156459093;19;5939.43465671908
08;2021-02-22;0;0;0;2080.8882988764;1718.16634315323;29;3799.05464202964
08;2021-02-22;1;0;1;2701.8582062647;1896.52641413317;39;4598.38462039786
08;2021-02-22;1;1;2;3151.45861023308;2460.52498233809;49;5611.98359257117
08;2021-02-22;0;0;0;2620.29868333099;2422.23566154656;59;5042.53434487755
08;2021-02-22;0;0;0;1621.44173420671;1438.58325779464;69;3060.02499200135
08;2021-02-22;0;0;0;626.575909335673;526.358467843651;79;1152.93437717932
08;2021-02-22;0;0;0;205.018522985054;140.993639349697;89;346.012162334751
08;2021-02-22;0;0;0;50.0325684687745;20.62259870351;90;70.6551671722846
08;2021-02-22;2;1;3;18551.3174743414;16782.6825256586;0;35334
11;2021-02-22;187;178;377;783071;811785;09;1594856
11;2021-02-22;477;481;998;761456;784653;19;1546109
11;2021-02-22;838;772;1617;850145;801772;29;1651917
11;2021-02-22;845;772;1622;914360;843488;39;1757848
11;2021-02-22;785;744;1533;845609;826202;49;1671811
11;2021-02-22;633;609;1250;793566;745070;59;1538636
11;2021-02-22;369;397;773;628649;549192;69;1177841
11;2021-02-22;192;169;361;434606;358356;79;792962
11;2021-02-22;128;83;212;261425;162933;89;424358
11;2021-02-22;56;26;86;89253;32619;90;121872
11;2021-02-22;4510;4233;8831;6362140;5916070;0;12278210
24;2021-02-22;7;17;24;139720;144686;09;284406
24;2021-02-22;49;67;119;152979;161185;19;314164
24;2021-02-22;61;67;128;122237;126536;29;248773
24;2021-02-22;74;63;137;150359;142009;39;292368
24;2021-02-22;78;70;148;161829;158758;49;320587
24;2021-02-22;73;79;152;172552;168011;59;340563
24;2021-02-22;50;41;91;172509;158177;69;330686
24;2021-02-22;44;40;84;129428;110593;79;240021
24;2021-02-22;46;28;74;87342;56882;89;144224
24;2021-02-22;30;13;43;31210;12071;90;43281
24;2021-02-22;512;485;1000;1320165;1238908;0;2559073
27;2021-02-22;14;20;34;143373;149679;09;293052
27;2021-02-22;62;62;125;160962;173003;19;333965
27;2021-02-22;73;61;134;133746;142254;29;276000
27;2021-02-22;74;78;152;160004;155407;39;315411
27;2021-02-22;87;86;173;172333;169564;49;341897
27;2021-02-22;62;83;145;189979;183788;59;373767
27;2021-02-22;67;50;117;192591;178206;69;370797
27;2021-02-22;28;30;58;146876;127546;79;274422
27;2021-02-22;24;23;47;96896;61575;89;158471
27;2021-02-22;14;11;25;33148;12109;90;45257
27;2021-02-22;505;504;1010;1429908;1353131;0;2783039
28;2021-02-22;21;34;57;180735;186856;09;367591
28;2021-02-22;88;76;165;200125;213621;19;413746
28;2021-02-22;78;69;147;168922;173007;29;341929
28;2021-02-22;83;60;143;196628;188487;39;385115
28;2021-02-22;84;95;179;205396;201699;49;407095
28;2021-02-22;96;87;183;222002;213866;59;435868
28;2021-02-22;87;75;162;224688;203758;69;428446
28;2021-02-22;42;38;80;163192;135543;79;298735
28;2021-02-22;27;20;47;109691;65377;89;175068
28;2021-02-22;12;8;20;37222;12685;90;49907
28;2021-02-22;618;562;1186;1708601;1594899;0;3303500
32;2021-02-22;93;92;185;358062;373689;09;731751
32;2021-02-22;272;251;525;387045;406742;19;793787
32;2021-02-22;316;284;600;342304;348587;29;690891
32;2021-02-22;338;295;633;382485;369972;39;752457
32;2021-02-22;341;320;661;382510;376716;49;759226
32;2021-02-22;362;365;727;386937;376527;59;763464
32;2021-02-22;235;160;395;371211;330938;69;702149
32;2021-02-22;155;116;271;250542;201459;79;452001
32;2021-02-22;129;70;199;163399;89786;89;253185
32;2021-02-22;77;21;98;48384;15367;90;63751
32;2021-02-22;2318;1974;4294;3072879;2889783;0;5962662
44;2021-02-22;48;55;104;291525;306839;09;598364
44;2021-02-22;152;143;296;320255;339504;19;659759
44;2021-02-22;191;190;381;302020;314428;29;616448
44;2021-02-22;162;179;347;342222;333292;39;675514
44;2021-02-22;183;145;332;349727;344491;49;694218
44;2021-02-22;184;174;360;381371;373239;59;754610
44;2021-02-22;88;120;210;367165;335850;69;703015
44;2021-02-22;83;64;149;250387;215436;79;465823
44;2021-02-22;55;38;94;170825;105192;89;276017
44;2021-02-22;27;9;36;51248;16731;90;67979
44;2021-02-22;1173;1117;2309;2826745;2685002;0;5511747
52;2021-02-22;19;30;50;213594;223900;09;437494
52;2021-02-22;84;91;175;240818;255197;19;496015
52;2021-02-22;96;68;164;197010;200630;29;397640
52;2021-02-22;93;67;161;231204;224885;39;456089
52;2021-02-22;97;79;177;243874;243418;49;487292
52;2021-02-22;89;69;159;244100;239116;59;483216
52;2021-02-22;45;56;101;241796;221345;69;463141
52;2021-02-22;48;39;87;177805;149903;79;327708
52;2021-02-22;27;24;51;119561;75822;89;195383
52;2021-02-22;25;9;34;42559;15260;90;57819
52;2021-02-22;623;532;1159;1952321;1849476;0;3801797
53;2021-02-22;10;22;33;173813;182358;09;356171
53;2021-02-22;49;73;124;202720;214740;19;417460
53;2021-02-22;60;55;115;163116;173196;29;336312
53;2021-02-22;51;51;102;190526;187674;39;378200
53;2021-02-22;74;60;134;212098;212015;49;424113
53;2021-02-22;57;57;114;223699;219176;59;442875
53;2021-02-22;34;33;67;227435;209274;69;436709
53;2021-02-22;20;28;48;169992;140910;79;310902
53;2021-02-22;34;14;48;118117;69883;89;188000
53;2021-02-22;19;1;20;37370;12267;90;49637
53;2021-02-22;408;394;805;1718886;1621493;0;3340379
75;2021-02-22;43;43;86;293104;305291;09;598395
75;2021-02-22;129;107;236;337141;357785;19;694926
75;2021-02-22;140;94;234;295024;300618;29;595642
75;2021-02-22;142;111;253;347871;331233;39;679104
75;2021-02-22;134;110;244;384742;372771;49;757513
75;2021-02-22;130;102;232;413361;390880;59;804241
75;2021-02-22;94;88;183;425623;384060;69;809683
75;2021-02-22;52;62;114;325086;276298;79;601384
75;2021-02-22;43;29;72;213986;139308;89;353294
75;2021-02-22;43;9;52;77600;28200;90;105800
75;2021-02-22;952;756;1709;3113538;2886444;0;5999982
76;2021-02-22;23;32;58;305956;318589;09;624545
76;2021-02-22;124;110;237;338942;356969;19;695911
76;2021-02-22;164;141;305;316210;319570;29;635780
76;2021-02-22;182;158;340;356758;337587;39;694345
76;2021-02-22;186;135;321;376541;363812;49;740353
76;2021-02-22;181;152;333;402608;383750;59;786358
76;2021-02-22;110;96;206;394889;358997;69;753886
76;2021-02-22;59;76;135;308664;263806;79;572470
76;2021-02-22;59;41;100;195838;129272;89;325110
76;2021-02-22;36;11;47;69372;26728;90;96100
76;2021-02-22;1125;952;2083;3065778;2859080;0;5924858
84;2021-02-22;80;71;152;459549;481088;09;940637
84;2021-02-22;251;248;499;487711;511905;19;999616
84;2021-02-22;266;242;508;443824;451094;29;894918
84;2021-02-22;303;275;578;512522;493262;39;1005784
84;2021-02-22;281;253;534;520248;515106;49;1035354
84;2021-02-22;265;235;500;529611;514848;59;1044459
84;2021-02-22;182;159;342;486720;439940;69;926660
84;2021-02-22;122;105;227;372151;315211;79;687362
84;2021-02-22;79;52;131;237198;150524;89;387722
84;2021-02-22;55;19;74;81185;28680;90;109865
84;2021-02-22;1884;1659;3545;4130719;3901658;0;8032377
93;2021-02-22;81;62;144;268834;283093;09;551927
93;2021-02-22;214;259;474;280751;296087;19;576838
93;2021-02-22;346;286;632;254404;255552;29;509956
93;2021-02-22;357;325;682;310704;288398;39;599102
93;2021-02-22;379;318;698;325559;305827;49;631386
93;2021-02-22;368;333;701;353104;325389;59;678493
93;2021-02-22;236;229;466;336327;296459;69;632786
93;2021-02-22;155;159;314;279820;229699;79;509519
93;2021-02-22;110;75;185;171274;113716;89;284990
93;2021-02-22;67;26;93;58896;21758;90;80654
93;2021-02-22;2313;2072;4390;2639673;2415978;0;5055651
94;2021-02-22;1;3;4;16311;17433;09;33744
94;2021-02-22;8;5;13;16679;18132;19;34811
94;2021-02-22;13;7;20;16782;16579;29;33361
94;2021-02-22;10;12;22;23044;20580;39;43624
94;2021-02-22;11;9;20;23065;22140;49;45205
94;2021-02-22;7;10;17;24549;23421;59;47970
94;2021-02-22;7;6;13;23212;21883;69;45095
94;2021-02-22;11;6;17;19544;17141;79;36685
94;2021-02-22;7;1;8;11227;8178;89;19405
94;2021-02-22;1;0;1;3332;1447;90;4779
94;2021-02-22;76;59;135;177745;166934;0;344679
01;2021-02-23;0;1;1;19979;20155;09;40134
01;2021-02-23;4;5;9;24994;25489;19;50483
01;2021-02-23;13;3;16;17868;16690;29;34558
01;2021-02-23;2;6;8;22328;14821;39;37149
01;2021-02-23;8;2;10;28652;20276;49;48928
01;2021-02-23;6;6;12;33264;27260;59;60524
01;2021-02-23;4;5;9;27135;23978;69;51113
01;2021-02-23;1;0;1;18401;14661;79;33062
01;2021-02-23;2;0;2;9633;6375;89;16008
01;2021-02-23;0;0;0;3410;1510;90;4920
01;2021-02-23;40;28;68;205664;171215;0;376879
02;2021-02-23;0;0;0;16881;17110;09;33991
02;2021-02-23;0;1;1;21410;21604;19;43014
02;2021-02-23;1;1;2;16017;15479;29;31496
02;2021-02-23;3;0;3;19825;14455;39;34280
02;2021-02-23;1;2;3;24719;18248;49;42967
02;2021-02-23;1;0;1;34361;28310;59;62671
02;2021-02-23;2;2;4;28061;24495;69;52556
02;2021-02-23;2;1;3;18231;15278;79;33509
02;2021-02-23;0;0;0;11090;7677;89;18767
02;2021-02-23;1;1;2;3992;1506;90;5498
02;2021-02-23;11;8;19;194587;164162;0;358749
03;2021-02-23;1;0;1;31123;30920;09;62043
03;2021-02-23;1;1;2;29370;29268;19;58638
03;2021-02-23;1;1;2;21458;18963;29;40421
03;2021-02-23;3;0;3;21276;18326;39;39602
03;2021-02-23;3;1;4;18164;16593;49;34757
03;2021-02-23;1;1;2;13469;13557;59;27026
03;2021-02-23;1;2;3;8776;8670;69;17446
03;2021-02-23;0;0;0;3777;3591;79;7368
03;2021-02-23;0;0;0;1649;1072;89;2721
03;2021-02-23;0;0;0;485;184;90;669
03;2021-02-23;11;6;17;149547;141144;0;290691
04;2021-02-23;2;4;6;60314;61377;09;121691
04;2021-02-23;17;16;33;66065;68387;19;134452
04;2021-02-23;14;9;23;51059;47156;29;98215
04;2021-02-23;9;18;27;58788;45780;39;104568
04;2021-02-23;13;17;30;61408;52207;49;113615
04;2021-02-23;6;11;17;64838;60759;59;125597
04;2021-02-23;8;1;9;47008;42843;69;89851
04;2021-02-23;1;2;3;25509;21184;79;46693
04;2021-02-23;0;0;0;13168;7647;89;20815
04;2021-02-23;0;0;0;3209;1253;90;4462
04;2021-02-23;70;78;148;451366;408593;0;859959
05;2021-02-23;0;0;0;362.366008612902;341.338819562748;09;703.704828175651
05;2021-02-23;0;0;0;353.376145114279;370.349735405642;19;723.725880519921
05;2021-02-23;0;0;0;218.593559489256;256.539602589476;29;475.133162078732
05;2021-02-23;0;0;0;404.225408693299;360.321910454353;39;764.547319147651
05;2021-02-23;0;0;0;520.067953604221;497.108383964256;49;1017.17633756848
05;2021-02-23;0;0;0;468.146063921917;510.087601910415;59;978.233665832332
05;2021-02-23;0;0;0;340.368470050554;334.366842191253;69;674.735312241807
05;2021-02-23;0;0;0;212.598666888387;192.597753227106;79;405.196420115493
05;2021-02-23;0;0;0;148.727797095705;61.8681715431829;89;210.595968638888
05;2021-02-23;0;0;0;32.9601271090696;10.9909785719784;90;43.9511056810479
05;2021-02-23;0;0;0;3061.43020057959;2935.56979942041;0;5997
06;2021-02-23;4;2;6;42583;42380;09;84963
06;2021-02-23;16;10;27;33369;31925;19;65294
06;2021-02-23;32;22;54;21571;15080;29;36651
06;2021-02-23;33;23;56;21550;16147;39;37697
06;2021-02-23;19;28;47;14193;13939;49;28132
06;2021-02-23;11;14;25;7171;7597;59;14768
06;2021-02-23;10;10;20;3629;4117;69;7746
06;2021-02-23;6;5;11;1577;1457;79;3034
06;2021-02-23;3;1;4;531;474;89;1005
06;2021-02-23;1;0;1;88;93;90;181
06;2021-02-23;135;115;251;146262;133209;0;279471
07;2021-02-23;0;0;0;485;549;09;1034
07;2021-02-23;4;1;5;403;432;19;835
07;2021-02-23;0;0;0;764;841;29;1605
07;2021-02-23;0;1;1;824;928;39;1752
07;2021-02-23;0;2;2;788;1020;49;1808
07;2021-02-23;1;0;1;678;870;59;1548
07;2021-02-23;0;0;0;360;382;69;742
07;2021-02-23;0;0;0;231;190;79;421
07;2021-02-23;0;0;0;114;67;89;181
07;2021-02-23;0;0;0;24;11;90;35
07;2021-02-23;5;4;9;4671;5290;0;9961
08;2021-02-23;0;0;0;2715.22592983026;2997.75551488675;09;5712.98144471701
08;2021-02-23;0;0;0;2778.51901080978;3160.9156459093;19;5939.43465671908
08;2021-02-23;0;0;0;2080.8882988764;1718.16634315323;29;3799.05464202964
08;2021-02-23;0;0;0;2701.8582062647;1896.52641413317;39;4598.38462039786
08;2021-02-23;0;0;0;3151.45861023308;2460.52498233809;49;5611.98359257117
08;2021-02-23;0;1;1;2620.29868333099;2422.23566154656;59;5042.53434487755
08;2021-02-23;0;1;1;1621.44173420671;1438.58325779464;69;3060.02499200135
08;2021-02-23;0;0;0;626.575909335673;526.358467843651;79;1152.93437717932
08;2021-02-23;0;0;0;205.018522985054;140.993639349697;89;346.012162334751
08;2021-02-23;0;0;0;50.0325684687745;20.62259870351;90;70.6551671722846
08;2021-02-23;0;2;2;18551.3174743414;16782.6825256586;0;35334
11;2021-02-23;101;130;241;783071;811785;09;1594856
11;2021-02-23;368;378;770;761456;784653;19;1546109
11;2021-02-23;682;593;1277;850145;801772;29;1651917
11;2021-02-23;686;634;1326;914360;843488;39;1757848
11;2021-02-23;575;533;1114;845609;826202;49;1671811
11;2021-02-23;500;466;969;793566;745070;59;1538636
11;2021-02-23;312;303;621;628649;549192;69;1177841
11;2021-02-23;170;187;357;434606;358356;79;792962
11;2021-02-23;122;70;192;261425;162933;89;424358
11;2021-02-23;59;17;76;89253;32619;90;121872
11;2021-02-23;3575;3314;6948;6362140;5916070;0;12278210
24;2021-02-23;10;5;16;139720;144686;09;284406
24;2021-02-23;45;40;87;152979;161185;19;314164
24;2021-02-23;62;44;106;122237;126536;29;248773
24;2021-02-23;70;57;127;150359;142009;39;292368
24;2021-02-23;60;54;114;161829;158758;49;320587
24;2021-02-23;66;57;123;172552;168011;59;340563
24;2021-02-23;39;56;95;172509;158177;69;330686
24;2021-02-23;32;22;54;129428;110593;79;240021
24;2021-02-23;21;15;36;87342;56882;89;144224
24;2021-02-23;39;10;49;31210;12071;90;43281
24;2021-02-23;444;360;807;1320165;1238908;0;2559073
27;2021-02-23;12;25;37;143373;149679;09;293052
27;2021-02-23;53;45;98;160962;173003;19;333965
27;2021-02-23;44;51;95;133746;142254;29;276000
27;2021-02-23;57;52;109;160004;155407;39;315411
27;2021-02-23;66;62;128;172333;169564;49;341897
27;2021-02-23;67;56;123;189979;183788;59;373767
27;2021-02-23;37;39;77;192591;178206;69;370797
27;2021-02-23;33;28;61;146876;127546;79;274422
27;2021-02-23;17;23;40;96896;61575;89;158471
27;2021-02-23;8;8;16;33148;12109;90;45257
27;2021-02-23;394;389;784;1429908;1353131;0;2783039
28;2021-02-23;8;21;29;180735;186856;09;367591
28;2021-02-23;70;52;123;200125;213621;19;413746
28;2021-02-23;57;55;112;168922;173007;29;341929
28;2021-02-23;85;46;131;196628;188487;39;385115
28;2021-02-23;90;72;162;205396;201699;49;407095
28;2021-02-23;79;68;147;222002;213866;59;435868
28;2021-02-23;48;54;102;224688;203758;69;428446
28;2021-02-23;37;36;73;163192;135543;79;298735
28;2021-02-23;30;20;50;109691;65377;89;175068
28;2021-02-23;18;8;26;37222;12685;90;49907
28;2021-02-23;522;432;955;1708601;1594899;0;3303500
32;2021-02-23;68;95;163;358062;373689;09;731751
32;2021-02-23;207;247;454;387045;406742;19;793787
32;2021-02-23;250;250;500;342304;348587;29;690891
32;2021-02-23;266;267;533;382485;369972;39;752457
32;2021-02-23;275;278;553;382510;376716;49;759226
32;2021-02-23;270;242;512;386937;376527;59;763464
32;2021-02-23;187;146;333;371211;330938;69;702149
32;2021-02-23;119;127;246;250542;201459;79;452001
32;2021-02-23;88;39;127;163399;89786;89;253185
32;2021-02-23;42;12;54;48384;15367;90;63751
32;2021-02-23;1772;1703;3479;3072879;2889783;0;5962662
44;2021-02-23;34;29;65;291525;306839;09;598364
44;2021-02-23;92;101;194;320255;339504;19;659759
44;2021-02-23;165;134;302;302020;314428;29;616448
44;2021-02-23;131;150;281;342222;333292;39;675514
44;2021-02-23;124;108;234;349727;344491;49;694218
44;2021-02-23;130;111;241;381371;373239;59;754610
44;2021-02-23;84;90;174;367165;335850;69;703015
44;2021-02-23;46;42;88;250387;215436;79;465823
44;2021-02-23;31;22;53;170825;105192;89;276017
44;2021-02-23;19;8;27;51248;16731;90;67979
44;2021-02-23;857;795;1660;2826745;2685002;0;5511747
52;2021-02-23;29;21;51;213594;223900;09;437494
52;2021-02-23;72;55;128;240818;255197;19;496015
52;2021-02-23;64;61;125;197010;200630;29;397640
52;2021-02-23;81;66;147;231204;224885;39;456089
52;2021-02-23;73;58;131;243874;243418;49;487292
52;2021-02-23;62;72;134;244100;239116;59;483216
52;2021-02-23;29;51;80;241796;221345;69;463141
52;2021-02-23;47;31;78;177805;149903;79;327708
52;2021-02-23;33;18;51;119561;75822;89;195383
52;2021-02-23;22;6;28;42559;15260;90;57819
52;2021-02-23;512;439;957;1952321;1849476;0;3801797
53;2021-02-23;13;20;35;173813;182358;09;356171
53;2021-02-23;38;38;81;202720;214740;19;417460
53;2021-02-23;60;53;114;163116;173196;29;336312
53;2021-02-23;50;27;77;190526;187674;39;378200
53;2021-02-23;52;46;98;212098;212015;49;424113
53;2021-02-23;45;40;85;223699;219176;59;442875
53;2021-02-23;21;18;39;227435;209274;69;436709
53;2021-02-23;21;19;40;169992;140910;79;310902
53;2021-02-23;9;3;12;118117;69883;89;188000
53;2021-02-23;3;2;5;37370;12267;90;49637
53;2021-02-23;312;266;587;1718886;1621493;0;3340379
75;2021-02-23;27;35;62;293104;305291;09;598395
75;2021-02-23;99;105;204;337141;357785;19;694926
75;2021-02-23;97;82;179;295024;300618;29;595642
75;2021-02-23;102;70;174;347871;331233;39;679104
75;2021-02-23;80;95;175;384742;372771;49;757513
75;2021-02-23;94;79;173;413361;390880;59;804241
75;2021-02-23;75;58;133;425623;384060;69;809683
75;2021-02-23;50;47;97;325086;276298;79;601384
75;2021-02-23;39;21;60;213986;139308;89;353294
75;2021-02-23;34;14;48;77600;28200;90;105800
75;2021-02-23;697;606;1305;3113538;2886444;0;5999982
76;2021-02-23;21;32;53;305956;318589;09;624545
76;2021-02-23;81;105;188;338942;356969;19;695911
76;2021-02-23;117;108;225;316210;319570;29;635780
76;2021-02-23;107;92;200;356758;337587;39;694345
76;2021-02-23;149;114;263;376541;363812;49;740353
76;2021-02-23;96;109;205;402608;383750;59;786358
76;2021-02-23;70;66;136;394889;358997;69;753886
76;2021-02-23;55;52;107;308664;263806;79;572470
76;2021-02-23;32;28;60;195838;129272;89;325110
76;2021-02-23;24;12;36;69372;26728;90;96100
76;2021-02-23;753;718;1474;3065778;2859080;0;5924858
84;2021-02-23;65;86;153;459549;481088;09;940637
84;2021-02-23;172;199;373;487711;511905;19;999616
84;2021-02-23;199;177;377;443824;451094;29;894918
84;2021-02-23;240;205;445;512522;493262;39;1005784
84;2021-02-23;200;206;407;520248;515106;49;1035354
84;2021-02-23;186;180;366;529611;514848;59;1044459
84;2021-02-23;119;138;257;486720;439940;69;926660
84;2021-02-23;102;93;195;372151;315211;79;687362
84;2021-02-23;74;49;123;237198;150524;89;387722
84;2021-02-23;49;22;71;81185;28680;90;109865
84;2021-02-23;1406;1355;2767;4130719;3901658;0;8032377
93;2021-02-23;40;53;93;268834;283093;09;551927
93;2021-02-23;166;169;337;280751;296087;19;576838
93;2021-02-23;265;229;494;254404;255552;29;509956
93;2021-02-23;284;236;521;310704;288398;39;599102
93;2021-02-23;303;227;530;325559;305827;49;631386
93;2021-02-23;293;238;531;353104;325389;59;678493
93;2021-02-23;175;174;350;336327;296459;69;632786
93;2021-02-23;126;125;251;279820;229699;79;509519
93;2021-02-23;108;52;160;171274;113716;89;284990
93;2021-02-23;81;23;104;58896;21758;90;80654
93;2021-02-23;1841;1526;3371;2639673;2415978;0;5055651
94;2021-02-23;4;0;4;16311;17433;09;33744
94;2021-02-23;2;4;7;16679;18132;19;34811
94;2021-02-23;7;1;8;16782;16579;29;33361
94;2021-02-23;11;2;13;23044;20580;39;43624
94;2021-02-23;9;4;13;23065;22140;49;45205
94;2021-02-23;10;9;19;24549;23421;59;47970
94;2021-02-23;3;6;9;23212;21883;69;45095
94;2021-02-23;2;4;6;19544;17141;79;36685
94;2021-02-23;2;0;2;11227;8178;89;19405
94;2021-02-23;2;0;2;3332;1447;90;4779
94;2021-02-23;52;30;83;177745;166934;0;344679
01;2021-02-24;0;2;2;19979;20155;09;40134
01;2021-02-24;3;1;4;24994;25489;19;50483
01;2021-02-24;5;1;6;17868;16690;29;34558
01;2021-02-24;3;1;4;22328;14821;39;37149
01;2021-02-24;5;7;12;28652;20276;49;48928
01;2021-02-24;8;4;12;33264;27260;59;60524
01;2021-02-24;4;2;6;27135;23978;69;51113
01;2021-02-24;0;0;0;18401;14661;79;33062
01;2021-02-24;2;1;3;9633;6375;89;16008
01;2021-02-24;0;0;0;3410;1510;90;4920
01;2021-02-24;30;19;49;205664;171215;0;376879
02;2021-02-24;2;0;2;16881;17110;09;33991
02;2021-02-24;2;1;3;21410;21604;19;43014
02;2021-02-24;1;1;2;16017;15479;29;31496
02;2021-02-24;2;1;3;19825;14455;39;34280
02;2021-02-24;1;1;2;24719;18248;49;42967
02;2021-02-24;0;0;0;34361;28310;59;62671
02;2021-02-24;1;1;2;28061;24495;69;52556
02;2021-02-24;0;0;0;18231;15278;79;33509
02;2021-02-24;2;0;2;11090;7677;89;18767
02;2021-02-24;0;0;0;3992;1506;90;5498
02;2021-02-24;11;5;16;194587;164162;0;358749
03;2021-02-24;0;1;1;31123;30920;09;62043
03;2021-02-24;2;2;4;29370;29268;19;58638
03;2021-02-24;0;3;3;21458;18963;29;40421
03;2021-02-24;3;0;3;21276;18326;39;39602
03;2021-02-24;1;1;2;18164;16593;49;34757
03;2021-02-24;1;1;2;13469;13557;59;27026
03;2021-02-24;1;1;2;8776;8670;69;17446
03;2021-02-24;1;0;1;3777;3591;79;7368
03;2021-02-24;0;0;0;1649;1072;89;2721
03;2021-02-24;0;0;0;485;184;90;669
03;2021-02-24;9;9;18;149547;141144;0;290691
04;2021-02-24;1;6;7;60314;61377;09;121691
04;2021-02-24;16;10;26;66065;68387;19;134452
04;2021-02-24;16;8;24;51059;47156;29;98215
04;2021-02-24;12;14;26;58788;45780;39;104568
04;2021-02-24;16;8;24;61408;52207;49;113615
04;2021-02-24;10;5;15;64838;60759;59;125597
04;2021-02-24;7;8;15;47008;42843;69;89851
04;2021-02-24;1;2;3;25509;21184;79;46693
04;2021-02-24;4;0;4;13168;7647;89;20815
04;2021-02-24;0;0;0;3209;1253;90;4462
04;2021-02-24;83;61;144;451366;408593;0;859959
05;2021-02-24;0;0;0;362.366008612902;341.338819562748;09;703.704828175651
05;2021-02-24;0;0;0;353.376145114279;370.349735405642;19;723.725880519921
05;2021-02-24;0;0;0;218.593559489256;256.539602589476;29;475.133162078732
05;2021-02-24;0;0;0;404.225408693299;360.321910454353;39;764.547319147651
05;2021-02-24;0;0;0;520.067953604221;497.108383964256;49;1017.17633756848
05;2021-02-24;0;0;0;468.146063921917;510.087601910415;59;978.233665832332
05;2021-02-24;0;0;0;340.368470050554;334.366842191253;69;674.735312241807
05;2021-02-24;0;0;0;212.598666888387;192.597753227106;79;405.196420115493
05;2021-02-24;0;0;0;148.727797095705;61.8681715431829;89;210.595968638888
05;2021-02-24;0;0;0;32.9601271090696;10.9909785719784;90;43.9511056810479
05;2021-02-24;0;0;0;3061.43020057959;2935.56979942041;0;5997
06;2021-02-24;1;3;4;42583;42380;09;84963
06;2021-02-24;16;12;28;33369;31925;19;65294
06;2021-02-24;30;16;46;21571;15080;29;36651
06;2021-02-24;40;28;68;21550;16147;39;37697
06;2021-02-24;22;32;54;14193;13939;49;28132
06;2021-02-24;7;12;19;7171;7597;59;14768
06;2021-02-24;25;25;51;3629;4117;69;7746
06;2021-02-24;0;4;4;1577;1457;79;3034
06;2021-02-24;0;3;3;531;474;89;1005
06;2021-02-24;0;0;0;88;93;90;181
06;2021-02-24;141;135;277;146262;133209;0;279471
07;2021-02-24;0;0;0;485;549;09;1034
07;2021-02-24;1;0;1;403;432;19;835
07;2021-02-24;2;0;2;764;841;29;1605
07;2021-02-24;1;0;1;824;928;39;1752
07;2021-02-24;0;1;1;788;1020;49;1808
07;2021-02-24;0;0;0;678;870;59;1548
07;2021-02-24;1;2;3;360;382;69;742
07;2021-02-24;0;0;0;231;190;79;421
07;2021-02-24;0;0;0;114;67;89;181
07;2021-02-24;0;1;1;24;11;90;35
07;2021-02-24;5;4;9;4671;5290;0;9961
08;2021-02-24;0;0;0;2715.22592983026;2997.75551488675;09;5712.98144471701
08;2021-02-24;0;0;0;2778.51901080978;3160.9156459093;19;5939.43465671908
08;2021-02-24;1;0;1;2080.8882988764;1718.16634315323;29;3799.05464202964
08;2021-02-24;2;0;2;2701.8582062647;1896.52641413317;39;4598.38462039786
08;2021-02-24;0;0;0;3151.45861023308;2460.52498233809;49;5611.98359257117
08;2021-02-24;1;0;1;2620.29868333099;2422.23566154656;59;5042.53434487755
08;2021-02-24;0;1;1;1621.44173420671;1438.58325779464;69;3060.02499200135
08;2021-02-24;0;0;0;626.575909335673;526.358467843651;79;1152.93437717932
08;2021-02-24;0;0;0;205.018522985054;140.993639349697;89;346.012162334751
08;2021-02-24;0;0;0;50.0325684687745;20.62259870351;90;70.6551671722846
08;2021-02-24;4;1;5;18551.3174743414;16782.6825256586;0;35334
11;2021-02-24;130;120;267;783071;811785;09;1594856
11;2021-02-24;388;349;764;761456;784653;19;1546109
11;2021-02-24;688;579;1273;850145;801772;29;1651917
11;2021-02-24;605;532;1146;914360;843488;39;1757848
11;2021-02-24;523;512;1044;845609;826202;49;1671811
11;2021-02-24;447;422;874;793566;745070;59;1538636
11;2021-02-24;296;281;581;628649;549192;69;1177841
11;2021-02-24;156;135;291;434606;358356;79;792962
11;2021-02-24;111;64;175;261425;162933;89;424358
11;2021-02-24;52;19;71;89253;32619;90;121872
11;2021-02-24;3396;3016;6489;6362140;5916070;0;12278210
24;2021-02-24;20;9;29;139720;144686;09;284406
24;2021-02-24;48;56;105;152979;161185;19;314164
24;2021-02-24;56;88;144;122237;126536;29;248773
24;2021-02-24;60;53;113;150359;142009;39;292368
24;2021-02-24;59;51;110;161829;158758;49;320587
24;2021-02-24;54;44;98;172552;168011;59;340563
24;2021-02-24;45;32;77;172509;158177;69;330686
24;2021-02-24;28;29;57;129428;110593;79;240021
24;2021-02-24;20;14;34;87342;56882;89;144224
24;2021-02-24;9;4;13;31210;12071;90;43281
24;2021-02-24;399;380;780;1320165;1238908;0;2559073
27;2021-02-24;13;10;23;143373;149679;09;293052
27;2021-02-24;41;54;96;160962;173003;19;333965
27;2021-02-24;60;43;103;133746;142254;29;276000
27;2021-02-24;43;38;81;160004;155407;39;315411
27;2021-02-24;59;44;103;172333;169564;49;341897
27;2021-02-24;47;50;97;189979;183788;59;373767
27;2021-02-24;36;29;65;192591;178206;69;370797
27;2021-02-24;28;28;57;146876;127546;79;274422
27;2021-02-24;19;11;30;96896;61575;89;158471
27;2021-02-24;6;5;11;33148;12109;90;45257
27;2021-02-24;352;312;666;1429908;1353131;0;2783039
28;2021-02-24;18;28;47;180735;186856;09;367591
28;2021-02-24;50;46;96;200125;213621;19;413746
28;2021-02-24;56;58;114;168922;173007;29;341929
28;2021-02-24;71;58;129;196628;188487;39;385115
28;2021-02-24;69;55;124;205396;201699;49;407095
28;2021-02-24;78;70;148;222002;213866;59;435868
28;2021-02-24;63;61;124;224688;203758;69;428446
28;2021-02-24;42;34;76;163192;135543;79;298735
28;2021-02-24;28;13;41;109691;65377;89;175068
28;2021-02-24;10;10;20;37222;12685;90;49907
28;2021-02-24;485;433;919;1708601;1594899;0;3303500
32;2021-02-24;66;89;156;358062;373689;09;731751
32;2021-02-24;235;208;443;387045;406742;19;793787
32;2021-02-24;258;219;477;342304;348587;29;690891
32;2021-02-24;262;215;477;382485;369972;39;752457
32;2021-02-24;264;236;500;382510;376716;49;759226
32;2021-02-24;233;233;466;386937;376527;59;763464
32;2021-02-24;146;192;338;371211;330938;69;702149
32;2021-02-24;110;96;206;250542;201459;79;452001
32;2021-02-24;82;47;129;163399;89786;89;253185
32;2021-02-24;33;6;39;48384;15367;90;63751
32;2021-02-24;1689;1543;3233;3072879;2889783;0;5962662
44;2021-02-24;35;30;66;291525;306839;09;598364
44;2021-02-24;111;132;244;320255;339504;19;659759
44;2021-02-24;134;123;257;302020;314428;29;616448
44;2021-02-24;145;122;267;342222;333292;39;675514
44;2021-02-24;107;110;219;349727;344491;49;694218
44;2021-02-24;103;95;199;381371;373239;59;754610
44;2021-02-24;65;91;157;367165;335850;69;703015
44;2021-02-24;59;47;107;250387;215436;79;465823
44;2021-02-24;42;35;77;170825;105192;89;276017
44;2021-02-24;18;8;26;51248;16731;90;67979
44;2021-02-24;820;795;1622;2826745;2685002;0;5511747
52;2021-02-24;15;14;29;213594;223900;09;437494
52;2021-02-24;65;62;129;240818;255197;19;496015
52;2021-02-24;76;62;138;197010;200630;29;397640
52;2021-02-24;63;46;109;231204;224885;39;456089
52;2021-02-24;71;61;132;243874;243418;49;487292
52;2021-02-24;51;54;105;244100;239116;59;483216
52;2021-02-24;40;31;71;241796;221345;69;463141
52;2021-02-24;38;26;64;177805;149903;79;327708
52;2021-02-24;41;23;64;119561;75822;89;195383
52;2021-02-24;32;15;47;42559;15260;90;57819
52;2021-02-24;492;394;888;1952321;1849476;0;3801797
53;2021-02-24;15;18;33;173813;182358;09;356171
53;2021-02-24;44;48;94;202720;214740;19;417460
53;2021-02-24;48;51;99;163116;173196;29;336312
53;2021-02-24;35;32;67;190526;187674;39;378200
53;2021-02-24;47;44;91;212098;212015;49;424113
53;2021-02-24;35;36;71;223699;219176;59;442875
53;2021-02-24;21;23;44;227435;209274;69;436709
53;2021-02-24;14;16;30;169992;140910;79;310902
53;2021-02-24;13;9;22;118117;69883;89;188000
53;2021-02-24;12;3;15;37370;12267;90;49637
53;2021-02-24;284;280;566;1718886;1621493;0;3340379
75;2021-02-24;29;24;53;293104;305291;09;598395
75;2021-02-24;78;87;165;337141;357785;19;694926
75;2021-02-24;97;101;198;295024;300618;29;595642
75;2021-02-24;82;73;155;347871;331233;39;679104
75;2021-02-24;94;92;186;384742;372771;49;757513
75;2021-02-24;85;85;170;413361;390880;59;804241
75;2021-02-24;70;60;130;425623;384060;69;809683
75;2021-02-24;50;42;92;325086;276298;79;601384
75;2021-02-24;41;26;67;213986;139308;89;353294
75;2021-02-24;40;11;51;77600;28200;90;105800
75;2021-02-24;666;601;1267;3113538;2886444;0;5999982
76;2021-02-24;33;34;67;305956;318589;09;624545
76;2021-02-24;106;110;217;338942;356969;19;695911
76;2021-02-24;134;102;236;316210;319570;29;635780
76;2021-02-24;136;107;243;356758;337587;39;694345
76;2021-02-24;127;110;237;376541;363812;49;740353
76;2021-02-24;101;86;187;402608;383750;59;786358
76;2021-02-24;71;63;134;394889;358997;69;753886
76;2021-02-24;53;48;101;308664;263806;79;572470
76;2021-02-24;29;19;48;195838;129272;89;325110
76;2021-02-24;25;9;34;69372;26728;90;96100
76;2021-02-24;816;688;1505;3065778;2859080;0;5924858
84;2021-02-24;69;56;128;459549;481088;09;940637
84;2021-02-24;189;203;395;487711;511905;19;999616
84;2021-02-24;228;206;434;443824;451094;29;894918
84;2021-02-24;208;192;400;512522;493262;39;1005784
84;2021-02-24;196;185;381;520248;515106;49;1035354
84;2021-02-24;190;177;367;529611;514848;59;1044459
84;2021-02-24;136;125;262;486720;439940;69;926660
84;2021-02-24;83;78;161;372151;315211;79;687362
84;2021-02-24;67;49;116;237198;150524;89;387722
84;2021-02-24;37;12;49;81185;28680;90;109865
84;2021-02-24;1403;1283;2693;4130719;3901658;0;8032377
93;2021-02-24;41;64;105;268834;283093;09;551927
93;2021-02-24;195;202;397;280751;296087;19;576838
93;2021-02-24;247;220;467;254404;255552;29;509956
93;2021-02-24;258;211;469;310704;288398;39;599102
93;2021-02-24;256;208;465;325559;305827;49;631386
93;2021-02-24;243;218;461;353104;325389;59;678493
93;2021-02-24;151;148;299;336327;296459;69;632786
93;2021-02-24;111;93;204;279820;229699;79;509519
93;2021-02-24;57;39;96;171274;113716;89;284990
93;2021-02-24;35;15;50;58896;21758;90;80654
93;2021-02-24;1594;1418;3013;2639673;2415978;0;5055651
94;2021-02-24;1;1;2;16311;17433;09;33744
94;2021-02-24;4;6;10;16679;18132;19;34811
94;2021-02-24;3;7;10;16782;16579;29;33361
94;2021-02-24;12;3;15;23044;20580;39;43624
94;2021-02-24;5;3;8;23065;22140;49;45205
94;2021-02-24;8;13;21;24549;23421;59;47970
94;2021-02-24;5;2;7;23212;21883;69;45095
94;2021-02-24;2;3;5;19544;17141;79;36685
94;2021-02-24;1;2;3;11227;8178;89;19405
94;2021-02-24;1;1;2;3332;1447;90;4779
94;2021-02-24;42;41;83;177745;166934;0;344679
01;2021-02-25;0;1;1;19979;20155;09;40134
01;2021-02-25;5;7;12;24994;25489;19;50483
01;2021-02-25;3;2;5;17868;16690;29;34558
01;2021-02-25;8;6;14;22328;14821;39;37149
01;2021-02-25;10;5;15;28652;20276;49;48928
01;2021-02-25;5;8;13;33264;27260;59;60524
01;2021-02-25;5;2;7;27135;23978;69;51113
01;2021-02-25;0;1;1;18401;14661;79;33062
01;2021-02-25;1;0;1;9633;6375;89;16008
01;2021-02-25;0;0;0;3410;1510;90;4920
01;2021-02-25;37;32;69;205664;171215;0;376879
02;2021-02-25;0;0;0;16881;17110;09;33991
02;2021-02-25;2;1;3;21410;21604;19;43014
02;2021-02-25;4;0;4;16017;15479;29;31496
02;2021-02-25;7;2;9;19825;14455;39;34280
02;2021-02-25;1;2;3;24719;18248;49;42967
02;2021-02-25;0;1;1;34361;28310;59;62671
02;2021-02-25;2;0;3;28061;24495;69;52556
02;2021-02-25;1;0;1;18231;15278;79;33509
02;2021-02-25;0;0;0;11090;7677;89;18767
02;2021-02-25;0;0;0;3992;1506;90;5498
02;2021-02-25;17;6;24;194587;164162;0;358749
03;2021-02-25;0;0;0;31123;30920;09;62043
03;2021-02-25;2;1;3;29370;29268;19;58638
03;2021-02-25;0;1;1;21458;18963;29;40421
03;2021-02-25;0;2;2;21276;18326;39;39602
03;2021-02-25;1;1;2;18164;16593;49;34757
03;2021-02-25;1;2;3;13469;13557;59;27026
03;2021-02-25;0;0;0;8776;8670;69;17446
03;2021-02-25;0;0;0;3777;3591;79;7368
03;2021-02-25;1;0;1;1649;1072;89;2721
03;2021-02-25;0;0;0;485;184;90;669
03;2021-02-25;5;7;12;149547;141144;0;290691
04;2021-02-25;6;3;9;60314;61377;09;121691
04;2021-02-25;8;21;29;66065;68387;19;134452
04;2021-02-25;12;11;23;51059;47156;29;98215
04;2021-02-25;8;8;16;58788;45780;39;104568
04;2021-02-25;6;11;17;61408;52207;49;113615
04;2021-02-25;5;5;10;64838;60759;59;125597
04;2021-02-25;3;7;10;47008;42843;69;89851
04;2021-02-25;5;1;6;25509;21184;79;46693
04;2021-02-25;0;1;1;13168;7647;89;20815
04;2021-02-25;0;0;0;3209;1253;90;4462
04;2021-02-25;53;68;121;451366;408593;0;859959
05;2021-02-25;0;0;0;362.366008612902;341.338819562748;09;703.704828175651
05;2021-02-25;0;0;0;353.376145114279;370.349735405642;19;723.725880519921
05;2021-02-25;0;0;0;218.593559489256;256.539602589476;29;475.133162078732
05;2021-02-25;0;0;0;404.225408693299;360.321910454353;39;764.547319147651
05;2021-02-25;0;0;0;520.067953604221;497.108383964256;49;1017.17633756848
05;2021-02-25;0;0;0;468.146063921917;510.087601910415;59;978.233665832332
05;2021-02-25;0;0;0;340.368470050554;334.366842191253;69;674.735312241807
05;2021-02-25;0;0;0;212.598666888387;192.597753227106;79;405.196420115493
05;2021-02-25;0;0;0;148.727797095705;61.8681715431829;89;210.595968638888
05;2021-02-25;0;0;0;32.9601271090696;10.9909785719784;90;43.9511056810479
05;2021-02-25;0;0;0;3061.43020057959;2935.56979942041;0;5997
06;2021-02-25;4;1;5;42583;42380;09;84963
06;2021-02-25;14;2;18;33369;31925;19;65294
06;2021-02-25;24;7;31;21571;15080;29;36651
06;2021-02-25;20;9;29;21550;16147;39;37697
06;2021-02-25;15;16;31;14193;13939;49;28132
06;2021-02-25;10;20;30;7171;7597;59;14768
06;2021-02-25;8;10;18;3629;4117;69;7746
06;2021-02-25;4;0;4;1577;1457;79;3034
06;2021-02-25;1;0;1;531;474;89;1005
06;2021-02-25;0;0;0;88;93;90;181
06;2021-02-25;100;65;167;146262;133209;0;279471
07;2021-02-25;0;0;0;485;549;09;1034
07;2021-02-25;0;2;2;403;432;19;835
07;2021-02-25;1;2;3;764;841;29;1605
07;2021-02-25;0;1;1;824;928;39;1752
07;2021-02-25;0;0;0;788;1020;49;1808
07;2021-02-25;2;0;2;678;870;59;1548
07;2021-02-25;0;1;1;360;382;69;742
07;2021-02-25;0;0;0;231;190;79;421
07;2021-02-25;0;0;0;114;67;89;181
07;2021-02-25;0;0;0;24;11;90;35
07;2021-02-25;3;6;9;4671;5290;0;9961
08;2021-02-25;0;0;0;2715.22592983026;2997.75551488675;09;5712.98144471701
08;2021-02-25;1;0;1;2778.51901080978;3160.9156459093;19;5939.43465671908
08;2021-02-25;0;0;0;2080.8882988764;1718.16634315323;29;3799.05464202964
08;2021-02-25;2;0;2;2701.8582062647;1896.52641413317;39;4598.38462039786
08;2021-02-25;1;1;2;3151.45861023308;2460.52498233809;49;5611.98359257117
08;2021-02-25;1;0;1;2620.29868333099;2422.23566154656;59;5042.53434487755
08;2021-02-25;0;0;0;1621.44173420671;1438.58325779464;69;3060.02499200135
08;2021-02-25;0;0;0;626.575909335673;526.358467843651;79;1152.93437717932
08;2021-02-25;0;0;0;205.018522985054;140.993639349697;89;346.012162334751
08;2021-02-25;0;0;0;50.0325684687745;20.62259870351;90;70.6551671722846
08;2021-02-25;5;1;6;18551.3174743414;16782.6825256586;0;35334
11;2021-02-25;142;129;291;783071;811785;09;1594856
11;2021-02-25;395;404;829;761456;784653;19;1546109
11;2021-02-25;597;560;1165;850145;801772;29;1651917
11;2021-02-25;653;551;1217;914360;843488;39;1757848
11;2021-02-25;570;516;1091;845609;826202;49;1671811
11;2021-02-25;488;452;951;793566;745070;59;1538636
11;2021-02-25;286;281;573;628649;549192;69;1177841
11;2021-02-25;142;139;283;434606;358356;79;792962
11;2021-02-25;72;61;134;261425;162933;89;424358
11;2021-02-25;35;17;53;89253;32619;90;121872
11;2021-02-25;3381;3110;6588;6362140;5916070;0;12278210
24;2021-02-25;11;15;26;139720;144686;09;284406
24;2021-02-25;54;61;119;152979;161185;19;314164
24;2021-02-25;55;62;117;122237;126536;29;248773
24;2021-02-25;55;40;95;150359;142009;39;292368
24;2021-02-25;65;46;111;161829;158758;49;320587
24;2021-02-25;58;50;108;172552;168011;59;340563
24;2021-02-25;35;48;83;172509;158177;69;330686
24;2021-02-25;28;27;55;129428;110593;79;240021
24;2021-02-25;25;16;41;87342;56882;89;144224
24;2021-02-25;13;3;16;31210;12071;90;43281
24;2021-02-25;399;368;771;1320165;1238908;0;2559073
27;2021-02-25;13;17;30;143373;149679;09;293052
27;2021-02-25;49;67;117;160962;173003;19;333965
27;2021-02-25;60;75;135;133746;142254;29;276000
27;2021-02-25;56;45;101;160004;155407;39;315411
27;2021-02-25;63;43;107;172333;169564;49;341897
27;2021-02-25;54;52;106;189979;183788;59;373767
27;2021-02-25;41;52;93;192591;178206;69;370797
27;2021-02-25;29;23;52;146876;127546;79;274422
27;2021-02-25;34;15;49;96896;61575;89;158471
27;2021-02-25;10;5;15;33148;12109;90;45257
27;2021-02-25;409;394;805;1429908;1353131;0;2783039
28;2021-02-25;25;23;49;180735;186856;09;367591
28;2021-02-25;75;72;148;200125;213621;19;413746
28;2021-02-25;81;71;152;168922;173007;29;341929
28;2021-02-25;90;75;165;196628;188487;39;385115
28;2021-02-25;87;81;168;205396;201699;49;407095
28;2021-02-25;64;78;143;222002;213866;59;435868
28;2021-02-25;76;62;138;224688;203758;69;428446
28;2021-02-25;37;27;65;163192;135543;79;298735
28;2021-02-25;24;11;36;109691;65377;89;175068
28;2021-02-25;15;4;19;37222;12685;90;49907
28;2021-02-25;574;504;1084;1708601;1594899;0;3303500
32;2021-02-25;64;78;142;358062;373689;09;731751
32;2021-02-25;223;223;446;387045;406742;19;793787
32;2021-02-25;247;233;480;342304;348587;29;690891
32;2021-02-25;300;221;521;382485;369972;39;752457
32;2021-02-25;267;250;517;382510;376716;49;759226
32;2021-02-25;222;218;440;386937;376527;59;763464
32;2021-02-25;177;145;322;371211;330938;69;702149
32;2021-02-25;108;107;215;250542;201459;79;452001
32;2021-02-25;86;52;138;163399;89786;89;253185
32;2021-02-25;41;16;57;48384;15367;90;63751
32;2021-02-25;1736;1543;3280;3072879;2889783;0;5962662
44;2021-02-25;31;39;75;291525;306839;09;598364
44;2021-02-25;91;98;191;320255;339504;19;659759
44;2021-02-25;139;125;267;302020;314428;29;616448
44;2021-02-25;167;113;283;342222;333292;39;675514
44;2021-02-25;138;87;227;349727;344491;49;694218
44;2021-02-25;116;87;204;381371;373239;59;754610
44;2021-02-25;72;72;147;367165;335850;69;703015
44;2021-02-25;44;53;97;250387;215436;79;465823
44;2021-02-25;39;22;61;170825;105192;89;276017
44;2021-02-25;19;7;26;51248;16731;90;67979
44;2021-02-25;857;703;1579;2826745;2685002;0;5511747
52;2021-02-25;21;15;37;213594;223900;09;437494
52;2021-02-25;78;78;158;240818;255197;19;496015
52;2021-02-25;60;70;131;197010;200630;29;397640
52;2021-02-25;81;60;142;231204;224885;39;456089
52;2021-02-25;73;59;132;243874;243418;49;487292
52;2021-02-25;59;54;113;244100;239116;59;483216
52;2021-02-25;45;60;105;241796;221345;69;463141
52;2021-02-25;27;33;61;177805;149903;79;327708
52;2021-02-25;33;18;51;119561;75822;89;195383
52;2021-02-25;23;5;28;42559;15260;90;57819
52;2021-02-25;500;452;958;1952321;1849476;0;3801797
53;2021-02-25;15;16;31;173813;182358;09;356171
53;2021-02-25;57;67;124;202720;214740;19;417460
53;2021-02-25;63;59;123;163116;173196;29;336312
53;2021-02-25;38;41;79;190526;187674;39;378200
53;2021-02-25;48;37;85;212098;212015;49;424113
53;2021-02-25;43;40;84;223699;219176;59;442875
53;2021-02-25;22;32;54;227435;209274;69;436709
53;2021-02-25;20;12;32;169992;140910;79;310902
53;2021-02-25;7;3;10;118117;69883;89;188000
53;2021-02-25;12;1;13;37370;12267;90;49637
53;2021-02-25;325;308;635;1718886;1621493;0;3340379
75;2021-02-25;19;20;39;293104;305291;09;598395
75;2021-02-25;92;86;178;337141;357785;19;694926
75;2021-02-25;111;88;199;295024;300618;29;595642
75;2021-02-25;99;63;162;347871;331233;39;679104
75;2021-02-25;87;75;162;384742;372771;49;757513
75;2021-02-25;85;70;155;413361;390880;59;804241
75;2021-02-25;57;61;118;425623;384060;69;809683
75;2021-02-25;34;29;63;325086;276298;79;601384
75;2021-02-25;30;16;46;213986;139308;89;353294
75;2021-02-25;13;9;22;77600;28200;90;105800
75;2021-02-25;627;517;1144;3113538;2886444;0;5999982
76;2021-02-25;22;34;59;305956;318589;09;624545
76;2021-02-25;96;95;196;338942;356969;19;695911
76;2021-02-25;121;115;236;316210;319570;29;635780
76;2021-02-25;125;119;245;356758;337587;39;694345
76;2021-02-25;115;98;213;376541;363812;49;740353
76;2021-02-25;106;113;219;402608;383750;59;786358
76;2021-02-25;85;70;155;394889;358997;69;753886
76;2021-02-25;56;45;101;308664;263806;79;572470
76;2021-02-25;24;25;50;195838;129272;89;325110
76;2021-02-25;19;6;25;69372;26728;90;96100
76;2021-02-25;770;722;1502;3065778;2859080;0;5924858
84;2021-02-25;57;58;115;459549;481088;09;940637
84;2021-02-25;152;185;337;487711;511905;19;999616
84;2021-02-25;215;198;413;443824;451094;29;894918
84;2021-02-25;200;177;377;512522;493262;39;1005784
84;2021-02-25;194;154;348;520248;515106;49;1035354
84;2021-02-25;187;193;380;529611;514848;59;1044459
84;2021-02-25;111;105;216;486720;439940;69;926660
84;2021-02-25;98;88;186;372151;315211;79;687362
84;2021-02-25;57;38;96;237198;150524;89;387722
84;2021-02-25;23;11;34;81185;28680;90;109865
84;2021-02-25;1294;1207;2502;4130719;3901658;0;8032377
93;2021-02-25;48;67;115;268834;283093;09;551927
93;2021-02-25;173;151;325;280751;296087;19;576838
93;2021-02-25;239;173;412;254404;255552;29;509956
93;2021-02-25;274;193;467;310704;288398;39;599102
93;2021-02-25;262;229;491;325559;305827;49;631386
93;2021-02-25;222;201;424;353104;325389;59;678493
93;2021-02-25;152;149;302;336327;296459;69;632786
93;2021-02-25;102;73;176;279820;229699;79;509519
93;2021-02-25;62;44;107;171274;113716;89;284990
93;2021-02-25;36;21;57;58896;21758;90;80654
93;2021-02-25;1570;1301;2876;2639673;2415978;0;5055651
94;2021-02-25;0;3;3;16311;17433;09;33744
94;2021-02-25;6;4;10;16679;18132;19;34811
94;2021-02-25;7;5;12;16782;16579;29;33361
94;2021-02-25;5;2;7;23044;20580;39;43624
94;2021-02-25;3;3;6;23065;22140;49;45205
94;2021-02-25;7;10;17;24549;23421;59;47970
94;2021-02-25;7;3;10;23212;21883;69;45095
94;2021-02-25;4;1;5;19544;17141;79;36685
94;2021-02-25;1;0;1;11227;8178;89;19405
94;2021-02-25;2;0;2;3332;1447;90;4779
94;2021-02-25;42;31;73;177745;166934;0;344679
01;2021-02-26;0;2;2;19979;20155;09;40134
01;2021-02-26;5;3;8;24994;25489;19;50483
01;2021-02-26;6;7;13;17868;16690;29;34558
01;2021-02-26;4;6;10;22328;14821;39;37149
01;2021-02-26;9;5;14;28652;20276;49;48928
01;2021-02-26;15;8;23;33264;27260;59;60524
01;2021-02-26;5;9;14;27135;23978;69;51113
01;2021-02-26;0;1;1;18401;14661;79;33062
01;2021-02-26;0;2;2;9633;6375;89;16008
01;2021-02-26;0;0;0;3410;1510;90;4920
01;2021-02-26;44;43;87;205664;171215;0;376879
02;2021-02-26;2;0;2;16881;17110;09;33991
02;2021-02-26;0;2;2;21410;21604;19;43014
02;2021-02-26;2;1;3;16017;15479;29;31496
02;2021-02-26;5;3;8;19825;14455;39;34280
02;2021-02-26;2;3;5;24719;18248;49;42967
02;2021-02-26;3;2;5;34361;28310;59;62671
02;2021-02-26;0;0;0;28061;24495;69;52556
02;2021-02-26;1;0;1;18231;15278;79;33509
02;2021-02-26;1;1;2;11090;7677;89;18767
02;2021-02-26;1;0;1;3992;1506;90;5498
02;2021-02-26;17;12;29;194587;164162;0;358749
03;2021-02-26;1;0;1;31123;30920;09;62043
03;2021-02-26;0;0;0;29370;29268;19;58638
03;2021-02-26;0;1;1;21458;18963;29;40421
03;2021-02-26;0;0;0;21276;18326;39;39602
03;2021-02-26;1;0;1;18164;16593;49;34757
03;2021-02-26;1;2;3;13469;13557;59;27026
03;2021-02-26;0;1;1;8776;8670;69;17446
03;2021-02-26;0;1;1;3777;3591;79;7368
03;2021-02-26;0;0;0;1649;1072;89;2721
03;2021-02-26;0;0;0;485;184;90;669
03;2021-02-26;3;5;8;149547;141144;0;290691
04;2021-02-26;5;3;8;60314;61377;09;121691
04;2021-02-26;28;21;49;66065;68387;19;134452
04;2021-02-26;15;9;24;51059;47156;29;98215
04;2021-02-26;13;6;19;58788;45780;39;104568
04;2021-02-26;16;11;27;61408;52207;49;113615
04;2021-02-26;15;13;28;64838;60759;59;125597
04;2021-02-26;10;11;21;47008;42843;69;89851
04;2021-02-26;7;3;10;25509;21184;79;46693
04;2021-02-26;0;0;0;13168;7647;89;20815
04;2021-02-26;0;0;0;3209;1253;90;4462
04;2021-02-26;109;77;186;451366;408593;0;859959
05;2021-02-26;0;0;0;362.366008612902;341.338819562748;09;703.704828175651
05;2021-02-26;0;0;0;353.376145114279;370.349735405642;19;723.725880519921
05;2021-02-26;0;0;0;218.593559489256;256.539602589476;29;475.133162078732
05;2021-02-26;0;0;0;404.225408693299;360.321910454353;39;764.547319147651
05;2021-02-26;0;0;0;520.067953604221;497.108383964256;49;1017.17633756848
05;2021-02-26;0;0;0;468.146063921917;510.087601910415;59;978.233665832332
05;2021-02-26;0;0;0;340.368470050554;334.366842191253;69;674.735312241807
05;2021-02-26;0;0;0;212.598666888387;192.597753227106;79;405.196420115493
05;2021-02-26;0;0;0;148.727797095705;61.8681715431829;89;210.595968638888
05;2021-02-26;0;0;0;32.9601271090696;10.9909785719784;90;43.9511056810479
05;2021-02-26;0;0;0;3061.43020057959;2935.56979942041;0;5997
06;2021-02-26;2;3;6;42583;42380;09;84963
06;2021-02-26;10;5;15;33369;31925;19;65294
06;2021-02-26;30;9;39;21571;15080;29;36651
06;2021-02-26;26;15;41;21550;16147;39;37697
06;2021-02-26;25;15;40;14193;13939;49;28132
06;2021-02-26;6;11;17;7171;7597;59;14768
06;2021-02-26;24;18;43;3629;4117;69;7746
06;2021-02-26;3;5;8;1577;1457;79;3034
06;2021-02-26;2;1;3;531;474;89;1005
06;2021-02-26;1;0;1;88;93;90;181
06;2021-02-26;129;82;213;146262;133209;0;279471
07;2021-02-26;0;0;0;485;549;09;1034
07;2021-02-26;0;1;1;403;432;19;835
07;2021-02-26;1;0;1;764;841;29;1605
07;2021-02-26;4;2;6;824;928;39;1752
07;2021-02-26;2;0;2;788;1020;49;1808
07;2021-02-26;1;0;1;678;870;59;1548
07;2021-02-26;0;1;1;360;382;69;742
07;2021-02-26;0;0;0;231;190;79;421
07;2021-02-26;0;0;0;114;67;89;181
07;2021-02-26;0;0;0;24;11;90;35
07;2021-02-26;8;4;12;4671;5290;0;9961
08;2021-02-26;0;0;0;2715.22592983026;2997.75551488675;09;5712.98144471701
08;2021-02-26;2;0;2;2778.51901080978;3160.9156459093;19;5939.43465671908
08;2021-02-26;0;0;0;2080.8882988764;1718.16634315323;29;3799.05464202964
08;2021-02-26;1;1;2;2701.8582062647;1896.52641413317;39;4598.38462039786
08;2021-02-26;0;0;0;3151.45861023308;2460.52498233809;49;5611.98359257117
08;2021-02-26;0;0;0;2620.29868333099;2422.23566154656;59;5042.53434487755
08;2021-02-26;0;0;0;1621.44173420671;1438.58325779464;69;3060.02499200135
08;2021-02-26;0;0;0;626.575909335673;526.358467843651;79;1152.93437717932
08;2021-02-26;0;0;0;205.018522985054;140.993639349697;89;346.012162334751
08;2021-02-26;0;0;0;50.0325684687745;20.62259870351;90;70.6551671722846
08;2021-02-26;3;1;4;18551.3174743414;16782.6825256586;0;35334
11;2021-02-26;185;181;384;783071;811785;09;1594856
11;2021-02-26;489;451;970;761456;784653;19;1546109
11;2021-02-26;653;548;1206;850145;801772;29;1651917
11;2021-02-26;626;582;1213;914360;843488;39;1757848
11;2021-02-26;610;531;1146;845609;826202;49;1671811
11;2021-02-26;457;437;904;793566;745070;59;1538636
11;2021-02-26;305;306;615;628649;549192;69;1177841
11;2021-02-26;142;133;276;434606;358356;79;792962
11;2021-02-26;98;66;165;261425;162933;89;424358
11;2021-02-26;52;14;66;89253;32619;90;121872
11;2021-02-26;3617;3249;6945;6362140;5916070;0;12278210
24;2021-02-26;14;10;24;139720;144686;09;284406
24;2021-02-26;42;36;79;152979;161185;19;314164
24;2021-02-26;51;53;104;122237;126536;29;248773
24;2021-02-26;64;59;123;150359;142009;39;292368
24;2021-02-26;49;44;93;161829;158758;49;320587
24;2021-02-26;53;58;111;172552;168011;59;340563
24;2021-02-26;43;58;101;172509;158177;69;330686
24;2021-02-26;27;27;54;129428;110593;79;240021
24;2021-02-26;20;8;28;87342;56882;89;144224
24;2021-02-26;4;1;5;31210;12071;90;43281
24;2021-02-26;367;354;722;1320165;1238908;0;2559073
27;2021-02-26;14;16;30;143373;149679;09;293052
27;2021-02-26;53;66;119;160962;173003;19;333965
27;2021-02-26;56;57;113;133746;142254;29;276000
27;2021-02-26;35;59;94;160004;155407;39;315411
27;2021-02-26;52;50;102;172333;169564;49;341897
27;2021-02-26;70;61;131;189979;183788;59;373767
27;2021-02-26;44;44;88;192591;178206;69;370797
27;2021-02-26;33;24;57;146876;127546;79;274422
27;2021-02-26;18;22;40;96896;61575;89;158471
27;2021-02-26;6;1;7;33148;12109;90;45257
27;2021-02-26;381;400;781;1429908;1353131;0;2783039
28;2021-02-26;18;19;39;180735;186856;09;367591
28;2021-02-26;74;51;126;200125;213621;19;413746
28;2021-02-26;67;76;143;168922;173007;29;341929
28;2021-02-26;80;78;158;196628;188487;39;385115
28;2021-02-26;82;62;144;205396;201699;49;407095
28;2021-02-26;55;64;119;222002;213866;59;435868
28;2021-02-26;59;49;108;224688;203758;69;428446
28;2021-02-26;30;33;63;163192;135543;79;298735
28;2021-02-26;26;12;38;109691;65377;89;175068
28;2021-02-26;6;3;9;37222;12685;90;49907
28;2021-02-26;497;447;947;1708601;1594899;0;3303500
32;2021-02-26;87;113;200;358062;373689;09;731751
32;2021-02-26;235;245;481;387045;406742;19;793787
32;2021-02-26;298;245;544;342304;348587;29;690891
32;2021-02-26;283;210;494;382485;369972;39;752457
32;2021-02-26;299;247;547;382510;376716;49;759226
32;2021-02-26;221;241;462;386937;376527;59;763464
32;2021-02-26;174;166;340;371211;330938;69;702149
32;2021-02-26;123;112;235;250542;201459;79;452001
32;2021-02-26;92;47;139;163399;89786;89;253185
32;2021-02-26;41;14;56;48384;15367;90;63751
32;2021-02-26;1853;1641;3499;3072879;2889783;0;5962662
44;2021-02-26;63;50;116;291525;306839;09;598364
44;2021-02-26;124;137;261;320255;339504;19;659759
44;2021-02-26;135;126;263;302020;314428;29;616448
44;2021-02-26;159;129;289;342222;333292;39;675514
44;2021-02-26;129;110;239;349727;344491;49;694218
44;2021-02-26;117;125;242;381371;373239;59;754610
44;2021-02-26;80;81;161;367165;335850;69;703015
44;2021-02-26;51;50;102;250387;215436;79;465823
44;2021-02-26;39;28;67;170825;105192;89;276017
44;2021-02-26;28;8;36;51248;16731;90;67979
44;2021-02-26;925;844;1776;2826745;2685002;0;5511747
52;2021-02-26;20;16;36;213594;223900;09;437494
52;2021-02-26;62;79;143;240818;255197;19;496015
52;2021-02-26;64;70;134;197010;200630;29;397640
52;2021-02-26;65;50;115;231204;224885;39;456089
52;2021-02-26;71;67;138;243874;243418;49;487292
52;2021-02-26;69;70;139;244100;239116;59;483216
52;2021-02-26;50;42;92;241796;221345;69;463141
52;2021-02-26;30;26;56;177805;149903;79;327708
52;2021-02-26;15;16;31;119561;75822;89;195383
52;2021-02-26;9;5;14;42559;15260;90;57819
52;2021-02-26;455;441;898;1952321;1849476;0;3801797
53;2021-02-26;18;9;28;173813;182358;09;356171
53;2021-02-26;61;70;133;202720;214740;19;417460
53;2021-02-26;50;62;112;163116;173196;29;336312
53;2021-02-26;33;46;79;190526;187674;39;378200
53;2021-02-26;43;43;86;212098;212015;49;424113
53;2021-02-26;34;28;62;223699;219176;59;442875
53;2021-02-26;20;31;51;227435;209274;69;436709
53;2021-02-26;17;11;28;169992;140910;79;310902
53;2021-02-26;10;5;15;118117;69883;89;188000
53;2021-02-26;10;1;11;37370;12267;90;49637
53;2021-02-26;296;306;605;1718886;1621493;0;3340379
75;2021-02-26;23;23;46;293104;305291;09;598395
75;2021-02-26;97;85;182;337141;357785;19;694926
75;2021-02-26;84;93;177;295024;300618;29;595642
75;2021-02-26;68;68;136;347871;331233;39;679104
75;2021-02-26;89;76;165;384742;372771;49;757513
75;2021-02-26;96;83;179;413361;390880;59;804241
75;2021-02-26;71;69;140;425623;384060;69;809683
75;2021-02-26;34;37;71;325086;276298;79;601384
75;2021-02-26;36;17;53;213986;139308;89;353294
75;2021-02-26;22;6;28;77600;28200;90;105800
75;2021-02-26;620;557;1177;3113538;2886444;0;5999982
76;2021-02-26;40;29;70;305956;318589;09;624545
76;2021-02-26;98;122;223;338942;356969;19;695911
76;2021-02-26;108;112;220;316210;319570;29;635780
76;2021-02-26;124;112;236;356758;337587;39;694345
76;2021-02-26;110;121;231;376541;363812;49;740353
76;2021-02-26;112;108;220;402608;383750;59;786358
76;2021-02-26;88;78;166;394889;358997;69;753886
76;2021-02-26;43;33;76;308664;263806;79;572470
76;2021-02-26;41;25;66;195838;129272;89;325110
76;2021-02-26;19;4;23;69372;26728;90;96100
76;2021-02-26;784;744;1532;3065778;2859080;0;5924858
84;2021-02-26;59;79;138;459549;481088;09;940637
84;2021-02-26;190;183;375;487711;511905;19;999616
84;2021-02-26;215;185;401;443824;451094;29;894918
84;2021-02-26;220;169;389;512522;493262;39;1005784
84;2021-02-26;202;182;384;520248;515106;49;1035354
84;2021-02-26;186;190;376;529611;514848;59;1044459
84;2021-02-26;123;108;231;486720;439940;69;926660
84;2021-02-26;86;82;168;372151;315211;79;687362
84;2021-02-26;54;46;100;237198;150524;89;387722
84;2021-02-26;30;5;35;81185;28680;90;109865
84;2021-02-26;1366;1229;2599;4130719;3901658;0;8032377
93;2021-02-26;63;55;118;268834;283093;09;551927
93;2021-02-26;201;170;372;280751;296087;19;576838
93;2021-02-26;254;183;438;254404;255552;29;509956
93;2021-02-26;270;198;470;310704;288398;39;599102
93;2021-02-26;237;214;451;325559;305827;49;631386
93;2021-02-26;248;242;490;353104;325389;59;678493
93;2021-02-26;144;122;266;336327;296459;69;632786
93;2021-02-26;95;98;194;279820;229699;79;509519
93;2021-02-26;54;53;107;171274;113716;89;284990
93;2021-02-26;22;15;37;58896;21758;90;80654
93;2021-02-26;1588;1350;2943;2639673;2415978;0;5055651
94;2021-02-26;3;0;3;16311;17433;09;33744
94;2021-02-26;5;13;18;16679;18132;19;34811
94;2021-02-26;2;2;4;16782;16579;29;33361
94;2021-02-26;2;3;5;23044;20580;39;43624
94;2021-02-26;9;5;14;23065;22140;49;45205
94;2021-02-26;2;11;13;24549;23421;59;47970
94;2021-02-26;6;5;11;23212;21883;69;45095
94;2021-02-26;2;2;4;19544;17141;79;36685
94;2021-02-26;2;2;4;11227;8178;89;19405
94;2021-02-26;3;0;3;3332;1447;90;4779
94;2021-02-26;36;43;79;177745;166934;0;344679
01;2021-02-27;0;2;2;19979;20155;09;40134
01;2021-02-27;3;1;4;24994;25489;19;50483
01;2021-02-27;1;1;2;17868;16690;29;34558
01;2021-02-27;2;1;3;22328;14821;39;37149
01;2021-02-27;3;2;5;28652;20276;49;48928
01;2021-02-27;3;2;5;33264;27260;59;60524
01;2021-02-27;1;4;5;27135;23978;69;51113
01;2021-02-27;1;1;2;18401;14661;79;33062
01;2021-02-27;0;0;0;9633;6375;89;16008
01;2021-02-27;0;1;1;3410;1510;90;4920
01;2021-02-27;14;15;29;205664;171215;0;376879
02;2021-02-27;0;0;0;16881;17110;09;33991
02;2021-02-27;0;0;0;21410;21604;19;43014
02;2021-02-27;4;0;4;16017;15479;29;31496
02;2021-02-27;2;0;2;19825;14455;39;34280
02;2021-02-27;0;0;0;24719;18248;49;42967
02;2021-02-27;1;1;2;34361;28310;59;62671
02;2021-02-27;0;0;0;28061;24495;69;52556
02;2021-02-27;0;0;0;18231;15278;79;33509
02;2021-02-27;0;0;0;11090;7677;89;18767
02;2021-02-27;0;0;0;3992;1506;90;5498
02;2021-02-27;7;1;8;194587;164162;0;358749
03;2021-02-27;0;0;0;31123;30920;09;62043
03;2021-02-27;0;2;2;29370;29268;19;58638
03;2021-02-27;0;0;0;21458;18963;29;40421
03;2021-02-27;1;1;2;21276;18326;39;39602
03;2021-02-27;1;0;1;18164;16593;49;34757
03;2021-02-27;1;2;3;13469;13557;59;27026
03;2021-02-27;0;1;1;8776;8670;69;17446
03;2021-02-27;0;0;0;3777;3591;79;7368
03;2021-02-27;0;0;0;1649;1072;89;2721
03;2021-02-27;0;0;0;485;184;90;669
03;2021-02-27;3;6;9;149547;141144;0;290691
04;2021-02-27;3;1;4;60314;61377;09;121691
04;2021-02-27;8;4;12;66065;68387;19;134452
04;2021-02-27;7;14;21;51059;47156;29;98215
04;2021-02-27;11;7;18;58788;45780;39;104568
04;2021-02-27;12;10;22;61408;52207;49;113615
04;2021-02-27;8;9;17;64838;60759;59;125597
04;2021-02-27;3;4;7;47008;42843;69;89851
04;2021-02-27;1;2;3;25509;21184;79;46693
04;2021-02-27;0;0;0;13168;7647;89;20815
04;2021-02-27;0;0;0;3209;1253;90;4462
04;2021-02-27;53;51;104;451366;408593;0;859959
05;2021-02-27;0;0;0;362.366008612902;341.338819562748;09;703.704828175651
05;2021-02-27;0;0;0;353.376145114279;370.349735405642;19;723.725880519921
05;2021-02-27;0;0;0;218.593559489256;256.539602589476;29;475.133162078732
05;2021-02-27;0;0;0;404.225408693299;360.321910454353;39;764.547319147651
05;2021-02-27;0;0;0;520.067953604221;497.108383964256;49;1017.17633756848
05;2021-02-27;0;0;0;468.146063921917;510.087601910415;59;978.233665832332
05;2021-02-27;0;0;0;340.368470050554;334.366842191253;69;674.735312241807
05;2021-02-27;0;0;0;212.598666888387;192.597753227106;79;405.196420115493
05;2021-02-27;0;0;0;148.727797095705;61.8681715431829;89;210.595968638888
05;2021-02-27;0;0;0;32.9601271090696;10.9909785719784;90;43.9511056810479
05;2021-02-27;0;0;0;3061.43020057959;2935.56979942041;0;5997
06;2021-02-27;2;0;2;42583;42380;09;84963
06;2021-02-27;2;3;5;33369;31925;19;65294
06;2021-02-27;7;9;16;21571;15080;29;36651
06;2021-02-27;11;13;24;21550;16147;39;37697
06;2021-02-27;4;7;11;14193;13939;49;28132
06;2021-02-27;4;2;6;7171;7597;59;14768
06;2021-02-27;21;21;42;3629;4117;69;7746
06;2021-02-27;4;2;6;1577;1457;79;3034
06;2021-02-27;0;0;0;531;474;89;1005
06;2021-02-27;0;0;0;88;93;90;181
06;2021-02-27;55;57;112;146262;133209;0;279471
07;2021-02-27;0;0;0;485;549;09;1034
07;2021-02-27;0;0;0;403;432;19;835
07;2021-02-27;1;0;1;764;841;29;1605
07;2021-02-27;0;0;0;824;928;39;1752
07;2021-02-27;1;0;1;788;1020;49;1808
07;2021-02-27;0;0;0;678;870;59;1548
07;2021-02-27;1;0;1;360;382;69;742
07;2021-02-27;0;0;0;231;190;79;421
07;2021-02-27;0;0;0;114;67;89;181
07;2021-02-27;0;0;0;24;11;90;35
07;2021-02-27;3;0;3;4671;5290;0;9961
08;2021-02-27;0;0;0;2715.22592983026;2997.75551488675;09;5712.98144471701
08;2021-02-27;0;1;1;2778.51901080978;3160.9156459093;19;5939.43465671908
08;2021-02-27;0;1;1;2080.8882988764;1718.16634315323;29;3799.05464202964
08;2021-02-27;0;1;1;2701.8582062647;1896.52641413317;39;4598.38462039786
08;2021-02-27;1;0;1;3151.45861023308;2460.52498233809;49;5611.98359257117
08;2021-02-27;0;0;0;2620.29868333099;2422.23566154656;59;5042.53434487755
08;2021-02-27;1;1;2;1621.44173420671;1438.58325779464;69;3060.02499200135
08;2021-02-27;0;0;0;626.575909335673;526.358467843651;79;1152.93437717932
08;2021-02-27;0;0;0;205.018522985054;140.993639349697;89;346.012162334751
08;2021-02-27;0;0;0;50.0325684687745;20.62259870351;90;70.6551671722846
08;2021-02-27;2;4;6;18551.3174743414;16782.6825256586;0;35334
11;2021-02-27;100;125;243;783071;811785;09;1594856
11;2021-02-27;295;303;623;761456;784653;19;1546109
11;2021-02-27;404;381;787;850145;801772;29;1651917
11;2021-02-27;388;322;711;914360;843488;39;1757848
11;2021-02-27;339;333;672;845609;826202;49;1671811
11;2021-02-27;264;298;563;793566;745070;59;1538636
11;2021-02-27;217;190;414;628649;549192;69;1177841
11;2021-02-27;87;82;169;434606;358356;79;792962
11;2021-02-27;57;43;100;261425;162933;89;424358
11;2021-02-27;16;12;28;89253;32619;90;121872
11;2021-02-27;2167;2089;4310;6362140;5916070;0;12278210
24;2021-02-27;4;7;11;139720;144686;09;284406
24;2021-02-27;26;35;61;152979;161185;19;314164
24;2021-02-27;30;29;59;122237;126536;29;248773
24;2021-02-27;33;33;66;150359;142009;39;292368
24;2021-02-27;28;47;75;161829;158758;49;320587
24;2021-02-27;28;37;65;172552;168011;59;340563
24;2021-02-27;21;15;36;172509;158177;69;330686
24;2021-02-27;11;16;27;129428;110593;79;240021
24;2021-02-27;5;4;9;87342;56882;89;144224
24;2021-02-27;5;8;13;31210;12071;90;43281
24;2021-02-27;191;231;422;1320165;1238908;0;2559073
27;2021-02-27;7;7;14;143373;149679;09;293052
27;2021-02-27;26;49;75;160962;173003;19;333965
27;2021-02-27;32;25;57;133746;142254;29;276000
27;2021-02-27;41;37;78;160004;155407;39;315411
27;2021-02-27;33;29;62;172333;169564;49;341897
27;2021-02-27;28;42;70;189979;183788;59;373767
27;2021-02-27;29;25;54;192591;178206;69;370797
27;2021-02-27;12;21;33;146876;127546;79;274422
27;2021-02-27;13;8;21;96896;61575;89;158471
27;2021-02-27;1;1;2;33148;12109;90;45257
27;2021-02-27;222;244;466;1429908;1353131;0;2783039
28;2021-02-27;8;3;12;180735;186856;09;367591
28;2021-02-27;41;37;79;200125;213621;19;413746
28;2021-02-27;28;27;55;168922;173007;29;341929
28;2021-02-27;35;35;70;196628;188487;39;385115
28;2021-02-27;44;31;75;205396;201699;49;407095
28;2021-02-27;35;43;78;222002;213866;59;435868
28;2021-02-27;32;33;65;224688;203758;69;428446
28;2021-02-27;16;18;34;163192;135543;79;298735
28;2021-02-27;15;6;21;109691;65377;89;175068
28;2021-02-27;7;5;12;37222;12685;90;49907
28;2021-02-27;261;238;501;1708601;1594899;0;3303500
32;2021-02-27;55;73;128;358062;373689;09;731751
32;2021-02-27;129;160;289;387045;406742;19;793787
32;2021-02-27;151;146;297;342304;348587;29;690891
32;2021-02-27;163;157;320;382485;369972;39;752457
32;2021-02-27;188;180;368;382510;376716;49;759226
32;2021-02-27;161;130;291;386937;376527;59;763464
32;2021-02-27;103;98;201;371211;330938;69;702149
32;2021-02-27;75;63;138;250542;201459;79;452001
32;2021-02-27;46;27;73;163399;89786;89;253185
32;2021-02-27;16;11;27;48384;15367;90;63751
32;2021-02-27;1087;1045;2132;3072879;2889783;0;5962662
44;2021-02-27;17;20;38;291525;306839;09;598364
44;2021-02-27;72;71;143;320255;339504;19;659759
44;2021-02-27;96;74;170;302020;314428;29;616448
44;2021-02-27;82;89;171;342222;333292;39;675514
44;2021-02-27;99;86;185;349727;344491;49;694218
44;2021-02-27;77;70;147;381371;373239;59;754610
44;2021-02-27;52;50;102;367165;335850;69;703015
44;2021-02-27;40;33;73;250387;215436;79;465823
44;2021-02-27;27;15;42;170825;105192;89;276017
44;2021-02-27;10;5;15;51248;16731;90;67979
44;2021-02-27;572;513;1086;2826745;2685002;0;5511747
52;2021-02-27;12;20;34;213594;223900;09;437494
52;2021-02-27;55;45;100;240818;255197;19;496015
52;2021-02-27;49;30;79;197010;200630;29;397640
52;2021-02-27;40;39;79;231204;224885;39;456089
52;2021-02-27;46;43;89;243874;243418;49;487292
52;2021-02-27;48;46;94;244100;239116;59;483216
52;2021-02-27;19;23;42;241796;221345;69;463141
52;2021-02-27;16;19;35;177805;149903;79;327708
52;2021-02-27;6;13;19;119561;75822;89;195383
52;2021-02-27;7;3;10;42559;15260;90;57819
52;2021-02-27;298;281;581;1952321;1849476;0;3801797
53;2021-02-27;3;10;14;173813;182358;09;356171
53;2021-02-27;24;35;59;202720;214740;19;417460
53;2021-02-27;37;30;67;163116;173196;29;336312
53;2021-02-27;19;31;50;190526;187674;39;378200
53;2021-02-27;22;32;54;212098;212015;49;424113
53;2021-02-27;26;26;52;223699;219176;59;442875
53;2021-02-27;16;7;23;227435;209274;69;436709
53;2021-02-27;10;8;18;169992;140910;79;310902
53;2021-02-27;11;5;16;118117;69883;89;188000
53;2021-02-27;3;2;5;37370;12267;90;49637
53;2021-02-27;171;186;358;1718886;1621493;0;3340379
75;2021-02-27;16;16;32;293104;305291;09;598395
75;2021-02-27;49;48;97;337141;357785;19;694926
75;2021-02-27;73;54;127;295024;300618;29;595642
75;2021-02-27;44;44;88;347871;331233;39;679104
75;2021-02-27;55;45;100;384742;372771;49;757513
75;2021-02-27;43;41;84;413361;390880;59;804241
75;2021-02-27;41;24;65;425623;384060;69;809683
75;2021-02-27;17;29;46;325086;276298;79;601384
75;2021-02-27;18;10;28;213986;139308;89;353294
75;2021-02-27;8;2;10;77600;28200;90;105800
75;2021-02-27;364;313;677;3113538;2886444;0;5999982
76;2021-02-27;26;13;39;305956;318589;09;624545
76;2021-02-27;58;66;126;338942;356969;19;695911
76;2021-02-27;69;60;130;316210;319570;29;635780
76;2021-02-27;76;75;151;356758;337587;39;694345
76;2021-02-27;70;50;120;376541;363812;49;740353
76;2021-02-27;61;52;113;402608;383750;59;786358
76;2021-02-27;36;38;74;394889;358997;69;753886
76;2021-02-27;15;19;34;308664;263806;79;572470
76;2021-02-27;18;11;29;195838;129272;89;325110
76;2021-02-27;5;3;8;69372;26728;90;96100
76;2021-02-27;434;387;824;3065778;2859080;0;5924858
84;2021-02-27;31;43;74;459549;481088;09;940637
84;2021-02-27;110;101;211;487711;511905;19;999616
84;2021-02-27;107;114;221;443824;451094;29;894918
84;2021-02-27;107;96;203;512522;493262;39;1005784
84;2021-02-27;119;103;223;520248;515106;49;1035354
84;2021-02-27;88;90;178;529611;514848;59;1044459
84;2021-02-27;58;55;113;486720;439940;69;926660
84;2021-02-27;37;36;73;372151;315211;79;687362
84;2021-02-27;31;21;52;237198;150524;89;387722
84;2021-02-27;13;2;15;81185;28680;90;109865
84;2021-02-27;701;661;1363;4130719;3901658;0;8032377
93;2021-02-27;24;27;51;268834;283093;09;551927
93;2021-02-27;119;77;196;280751;296087;19;576838
93;2021-02-27;140;102;242;254404;255552;29;509956
93;2021-02-27;107;96;203;310704;288398;39;599102
93;2021-02-27;128;113;241;325559;305827;49;631386
93;2021-02-27;92;116;209;353104;325389;59;678493
93;2021-02-27;78;67;145;336327;296459;69;632786
93;2021-02-27;46;45;91;279820;229699;79;509519
93;2021-02-27;22;28;50;171274;113716;89;284990
93;2021-02-27;16;10;26;58896;21758;90;80654
93;2021-02-27;772;682;1455;2639673;2415978;0;5055651
94;2021-02-27;0;0;0;16311;17433;09;33744
94;2021-02-27;1;1;2;16679;18132;19;34811
94;2021-02-27;4;7;11;16782;16579;29;33361
94;2021-02-27;1;5;6;23044;20580;39;43624
94;2021-02-27;0;2;2;23065;22140;49;45205
94;2021-02-27;1;1;2;24549;23421;59;47970
94;2021-02-27;3;1;4;23212;21883;69;45095
94;2021-02-27;0;1;1;19544;17141;79;36685
94;2021-02-27;0;0;0;11227;8178;89;19405
94;2021-02-27;0;0;0;3332;1447;90;4779
94;2021-02-27;10;18;28;177745;166934;0;344679
01;2021-02-28;0;0;0;19979;20155;09;40134
01;2021-02-28;2;1;3;24994;25489;19;50483
01;2021-02-28;0;1;1;17868;16690;29;34558
01;2021-02-28;3;1;4;22328;14821;39;37149
01;2021-02-28;1;0;1;28652;20276;49;48928
01;2021-02-28;2;0;2;33264;27260;59;60524
01;2021-02-28;0;3;3;27135;23978;69;51113
01;2021-02-28;1;0;1;18401;14661;79;33062
01;2021-02-28;0;0;0;9633;6375;89;16008
01;2021-02-28;0;0;0;3410;1510;90;4920
01;2021-02-28;9;6;15;205664;171215;0;376879
02;2021-02-28;0;0;0;16881;17110;09;33991
02;2021-02-28;0;0;0;21410;21604;19;43014
02;2021-02-28;0;0;0;16017;15479;29;31496
02;2021-02-28;2;0;2;19825;14455;39;34280
02;2021-02-28;0;0;0;24719;18248;49;42967
02;2021-02-28;0;0;0;34361;28310;59;62671
02;2021-02-28;0;0;0;28061;24495;69;52556
02;2021-02-28;0;0;0;18231;15278;79;33509
02;2021-02-28;0;0;0;11090;7677;89;18767
02;2021-02-28;0;0;0;3992;1506;90;5498
02;2021-02-28;2;0;2;194587;164162;0;358749
03;2021-02-28;0;0;0;31123;30920;09;62043
03;2021-02-28;0;0;0;29370;29268;19;58638
03;2021-02-28;0;0;0;21458;18963;29;40421
03;2021-02-28;0;0;0;21276;18326;39;39602
03;2021-02-28;0;0;0;18164;16593;49;34757
03;2021-02-28;0;0;0;13469;13557;59;27026
03;2021-02-28;0;0;0;8776;8670;69;17446
03;2021-02-28;0;0;0;3777;3591;79;7368
03;2021-02-28;0;0;0;1649;1072;89;2721
03;2021-02-28;0;0;0;485;184;90;669
03;2021-02-28;0;0;0;149547;141144;0;290691
04;2021-02-28;0;3;3;60314;61377;09;121691
04;2021-02-28;6;0;6;66065;68387;19;134452
04;2021-02-28;3;2;5;51059;47156;29;98215
04;2021-02-28;5;2;7;58788;45780;39;104568
04;2021-02-28;1;4;5;61408;52207;49;113615
04;2021-02-28;4;3;7;64838;60759;59;125597
04;2021-02-28;4;1;5;47008;42843;69;89851
04;2021-02-28;0;0;0;25509;21184;79;46693
04;2021-02-28;0;0;0;13168;7647;89;20815
04;2021-02-28;0;0;0;3209;1253;90;4462
04;2021-02-28;23;15;38;451366;408593;0;859959
05;2021-02-28;0;0;0;362.366008612902;341.338819562748;09;703.704828175651
05;2021-02-28;0;0;0;353.376145114279;370.349735405642;19;723.725880519921
05;2021-02-28;0;0;0;218.593559489256;256.539602589476;29;475.133162078732
05;2021-02-28;0;0;0;404.225408693299;360.321910454353;39;764.547319147651
05;2021-02-28;0;0;0;520.067953604221;497.108383964256;49;1017.17633756848
05;2021-02-28;0;0;0;468.146063921917;510.087601910415;59;978.233665832332
05;2021-02-28;0;0;0;340.368470050554;334.366842191253;69;674.735312241807
05;2021-02-28;0;0;0;212.598666888387;192.597753227106;79;405.196420115493
05;2021-02-28;0;0;0;148.727797095705;61.8681715431829;89;210.595968638888
05;2021-02-28;0;0;0;32.9601271090696;10.9909785719784;90;43.9511056810479
05;2021-02-28;0;0;0;3061.43020057959;2935.56979942041;0;5997
06;2021-02-28;0;0;0;42583;42380;09;84963
06;2021-02-28;1;1;2;33369;31925;19;65294
06;2021-02-28;6;2;8;21571;15080;29;36651
06;2021-02-28;5;2;7;21550;16147;39;37697
06;2021-02-28;3;1;4;14193;13939;49;28132
06;2021-02-28;3;1;4;7171;7597;59;14768
06;2021-02-28;8;8;16;3629;4117;69;7746
06;2021-02-28;0;1;1;1577;1457;79;3034
06;2021-02-28;1;1;2;531;474;89;1005
06;2021-02-28;0;0;0;88;93;90;181
06;2021-02-28;28;17;45;146262;133209;0;279471
07;2021-02-28;0;0;0;485;549;09;1034
07;2021-02-28;0;0;0;403;432;19;835
07;2021-02-28;0;0;0;764;841;29;1605
07;2021-02-28;0;0;0;824;928;39;1752
07;2021-02-28;0;0;0;788;1020;49;1808
07;2021-02-28;0;0;0;678;870;59;1548
07;2021-02-28;0;0;0;360;382;69;742
07;2021-02-28;1;0;1;231;190;79;421
07;2021-02-28;0;0;0;114;67;89;181
07;2021-02-28;0;0;0;24;11;90;35
07;2021-02-28;1;0;1;4671;5290;0;9961
08;2021-02-28;0;0;0;2715.22592983026;2997.75551488675;09;5712.98144471701
08;2021-02-28;0;0;0;2778.51901080978;3160.9156459093;19;5939.43465671908
08;2021-02-28;0;0;0;2080.8882988764;1718.16634315323;29;3799.05464202964
08;2021-02-28;0;0;0;2701.8582062647;1896.52641413317;39;4598.38462039786
08;2021-02-28;0;0;0;3151.45861023308;2460.52498233809;49;5611.98359257117
08;2021-02-28;0;0;0;2620.29868333099;2422.23566154656;59;5042.53434487755
08;2021-02-28;0;0;0;1621.44173420671;1438.58325779464;69;3060.02499200135
08;2021-02-28;0;0;0;626.575909335673;526.358467843651;79;1152.93437717932
08;2021-02-28;0;0;0;205.018522985054;140.993639349697;89;346.012162334751
08;2021-02-28;0;0;0;50.0325684687745;20.62259870351;90;70.6551671722846
08;2021-02-28;0;0;0;18551.3174743414;16782.6825256586;0;35334
11;2021-02-28;19;29;49;783071;811785;09;1594856
11;2021-02-28;48;56;104;761456;784653;19;1546109
11;2021-02-28;104;105;209;850145;801772;29;1651917
11;2021-02-28;87;91;178;914360;843488;39;1757848
11;2021-02-28;85;79;165;845609;826202;49;1671811
11;2021-02-28;53;56;109;793566;745070;59;1538636
11;2021-02-28;51;47;98;628649;549192;69;1177841
11;2021-02-28;28;24;52;434606;358356;79;792962
11;2021-02-28;20;15;35;261425;162933;89;424358
11;2021-02-28;14;11;25;89253;32619;90;121872
11;2021-02-28;509;513;1024;6362140;5916070;0;12278210
24;2021-02-28;2;1;3;139720;144686;09;284406
24;2021-02-28;7;7;14;152979;161185;19;314164
24;2021-02-28;5;10;15;122237;126536;29;248773
24;2021-02-28;3;7;10;150359;142009;39;292368
24;2021-02-28;6;3;9;161829;158758;49;320587
24;2021-02-28;2;3;5;172552;168011;59;340563
24;2021-02-28;2;7;9;172509;158177;69;330686
24;2021-02-28;5;5;10;129428;110593;79;240021
24;2021-02-28;4;2;6;87342;56882;89;144224
24;2021-02-28;2;1;3;31210;12071;90;43281
24;2021-02-28;38;46;84;1320165;1238908;0;2559073
27;2021-02-28;0;0;0;143373;149679;09;293052
27;2021-02-28;3;2;5;160962;173003;19;333965
27;2021-02-28;4;5;9;133746;142254;29;276000
27;2021-02-28;4;0;4;160004;155407;39;315411
27;2021-02-28;4;1;5;172333;169564;49;341897
27;2021-02-28;8;4;12;189979;183788;59;373767
27;2021-02-28;0;6;6;192591;178206;69;370797
27;2021-02-28;4;4;8;146876;127546;79;274422
27;2021-02-28;7;3;10;96896;61575;89;158471
27;2021-02-28;3;1;4;33148;12109;90;45257
27;2021-02-28;37;26;63;1429908;1353131;0;2783039
28;2021-02-28;0;6;6;180735;186856;09;367591
28;2021-02-28;7;8;15;200125;213621;19;413746
28;2021-02-28;14;15;29;168922;173007;29;341929
28;2021-02-28;18;9;27;196628;188487;39;385115
28;2021-02-28;9;9;18;205396;201699;49;407095
28;2021-02-28;6;12;18;222002;213866;59;435868
28;2021-02-28;6;3;9;224688;203758;69;428446
28;2021-02-28;7;9;16;163192;135543;79;298735
28;2021-02-28;7;6;13;109691;65377;89;175068
28;2021-02-28;3;1;4;37222;12685;90;49907
28;2021-02-28;77;78;155;1708601;1594899;0;3303500
32;2021-02-28;18;16;34;358062;373689;09;731751
32;2021-02-28;30;37;67;387045;406742;19;793787
32;2021-02-28;47;27;74;342304;348587;29;690891
32;2021-02-28;51;52;103;382485;369972;39;752457
32;2021-02-28;47;39;86;382510;376716;49;759226
32;2021-02-28;27;47;74;386937;376527;59;763464
32;2021-02-28;22;21;43;371211;330938;69;702149
32;2021-02-28;10;11;21;250542;201459;79;452001
32;2021-02-28;15;14;29;163399;89786;89;253185
32;2021-02-28;8;4;12;48384;15367;90;63751
32;2021-02-28;275;269;544;3072879;2889783;0;5962662
44;2021-02-28;4;2;6;291525;306839;09;598364
44;2021-02-28;4;8;12;320255;339504;19;659759
44;2021-02-28;15;7;22;302020;314428;29;616448
44;2021-02-28;17;10;27;342222;333292;39;675514
44;2021-02-28;11;15;26;349727;344491;49;694218
44;2021-02-28;8;11;19;381371;373239;59;754610
44;2021-02-28;9;13;22;367165;335850;69;703015
44;2021-02-28;6;6;12;250387;215436;79;465823
44;2021-02-28;11;8;19;170825;105192;89;276017
44;2021-02-28;8;4;12;51248;16731;90;67979
44;2021-02-28;93;84;177;2826745;2685002;0;5511747
52;2021-02-28;2;1;3;213594;223900;09;437494
52;2021-02-28;15;17;32;240818;255197;19;496015
52;2021-02-28;16;8;24;197010;200630;29;397640
52;2021-02-28;15;14;29;231204;224885;39;456089
52;2021-02-28;13;18;31;243874;243418;49;487292
52;2021-02-28;12;11;23;244100;239116;59;483216
52;2021-02-28;10;8;18;241796;221345;69;463141
52;2021-02-28;3;4;7;177805;149903;79;327708
52;2021-02-28;3;3;6;119561;75822;89;195383
52;2021-02-28;1;0;1;42559;15260;90;57819
52;2021-02-28;90;84;174;1952321;1849476;0;3801797
53;2021-02-28;0;1;1;173813;182358;09;356171
53;2021-02-28;10;3;13;202720;214740;19;417460
53;2021-02-28;6;5;11;163116;173196;29;336312
53;2021-02-28;2;1;3;190526;187674;39;378200
53;2021-02-28;4;7;11;212098;212015;49;424113
53;2021-02-28;3;6;9;223699;219176;59;442875
53;2021-02-28;1;3;4;227435;209274;69;436709
53;2021-02-28;4;5;9;169992;140910;79;310902
53;2021-02-28;2;1;3;118117;69883;89;188000
53;2021-02-28;1;0;1;37370;12267;90;49637
53;2021-02-28;33;32;65;1718886;1621493;0;3340379
75;2021-02-28;1;1;2;293104;305291;09;598395
75;2021-02-28;4;7;11;337141;357785;19;694926
75;2021-02-28;6;6;12;295024;300618;29;595642
75;2021-02-28;11;8;19;347871;331233;39;679104
75;2021-02-28;5;3;8;384742;372771;49;757513
75;2021-02-28;6;5;11;413361;390880;59;804241
75;2021-02-28;3;3;6;425623;384060;69;809683
75;2021-02-28;4;4;8;325086;276298;79;601384
75;2021-02-28;6;3;9;213986;139308;89;353294
75;2021-02-28;3;0;3;77600;28200;90;105800
75;2021-02-28;49;40;89;3113538;2886444;0;5999982
76;2021-02-28;5;4;9;305956;318589;09;624545
76;2021-02-28;15;13;28;338942;356969;19;695911
76;2021-02-28;13;17;30;316210;319570;29;635780
76;2021-02-28;19;9;28;356758;337587;39;694345
76;2021-02-28;12;13;25;376541;363812;49;740353
76;2021-02-28;10;15;25;402608;383750;59;786358
76;2021-02-28;13;11;24;394889;358997;69;753886
76;2021-02-28;8;3;11;308664;263806;79;572470
76;2021-02-28;5;7;12;195838;129272;89;325110
76;2021-02-28;2;2;4;69372;26728;90;96100
76;2021-02-28;102;94;196;3065778;2859080;0;5924858
84;2021-02-28;10;4;14;459549;481088;09;940637
84;2021-02-28;16;13;29;487711;511905;19;999616
84;2021-02-28;19;22;41;443824;451094;29;894918
84;2021-02-28;15;20;35;512522;493262;39;1005784
84;2021-02-28;22;12;34;520248;515106;49;1035354
84;2021-02-28;16;15;31;529611;514848;59;1044459
84;2021-02-28;10;8;18;486720;439940;69;926660
84;2021-02-28;6;14;20;372151;315211;79;687362
84;2021-02-28;11;13;24;237198;150524;89;387722
84;2021-02-28;13;5;18;81185;28680;90;109865
84;2021-02-28;138;126;264;4130719;3901658;0;8032377
93;2021-02-28;4;8;12;268834;283093;09;551927
93;2021-02-28;18;20;38;280751;296087;19;576838
93;2021-02-28;28;18;46;254404;255552;29;509956
93;2021-02-28;22;19;41;310704;288398;39;599102
93;2021-02-28;31;23;54;325559;305827;49;631386
93;2021-02-28;25;36;61;353104;325389;59;678493
93;2021-02-28;24;23;47;336327;296459;69;632786
93;2021-02-28;13;16;29;279820;229699;79;509519
93;2021-02-28;17;13;30;171274;113716;89;284990
93;2021-02-28;8;3;11;58896;21758;90;80654
93;2021-02-28;190;179;369;2639673;2415978;0;5055651
94;2021-02-28;0;0;0;16311;17433;09;33744
94;2021-02-28;0;0;0;16679;18132;19;34811
94;2021-02-28;0;2;2;16782;16579;29;33361
94;2021-02-28;0;2;2;23044;20580;39;43624
94;2021-02-28;0;1;1;23065;22140;49;45205
94;2021-02-28;0;0;0;24549;23421;59;47970
94;2021-02-28;0;0;0;23212;21883;69;45095
94;2021-02-28;1;0;1;19544;17141;79;36685
94;2021-02-28;0;0;0;11227;8178;89;19405
94;2021-02-28;0;0;0;3332;1447;90;4779
94;2021-02-28;1;5;6;177745;166934;0;344679
01;2021-03-01;1;2;3;19979;20155;09;40134
01;2021-03-01;7;5;12;24994;25489;19;50483
01;2021-03-01;12;8;20;17868;16690;29;34558
01;2021-03-01;18;5;23;22328;14821;39;37149
01;2021-03-01;8;7;15;28652;20276;49;48928
01;2021-03-01;19;7;26;33264;27260;59;60524
01;2021-03-01;5;10;15;27135;23978;69;51113
01;2021-03-01;2;1;3;18401;14661;79;33062
01;2021-03-01;0;0;0;9633;6375;89;16008
01;2021-03-01;0;0;0;3410;1510;90;4920
01;2021-03-01;72;46;118;205664;171215;0;376879
02;2021-03-01;0;0;0;16881;17110;09;33991
02;2021-03-01;1;0;1;21410;21604;19;43014
02;2021-03-01;0;1;1;16017;15479;29;31496
02;2021-03-01;6;2;8;19825;14455;39;34280
02;2021-03-01;2;3;5;24719;18248;49;42967
02;2021-03-01;4;2;6;34361;28310;59;62671
02;2021-03-01;0;2;2;28061;24495;69;52556
02;2021-03-01;0;0;0;18231;15278;79;33509
02;2021-03-01;2;1;3;11090;7677;89;18767
02;2021-03-01;1;1;2;3992;1506;90;5498
02;2021-03-01;16;12;28;194587;164162;0;358749
03;2021-03-01;1;1;3;31123;30920;09;62043
03;2021-03-01;4;0;4;29370;29268;19;58638
03;2021-03-01;1;0;1;21458;18963;29;40421
03;2021-03-01;2;1;3;21276;18326;39;39602
03;2021-03-01;3;2;5;18164;16593;49;34757
03;2021-03-01;0;0;0;13469;13557;59;27026
03;2021-03-01;3;2;5;8776;8670;69;17446
03;2021-03-01;0;1;1;3777;3591;79;7368
03;2021-03-01;0;0;0;1649;1072;89;2721
03;2021-03-01;0;0;0;485;184;90;669
03;2021-03-01;14;7;22;149547;141144;0;290691
04;2021-03-01;9;5;14;60314;61377;09;121691
04;2021-03-01;19;26;45;66065;68387;19;134452
04;2021-03-01;27;14;41;51059;47156;29;98215
04;2021-03-01;22;17;39;58788;45780;39;104568
04;2021-03-01;16;9;25;61408;52207;49;113615
04;2021-03-01;12;14;26;64838;60759;59;125597
04;2021-03-01;8;7;15;47008;42843;69;89851
04;2021-03-01;3;5;8;25509;21184;79;46693
04;2021-03-01;1;1;2;13168;7647;89;20815
04;2021-03-01;0;0;0;3209;1253;90;4462
04;2021-03-01;117;98;215;451366;408593;0;859959
05;2021-03-01;0;0;0;362.366008612902;341.338819562748;09;703.704828175651
05;2021-03-01;0;0;0;353.376145114279;370.349735405642;19;723.725880519921
05;2021-03-01;0;0;0;218.593559489256;256.539602589476;29;475.133162078732
05;2021-03-01;0;0;0;404.225408693299;360.321910454353;39;764.547319147651
05;2021-03-01;0;0;0;520.067953604221;497.108383964256;49;1017.17633756848
05;2021-03-01;0;0;0;468.146063921917;510.087601910415;59;978.233665832332
05;2021-03-01;0;0;0;340.368470050554;334.366842191253;69;674.735312241807
05;2021-03-01;0;0;0;212.598666888387;192.597753227106;79;405.196420115493
05;2021-03-01;0;0;0;148.727797095705;61.8681715431829;89;210.595968638888
05;2021-03-01;0;0;0;32.9601271090696;10.9909785719784;90;43.9511056810479
05;2021-03-01;0;0;0;3061.43020057959;2935.56979942041;0;5997
06;2021-03-01;0;1;1;42583;42380;09;84963
06;2021-03-01;12;8;21;33369;31925;19;65294
06;2021-03-01;15;17;32;21571;15080;29;36651
06;2021-03-01;16;26;42;21550;16147;39;37697
06;2021-03-01;18;19;37;14193;13939;49;28132
06;2021-03-01;8;8;16;7171;7597;59;14768
06;2021-03-01;16;24;40;3629;4117;69;7746
06;2021-03-01;3;3;6;1577;1457;79;3034
06;2021-03-01;1;5;6;531;474;89;1005
06;2021-03-01;0;0;0;88;93;90;181
06;2021-03-01;89;111;201;146262;133209;0;279471
07;2021-03-01;0;0;0;485;549;09;1034
07;2021-03-01;0;1;1;403;432;19;835
07;2021-03-01;2;2;4;764;841;29;1605
07;2021-03-01;2;1;3;824;928;39;1752
07;2021-03-01;1;0;1;788;1020;49;1808
07;2021-03-01;1;1;2;678;870;59;1548
07;2021-03-01;0;1;1;360;382;69;742
07;2021-03-01;0;1;1;231;190;79;421
07;2021-03-01;0;0;0;114;67;89;181
07;2021-03-01;0;0;0;24;11;90;35
07;2021-03-01;6;7;13;4671;5290;0;9961
08;2021-03-01;0;0;0;2715.22592983026;2997.75551488675;09;5712.98144471701
08;2021-03-01;0;0;0;2778.51901080978;3160.9156459093;19;5939.43465671908
08;2021-03-01;0;3;3;2080.8882988764;1718.16634315323;29;3799.05464202964
08;2021-03-01;0;0;0;2701.8582062647;1896.52641413317;39;4598.38462039786
08;2021-03-01;0;0;0;3151.45861023308;2460.52498233809;49;5611.98359257117
08;2021-03-01;2;2;4;2620.29868333099;2422.23566154656;59;5042.53434487755
08;2021-03-01;0;1;1;1621.44173420671;1438.58325779464;69;3060.02499200135
08;2021-03-01;0;0;0;626.575909335673;526.358467843651;79;1152.93437717932
08;2021-03-01;0;0;0;205.018522985054;140.993639349697;89;346.012162334751
08;2021-03-01;0;0;0;50.0325684687745;20.62259870351;90;70.6551671722846
08;2021-03-01;2;6;8;18551.3174743414;16782.6825256586;0;35334
11;2021-03-01;175;198;394;783071;811785;09;1594856
11;2021-03-01;560;572;1171;761456;784653;19;1546109
11;2021-03-01;852;783;1641;850145;801772;29;1651917
11;2021-03-01;890;804;1702;914360;843488;39;1757848
11;2021-03-01;794;691;1499;845609;826202;49;1671811
11;2021-03-01;676;599;1281;793566;745070;59;1538636
11;2021-03-01;429;403;839;628649;549192;69;1177841
11;2021-03-01;187;192;379;434606;358356;79;792962
11;2021-03-01;126;90;216;261425;162933;89;424358
11;2021-03-01;40;20;60;89253;32619;90;121872
11;2021-03-01;4730;4355;9187;6362140;5916070;0;12278210
24;2021-03-01;15;12;27;139720;144686;09;284406
24;2021-03-01;54;57;111;152979;161185;19;314164
24;2021-03-01;64;39;104;122237;126536;29;248773
24;2021-03-01;63;63;126;150359;142009;39;292368
24;2021-03-01;84;66;151;161829;158758;49;320587
24;2021-03-01;68;73;141;172552;168011;59;340563
24;2021-03-01;44;46;90;172509;158177;69;330686
24;2021-03-01;30;26;56;129428;110593;79;240021
24;2021-03-01;29;24;53;87342;56882;89;144224
24;2021-03-01;17;6;23;31210;12071;90;43281
24;2021-03-01;468;412;882;1320165;1238908;0;2559073
27;2021-03-01;14;13;27;143373;149679;09;293052
27;2021-03-01;55;64;121;160962;173003;19;333965
27;2021-03-01;66;71;137;133746;142254;29;276000
27;2021-03-01;73;74;147;160004;155407;39;315411
27;2021-03-01;60;54;115;172333;169564;49;341897
27;2021-03-01;86;87;173;189979;183788;59;373767
27;2021-03-01;51;48;99;192591;178206;69;370797
27;2021-03-01;39;34;73;146876;127546;79;274422
27;2021-03-01;20;15;35;96896;61575;89;158471
27;2021-03-01;10;6;16;33148;12109;90;45257
27;2021-03-01;474;466;943;1429908;1353131;0;2783039
28;2021-03-01;21;29;52;180735;186856;09;367591
28;2021-03-01;102;81;185;200125;213621;19;413746
28;2021-03-01;90;83;173;168922;173007;29;341929
28;2021-03-01;82;79;161;196628;188487;39;385115
28;2021-03-01;120;88;208;205396;201699;49;407095
28;2021-03-01;97;101;198;222002;213866;59;435868
28;2021-03-01;80;66;146;224688;203758;69;428446
28;2021-03-01;54;46;100;163192;135543;79;298735
28;2021-03-01;30;26;56;109691;65377;89;175068
28;2021-03-01;14;11;25;37222;12685;90;49907
28;2021-03-01;690;610;1304;1708601;1594899;0;3303500
32;2021-03-01;90;94;184;358062;373689;09;731751
32;2021-03-01;298;289;587;387045;406742;19;793787
32;2021-03-01;325;269;594;342304;348587;29;690891
32;2021-03-01;361;273;634;382485;369972;39;752457
32;2021-03-01;368;269;637;382510;376716;49;759226
32;2021-03-01;290;284;574;386937;376527;59;763464
32;2021-03-01;243;204;447;371211;330938;69;702149
32;2021-03-01;150;120;270;250542;201459;79;452001
32;2021-03-01;100;56;156;163399;89786;89;253185
32;2021-03-01;38;15;53;48384;15367;90;63751
32;2021-03-01;2264;1874;4138;3072879;2889783;0;5962662
44;2021-03-01;40;47;89;291525;306839;09;598364
44;2021-03-01;148;156;306;320255;339504;19;659759
44;2021-03-01;177;161;339;302020;314428;29;616448
44;2021-03-01;190;162;353;342222;333292;39;675514
44;2021-03-01;178;179;360;349727;344491;49;694218
44;2021-03-01;166;153;319;381371;373239;59;754610
44;2021-03-01;124;112;238;367165;335850;69;703015
44;2021-03-01;58;72;132;250387;215436;79;465823
44;2021-03-01;43;20;63;170825;105192;89;276017
44;2021-03-01;17;7;24;51248;16731;90;67979
44;2021-03-01;1141;1070;2224;2826745;2685002;0;5511747
52;2021-03-01;31;24;56;213594;223900;09;437494
52;2021-03-01;94;84;180;240818;255197;19;496015
52;2021-03-01;90;84;174;197010;200630;29;397640
52;2021-03-01;86;76;162;231204;224885;39;456089
52;2021-03-01;97;74;171;243874;243418;49;487292
52;2021-03-01;71;72;143;244100;239116;59;483216
52;2021-03-01;73;66;139;241796;221345;69;463141
52;2021-03-01;37;36;73;177805;149903;79;327708
52;2021-03-01;23;15;38;119561;75822;89;195383
52;2021-03-01;6;5;11;42559;15260;90;57819
52;2021-03-01;608;536;1147;1952321;1849476;0;3801797
53;2021-03-01;12;15;27;173813;182358;09;356171
53;2021-03-01;57;55;114;202720;214740;19;417460
53;2021-03-01;52;81;136;163116;173196;29;336312
53;2021-03-01;60;49;109;190526;187674;39;378200
53;2021-03-01;68;63;131;212098;212015;49;424113
53;2021-03-01;59;54;113;223699;219176;59;442875
53;2021-03-01;26;34;60;227435;209274;69;436709
53;2021-03-01;31;22;53;169992;140910;79;310902
53;2021-03-01;15;7;22;118117;69883;89;188000
53;2021-03-01;11;5;16;37370;12267;90;49637
53;2021-03-01;391;385;781;1718886;1621493;0;3340379
75;2021-03-01;42;39;81;293104;305291;09;598395
75;2021-03-01;84;107;191;337141;357785;19;694926
75;2021-03-01;93;99;192;295024;300618;29;595642
75;2021-03-01;104;104;208;347871;331233;39;679104
75;2021-03-01;104;99;203;384742;372771;49;757513
75;2021-03-01;80;96;176;413361;390880;59;804241
75;2021-03-01;76;71;147;425623;384060;69;809683
75;2021-03-01;44;49;93;325086;276298;79;601384
75;2021-03-01;31;17;48;213986;139308;89;353294
75;2021-03-01;16;8;24;77600;28200;90;105800
75;2021-03-01;674;689;1363;3113538;2886444;0;5999982
76;2021-03-01;50;35;92;305956;318589;09;624545
76;2021-03-01;154;154;309;338942;356969;19;695911
76;2021-03-01;178;154;332;316210;319570;29;635780
76;2021-03-01;199;121;320;356758;337587;39;694345
76;2021-03-01;166;148;314;376541;363812;49;740353
76;2021-03-01;167;146;313;402608;383750;59;786358
76;2021-03-01;89;95;184;394889;358997;69;753886
76;2021-03-01;65;56;121;308664;263806;79;572470
76;2021-03-01;52;28;80;195838;129272;89;325110
76;2021-03-01;25;8;33;69372;26728;90;96100
76;2021-03-01;1146;946;2100;3065778;2859080;0;5924858
84;2021-03-01;87;61;148;459549;481088;09;940637
84;2021-03-01;183;190;374;487711;511905;19;999616
84;2021-03-01;277;222;500;443824;451094;29;894918
84;2021-03-01;263;211;474;512522;493262;39;1005784
84;2021-03-01;232;235;467;520248;515106;49;1035354
84;2021-03-01;239;211;450;529611;514848;59;1044459
84;2021-03-01;171;158;329;486720;439940;69;926660
84;2021-03-01;110;102;212;372151;315211;79;687362
84;2021-03-01;65;42;107;237198;150524;89;387722
84;2021-03-01;26;12;38;81185;28680;90;109865
84;2021-03-01;1653;1444;3099;4130719;3901658;0;8032377
93;2021-03-01;78;69;147;268834;283093;09;551927
93;2021-03-01;251;256;510;280751;296087;19;576838
93;2021-03-01;323;251;575;254404;255552;29;509956
93;2021-03-01;324;264;589;310704;288398;39;599102
93;2021-03-01;342;305;650;325559;305827;49;631386
93;2021-03-01;308;270;578;353104;325389;59;678493
93;2021-03-01;224;236;460;336327;296459;69;632786
93;2021-03-01;129;133;262;279820;229699;79;509519
93;2021-03-01;88;62;150;171274;113716;89;284990
93;2021-03-01;37;14;51;58896;21758;90;80654
93;2021-03-01;2104;1860;3972;2639673;2415978;0;5055651
94;2021-03-01;0;1;1;16311;17433;09;33744
94;2021-03-01;8;3;11;16679;18132;19;34811
94;2021-03-01;6;12;18;16782;16579;29;33361
94;2021-03-01;6;14;20;23044;20580;39;43624
94;2021-03-01;3;5;8;23065;22140;49;45205
94;2021-03-01;10;7;17;24549;23421;59;47970
94;2021-03-01;5;10;15;23212;21883;69;45095
94;2021-03-01;2;3;5;19544;17141;79;36685
94;2021-03-01;3;3;6;11227;8178;89;19405
94;2021-03-01;3;0;3;3332;1447;90;4779
94;2021-03-01;46;58;104;177745;166934;0;344679
01;2021-03-02;0;1;1;19979;20155;09;40134
01;2021-03-02;5;9;14;24994;25489;19;50483
01;2021-03-02;8;6;14;17868;16690;29;34558
01;2021-03-02;8;4;12;22328;14821;39;37149
01;2021-03-02;7;7;14;28652;20276;49;48928
01;2021-03-02;8;6;14;33264;27260;59;60524
01;2021-03-02;10;6;16;27135;23978;69;51113
01;2021-03-02;3;3;6;18401;14661;79;33062
01;2021-03-02;0;1;1;9633;6375;89;16008
01;2021-03-02;0;0;0;3410;1510;90;4920
01;2021-03-02;49;43;92;205664;171215;0;376879
02;2021-03-02;2;0;2;16881;17110;09;33991
02;2021-03-02;0;0;1;21410;21604;19;43014
02;2021-03-02;3;2;5;16017;15479;29;31496
02;2021-03-02;1;1;2;19825;14455;39;34280
02;2021-03-02;0;0;0;24719;18248;49;42967
02;2021-03-02;0;1;1;34361;28310;59;62671
02;2021-03-02;2;1;3;28061;24495;69;52556
02;2021-03-02;0;1;1;18231;15278;79;33509
02;2021-03-02;1;0;1;11090;7677;89;18767
02;2021-03-02;0;0;0;3992;1506;90;5498
02;2021-03-02;9;6;16;194587;164162;0;358749
03;2021-03-02;0;0;0;31123;30920;09;62043
03;2021-03-02;1;0;1;29370;29268;19;58638
03;2021-03-02;1;2;3;21458;18963;29;40421
03;2021-03-02;1;1;2;21276;18326;39;39602
03;2021-03-02;1;0;1;18164;16593;49;34757
03;2021-03-02;1;1;2;13469;13557;59;27026
03;2021-03-02;0;0;0;8776;8670;69;17446
03;2021-03-02;0;0;0;3777;3591;79;7368
03;2021-03-02;0;0;0;1649;1072;89;2721
03;2021-03-02;0;0;0;485;184;90;669
03;2021-03-02;5;4;9;149547;141144;0;290691
04;2021-03-02;6;3;9;60314;61377;09;121691
04;2021-03-02;12;20;32;66065;68387;19;134452
04;2021-03-02;27;15;42;51059;47156;29;98215
04;2021-03-02;14;7;21;58788;45780;39;104568
04;2021-03-02;19;8;27;61408;52207;49;113615
04;2021-03-02;15;13;28;64838;60759;59;125597
04;2021-03-02;7;6;13;47008;42843;69;89851
04;2021-03-02;2;5;7;25509;21184;79;46693
04;2021-03-02;0;2;2;13168;7647;89;20815
04;2021-03-02;0;0;0;3209;1253;90;4462
04;2021-03-02;102;79;181;451366;408593;0;859959
05;2021-03-02;0;0;0;362.366008612902;341.338819562748;09;703.704828175651
05;2021-03-02;0;0;0;353.376145114279;370.349735405642;19;723.725880519921
05;2021-03-02;0;0;0;218.593559489256;256.539602589476;29;475.133162078732
05;2021-03-02;0;0;0;404.225408693299;360.321910454353;39;764.547319147651
05;2021-03-02;0;0;0;520.067953604221;497.108383964256;49;1017.17633756848
05;2021-03-02;0;0;0;468.146063921917;510.087601910415;59;978.233665832332
05;2021-03-02;0;0;0;340.368470050554;334.366842191253;69;674.735312241807
05;2021-03-02;0;0;0;212.598666888387;192.597753227106;79;405.196420115493
05;2021-03-02;0;0;0;148.727797095705;61.8681715431829;89;210.595968638888
05;2021-03-02;0;0;0;32.9601271090696;10.9909785719784;90;43.9511056810479
05;2021-03-02;0;0;0;3061.43020057959;2935.56979942041;0;5997
06;2021-03-02;2;1;3;42583;42380;09;84963
06;2021-03-02;5;5;10;33369;31925;19;65294
06;2021-03-02;12;10;22;21571;15080;29;36651
06;2021-03-02;9;9;18;21550;16147;39;37697
06;2021-03-02;6;11;17;14193;13939;49;28132
06;2021-03-02;9;8;17;7171;7597;59;14768
06;2021-03-02;1;2;3;3629;4117;69;7746
06;2021-03-02;4;1;5;1577;1457;79;3034
06;2021-03-02;0;1;1;531;474;89;1005
06;2021-03-02;0;0;0;88;93;90;181
06;2021-03-02;48;48;96;146262;133209;0;279471
07;2021-03-02;0;0;0;485;549;09;1034
07;2021-03-02;0;0;0;403;432;19;835
07;2021-03-02;1;1;2;764;841;29;1605
07;2021-03-02;4;0;4;824;928;39;1752
07;2021-03-02;0;2;2;788;1020;49;1808
07;2021-03-02;1;0;1;678;870;59;1548
07;2021-03-02;0;1;1;360;382;69;742
07;2021-03-02;0;0;0;231;190;79;421
07;2021-03-02;1;0;1;114;67;89;181
07;2021-03-02;0;0;0;24;11;90;35
07;2021-03-02;7;4;11;4671;5290;0;9961
08;2021-03-02;0;0;0;2715.22592983026;2997.75551488675;09;5712.98144471701
08;2021-03-02;0;0;0;2778.51901080978;3160.9156459093;19;5939.43465671908
08;2021-03-02;0;0;0;2080.8882988764;1718.16634315323;29;3799.05464202964
08;2021-03-02;0;1;1;2701.8582062647;1896.52641413317;39;4598.38462039786
08;2021-03-02;0;0;0;3151.45861023308;2460.52498233809;49;5611.98359257117
08;2021-03-02;1;0;1;2620.29868333099;2422.23566154656;59;5042.53434487755
08;2021-03-02;0;0;0;1621.44173420671;1438.58325779464;69;3060.02499200135
08;2021-03-02;0;0;0;626.575909335673;526.358467843651;79;1152.93437717932
08;2021-03-02;0;0;0;205.018522985054;140.993639349697;89;346.012162334751
08;2021-03-02;0;0;0;50.0325684687745;20.62259870351;90;70.6551671722846
08;2021-03-02;1;1;2;18551.3174743414;16782.6825256586;0;35334
11;2021-03-02;128;145;302;783071;811785;09;1594856
11;2021-03-02;472;442;953;761456;784653;19;1546109
11;2021-03-02;751;616;1373;850145;801772;29;1651917
11;2021-03-02;706;626;1336;914360;843488;39;1757848
11;2021-03-02;613;529;1155;845609;826202;49;1671811
11;2021-03-02;471;509;991;793566;745070;59;1538636
11;2021-03-02;303;299;613;628649;549192;69;1177841
11;2021-03-02;188;158;349;434606;358356;79;792962
11;2021-03-02;111;65;176;261425;162933;89;424358
11;2021-03-02;73;23;96;89253;32619;90;121872
11;2021-03-02;3816;3413;7345;6362140;5916070;0;12278210
24;2021-03-02;11;13;25;139720;144686;09;284406
24;2021-03-02;43;37;82;152979;161185;19;314164
24;2021-03-02;57;54;111;122237;126536;29;248773
24;2021-03-02;61;42;103;150359;142009;39;292368
24;2021-03-02;40;50;90;161829;158758;49;320587
24;2021-03-02;50;51;101;172552;168011;59;340563
24;2021-03-02;38;38;76;172509;158177;69;330686
24;2021-03-02;28;30;58;129428;110593;79;240021
24;2021-03-02;13;10;23;87342;56882;89;144224
24;2021-03-02;11;4;15;31210;12071;90;43281
24;2021-03-02;352;329;684;1320165;1238908;0;2559073
27;2021-03-02;13;10;23;143373;149679;09;293052
27;2021-03-02;45;44;89;160962;173003;19;333965
27;2021-03-02;62;40;102;133746;142254;29;276000
27;2021-03-02;32;48;80;160004;155407;39;315411
27;2021-03-02;61;51;112;172333;169564;49;341897
27;2021-03-02;45;45;90;189979;183788;59;373767
27;2021-03-02;52;37;89;192591;178206;69;370797
27;2021-03-02;34;31;65;146876;127546;79;274422
27;2021-03-02;16;10;26;96896;61575;89;158471
27;2021-03-02;10;0;10;33148;12109;90;45257
27;2021-03-02;370;316;686;1429908;1353131;0;2783039
28;2021-03-02;16;22;39;180735;186856;09;367591
28;2021-03-02;87;67;154;200125;213621;19;413746
28;2021-03-02;78;79;157;168922;173007;29;341929
28;2021-03-02;81;61;142;196628;188487;39;385115
28;2021-03-02;96;68;164;205396;201699;49;407095
28;2021-03-02;76;85;161;222002;213866;59;435868
28;2021-03-02;59;59;118;224688;203758;69;428446
28;2021-03-02;32;37;69;163192;135543;79;298735
28;2021-03-02;25;22;47;109691;65377;89;175068
28;2021-03-02;12;4;16;37222;12685;90;49907
28;2021-03-02;562;504;1067;1708601;1594899;0;3303500
32;2021-03-02;78;93;171;358062;373689;09;731751
32;2021-03-02;221;228;450;387045;406742;19;793787
32;2021-03-02;280;226;506;342304;348587;29;690891
32;2021-03-02;277;226;503;382485;369972;39;752457
32;2021-03-02;261;233;494;382510;376716;49;759226
32;2021-03-02;207;192;399;386937;376527;59;763464
32;2021-03-02;171;157;328;371211;330938;69;702149
32;2021-03-02;114;108;222;250542;201459;79;452001
32;2021-03-02;76;41;117;163399;89786;89;253185
32;2021-03-02;37;10;47;48384;15367;90;63751
32;2021-03-02;1722;1515;3238;3072879;2889783;0;5962662
44;2021-03-02;34;41;77;291525;306839;09;598364
44;2021-03-02;88;102;194;320255;339504;19;659759
44;2021-03-02;147;135;288;302020;314428;29;616448
44;2021-03-02;132;136;269;342222;333292;39;675514
44;2021-03-02;149;96;246;349727;344491;49;694218
44;2021-03-02;108;120;230;381371;373239;59;754610
44;2021-03-02;97;86;184;367165;335850;69;703015
44;2021-03-02;55;56;111;250387;215436;79;465823
44;2021-03-02;34;31;65;170825;105192;89;276017
44;2021-03-02;22;10;32;51248;16731;90;67979
44;2021-03-02;866;813;1696;2826745;2685002;0;5511747
52;2021-03-02;22;15;37;213594;223900;09;437494
52;2021-03-02;58;94;153;240818;255197;19;496015
52;2021-03-02;66;72;138;197010;200630;29;397640
52;2021-03-02;73;76;150;231204;224885;39;456089
52;2021-03-02;74;56;130;243874;243418;49;487292
52;2021-03-02;57;56;113;244100;239116;59;483216
52;2021-03-02;35;38;73;241796;221345;69;463141
52;2021-03-02;33;27;60;177805;149903;79;327708
52;2021-03-02;22;19;41;119561;75822;89;195383
52;2021-03-02;17;5;22;42559;15260;90;57819
52;2021-03-02;457;458;923;1952321;1849476;0;3801797
53;2021-03-02;19;11;31;173813;182358;09;356171
53;2021-03-02;60;59;120;202720;214740;19;417460
53;2021-03-02;58;57;115;163116;173196;29;336312
53;2021-03-02;51;34;86;190526;187674;39;378200
53;2021-03-02;49;40;89;212098;212015;49;424113
53;2021-03-02;41;38;79;223699;219176;59;442875
53;2021-03-02;20;14;34;227435;209274;69;436709
53;2021-03-02;16;15;31;169992;140910;79;310902
53;2021-03-02;11;8;19;118117;69883;89;188000
53;2021-03-02;4;3;7;37370;12267;90;49637
53;2021-03-02;329;279;611;1718886;1621493;0;3340379
75;2021-03-02;26;22;48;293104;305291;09;598395
75;2021-03-02;61;74;136;337141;357785;19;694926
75;2021-03-02;78;76;154;295024;300618;29;595642
75;2021-03-02;81;82;163;347871;331233;39;679104
75;2021-03-02;88;52;140;384742;372771;49;757513
75;2021-03-02;88;78;166;413361;390880;59;804241
75;2021-03-02;56;46;102;425623;384060;69;809683
75;2021-03-02;40;40;80;325086;276298;79;601384
75;2021-03-02;29;19;48;213986;139308;89;353294
75;2021-03-02;28;10;38;77600;28200;90;105800
75;2021-03-02;575;499;1075;3113538;2886444;0;5999982
76;2021-03-02;28;35;65;305956;318589;09;624545
76;2021-03-02;125;115;244;338942;356969;19;695911
76;2021-03-02;136;106;242;316210;319570;29;635780
76;2021-03-02;109;110;220;356758;337587;39;694345
76;2021-03-02;130;72;202;376541;363812;49;740353
76;2021-03-02;107;94;201;402608;383750;59;786358
76;2021-03-02;82;63;145;394889;358997;69;753886
76;2021-03-02;42;41;83;308664;263806;79;572470
76;2021-03-02;44;30;74;195838;129272;89;325110
76;2021-03-02;17;6;23;69372;26728;90;96100
76;2021-03-02;822;673;1502;3065778;2859080;0;5924858
84;2021-03-02;68;61;129;459549;481088;09;940637
84;2021-03-02;142;172;314;487711;511905;19;999616
84;2021-03-02;188;196;384;443824;451094;29;894918
84;2021-03-02;206;186;392;512522;493262;39;1005784
84;2021-03-02;187;171;359;520248;515106;49;1035354
84;2021-03-02;176;156;333;529611;514848;59;1044459
84;2021-03-02;128;104;232;486720;439940;69;926660
84;2021-03-02;74;85;159;372151;315211;79;687362
84;2021-03-02;62;42;104;237198;150524;89;387722
84;2021-03-02;36;12;48;81185;28680;90;109865
84;2021-03-02;1267;1185;2454;4130719;3901658;0;8032377
93;2021-03-02;38;49;87;268834;283093;09;551927
93;2021-03-02;180;151;331;280751;296087;19;576838
93;2021-03-02;243;180;423;254404;255552;29;509956
93;2021-03-02;221;194;415;310704;288398;39;599102
93;2021-03-02;261;207;468;325559;305827;49;631386
93;2021-03-02;219;206;425;353104;325389;59;678493
93;2021-03-02;169;160;329;336327;296459;69;632786
93;2021-03-02;113;85;198;279820;229699;79;509519
93;2021-03-02;64;48;112;171274;113716;89;284990
93;2021-03-02;33;17;50;58896;21758;90;80654
93;2021-03-02;1542;1297;2839;2639673;2415978;0;5055651
94;2021-03-02;1;3;4;16311;17433;09;33744
94;2021-03-02;5;6;11;16679;18132;19;34811
94;2021-03-02;6;11;17;16782;16579;29;33361
94;2021-03-02;9;7;16;23044;20580;39;43624
94;2021-03-02;8;4;12;23065;22140;49;45205
94;2021-03-02;6;7;13;24549;23421;59;47970
94;2021-03-02;12;9;21;23212;21883;69;45095
94;2021-03-02;2;1;3;19544;17141;79;36685
94;2021-03-02;3;3;6;11227;8178;89;19405
94;2021-03-02;0;0;0;3332;1447;90;4779
94;2021-03-02;52;51;103;177745;166934;0;344679
01;2021-03-03;1;0;1;19979;20155;09;40134
01;2021-03-03;6;4;10;24994;25489;19;50483
01;2021-03-03;2;6;8;17868;16690;29;34558
01;2021-03-03;8;3;11;22328;14821;39;37149
01;2021-03-03;8;9;17;28652;20276;49;48928
01;2021-03-03;1;8;9;33264;27260;59;60524
01;2021-03-03;1;2;3;27135;23978;69;51113
01;2021-03-03;0;0;0;18401;14661;79;33062
01;2021-03-03;0;0;0;9633;6375;89;16008
01;2021-03-03;0;0;0;3410;1510;90;4920
01;2021-03-03;27;32;59;205664;171215;0;376879
02;2021-03-03;0;0;0;16881;17110;09;33991
02;2021-03-03;0;0;0;21410;21604;19;43014
02;2021-03-03;1;3;4;16017;15479;29;31496
02;2021-03-03;3;0;3;19825;14455;39;34280
02;2021-03-03;2;1;3;24719;18248;49;42967
02;2021-03-03;6;1;7;34361;28310;59;62671
02;2021-03-03;2;5;7;28061;24495;69;52556
02;2021-03-03;1;2;3;18231;15278;79;33509
02;2021-03-03;0;0;0;11090;7677;89;18767
02;2021-03-03;0;0;0;3992;1506;90;5498
02;2021-03-03;15;12;27;194587;164162;0;358749
03;2021-03-03;0;0;0;31123;30920;09;62043
03;2021-03-03;0;0;0;29370;29268;19;58638
03;2021-03-03;1;0;1;21458;18963;29;40421
03;2021-03-03;1;0;1;21276;18326;39;39602
03;2021-03-03;0;1;1;18164;16593;49;34757
03;2021-03-03;2;0;2;13469;13557;59;27026
03;2021-03-03;1;1;3;8776;8670;69;17446
03;2021-03-03;0;0;0;3777;3591;79;7368
03;2021-03-03;0;0;0;1649;1072;89;2721
03;2021-03-03;0;0;0;485;184;90;669
03;2021-03-03;5;2;8;149547;141144;0;290691
04;2021-03-03;3;10;13;60314;61377;09;121691
04;2021-03-03;11;14;25;66065;68387;19;134452
04;2021-03-03;22;13;35;51059;47156;29;98215
04;2021-03-03;20;14;34;58788;45780;39;104568
04;2021-03-03;15;12;27;61408;52207;49;113615
04;2021-03-03;15;11;26;64838;60759;59;125597
04;2021-03-03;11;11;22;47008;42843;69;89851
04;2021-03-03;2;2;4;25509;21184;79;46693
04;2021-03-03;2;1;3;13168;7647;89;20815
04;2021-03-03;0;1;1;3209;1253;90;4462
04;2021-03-03;101;89;190;451366;408593;0;859959
05;2021-03-03;0;0;0;362.366008612902;341.338819562748;09;703.704828175651
05;2021-03-03;0;0;0;353.376145114279;370.349735405642;19;723.725880519921
05;2021-03-03;0;0;0;218.593559489256;256.539602589476;29;475.133162078732
05;2021-03-03;0;0;0;404.225408693299;360.321910454353;39;764.547319147651
05;2021-03-03;0;0;0;520.067953604221;497.108383964256;49;1017.17633756848
05;2021-03-03;0;0;0;468.146063921917;510.087601910415;59;978.233665832332
05;2021-03-03;0;0;0;340.368470050554;334.366842191253;69;674.735312241807
05;2021-03-03;0;0;0;212.598666888387;192.597753227106;79;405.196420115493
05;2021-03-03;0;0;0;148.727797095705;61.8681715431829;89;210.595968638888
05;2021-03-03;0;0;0;32.9601271090696;10.9909785719784;90;43.9511056810479
05;2021-03-03;0;0;0;3061.43020057959;2935.56979942041;0;5997
06;2021-03-03;2;0;2;42583;42380;09;84963
06;2021-03-03;5;3;11;33369;31925;19;65294
06;2021-03-03;6;8;14;21571;15080;29;36651
06;2021-03-03;22;10;32;21550;16147;39;37697
06;2021-03-03;10;11;21;14193;13939;49;28132
06;2021-03-03;3;4;7;7171;7597;59;14768
06;2021-03-03;13;21;34;3629;4117;69;7746
06;2021-03-03;4;3;7;1577;1457;79;3034
06;2021-03-03;0;0;0;531;474;89;1005
06;2021-03-03;0;0;0;88;93;90;181
06;2021-03-03;65;60;128;146262;133209;0;279471
07;2021-03-03;0;0;0;485;549;09;1034
07;2021-03-03;0;0;0;403;432;19;835
07;2021-03-03;0;0;0;764;841;29;1605
07;2021-03-03;3;1;4;824;928;39;1752
07;2021-03-03;0;2;2;788;1020;49;1808
07;2021-03-03;1;0;1;678;870;59;1548
07;2021-03-03;2;1;3;360;382;69;742
07;2021-03-03;0;0;0;231;190;79;421
07;2021-03-03;0;0;0;114;67;89;181
07;2021-03-03;0;0;0;24;11;90;35
07;2021-03-03;6;4;10;4671;5290;0;9961
08;2021-03-03;0;0;0;2715.22592983026;2997.75551488675;09;5712.98144471701
08;2021-03-03;0;0;0;2778.51901080978;3160.9156459093;19;5939.43465671908
08;2021-03-03;0;0;0;2080.8882988764;1718.16634315323;29;3799.05464202964
08;2021-03-03;0;0;0;2701.8582062647;1896.52641413317;39;4598.38462039786
08;2021-03-03;0;0;0;3151.45861023308;2460.52498233809;49;5611.98359257117
08;2021-03-03;0;1;1;2620.29868333099;2422.23566154656;59;5042.53434487755
08;2021-03-03;0;1;1;1621.44173420671;1438.58325779464;69;3060.02499200135
08;2021-03-03;0;0;0;626.575909335673;526.358467843651;79;1152.93437717932
08;2021-03-03;0;0;0;205.018522985054;140.993639349697;89;346.012162334751
08;2021-03-03;0;0;0;50.0325684687745;20.62259870351;90;70.6551671722846
08;2021-03-03;0;2;2;18551.3174743414;16782.6825256586;0;35334
11;2021-03-03;146;163;328;783071;811785;09;1594856
11;2021-03-03;496;485;1020;761456;784653;19;1546109
11;2021-03-03;723;628;1357;850145;801772;29;1651917
11;2021-03-03;616;663;1284;914360;843488;39;1757848
11;2021-03-03;591;562;1155;845609;826202;49;1671811
11;2021-03-03;484;435;923;793566;745070;59;1538636
11;2021-03-03;308;272;590;628649;549192;69;1177841
11;2021-03-03;167;118;286;434606;358356;79;792962
11;2021-03-03;97;55;153;261425;162933;89;424358
11;2021-03-03;42;19;61;89253;32619;90;121872
11;2021-03-03;3671;3401;7161;6362140;5916070;0;12278210
24;2021-03-03;8;14;22;139720;144686;09;284406
24;2021-03-03;46;48;95;152979;161185;19;314164
24;2021-03-03;59;51;110;122237;126536;29;248773
24;2021-03-03;55;37;92;150359;142009;39;292368
24;2021-03-03;53;40;93;161829;158758;49;320587
24;2021-03-03;42;37;79;172552;168011;59;340563
24;2021-03-03;44;30;74;172509;158177;69;330686
24;2021-03-03;23;19;42;129428;110593;79;240021
24;2021-03-03;9;10;19;87342;56882;89;144224
24;2021-03-03;8;3;11;31210;12071;90;43281
24;2021-03-03;347;289;637;1320165;1238908;0;2559073
27;2021-03-03;12;12;24;143373;149679;09;293052
27;2021-03-03;57;75;132;160962;173003;19;333965
27;2021-03-03;47;57;104;133746;142254;29;276000
27;2021-03-03;47;36;83;160004;155407;39;315411
27;2021-03-03;49;50;99;172333;169564;49;341897
27;2021-03-03;64;44;108;189979;183788;59;373767
27;2021-03-03;34;27;61;192591;178206;69;370797
27;2021-03-03;16;25;41;146876;127546;79;274422
27;2021-03-03;6;20;26;96896;61575;89;158471
27;2021-03-03;6;1;7;33148;12109;90;45257
27;2021-03-03;338;347;685;1429908;1353131;0;2783039
28;2021-03-03;25;27;55;180735;186856;09;367591
28;2021-03-03;66;68;138;200125;213621;19;413746
28;2021-03-03;63;70;133;168922;173007;29;341929
28;2021-03-03;68;61;129;196628;188487;39;385115
28;2021-03-03;74;77;151;205396;201699;49;407095
28;2021-03-03;68;73;141;222002;213866;59;435868
28;2021-03-03;50;52;103;224688;203758;69;428446
28;2021-03-03;50;23;73;163192;135543;79;298735
28;2021-03-03;18;14;32;109691;65377;89;175068
28;2021-03-03;10;4;14;37222;12685;90;49907
28;2021-03-03;492;469;969;1708601;1594899;0;3303500
32;2021-03-03;82;88;170;358062;373689;09;731751
32;2021-03-03;233;196;429;387045;406742;19;793787
32;2021-03-03;266;248;514;342304;348587;29;690891
32;2021-03-03;263;229;492;382485;369972;39;752457
32;2021-03-03;222;210;432;382510;376716;49;759226
32;2021-03-03;207;212;419;386937;376527;59;763464
32;2021-03-03;149;145;294;371211;330938;69;702149
32;2021-03-03;99;78;177;250542;201459;79;452001
32;2021-03-03;51;42;93;163399;89786;89;253185
32;2021-03-03;20;7;27;48384;15367;90;63751
32;2021-03-03;1592;1455;3047;3072879;2889783;0;5962662
44;2021-03-03;40;40;80;291525;306839;09;598364
44;2021-03-03;110;99;210;320255;339504;19;659759
44;2021-03-03;133;135;268;302020;314428;29;616448
44;2021-03-03;138;122;261;342222;333292;39;675514
44;2021-03-03;119;112;231;349727;344491;49;694218
44;2021-03-03;113;118;232;381371;373239;59;754610
44;2021-03-03;62;62;124;367165;335850;69;703015
44;2021-03-03;43;60;103;250387;215436;79;465823
44;2021-03-03;35;22;58;170825;105192;89;276017
44;2021-03-03;19;8;27;51248;16731;90;67979
44;2021-03-03;812;778;1594;2826745;2685002;0;5511747
52;2021-03-03;22;16;38;213594;223900;09;437494
52;2021-03-03;60;64;124;240818;255197;19;496015
52;2021-03-03;90;73;163;197010;200630;29;397640
52;2021-03-03;68;64;132;231204;224885;39;456089
52;2021-03-03;62;49;111;243874;243418;49;487292
52;2021-03-03;64;58;122;244100;239116;59;483216
52;2021-03-03;42;38;80;241796;221345;69;463141
52;2021-03-03;21;27;48;177805;149903;79;327708
52;2021-03-03;33;17;50;119561;75822;89;195383
52;2021-03-03;7;3;10;42559;15260;90;57819
52;2021-03-03;469;409;878;1952321;1849476;0;3801797
53;2021-03-03;6;15;21;173813;182358;09;356171
53;2021-03-03;46;70;120;202720;214740;19;417460
53;2021-03-03;62;75;137;163116;173196;29;336312
53;2021-03-03;47;48;95;190526;187674;39;378200
53;2021-03-03;44;23;67;212098;212015;49;424113
53;2021-03-03;35;36;72;223699;219176;59;442875
53;2021-03-03;28;18;46;227435;209274;69;436709
53;2021-03-03;17;17;34;169992;140910;79;310902
53;2021-03-03;9;9;18;118117;69883;89;188000
53;2021-03-03;3;5;8;37370;12267;90;49637
53;2021-03-03;297;316;618;1718886;1621493;0;3340379
75;2021-03-03;30;28;58;293104;305291;09;598395
75;2021-03-03;81;95;178;337141;357785;19;694926
75;2021-03-03;91;95;186;295024;300618;29;595642
75;2021-03-03;84;65;149;347871;331233;39;679104
75;2021-03-03;79;71;150;384742;372771;49;757513
75;2021-03-03;65;56;121;413361;390880;59;804241
75;2021-03-03;60;64;124;425623;384060;69;809683
75;2021-03-03;24;22;46;325086;276298;79;601384
75;2021-03-03;20;19;39;213986;139308;89;353294
75;2021-03-03;8;5;13;77600;28200;90;105800
75;2021-03-03;542;520;1064;3113538;2886444;0;5999982
76;2021-03-03;42;38;82;305956;318589;09;624545
76;2021-03-03;125;129;258;338942;356969;19;695911
76;2021-03-03;124;111;235;316210;319570;29;635780
76;2021-03-03;130;95;225;356758;337587;39;694345
76;2021-03-03;123;92;215;376541;363812;49;740353
76;2021-03-03;99;87;186;402608;383750;59;786358
76;2021-03-03;79;62;141;394889;358997;69;753886
76;2021-03-03;42;51;93;308664;263806;79;572470
76;2021-03-03;19;26;45;195838;129272;89;325110
76;2021-03-03;17;5;22;69372;26728;90;96100
76;2021-03-03;801;698;1506;3065778;2859080;0;5924858
84;2021-03-03;47;67;115;459549;481088;09;940637
84;2021-03-03;162;171;335;487711;511905;19;999616
84;2021-03-03;195;186;382;443824;451094;29;894918
84;2021-03-03;203;177;380;512522;493262;39;1005784
84;2021-03-03;186;150;336;520248;515106;49;1035354
84;2021-03-03;157;156;313;529611;514848;59;1044459
84;2021-03-03;99;109;208;486720;439940;69;926660
84;2021-03-03;74;75;149;372151;315211;79;687362
84;2021-03-03;41;32;73;237198;150524;89;387722
84;2021-03-03;31;7;38;81185;28680;90;109865
84;2021-03-03;1195;1130;2329;4130719;3901658;0;8032377
93;2021-03-03;50;50;100;268834;283093;09;551927
93;2021-03-03;175;184;361;280751;296087;19;576838
93;2021-03-03;204;178;387;254404;255552;29;509956
93;2021-03-03;220;196;418;310704;288398;39;599102
93;2021-03-03;241;190;431;325559;305827;49;631386
93;2021-03-03;218;191;409;353104;325389;59;678493
93;2021-03-03;122;120;242;336327;296459;69;632786
93;2021-03-03;97;77;175;279820;229699;79;509519
93;2021-03-03;61;36;97;171274;113716;89;284990
93;2021-03-03;20;10;30;58896;21758;90;80654
93;2021-03-03;1408;1233;2651;2639673;2415978;0;5055651
94;2021-03-03;0;0;0;16311;17433;09;33744
94;2021-03-03;3;4;7;16679;18132;19;34811
94;2021-03-03;9;4;13;16782;16579;29;33361
94;2021-03-03;7;3;10;23044;20580;39;43624
94;2021-03-03;5;6;11;23065;22140;49;45205
94;2021-03-03;8;7;15;24549;23421;59;47970
94;2021-03-03;5;1;6;23212;21883;69;45095
94;2021-03-03;6;3;9;19544;17141;79;36685
94;2021-03-03;3;1;4;11227;8178;89;19405
94;2021-03-03;0;0;0;3332;1447;90;4779
94;2021-03-03;46;29;75;177745;166934;0;344679
01;2021-03-04;0;1;1;19979;20155;09;40134
01;2021-03-04;3;9;12;24994;25489;19;50483
01;2021-03-04;4;3;7;17868;16690;29;34558
01;2021-03-04;5;1;6;22328;14821;39;37149
01;2021-03-04;10;9;19;28652;20276;49;48928
01;2021-03-04;5;6;11;33264;27260;59;60524
01;2021-03-04;3;1;4;27135;23978;69;51113
01;2021-03-04;1;1;2;18401;14661;79;33062
01;2021-03-04;0;0;0;9633;6375;89;16008
01;2021-03-04;0;0;0;3410;1510;90;4920
01;2021-03-04;31;31;62;205664;171215;0;376879
02;2021-03-04;0;0;0;16881;17110;09;33991
02;2021-03-04;0;0;0;21410;21604;19;43014
02;2021-03-04;0;0;0;16017;15479;29;31496
02;2021-03-04;3;2;5;19825;14455;39;34280
02;2021-03-04;2;2;4;24719;18248;49;42967
02;2021-03-04;4;0;4;34361;28310;59;62671
02;2021-03-04;1;2;3;28061;24495;69;52556
02;2021-03-04;0;0;0;18231;15278;79;33509
02;2021-03-04;0;0;0;11090;7677;89;18767
02;2021-03-04;0;0;0;3992;1506;90;5498
02;2021-03-04;10;6;16;194587;164162;0;358749
03;2021-03-04;0;0;0;31123;30920;09;62043
03;2021-03-04;0;0;0;29370;29268;19;58638
03;2021-03-04;1;0;1;21458;18963;29;40421
03;2021-03-04;1;0;1;21276;18326;39;39602
03;2021-03-04;1;2;3;18164;16593;49;34757
03;2021-03-04;0;0;0;13469;13557;59;27026
03;2021-03-04;1;0;1;8776;8670;69;17446
03;2021-03-04;0;0;0;3777;3591;79;7368
03;2021-03-04;0;0;0;1649;1072;89;2721
03;2021-03-04;0;0;0;485;184;90;669
03;2021-03-04;4;2;6;149547;141144;0;290691
04;2021-03-04;4;5;9;60314;61377;09;121691
04;2021-03-04;13;15;28;66065;68387;19;134452
04;2021-03-04;25;18;43;51059;47156;29;98215
04;2021-03-04;14;16;30;58788;45780;39;104568
04;2021-03-04;13;8;21;61408;52207;49;113615
04;2021-03-04;15;6;21;64838;60759;59;125597
04;2021-03-04;9;4;13;47008;42843;69;89851
04;2021-03-04;1;4;5;25509;21184;79;46693
04;2021-03-04;0;1;1;13168;7647;89;20815
04;2021-03-04;0;0;0;3209;1253;90;4462
04;2021-03-04;94;77;171;451366;408593;0;859959
05;2021-03-04;0;0;0;362.366008612902;341.338819562748;09;703.704828175651
05;2021-03-04;0;0;0;353.376145114279;370.349735405642;19;723.725880519921
05;2021-03-04;0;0;0;218.593559489256;256.539602589476;29;475.133162078732
05;2021-03-04;0;0;0;404.225408693299;360.321910454353;39;764.547319147651
05;2021-03-04;0;0;0;520.067953604221;497.108383964256;49;1017.17633756848
05;2021-03-04;0;0;0;468.146063921917;510.087601910415;59;978.233665832332
05;2021-03-04;0;0;0;340.368470050554;334.366842191253;69;674.735312241807
05;2021-03-04;0;0;0;212.598666888387;192.597753227106;79;405.196420115493
05;2021-03-04;0;0;0;148.727797095705;61.8681715431829;89;210.595968638888
05;2021-03-04;0;0;0;32.9601271090696;10.9909785719784;90;43.9511056810479
05;2021-03-04;0;0;0;3061.43020057959;2935.56979942041;0;5997
06;2021-03-04;0;0;0;42583;42380;09;84963
06;2021-03-04;1;4;6;33369;31925;19;65294
06;2021-03-04;12;10;22;21571;15080;29;36651
06;2021-03-04;5;10;15;21550;16147;39;37697
06;2021-03-04;9;7;16;14193;13939;49;28132
06;2021-03-04;5;2;7;7171;7597;59;14768
06;2021-03-04;2;2;4;3629;4117;69;7746
06;2021-03-04;2;1;3;1577;1457;79;3034
06;2021-03-04;0;2;2;531;474;89;1005
06;2021-03-04;0;0;0;88;93;90;181
06;2021-03-04;36;38;75;146262;133209;0;279471
07;2021-03-04;0;0;0;485;549;09;1034
07;2021-03-04;1;0;1;403;432;19;835
07;2021-03-04;0;0;0;764;841;29;1605
07;2021-03-04;1;2;3;824;928;39;1752
07;2021-03-04;0;1;1;788;1020;49;1808
07;2021-03-04;3;2;5;678;870;59;1548
07;2021-03-04;0;0;0;360;382;69;742
07;2021-03-04;0;0;0;231;190;79;421
07;2021-03-04;0;0;0;114;67;89;181
07;2021-03-04;0;0;0;24;11;90;35
07;2021-03-04;5;5;10;4671;5290;0;9961
08;2021-03-04;0;0;0;2715.22592983026;2997.75551488675;09;5712.98144471701
08;2021-03-04;0;0;0;2778.51901080978;3160.9156459093;19;5939.43465671908
08;2021-03-04;0;0;0;2080.8882988764;1718.16634315323;29;3799.05464202964
08;2021-03-04;0;0;0;2701.8582062647;1896.52641413317;39;4598.38462039786
08;2021-03-04;1;0;1;3151.45861023308;2460.52498233809;49;5611.98359257117
08;2021-03-04;0;0;0;2620.29868333099;2422.23566154656;59;5042.53434487755
08;2021-03-04;0;1;1;1621.44173420671;1438.58325779464;69;3060.02499200135
08;2021-03-04;0;1;1;626.575909335673;526.358467843651;79;1152.93437717932
08;2021-03-04;0;0;0;205.018522985054;140.993639349697;89;346.012162334751
08;2021-03-04;0;0;0;50.0325684687745;20.62259870351;90;70.6551671722846
08;2021-03-04;1;2;3;18551.3174743414;16782.6825256586;0;35334
11;2021-03-04;139;147;304;783071;811785;09;1594856
11;2021-03-04;469;447;944;761456;784653;19;1546109
11;2021-03-04;735;644;1385;850145;801772;29;1651917
11;2021-03-04;680;586;1272;914360;843488;39;1757848
11;2021-03-04;595;501;1104;845609;826202;49;1671811
11;2021-03-04;431;436;873;793566;745070;59;1538636
11;2021-03-04;319;280;608;628649;549192;69;1177841
11;2021-03-04;155;131;287;434606;358356;79;792962
11;2021-03-04;95;57;152;261425;162933;89;424358
11;2021-03-04;38;20;58;89253;32619;90;121872
11;2021-03-04;3657;3252;6991;6362140;5916070;0;12278210
24;2021-03-04;15;20;35;139720;144686;09;284406
24;2021-03-04;55;54;114;152979;161185;19;314164
24;2021-03-04;49;56;105;122237;126536;29;248773
24;2021-03-04;51;46;97;150359;142009;39;292368
24;2021-03-04;61;52;113;161829;158758;49;320587
24;2021-03-04;53;53;106;172552;168011;59;340563
24;2021-03-04;52;34;86;172509;158177;69;330686
24;2021-03-04;15;31;46;129428;110593;79;240021
24;2021-03-04;13;9;22;87342;56882;89;144224
24;2021-03-04;10;4;14;31210;12071;90;43281
24;2021-03-04;374;359;738;1320165;1238908;0;2559073
27;2021-03-04;7;8;15;143373;149679;09;293052
27;2021-03-04;52;49;101;160962;173003;19;333965
27;2021-03-04;54;56;110;133746;142254;29;276000
27;2021-03-04;39;45;84;160004;155407;39;315411
27;2021-03-04;57;35;92;172333;169564;49;341897
27;2021-03-04;51;42;93;189979;183788;59;373767
27;2021-03-04;42;34;76;192591;178206;69;370797
27;2021-03-04;19;23;42;146876;127546;79;274422
27;2021-03-04;20;11;31;96896;61575;89;158471
27;2021-03-04;3;4;7;33148;12109;90;45257
27;2021-03-04;344;307;651;1429908;1353131;0;2783039
28;2021-03-04;19;22;41;180735;186856;09;367591
28;2021-03-04;67;62;131;200125;213621;19;413746
28;2021-03-04;78;71;150;168922;173007;29;341929
28;2021-03-04;73;63;136;196628;188487;39;385115
28;2021-03-04;82;58;140;205396;201699;49;407095
28;2021-03-04;73;60;133;222002;213866;59;435868
28;2021-03-04;54;64;118;224688;203758;69;428446
28;2021-03-04;31;29;60;163192;135543;79;298735
28;2021-03-04;43;20;63;109691;65377;89;175068
28;2021-03-04;14;2;16;37222;12685;90;49907
28;2021-03-04;534;451;988;1708601;1594899;0;3303500
32;2021-03-04;87;101;188;358062;373689;09;731751
32;2021-03-04;219;242;463;387045;406742;19;793787
32;2021-03-04;245;252;497;342304;348587;29;690891
32;2021-03-04;272;220;493;382485;369972;39;752457
32;2021-03-04;292;219;512;382510;376716;49;759226
32;2021-03-04;226;216;442;386937;376527;59;763464
32;2021-03-04;158;141;300;371211;330938;69;702149
32;2021-03-04;130;74;204;250542;201459;79;452001
32;2021-03-04;54;39;93;163399;89786;89;253185
32;2021-03-04;23;8;31;48384;15367;90;63751
32;2021-03-04;1707;1513;3225;3072879;2889783;0;5962662
44;2021-03-04;26;40;66;291525;306839;09;598364
44;2021-03-04;111;106;218;320255;339504;19;659759
44;2021-03-04;145;111;259;302020;314428;29;616448
44;2021-03-04;113;127;240;342222;333292;39;675514
44;2021-03-04;140;98;239;349727;344491;49;694218
44;2021-03-04;95;104;202;381371;373239;59;754610
44;2021-03-04;74;94;168;367165;335850;69;703015
44;2021-03-04;49;39;88;250387;215436;79;465823
44;2021-03-04;49;24;73;170825;105192;89;276017
44;2021-03-04;18;3;21;51248;16731;90;67979
44;2021-03-04;820;746;1574;2826745;2685002;0;5511747
52;2021-03-04;23;21;45;213594;223900;09;437494
52;2021-03-04;89;91;182;240818;255197;19;496015
52;2021-03-04;83;84;167;197010;200630;29;397640
52;2021-03-04;65;63;128;231204;224885;39;456089
52;2021-03-04;84;72;156;243874;243418;49;487292
52;2021-03-04;58;63;121;244100;239116;59;483216
52;2021-03-04;35;36;71;241796;221345;69;463141
52;2021-03-04;21;22;43;177805;149903;79;327708
52;2021-03-04;18;15;33;119561;75822;89;195383
52;2021-03-04;9;4;13;42559;15260;90;57819
52;2021-03-04;485;471;959;1952321;1849476;0;3801797
53;2021-03-04;13;18;32;173813;182358;09;356171
53;2021-03-04;55;69;128;202720;214740;19;417460
53;2021-03-04;74;61;135;163116;173196;29;336312
53;2021-03-04;30;34;64;190526;187674;39;378200
53;2021-03-04;38;44;82;212098;212015;49;424113
53;2021-03-04;32;45;77;223699;219176;59;442875
53;2021-03-04;26;18;44;227435;209274;69;436709
53;2021-03-04;16;13;29;169992;140910;79;310902
53;2021-03-04;12;5;17;118117;69883;89;188000
53;2021-03-04;5;4;9;37370;12267;90;49637
53;2021-03-04;302;311;618;1718886;1621493;0;3340379
75;2021-03-04;26;24;50;293104;305291;09;598395
75;2021-03-04;88;81;174;337141;357785;19;694926
75;2021-03-04;84;100;184;295024;300618;29;595642
75;2021-03-04;78;62;140;347871;331233;39;679104
75;2021-03-04;67;80;147;384742;372771;49;757513
75;2021-03-04;77;81;158;413361;390880;59;804241
75;2021-03-04;62;41;103;425623;384060;69;809683
75;2021-03-04;28;27;55;325086;276298;79;601384
75;2021-03-04;26;15;41;213986;139308;89;353294
75;2021-03-04;15;6;21;77600;28200;90;105800
75;2021-03-04;551;517;1073;3113538;2886444;0;5999982
76;2021-03-04;41;44;87;305956;318589;09;624545
76;2021-03-04;97;127;228;338942;356969;19;695911
76;2021-03-04;141;101;242;316210;319570;29;635780
76;2021-03-04;132;98;231;356758;337587;39;694345
76;2021-03-04;129;93;222;376541;363812;49;740353
76;2021-03-04;105;98;203;402608;383750;59;786358
76;2021-03-04;85;56;142;394889;358997;69;753886
76;2021-03-04;40;46;86;308664;263806;79;572470
76;2021-03-04;29;23;52;195838;129272;89;325110
76;2021-03-04;9;7;16;69372;26728;90;96100
76;2021-03-04;809;694;1511;3065778;2859080;0;5924858
84;2021-03-04;58;82;140;459549;481088;09;940637
84;2021-03-04;179;174;354;487711;511905;19;999616
84;2021-03-04;203;189;392;443824;451094;29;894918
84;2021-03-04;215;170;385;512522;493262;39;1005784
84;2021-03-04;176;171;348;520248;515106;49;1035354
84;2021-03-04;148;148;298;529611;514848;59;1044459
84;2021-03-04;97;119;218;486720;439940;69;926660
84;2021-03-04;68;62;130;372151;315211;79;687362
84;2021-03-04;52;33;85;237198;150524;89;387722
84;2021-03-04;33;11;44;81185;28680;90;109865
84;2021-03-04;1229;1160;2395;4130719;3901658;0;8032377
93;2021-03-04;53;57;110;268834;283093;09;551927
93;2021-03-04;150;152;302;280751;296087;19;576838
93;2021-03-04;227;163;390;254404;255552;29;509956
93;2021-03-04;227;194;421;310704;288398;39;599102
93;2021-03-04;201;208;410;325559;305827;49;631386
93;2021-03-04;182;200;382;353104;325389;59;678493
93;2021-03-04;142;127;269;336327;296459;69;632786
93;2021-03-04;102;66;168;279820;229699;79;509519
93;2021-03-04;66;44;110;171274;113716;89;284990
93;2021-03-04;29;13;42;58896;21758;90;80654
93;2021-03-04;1379;1224;2604;2639673;2415978;0;5055651
94;2021-03-04;0;1;1;16311;17433;09;33744
94;2021-03-04;6;4;10;16679;18132;19;34811
94;2021-03-04;7;8;15;16782;16579;29;33361
94;2021-03-04;9;11;20;23044;20580;39;43624
94;2021-03-04;12;4;16;23065;22140;49;45205
94;2021-03-04;7;6;13;24549;23421;59;47970
94;2021-03-04;6;5;11;23212;21883;69;45095
94;2021-03-04;1;3;4;19544;17141;79;36685
94;2021-03-04;3;4;7;11227;8178;89;19405
94;2021-03-04;0;1;1;3332;1447;90;4779
94;2021-03-04;51;47;98;177745;166934;0;344679
01;2021-03-05;0;2;2;19979;20155;09;40134
01;2021-03-05;2;10;12;24994;25489;19;50483
01;2021-03-05;4;3;7;17868;16690;29;34558
01;2021-03-05;7;1;8;22328;14821;39;37149
01;2021-03-05;7;8;15;28652;20276;49;48928
01;2021-03-05;3;5;8;33264;27260;59;60524
01;2021-03-05;2;5;7;27135;23978;69;51113
01;2021-03-05;1;1;2;18401;14661;79;33062
01;2021-03-05;0;1;1;9633;6375;89;16008
01;2021-03-05;0;0;0;3410;1510;90;4920
01;2021-03-05;26;36;62;205664;171215;0;376879
02;2021-03-05;1;0;1;16881;17110;09;33991
02;2021-03-05;0;0;0;21410;21604;19;43014
02;2021-03-05;2;0;2;16017;15479;29;31496
02;2021-03-05;1;1;2;19825;14455;39;34280
02;2021-03-05;0;4;4;24719;18248;49;42967
02;2021-03-05;6;3;9;34361;28310;59;62671
02;2021-03-05;1;1;2;28061;24495;69;52556
02;2021-03-05;0;0;0;18231;15278;79;33509
02;2021-03-05;0;0;0;11090;7677;89;18767
02;2021-03-05;2;0;2;3992;1506;90;5498
02;2021-03-05;13;9;22;194587;164162;0;358749
03;2021-03-05;0;0;0;31123;30920;09;62043
03;2021-03-05;0;2;2;29370;29268;19;58638
03;2021-03-05;1;2;3;21458;18963;29;40421
03;2021-03-05;2;0;2;21276;18326;39;39602
03;2021-03-05;7;2;9;18164;16593;49;34757
03;2021-03-05;1;1;2;13469;13557;59;27026
03;2021-03-05;1;0;1;8776;8670;69;17446
03;2021-03-05;0;0;0;3777;3591;79;7368
03;2021-03-05;0;0;0;1649;1072;89;2721
03;2021-03-05;0;0;0;485;184;90;669
03;2021-03-05;12;7;19;149547;141144;0;290691
04;2021-03-05;4;3;7;60314;61377;09;121691
04;2021-03-05;12;11;23;66065;68387;19;134452
04;2021-03-05;12;13;25;51059;47156;29;98215
04;2021-03-05;14;10;24;58788;45780;39;104568
04;2021-03-05;9;16;25;61408;52207;49;113615
04;2021-03-05;11;18;29;64838;60759;59;125597
04;2021-03-05;9;14;23;47008;42843;69;89851
04;2021-03-05;2;4;6;25509;21184;79;46693
04;2021-03-05;2;1;3;13168;7647;89;20815
04;2021-03-05;0;0;0;3209;1253;90;4462
04;2021-03-05;75;90;165;451366;408593;0;859959
05;2021-03-05;0;0;0;362.366008612902;341.338819562748;09;703.704828175651
05;2021-03-05;0;0;0;353.376145114279;370.349735405642;19;723.725880519921
05;2021-03-05;0;0;0;218.593559489256;256.539602589476;29;475.133162078732
05;2021-03-05;0;0;0;404.225408693299;360.321910454353;39;764.547319147651
05;2021-03-05;0;0;0;520.067953604221;497.108383964256;49;1017.17633756848
05;2021-03-05;0;0;0;468.146063921917;510.087601910415;59;978.233665832332
05;2021-03-05;0;0;0;340.368470050554;334.366842191253;69;674.735312241807
05;2021-03-05;0;0;0;212.598666888387;192.597753227106;79;405.196420115493
05;2021-03-05;0;0;0;148.727797095705;61.8681715431829;89;210.595968638888
05;2021-03-05;0;0;0;32.9601271090696;10.9909785719784;90;43.9511056810479
05;2021-03-05;0;0;0;3061.43020057959;2935.56979942041;0;5997
06;2021-03-05;0;0;0;42583;42380;09;84963
06;2021-03-05;5;2;7;33369;31925;19;65294
06;2021-03-05;10;6;16;21571;15080;29;36651
06;2021-03-05;11;11;22;21550;16147;39;37697
06;2021-03-05;8;11;19;14193;13939;49;28132
06;2021-03-05;2;3;5;7171;7597;59;14768
06;2021-03-05;16;16;32;3629;4117;69;7746
06;2021-03-05;1;0;1;1577;1457;79;3034
06;2021-03-05;1;0;1;531;474;89;1005
06;2021-03-05;0;0;0;88;93;90;181
06;2021-03-05;54;49;103;146262;133209;0;279471
07;2021-03-05;0;0;0;485;549;09;1034
07;2021-03-05;0;0;0;403;432;19;835
07;2021-03-05;1;1;2;764;841;29;1605
07;2021-03-05;1;0;1;824;928;39;1752
07;2021-03-05;0;0;0;788;1020;49;1808
07;2021-03-05;2;0;2;678;870;59;1548
07;2021-03-05;1;0;1;360;382;69;742
07;2021-03-05;1;1;2;231;190;79;421
07;2021-03-05;0;0;0;114;67;89;181
07;2021-03-05;0;0;0;24;11;90;35
07;2021-03-05;6;2;8;4671;5290;0;9961
08;2021-03-05;0;0;0;2715.22592983026;2997.75551488675;09;5712.98144471701
08;2021-03-05;0;0;0;2778.51901080978;3160.9156459093;19;5939.43465671908
08;2021-03-05;1;0;1;2080.8882988764;1718.16634315323;29;3799.05464202964
08;2021-03-05;1;2;3;2701.8582062647;1896.52641413317;39;4598.38462039786
08;2021-03-05;2;1;3;3151.45861023308;2460.52498233809;49;5611.98359257117
08;2021-03-05;0;1;1;2620.29868333099;2422.23566154656;59;5042.53434487755
08;2021-03-05;0;0;0;1621.44173420671;1438.58325779464;69;3060.02499200135
08;2021-03-05;0;0;0;626.575909335673;526.358467843651;79;1152.93437717932
08;2021-03-05;1;0;1;205.018522985054;140.993639349697;89;346.012162334751
08;2021-03-05;0;0;0;50.0325684687745;20.62259870351;90;70.6551671722846
08;2021-03-05;5;4;9;18551.3174743414;16782.6825256586;0;35334
11;2021-03-05;175;231;424;783071;811785;09;1594856
11;2021-03-05;485;500;1024;761456;784653;19;1546109
11;2021-03-05;755;650;1409;850145;801772;29;1651917
11;2021-03-05;699;577;1284;914360;843488;39;1757848
11;2021-03-05;589;536;1132;845609;826202;49;1671811
11;2021-03-05;537;524;1068;793566;745070;59;1538636
11;2021-03-05;335;293;636;628649;549192;69;1177841
11;2021-03-05;163;146;310;434606;358356;79;792962
11;2021-03-05;110;61;172;261425;162933;89;424358
11;2021-03-05;44;21;65;89253;32619;90;121872
11;2021-03-05;3895;3539;7528;6362140;5916070;0;12278210
24;2021-03-05;9;15;24;139720;144686;09;284406
24;2021-03-05;49;55;107;152979;161185;19;314164
24;2021-03-05;76;45;121;122237;126536;29;248773
24;2021-03-05;72;50;122;150359;142009;39;292368
24;2021-03-05;56;54;110;161829;158758;49;320587
24;2021-03-05;48;63;111;172552;168011;59;340563
24;2021-03-05;56;37;93;172509;158177;69;330686
24;2021-03-05;35;21;56;129428;110593;79;240021
24;2021-03-05;16;13;29;87342;56882;89;144224
24;2021-03-05;10;7;17;31210;12071;90;43281
24;2021-03-05;428;360;791;1320165;1238908;0;2559073
27;2021-03-05;18;17;35;143373;149679;09;293052
27;2021-03-05;73;85;158;160962;173003;19;333965
27;2021-03-05;54;44;98;133746;142254;29;276000
27;2021-03-05;49;45;94;160004;155407;39;315411
27;2021-03-05;59;38;97;172333;169564;49;341897
27;2021-03-05;48;57;105;189979;183788;59;373767
27;2021-03-05;37;37;74;192591;178206;69;370797
27;2021-03-05;19;32;51;146876;127546;79;274422
27;2021-03-05;9;9;18;96896;61575;89;158471
27;2021-03-05;6;7;13;33148;12109;90;45257
27;2021-03-05;372;371;743;1429908;1353131;0;2783039
28;2021-03-05;28;34;63;180735;186856;09;367591
28;2021-03-05;89;81;171;200125;213621;19;413746
28;2021-03-05;72;71;143;168922;173007;29;341929
28;2021-03-05;82;74;156;196628;188487;39;385115
28;2021-03-05;104;69;173;205396;201699;49;407095
28;2021-03-05;79;88;167;222002;213866;59;435868
28;2021-03-05;72;48;120;224688;203758;69;428446
28;2021-03-05;41;34;75;163192;135543;79;298735
28;2021-03-05;37;20;57;109691;65377;89;175068
28;2021-03-05;26;6;32;37222;12685;90;49907
28;2021-03-05;630;525;1157;1708601;1594899;0;3303500
32;2021-03-05;100;108;208;358062;373689;09;731751
32;2021-03-05;266;247;513;387045;406742;19;793787
32;2021-03-05;287;258;546;342304;348587;29;690891
32;2021-03-05;277;237;514;382485;369972;39;752457
32;2021-03-05;265;243;508;382510;376716;49;759226
32;2021-03-05;223;222;445;386937;376527;59;763464
32;2021-03-05;176;150;326;371211;330938;69;702149
32;2021-03-05;113;109;222;250542;201459;79;452001
32;2021-03-05;71;42;113;163399;89786;89;253185
32;2021-03-05;17;8;25;48384;15367;90;63751
32;2021-03-05;1795;1625;3421;3072879;2889783;0;5962662
44;2021-03-05;51;62;114;291525;306839;09;598364
44;2021-03-05;125;127;254;320255;339504;19;659759
44;2021-03-05;149;120;270;302020;314428;29;616448
44;2021-03-05;136;131;268;342222;333292;39;675514
44;2021-03-05;151;109;260;349727;344491;49;694218
44;2021-03-05;108;129;237;381371;373239;59;754610
44;2021-03-05;97;96;193;367165;335850;69;703015
44;2021-03-05;72;70;143;250387;215436;79;465823
44;2021-03-05;42;23;65;170825;105192;89;276017
44;2021-03-05;17;3;20;51248;16731;90;67979
44;2021-03-05;948;870;1824;2826745;2685002;0;5511747
52;2021-03-05;26;30;58;213594;223900;09;437494
52;2021-03-05;95;85;181;240818;255197;19;496015
52;2021-03-05;84;81;165;197010;200630;29;397640
52;2021-03-05;68;74;143;231204;224885;39;456089
52;2021-03-05;60;59;119;243874;243418;49;487292
52;2021-03-05;54;66;120;244100;239116;59;483216
52;2021-03-05;49;52;101;241796;221345;69;463141
52;2021-03-05;26;29;55;177805;149903;79;327708
52;2021-03-05;15;18;33;119561;75822;89;195383
52;2021-03-05;10;4;14;42559;15260;90;57819
52;2021-03-05;487;498;989;1952321;1849476;0;3801797
53;2021-03-05;15;20;36;173813;182358;09;356171
53;2021-03-05;54;71;125;202720;214740;19;417460
53;2021-03-05;57;43;100;163116;173196;29;336312
53;2021-03-05;40;41;81;190526;187674;39;378200
53;2021-03-05;40;49;89;212098;212015;49;424113
53;2021-03-05;39;44;83;223699;219176;59;442875
53;2021-03-05;30;28;58;227435;209274;69;436709
53;2021-03-05;16;20;36;169992;140910;79;310902
53;2021-03-05;15;8;23;118117;69883;89;188000
53;2021-03-05;5;4;9;37370;12267;90;49637
53;2021-03-05;311;328;640;1718886;1621493;0;3340379
75;2021-03-05;30;36;67;293104;305291;09;598395
75;2021-03-05;74;98;172;337141;357785;19;694926
75;2021-03-05;87;86;174;295024;300618;29;595642
75;2021-03-05;96;59;155;347871;331233;39;679104
75;2021-03-05;74;63;137;384742;372771;49;757513
75;2021-03-05;71;73;144;413361;390880;59;804241
75;2021-03-05;54;52;106;425623;384060;69;809683
75;2021-03-05;29;31;60;325086;276298;79;601384
75;2021-03-05;25;13;38;213986;139308;89;353294
75;2021-03-05;17;6;23;77600;28200;90;105800
75;2021-03-05;558;517;1077;3113538;2886444;0;5999982
76;2021-03-05;44;39;86;305956;318589;09;624545
76;2021-03-05;125;112;238;338942;356969;19;695911
76;2021-03-05;123;100;225;316210;319570;29;635780
76;2021-03-05;108;91;199;356758;337587;39;694345
76;2021-03-05;138;95;233;376541;363812;49;740353
76;2021-03-05;113;86;199;402608;383750;59;786358
76;2021-03-05;73;61;134;394889;358997;69;753886
76;2021-03-05;57;49;106;308664;263806;79;572470
76;2021-03-05;16;18;34;195838;129272;89;325110
76;2021-03-05;11;5;16;69372;26728;90;96100
76;2021-03-05;811;657;1474;3065778;2859080;0;5924858
84;2021-03-05;85;78;165;459549;481088;09;940637
84;2021-03-05;149;193;342;487711;511905;19;999616
84;2021-03-05;214;209;423;443824;451094;29;894918
84;2021-03-05;214;191;407;512522;493262;39;1005784
84;2021-03-05;190;168;358;520248;515106;49;1035354
84;2021-03-05;167;174;341;529611;514848;59;1044459
84;2021-03-05;113;108;221;486720;439940;69;926660
84;2021-03-05;99;82;181;372151;315211;79;687362
84;2021-03-05;51;37;88;237198;150524;89;387722
84;2021-03-05;26;2;28;81185;28680;90;109865
84;2021-03-05;1308;1242;2554;4130719;3901658;0;8032377
93;2021-03-05;61;62;123;268834;283093;09;551927
93;2021-03-05;176;195;371;280751;296087;19;576838
93;2021-03-05;233;194;427;254404;255552;29;509956
93;2021-03-05;220;202;423;310704;288398;39;599102
93;2021-03-05;259;198;458;325559;305827;49;631386
93;2021-03-05;218;194;412;353104;325389;59;678493
93;2021-03-05;149;147;296;336327;296459;69;632786
93;2021-03-05;92;80;172;279820;229699;79;509519
93;2021-03-05;64;49;113;171274;113716;89;284990
93;2021-03-05;17;11;28;58896;21758;90;80654
93;2021-03-05;1489;1332;2850;2639673;2415978;0;5055651
94;2021-03-05;2;7;9;16311;17433;09;33744
94;2021-03-05;11;8;20;16679;18132;19;34811
94;2021-03-05;6;4;10;16782;16579;29;33361
94;2021-03-05;9;6;15;23044;20580;39;43624
94;2021-03-05;5;9;14;23065;22140;49;45205
94;2021-03-05;7;6;13;24549;23421;59;47970
94;2021-03-05;4;6;10;23212;21883;69;45095
94;2021-03-05;2;2;4;19544;17141;79;36685
94;2021-03-05;2;2;4;11227;8178;89;19405
94;2021-03-05;1;0;1;3332;1447;90;4779
94;2021-03-05;49;50;100;177745;166934;0;344679
01;2021-03-06;0;0;0;19979;20155;09;40134
01;2021-03-06;2;3;5;24994;25489;19;50483
01;2021-03-06;2;1;3;17868;16690;29;34558
01;2021-03-06;3;1;4;22328;14821;39;37149
01;2021-03-06;1;0;1;28652;20276;49;48928
01;2021-03-06;2;2;4;33264;27260;59;60524
01;2021-03-06;0;0;0;27135;23978;69;51113
01;2021-03-06;0;0;0;18401;14661;79;33062
01;2021-03-06;1;0;1;9633;6375;89;16008
01;2021-03-06;0;0;0;3410;1510;90;4920
01;2021-03-06;11;7;18;205664;171215;0;376879
02;2021-03-06;0;0;0;16881;17110;09;33991
02;2021-03-06;1;0;1;21410;21604;19;43014
02;2021-03-06;0;0;0;16017;15479;29;31496
02;2021-03-06;2;1;3;19825;14455;39;34280
02;2021-03-06;0;1;1;24719;18248;49;42967
02;2021-03-06;1;1;2;34361;28310;59;62671
02;2021-03-06;1;1;2;28061;24495;69;52556
02;2021-03-06;0;0;0;18231;15278;79;33509
02;2021-03-06;1;0;1;11090;7677;89;18767
02;2021-03-06;0;0;0;3992;1506;90;5498
02;2021-03-06;6;4;10;194587;164162;0;358749
03;2021-03-06;0;0;0;31123;30920;09;62043
03;2021-03-06;1;0;1;29370;29268;19;58638
03;2021-03-06;0;0;0;21458;18963;29;40421
03;2021-03-06;0;0;0;21276;18326;39;39602
03;2021-03-06;1;1;2;18164;16593;49;34757
03;2021-03-06;3;2;5;13469;13557;59;27026
03;2021-03-06;1;0;1;8776;8670;69;17446
03;2021-03-06;0;0;0;3777;3591;79;7368
03;2021-03-06;0;0;0;1649;1072;89;2721
03;2021-03-06;0;0;0;485;184;90;669
03;2021-03-06;6;3;9;149547;141144;0;290691
04;2021-03-06;2;1;3;60314;61377;09;121691
04;2021-03-06;4;10;14;66065;68387;19;134452
04;2021-03-06;8;3;11;51059;47156;29;98215
04;2021-03-06;11;5;16;58788;45780;39;104568
04;2021-03-06;12;7;19;61408;52207;49;113615
04;2021-03-06;8;7;15;64838;60759;59;125597
04;2021-03-06;6;5;11;47008;42843;69;89851
04;2021-03-06;1;3;4;25509;21184;79;46693
04;2021-03-06;3;5;8;13168;7647;89;20815
04;2021-03-06;0;0;0;3209;1253;90;4462
04;2021-03-06;55;46;101;451366;408593;0;859959
05;2021-03-06;0;0;0;362.366008612902;341.338819562748;09;703.704828175651
05;2021-03-06;0;0;0;353.376145114279;370.349735405642;19;723.725880519921
05;2021-03-06;0;0;0;218.593559489256;256.539602589476;29;475.133162078732
05;2021-03-06;0;0;0;404.225408693299;360.321910454353;39;764.547319147651
05;2021-03-06;0;0;0;520.067953604221;497.108383964256;49;1017.17633756848
05;2021-03-06;0;0;0;468.146063921917;510.087601910415;59;978.233665832332
05;2021-03-06;0;0;0;340.368470050554;334.366842191253;69;674.735312241807
05;2021-03-06;0;0;0;212.598666888387;192.597753227106;79;405.196420115493
05;2021-03-06;0;0;0;148.727797095705;61.8681715431829;89;210.595968638888
05;2021-03-06;0;0;0;32.9601271090696;10.9909785719784;90;43.9511056810479
05;2021-03-06;0;0;0;3061.43020057959;2935.56979942041;0;5997
06;2021-03-06;1;0;1;42583;42380;09;84963
06;2021-03-06;4;0;4;33369;31925;19;65294
06;2021-03-06;4;2;6;21571;15080;29;36651
06;2021-03-06;5;1;6;21550;16147;39;37697
06;2021-03-06;2;1;3;14193;13939;49;28132
06;2021-03-06;4;2;6;7171;7597;59;14768
06;2021-03-06;1;2;3;3629;4117;69;7746
06;2021-03-06;0;1;1;1577;1457;79;3034
06;2021-03-06;1;0;1;531;474;89;1005
06;2021-03-06;0;0;0;88;93;90;181
06;2021-03-06;22;9;31;146262;133209;0;279471
07;2021-03-06;0;0;0;485;549;09;1034
07;2021-03-06;2;0;2;403;432;19;835
07;2021-03-06;0;1;1;764;841;29;1605
07;2021-03-06;0;1;1;824;928;39;1752
07;2021-03-06;1;0;1;788;1020;49;1808
07;2021-03-06;0;0;0;678;870;59;1548
07;2021-03-06;0;0;0;360;382;69;742
07;2021-03-06;0;0;0;231;190;79;421
07;2021-03-06;0;0;0;114;67;89;181
07;2021-03-06;0;0;0;24;11;90;35
07;2021-03-06;3;2;5;4671;5290;0;9961
08;2021-03-06;0;0;0;2715.22592983026;2997.75551488675;09;5712.98144471701
08;2021-03-06;0;0;0;2778.51901080978;3160.9156459093;19;5939.43465671908
08;2021-03-06;0;0;0;2080.8882988764;1718.16634315323;29;3799.05464202964
08;2021-03-06;1;0;1;2701.8582062647;1896.52641413317;39;4598.38462039786
08;2021-03-06;1;0;1;3151.45861023308;2460.52498233809;49;5611.98359257117
08;2021-03-06;0;0;0;2620.29868333099;2422.23566154656;59;5042.53434487755
08;2021-03-06;0;2;2;1621.44173420671;1438.58325779464;69;3060.02499200135
08;2021-03-06;0;0;0;626.575909335673;526.358467843651;79;1152.93437717932
08;2021-03-06;0;1;1;205.018522985054;140.993639349697;89;346.012162334751
08;2021-03-06;0;0;0;50.0325684687745;20.62259870351;90;70.6551671722846
08;2021-03-06;2;3;5;18551.3174743414;16782.6825256586;0;35334
11;2021-03-06;115;117;254;783071;811785;09;1594856
11;2021-03-06;296;317;632;761456;784653;19;1546109
11;2021-03-06;450;355;806;850145;801772;29;1651917
11;2021-03-06;401;414;815;914360;843488;39;1757848
11;2021-03-06;375;354;729;845609;826202;49;1671811
11;2021-03-06;305;298;604;793566;745070;59;1538636
11;2021-03-06;201;206;412;628649;549192;69;1177841
11;2021-03-06;107;88;195;434606;358356;79;792962
11;2021-03-06;64;40;104;261425;162933;89;424358
11;2021-03-06;24;14;38;89253;32619;90;121872
11;2021-03-06;2339;2204;4591;6362140;5916070;0;12278210
24;2021-03-06;8;6;14;139720;144686;09;284406
24;2021-03-06;38;43;81;152979;161185;19;314164
24;2021-03-06;38;31;69;122237;126536;29;248773
24;2021-03-06;43;34;77;150359;142009;39;292368
24;2021-03-06;33;35;68;161829;158758;49;320587
24;2021-03-06;26;38;64;172552;168011;59;340563
24;2021-03-06;20;19;39;172509;158177;69;330686
24;2021-03-06;11;15;26;129428;110593;79;240021
24;2021-03-06;9;7;16;87342;56882;89;144224
24;2021-03-06;4;3;7;31210;12071;90;43281
24;2021-03-06;230;231;461;1320165;1238908;0;2559073
27;2021-03-06;15;10;25;143373;149679;09;293052
27;2021-03-06;27;47;74;160962;173003;19;333965
27;2021-03-06;37;30;67;133746;142254;29;276000
27;2021-03-06;44;24;68;160004;155407;39;315411
27;2021-03-06;34;25;59;172333;169564;49;341897
27;2021-03-06;24;30;55;189979;183788;59;373767
27;2021-03-06;20;22;42;192591;178206;69;370797
27;2021-03-06;22;17;39;146876;127546;79;274422
27;2021-03-06;6;8;14;96896;61575;89;158471
27;2021-03-06;4;3;7;33148;12109;90;45257
27;2021-03-06;233;216;450;1429908;1353131;0;2783039
28;2021-03-06;15;18;34;180735;186856;09;367591
28;2021-03-06;52;57;109;200125;213621;19;413746
28;2021-03-06;51;45;96;168922;173007;29;341929
28;2021-03-06;49;24;73;196628;188487;39;385115
28;2021-03-06;49;42;91;205396;201699;49;407095
28;2021-03-06;61;45;106;222002;213866;59;435868
28;2021-03-06;28;36;64;224688;203758;69;428446
28;2021-03-06;25;25;50;163192;135543;79;298735
28;2021-03-06;11;9;20;109691;65377;89;175068
28;2021-03-06;7;2;9;37222;12685;90;49907
28;2021-03-06;348;303;652;1708601;1594899;0;3303500
32;2021-03-06;58;82;140;358062;373689;09;731751
32;2021-03-06;172;153;325;387045;406742;19;793787
32;2021-03-06;180;173;353;342304;348587;29;690891
32;2021-03-06;186;158;344;382485;369972;39;752457
32;2021-03-06;171;182;353;382510;376716;49;759226
32;2021-03-06;157;156;313;386937;376527;59;763464
32;2021-03-06;115;91;206;371211;330938;69;702149
32;2021-03-06;76;63;139;250542;201459;79;452001
32;2021-03-06;50;24;74;163399;89786;89;253185
32;2021-03-06;13;6;19;48384;15367;90;63751
32;2021-03-06;1178;1089;2267;3072879;2889783;0;5962662
44;2021-03-06;20;30;50;291525;306839;09;598364
44;2021-03-06;69;101;172;320255;339504;19;659759
44;2021-03-06;98;101;199;302020;314428;29;616448
44;2021-03-06;96;85;181;342222;333292;39;675514
44;2021-03-06;107;93;200;349727;344491;49;694218
44;2021-03-06;103;82;185;381371;373239;59;754610
44;2021-03-06;57;54;111;367165;335850;69;703015
44;2021-03-06;34;42;76;250387;215436;79;465823
44;2021-03-06;33;17;50;170825;105192;89;276017
44;2021-03-06;12;5;17;51248;16731;90;67979
44;2021-03-06;629;610;1241;2826745;2685002;0;5511747
52;2021-03-06;11;19;31;213594;223900;09;437494
52;2021-03-06;57;53;112;240818;255197;19;496015
52;2021-03-06;63;45;108;197010;200630;29;397640
52;2021-03-06;47;35;82;231204;224885;39;456089
52;2021-03-06;54;58;112;243874;243418;49;487292
52;2021-03-06;50;45;95;244100;239116;59;483216
52;2021-03-06;39;27;66;241796;221345;69;463141
52;2021-03-06;20;26;46;177805;149903;79;327708
52;2021-03-06;8;4;12;119561;75822;89;195383
52;2021-03-06;5;1;6;42559;15260;90;57819
52;2021-03-06;354;313;670;1952321;1849476;0;3801797
53;2021-03-06;11;12;23;173813;182358;09;356171
53;2021-03-06;38;32;70;202720;214740;19;417460
53;2021-03-06;28;51;79;163116;173196;29;336312
53;2021-03-06;29;23;52;190526;187674;39;378200
53;2021-03-06;39;34;73;212098;212015;49;424113
53;2021-03-06;32;28;61;223699;219176;59;442875
53;2021-03-06;13;17;30;227435;209274;69;436709
53;2021-03-06;16;10;26;169992;140910;79;310902
53;2021-03-06;11;7;18;118117;69883;89;188000
53;2021-03-06;6;3;9;37370;12267;90;49637
53;2021-03-06;223;217;441;1718886;1621493;0;3340379
75;2021-03-06;10;20;30;293104;305291;09;598395
75;2021-03-06;47;62;110;337141;357785;19;694926
75;2021-03-06;55;49;104;295024;300618;29;595642
75;2021-03-06;38;47;85;347871;331233;39;679104
75;2021-03-06;62;49;111;384742;372771;49;757513
75;2021-03-06;37;38;75;413361;390880;59;804241
75;2021-03-06;35;33;68;425623;384060;69;809683
75;2021-03-06;23;17;40;325086;276298;79;601384
75;2021-03-06;16;7;23;213986;139308;89;353294
75;2021-03-06;4;5;9;77600;28200;90;105800
75;2021-03-06;327;327;655;3113538;2886444;0;5999982
76;2021-03-06;22;20;44;305956;318589;09;624545
76;2021-03-06;86;65;151;338942;356969;19;695911
76;2021-03-06;84;73;157;316210;319570;29;635780
76;2021-03-06;64;74;138;356758;337587;39;694345
76;2021-03-06;74;61;135;376541;363812;49;740353
76;2021-03-06;71;46;117;402608;383750;59;786358
76;2021-03-06;49;41;90;394889;358997;69;753886
76;2021-03-06;30;20;50;308664;263806;79;572470
76;2021-03-06;11;12;23;195838;129272;89;325110
76;2021-03-06;2;4;6;69372;26728;90;96100
76;2021-03-06;493;416;911;3065778;2859080;0;5924858
84;2021-03-06;27;51;78;459549;481088;09;940637
84;2021-03-06;101;103;204;487711;511905;19;999616
84;2021-03-06;136;106;242;443824;451094;29;894918
84;2021-03-06;130;110;240;512522;493262;39;1005784
84;2021-03-06;142;114;256;520248;515106;49;1035354
84;2021-03-06;102;112;214;529611;514848;59;1044459
84;2021-03-06;51;72;123;486720;439940;69;926660
84;2021-03-06;27;44;71;372151;315211;79;687362
84;2021-03-06;39;24;63;237198;150524;89;387722
84;2021-03-06;8;5;13;81185;28680;90;109865
84;2021-03-06;763;741;1504;4130719;3901658;0;8032377
93;2021-03-06;29;35;65;268834;283093;09;551927
93;2021-03-06;113;99;212;280751;296087;19;576838
93;2021-03-06;127;109;237;254404;255552;29;509956
93;2021-03-06;127;106;233;310704;288398;39;599102
93;2021-03-06;122;132;254;325559;305827;49;631386
93;2021-03-06;129;115;244;353104;325389;59;678493
93;2021-03-06;83;80;163;336327;296459;69;632786
93;2021-03-06;60;37;97;279820;229699;79;509519
93;2021-03-06;40;19;59;171274;113716;89;284990
93;2021-03-06;15;8;23;58896;21758;90;80654
93;2021-03-06;845;740;1587;2639673;2415978;0;5055651
94;2021-03-06;0;1;1;16311;17433;09;33744
94;2021-03-06;3;3;6;16679;18132;19;34811
94;2021-03-06;0;4;4;16782;16579;29;33361
94;2021-03-06;7;5;12;23044;20580;39;43624
94;2021-03-06;7;4;11;23065;22140;49;45205
94;2021-03-06;0;1;1;24549;23421;59;47970
94;2021-03-06;3;2;5;23212;21883;69;45095
94;2021-03-06;2;2;4;19544;17141;79;36685
94;2021-03-06;0;0;0;11227;8178;89;19405
94;2021-03-06;0;0;0;3332;1447;90;4779
94;2021-03-06;22;22;44;177745;166934;0;344679
01;2021-03-07;0;0;0;19979;20155;09;40134
01;2021-03-07;2;0;2;24994;25489;19;50483
01;2021-03-07;0;0;0;17868;16690;29;34558
01;2021-03-07;0;0;0;22328;14821;39;37149
01;2021-03-07;0;1;1;28652;20276;49;48928
01;2021-03-07;2;2;4;33264;27260;59;60524
01;2021-03-07;2;2;4;27135;23978;69;51113
01;2021-03-07;1;1;2;18401;14661;79;33062
01;2021-03-07;1;0;1;9633;6375;89;16008
01;2021-03-07;0;0;0;3410;1510;90;4920
01;2021-03-07;8;6;14;205664;171215;0;376879
02;2021-03-07;0;0;0;16881;17110;09;33991
02;2021-03-07;0;0;0;21410;21604;19;43014
02;2021-03-07;0;0;0;16017;15479;29;31496
02;2021-03-07;0;1;1;19825;14455;39;34280
02;2021-03-07;1;0;1;24719;18248;49;42967
02;2021-03-07;3;1;4;34361;28310;59;62671
02;2021-03-07;1;1;2;28061;24495;69;52556
02;2021-03-07;0;0;0;18231;15278;79;33509
02;2021-03-07;0;0;0;11090;7677;89;18767
02;2021-03-07;1;0;1;3992;1506;90;5498
02;2021-03-07;6;3;9;194587;164162;0;358749
03;2021-03-07;0;1;1;31123;30920;09;62043
03;2021-03-07;0;0;0;29370;29268;19;58638
03;2021-03-07;0;0;0;21458;18963;29;40421
03;2021-03-07;0;0;0;21276;18326;39;39602
03;2021-03-07;0;1;1;18164;16593;49;34757
03;2021-03-07;0;0;0;13469;13557;59;27026
03;2021-03-07;0;0;0;8776;8670;69;17446
03;2021-03-07;0;0;0;3777;3591;79;7368
03;2021-03-07;0;0;0;1649;1072;89;2721
03;2021-03-07;0;0;0;485;184;90;669
03;2021-03-07;0;2;2;149547;141144;0;290691
04;2021-03-07;1;2;3;60314;61377;09;121691
04;2021-03-07;3;2;5;66065;68387;19;134452
04;2021-03-07;5;2;7;51059;47156;29;98215
04;2021-03-07;6;1;7;58788;45780;39;104568
04;2021-03-07;3;2;5;61408;52207;49;113615
04;2021-03-07;1;1;2;64838;60759;59;125597
04;2021-03-07;2;1;3;47008;42843;69;89851
04;2021-03-07;1;0;1;25509;21184;79;46693
04;2021-03-07;0;3;3;13168;7647;89;20815
04;2021-03-07;1;1;2;3209;1253;90;4462
04;2021-03-07;23;15;38;451366;408593;0;859959
05;2021-03-07;0;0;0;362.366008612902;341.338819562748;09;703.704828175651
05;2021-03-07;0;0;0;353.376145114279;370.349735405642;19;723.725880519921
05;2021-03-07;0;0;0;218.593559489256;256.539602589476;29;475.133162078732
05;2021-03-07;0;0;0;404.225408693299;360.321910454353;39;764.547319147651
05;2021-03-07;0;0;0;520.067953604221;497.108383964256;49;1017.17633756848
05;2021-03-07;0;0;0;468.146063921917;510.087601910415;59;978.233665832332
05;2021-03-07;0;0;0;340.368470050554;334.366842191253;69;674.735312241807
05;2021-03-07;0;0;0;212.598666888387;192.597753227106;79;405.196420115493
05;2021-03-07;0;0;0;148.727797095705;61.8681715431829;89;210.595968638888
05;2021-03-07;0;0;0;32.9601271090696;10.9909785719784;90;43.9511056810479
05;2021-03-07;0;0;0;3061.43020057959;2935.56979942041;0;5997
06;2021-03-07;0;0;0;42583;42380;09;84963
06;2021-03-07;2;0;2;33369;31925;19;65294
06;2021-03-07;1;4;5;21571;15080;29;36651
06;2021-03-07;1;2;3;21550;16147;39;37697
06;2021-03-07;0;2;2;14193;13939;49;28132
06;2021-03-07;0;0;0;7171;7597;59;14768
06;2021-03-07;5;0;5;3629;4117;69;7746
06;2021-03-07;0;0;0;1577;1457;79;3034
06;2021-03-07;0;0;0;531;474;89;1005
06;2021-03-07;0;0;0;88;93;90;181
06;2021-03-07;9;8;17;146262;133209;0;279471
07;2021-03-07;0;0;0;485;549;09;1034
07;2021-03-07;0;0;0;403;432;19;835
07;2021-03-07;0;0;0;764;841;29;1605
07;2021-03-07;0;0;0;824;928;39;1752
07;2021-03-07;0;0;0;788;1020;49;1808
07;2021-03-07;0;1;1;678;870;59;1548
07;2021-03-07;0;0;0;360;382;69;742
07;2021-03-07;0;0;0;231;190;79;421
07;2021-03-07;0;0;0;114;67;89;181
07;2021-03-07;0;0;0;24;11;90;35
07;2021-03-07;0;1;1;4671;5290;0;9961
08;2021-03-07;0;0;0;2715.22592983026;2997.75551488675;09;5712.98144471701
08;2021-03-07;0;0;0;2778.51901080978;3160.9156459093;19;5939.43465671908
08;2021-03-07;0;0;0;2080.8882988764;1718.16634315323;29;3799.05464202964
08;2021-03-07;0;0;0;2701.8582062647;1896.52641413317;39;4598.38462039786
08;2021-03-07;0;0;0;3151.45861023308;2460.52498233809;49;5611.98359257117
08;2021-03-07;0;0;0;2620.29868333099;2422.23566154656;59;5042.53434487755
08;2021-03-07;0;0;0;1621.44173420671;1438.58325779464;69;3060.02499200135
08;2021-03-07;0;0;0;626.575909335673;526.358467843651;79;1152.93437717932
08;2021-03-07;0;0;0;205.018522985054;140.993639349697;89;346.012162334751
08;2021-03-07;0;0;0;50.0325684687745;20.62259870351;90;70.6551671722846
08;2021-03-07;0;0;0;18551.3174743414;16782.6825256586;0;35334
11;2021-03-07;37;28;65;783071;811785;09;1594856
11;2021-03-07;69;57;127;761456;784653;19;1546109
11;2021-03-07;105;92;197;850145;801772;29;1651917
11;2021-03-07;103;90;193;914360;843488;39;1757848
11;2021-03-07;69;82;151;845609;826202;49;1671811
11;2021-03-07;63;62;125;793566;745070;59;1538636
11;2021-03-07;51;44;95;628649;549192;69;1177841
11;2021-03-07;25;26;51;434606;358356;79;792962
11;2021-03-07;27;24;51;261425;162933;89;424358
11;2021-03-07;10;4;14;89253;32619;90;121872
11;2021-03-07;559;509;1069;6362140;5916070;0;12278210
24;2021-03-07;1;1;2;139720;144686;09;284406
24;2021-03-07;3;1;4;152979;161185;19;314164
24;2021-03-07;5;3;8;122237;126536;29;248773
24;2021-03-07;5;6;11;150359;142009;39;292368
24;2021-03-07;4;5;9;161829;158758;49;320587
24;2021-03-07;11;4;15;172552;168011;59;340563
24;2021-03-07;4;4;8;172509;158177;69;330686
24;2021-03-07;0;4;4;129428;110593;79;240021
24;2021-03-07;3;4;7;87342;56882;89;144224
24;2021-03-07;4;3;7;31210;12071;90;43281
24;2021-03-07;40;35;75;1320165;1238908;0;2559073
27;2021-03-07;4;0;4;143373;149679;09;293052
27;2021-03-07;7;1;8;160962;173003;19;333965
27;2021-03-07;2;3;5;133746;142254;29;276000
27;2021-03-07;3;7;10;160004;155407;39;315411
27;2021-03-07;4;7;11;172333;169564;49;341897
27;2021-03-07;3;5;8;189979;183788;59;373767
27;2021-03-07;2;1;3;192591;178206;69;370797
27;2021-03-07;4;3;7;146876;127546;79;274422
27;2021-03-07;6;4;10;96896;61575;89;158471
27;2021-03-07;2;0;2;33148;12109;90;45257
27;2021-03-07;37;31;68;1429908;1353131;0;2783039
28;2021-03-07;3;2;5;180735;186856;09;367591
28;2021-03-07;11;6;17;200125;213621;19;413746
28;2021-03-07;12;9;21;168922;173007;29;341929
28;2021-03-07;10;10;20;196628;188487;39;385115
28;2021-03-07;12;10;22;205396;201699;49;407095
28;2021-03-07;12;11;23;222002;213866;59;435868
28;2021-03-07;8;10;18;224688;203758;69;428446
28;2021-03-07;4;4;8;163192;135543;79;298735
28;2021-03-07;7;2;9;109691;65377;89;175068
28;2021-03-07;2;0;2;37222;12685;90;49907
28;2021-03-07;81;64;145;1708601;1594899;0;3303500
32;2021-03-07;12;20;32;358062;373689;09;731751
32;2021-03-07;47;44;91;387045;406742;19;793787
32;2021-03-07;42;38;80;342304;348587;29;690891
32;2021-03-07;69;42;111;382485;369972;39;752457
32;2021-03-07;49;38;87;382510;376716;49;759226
32;2021-03-07;33;32;65;386937;376527;59;763464
32;2021-03-07;14;19;33;371211;330938;69;702149
32;2021-03-07;20;14;34;250542;201459;79;452001
32;2021-03-07;18;10;28;163399;89786;89;253185
32;2021-03-07;7;3;10;48384;15367;90;63751
32;2021-03-07;311;260;571;3072879;2889783;0;5962662
44;2021-03-07;4;3;7;291525;306839;09;598364
44;2021-03-07;12;9;21;320255;339504;19;659759
44;2021-03-07;12;12;24;302020;314428;29;616448
44;2021-03-07;13;18;31;342222;333292;39;675514
44;2021-03-07;15;12;27;349727;344491;49;694218
44;2021-03-07;13;14;27;381371;373239;59;754610
44;2021-03-07;12;14;26;367165;335850;69;703015
44;2021-03-07;7;10;17;250387;215436;79;465823
44;2021-03-07;8;15;23;170825;105192;89;276017
44;2021-03-07;3;2;5;51248;16731;90;67979
44;2021-03-07;99;109;208;2826745;2685002;0;5511747
52;2021-03-07;5;8;13;213594;223900;09;437494
52;2021-03-07;15;18;33;240818;255197;19;496015
52;2021-03-07;12;16;28;197010;200630;29;397640
52;2021-03-07;13;6;19;231204;224885;39;456089
52;2021-03-07;28;14;42;243874;243418;49;487292
52;2021-03-07;6;18;24;244100;239116;59;483216
52;2021-03-07;7;5;12;241796;221345;69;463141
52;2021-03-07;2;5;7;177805;149903;79;327708
52;2021-03-07;1;7;8;119561;75822;89;195383
52;2021-03-07;0;1;1;42559;15260;90;57819
52;2021-03-07;89;98;187;1952321;1849476;0;3801797
53;2021-03-07;1;4;5;173813;182358;09;356171
53;2021-03-07;15;9;24;202720;214740;19;417460
53;2021-03-07;14;5;19;163116;173196;29;336312
53;2021-03-07;9;5;14;190526;187674;39;378200
53;2021-03-07;4;10;14;212098;212015;49;424113
53;2021-03-07;11;6;17;223699;219176;59;442875
53;2021-03-07;1;5;6;227435;209274;69;436709
53;2021-03-07;0;0;0;169992;140910;79;310902
53;2021-03-07;4;0;4;118117;69883;89;188000
53;2021-03-07;3;0;3;37370;12267;90;49637
53;2021-03-07;62;44;106;1718886;1621493;0;3340379
75;2021-03-07;2;6;8;293104;305291;09;598395
75;2021-03-07;7;9;16;337141;357785;19;694926
75;2021-03-07;10;8;18;295024;300618;29;595642
75;2021-03-07;9;12;21;347871;331233;39;679104
75;2021-03-07;5;7;12;384742;372771;49;757513
75;2021-03-07;11;5;16;413361;390880;59;804241
75;2021-03-07;1;3;4;425623;384060;69;809683
75;2021-03-07;6;3;9;325086;276298;79;601384
75;2021-03-07;6;5;11;213986;139308;89;353294
75;2021-03-07;1;4;5;77600;28200;90;105800
75;2021-03-07;58;62;120;3113538;2886444;0;5999982
76;2021-03-07;7;3;10;305956;318589;09;624545
76;2021-03-07;12;6;18;338942;356969;19;695911
76;2021-03-07;14;12;26;316210;319570;29;635780
76;2021-03-07;18;13;31;356758;337587;39;694345
76;2021-03-07;15;13;28;376541;363812;49;740353
76;2021-03-07;19;15;34;402608;383750;59;786358
76;2021-03-07;12;10;22;394889;358997;69;753886
76;2021-03-07;4;7;11;308664;263806;79;572470
76;2021-03-07;10;7;17;195838;129272;89;325110
76;2021-03-07;2;0;2;69372;26728;90;96100
76;2021-03-07;113;86;199;3065778;2859080;0;5924858
84;2021-03-07;10;12;22;459549;481088;09;940637
84;2021-03-07;21;13;34;487711;511905;19;999616
84;2021-03-07;12;27;39;443824;451094;29;894918
84;2021-03-07;30;25;55;512522;493262;39;1005784
84;2021-03-07;21;27;48;520248;515106;49;1035354
84;2021-03-07;17;23;40;529611;514848;59;1044459
84;2021-03-07;20;20;40;486720;439940;69;926660
84;2021-03-07;7;9;16;372151;315211;79;687362
84;2021-03-07;9;9;18;237198;150524;89;387722
84;2021-03-07;8;3;11;81185;28680;90;109865
84;2021-03-07;155;168;323;4130719;3901658;0;8032377
93;2021-03-07;7;8;15;268834;283093;09;551927
93;2021-03-07;20;27;47;280751;296087;19;576838
93;2021-03-07;31;17;48;254404;255552;29;509956
93;2021-03-07;41;38;79;310704;288398;39;599102
93;2021-03-07;35;40;75;325559;305827;49;631386
93;2021-03-07;35;32;67;353104;325389;59;678493
93;2021-03-07;20;20;40;336327;296459;69;632786
93;2021-03-07;14;14;28;279820;229699;79;509519
93;2021-03-07;14;10;24;171274;113716;89;284990
93;2021-03-07;11;3;14;58896;21758;90;80654
93;2021-03-07;228;209;437;2639673;2415978;0;5055651
94;2021-03-07;0;0;0;16311;17433;09;33744
94;2021-03-07;1;0;1;16679;18132;19;34811
94;2021-03-07;0;1;1;16782;16579;29;33361
94;2021-03-07;1;0;1;23044;20580;39;43624
94;2021-03-07;0;0;0;23065;22140;49;45205
94;2021-03-07;1;1;2;24549;23421;59;47970
94;2021-03-07;0;0;0;23212;21883;69;45095
94;2021-03-07;0;0;0;19544;17141;79;36685
94;2021-03-07;0;0;0;11227;8178;89;19405
94;2021-03-07;1;0;1;3332;1447;90;4779
94;2021-03-07;4;2;6;177745;166934;0;344679
01;2021-03-08;0;0;0;19979;20155;09;40134
01;2021-03-08;3;6;9;24994;25489;19;50483
01;2021-03-08;6;6;12;17868;16690;29;34558
01;2021-03-08;5;3;8;22328;14821;39;37149
01;2021-03-08;9;3;12;28652;20276;49;48928
01;2021-03-08;7;12;19;33264;27260;59;60524
01;2021-03-08;2;6;8;27135;23978;69;51113
01;2021-03-08;0;0;0;18401;14661;79;33062
01;2021-03-08;2;1;3;9633;6375;89;16008
01;2021-03-08;0;0;0;3410;1510;90;4920
01;2021-03-08;34;37;71;205664;171215;0;376879
02;2021-03-08;0;0;0;16881;17110;09;33991
02;2021-03-08;0;2;2;21410;21604;19;43014
02;2021-03-08;1;4;5;16017;15479;29;31496
02;2021-03-08;2;5;7;19825;14455;39;34280
02;2021-03-08;2;1;3;24719;18248;49;42967
02;2021-03-08;6;2;8;34361;28310;59;62671
02;2021-03-08;1;3;4;28061;24495;69;52556
02;2021-03-08;0;0;0;18231;15278;79;33509
02;2021-03-08;1;0;1;11090;7677;89;18767
02;2021-03-08;0;0;0;3992;1506;90;5498
02;2021-03-08;13;17;30;194587;164162;0;358749
03;2021-03-08;0;0;0;31123;30920;09;62043
03;2021-03-08;2;2;4;29370;29268;19;58638
03;2021-03-08;0;0;0;21458;18963;29;40421
03;2021-03-08;1;0;1;21276;18326;39;39602
03;2021-03-08;1;2;3;18164;16593;49;34757
03;2021-03-08;1;1;2;13469;13557;59;27026
03;2021-03-08;1;1;2;8776;8670;69;17446
03;2021-03-08;0;0;0;3777;3591;79;7368
03;2021-03-08;0;0;0;1649;1072;89;2721
03;2021-03-08;0;0;0;485;184;90;669
03;2021-03-08;6;6;12;149547;141144;0;290691
04;2021-03-08;9;6;15;60314;61377;09;121691
04;2021-03-08;15;14;29;66065;68387;19;134452
04;2021-03-08;25;16;41;51059;47156;29;98215
04;2021-03-08;21;11;32;58788;45780;39;104568
04;2021-03-08;23;15;38;61408;52207;49;113615
04;2021-03-08;14;16;30;64838;60759;59;125597
04;2021-03-08;3;7;10;47008;42843;69;89851
04;2021-03-08;6;2;8;25509;21184;79;46693
04;2021-03-08;2;1;3;13168;7647;89;20815
04;2021-03-08;0;0;0;3209;1253;90;4462
04;2021-03-08;118;88;206;451366;408593;0;859959
05;2021-03-08;0;0;0;362.366008612902;341.338819562748;09;703.704828175651
05;2021-03-08;0;0;0;353.376145114279;370.349735405642;19;723.725880519921
05;2021-03-08;0;0;0;218.593559489256;256.539602589476;29;475.133162078732
05;2021-03-08;0;0;0;404.225408693299;360.321910454353;39;764.547319147651
05;2021-03-08;0;0;0;520.067953604221;497.108383964256;49;1017.17633756848
05;2021-03-08;0;0;0;468.146063921917;510.087601910415;59;978.233665832332
05;2021-03-08;0;0;0;340.368470050554;334.366842191253;69;674.735312241807
05;2021-03-08;0;0;0;212.598666888387;192.597753227106;79;405.196420115493
05;2021-03-08;0;0;0;148.727797095705;61.8681715431829;89;210.595968638888
05;2021-03-08;0;0;0;32.9601271090696;10.9909785719784;90;43.9511056810479
05;2021-03-08;0;0;0;3061.43020057959;2935.56979942041;0;5997
06;2021-03-08;1;1;2;42583;42380;09;84963
06;2021-03-08;3;7;10;33369;31925;19;65294
06;2021-03-08;13;16;29;21571;15080;29;36651
06;2021-03-08;11;13;24;21550;16147;39;37697
06;2021-03-08;4;7;11;14193;13939;49;28132
06;2021-03-08;2;6;8;7171;7597;59;14768
06;2021-03-08;8;6;14;3629;4117;69;7746
06;2021-03-08;2;2;4;1577;1457;79;3034
06;2021-03-08;0;1;1;531;474;89;1005
06;2021-03-08;0;0;0;88;93;90;181
06;2021-03-08;44;59;103;146262;133209;0;279471
07;2021-03-08;0;0;0;485;549;09;1034
07;2021-03-08;0;1;1;403;432;19;835
07;2021-03-08;1;4;5;764;841;29;1605
07;2021-03-08;1;3;4;824;928;39;1752
07;2021-03-08;1;2;3;788;1020;49;1808
07;2021-03-08;1;3;4;678;870;59;1548
07;2021-03-08;1;0;1;360;382;69;742
07;2021-03-08;0;0;0;231;190;79;421
07;2021-03-08;0;0;0;114;67;89;181
07;2021-03-08;0;0;0;24;11;90;35
07;2021-03-08;5;13;18;4671;5290;0;9961
08;2021-03-08;0;0;0;2715.22592983026;2997.75551488675;09;5712.98144471701
08;2021-03-08;2;0;2;2778.51901080978;3160.9156459093;19;5939.43465671908
08;2021-03-08;0;0;0;2080.8882988764;1718.16634315323;29;3799.05464202964
08;2021-03-08;0;0;0;2701.8582062647;1896.52641413317;39;4598.38462039786
08;2021-03-08;1;0;1;3151.45861023308;2460.52498233809;49;5611.98359257117
08;2021-03-08;1;1;2;2620.29868333099;2422.23566154656;59;5042.53434487755
08;2021-03-08;0;0;0;1621.44173420671;1438.58325779464;69;3060.02499200135
08;2021-03-08;0;0;0;626.575909335673;526.358467843651;79;1152.93437717932
08;2021-03-08;0;0;0;205.018522985054;140.993639349697;89;346.012162334751
08;2021-03-08;0;0;0;50.0325684687745;20.62259870351;90;70.6551671722846
08;2021-03-08;4;1;5;18551.3174743414;16782.6825256586;0;35334
11;2021-03-08;218;223;471;783071;811785;09;1594856
11;2021-03-08;658;689;1393;761456;784653;19;1546109
11;2021-03-08;938;821;1766;850145;801772;29;1651917
11;2021-03-08;958;848;1814;914360;843488;39;1757848
11;2021-03-08;834;792;1629;845609;826202;49;1671811
11;2021-03-08;754;690;1449;793566;745070;59;1538636
11;2021-03-08;447;427;881;628649;549192;69;1177841
11;2021-03-08;205;187;393;434606;358356;79;792962
11;2021-03-08;110;72;182;261425;162933;89;424358
11;2021-03-08;39;16;55;89253;32619;90;121872
11;2021-03-08;5162;4766;10036;6362140;5916070;0;12278210
24;2021-03-08;21;17;38;139720;144686;09;284406
24;2021-03-08;40;59;101;152979;161185;19;314164
24;2021-03-08;94;96;190;122237;126536;29;248773
24;2021-03-08;96;97;193;150359;142009;39;292368
24;2021-03-08;87;85;173;161829;158758;49;320587
24;2021-03-08;62;79;141;172552;168011;59;340563
24;2021-03-08;59;57;116;172509;158177;69;330686
24;2021-03-08;34;29;63;129428;110593;79;240021
24;2021-03-08;9;13;22;87342;56882;89;144224
24;2021-03-08;10;1;11;31210;12071;90;43281
24;2021-03-08;512;533;1048;1320165;1238908;0;2559073
27;2021-03-08;15;29;44;143373;149679;09;293052
27;2021-03-08;74;87;161;160962;173003;19;333965
27;2021-03-08;77;94;171;133746;142254;29;276000
27;2021-03-08;78;74;152;160004;155407;39;315411
27;2021-03-08;78;65;143;172333;169564;49;341897
27;2021-03-08;69;69;138;189979;183788;59;373767
27;2021-03-08;43;59;102;192591;178206;69;370797
27;2021-03-08;34;33;67;146876;127546;79;274422
27;2021-03-08;16;10;26;96896;61575;89;158471
27;2021-03-08;12;4;16;33148;12109;90;45257
27;2021-03-08;496;524;1020;1429908;1353131;0;2783039
28;2021-03-08;33;31;66;180735;186856;09;367591
28;2021-03-08;86;89;177;200125;213621;19;413746
28;2021-03-08;103;72;175;168922;173007;29;341929
28;2021-03-08;105;82;187;196628;188487;39;385115
28;2021-03-08;116;107;223;205396;201699;49;407095
28;2021-03-08;115;89;204;222002;213866;59;435868
28;2021-03-08;64;64;128;224688;203758;69;428446
28;2021-03-08;43;37;80;163192;135543;79;298735
28;2021-03-08;27;22;49;109691;65377;89;175068
28;2021-03-08;15;4;19;37222;12685;90;49907
28;2021-03-08;707;597;1308;1708601;1594899;0;3303500
32;2021-03-08;131;133;264;358062;373689;09;731751
32;2021-03-08;348;310;658;387045;406742;19;793787
32;2021-03-08;392;366;759;342304;348587;29;690891
32;2021-03-08;385;320;706;382485;369972;39;752457
32;2021-03-08;355;394;750;382510;376716;49;759226
32;2021-03-08;317;305;622;386937;376527;59;763464
32;2021-03-08;260;202;462;371211;330938;69;702149
32;2021-03-08;152;148;300;250542;201459;79;452001
32;2021-03-08;93;60;153;163399;89786;89;253185
32;2021-03-08;43;12;55;48384;15367;90;63751
32;2021-03-08;2476;2250;4729;3072879;2889783;0;5962662
44;2021-03-08;56;40;97;291525;306839;09;598364
44;2021-03-08;188;168;357;320255;339504;19;659759
44;2021-03-08;205;212;419;302020;314428;29;616448
44;2021-03-08;183;174;357;342222;333292;39;675514
44;2021-03-08;192;196;388;349727;344491;49;694218
44;2021-03-08;156;181;340;381371;373239;59;754610
44;2021-03-08;114;122;237;367165;335850;69;703015
44;2021-03-08;70;63;134;250387;215436;79;465823
44;2021-03-08;54;32;87;170825;105192;89;276017
44;2021-03-08;26;8;34;51248;16731;90;67979
44;2021-03-08;1244;1197;2451;2826745;2685002;0;5511747
52;2021-03-08;27;25;55;213594;223900;09;437494
52;2021-03-08;100;87;188;240818;255197;19;496015
52;2021-03-08;92;83;175;197010;200630;29;397640
52;2021-03-08;90;58;148;231204;224885;39;456089
52;2021-03-08;91;92;183;243874;243418;49;487292
52;2021-03-08;78;87;166;244100;239116;59;483216
52;2021-03-08;40;49;89;241796;221345;69;463141
52;2021-03-08;43;31;74;177805;149903;79;327708
52;2021-03-08;14;18;32;119561;75822;89;195383
52;2021-03-08;13;4;17;42559;15260;90;57819
52;2021-03-08;588;535;1128;1952321;1849476;0;3801797
53;2021-03-08;19;22;41;173813;182358;09;356171
53;2021-03-08;84;81;167;202720;214740;19;417460
53;2021-03-08;76;67;144;163116;173196;29;336312
53;2021-03-08;60;47;107;190526;187674;39;378200
53;2021-03-08;82;79;161;212098;212015;49;424113
53;2021-03-08;61;46;107;223699;219176;59;442875
53;2021-03-08;46;27;73;227435;209274;69;436709
53;2021-03-08;21;34;55;169992;140910;79;310902
53;2021-03-08;20;6;26;118117;69883;89;188000
53;2021-03-08;4;1;5;37370;12267;90;49637
53;2021-03-08;473;410;886;1718886;1621493;0;3340379
75;2021-03-08;42;38;80;293104;305291;09;598395
75;2021-03-08;98;111;210;337141;357785;19;694926
75;2021-03-08;118;99;217;295024;300618;29;595642
75;2021-03-08;138;94;232;347871;331233;39;679104
75;2021-03-08;121;93;214;384742;372771;49;757513
75;2021-03-08;104;85;190;413361;390880;59;804241
75;2021-03-08;68;95;163;425623;384060;69;809683
75;2021-03-08;47;49;96;325086;276298;79;601384
75;2021-03-08;27;23;50;213986;139308;89;353294
75;2021-03-08;9;4;13;77600;28200;90;105800
75;2021-03-08;772;691;1465;3113538;2886444;0;5999982
76;2021-03-08;46;38;87;305956;318589;09;624545
76;2021-03-08;169;147;320;338942;356969;19;695911
76;2021-03-08;181;120;302;316210;319570;29;635780
76;2021-03-08;176;152;328;356758;337587;39;694345
76;2021-03-08;188;153;342;376541;363812;49;740353
76;2021-03-08;141;148;289;402608;383750;59;786358
76;2021-03-08;98;81;179;394889;358997;69;753886
76;2021-03-08;72;55;127;308664;263806;79;572470
76;2021-03-08;22;24;46;195838;129272;89;325110
76;2021-03-08;15;8;23;69372;26728;90;96100
76;2021-03-08;1109;926;2045;3065778;2859080;0;5924858
84;2021-03-08;104;83;188;459549;481088;09;940637
84;2021-03-08;243;218;462;487711;511905;19;999616
84;2021-03-08;279;258;537;443824;451094;29;894918
84;2021-03-08;280;267;548;512522;493262;39;1005784
84;2021-03-08;280;255;535;520248;515106;49;1035354
84;2021-03-08;233;244;479;529611;514848;59;1044459
84;2021-03-08;156;143;299;486720;439940;69;926660
84;2021-03-08;115;105;220;372151;315211;79;687362
84;2021-03-08;64;59;123;237198;150524;89;387722
84;2021-03-08;29;6;35;81185;28680;90;109865
84;2021-03-08;1783;1638;3426;4130719;3901658;0;8032377
93;2021-03-08;67;80;148;268834;283093;09;551927
93;2021-03-08;277;295;573;280751;296087;19;576838
93;2021-03-08;304;257;562;254404;255552;29;509956
93;2021-03-08;355;278;634;310704;288398;39;599102
93;2021-03-08;400;314;714;325559;305827;49;631386
93;2021-03-08;316;323;641;353104;325389;59;678493
93;2021-03-08;225;212;437;336327;296459;69;632786
93;2021-03-08;149;123;273;279820;229699;79;509519
93;2021-03-08;65;49;114;171274;113716;89;284990
93;2021-03-08;40;18;58;58896;21758;90;80654
93;2021-03-08;2198;1949;4155;2639673;2415978;0;5055651
94;2021-03-08;2;1;3;16311;17433;09;33744
94;2021-03-08;9;5;14;16679;18132;19;34811
94;2021-03-08;11;7;18;16782;16579;29;33361
94;2021-03-08;3;8;11;23044;20580;39;43624
94;2021-03-08;5;10;15;23065;22140;49;45205
94;2021-03-08;13;6;19;24549;23421;59;47970
94;2021-03-08;3;13;16;23212;21883;69;45095
94;2021-03-08;7;6;13;19544;17141;79;36685
94;2021-03-08;3;4;7;11227;8178;89;19405
94;2021-03-08;3;0;3;3332;1447;90;4779
94;2021-03-08;59;60;119;177745;166934;0;344679
01;2021-03-09;0;1;1;19979;20155;09;40134
01;2021-03-09;8;2;10;24994;25489;19;50483
01;2021-03-09;4;4;8;17868;16690;29;34558
01;2021-03-09;4;2;6;22328;14821;39;37149
01;2021-03-09;8;4;12;28652;20276;49;48928
01;2021-03-09;7;5;12;33264;27260;59;60524
01;2021-03-09;4;5;9;27135;23978;69;51113
01;2021-03-09;0;2;2;18401;14661;79;33062
01;2021-03-09;0;0;0;9633;6375;89;16008
01;2021-03-09;0;0;0;3410;1510;90;4920
01;2021-03-09;35;25;60;205664;171215;0;376879
02;2021-03-09;0;0;0;16881;17110;09;33991
02;2021-03-09;1;2;3;21410;21604;19;43014
02;2021-03-09;5;0;5;16017;15479;29;31496
02;2021-03-09;5;2;7;19825;14455;39;34280
02;2021-03-09;1;4;5;24719;18248;49;42967
02;2021-03-09;1;4;5;34361;28310;59;62671
02;2021-03-09;4;0;4;28061;24495;69;52556
02;2021-03-09;1;1;2;18231;15278;79;33509
02;2021-03-09;1;0;1;11090;7677;89;18767
02;2021-03-09;0;0;0;3992;1506;90;5498
02;2021-03-09;19;13;32;194587;164162;0;358749
03;2021-03-09;0;2;2;31123;30920;09;62043
03;2021-03-09;1;3;4;29370;29268;19;58638
03;2021-03-09;0;0;0;21458;18963;29;40421
03;2021-03-09;0;0;0;21276;18326;39;39602
03;2021-03-09;0;1;1;18164;16593;49;34757
03;2021-03-09;0;0;0;13469;13557;59;27026
03;2021-03-09;0;0;0;8776;8670;69;17446
03;2021-03-09;0;0;0;3777;3591;79;7368
03;2021-03-09;0;0;0;1649;1072;89;2721
03;2021-03-09;0;0;0;485;184;90;669
03;2021-03-09;1;6;7;149547;141144;0;290691
04;2021-03-09;5;4;9;60314;61377;09;121691
04;2021-03-09;11;15;26;66065;68387;19;134452
04;2021-03-09;13;8;21;51059;47156;29;98215
04;2021-03-09;19;8;27;58788;45780;39;104568
04;2021-03-09;5;6;11;61408;52207;49;113615
04;2021-03-09;13;12;25;64838;60759;59;125597
04;2021-03-09;10;9;19;47008;42843;69;89851
04;2021-03-09;4;2;6;25509;21184;79;46693
04;2021-03-09;4;0;4;13168;7647;89;20815
04;2021-03-09;0;0;0;3209;1253;90;4462
04;2021-03-09;84;64;148;451366;408593;0;859959
05;2021-03-09;0;0;0;362.366008612902;341.338819562748;09;703.704828175651
05;2021-03-09;0;0;0;353.376145114279;370.349735405642;19;723.725880519921
05;2021-03-09;0;0;0;218.593559489256;256.539602589476;29;475.133162078732
05;2021-03-09;0;0;0;404.225408693299;360.321910454353;39;764.547319147651
05;2021-03-09;0;0;0;520.067953604221;497.108383964256;49;1017.17633756848
05;2021-03-09;0;0;0;468.146063921917;510.087601910415;59;978.233665832332
05;2021-03-09;0;0;0;340.368470050554;334.366842191253;69;674.735312241807
05;2021-03-09;0;0;0;212.598666888387;192.597753227106;79;405.196420115493
05;2021-03-09;0;0;0;148.727797095705;61.8681715431829;89;210.595968638888
05;2021-03-09;0;0;0;32.9601271090696;10.9909785719784;90;43.9511056810479
05;2021-03-09;0;0;0;3061.43020057959;2935.56979942041;0;5997
06;2021-03-09;0;2;2;42583;42380;09;84963
06;2021-03-09;5;9;14;33369;31925;19;65294
06;2021-03-09;10;20;30;21571;15080;29;36651
06;2021-03-09;9;9;18;21550;16147;39;37697
06;2021-03-09;13;10;23;14193;13939;49;28132
06;2021-03-09;2;6;8;7171;7597;59;14768
06;2021-03-09;2;2;4;3629;4117;69;7746
06;2021-03-09;0;1;1;1577;1457;79;3034
06;2021-03-09;0;0;0;531;474;89;1005
06;2021-03-09;0;0;0;88;93;90;181
06;2021-03-09;41;59;100;146262;133209;0;279471
07;2021-03-09;0;0;0;485;549;09;1034
07;2021-03-09;0;0;0;403;432;19;835
07;2021-03-09;2;0;2;764;841;29;1605
07;2021-03-09;2;1;3;824;928;39;1752
07;2021-03-09;0;0;0;788;1020;49;1808
07;2021-03-09;0;0;0;678;870;59;1548
07;2021-03-09;0;0;0;360;382;69;742
07;2021-03-09;0;0;0;231;190;79;421
07;2021-03-09;0;0;0;114;67;89;181
07;2021-03-09;0;0;0;24;11;90;35
07;2021-03-09;4;1;5;4671;5290;0;9961
08;2021-03-09;0;0;0;2715.22592983026;2997.75551488675;09;5712.98144471701
08;2021-03-09;1;0;1;2778.51901080978;3160.9156459093;19;5939.43465671908
08;2021-03-09;1;0;1;2080.8882988764;1718.16634315323;29;3799.05464202964
08;2021-03-09;0;0;0;2701.8582062647;1896.52641413317;39;4598.38462039786
08;2021-03-09;0;0;0;3151.45861023308;2460.52498233809;49;5611.98359257117
08;2021-03-09;1;0;1;2620.29868333099;2422.23566154656;59;5042.53434487755
08;2021-03-09;0;0;0;1621.44173420671;1438.58325779464;69;3060.02499200135
08;2021-03-09;0;1;1;626.575909335673;526.358467843651;79;1152.93437717932
08;2021-03-09;0;0;0;205.018522985054;140.993639349697;89;346.012162334751
08;2021-03-09;0;0;0;50.0325684687745;20.62259870351;90;70.6551671722846
08;2021-03-09;3;1;4;18551.3174743414;16782.6825256586;0;35334
11;2021-03-09;182;220;434;783071;811785;09;1594856
11;2021-03-09;558;559;1175;761456;784653;19;1546109
11;2021-03-09;812;781;1598;850145;801772;29;1651917
11;2021-03-09;761;761;1531;914360;843488;39;1757848
11;2021-03-09;696;612;1313;845609;826202;49;1671811
11;2021-03-09;595;552;1155;793566;745070;59;1538636
11;2021-03-09;355;348;720;628649;549192;69;1177841
11;2021-03-09;164;159;323;434606;358356;79;792962
11;2021-03-09;112;71;183;261425;162933;89;424358
11;2021-03-09;35;19;54;89253;32619;90;121872
11;2021-03-09;4270;4083;8488;6362140;5916070;0;12278210
24;2021-03-09;11;15;26;139720;144686;09;284406
24;2021-03-09;57;64;123;152979;161185;19;314164
24;2021-03-09;63;61;125;122237;126536;29;248773
24;2021-03-09;52;52;104;150359;142009;39;292368
24;2021-03-09;70;61;131;161829;158758;49;320587
24;2021-03-09;67;58;125;172552;168011;59;340563
24;2021-03-09;45;37;82;172509;158177;69;330686
24;2021-03-09;25;26;51;129428;110593;79;240021
24;2021-03-09;16;6;22;87342;56882;89;144224
24;2021-03-09;4;1;5;31210;12071;90;43281
24;2021-03-09;410;381;794;1320165;1238908;0;2559073
27;2021-03-09;12;15;27;143373;149679;09;293052
27;2021-03-09;66;99;167;160962;173003;19;333965
27;2021-03-09;62;63;125;133746;142254;29;276000
27;2021-03-09;50;45;95;160004;155407;39;315411
27;2021-03-09;59;55;114;172333;169564;49;341897
27;2021-03-09;48;54;102;189979;183788;59;373767
27;2021-03-09;52;44;96;192591;178206;69;370797
27;2021-03-09;31;25;56;146876;127546;79;274422
27;2021-03-09;16;17;33;96896;61575;89;158471
27;2021-03-09;9;3;12;33148;12109;90;45257
27;2021-03-09;405;420;828;1429908;1353131;0;2783039
28;2021-03-09;21;23;44;180735;186856;09;367591
28;2021-03-09;68;77;146;200125;213621;19;413746
28;2021-03-09;82;91;174;168922;173007;29;341929
28;2021-03-09;89;69;158;196628;188487;39;385115
28;2021-03-09;99;73;172;205396;201699;49;407095
28;2021-03-09;86;74;160;222002;213866;59;435868
28;2021-03-09;64;44;108;224688;203758;69;428446
28;2021-03-09;42;42;84;163192;135543;79;298735
28;2021-03-09;29;23;52;109691;65377;89;175068
28;2021-03-09;11;3;14;37222;12685;90;49907
28;2021-03-09;591;519;1112;1708601;1594899;0;3303500
32;2021-03-09;92;106;198;358062;373689;09;731751
32;2021-03-09;257;294;552;387045;406742;19;793787
32;2021-03-09;298;267;565;342304;348587;29;690891
32;2021-03-09;298;251;549;382485;369972;39;752457
32;2021-03-09;301;257;558;382510;376716;49;759226
32;2021-03-09;243;244;487;386937;376527;59;763464
32;2021-03-09;198;181;379;371211;330938;69;702149
32;2021-03-09;138;104;242;250542;201459;79;452001
32;2021-03-09;87;52;139;163399;89786;89;253185
32;2021-03-09;51;15;66;48384;15367;90;63751
32;2021-03-09;1963;1771;3735;3072879;2889783;0;5962662
44;2021-03-09;47;48;96;291525;306839;09;598364
44;2021-03-09;125;146;273;320255;339504;19;659759
44;2021-03-09;149;149;299;302020;314428;29;616448
44;2021-03-09;161;124;287;342222;333292;39;675514
44;2021-03-09;140;123;264;349727;344491;49;694218
44;2021-03-09;132;145;278;381371;373239;59;754610
44;2021-03-09;119;73;192;367165;335850;69;703015
44;2021-03-09;53;47;102;250387;215436;79;465823
44;2021-03-09;59;34;94;170825;105192;89;276017
44;2021-03-09;19;9;28;51248;16731;90;67979
44;2021-03-09;1004;898;1913;2826745;2685002;0;5511747
52;2021-03-09;23;23;46;213594;223900;09;437494
52;2021-03-09;57;62;121;240818;255197;19;496015
52;2021-03-09;79;81;161;197010;200630;29;397640
52;2021-03-09;53;73;126;231204;224885;39;456089
52;2021-03-09;61;73;134;243874;243418;49;487292
52;2021-03-09;77;63;140;244100;239116;59;483216
52;2021-03-09;42;59;101;241796;221345;69;463141
52;2021-03-09;34;31;65;177805;149903;79;327708
52;2021-03-09;26;18;44;119561;75822;89;195383
52;2021-03-09;14;5;19;42559;15260;90;57819
52;2021-03-09;466;488;957;1952321;1849476;0;3801797
53;2021-03-09;16;26;43;173813;182358;09;356171
53;2021-03-09;62;69;132;202720;214740;19;417460
53;2021-03-09;79;63;143;163116;173196;29;336312
53;2021-03-09;39;55;94;190526;187674;39;378200
53;2021-03-09;63;70;133;212098;212015;49;424113
53;2021-03-09;46;52;98;223699;219176;59;442875
53;2021-03-09;40;35;75;227435;209274;69;436709
53;2021-03-09;20;14;34;169992;140910;79;310902
53;2021-03-09;11;8;19;118117;69883;89;188000
53;2021-03-09;12;4;16;37370;12267;90;49637
53;2021-03-09;388;396;787;1718886;1621493;0;3340379
75;2021-03-09;44;51;97;293104;305291;09;598395
75;2021-03-09;151;134;287;337141;357785;19;694926
75;2021-03-09;101;107;208;295024;300618;29;595642
75;2021-03-09;97;73;170;347871;331233;39;679104
75;2021-03-09;123;93;217;384742;372771;49;757513
75;2021-03-09;100;78;178;413361;390880;59;804241
75;2021-03-09;50;59;109;425623;384060;69;809683
75;2021-03-09;39;41;80;325086;276298;79;601384
75;2021-03-09;33;26;59;213986;139308;89;353294
75;2021-03-09;13;10;23;77600;28200;90;105800
75;2021-03-09;752;672;1429;3113538;2886444;0;5999982
76;2021-03-09;32;32;68;305956;318589;09;624545
76;2021-03-09;123;148;271;338942;356969;19;695911
76;2021-03-09;107;106;213;316210;319570;29;635780
76;2021-03-09;135;109;244;356758;337587;39;694345
76;2021-03-09;112;115;227;376541;363812;49;740353
76;2021-03-09;93;101;194;402608;383750;59;786358
76;2021-03-09;89;81;170;394889;358997;69;753886
76;2021-03-09;57;38;95;308664;263806;79;572470
76;2021-03-09;42;19;61;195838;129272;89;325110
76;2021-03-09;16;7;23;69372;26728;90;96100
76;2021-03-09;809;757;1570;3065778;2859080;0;5924858
84;2021-03-09;92;82;176;459549;481088;09;940637
84;2021-03-09;208;204;412;487711;511905;19;999616
84;2021-03-09;218;204;422;443824;451094;29;894918
84;2021-03-09;213;173;386;512522;493262;39;1005784
84;2021-03-09;228;201;429;520248;515106;49;1035354
84;2021-03-09;192;177;369;529611;514848;59;1044459
84;2021-03-09;134;131;265;486720;439940;69;926660
84;2021-03-09;64;71;135;372151;315211;79;687362
84;2021-03-09;48;40;88;237198;150524;89;387722
84;2021-03-09;34;13;47;81185;28680;90;109865
84;2021-03-09;1431;1296;2730;4130719;3901658;0;8032377
93;2021-03-09;51;60;111;268834;283093;09;551927
93;2021-03-09;201;196;399;280751;296087;19;576838
93;2021-03-09;202;210;413;254404;255552;29;509956
93;2021-03-09;262;175;437;310704;288398;39;599102
93;2021-03-09;271;238;510;325559;305827;49;631386
93;2021-03-09;246;217;463;353104;325389;59;678493
93;2021-03-09;158;180;339;336327;296459;69;632786
93;2021-03-09;129;102;231;279820;229699;79;509519
93;2021-03-09;75;50;125;171274;113716;89;284990
93;2021-03-09;31;8;39;58896;21758;90;80654
93;2021-03-09;1627;1436;3073;2639673;2415978;0;5055651
94;2021-03-09;5;2;7;16311;17433;09;33744
94;2021-03-09;3;6;9;16679;18132;19;34811
94;2021-03-09;7;5;12;16782;16579;29;33361
94;2021-03-09;12;6;18;23044;20580;39;43624
94;2021-03-09;9;12;21;23065;22140;49;45205
94;2021-03-09;4;6;10;24549;23421;59;47970
94;2021-03-09;4;6;10;23212;21883;69;45095
94;2021-03-09;3;4;7;19544;17141;79;36685
94;2021-03-09;0;3;3;11227;8178;89;19405
94;2021-03-09;2;1;3;3332;1447;90;4779
94;2021-03-09;49;51;100;177745;166934;0;344679
01;2021-03-10;0;0;0;19979;20155;09;40134
01;2021-03-10;1;1;2;24994;25489;19;50483
01;2021-03-10;3;4;7;17868;16690;29;34558
01;2021-03-10;3;0;3;22328;14821;39;37149
01;2021-03-10;4;0;4;28652;20276;49;48928
01;2021-03-10;6;9;15;33264;27260;59;60524
01;2021-03-10;6;2;8;27135;23978;69;51113
01;2021-03-10;0;1;1;18401;14661;79;33062
01;2021-03-10;0;0;0;9633;6375;89;16008
01;2021-03-10;0;0;0;3410;1510;90;4920
01;2021-03-10;23;17;40;205664;171215;0;376879
02;2021-03-10;0;0;0;16881;17110;09;33991
02;2021-03-10;2;1;3;21410;21604;19;43014
02;2021-03-10;4;3;7;16017;15479;29;31496
02;2021-03-10;3;2;5;19825;14455;39;34280
02;2021-03-10;1;4;5;24719;18248;49;42967
02;2021-03-10;4;1;5;34361;28310;59;62671
02;2021-03-10;1;3;4;28061;24495;69;52556
02;2021-03-10;1;0;1;18231;15278;79;33509
02;2021-03-10;1;0;1;11090;7677;89;18767
02;2021-03-10;0;0;0;3992;1506;90;5498
02;2021-03-10;17;14;31;194587;164162;0;358749
03;2021-03-10;0;0;0;31123;30920;09;62043
03;2021-03-10;0;2;2;29370;29268;19;58638
03;2021-03-10;2;0;2;21458;18963;29;40421
03;2021-03-10;1;4;5;21276;18326;39;39602
03;2021-03-10;2;0;2;18164;16593;49;34757
03;2021-03-10;1;0;1;13469;13557;59;27026
03;2021-03-10;0;1;1;8776;8670;69;17446
03;2021-03-10;0;0;0;3777;3591;79;7368
03;2021-03-10;0;0;0;1649;1072;89;2721
03;2021-03-10;0;0;0;485;184;90;669
03;2021-03-10;6;7;13;149547;141144;0;290691
04;2021-03-10;5;1;6;60314;61377;09;121691
04;2021-03-10;5;8;13;66065;68387;19;134452
04;2021-03-10;17;8;25;51059;47156;29;98215
04;2021-03-10;13;18;31;58788;45780;39;104568
04;2021-03-10;17;9;26;61408;52207;49;113615
04;2021-03-10;8;7;15;64838;60759;59;125597
04;2021-03-10;6;7;13;47008;42843;69;89851
04;2021-03-10;1;1;2;25509;21184;79;46693
04;2021-03-10;2;2;4;13168;7647;89;20815
04;2021-03-10;0;0;0;3209;1253;90;4462
04;2021-03-10;74;61;135;451366;408593;0;859959
05;2021-03-10;0;0;0;362.366008612902;341.338819562748;09;703.704828175651
05;2021-03-10;0;0;0;353.376145114279;370.349735405642;19;723.725880519921
05;2021-03-10;0;0;0;218.593559489256;256.539602589476;29;475.133162078732
05;2021-03-10;0;0;0;404.225408693299;360.321910454353;39;764.547319147651
05;2021-03-10;0;0;0;520.067953604221;497.108383964256;49;1017.17633756848
05;2021-03-10;0;0;0;468.146063921917;510.087601910415;59;978.233665832332
05;2021-03-10;0;0;0;340.368470050554;334.366842191253;69;674.735312241807
05;2021-03-10;0;0;0;212.598666888387;192.597753227106;79;405.196420115493
05;2021-03-10;0;0;0;148.727797095705;61.8681715431829;89;210.595968638888
05;2021-03-10;0;0;0;32.9601271090696;10.9909785719784;90;43.9511056810479
05;2021-03-10;0;0;0;3061.43020057959;2935.56979942041;0;5997
06;2021-03-10;2;3;5;42583;42380;09;84963
06;2021-03-10;4;3;7;33369;31925;19;65294
06;2021-03-10;4;6;10;21571;15080;29;36651
06;2021-03-10;10;8;18;21550;16147;39;37697
06;2021-03-10;5;7;12;14193;13939;49;28132
06;2021-03-10;1;11;12;7171;7597;59;14768
06;2021-03-10;6;12;18;3629;4117;69;7746
06;2021-03-10;3;0;3;1577;1457;79;3034
06;2021-03-10;0;0;0;531;474;89;1005
06;2021-03-10;0;0;0;88;93;90;181
06;2021-03-10;35;50;85;146262;133209;0;279471
07;2021-03-10;0;0;0;485;549;09;1034
07;2021-03-10;0;1;1;403;432;19;835
07;2021-03-10;3;2;5;764;841;29;1605
07;2021-03-10;0;1;1;824;928;39;1752
07;2021-03-10;0;1;1;788;1020;49;1808
07;2021-03-10;1;0;1;678;870;59;1548
07;2021-03-10;1;0;1;360;382;69;742
07;2021-03-10;0;0;0;231;190;79;421
07;2021-03-10;0;0;0;114;67;89;181
07;2021-03-10;0;0;0;24;11;90;35
07;2021-03-10;5;5;10;4671;5290;0;9961
08;2021-03-10;0;0;0;2715.22592983026;2997.75551488675;09;5712.98144471701
08;2021-03-10;0;0;0;2778.51901080978;3160.9156459093;19;5939.43465671908
08;2021-03-10;0;1;1;2080.8882988764;1718.16634315323;29;3799.05464202964
08;2021-03-10;0;0;0;2701.8582062647;1896.52641413317;39;4598.38462039786
08;2021-03-10;0;0;0;3151.45861023308;2460.52498233809;49;5611.98359257117
08;2021-03-10;1;0;1;2620.29868333099;2422.23566154656;59;5042.53434487755
08;2021-03-10;0;1;1;1621.44173420671;1438.58325779464;69;3060.02499200135
08;2021-03-10;1;0;1;626.575909335673;526.358467843651;79;1152.93437717932
08;2021-03-10;0;0;0;205.018522985054;140.993639349697;89;346.012162334751
08;2021-03-10;0;0;0;50.0325684687745;20.62259870351;90;70.6551671722846
08;2021-03-10;2;2;4;18551.3174743414;16782.6825256586;0;35334
11;2021-03-10;210;234;478;783071;811785;09;1594856
11;2021-03-10;572;576;1198;761456;784653;19;1546109
11;2021-03-10;962;809;1783;850145;801772;29;1651917
11;2021-03-10;842;769;1620;914360;843488;39;1757848
11;2021-03-10;764;668;1438;845609;826202;49;1671811
11;2021-03-10;602;569;1174;793566;745070;59;1538636
11;2021-03-10;360;343;714;628649;549192;69;1177841
11;2021-03-10;183;149;334;434606;358356;79;792962
11;2021-03-10;97;73;170;261425;162933;89;424358
11;2021-03-10;41;8;49;89253;32619;90;121872
11;2021-03-10;4635;4198;8961;6362140;5916070;0;12278210
24;2021-03-10;7;18;25;139720;144686;09;284406
24;2021-03-10;46;67;114;152979;161185;19;314164
24;2021-03-10;60;63;123;122237;126536;29;248773
24;2021-03-10;62;57;119;150359;142009;39;292368
24;2021-03-10;64;55;119;161829;158758;49;320587
24;2021-03-10;55;49;104;172552;168011;59;340563
24;2021-03-10;41;36;78;172509;158177;69;330686
24;2021-03-10;26;24;50;129428;110593;79;240021
24;2021-03-10;20;10;30;87342;56882;89;144224
24;2021-03-10;9;3;12;31210;12071;90;43281
24;2021-03-10;390;382;774;1320165;1238908;0;2559073
27;2021-03-10;16;27;43;143373;149679;09;293052
27;2021-03-10;86;73;160;160962;173003;19;333965
27;2021-03-10;58;72;130;133746;142254;29;276000
27;2021-03-10;62;58;120;160004;155407;39;315411
27;2021-03-10;61;59;120;172333;169564;49;341897
27;2021-03-10;55;64;119;189979;183788;59;373767
27;2021-03-10;41;38;79;192591;178206;69;370797
27;2021-03-10;19;19;38;146876;127546;79;274422
27;2021-03-10;15;19;34;96896;61575;89;158471
27;2021-03-10;6;3;9;33148;12109;90;45257
27;2021-03-10;419;432;852;1429908;1353131;0;2783039
28;2021-03-10;35;27;62;180735;186856;09;367591
28;2021-03-10;112;78;193;200125;213621;19;413746
28;2021-03-10;108;90;198;168922;173007;29;341929
28;2021-03-10;104;81;185;196628;188487;39;385115
28;2021-03-10;99;96;195;205396;201699;49;407095
28;2021-03-10;91;79;170;222002;213866;59;435868
28;2021-03-10;67;51;118;224688;203758;69;428446
28;2021-03-10;47;30;77;163192;135543;79;298735
28;2021-03-10;23;13;36;109691;65377;89;175068
28;2021-03-10;12;6;18;37222;12685;90;49907
28;2021-03-10;698;551;1252;1708601;1594899;0;3303500
32;2021-03-10;102;96;198;358062;373689;09;731751
32;2021-03-10;288;300;588;387045;406742;19;793787
32;2021-03-10;333;251;584;342304;348587;29;690891
32;2021-03-10;317;255;572;382485;369972;39;752457
32;2021-03-10;270;270;540;382510;376716;49;759226
32;2021-03-10;219;220;439;386937;376527;59;763464
32;2021-03-10;159;168;328;371211;330938;69;702149
32;2021-03-10;123;101;224;250542;201459;79;452001
32;2021-03-10;66;52;118;163399;89786;89;253185
32;2021-03-10;27;6;33;48384;15367;90;63751
32;2021-03-10;1905;1721;3627;3072879;2889783;0;5962662
44;2021-03-10;49;58;109;291525;306839;09;598364
44;2021-03-10;140;153;294;320255;339504;19;659759
44;2021-03-10;145;165;310;302020;314428;29;616448
44;2021-03-10;148;141;290;342222;333292;39;675514
44;2021-03-10;147;145;295;349727;344491;49;694218
44;2021-03-10;128;135;265;381371;373239;59;754610
44;2021-03-10;86;107;194;367165;335850;69;703015
44;2021-03-10;47;37;84;250387;215436;79;465823
44;2021-03-10;54;32;87;170825;105192;89;276017
44;2021-03-10;30;6;37;51248;16731;90;67979
44;2021-03-10;974;979;1965;2826745;2685002;0;5511747
52;2021-03-10;23;27;53;213594;223900;09;437494
52;2021-03-10;74;94;170;240818;255197;19;496015
52;2021-03-10;108;83;192;197010;200630;29;397640
52;2021-03-10;93;73;166;231204;224885;39;456089
52;2021-03-10;92;77;169;243874;243418;49;487292
52;2021-03-10;86;64;150;244100;239116;59;483216
52;2021-03-10;41;43;84;241796;221345;69;463141
52;2021-03-10;28;24;52;177805;149903;79;327708
52;2021-03-10;23;13;36;119561;75822;89;195383
52;2021-03-10;9;5;14;42559;15260;90;57819
52;2021-03-10;577;503;1086;1952321;1849476;0;3801797
53;2021-03-10;19;22;41;173813;182358;09;356171
53;2021-03-10;71;76;147;202720;214740;19;417460
53;2021-03-10;70;74;144;163116;173196;29;336312
53;2021-03-10;50;48;98;190526;187674;39;378200
53;2021-03-10;47;47;94;212098;212015;49;424113
53;2021-03-10;53;46;99;223699;219176;59;442875
53;2021-03-10;26;35;61;227435;209274;69;436709
53;2021-03-10;17;18;35;169992;140910;79;310902
53;2021-03-10;16;6;22;118117;69883;89;188000
53;2021-03-10;5;0;5;37370;12267;90;49637
53;2021-03-10;374;372;746;1718886;1621493;0;3340379
75;2021-03-10;31;40;71;293104;305291;09;598395
75;2021-03-10;86;106;193;337141;357785;19;694926
75;2021-03-10;109;95;204;295024;300618;29;595642
75;2021-03-10;93;87;180;347871;331233;39;679104
75;2021-03-10;88;83;171;384742;372771;49;757513
75;2021-03-10;86;76;162;413361;390880;59;804241
75;2021-03-10;61;52;113;425623;384060;69;809683
75;2021-03-10;42;34;76;325086;276298;79;601384
75;2021-03-10;19;17;36;213986;139308;89;353294
75;2021-03-10;7;8;15;77600;28200;90;105800
75;2021-03-10;622;598;1221;3113538;2886444;0;5999982
76;2021-03-10;45;55;101;305956;318589;09;624545
76;2021-03-10;124;118;243;338942;356969;19;695911
76;2021-03-10;123;110;233;316210;319570;29;635780
76;2021-03-10;124;99;224;356758;337587;39;694345
76;2021-03-10;140;103;243;376541;363812;49;740353
76;2021-03-10;103;115;218;402608;383750;59;786358
76;2021-03-10;79;61;140;394889;358997;69;753886
76;2021-03-10;49;36;85;308664;263806;79;572470
76;2021-03-10;24;14;38;195838;129272;89;325110
76;2021-03-10;11;14;25;69372;26728;90;96100
76;2021-03-10;822;725;1550;3065778;2859080;0;5924858
84;2021-03-10;65;83;150;459549;481088;09;940637
84;2021-03-10;240;218;459;487711;511905;19;999616
84;2021-03-10;242;229;471;443824;451094;29;894918
84;2021-03-10;246;190;436;512522;493262;39;1005784
84;2021-03-10;182;207;389;520248;515106;49;1035354
84;2021-03-10;161;166;327;529611;514848;59;1044459
84;2021-03-10;122;107;230;486720;439940;69;926660
84;2021-03-10;81;84;165;372151;315211;79;687362
84;2021-03-10;56;43;99;237198;150524;89;387722
84;2021-03-10;23;17;40;81185;28680;90;109865
84;2021-03-10;1418;1344;2766;4130719;3901658;0;8032377
93;2021-03-10;63;79;142;268834;283093;09;551927
93;2021-03-10;195;180;376;280751;296087;19;576838
93;2021-03-10;267;172;439;254404;255552;29;509956
93;2021-03-10;212;191;404;310704;288398;39;599102
93;2021-03-10;247;249;497;325559;305827;49;631386
93;2021-03-10;217;200;418;353104;325389;59;678493
93;2021-03-10;164;154;318;336327;296459;69;632786
93;2021-03-10;102;80;182;279820;229699;79;509519
93;2021-03-10;71;46;117;171274;113716;89;284990
93;2021-03-10;30;18;48;58896;21758;90;80654
93;2021-03-10;1568;1370;2942;2639673;2415978;0;5055651
94;2021-03-10;0;2;2;16311;17433;09;33744
94;2021-03-10;6;5;11;16679;18132;19;34811
94;2021-03-10;10;8;18;16782;16579;29;33361
94;2021-03-10;10;7;17;23044;20580;39;43624
94;2021-03-10;7;4;11;23065;22140;49;45205
94;2021-03-10;6;6;12;24549;23421;59;47970
94;2021-03-10;3;7;10;23212;21883;69;45095
94;2021-03-10;4;1;5;19544;17141;79;36685
94;2021-03-10;6;0;6;11227;8178;89;19405
94;2021-03-10;3;1;4;3332;1447;90;4779
94;2021-03-10;55;41;96;177745;166934;0;344679
01;2021-03-11;0;0;0;19979;20155;09;40134
01;2021-03-11;0;0;0;24994;25489;19;50483
01;2021-03-11;5;1;6;17868;16690;29;34558
01;2021-03-11;1;3;4;22328;14821;39;37149
01;2021-03-11;2;1;3;28652;20276;49;48928
01;2021-03-11;4;5;9;33264;27260;59;60524
01;2021-03-11;1;6;7;27135;23978;69;51113
01;2021-03-11;1;0;1;18401;14661;79;33062
01;2021-03-11;0;0;0;9633;6375;89;16008
01;2021-03-11;0;0;0;3410;1510;90;4920
01;2021-03-11;14;16;30;205664;171215;0;376879
02;2021-03-11;0;0;0;16881;17110;09;33991
02;2021-03-11;4;3;7;21410;21604;19;43014
02;2021-03-11;6;4;10;16017;15479;29;31496
02;2021-03-11;5;6;11;19825;14455;39;34280
02;2021-03-11;4;2;6;24719;18248;49;42967
02;2021-03-11;2;2;4;34361;28310;59;62671
02;2021-03-11;2;1;3;28061;24495;69;52556
02;2021-03-11;0;2;2;18231;15278;79;33509
02;2021-03-11;0;1;1;11090;7677;89;18767
02;2021-03-11;0;0;0;3992;1506;90;5498
02;2021-03-11;23;21;44;194587;164162;0;358749
03;2021-03-11;0;0;0;31123;30920;09;62043
03;2021-03-11;0;3;3;29370;29268;19;58638
03;2021-03-11;3;1;4;21458;18963;29;40421
03;2021-03-11;0;1;1;21276;18326;39;39602
03;2021-03-11;2;3;5;18164;16593;49;34757
03;2021-03-11;0;0;0;13469;13557;59;27026
03;2021-03-11;1;0;1;8776;8670;69;17446
03;2021-03-11;0;0;0;3777;3591;79;7368
03;2021-03-11;0;0;0;1649;1072;89;2721
03;2021-03-11;0;0;0;485;184;90;669
03;2021-03-11;6;8;14;149547;141144;0;290691
04;2021-03-11;3;5;8;60314;61377;09;121691
04;2021-03-11;11;18;29;66065;68387;19;134452
04;2021-03-11;14;25;39;51059;47156;29;98215
04;2021-03-11;15;20;35;58788;45780;39;104568
04;2021-03-11;16;15;31;61408;52207;49;113615
04;2021-03-11;17;10;27;64838;60759;59;125597
04;2021-03-11;4;6;10;47008;42843;69;89851
04;2021-03-11;7;2;9;25509;21184;79;46693
04;2021-03-11;2;2;4;13168;7647;89;20815
04;2021-03-11;1;0;1;3209;1253;90;4462
04;2021-03-11;90;103;193;451366;408593;0;859959
05;2021-03-11;0;0;0;362.366008612902;341.338819562748;09;703.704828175651
05;2021-03-11;0;0;0;353.376145114279;370.349735405642;19;723.725880519921
05;2021-03-11;0;0;0;218.593559489256;256.539602589476;29;475.133162078732
05;2021-03-11;0;0;0;404.225408693299;360.321910454353;39;764.547319147651
05;2021-03-11;0;0;0;520.067953604221;497.108383964256;49;1017.17633756848
05;2021-03-11;0;0;0;468.146063921917;510.087601910415;59;978.233665832332
05;2021-03-11;0;0;0;340.368470050554;334.366842191253;69;674.735312241807
05;2021-03-11;0;0;0;212.598666888387;192.597753227106;79;405.196420115493
05;2021-03-11;0;0;0;148.727797095705;61.8681715431829;89;210.595968638888
05;2021-03-11;0;0;0;32.9601271090696;10.9909785719784;90;43.9511056810479
05;2021-03-11;0;0;0;3061.43020057959;2935.56979942041;0;5997
06;2021-03-11;0;0;0;42583;42380;09;84963
06;2021-03-11;0;3;3;33369;31925;19;65294
06;2021-03-11;7;4;11;21571;15080;29;36651
06;2021-03-11;1;0;1;21550;16147;39;37697
06;2021-03-11;0;5;5;14193;13939;49;28132
06;2021-03-11;1;3;4;7171;7597;59;14768
06;2021-03-11;1;1;2;3629;4117;69;7746
06;2021-03-11;0;0;0;1577;1457;79;3034
06;2021-03-11;0;0;0;531;474;89;1005
06;2021-03-11;0;0;0;88;93;90;181
06;2021-03-11;10;16;26;146262;133209;0;279471
07;2021-03-11;0;0;0;485;549;09;1034
07;2021-03-11;0;0;0;403;432;19;835
07;2021-03-11;2;4;6;764;841;29;1605
07;2021-03-11;0;0;0;824;928;39;1752
07;2021-03-11;0;1;1;788;1020;49;1808
07;2021-03-11;0;0;0;678;870;59;1548
07;2021-03-11;1;0;1;360;382;69;742
07;2021-03-11;0;0;0;231;190;79;421
07;2021-03-11;0;0;0;114;67;89;181
07;2021-03-11;0;0;0;24;11;90;35
07;2021-03-11;3;5;8;4671;5290;0;9961
08;2021-03-11;0;1;1;2715.22592983026;2997.75551488675;09;5712.98144471701
08;2021-03-11;0;0;0;2778.51901080978;3160.9156459093;19;5939.43465671908
08;2021-03-11;0;0;0;2080.8882988764;1718.16634315323;29;3799.05464202964
08;2021-03-11;0;0;0;2701.8582062647;1896.52641413317;39;4598.38462039786
08;2021-03-11;0;0;0;3151.45861023308;2460.52498233809;49;5611.98359257117
08;2021-03-11;0;1;1;2620.29868333099;2422.23566154656;59;5042.53434487755
08;2021-03-11;0;0;0;1621.44173420671;1438.58325779464;69;3060.02499200135
08;2021-03-11;0;0;0;626.575909335673;526.358467843651;79;1152.93437717932
08;2021-03-11;0;0;0;205.018522985054;140.993639349697;89;346.012162334751
08;2021-03-11;0;0;0;50.0325684687745;20.62259870351;90;70.6551671722846
08;2021-03-11;0;2;2;18551.3174743414;16782.6825256586;0;35334
11;2021-03-11;225;282;541;783071;811785;09;1594856
11;2021-03-11;699;739;1480;761456;784653;19;1546109
11;2021-03-11;1055;968;2026;850145;801772;29;1651917
11;2021-03-11;977;857;1838;914360;843488;39;1757848
11;2021-03-11;842;771;1617;845609;826202;49;1671811
11;2021-03-11;639;585;1229;793566;745070;59;1538636
11;2021-03-11;415;378;808;628649;549192;69;1177841
11;2021-03-11;152;168;320;434606;358356;79;792962
11;2021-03-11;96;74;174;261425;162933;89;424358
11;2021-03-11;49;18;67;89253;32619;90;121872
11;2021-03-11;5150;4840;10102;6362140;5916070;0;12278210
24;2021-03-11;10;25;37;139720;144686;09;284406
24;2021-03-11;64;82;146;152979;161185;19;314164
24;2021-03-11;65;84;150;122237;126536;29;248773
24;2021-03-11;72;70;143;150359;142009;39;292368
24;2021-03-11;59;83;142;161829;158758;49;320587
24;2021-03-11;57;61;118;172552;168011;59;340563
24;2021-03-11;39;38;77;172509;158177;69;330686
24;2021-03-11;24;29;53;129428;110593;79;240021
24;2021-03-11;14;15;29;87342;56882;89;144224
24;2021-03-11;8;3;11;31210;12071;90;43281
24;2021-03-11;412;490;906;1320165;1238908;0;2559073
27;2021-03-11;21;20;41;143373;149679;09;293052
27;2021-03-11;76;88;165;160962;173003;19;333965
27;2021-03-11;74;69;143;133746;142254;29;276000
27;2021-03-11;79;59;139;160004;155407;39;315411
27;2021-03-11;55;71;126;172333;169564;49;341897
27;2021-03-11;63;44;107;189979;183788;59;373767
27;2021-03-11;50;35;85;192591;178206;69;370797
27;2021-03-11;32;32;64;146876;127546;79;274422
27;2021-03-11;12;10;22;96896;61575;89;158471
27;2021-03-11;8;4;12;33148;12109;90;45257
27;2021-03-11;470;432;904;1429908;1353131;0;2783039
28;2021-03-11;33;31;66;180735;186856;09;367591
28;2021-03-11;99;106;207;200125;213621;19;413746
28;2021-03-11;119;83;202;168922;173007;29;341929
28;2021-03-11;102;89;191;196628;188487;39;385115
28;2021-03-11;114;81;195;205396;201699;49;407095
28;2021-03-11;95;86;181;222002;213866;59;435868
28;2021-03-11;77;59;136;224688;203758;69;428446
28;2021-03-11;44;45;89;163192;135543;79;298735
28;2021-03-11;27;13;40;109691;65377;89;175068
28;2021-03-11;4;10;14;37222;12685;90;49907
28;2021-03-11;714;603;1321;1708601;1594899;0;3303500
32;2021-03-11;112;141;253;358062;373689;09;731751
32;2021-03-11;286;259;545;387045;406742;19;793787
32;2021-03-11;304;341;645;342304;348587;29;690891
32;2021-03-11;322;311;633;382485;369972;39;752457
32;2021-03-11;307;288;595;382510;376716;49;759226
32;2021-03-11;269;260;529;386937;376527;59;763464
32;2021-03-11;198;166;364;371211;330938;69;702149
32;2021-03-11;120;95;215;250542;201459;79;452001
32;2021-03-11;71;33;104;163399;89786;89;253185
32;2021-03-11;25;8;33;48384;15367;90;63751
32;2021-03-11;2014;1902;3916;3072879;2889783;0;5962662
44;2021-03-11;55;64;121;291525;306839;09;598364
44;2021-03-11;128;167;297;320255;339504;19;659759
44;2021-03-11;199;169;368;302020;314428;29;616448
44;2021-03-11;161;171;335;342222;333292;39;675514
44;2021-03-11;171;134;306;349727;344491;49;694218
44;2021-03-11;152;143;295;381371;373239;59;754610
44;2021-03-11;105;112;217;367165;335850;69;703015
44;2021-03-11;63;69;134;250387;215436;79;465823
44;2021-03-11;32;34;67;170825;105192;89;276017
44;2021-03-11;19;9;28;51248;16731;90;67979
44;2021-03-11;1085;1073;2169;2826745;2685002;0;5511747
52;2021-03-11;28;27;59;213594;223900;09;437494
52;2021-03-11;77;92;173;240818;255197;19;496015
52;2021-03-11;98;99;197;197010;200630;29;397640
52;2021-03-11;73;73;146;231204;224885;39;456089
52;2021-03-11;93;77;170;243874;243418;49;487292
52;2021-03-11;53;78;131;244100;239116;59;483216
52;2021-03-11;52;46;98;241796;221345;69;463141
52;2021-03-11;37;39;76;177805;149903;79;327708
52;2021-03-11;28;15;43;119561;75822;89;195383
52;2021-03-11;10;4;14;42559;15260;90;57819
52;2021-03-11;549;551;1108;1952321;1849476;0;3801797
53;2021-03-11;19;15;35;173813;182358;09;356171
53;2021-03-11;38;101;140;202720;214740;19;417460
53;2021-03-11;85;94;180;163116;173196;29;336312
53;2021-03-11;69;49;118;190526;187674;39;378200
53;2021-03-11;56;43;99;212098;212015;49;424113
53;2021-03-11;42;47;89;223699;219176;59;442875
53;2021-03-11;35;23;58;227435;209274;69;436709
53;2021-03-11;19;16;35;169992;140910;79;310902
53;2021-03-11;7;5;12;118117;69883;89;188000
53;2021-03-11;5;2;7;37370;12267;90;49637
53;2021-03-11;375;395;773;1718886;1621493;0;3340379
75;2021-03-11;54;54;110;293104;305291;09;598395
75;2021-03-11;131;145;277;337141;357785;19;694926
75;2021-03-11;112;108;220;295024;300618;29;595642
75;2021-03-11;96;93;189;347871;331233;39;679104
75;2021-03-11;105;96;201;384742;372771;49;757513
75;2021-03-11;88;88;176;413361;390880;59;804241
75;2021-03-11;66;61;127;425623;384060;69;809683
75;2021-03-11;45;43;88;325086;276298;79;601384
75;2021-03-11;22;16;38;213986;139308;89;353294
75;2021-03-11;8;4;12;77600;28200;90;105800
75;2021-03-11;727;708;1438;3113538;2886444;0;5999982
76;2021-03-11;30;51;82;305956;318589;09;624545
76;2021-03-11;136;143;280;338942;356969;19;695911
76;2021-03-11;133;130;263;316210;319570;29;635780
76;2021-03-11;152;115;268;356758;337587;39;694345
76;2021-03-11;157;128;286;376541;363812;49;740353
76;2021-03-11;136;130;267;402608;383750;59;786358
76;2021-03-11;82;81;163;394889;358997;69;753886
76;2021-03-11;50;52;102;308664;263806;79;572470
76;2021-03-11;42;16;58;195838;129272;89;325110
76;2021-03-11;11;15;26;69372;26728;90;96100
76;2021-03-11;930;863;1798;3065778;2859080;0;5924858
84;2021-03-11;83;75;161;459549;481088;09;940637
84;2021-03-11;252;234;487;487711;511905;19;999616
84;2021-03-11;303;280;583;443824;451094;29;894918
84;2021-03-11;256;224;480;512522;493262;39;1005784
84;2021-03-11;235;210;445;520248;515106;49;1035354
84;2021-03-11;194;185;379;529611;514848;59;1044459
84;2021-03-11;141;132;273;486720;439940;69;926660
84;2021-03-11;89;62;151;372151;315211;79;687362
84;2021-03-11;50;23;73;237198;150524;89;387722
84;2021-03-11;15;11;26;81185;28680;90;109865
84;2021-03-11;1618;1436;3058;4130719;3901658;0;8032377
93;2021-03-11;58;49;107;268834;283093;09;551927
93;2021-03-11;200;229;430;280751;296087;19;576838
93;2021-03-11;291;238;531;254404;255552;29;509956
93;2021-03-11;239;230;469;310704;288398;39;599102
93;2021-03-11;266;204;470;325559;305827;49;631386
93;2021-03-11;224;176;400;353104;325389;59;678493
93;2021-03-11;161;125;286;336327;296459;69;632786
93;2021-03-11;84;77;161;279820;229699;79;509519
93;2021-03-11;72;34;106;171274;113716;89;284990
93;2021-03-11;40;19;59;58896;21758;90;80654
93;2021-03-11;1636;1381;3020;2639673;2415978;0;5055651
94;2021-03-11;0;3;3;16311;17433;09;33744
94;2021-03-11;5;11;17;16679;18132;19;34811
94;2021-03-11;5;3;8;16782;16579;29;33361
94;2021-03-11;6;6;12;23044;20580;39;43624
94;2021-03-11;4;11;15;23065;22140;49;45205
94;2021-03-11;10;3;13;24549;23421;59;47970
94;2021-03-11;4;2;6;23212;21883;69;45095
94;2021-03-11;1;5;6;19544;17141;79;36685
94;2021-03-11;1;5;6;11227;8178;89;19405
94;2021-03-11;4;1;5;3332;1447;90;4779
94;2021-03-11;40;50;91;177745;166934;0;344679
01;2021-03-12;0;0;0;19979;20155;09;40134
01;2021-03-12;3;5;8;24994;25489;19;50483
01;2021-03-12;6;2;8;17868;16690;29;34558
01;2021-03-12;5;5;10;22328;14821;39;37149
01;2021-03-12;4;2;6;28652;20276;49;48928
01;2021-03-12;9;14;23;33264;27260;59;60524
01;2021-03-12;6;6;12;27135;23978;69;51113
01;2021-03-12;3;4;7;18401;14661;79;33062
01;2021-03-12;0;0;0;9633;6375;89;16008
01;2021-03-12;2;0;2;3410;1510;90;4920
01;2021-03-12;38;38;76;205664;171215;0;376879
02;2021-03-12;0;0;0;16881;17110;09;33991
02;2021-03-12;3;7;10;21410;21604;19;43014
02;2021-03-12;6;5;11;16017;15479;29;31496
02;2021-03-12;7;4;11;19825;14455;39;34280
02;2021-03-12;7;5;12;24719;18248;49;42967
02;2021-03-12;9;2;11;34361;28310;59;62671
02;2021-03-12;3;2;5;28061;24495;69;52556
02;2021-03-12;1;2;3;18231;15278;79;33509
02;2021-03-12;0;0;0;11090;7677;89;18767
02;2021-03-12;0;0;0;3992;1506;90;5498
02;2021-03-12;36;27;63;194587;164162;0;358749
03;2021-03-12;0;0;0;31123;30920;09;62043
03;2021-03-12;0;3;3;29370;29268;19;58638
03;2021-03-12;2;1;3;21458;18963;29;40421
03;2021-03-12;0;3;3;21276;18326;39;39602
03;2021-03-12;0;3;3;18164;16593;49;34757
03;2021-03-12;0;0;0;13469;13557;59;27026
03;2021-03-12;0;0;0;8776;8670;69;17446
03;2021-03-12;0;1;1;3777;3591;79;7368
03;2021-03-12;0;0;0;1649;1072;89;2721
03;2021-03-12;0;0;0;485;184;90;669
03;2021-03-12;2;11;13;149547;141144;0;290691
04;2021-03-12;5;3;8;60314;61377;09;121691
04;2021-03-12;13;6;19;66065;68387;19;134452
04;2021-03-12;14;12;26;51059;47156;29;98215
04;2021-03-12;17;7;24;58788;45780;39;104568
04;2021-03-12;21;11;32;61408;52207;49;113615
04;2021-03-12;11;15;26;64838;60759;59;125597
04;2021-03-12;9;5;14;47008;42843;69;89851
04;2021-03-12;0;2;2;25509;21184;79;46693
04;2021-03-12;6;2;8;13168;7647;89;20815
04;2021-03-12;0;0;0;3209;1253;90;4462
04;2021-03-12;96;63;159;451366;408593;0;859959
05;2021-03-12;0;0;0;362.366008612902;341.338819562748;09;703.704828175651
05;2021-03-12;0;1;1;353.376145114279;370.349735405642;19;723.725880519921
05;2021-03-12;0;0;0;218.593559489256;256.539602589476;29;475.133162078732
05;2021-03-12;0;0;0;404.225408693299;360.321910454353;39;764.547319147651
05;2021-03-12;0;0;0;520.067953604221;497.108383964256;49;1017.17633756848
05;2021-03-12;0;0;0;468.146063921917;510.087601910415;59;978.233665832332
05;2021-03-12;0;0;0;340.368470050554;334.366842191253;69;674.735312241807
05;2021-03-12;0;0;0;212.598666888387;192.597753227106;79;405.196420115493
05;2021-03-12;0;0;0;148.727797095705;61.8681715431829;89;210.595968638888
05;2021-03-12;0;0;0;32.9601271090696;10.9909785719784;90;43.9511056810479
05;2021-03-12;0;1;1;3061.43020057959;2935.56979942041;0;5997
06;2021-03-12;9;8;17;42583;42380;09;84963
06;2021-03-12;18;13;31;33369;31925;19;65294
06;2021-03-12;6;6;12;21571;15080;29;36651
06;2021-03-12;15;6;21;21550;16147;39;37697
06;2021-03-12;8;6;14;14193;13939;49;28132
06;2021-03-12;3;4;7;7171;7597;59;14768
06;2021-03-12;12;15;28;3629;4117;69;7746
06;2021-03-12;0;0;0;1577;1457;79;3034
06;2021-03-12;0;0;0;531;474;89;1005
06;2021-03-12;0;0;0;88;93;90;181
06;2021-03-12;71;58;130;146262;133209;0;279471
07;2021-03-12;0;0;0;485;549;09;1034
07;2021-03-12;0;0;0;403;432;19;835
07;2021-03-12;2;2;4;764;841;29;1605
07;2021-03-12;0;1;1;824;928;39;1752
07;2021-03-12;1;0;1;788;1020;49;1808
07;2021-03-12;1;0;1;678;870;59;1548
07;2021-03-12;1;0;1;360;382;69;742
07;2021-03-12;0;0;0;231;190;79;421
07;2021-03-12;0;0;0;114;67;89;181
07;2021-03-12;0;0;0;24;11;90;35
07;2021-03-12;5;3;8;4671;5290;0;9961
08;2021-03-12;0;0;0;2715.22592983026;2997.75551488675;09;5712.98144471701
08;2021-03-12;0;0;0;2778.51901080978;3160.9156459093;19;5939.43465671908
08;2021-03-12;0;0;0;2080.8882988764;1718.16634315323;29;3799.05464202964
08;2021-03-12;0;0;0;2701.8582062647;1896.52641413317;39;4598.38462039786
08;2021-03-12;0;1;1;3151.45861023308;2460.52498233809;49;5611.98359257117
08;2021-03-12;2;0;2;2620.29868333099;2422.23566154656;59;5042.53434487755
08;2021-03-12;2;1;3;1621.44173420671;1438.58325779464;69;3060.02499200135
08;2021-03-12;0;0;0;626.575909335673;526.358467843651;79;1152.93437717932
08;2021-03-12;0;0;0;205.018522985054;140.993639349697;89;346.012162334751
08;2021-03-12;0;0;0;50.0325684687745;20.62259870351;90;70.6551671722846
08;2021-03-12;4;2;6;18551.3174743414;16782.6825256586;0;35334
11;2021-03-12;310;307;651;783071;811785;09;1594856
11;2021-03-12;748;752;1548;761456;784653;19;1546109
11;2021-03-12;1017;863;1886;850145;801772;29;1651917
11;2021-03-12;969;903;1876;914360;843488;39;1757848
11;2021-03-12;820;785;1614;845609;826202;49;1671811
11;2021-03-12;665;667;1343;793566;745070;59;1538636
11;2021-03-12;417;381;814;628649;549192;69;1177841
11;2021-03-12;173;177;353;434606;358356;79;792962
11;2021-03-12;100;66;166;261425;162933;89;424358
11;2021-03-12;46;14;60;89253;32619;90;121872
11;2021-03-12;5266;4917;10314;6362140;5916070;0;12278210
24;2021-03-12;24;22;46;139720;144686;09;284406
24;2021-03-12;73;87;161;152979;161185;19;314164
24;2021-03-12;84;83;167;122237;126536;29;248773
24;2021-03-12;93;66;159;150359;142009;39;292368
24;2021-03-12;79;68;147;161829;158758;49;320587
24;2021-03-12;64;82;146;172552;168011;59;340563
24;2021-03-12;52;53;105;172509;158177;69;330686
24;2021-03-12;25;19;44;129428;110593;79;240021
24;2021-03-12;16;8;24;87342;56882;89;144224
24;2021-03-12;13;3;16;31210;12071;90;43281
24;2021-03-12;523;491;1018;1320165;1238908;0;2559073
27;2021-03-12;34;32;66;143373;149679;09;293052
27;2021-03-12;93;89;183;160962;173003;19;333965
27;2021-03-12;96;71;167;133746;142254;29;276000
27;2021-03-12;63;49;112;160004;155407;39;315411
27;2021-03-12;69;59;128;172333;169564;49;341897
27;2021-03-12;60;46;106;189979;183788;59;373767
27;2021-03-12;55;56;111;192591;178206;69;370797
27;2021-03-12;23;29;52;146876;127546;79;274422
27;2021-03-12;15;10;25;96896;61575;89;158471
27;2021-03-12;7;1;8;33148;12109;90;45257
27;2021-03-12;515;442;958;1429908;1353131;0;2783039
28;2021-03-12;44;42;88;180735;186856;09;367591
28;2021-03-12;98;109;210;200125;213621;19;413746
28;2021-03-12;116;124;241;168922;173007;29;341929
28;2021-03-12;97;103;200;196628;188487;39;385115
28;2021-03-12;101;109;210;205396;201699;49;407095
28;2021-03-12;89;64;153;222002;213866;59;435868
28;2021-03-12;77;90;167;224688;203758;69;428446
28;2021-03-12;54;36;90;163192;135543;79;298735
28;2021-03-12;31;26;57;109691;65377;89;175068
28;2021-03-12;25;9;34;37222;12685;90;49907
28;2021-03-12;732;712;1450;1708601;1594899;0;3303500
32;2021-03-12;108;159;267;358062;373689;09;731751
32;2021-03-12;294;310;604;387045;406742;19;793787
32;2021-03-12;324;286;610;342304;348587;29;690891
32;2021-03-12;334;287;621;382485;369972;39;752457
32;2021-03-12;302;271;573;382510;376716;49;759226
32;2021-03-12;257;243;500;386937;376527;59;763464
32;2021-03-12;178;168;346;371211;330938;69;702149
32;2021-03-12;120;104;224;250542;201459;79;452001
32;2021-03-12;90;44;134;163399;89786;89;253185
32;2021-03-12;24;12;36;48384;15367;90;63751
32;2021-03-12;2031;1884;3915;3072879;2889783;0;5962662
44;2021-03-12;62;91;156;291525;306839;09;598364
44;2021-03-12;170;167;337;320255;339504;19;659759
44;2021-03-12;178;153;331;302020;314428;29;616448
44;2021-03-12;167;169;338;342222;333292;39;675514
44;2021-03-12;152;162;314;349727;344491;49;694218
44;2021-03-12;167;160;329;381371;373239;59;754610
44;2021-03-12;103;81;184;367165;335850;69;703015
44;2021-03-12;58;53;114;250387;215436;79;465823
44;2021-03-12;51;22;75;170825;105192;89;276017
44;2021-03-12;12;10;22;51248;16731;90;67979
44;2021-03-12;1120;1068;2200;2826745;2685002;0;5511747
52;2021-03-12;30;25;56;213594;223900;09;437494
52;2021-03-12;83;91;178;240818;255197;19;496015
52;2021-03-12;93;112;205;197010;200630;29;397640
52;2021-03-12;64;83;147;231204;224885;39;456089
52;2021-03-12;88;74;162;243874;243418;49;487292
52;2021-03-12;79;81;160;244100;239116;59;483216
52;2021-03-12;61;49;110;241796;221345;69;463141
52;2021-03-12;40;34;74;177805;149903;79;327708
52;2021-03-12;29;17;46;119561;75822;89;195383
52;2021-03-12;8;2;10;42559;15260;90;57819
52;2021-03-12;575;568;1148;1952321;1849476;0;3801797
53;2021-03-12;17;20;37;173813;182358;09;356171
53;2021-03-12;79;87;166;202720;214740;19;417460
53;2021-03-12;79;74;154;163116;173196;29;336312
53;2021-03-12;61;41;102;190526;187674;39;378200
53;2021-03-12;55;74;129;212098;212015;49;424113
53;2021-03-12;56;58;114;223699;219176;59;442875
53;2021-03-12;26;32;58;227435;209274;69;436709
53;2021-03-12;18;18;36;169992;140910;79;310902
53;2021-03-12;11;7;18;118117;69883;89;188000
53;2021-03-12;2;3;5;37370;12267;90;49637
53;2021-03-12;404;414;819;1718886;1621493;0;3340379
75;2021-03-12;46;35;82;293104;305291;09;598395
75;2021-03-12;126;130;257;337141;357785;19;694926
75;2021-03-12;103;100;203;295024;300618;29;595642
75;2021-03-12;120;119;239;347871;331233;39;679104
75;2021-03-12;113;110;223;384742;372771;49;757513
75;2021-03-12;83;88;171;413361;390880;59;804241
75;2021-03-12;67;69;136;425623;384060;69;809683
75;2021-03-12;33;30;64;325086;276298;79;601384
75;2021-03-12;24;16;40;213986;139308;89;353294
75;2021-03-12;19;9;28;77600;28200;90;105800
75;2021-03-12;734;708;1445;3113538;2886444;0;5999982
76;2021-03-12;55;53;110;305956;318589;09;624545
76;2021-03-12;142;148;293;338942;356969;19;695911
76;2021-03-12;144;128;272;316210;319570;29;635780
76;2021-03-12;154;119;273;356758;337587;39;694345
76;2021-03-12;127;114;242;376541;363812;49;740353
76;2021-03-12;135;111;246;402608;383750;59;786358
76;2021-03-12;85;76;161;394889;358997;69;753886
76;2021-03-12;62;39;101;308664;263806;79;572470
76;2021-03-12;32;29;61;195838;129272;89;325110
76;2021-03-12;14;10;24;69372;26728;90;96100
76;2021-03-12;951;827;1784;3065778;2859080;0;5924858
84;2021-03-12;116;127;257;459549;481088;09;940637
84;2021-03-12;328;310;642;487711;511905;19;999616
84;2021-03-12;276;274;550;443824;451094;29;894918
84;2021-03-12;249;228;478;512522;493262;39;1005784
84;2021-03-12;279;206;485;520248;515106;49;1035354
84;2021-03-12;189;196;385;529611;514848;59;1044459
84;2021-03-12;149;143;292;486720;439940;69;926660
84;2021-03-12;83;82;165;372151;315211;79;687362
84;2021-03-12;41;45;86;237198;150524;89;387722
84;2021-03-12;19;9;28;81185;28680;90;109865
84;2021-03-12;1729;1621;3369;4130719;3901658;0;8032377
93;2021-03-12;87;71;158;268834;283093;09;551927
93;2021-03-12;225;216;443;280751;296087;19;576838
93;2021-03-12;272;199;471;254404;255552;29;509956
93;2021-03-12;267;224;494;310704;288398;39;599102
93;2021-03-12;272;214;487;325559;305827;49;631386
93;2021-03-12;268;231;499;353104;325389;59;678493
93;2021-03-12;187;156;343;336327;296459;69;632786
93;2021-03-12;111;86;198;279820;229699;79;509519
93;2021-03-12;59;36;95;171274;113716;89;284990
93;2021-03-12;15;13;28;58896;21758;90;80654
93;2021-03-12;1764;1446;3218;2639673;2415978;0;5055651
94;2021-03-12;3;1;4;16311;17433;09;33744
94;2021-03-12;7;4;11;16679;18132;19;34811
94;2021-03-12;5;4;9;16782;16579;29;33361
94;2021-03-12;15;4;19;23044;20580;39;43624
94;2021-03-12;3;8;11;23065;22140;49;45205
94;2021-03-12;5;7;12;24549;23421;59;47970
94;2021-03-12;3;5;8;23212;21883;69;45095
94;2021-03-12;5;5;10;19544;17141;79;36685
94;2021-03-12;3;1;4;11227;8178;89;19405
94;2021-03-12;2;0;2;3332;1447;90;4779
94;2021-03-12;51;39;90;177745;166934;0;344679
01;2021-03-13;1;1;2;19979;20155;09;40134
01;2021-03-13;6;1;7;24994;25489;19;50483
01;2021-03-13;0;1;1;17868;16690;29;34558
01;2021-03-13;2;2;4;22328;14821;39;37149
01;2021-03-13;1;2;3;28652;20276;49;48928
01;2021-03-13;3;1;4;33264;27260;59;60524
01;2021-03-13;0;1;1;27135;23978;69;51113
01;2021-03-13;0;0;0;18401;14661;79;33062
01;2021-03-13;3;0;3;9633;6375;89;16008
01;2021-03-13;0;0;0;3410;1510;90;4920
01;2021-03-13;16;9;25;205664;171215;0;376879
02;2021-03-13;0;0;0;16881;17110;09;33991
02;2021-03-13;3;9;12;21410;21604;19;43014
02;2021-03-13;7;1;8;16017;15479;29;31496
02;2021-03-13;2;4;6;19825;14455;39;34280
02;2021-03-13;4;6;10;24719;18248;49;42967
02;2021-03-13;1;1;2;34361;28310;59;62671
02;2021-03-13;1;0;1;28061;24495;69;52556
02;2021-03-13;0;0;0;18231;15278;79;33509
02;2021-03-13;0;1;1;11090;7677;89;18767
02;2021-03-13;0;0;0;3992;1506;90;5498
02;2021-03-13;18;22;40;194587;164162;0;358749
03;2021-03-13;0;0;0;31123;30920;09;62043
03;2021-03-13;1;0;1;29370;29268;19;58638
03;2021-03-13;1;0;1;21458;18963;29;40421
03;2021-03-13;0;0;0;21276;18326;39;39602
03;2021-03-13;0;1;1;18164;16593;49;34757
03;2021-03-13;0;0;0;13469;13557;59;27026
03;2021-03-13;1;0;1;8776;8670;69;17446
03;2021-03-13;0;0;0;3777;3591;79;7368
03;2021-03-13;0;0;0;1649;1072;89;2721
03;2021-03-13;0;0;0;485;184;90;669
03;2021-03-13;3;1;4;149547;141144;0;290691
04;2021-03-13;3;0;3;60314;61377;09;121691
04;2021-03-13;6;4;10;66065;68387;19;134452
04;2021-03-13;13;6;19;51059;47156;29;98215
04;2021-03-13;17;11;28;58788;45780;39;104568
04;2021-03-13;7;12;19;61408;52207;49;113615
04;2021-03-13;11;6;17;64838;60759;59;125597
04;2021-03-13;4;8;12;47008;42843;69;89851
04;2021-03-13;2;1;3;25509;21184;79;46693
04;2021-03-13;2;4;6;13168;7647;89;20815
04;2021-03-13;0;0;0;3209;1253;90;4462
04;2021-03-13;65;52;117;451366;408593;0;859959
05;2021-03-13;0;0;0;362.366008612902;341.338819562748;09;703.704828175651
05;2021-03-13;0;0;0;353.376145114279;370.349735405642;19;723.725880519921
05;2021-03-13;0;0;0;218.593559489256;256.539602589476;29;475.133162078732
05;2021-03-13;0;0;0;404.225408693299;360.321910454353;39;764.547319147651
05;2021-03-13;0;0;0;520.067953604221;497.108383964256;49;1017.17633756848
05;2021-03-13;0;0;0;468.146063921917;510.087601910415;59;978.233665832332
05;2021-03-13;0;0;0;340.368470050554;334.366842191253;69;674.735312241807
05;2021-03-13;0;0;0;212.598666888387;192.597753227106;79;405.196420115493
05;2021-03-13;0;0;0;148.727797095705;61.8681715431829;89;210.595968638888
05;2021-03-13;0;0;0;32.9601271090696;10.9909785719784;90;43.9511056810479
05;2021-03-13;0;0;0;3061.43020057959;2935.56979942041;0;5997
06;2021-03-13;4;8;12;42583;42380;09;84963
06;2021-03-13;24;19;43;33369;31925;19;65294
06;2021-03-13;3;2;5;21571;15080;29;36651
06;2021-03-13;6;3;9;21550;16147;39;37697
06;2021-03-13;6;5;11;14193;13939;49;28132
06;2021-03-13;3;5;8;7171;7597;59;14768
06;2021-03-13;0;1;1;3629;4117;69;7746
06;2021-03-13;0;0;0;1577;1457;79;3034
06;2021-03-13;1;0;1;531;474;89;1005
06;2021-03-13;0;0;0;88;93;90;181
06;2021-03-13;47;43;90;146262;133209;0;279471
07;2021-03-13;0;0;0;485;549;09;1034
07;2021-03-13;0;0;0;403;432;19;835
07;2021-03-13;0;0;0;764;841;29;1605
07;2021-03-13;1;1;2;824;928;39;1752
07;2021-03-13;0;0;0;788;1020;49;1808
07;2021-03-13;1;1;2;678;870;59;1548
07;2021-03-13;0;0;0;360;382;69;742
07;2021-03-13;0;0;0;231;190;79;421
07;2021-03-13;0;1;1;114;67;89;181
07;2021-03-13;0;0;0;24;11;90;35
07;2021-03-13;2;3;5;4671;5290;0;9961
08;2021-03-13;0;0;0;2715.22592983026;2997.75551488675;09;5712.98144471701
08;2021-03-13;1;0;1;2778.51901080978;3160.9156459093;19;5939.43465671908
08;2021-03-13;0;0;0;2080.8882988764;1718.16634315323;29;3799.05464202964
08;2021-03-13;0;0;0;2701.8582062647;1896.52641413317;39;4598.38462039786
08;2021-03-13;0;0;0;3151.45861023308;2460.52498233809;49;5611.98359257117
08;2021-03-13;0;0;0;2620.29868333099;2422.23566154656;59;5042.53434487755
08;2021-03-13;0;0;0;1621.44173420671;1438.58325779464;69;3060.02499200135
08;2021-03-13;0;0;0;626.575909335673;526.358467843651;79;1152.93437717932
08;2021-03-13;0;0;0;205.018522985054;140.993639349697;89;346.012162334751
08;2021-03-13;0;0;0;50.0325684687745;20.62259870351;90;70.6551671722846
08;2021-03-13;1;0;1;18551.3174743414;16782.6825256586;0;35334
11;2021-03-13;212;189;420;783071;811785;09;1594856
11;2021-03-13;518;487;1051;761456;784653;19;1546109
11;2021-03-13;673;572;1246;850145;801772;29;1651917
11;2021-03-13;750;547;1297;914360;843488;39;1757848
11;2021-03-13;619;567;1188;845609;826202;49;1671811
11;2021-03-13;509;498;1009;793566;745070;59;1538636
11;2021-03-13;298;277;581;628649;549192;69;1177841
11;2021-03-13;112;123;235;434606;358356;79;792962
11;2021-03-13;54;44;98;261425;162933;89;424358
11;2021-03-13;25;15;40;89253;32619;90;121872
11;2021-03-13;3770;3320;7166;6362140;5916070;0;12278210
24;2021-03-13;18;17;36;139720;144686;09;284406
24;2021-03-13;50;48;100;152979;161185;19;314164
24;2021-03-13;46;62;108;122237;126536;29;248773
24;2021-03-13;48;31;79;150359;142009;39;292368
24;2021-03-13;34;60;94;161829;158758;49;320587
24;2021-03-13;45;45;90;172552;168011;59;340563
24;2021-03-13;23;26;49;172509;158177;69;330686
24;2021-03-13;19;17;36;129428;110593;79;240021
24;2021-03-13;14;9;23;87342;56882;89;144224
24;2021-03-13;1;2;3;31210;12071;90;43281
24;2021-03-13;298;317;618;1320165;1238908;0;2559073
27;2021-03-13;12;22;34;143373;149679;09;293052
27;2021-03-13;43;56;99;160962;173003;19;333965
27;2021-03-13;53;45;98;133746;142254;29;276000
27;2021-03-13;66;45;111;160004;155407;39;315411
27;2021-03-13;54;41;95;172333;169564;49;341897
27;2021-03-13;49;39;88;189979;183788;59;373767
27;2021-03-13;25;31;56;192591;178206;69;370797
27;2021-03-13;18;21;39;146876;127546;79;274422
27;2021-03-13;9;3;12;96896;61575;89;158471
27;2021-03-13;4;3;7;33148;12109;90;45257
27;2021-03-13;333;306;639;1429908;1353131;0;2783039
28;2021-03-13;19;24;44;180735;186856;09;367591
28;2021-03-13;56;63;120;200125;213621;19;413746
28;2021-03-13;77;83;160;168922;173007;29;341929
28;2021-03-13;72;56;128;196628;188487;39;385115
28;2021-03-13;66;70;136;205396;201699;49;407095
28;2021-03-13;61;65;127;222002;213866;59;435868
28;2021-03-13;38;49;87;224688;203758;69;428446
28;2021-03-13;38;31;69;163192;135543;79;298735
28;2021-03-13;14;8;22;109691;65377;89;175068
28;2021-03-13;6;3;9;37222;12685;90;49907
28;2021-03-13;447;452;902;1708601;1594899;0;3303500
32;2021-03-13;73;96;169;358062;373689;09;731751
32;2021-03-13;196;202;398;387045;406742;19;793787
32;2021-03-13;257;187;444;342304;348587;29;690891
32;2021-03-13;211;193;404;382485;369972;39;752457
32;2021-03-13;214;198;412;382510;376716;49;759226
32;2021-03-13;216;185;401;386937;376527;59;763464
32;2021-03-13;105;113;218;371211;330938;69;702149
32;2021-03-13;78;68;146;250542;201459;79;452001
32;2021-03-13;56;28;84;163399;89786;89;253185
32;2021-03-13;14;9;23;48384;15367;90;63751
32;2021-03-13;1420;1279;2699;3072879;2889783;0;5962662
44;2021-03-13;34;41;75;291525;306839;09;598364
44;2021-03-13;127;108;236;320255;339504;19;659759
44;2021-03-13;116;113;229;302020;314428;29;616448
44;2021-03-13;128;100;228;342222;333292;39;675514
44;2021-03-13;112;97;209;349727;344491;49;694218
44;2021-03-13;120;155;275;381371;373239;59;754610
44;2021-03-13;81;79;161;367165;335850;69;703015
44;2021-03-13;50;41;91;250387;215436;79;465823
44;2021-03-13;29;19;48;170825;105192;89;276017
44;2021-03-13;10;6;16;51248;16731;90;67979
44;2021-03-13;807;759;1568;2826745;2685002;0;5511747
52;2021-03-13;25;19;45;213594;223900;09;437494
52;2021-03-13;74;76;151;240818;255197;19;496015
52;2021-03-13;66;80;146;197010;200630;29;397640
52;2021-03-13;52;51;103;231204;224885;39;456089
52;2021-03-13;57;55;112;243874;243418;49;487292
52;2021-03-13;53;58;111;244100;239116;59;483216
52;2021-03-13;40;42;82;241796;221345;69;463141
52;2021-03-13;23;25;48;177805;149903;79;327708
52;2021-03-13;13;7;20;119561;75822;89;195383
52;2021-03-13;6;3;9;42559;15260;90;57819
52;2021-03-13;409;416;827;1952321;1849476;0;3801797
53;2021-03-13;15;9;24;173813;182358;09;356171
53;2021-03-13;54;55;109;202720;214740;19;417460
53;2021-03-13;56;48;104;163116;173196;29;336312
53;2021-03-13;36;36;72;190526;187674;39;378200
53;2021-03-13;37;39;76;212098;212015;49;424113
53;2021-03-13;28;33;61;223699;219176;59;442875
53;2021-03-13;28;13;41;227435;209274;69;436709
53;2021-03-13;11;9;20;169992;140910;79;310902
53;2021-03-13;5;3;8;118117;69883;89;188000
53;2021-03-13;1;0;1;37370;12267;90;49637
53;2021-03-13;271;245;516;1718886;1621493;0;3340379
75;2021-03-13;33;26;59;293104;305291;09;598395
75;2021-03-13;63;67;130;337141;357785;19;694926
75;2021-03-13;68;77;145;295024;300618;29;595642
75;2021-03-13;73;52;125;347871;331233;39;679104
75;2021-03-13;82;67;149;384742;372771;49;757513
75;2021-03-13;67;57;124;413361;390880;59;804241
75;2021-03-13;40;32;72;425623;384060;69;809683
75;2021-03-13;33;32;65;325086;276298;79;601384
75;2021-03-13;15;12;27;213986;139308;89;353294
75;2021-03-13;7;6;13;77600;28200;90;105800
75;2021-03-13;481;428;909;3113538;2886444;0;5999982
76;2021-03-13;34;40;76;305956;318589;09;624545
76;2021-03-13;70;65;135;338942;356969;19;695911
76;2021-03-13;94;75;169;316210;319570;29;635780
76;2021-03-13;84;76;160;356758;337587;39;694345
76;2021-03-13;88;64;152;376541;363812;49;740353
76;2021-03-13;85;65;150;402608;383750;59;786358
76;2021-03-13;49;49;99;394889;358997;69;753886
76;2021-03-13;32;31;63;308664;263806;79;572470
76;2021-03-13;18;6;25;195838;129272;89;325110
76;2021-03-13;9;7;16;69372;26728;90;96100
76;2021-03-13;563;479;1046;3065778;2859080;0;5924858
84;2021-03-13;49;58;109;459549;481088;09;940637
84;2021-03-13;142;167;309;487711;511905;19;999616
84;2021-03-13;150;119;269;443824;451094;29;894918
84;2021-03-13;167;172;339;512522;493262;39;1005784
84;2021-03-13;171;173;344;520248;515106;49;1035354
84;2021-03-13;137;139;276;529611;514848;59;1044459
84;2021-03-13;98;86;184;486720;439940;69;926660
84;2021-03-13;43;40;83;372151;315211;79;687362
84;2021-03-13;35;23;58;237198;150524;89;387722
84;2021-03-13;15;3;18;81185;28680;90;109865
84;2021-03-13;1007;980;1989;4130719;3901658;0;8032377
93;2021-03-13;29;29;58;268834;283093;09;551927
93;2021-03-13;110;121;232;280751;296087;19;576838
93;2021-03-13;136;126;262;254404;255552;29;509956
93;2021-03-13;150;125;275;310704;288398;39;599102
93;2021-03-13;120;111;231;325559;305827;49;631386
93;2021-03-13;156;113;269;353104;325389;59;678493
93;2021-03-13;73;74;149;336327;296459;69;632786
93;2021-03-13;60;54;114;279820;229699;79;509519
93;2021-03-13;30;28;58;171274;113716;89;284990
93;2021-03-13;10;4;14;58896;21758;90;80654
93;2021-03-13;874;785;1662;2639673;2415978;0;5055651
94;2021-03-13;2;2;4;16311;17433;09;33744
94;2021-03-13;3;2;5;16679;18132;19;34811
94;2021-03-13;1;3;4;16782;16579;29;33361
94;2021-03-13;4;3;7;23044;20580;39;43624
94;2021-03-13;7;3;10;23065;22140;49;45205
94;2021-03-13;4;1;5;24549;23421;59;47970
94;2021-03-13;3;6;9;23212;21883;69;45095
94;2021-03-13;2;2;4;19544;17141;79;36685
94;2021-03-13;0;1;1;11227;8178;89;19405
94;2021-03-13;0;0;0;3332;1447;90;4779
94;2021-03-13;26;23;49;177745;166934;0;344679
01;2021-03-14;0;0;0;19979;20155;09;40134
01;2021-03-14;0;0;0;24994;25489;19;50483
01;2021-03-14;1;0;1;17868;16690;29;34558
01;2021-03-14;1;0;1;22328;14821;39;37149
01;2021-03-14;1;3;4;28652;20276;49;48928
01;2021-03-14;2;3;5;33264;27260;59;60524
01;2021-03-14;0;1;1;27135;23978;69;51113
01;2021-03-14;0;0;0;18401;14661;79;33062
01;2021-03-14;1;0;1;9633;6375;89;16008
01;2021-03-14;0;0;0;3410;1510;90;4920
01;2021-03-14;6;7;13;205664;171215;0;376879
02;2021-03-14;0;0;0;16881;17110;09;33991
02;2021-03-14;1;0;1;21410;21604;19;43014
02;2021-03-14;2;0;2;16017;15479;29;31496
02;2021-03-14;0;1;1;19825;14455;39;34280
02;2021-03-14;1;1;2;24719;18248;49;42967
02;2021-03-14;0;0;0;34361;28310;59;62671
02;2021-03-14;1;0;1;28061;24495;69;52556
02;2021-03-14;1;0;1;18231;15278;79;33509
02;2021-03-14;0;0;0;11090;7677;89;18767
02;2021-03-14;0;0;0;3992;1506;90;5498
02;2021-03-14;6;2;8;194587;164162;0;358749
03;2021-03-14;0;0;0;31123;30920;09;62043
03;2021-03-14;0;0;0;29370;29268;19;58638
03;2021-03-14;0;0;0;21458;18963;29;40421
03;2021-03-14;0;0;0;21276;18326;39;39602
03;2021-03-14;0;0;0;18164;16593;49;34757
03;2021-03-14;0;0;0;13469;13557;59;27026
03;2021-03-14;0;1;1;8776;8670;69;17446
03;2021-03-14;0;0;0;3777;3591;79;7368
03;2021-03-14;0;0;0;1649;1072;89;2721
03;2021-03-14;0;0;0;485;184;90;669
03;2021-03-14;0;1;1;149547;141144;0;290691
04;2021-03-14;1;0;1;60314;61377;09;121691
04;2021-03-14;3;0;3;66065;68387;19;134452
04;2021-03-14;1;4;5;51059;47156;29;98215
04;2021-03-14;3;5;8;58788;45780;39;104568
04;2021-03-14;5;2;7;61408;52207;49;113615
04;2021-03-14;5;2;7;64838;60759;59;125597
04;2021-03-14;1;2;3;47008;42843;69;89851
04;2021-03-14;1;0;1;25509;21184;79;46693
04;2021-03-14;0;0;0;13168;7647;89;20815
04;2021-03-14;1;0;1;3209;1253;90;4462
04;2021-03-14;21;15;36;451366;408593;0;859959
05;2021-03-14;0;0;0;362.366008612902;341.338819562748;09;703.704828175651
05;2021-03-14;0;0;0;353.376145114279;370.349735405642;19;723.725880519921
05;2021-03-14;0;0;0;218.593559489256;256.539602589476;29;475.133162078732
05;2021-03-14;0;0;0;404.225408693299;360.321910454353;39;764.547319147651
05;2021-03-14;0;0;0;520.067953604221;497.108383964256;49;1017.17633756848
05;2021-03-14;0;0;0;468.146063921917;510.087601910415;59;978.233665832332
05;2021-03-14;0;0;0;340.368470050554;334.366842191253;69;674.735312241807
05;2021-03-14;0;0;0;212.598666888387;192.597753227106;79;405.196420115493
05;2021-03-14;0;0;0;148.727797095705;61.8681715431829;89;210.595968638888
05;2021-03-14;0;0;0;32.9601271090696;10.9909785719784;90;43.9511056810479
05;2021-03-14;0;0;0;3061.43020057959;2935.56979942041;0;5997
06;2021-03-14;1;1;2;42583;42380;09;84963
06;2021-03-14;1;0;1;33369;31925;19;65294
06;2021-03-14;1;3;4;21571;15080;29;36651
06;2021-03-14;3;2;5;21550;16147;39;37697
06;2021-03-14;1;1;2;14193;13939;49;28132
06;2021-03-14;2;0;2;7171;7597;59;14768
06;2021-03-14;0;1;1;3629;4117;69;7746
06;2021-03-14;2;0;2;1577;1457;79;3034
06;2021-03-14;0;0;0;531;474;89;1005
06;2021-03-14;0;0;0;88;93;90;181
06;2021-03-14;11;8;19;146262;133209;0;279471
07;2021-03-14;0;0;0;485;549;09;1034
07;2021-03-14;0;0;0;403;432;19;835
07;2021-03-14;0;0;0;764;841;29;1605
07;2021-03-14;0;0;0;824;928;39;1752
07;2021-03-14;0;1;1;788;1020;49;1808
07;2021-03-14;0;0;0;678;870;59;1548
07;2021-03-14;1;0;1;360;382;69;742
07;2021-03-14;0;0;0;231;190;79;421
07;2021-03-14;0;0;0;114;67;89;181
07;2021-03-14;0;0;0;24;11;90;35
07;2021-03-14;1;1;2;4671;5290;0;9961
08;2021-03-14;0;0;0;2715.22592983026;2997.75551488675;09;5712.98144471701
08;2021-03-14;0;0;0;2778.51901080978;3160.9156459093;19;5939.43465671908
08;2021-03-14;0;0;0;2080.8882988764;1718.16634315323;29;3799.05464202964
08;2021-03-14;0;0;0;2701.8582062647;1896.52641413317;39;4598.38462039786
08;2021-03-14;0;0;0;3151.45861023308;2460.52498233809;49;5611.98359257117
08;2021-03-14;0;0;0;2620.29868333099;2422.23566154656;59;5042.53434487755
08;2021-03-14;0;0;0;1621.44173420671;1438.58325779464;69;3060.02499200135
08;2021-03-14;0;0;0;626.575909335673;526.358467843651;79;1152.93437717932
08;2021-03-14;0;0;0;205.018522985054;140.993639349697;89;346.012162334751
08;2021-03-14;0;0;0;50.0325684687745;20.62259870351;90;70.6551671722846
08;2021-03-14;0;0;0;18551.3174743414;16782.6825256586;0;35334
11;2021-03-14;57;53;116;783071;811785;09;1594856
11;2021-03-14;125;117;253;761456;784653;19;1546109
11;2021-03-14;183;192;375;850145;801772;29;1651917
11;2021-03-14;229;219;448;914360;843488;39;1757848
11;2021-03-14;187;170;357;845609;826202;49;1671811
11;2021-03-14;153;127;280;793566;745070;59;1538636
11;2021-03-14;64;88;153;628649;549192;69;1177841
11;2021-03-14;48;54;102;434606;358356;79;792962
11;2021-03-14;33;17;50;261425;162933;89;424358
11;2021-03-14;12;7;19;89253;32619;90;121872
11;2021-03-14;1091;1044;2153;6362140;5916070;0;12278210
24;2021-03-14;0;0;0;139720;144686;09;284406
24;2021-03-14;1;3;4;152979;161185;19;314164
24;2021-03-14;4;8;12;122237;126536;29;248773
24;2021-03-14;2;9;11;150359;142009;39;292368
24;2021-03-14;4;1;5;161829;158758;49;320587
24;2021-03-14;7;9;16;172552;168011;59;340563
24;2021-03-14;1;4;5;172509;158177;69;330686
24;2021-03-14;3;4;7;129428;110593;79;240021
24;2021-03-14;5;1;6;87342;56882;89;144224
24;2021-03-14;1;0;1;31210;12071;90;43281
24;2021-03-14;28;39;67;1320165;1238908;0;2559073
27;2021-03-14;2;2;4;143373;149679;09;293052
27;2021-03-14;5;11;16;160962;173003;19;333965
27;2021-03-14;3;3;6;133746;142254;29;276000
27;2021-03-14;11;12;23;160004;155407;39;315411
27;2021-03-14;15;5;20;172333;169564;49;341897
27;2021-03-14;11;9;20;189979;183788;59;373767
27;2021-03-14;2;6;8;192591;178206;69;370797
27;2021-03-14;5;5;10;146876;127546;79;274422
27;2021-03-14;4;6;10;96896;61575;89;158471
27;2021-03-14;3;0;3;33148;12109;90;45257
27;2021-03-14;61;59;120;1429908;1353131;0;2783039
28;2021-03-14;5;3;8;180735;186856;09;367591
28;2021-03-14;10;12;22;200125;213621;19;413746
28;2021-03-14;14;14;28;168922;173007;29;341929
28;2021-03-14;15;14;29;196628;188487;39;385115
28;2021-03-14;16;12;28;205396;201699;49;407095
28;2021-03-14;12;14;26;222002;213866;59;435868
28;2021-03-14;7;7;14;224688;203758;69;428446
28;2021-03-14;3;6;9;163192;135543;79;298735
28;2021-03-14;2;6;8;109691;65377;89;175068
28;2021-03-14;4;0;4;37222;12685;90;49907
28;2021-03-14;88;88;176;1708601;1594899;0;3303500
32;2021-03-14;16;29;45;358062;373689;09;731751
32;2021-03-14;43;45;88;387045;406742;19;793787
32;2021-03-14;58;54;113;342304;348587;29;690891
32;2021-03-14;49;38;87;382485;369972;39;752457
32;2021-03-14;53;60;113;382510;376716;49;759226
32;2021-03-14;30;37;67;386937;376527;59;763464
32;2021-03-14;29;20;49;371211;330938;69;702149
32;2021-03-14;13;24;37;250542;201459;79;452001
32;2021-03-14;9;7;16;163399;89786;89;253185
32;2021-03-14;9;4;13;48384;15367;90;63751
32;2021-03-14;309;319;629;3072879;2889783;0;5962662
44;2021-03-14;7;6;13;291525;306839;09;598364
44;2021-03-14;15;19;34;320255;339504;19;659759
44;2021-03-14;21;17;38;302020;314428;29;616448
44;2021-03-14;17;19;36;342222;333292;39;675514
44;2021-03-14;26;19;45;349727;344491;49;694218
44;2021-03-14;19;12;31;381371;373239;59;754610
44;2021-03-14;12;15;27;367165;335850;69;703015
44;2021-03-14;10;14;24;250387;215436;79;465823
44;2021-03-14;11;15;26;170825;105192;89;276017
44;2021-03-14;4;1;5;51248;16731;90;67979
44;2021-03-14;142;137;279;2826745;2685002;0;5511747
52;2021-03-14;6;7;14;213594;223900;09;437494
52;2021-03-14;13;11;24;240818;255197;19;496015
52;2021-03-14;16;13;29;197010;200630;29;397640
52;2021-03-14;13;15;28;231204;224885;39;456089
52;2021-03-14;21;15;36;243874;243418;49;487292
52;2021-03-14;14;13;27;244100;239116;59;483216
52;2021-03-14;4;4;8;241796;221345;69;463141
52;2021-03-14;4;6;10;177805;149903;79;327708
52;2021-03-14;3;5;8;119561;75822;89;195383
52;2021-03-14;4;2;6;42559;15260;90;57819
52;2021-03-14;98;91;190;1952321;1849476;0;3801797
53;2021-03-14;4;1;5;173813;182358;09;356171
53;2021-03-14;7;6;13;202720;214740;19;417460
53;2021-03-14;9;12;21;163116;173196;29;336312
53;2021-03-14;7;5;12;190526;187674;39;378200
53;2021-03-14;6;3;9;212098;212015;49;424113
53;2021-03-14;2;6;8;223699;219176;59;442875
53;2021-03-14;1;6;7;227435;209274;69;436709
53;2021-03-14;0;0;0;169992;140910;79;310902
53;2021-03-14;3;1;4;118117;69883;89;188000
53;2021-03-14;0;0;0;37370;12267;90;49637
53;2021-03-14;39;40;79;1718886;1621493;0;3340379
75;2021-03-14;2;1;3;293104;305291;09;598395
75;2021-03-14;10;7;17;337141;357785;19;694926
75;2021-03-14;13;10;23;295024;300618;29;595642
75;2021-03-14;17;10;27;347871;331233;39;679104
75;2021-03-14;6;9;15;384742;372771;49;757513
75;2021-03-14;10;8;18;413361;390880;59;804241
75;2021-03-14;7;6;14;425623;384060;69;809683
75;2021-03-14;5;4;9;325086;276298;79;601384
75;2021-03-14;5;9;14;213986;139308;89;353294
75;2021-03-14;6;1;7;77600;28200;90;105800
75;2021-03-14;81;65;147;3113538;2886444;0;5999982
76;2021-03-14;8;5;13;305956;318589;09;624545
76;2021-03-14;11;20;31;338942;356969;19;695911
76;2021-03-14;19;8;27;316210;319570;29;635780
76;2021-03-14;15;27;43;356758;337587;39;694345
76;2021-03-14;17;20;37;376541;363812;49;740353
76;2021-03-14;11;12;23;402608;383750;59;786358
76;2021-03-14;14;10;24;394889;358997;69;753886
76;2021-03-14;2;8;10;308664;263806;79;572470
76;2021-03-14;10;7;17;195838;129272;89;325110
76;2021-03-14;3;2;5;69372;26728;90;96100
76;2021-03-14;110;119;230;3065778;2859080;0;5924858
84;2021-03-14;11;12;23;459549;481088;09;940637
84;2021-03-14;29;24;53;487711;511905;19;999616
84;2021-03-14;26;22;48;443824;451094;29;894918
84;2021-03-14;37;46;83;512522;493262;39;1005784
84;2021-03-14;23;23;46;520248;515106;49;1035354
84;2021-03-14;21;31;52;529611;514848;59;1044459
84;2021-03-14;18;20;38;486720;439940;69;926660
84;2021-03-14;12;21;33;372151;315211;79;687362
84;2021-03-14;11;17;28;237198;150524;89;387722
84;2021-03-14;10;4;14;81185;28680;90;109865
84;2021-03-14;198;220;418;4130719;3901658;0;8032377
93;2021-03-14;7;10;17;268834;283093;09;551927
93;2021-03-14;27;20;47;280751;296087;19;576838
93;2021-03-14;34;22;56;254404;255552;29;509956
93;2021-03-14;33;25;59;310704;288398;39;599102
93;2021-03-14;31;40;71;325559;305827;49;631386
93;2021-03-14;26;34;60;353104;325389;59;678493
93;2021-03-14;17;28;45;336327;296459;69;632786
93;2021-03-14;10;19;29;279820;229699;79;509519
93;2021-03-14;10;9;19;171274;113716;89;284990
93;2021-03-14;4;4;8;58896;21758;90;80654
93;2021-03-14;199;211;411;2639673;2415978;0;5055651
94;2021-03-14;0;0;0;16311;17433;09;33744
94;2021-03-14;0;0;0;16679;18132;19;34811
94;2021-03-14;0;0;0;16782;16579;29;33361
94;2021-03-14;2;1;3;23044;20580;39;43624
94;2021-03-14;0;0;0;23065;22140;49;45205
94;2021-03-14;0;0;0;24549;23421;59;47970
94;2021-03-14;1;0;1;23212;21883;69;45095
94;2021-03-14;0;1;1;19544;17141;79;36685
94;2021-03-14;0;0;0;11227;8178;89;19405
94;2021-03-14;0;0;0;3332;1447;90;4779
94;2021-03-14;3;2;5;177745;166934;0;344679
01;2021-03-15;2;0;2;19979;20155;09;40134
01;2021-03-15;8;7;15;24994;25489;19;50483
01;2021-03-15;13;4;17;17868;16690;29;34558
01;2021-03-15;12;10;22;22328;14821;39;37149
01;2021-03-15;11;7;18;28652;20276;49;48928
01;2021-03-15;14;9;23;33264;27260;59;60524
01;2021-03-15;6;2;8;27135;23978;69;51113
01;2021-03-15;3;2;5;18401;14661;79;33062
01;2021-03-15;0;2;2;9633;6375;89;16008
01;2021-03-15;0;0;0;3410;1510;90;4920
01;2021-03-15;69;43;112;205664;171215;0;376879
02;2021-03-15;0;0;0;16881;17110;09;33991
02;2021-03-15;4;7;11;21410;21604;19;43014
02;2021-03-15;12;8;20;16017;15479;29;31496
02;2021-03-15;17;4;21;19825;14455;39;34280
02;2021-03-15;9;7;16;24719;18248;49;42967
02;2021-03-15;4;4;8;34361;28310;59;62671
02;2021-03-15;5;6;11;28061;24495;69;52556
02;2021-03-15;0;2;2;18231;15278;79;33509
02;2021-03-15;1;1;2;11090;7677;89;18767
02;2021-03-15;0;0;0;3992;1506;90;5498
02;2021-03-15;52;39;91;194587;164162;0;358749
03;2021-03-15;0;0;0;31123;30920;09;62043
03;2021-03-15;0;4;4;29370;29268;19;58638
03;2021-03-15;1;2;3;21458;18963;29;40421
03;2021-03-15;3;2;5;21276;18326;39;39602
03;2021-03-15;0;0;0;18164;16593;49;34757
03;2021-03-15;4;2;6;13469;13557;59;27026
03;2021-03-15;2;2;4;8776;8670;69;17446
03;2021-03-15;0;0;0;3777;3591;79;7368
03;2021-03-15;0;0;0;1649;1072;89;2721
03;2021-03-15;0;0;0;485;184;90;669
03;2021-03-15;10;12;22;149547;141144;0;290691
04;2021-03-15;2;3;5;60314;61377;09;121691
04;2021-03-15;11;8;19;66065;68387;19;134452
04;2021-03-15;25;16;41;51059;47156;29;98215
04;2021-03-15;21;11;32;58788;45780;39;104568
04;2021-03-15;18;19;37;61408;52207;49;113615
04;2021-03-15;16;24;40;64838;60759;59;125597
04;2021-03-15;15;9;24;47008;42843;69;89851
04;2021-03-15;2;1;3;25509;21184;79;46693
04;2021-03-15;2;2;4;13168;7647;89;20815
04;2021-03-15;0;0;0;3209;1253;90;4462
04;2021-03-15;112;93;205;451366;408593;0;859959
05;2021-03-15;0;0;0;362.366008612902;341.338819562748;09;703.704828175651
05;2021-03-15;0;0;0;353.376145114279;370.349735405642;19;723.725880519921
05;2021-03-15;0;0;0;218.593559489256;256.539602589476;29;475.133162078732
05;2021-03-15;0;0;0;404.225408693299;360.321910454353;39;764.547319147651
05;2021-03-15;0;0;0;520.067953604221;497.108383964256;49;1017.17633756848
05;2021-03-15;0;0;0;468.146063921917;510.087601910415;59;978.233665832332
05;2021-03-15;0;0;0;340.368470050554;334.366842191253;69;674.735312241807
05;2021-03-15;0;0;0;212.598666888387;192.597753227106;79;405.196420115493
05;2021-03-15;0;0;0;148.727797095705;61.8681715431829;89;210.595968638888
05;2021-03-15;0;0;0;32.9601271090696;10.9909785719784;90;43.9511056810479
05;2021-03-15;0;0;0;3061.43020057959;2935.56979942041;0;5997
06;2021-03-15;0;3;3;42583;42380;09;84963
06;2021-03-15;10;2;12;33369;31925;19;65294
06;2021-03-15;5;3;8;21571;15080;29;36651
06;2021-03-15;12;6;18;21550;16147;39;37697
06;2021-03-15;8;7;15;14193;13939;49;28132
06;2021-03-15;6;6;12;7171;7597;59;14768
06;2021-03-15;3;8;11;3629;4117;69;7746
06;2021-03-15;1;0;1;1577;1457;79;3034
06;2021-03-15;1;0;1;531;474;89;1005
06;2021-03-15;0;0;0;88;93;90;181
06;2021-03-15;46;35;81;146262;133209;0;279471
07;2021-03-15;0;0;0;485;549;09;1034
07;2021-03-15;0;0;0;403;432;19;835
07;2021-03-15;2;3;5;764;841;29;1605
07;2021-03-15;2;5;7;824;928;39;1752
07;2021-03-15;0;1;1;788;1020;49;1808
07;2021-03-15;1;1;2;678;870;59;1548
07;2021-03-15;0;1;1;360;382;69;742
07;2021-03-15;0;0;0;231;190;79;421
07;2021-03-15;0;0;0;114;67;89;181
07;2021-03-15;0;0;0;24;11;90;35
07;2021-03-15;5;11;16;4671;5290;0;9961
08;2021-03-15;0;0;0;2715.22592983026;2997.75551488675;09;5712.98144471701
08;2021-03-15;0;0;0;2778.51901080978;3160.9156459093;19;5939.43465671908
08;2021-03-15;0;0;0;2080.8882988764;1718.16634315323;29;3799.05464202964
08;2021-03-15;0;0;0;2701.8582062647;1896.52641413317;39;4598.38462039786
08;2021-03-15;0;0;0;3151.45861023308;2460.52498233809;49;5611.98359257117
08;2021-03-15;2;0;2;2620.29868333099;2422.23566154656;59;5042.53434487755
08;2021-03-15;0;0;0;1621.44173420671;1438.58325779464;69;3060.02499200135
08;2021-03-15;0;0;0;626.575909335673;526.358467843651;79;1152.93437717932
08;2021-03-15;0;0;0;205.018522985054;140.993639349697;89;346.012162334751
08;2021-03-15;0;0;0;50.0325684687745;20.62259870351;90;70.6551671722846
08;2021-03-15;2;0;2;18551.3174743414;16782.6825256586;0;35334
11;2021-03-15;353;388;790;783071;811785;09;1594856
11;2021-03-15;922;979;1978;761456;784653;19;1546109
11;2021-03-15;1301;1092;2402;850145;801772;29;1651917
11;2021-03-15;1397;1196;2599;914360;843488;39;1757848
11;2021-03-15;1235;1114;2360;845609;826202;49;1671811
11;2021-03-15;1023;998;2026;793566;745070;59;1538636
11;2021-03-15;604;560;1184;628649;549192;69;1177841
11;2021-03-15;253;252;508;434606;358356;79;792962
11;2021-03-15;131;104;236;261425;162933;89;424358
11;2021-03-15;51;20;72;89253;32619;90;121872
11;2021-03-15;7271;6703;14156;6362140;5916070;0;12278210
24;2021-03-15;21;20;41;139720;144686;09;284406
24;2021-03-15;89;80;172;152979;161185;19;314164
24;2021-03-15;88;87;175;122237;126536;29;248773
24;2021-03-15;89;84;173;150359;142009;39;292368
24;2021-03-15;106;82;188;161829;158758;49;320587
24;2021-03-15;102;98;200;172552;168011;59;340563
24;2021-03-15;64;65;129;172509;158177;69;330686
24;2021-03-15;32;46;78;129428;110593;79;240021
24;2021-03-15;20;14;34;87342;56882;89;144224
24;2021-03-15;13;7;20;31210;12071;90;43281
24;2021-03-15;624;583;1210;1320165;1238908;0;2559073
27;2021-03-15;34;42;77;143373;149679;09;293052
27;2021-03-15;90;103;194;160962;173003;19;333965
27;2021-03-15;97;134;231;133746;142254;29;276000
27;2021-03-15;108;91;199;160004;155407;39;315411
27;2021-03-15;101;92;193;172333;169564;49;341897
27;2021-03-15;82;94;176;189979;183788;59;373767
27;2021-03-15;58;69;127;192591;178206;69;370797
27;2021-03-15;34;43;77;146876;127546;79;274422
27;2021-03-15;13;19;32;96896;61575;89;158471
27;2021-03-15;8;0;8;33148;12109;90;45257
27;2021-03-15;625;687;1314;1429908;1353131;0;2783039
28;2021-03-15;41;45;88;180735;186856;09;367591
28;2021-03-15;112;140;254;200125;213621;19;413746
28;2021-03-15;159;116;275;168922;173007;29;341929
28;2021-03-15;157;177;334;196628;188487;39;385115
28;2021-03-15;141;124;265;205396;201699;49;407095
28;2021-03-15;151;139;290;222002;213866;59;435868
28;2021-03-15;130;127;257;224688;203758;69;428446
28;2021-03-15;71;62;133;163192;135543;79;298735
28;2021-03-15;38;25;63;109691;65377;89;175068
28;2021-03-15;22;9;31;37222;12685;90;49907
28;2021-03-15;1022;964;1990;1708601;1594899;0;3303500
32;2021-03-15;191;206;397;358062;373689;09;731751
32;2021-03-15;389;414;803;387045;406742;19;793787
32;2021-03-15;503;411;914;342304;348587;29;690891
32;2021-03-15;473;473;946;382485;369972;39;752457
32;2021-03-15;483;388;871;382510;376716;49;759226
32;2021-03-15;427;400;827;386937;376527;59;763464
32;2021-03-15;278;246;524;371211;330938;69;702149
32;2021-03-15;176;142;318;250542;201459;79;452001
32;2021-03-15;111;78;190;163399;89786;89;253185
32;2021-03-15;48;12;60;48384;15367;90;63751
32;2021-03-15;3079;2771;5851;3072879;2889783;0;5962662
44;2021-03-15;107;73;180;291525;306839;09;598364
44;2021-03-15;215;236;454;320255;339504;19;659759
44;2021-03-15;251;240;491;302020;314428;29;616448
44;2021-03-15;273;219;492;342222;333292;39;675514
44;2021-03-15;241;244;485;349727;344491;49;694218
44;2021-03-15;210;227;439;381371;373239;59;754610
44;2021-03-15;171;146;319;367165;335850;69;703015
44;2021-03-15;98;89;188;250387;215436;79;465823
44;2021-03-15;58;49;109;170825;105192;89;276017
44;2021-03-15;27;14;42;51248;16731;90;67979
44;2021-03-15;1651;1537;3199;2826745;2685002;0;5511747
52;2021-03-15;25;30;56;213594;223900;09;437494
52;2021-03-15;125;111;238;240818;255197;19;496015
52;2021-03-15;128;119;247;197010;200630;29;397640
52;2021-03-15;124;98;222;231204;224885;39;456089
52;2021-03-15;123;111;234;243874;243418;49;487292
52;2021-03-15;79;102;181;244100;239116;59;483216
52;2021-03-15;79;63;142;241796;221345;69;463141
52;2021-03-15;59;54;113;177805;149903;79;327708
52;2021-03-15;37;24;61;119561;75822;89;195383
52;2021-03-15;27;17;44;42559;15260;90;57819
52;2021-03-15;806;729;1538;1952321;1849476;0;3801797
53;2021-03-15;36;26;62;173813;182358;09;356171
53;2021-03-15;83;88;171;202720;214740;19;417460
53;2021-03-15;102;111;213;163116;173196;29;336312
53;2021-03-15;103;61;165;190526;187674;39;378200
53;2021-03-15;97;78;175;212098;212015;49;424113
53;2021-03-15;86;66;152;223699;219176;59;442875
53;2021-03-15;53;44;97;227435;209274;69;436709
53;2021-03-15;24;36;60;169992;140910;79;310902
53;2021-03-15;17;13;30;118117;69883;89;188000
53;2021-03-15;3;2;5;37370;12267;90;49637
53;2021-03-15;604;525;1130;1718886;1621493;0;3340379
75;2021-03-15;52;53;106;293104;305291;09;598395
75;2021-03-15;144;159;304;337141;357785;19;694926
75;2021-03-15;170;144;314;295024;300618;29;595642
75;2021-03-15;149;150;299;347871;331233;39;679104
75;2021-03-15;173;162;335;384742;372771;49;757513
75;2021-03-15;152;131;283;413361;390880;59;804241
75;2021-03-15;91;90;181;425623;384060;69;809683
75;2021-03-15;73;64;137;325086;276298;79;601384
75;2021-03-15;44;30;74;213986;139308;89;353294
75;2021-03-15;18;9;27;77600;28200;90;105800
75;2021-03-15;1066;993;2061;3113538;2886444;0;5999982
76;2021-03-15;62;63;130;305956;318589;09;624545
76;2021-03-15;179;169;353;338942;356969;19;695911
76;2021-03-15;196;196;392;316210;319570;29;635780
76;2021-03-15;234;194;430;356758;337587;39;694345
76;2021-03-15;220;209;430;376541;363812;49;740353
76;2021-03-15;194;138;332;402608;383750;59;786358
76;2021-03-15;138;110;248;394889;358997;69;753886
76;2021-03-15;74;69;144;308664;263806;79;572470
76;2021-03-15;48;34;82;195838;129272;89;325110
76;2021-03-15;24;17;41;69372;26728;90;96100
76;2021-03-15;1370;1200;2584;3065778;2859080;0;5924858
84;2021-03-15;130;105;239;459549;481088;09;940637
84;2021-03-15;386;397;790;487711;511905;19;999616
84;2021-03-15;396;368;765;443824;451094;29;894918
84;2021-03-15;421;370;791;512522;493262;39;1005784
84;2021-03-15;408;384;792;520248;515106;49;1035354
84;2021-03-15;301;325;626;529611;514848;59;1044459
84;2021-03-15;253;168;421;486720;439940;69;926660
84;2021-03-15;130;129;259;372151;315211;79;687362
84;2021-03-15;57;48;105;237198;150524;89;387722
84;2021-03-15;21;9;30;81185;28680;90;109865
84;2021-03-15;2503;2303;4818;4130719;3901658;0;8032377
93;2021-03-15;88;87;175;268834;283093;09;551927
93;2021-03-15;224;244;470;280751;296087;19;576838
93;2021-03-15;358;308;667;254404;255552;29;509956
93;2021-03-15;349;314;663;310704;288398;39;599102
93;2021-03-15;356;304;661;325559;305827;49;631386
93;2021-03-15;328;319;648;353104;325389;59;678493
93;2021-03-15;254;201;455;336327;296459;69;632786
93;2021-03-15;133;127;260;279820;229699;79;509519
93;2021-03-15;88;48;136;171274;113716;89;284990
93;2021-03-15;39;9;48;58896;21758;90;80654
93;2021-03-15;2217;1962;4184;2639673;2415978;0;5055651
94;2021-03-15;4;4;8;16311;17433;09;33744
94;2021-03-15;6;3;9;16679;18132;19;34811
94;2021-03-15;5;4;9;16782;16579;29;33361
94;2021-03-15;15;10;25;23044;20580;39;43624
94;2021-03-15;6;10;16;23065;22140;49;45205
94;2021-03-15;11;5;16;24549;23421;59;47970
94;2021-03-15;10;7;17;23212;21883;69;45095
94;2021-03-15;3;5;8;19544;17141;79;36685
94;2021-03-15;3;2;5;11227;8178;89;19405
94;2021-03-15;2;0;2;3332;1447;90;4779
94;2021-03-15;65;50;115;177745;166934;0;344679
01;2021-03-16;0;0;0;19979;20155;09;40134
01;2021-03-16;2;6;8;24994;25489;19;50483
01;2021-03-16;6;3;9;17868;16690;29;34558
01;2021-03-16;9;8;17;22328;14821;39;37149
01;2021-03-16;10;8;18;28652;20276;49;48928
01;2021-03-16;11;7;18;33264;27260;59;60524
01;2021-03-16;3;4;7;27135;23978;69;51113
01;2021-03-16;3;2;5;18401;14661;79;33062
01;2021-03-16;0;0;0;9633;6375;89;16008
01;2021-03-16;0;0;0;3410;1510;90;4920
01;2021-03-16;44;38;82;205664;171215;0;376879
02;2021-03-16;2;1;3;16881;17110;09;33991
02;2021-03-16;1;4;5;21410;21604;19;43014
02;2021-03-16;7;5;12;16017;15479;29;31496
02;2021-03-16;8;3;11;19825;14455;39;34280
02;2021-03-16;4;13;17;24719;18248;49;42967
02;2021-03-16;10;5;15;34361;28310;59;62671
02;2021-03-16;1;3;4;28061;24495;69;52556
02;2021-03-16;1;1;2;18231;15278;79;33509
02;2021-03-16;0;0;0;11090;7677;89;18767
02;2021-03-16;0;0;0;3992;1506;90;5498
02;2021-03-16;34;35;69;194587;164162;0;358749
03;2021-03-16;0;0;0;31123;30920;09;62043
03;2021-03-16;0;1;1;29370;29268;19;58638
03;2021-03-16;0;2;2;21458;18963;29;40421
03;2021-03-16;2;2;4;21276;18326;39;39602
03;2021-03-16;1;1;2;18164;16593;49;34757
03;2021-03-16;2;2;4;13469;13557;59;27026
03;2021-03-16;0;0;0;8776;8670;69;17446
03;2021-03-16;0;0;0;3777;3591;79;7368
03;2021-03-16;0;0;0;1649;1072;89;2721
03;2021-03-16;0;0;0;485;184;90;669
03;2021-03-16;5;8;13;149547;141144;0;290691
04;2021-03-16;6;5;11;60314;61377;09;121691
04;2021-03-16;12;16;28;66065;68387;19;134452
04;2021-03-16;10;11;21;51059;47156;29;98215
04;2021-03-16;13;12;25;58788;45780;39;104568
04;2021-03-16;17;19;36;61408;52207;49;113615
04;2021-03-16;14;14;28;64838;60759;59;125597
04;2021-03-16;12;7;19;47008;42843;69;89851
04;2021-03-16;2;4;6;25509;21184;79;46693
04;2021-03-16;0;3;3;13168;7647;89;20815
04;2021-03-16;2;0;2;3209;1253;90;4462
04;2021-03-16;88;91;179;451366;408593;0;859959
05;2021-03-16;0;0;0;362.366008612902;341.338819562748;09;703.704828175651
05;2021-03-16;0;0;0;353.376145114279;370.349735405642;19;723.725880519921
05;2021-03-16;0;0;0;218.593559489256;256.539602589476;29;475.133162078732
05;2021-03-16;0;0;0;404.225408693299;360.321910454353;39;764.547319147651
05;2021-03-16;0;0;0;520.067953604221;497.108383964256;49;1017.17633756848
05;2021-03-16;0;0;0;468.146063921917;510.087601910415;59;978.233665832332
05;2021-03-16;0;0;0;340.368470050554;334.366842191253;69;674.735312241807
05;2021-03-16;0;0;0;212.598666888387;192.597753227106;79;405.196420115493
05;2021-03-16;0;0;0;148.727797095705;61.8681715431829;89;210.595968638888
05;2021-03-16;0;0;0;32.9601271090696;10.9909785719784;90;43.9511056810479
05;2021-03-16;0;0;0;3061.43020057959;2935.56979942041;0;5997
06;2021-03-16;0;2;2;42583;42380;09;84963
06;2021-03-16;5;3;8;33369;31925;19;65294
06;2021-03-16;13;1;14;21571;15080;29;36651
06;2021-03-16;3;7;10;21550;16147;39;37697
06;2021-03-16;4;8;12;14193;13939;49;28132
06;2021-03-16;2;7;9;7171;7597;59;14768
06;2021-03-16;1;5;6;3629;4117;69;7746
06;2021-03-16;0;0;0;1577;1457;79;3034
06;2021-03-16;1;0;1;531;474;89;1005
06;2021-03-16;0;0;0;88;93;90;181
06;2021-03-16;29;33;62;146262;133209;0;279471
07;2021-03-16;1;1;2;485;549;09;1034
07;2021-03-16;0;0;0;403;432;19;835
07;2021-03-16;3;5;8;764;841;29;1605
07;2021-03-16;2;2;4;824;928;39;1752
07;2021-03-16;4;1;5;788;1020;49;1808
07;2021-03-16;0;0;0;678;870;59;1548
07;2021-03-16;0;0;0;360;382;69;742
07;2021-03-16;0;0;0;231;190;79;421
07;2021-03-16;0;0;0;114;67;89;181
07;2021-03-16;0;0;0;24;11;90;35
07;2021-03-16;10;9;19;4671;5290;0;9961
08;2021-03-16;0;0;0;2715.22592983026;2997.75551488675;09;5712.98144471701
08;2021-03-16;2;0;2;2778.51901080978;3160.9156459093;19;5939.43465671908
08;2021-03-16;0;0;0;2080.8882988764;1718.16634315323;29;3799.05464202964
08;2021-03-16;0;0;0;2701.8582062647;1896.52641413317;39;4598.38462039786
08;2021-03-16;0;0;0;3151.45861023308;2460.52498233809;49;5611.98359257117
08;2021-03-16;1;1;2;2620.29868333099;2422.23566154656;59;5042.53434487755
08;2021-03-16;0;0;0;1621.44173420671;1438.58325779464;69;3060.02499200135
08;2021-03-16;1;0;1;626.575909335673;526.358467843651;79;1152.93437717932
08;2021-03-16;0;0;0;205.018522985054;140.993639349697;89;346.012162334751
08;2021-03-16;0;0;0;50.0325684687745;20.62259870351;90;70.6551671722846
08;2021-03-16;4;1;5;18551.3174743414;16782.6825256586;0;35334
11;2021-03-16;334;395;764;783071;811785;09;1594856
11;2021-03-16;828;889;1778;761456;784653;19;1546109
11;2021-03-16;1116;963;2088;850145;801772;29;1651917
11;2021-03-16;1187;913;2114;914360;843488;39;1757848
11;2021-03-16;955;945;1911;845609;826202;49;1671811
11;2021-03-16;757;754;1516;793566;745070;59;1538636
11;2021-03-16;488;460;964;628649;549192;69;1177841
11;2021-03-16;205;181;386;434606;358356;79;792962
11;2021-03-16;113;83;196;261425;162933;89;424358
11;2021-03-16;71;22;93;89253;32619;90;121872
11;2021-03-16;6056;5606;11813;6362140;5916070;0;12278210
24;2021-03-16;26;25;52;139720;144686;09;284406
24;2021-03-16;76;79;157;152979;161185;19;314164
24;2021-03-16;83;91;174;122237;126536;29;248773
24;2021-03-16;87;64;151;150359;142009;39;292368
24;2021-03-16;82;92;174;161829;158758;49;320587
24;2021-03-16;76;77;153;172552;168011;59;340563
24;2021-03-16;55;53;108;172509;158177;69;330686
24;2021-03-16;27;44;71;129428;110593;79;240021
24;2021-03-16;10;15;25;87342;56882;89;144224
24;2021-03-16;4;4;8;31210;12071;90;43281
24;2021-03-16;526;544;1073;1320165;1238908;0;2559073
27;2021-03-16;17;31;48;143373;149679;09;293052
27;2021-03-16;99;104;204;160962;173003;19;333965
27;2021-03-16;84;85;169;133746;142254;29;276000
27;2021-03-16;96;53;149;160004;155407;39;315411
27;2021-03-16;81;70;151;172333;169564;49;341897
27;2021-03-16;79;70;149;189979;183788;59;373767
27;2021-03-16;54;47;101;192591;178206;69;370797
27;2021-03-16;28;28;56;146876;127546;79;274422
27;2021-03-16;24;7;31;96896;61575;89;158471
27;2021-03-16;7;2;9;33148;12109;90;45257
27;2021-03-16;569;497;1067;1429908;1353131;0;2783039
28;2021-03-16;50;35;85;180735;186856;09;367591
28;2021-03-16;125;98;225;200125;213621;19;413746
28;2021-03-16;150;124;275;168922;173007;29;341929
28;2021-03-16;128;120;248;196628;188487;39;385115
28;2021-03-16;124;115;239;205396;201699;49;407095
28;2021-03-16;110;106;216;222002;213866;59;435868
28;2021-03-16;105;77;182;224688;203758;69;428446
28;2021-03-16;54;48;102;163192;135543;79;298735
28;2021-03-16;40;19;59;109691;65377;89;175068
28;2021-03-16;15;4;19;37222;12685;90;49907
28;2021-03-16;901;746;1650;1708601;1594899;0;3303500
32;2021-03-16;124;142;267;358062;373689;09;731751
32;2021-03-16;312;323;636;387045;406742;19;793787
32;2021-03-16;377;316;693;342304;348587;29;690891
32;2021-03-16;337;301;638;382485;369972;39;752457
32;2021-03-16;322;299;621;382510;376716;49;759226
32;2021-03-16;277;279;556;386937;376527;59;763464
32;2021-03-16;214;174;388;371211;330938;69;702149
32;2021-03-16;116;101;217;250542;201459;79;452001
32;2021-03-16;98;56;154;163399;89786;89;253185
32;2021-03-16;45;23;68;48384;15367;90;63751
32;2021-03-16;2223;2014;4239;3072879;2889783;0;5962662
44;2021-03-16;82;72;157;291525;306839;09;598364
44;2021-03-16;176;188;368;320255;339504;19;659759
44;2021-03-16;184;189;374;302020;314428;29;616448
44;2021-03-16;172;171;343;342222;333292;39;675514
44;2021-03-16;162;156;320;349727;344491;49;694218
44;2021-03-16;156;131;287;381371;373239;59;754610
44;2021-03-16;125;100;225;367165;335850;69;703015
44;2021-03-16;70;58;132;250387;215436;79;465823
44;2021-03-16;42;24;66;170825;105192;89;276017
44;2021-03-16;19;10;29;51248;16731;90;67979
44;2021-03-16;1188;1099;2301;2826745;2685002;0;5511747
52;2021-03-16;36;31;67;213594;223900;09;437494
52;2021-03-16;107;103;212;240818;255197;19;496015
52;2021-03-16;112;96;208;197010;200630;29;397640
52;2021-03-16;103;75;178;231204;224885;39;456089
52;2021-03-16;81;69;150;243874;243418;49;487292
52;2021-03-16;74;74;148;244100;239116;59;483216
52;2021-03-16;67;61;128;241796;221345;69;463141
52;2021-03-16;40;37;77;177805;149903;79;327708
52;2021-03-16;34;14;48;119561;75822;89;195383
52;2021-03-16;17;5;22;42559;15260;90;57819
52;2021-03-16;671;565;1238;1952321;1849476;0;3801797
53;2021-03-16;32;22;55;173813;182358;09;356171
53;2021-03-16;62;91;153;202720;214740;19;417460
53;2021-03-16;98;89;190;163116;173196;29;336312
53;2021-03-16;59;66;125;190526;187674;39;378200
53;2021-03-16;88;81;169;212098;212015;49;424113
53;2021-03-16;45;71;116;223699;219176;59;442875
53;2021-03-16;25;26;51;227435;209274;69;436709
53;2021-03-16;19;25;44;169992;140910;79;310902
53;2021-03-16;14;8;22;118117;69883;89;188000
53;2021-03-16;13;2;15;37370;12267;90;49637
53;2021-03-16;455;481;940;1718886;1621493;0;3340379
75;2021-03-16;59;61;124;293104;305291;09;598395
75;2021-03-16;126;153;279;337141;357785;19;694926
75;2021-03-16;122;131;253;295024;300618;29;595642
75;2021-03-16;130;111;241;347871;331233;39;679104
75;2021-03-16;137;106;243;384742;372771;49;757513
75;2021-03-16;107;97;204;413361;390880;59;804241
75;2021-03-16;95;55;150;425623;384060;69;809683
75;2021-03-16;36;36;72;325086;276298;79;601384
75;2021-03-16;28;29;57;213986;139308;89;353294
75;2021-03-16;24;10;34;77600;28200;90;105800
75;2021-03-16;864;789;1657;3113538;2886444;0;5999982
76;2021-03-16;57;53;113;305956;318589;09;624545
76;2021-03-16;144;160;306;338942;356969;19;695911
76;2021-03-16;157;173;330;316210;319570;29;635780
76;2021-03-16;166;132;298;356758;337587;39;694345
76;2021-03-16;163;145;309;376541;363812;49;740353
76;2021-03-16;145;113;258;402608;383750;59;786358
76;2021-03-16;111;80;191;394889;358997;69;753886
76;2021-03-16;49;66;115;308664;263806;79;572470
76;2021-03-16;41;22;63;195838;129272;89;325110
76;2021-03-16;11;5;16;69372;26728;90;96100
76;2021-03-16;1045;950;2001;3065778;2859080;0;5924858
84;2021-03-16;112;140;254;459549;481088;09;940637
84;2021-03-16;314;345;659;487711;511905;19;999616
84;2021-03-16;294;274;568;443824;451094;29;894918
84;2021-03-16;319;267;586;512522;493262;39;1005784
84;2021-03-16;284;283;567;520248;515106;49;1035354
84;2021-03-16;261;246;507;529611;514848;59;1044459
84;2021-03-16;179;155;334;486720;439940;69;926660
84;2021-03-16;92;90;183;372151;315211;79;687362
84;2021-03-16;47;40;87;237198;150524;89;387722
84;2021-03-16;18;10;28;81185;28680;90;109865
84;2021-03-16;1921;1852;3778;4130719;3901658;0;8032377
93;2021-03-16;50;60;112;268834;283093;09;551927
93;2021-03-16;186;163;350;280751;296087;19;576838
93;2021-03-16;287;211;498;254404;255552;29;509956
93;2021-03-16;291;208;499;310704;288398;39;599102
93;2021-03-16;228;208;436;325559;305827;49;631386
93;2021-03-16;221;186;408;353104;325389;59;678493
93;2021-03-16;155;154;311;336327;296459;69;632786
93;2021-03-16;97;93;190;279820;229699;79;509519
93;2021-03-16;77;36;113;171274;113716;89;284990
93;2021-03-16;34;9;43;58896;21758;90;80654
93;2021-03-16;1626;1329;2961;2639673;2415978;0;5055651
94;2021-03-16;3;1;4;16311;17433;09;33744
94;2021-03-16;6;8;15;16679;18132;19;34811
94;2021-03-16;3;5;8;16782;16579;29;33361
94;2021-03-16;12;5;17;23044;20580;39;43624
94;2021-03-16;4;1;5;23065;22140;49;45205
94;2021-03-16;5;7;12;24549;23421;59;47970
94;2021-03-16;4;3;7;23212;21883;69;45095
94;2021-03-16;1;2;3;19544;17141;79;36685
94;2021-03-16;1;0;1;11227;8178;89;19405
94;2021-03-16;1;0;1;3332;1447;90;4779
94;2021-03-16;40;32;73;177745;166934;0;344679
01;2021-03-17;0;0;0;19979;20155;09;40134
01;2021-03-17;2;4;6;24994;25489;19;50483
01;2021-03-17;6;4;10;17868;16690;29;34558
01;2021-03-17;6;1;7;22328;14821;39;37149
01;2021-03-17;5;2;7;28652;20276;49;48928
01;2021-03-17;9;6;15;33264;27260;59;60524
01;2021-03-17;3;3;6;27135;23978;69;51113
01;2021-03-17;1;1;2;18401;14661;79;33062
01;2021-03-17;1;1;2;9633;6375;89;16008
01;2021-03-17;0;0;0;3410;1510;90;4920
01;2021-03-17;33;22;55;205664;171215;0;376879
02;2021-03-17;1;1;2;16881;17110;09;33991
02;2021-03-17;2;0;2;21410;21604;19;43014
02;2021-03-17;8;1;9;16017;15479;29;31496
02;2021-03-17;10;8;18;19825;14455;39;34280
02;2021-03-17;9;2;11;24719;18248;49;42967
02;2021-03-17;10;9;19;34361;28310;59;62671
02;2021-03-17;4;4;8;28061;24495;69;52556
02;2021-03-17;2;1;3;18231;15278;79;33509
02;2021-03-17;1;0;1;11090;7677;89;18767
02;2021-03-17;0;0;0;3992;1506;90;5498
02;2021-03-17;47;26;73;194587;164162;0;358749
03;2021-03-17;0;0;0;31123;30920;09;62043
03;2021-03-17;0;0;0;29370;29268;19;58638
03;2021-03-17;4;1;5;21458;18963;29;40421
03;2021-03-17;1;2;3;21276;18326;39;39602
03;2021-03-17;3;0;3;18164;16593;49;34757
03;2021-03-17;0;0;0;13469;13557;59;27026
03;2021-03-17;0;0;0;8776;8670;69;17446
03;2021-03-17;0;0;0;3777;3591;79;7368
03;2021-03-17;0;0;0;1649;1072;89;2721
03;2021-03-17;0;0;0;485;184;90;669
03;2021-03-17;8;3;11;149547;141144;0;290691
04;2021-03-17;5;2;7;60314;61377;09;121691
04;2021-03-17;19;13;32;66065;68387;19;134452
04;2021-03-17;17;7;24;51059;47156;29;98215
04;2021-03-17;14;17;31;58788;45780;39;104568
04;2021-03-17;21;14;35;61408;52207;49;113615
04;2021-03-17;14;14;28;64838;60759;59;125597
04;2021-03-17;5;7;12;47008;42843;69;89851
04;2021-03-17;5;4;9;25509;21184;79;46693
04;2021-03-17;0;4;4;13168;7647;89;20815
04;2021-03-17;0;0;0;3209;1253;90;4462
04;2021-03-17;100;82;182;451366;408593;0;859959
05;2021-03-17;0;0;0;362.366008612902;341.338819562748;09;703.704828175651
05;2021-03-17;0;0;0;353.376145114279;370.349735405642;19;723.725880519921
05;2021-03-17;0;0;0;218.593559489256;256.539602589476;29;475.133162078732
05;2021-03-17;0;0;0;404.225408693299;360.321910454353;39;764.547319147651
05;2021-03-17;0;0;0;520.067953604221;497.108383964256;49;1017.17633756848
05;2021-03-17;0;0;0;468.146063921917;510.087601910415;59;978.233665832332
05;2021-03-17;1;0;1;340.368470050554;334.366842191253;69;674.735312241807
05;2021-03-17;0;0;0;212.598666888387;192.597753227106;79;405.196420115493
05;2021-03-17;0;0;0;148.727797095705;61.8681715431829;89;210.595968638888
05;2021-03-17;0;0;0;32.9601271090696;10.9909785719784;90;43.9511056810479
05;2021-03-17;1;0;1;3061.43020057959;2935.56979942041;0;5997
06;2021-03-17;0;0;0;42583;42380;09;84963
06;2021-03-17;2;1;3;33369;31925;19;65294
06;2021-03-17;3;1;4;21571;15080;29;36651
06;2021-03-17;9;3;12;21550;16147;39;37697
06;2021-03-17;2;4;6;14193;13939;49;28132
06;2021-03-17;1;4;5;7171;7597;59;14768
06;2021-03-17;14;9;23;3629;4117;69;7746
06;2021-03-17;0;0;0;1577;1457;79;3034
06;2021-03-17;0;1;1;531;474;89;1005
06;2021-03-17;0;0;0;88;93;90;181
06;2021-03-17;31;23;54;146262;133209;0;279471
07;2021-03-17;1;2;3;485;549;09;1034
07;2021-03-17;1;0;1;403;432;19;835
07;2021-03-17;2;1;3;764;841;29;1605
07;2021-03-17;0;0;0;824;928;39;1752
07;2021-03-17;1;1;2;788;1020;49;1808
07;2021-03-17;1;3;4;678;870;59;1548
07;2021-03-17;1;0;1;360;382;69;742
07;2021-03-17;1;0;1;231;190;79;421
07;2021-03-17;0;0;0;114;67;89;181
07;2021-03-17;0;0;0;24;11;90;35
07;2021-03-17;8;7;15;4671;5290;0;9961
08;2021-03-17;0;0;0;2715.22592983026;2997.75551488675;09;5712.98144471701
08;2021-03-17;0;0;0;2778.51901080978;3160.9156459093;19;5939.43465671908
08;2021-03-17;1;1;2;2080.8882988764;1718.16634315323;29;3799.05464202964
08;2021-03-17;0;1;1;2701.8582062647;1896.52641413317;39;4598.38462039786
08;2021-03-17;1;0;1;3151.45861023308;2460.52498233809;49;5611.98359257117
08;2021-03-17;0;0;0;2620.29868333099;2422.23566154656;59;5042.53434487755
08;2021-03-17;0;1;1;1621.44173420671;1438.58325779464;69;3060.02499200135
08;2021-03-17;0;0;0;626.575909335673;526.358467843651;79;1152.93437717932
08;2021-03-17;0;0;0;205.018522985054;140.993639349697;89;346.012162334751
08;2021-03-17;0;0;0;50.0325684687745;20.62259870351;90;70.6551671722846
08;2021-03-17;2;3;5;18551.3174743414;16782.6825256586;0;35334
11;2021-03-17;314;371;726;783071;811785;09;1594856
11;2021-03-17;808;865;1745;761456;784653;19;1546109
11;2021-03-17;1069;927;2001;850145;801772;29;1651917
11;2021-03-17;1102;903;2016;914360;843488;39;1757848
11;2021-03-17;953;797;1756;845609;826202;49;1671811
11;2021-03-17;693;674;1375;793566;745070;59;1538636
11;2021-03-17;422;393;830;628649;549192;69;1177841
11;2021-03-17;190;177;369;434606;358356;79;792962
11;2021-03-17;106;83;191;261425;162933;89;424358
11;2021-03-17;39;20;59;89253;32619;90;121872
11;2021-03-17;5696;5213;11071;6362140;5916070;0;12278210
24;2021-03-17;24;32;57;139720;144686;09;284406
24;2021-03-17;86;83;173;152979;161185;19;314164
24;2021-03-17;73;105;178;122237;126536;29;248773
24;2021-03-17;86;97;183;150359;142009;39;292368
24;2021-03-17;81;72;153;161829;158758;49;320587
24;2021-03-17;77;62;139;172552;168011;59;340563
24;2021-03-17;51;52;103;172509;158177;69;330686
24;2021-03-17;26;24;50;129428;110593;79;240021
24;2021-03-17;20;17;37;87342;56882;89;144224
24;2021-03-17;11;3;14;31210;12071;90;43281
24;2021-03-17;535;547;1087;1320165;1238908;0;2559073
27;2021-03-17;22;29;51;143373;149679;09;293052
27;2021-03-17;90;71;161;160962;173003;19;333965
27;2021-03-17;84;56;140;133746;142254;29;276000
27;2021-03-17;64;43;107;160004;155407;39;315411
27;2021-03-17;80;44;124;172333;169564;49;341897
27;2021-03-17;65;65;130;189979;183788;59;373767
27;2021-03-17;47;49;96;192591;178206;69;370797
27;2021-03-17;34;16;50;146876;127546;79;274422
27;2021-03-17;22;9;31;96896;61575;89;158471
27;2021-03-17;12;6;18;33148;12109;90;45257
27;2021-03-17;520;388;908;1429908;1353131;0;2783039
28;2021-03-17;22;46;70;180735;186856;09;367591
28;2021-03-17;99;117;217;200125;213621;19;413746
28;2021-03-17;111;122;233;168922;173007;29;341929
28;2021-03-17;133;112;245;196628;188487;39;385115
28;2021-03-17;124;99;223;205396;201699;49;407095
28;2021-03-17;106;87;193;222002;213866;59;435868
28;2021-03-17;87;67;154;224688;203758;69;428446
28;2021-03-17;43;25;68;163192;135543;79;298735
28;2021-03-17;23;16;39;109691;65377;89;175068
28;2021-03-17;17;4;21;37222;12685;90;49907
28;2021-03-17;765;695;1463;1708601;1594899;0;3303500
32;2021-03-17;139;148;287;358062;373689;09;731751
32;2021-03-17;279;319;600;387045;406742;19;793787
32;2021-03-17;314;311;626;342304;348587;29;690891
32;2021-03-17;315;301;617;382485;369972;39;752457
32;2021-03-17;337;264;602;382510;376716;49;759226
32;2021-03-17;267;273;540;386937;376527;59;763464
32;2021-03-17;189;184;373;371211;330938;69;702149
32;2021-03-17;98;86;184;250542;201459;79;452001
32;2021-03-17;70;50;120;163399;89786;89;253185
32;2021-03-17;28;21;49;48384;15367;90;63751
32;2021-03-17;2037;1958;4000;3072879;2889783;0;5962662
44;2021-03-17;64;54;121;291525;306839;09;598364
44;2021-03-17;189;136;326;320255;339504;19;659759
44;2021-03-17;176;190;366;302020;314428;29;616448
44;2021-03-17;155;152;308;342222;333292;39;675514
44;2021-03-17;171;161;333;349727;344491;49;694218
44;2021-03-17;157;130;287;381371;373239;59;754610
44;2021-03-17;110;95;206;367165;335850;69;703015
44;2021-03-17;74;65;141;250387;215436;79;465823
44;2021-03-17;41;27;68;170825;105192;89;276017
44;2021-03-17;16;9;25;51248;16731;90;67979
44;2021-03-17;1153;1019;2181;2826745;2685002;0;5511747
52;2021-03-17;20;34;57;213594;223900;09;437494
52;2021-03-17;99;98;200;240818;255197;19;496015
52;2021-03-17;98;91;189;197010;200630;29;397640
52;2021-03-17;96;66;162;231204;224885;39;456089
52;2021-03-17;70;71;141;243874;243418;49;487292
52;2021-03-17;71;70;141;244100;239116;59;483216
52;2021-03-17;41;51;92;241796;221345;69;463141
52;2021-03-17;29;23;52;177805;149903;79;327708
52;2021-03-17;25;10;35;119561;75822;89;195383
52;2021-03-17;11;3;14;42559;15260;90;57819
52;2021-03-17;560;517;1083;1952321;1849476;0;3801797
53;2021-03-17;19;24;44;173813;182358;09;356171
53;2021-03-17;70;83;153;202720;214740;19;417460
53;2021-03-17;104;123;227;163116;173196;29;336312
53;2021-03-17;73;74;147;190526;187674;39;378200
53;2021-03-17;76;56;132;212098;212015;49;424113
53;2021-03-17;49;50;99;223699;219176;59;442875
53;2021-03-17;34;26;60;227435;209274;69;436709
53;2021-03-17;20;15;35;169992;140910;79;310902
53;2021-03-17;13;9;22;118117;69883;89;188000
53;2021-03-17;2;3;5;37370;12267;90;49637
53;2021-03-17;460;463;924;1718886;1621493;0;3340379
75;2021-03-17;36;46;84;293104;305291;09;598395
75;2021-03-17;125;128;254;337141;357785;19;694926
75;2021-03-17;141;127;268;295024;300618;29;595642
75;2021-03-17;128;117;245;347871;331233;39;679104
75;2021-03-17;143;120;264;384742;372771;49;757513
75;2021-03-17;99;91;190;413361;390880;59;804241
75;2021-03-17;70;68;138;425623;384060;69;809683
75;2021-03-17;33;34;67;325086;276298;79;601384
75;2021-03-17;26;21;47;213986;139308;89;353294
75;2021-03-17;10;3;13;77600;28200;90;105800
75;2021-03-17;813;755;1572;3113538;2886444;0;5999982
76;2021-03-17;48;42;92;305956;318589;09;624545
76;2021-03-17;156;152;310;338942;356969;19;695911
76;2021-03-17;143;153;297;316210;319570;29;635780
76;2021-03-17;155;124;280;356758;337587;39;694345
76;2021-03-17;153;146;299;376541;363812;49;740353
76;2021-03-17;131;119;250;402608;383750;59;786358
76;2021-03-17;92;66;158;394889;358997;69;753886
76;2021-03-17;49;55;104;308664;263806;79;572470
76;2021-03-17;35;31;66;195838;129272;89;325110
76;2021-03-17;20;7;27;69372;26728;90;96100
76;2021-03-17;983;896;1885;3065778;2859080;0;5924858
84;2021-03-17;85;92;179;459549;481088;09;940637
84;2021-03-17;286;298;587;487711;511905;19;999616
84;2021-03-17;299;237;537;443824;451094;29;894918
84;2021-03-17;265;220;485;512522;493262;39;1005784
84;2021-03-17;272;268;541;520248;515106;49;1035354
84;2021-03-17;253;199;453;529611;514848;59;1044459
84;2021-03-17;140;124;264;486720;439940;69;926660
84;2021-03-17;84;65;150;372151;315211;79;687362
84;2021-03-17;45;37;82;237198;150524;89;387722
84;2021-03-17;24;6;30;81185;28680;90;109865
84;2021-03-17;1753;1546;3308;4130719;3901658;0;8032377
93;2021-03-17;69;84;153;268834;283093;09;551927
93;2021-03-17;180;175;355;280751;296087;19;576838
93;2021-03-17;239;160;399;254404;255552;29;509956
93;2021-03-17;229;211;441;310704;288398;39;599102
93;2021-03-17;217;179;397;325559;305827;49;631386
93;2021-03-17;205;167;372;353104;325389;59;678493
93;2021-03-17;126;138;264;336327;296459;69;632786
93;2021-03-17;93;88;181;279820;229699;79;509519
93;2021-03-17;67;50;117;171274;113716;89;284990
93;2021-03-17;32;13;45;58896;21758;90;80654
93;2021-03-17;1458;1265;2725;2639673;2415978;0;5055651
94;2021-03-17;2;2;4;16311;17433;09;33744
94;2021-03-17;3;7;11;16679;18132;19;34811
94;2021-03-17;3;4;7;16782;16579;29;33361
94;2021-03-17;5;2;7;23044;20580;39;43624
94;2021-03-17;5;5;10;23065;22140;49;45205
94;2021-03-17;7;1;8;24549;23421;59;47970
94;2021-03-17;5;3;8;23212;21883;69;45095
94;2021-03-17;4;3;7;19544;17141;79;36685
94;2021-03-17;2;1;3;11227;8178;89;19405
94;2021-03-17;1;0;1;3332;1447;90;4779
94;2021-03-17;38;28;67;177745;166934;0;344679
01;2021-03-18;0;0;0;19979;20155;09;40134
01;2021-03-18;3;3;6;24994;25489;19;50483
01;2021-03-18;2;0;2;17868;16690;29;34558
01;2021-03-18;6;3;9;22328;14821;39;37149
01;2021-03-18;4;12;16;28652;20276;49;48928
01;2021-03-18;8;6;14;33264;27260;59;60524
01;2021-03-18;3;5;8;27135;23978;69;51113
01;2021-03-18;2;5;7;18401;14661;79;33062
01;2021-03-18;0;1;1;9633;6375;89;16008
01;2021-03-18;0;1;1;3410;1510;90;4920
01;2021-03-18;28;36;64;205664;171215;0;376879
02;2021-03-18;0;1;1;16881;17110;09;33991
02;2021-03-18;6;2;8;21410;21604;19;43014
02;2021-03-18;4;7;11;16017;15479;29;31496
02;2021-03-18;3;3;6;19825;14455;39;34280
02;2021-03-18;7;4;11;24719;18248;49;42967
02;2021-03-18;7;5;12;34361;28310;59;62671
02;2021-03-18;5;4;9;28061;24495;69;52556
02;2021-03-18;2;2;4;18231;15278;79;33509
02;2021-03-18;1;0;1;11090;7677;89;18767
02;2021-03-18;0;0;0;3992;1506;90;5498
02;2021-03-18;35;28;63;194587;164162;0;358749
03;2021-03-18;0;0;0;31123;30920;09;62043
03;2021-03-18;3;1;4;29370;29268;19;58638
03;2021-03-18;0;3;3;21458;18963;29;40421
03;2021-03-18;2;1;3;21276;18326;39;39602
03;2021-03-18;2;3;5;18164;16593;49;34757
03;2021-03-18;0;3;3;13469;13557;59;27026
03;2021-03-18;0;1;1;8776;8670;69;17446
03;2021-03-18;1;2;3;3777;3591;79;7368
03;2021-03-18;0;0;0;1649;1072;89;2721
03;2021-03-18;0;0;0;485;184;90;669
03;2021-03-18;8;14;22;149547;141144;0;290691
04;2021-03-18;5;5;10;60314;61377;09;121691
04;2021-03-18;12;8;20;66065;68387;19;134452
04;2021-03-18;12;9;21;51059;47156;29;98215
04;2021-03-18;17;16;33;58788;45780;39;104568
04;2021-03-18;10;9;19;61408;52207;49;113615
04;2021-03-18;9;9;18;64838;60759;59;125597
04;2021-03-18;5;6;11;47008;42843;69;89851
04;2021-03-18;3;1;4;25509;21184;79;46693
04;2021-03-18;2;1;3;13168;7647;89;20815
04;2021-03-18;0;1;1;3209;1253;90;4462
04;2021-03-18;75;65;140;451366;408593;0;859959
05;2021-03-18;0;0;0;362.366008612902;341.338819562748;09;703.704828175651
05;2021-03-18;0;0;0;353.376145114279;370.349735405642;19;723.725880519921
05;2021-03-18;0;0;0;218.593559489256;256.539602589476;29;475.133162078732
05;2021-03-18;0;0;0;404.225408693299;360.321910454353;39;764.547319147651
05;2021-03-18;0;0;0;520.067953604221;497.108383964256;49;1017.17633756848
05;2021-03-18;0;0;0;468.146063921917;510.087601910415;59;978.233665832332
05;2021-03-18;0;0;0;340.368470050554;334.366842191253;69;674.735312241807
05;2021-03-18;0;0;0;212.598666888387;192.597753227106;79;405.196420115493
05;2021-03-18;0;0;0;148.727797095705;61.8681715431829;89;210.595968638888
05;2021-03-18;0;0;0;32.9601271090696;10.9909785719784;90;43.9511056810479
05;2021-03-18;0;0;0;3061.43020057959;2935.56979942041;0;5997
06;2021-03-18;3;0;3;42583;42380;09;84963
06;2021-03-18;3;4;8;33369;31925;19;65294
06;2021-03-18;2;9;11;21571;15080;29;36651
06;2021-03-18;5;4;9;21550;16147;39;37697
06;2021-03-18;3;5;8;14193;13939;49;28132
06;2021-03-18;2;0;2;7171;7597;59;14768
06;2021-03-18;3;2;5;3629;4117;69;7746
06;2021-03-18;1;1;2;1577;1457;79;3034
06;2021-03-18;0;0;0;531;474;89;1005
06;2021-03-18;0;0;0;88;93;90;181
06;2021-03-18;22;25;48;146262;133209;0;279471
07;2021-03-18;0;0;0;485;549;09;1034
07;2021-03-18;0;0;0;403;432;19;835
07;2021-03-18;4;3;7;764;841;29;1605
07;2021-03-18;1;1;2;824;928;39;1752
07;2021-03-18;0;0;0;788;1020;49;1808
07;2021-03-18;0;2;2;678;870;59;1548
07;2021-03-18;0;0;0;360;382;69;742
07;2021-03-18;0;0;0;231;190;79;421
07;2021-03-18;0;0;0;114;67;89;181
07;2021-03-18;0;0;0;24;11;90;35
07;2021-03-18;5;6;11;4671;5290;0;9961
08;2021-03-18;0;0;0;2715.22592983026;2997.75551488675;09;5712.98144471701
08;2021-03-18;0;0;0;2778.51901080978;3160.9156459093;19;5939.43465671908
08;2021-03-18;0;0;0;2080.8882988764;1718.16634315323;29;3799.05464202964
08;2021-03-18;1;1;2;2701.8582062647;1896.52641413317;39;4598.38462039786
08;2021-03-18;0;1;1;3151.45861023308;2460.52498233809;49;5611.98359257117
08;2021-03-18;0;0;0;2620.29868333099;2422.23566154656;59;5042.53434487755
08;2021-03-18;0;0;0;1621.44173420671;1438.58325779464;69;3060.02499200135
08;2021-03-18;0;0;0;626.575909335673;526.358467843651;79;1152.93437717932
08;2021-03-18;0;0;0;205.018522985054;140.993639349697;89;346.012162334751
08;2021-03-18;0;0;0;50.0325684687745;20.62259870351;90;70.6551671722846
08;2021-03-18;1;2;3;18551.3174743414;16782.6825256586;0;35334
11;2021-03-18;368;380;796;783071;811785;09;1594856
11;2021-03-18;875;912;1864;761456;784653;19;1546109
11;2021-03-18;1087;953;2046;850145;801772;29;1651917
11;2021-03-18;1119;922;2048;914360;843488;39;1757848
11;2021-03-18;960;879;1853;845609;826202;49;1671811
11;2021-03-18;696;699;1407;793566;745070;59;1538636
11;2021-03-18;473;457;944;628649;549192;69;1177841
11;2021-03-18;203;174;379;434606;358356;79;792962
11;2021-03-18;105;78;183;261425;162933;89;424358
11;2021-03-18;65;20;85;89253;32619;90;121872
11;2021-03-18;5954;5476;11610;6362140;5916070;0;12278210
24;2021-03-18;18;23;41;139720;144686;09;284406
24;2021-03-18;102;90;192;152979;161185;19;314164
24;2021-03-18;94;84;178;122237;126536;29;248773
24;2021-03-18;67;78;145;150359;142009;39;292368
24;2021-03-18;100;72;172;161829;158758;49;320587
24;2021-03-18;83;68;151;172552;168011;59;340563
24;2021-03-18;51;50;101;172509;158177;69;330686
24;2021-03-18;29;31;60;129428;110593;79;240021
24;2021-03-18;21;9;30;87342;56882;89;144224
24;2021-03-18;12;7;19;31210;12071;90;43281
24;2021-03-18;578;512;1090;1320165;1238908;0;2559073
27;2021-03-18;36;33;69;143373;149679;09;293052
27;2021-03-18;68;82;151;160962;173003;19;333965
27;2021-03-18;79;74;153;133746;142254;29;276000
27;2021-03-18;78;52;130;160004;155407;39;315411
27;2021-03-18;88;57;145;172333;169564;49;341897
27;2021-03-18;62;58;120;189979;183788;59;373767
27;2021-03-18;48;48;96;192591;178206;69;370797
27;2021-03-18;39;18;57;146876;127546;79;274422
27;2021-03-18;17;11;28;96896;61575;89;158471
27;2021-03-18;10;4;14;33148;12109;90;45257
27;2021-03-18;525;437;963;1429908;1353131;0;2783039
28;2021-03-18;50;47;100;180735;186856;09;367591
28;2021-03-18;120;111;234;200125;213621;19;413746
28;2021-03-18;149;120;269;168922;173007;29;341929
28;2021-03-18;137;110;247;196628;188487;39;385115
28;2021-03-18;117;109;226;205396;201699;49;407095
28;2021-03-18;110;96;206;222002;213866;59;435868
28;2021-03-18;84;80;164;224688;203758;69;428446
28;2021-03-18;47;47;94;163192;135543;79;298735
28;2021-03-18;30;17;47;109691;65377;89;175068
28;2021-03-18;24;13;37;37222;12685;90;49907
28;2021-03-18;868;750;1624;1708601;1594899;0;3303500
32;2021-03-18;133;171;305;358062;373689;09;731751
32;2021-03-18;333;300;634;387045;406742;19;793787
32;2021-03-18;355;295;651;342304;348587;29;690891
32;2021-03-18;373;325;698;382485;369972;39;752457
32;2021-03-18;306;275;581;382510;376716;49;759226
32;2021-03-18;297;275;573;386937;376527;59;763464
32;2021-03-18;192;185;377;371211;330938;69;702149
32;2021-03-18;118;108;226;250542;201459;79;452001
32;2021-03-18;63;28;92;163399;89786;89;253185
32;2021-03-18;36;12;48;48384;15367;90;63751
32;2021-03-18;2207;1975;4187;3072879;2889783;0;5962662
44;2021-03-18;73;93;166;291525;306839;09;598364
44;2021-03-18;197;184;382;320255;339504;19;659759
44;2021-03-18;191;191;383;302020;314428;29;616448
44;2021-03-18;196;142;338;342222;333292;39;675514
44;2021-03-18;160;136;296;349727;344491;49;694218
44;2021-03-18;162;146;308;381371;373239;59;754610
44;2021-03-18;110;98;209;367165;335850;69;703015
44;2021-03-18;54;51;106;250387;215436;79;465823
44;2021-03-18;48;22;72;170825;105192;89;276017
44;2021-03-18;18;9;27;51248;16731;90;67979
44;2021-03-18;1209;1072;2287;2826745;2685002;0;5511747
52;2021-03-18;52;35;87;213594;223900;09;437494
52;2021-03-18;77;117;195;240818;255197;19;496015
52;2021-03-18;119;108;227;197010;200630;29;397640
52;2021-03-18;99;88;187;231204;224885;39;456089
52;2021-03-18;111;62;173;243874;243418;49;487292
52;2021-03-18;98;88;186;244100;239116;59;483216
52;2021-03-18;65;62;127;241796;221345;69;463141
52;2021-03-18;31;32;63;177805;149903;79;327708
52;2021-03-18;43;22;65;119561;75822;89;195383
52;2021-03-18;17;2;19;42559;15260;90;57819
52;2021-03-18;712;616;1329;1952321;1849476;0;3801797
53;2021-03-18;41;29;70;173813;182358;09;356171
53;2021-03-18;82;75;157;202720;214740;19;417460
53;2021-03-18;87;80;168;163116;173196;29;336312
53;2021-03-18;70;65;135;190526;187674;39;378200
53;2021-03-18;71;60;131;212098;212015;49;424113
53;2021-03-18;50;43;93;223699;219176;59;442875
53;2021-03-18;50;42;92;227435;209274;69;436709
53;2021-03-18;16;12;28;169992;140910;79;310902
53;2021-03-18;11;7;18;118117;69883;89;188000
53;2021-03-18;2;1;3;37370;12267;90;49637
53;2021-03-18;480;414;895;1718886;1621493;0;3340379
75;2021-03-18;51;57;109;293104;305291;09;598395
75;2021-03-18;136;133;271;337141;357785;19;694926
75;2021-03-18;120;107;228;295024;300618;29;595642
75;2021-03-18;148;105;254;347871;331233;39;679104
75;2021-03-18;148;116;265;384742;372771;49;757513
75;2021-03-18;93;76;169;413361;390880;59;804241
75;2021-03-18;73;71;144;425623;384060;69;809683
75;2021-03-18;47;35;82;325086;276298;79;601384
75;2021-03-18;33;24;57;213986;139308;89;353294
75;2021-03-18;14;5;19;77600;28200;90;105800
75;2021-03-18;863;729;1598;3113538;2886444;0;5999982
76;2021-03-18;70;62;134;305956;318589;09;624545
76;2021-03-18;179;157;341;338942;356969;19;695911
76;2021-03-18;149;149;298;316210;319570;29;635780
76;2021-03-18;174;118;292;356758;337587;39;694345
76;2021-03-18;149;112;261;376541;363812;49;740353
76;2021-03-18;114;108;222;402608;383750;59;786358
76;2021-03-18;92;87;179;394889;358997;69;753886
76;2021-03-18;68;52;120;308664;263806;79;572470
76;2021-03-18;35;20;55;195838;129272;89;325110
76;2021-03-18;15;3;18;69372;26728;90;96100
76;2021-03-18;1045;869;1921;3065778;2859080;0;5924858
84;2021-03-18;120;135;258;459549;481088;09;940637
84;2021-03-18;308;282;592;487711;511905;19;999616
84;2021-03-18;303;271;574;443824;451094;29;894918
84;2021-03-18;318;262;582;512522;493262;39;1005784
84;2021-03-18;265;264;529;520248;515106;49;1035354
84;2021-03-18;247;218;465;529611;514848;59;1044459
84;2021-03-18;186;167;353;486720;439940;69;926660
84;2021-03-18;96;81;177;372151;315211;79;687362
84;2021-03-18;72;35;107;237198;150524;89;387722
84;2021-03-18;20;8;28;81185;28680;90;109865
84;2021-03-18;1935;1723;3665;4130719;3901658;0;8032377
93;2021-03-18;64;89;154;268834;283093;09;551927
93;2021-03-18;207;194;402;280751;296087;19;576838
93;2021-03-18;220;195;415;254404;255552;29;509956
93;2021-03-18;236;182;419;310704;288398;39;599102
93;2021-03-18;218;193;411;325559;305827;49;631386
93;2021-03-18;200;178;378;353104;325389;59;678493
93;2021-03-18;144;129;275;336327;296459;69;632786
93;2021-03-18;90;79;169;279820;229699;79;509519
93;2021-03-18;55;55;110;171274;113716;89;284990
93;2021-03-18;27;11;38;58896;21758;90;80654
93;2021-03-18;1461;1305;2771;2639673;2415978;0;5055651
94;2021-03-18;2;1;3;16311;17433;09;33744
94;2021-03-18;3;3;6;16679;18132;19;34811
94;2021-03-18;3;6;9;16782;16579;29;33361
94;2021-03-18;4;3;7;23044;20580;39;43624
94;2021-03-18;7;2;9;23065;22140;49;45205
94;2021-03-18;4;6;10;24549;23421;59;47970
94;2021-03-18;5;7;12;23212;21883;69;45095
94;2021-03-18;7;3;10;19544;17141;79;36685
94;2021-03-18;1;2;3;11227;8178;89;19405
94;2021-03-18;1;0;1;3332;1447;90;4779
94;2021-03-18;37;33;70;177745;166934;0;344679
01;2021-03-19;1;0;1;19979;20155;09;40134
01;2021-03-19;6;4;10;24994;25489;19;50483
01;2021-03-19;6;6;12;17868;16690;29;34558
01;2021-03-19;9;4;13;22328;14821;39;37149
01;2021-03-19;7;5;12;28652;20276;49;48928
01;2021-03-19;6;6;12;33264;27260;59;60524
01;2021-03-19;4;8;12;27135;23978;69;51113
01;2021-03-19;2;1;3;18401;14661;79;33062
01;2021-03-19;2;0;2;9633;6375;89;16008
01;2021-03-19;0;0;0;3410;1510;90;4920
01;2021-03-19;43;34;77;205664;171215;0;376879
02;2021-03-19;0;1;1;16881;17110;09;33991
02;2021-03-19;8;4;12;21410;21604;19;43014
02;2021-03-19;12;7;19;16017;15479;29;31496
02;2021-03-19;7;4;11;19825;14455;39;34280
02;2021-03-19;7;4;11;24719;18248;49;42967
02;2021-03-19;12;6;18;34361;28310;59;62671
02;2021-03-19;2;4;6;28061;24495;69;52556
02;2021-03-19;4;4;8;18231;15278;79;33509
02;2021-03-19;0;0;0;11090;7677;89;18767
02;2021-03-19;0;0;0;3992;1506;90;5498
02;2021-03-19;52;34;86;194587;164162;0;358749
03;2021-03-19;0;0;0;31123;30920;09;62043
03;2021-03-19;4;1;5;29370;29268;19;58638
03;2021-03-19;1;1;2;21458;18963;29;40421
03;2021-03-19;6;0;6;21276;18326;39;39602
03;2021-03-19;3;3;6;18164;16593;49;34757
03;2021-03-19;0;0;0;13469;13557;59;27026
03;2021-03-19;4;1;5;8776;8670;69;17446
03;2021-03-19;1;0;1;3777;3591;79;7368
03;2021-03-19;0;1;1;1649;1072;89;2721
03;2021-03-19;0;0;0;485;184;90;669
03;2021-03-19;19;7;26;149547;141144;0;290691
04;2021-03-19;3;6;9;60314;61377;09;121691
04;2021-03-19;16;10;26;66065;68387;19;134452
04;2021-03-19;15;10;25;51059;47156;29;98215
04;2021-03-19;15;17;32;58788;45780;39;104568
04;2021-03-19;6;7;13;61408;52207;49;113615
04;2021-03-19;9;7;16;64838;60759;59;125597
04;2021-03-19;5;10;15;47008;42843;69;89851
04;2021-03-19;2;1;3;25509;21184;79;46693
04;2021-03-19;1;2;3;13168;7647;89;20815
04;2021-03-19;1;0;1;3209;1253;90;4462
04;2021-03-19;73;70;143;451366;408593;0;859959
05;2021-03-19;0;0;0;362.366008612902;341.338819562748;09;703.704828175651
05;2021-03-19;0;0;0;353.376145114279;370.349735405642;19;723.725880519921
05;2021-03-19;0;0;0;218.593559489256;256.539602589476;29;475.133162078732
05;2021-03-19;0;0;0;404.225408693299;360.321910454353;39;764.547319147651
05;2021-03-19;0;0;0;520.067953604221;497.108383964256;49;1017.17633756848
05;2021-03-19;0;0;0;468.146063921917;510.087601910415;59;978.233665832332
05;2021-03-19;0;0;0;340.368470050554;334.366842191253;69;674.735312241807
05;2021-03-19;0;0;0;212.598666888387;192.597753227106;79;405.196420115493
05;2021-03-19;0;0;0;148.727797095705;61.8681715431829;89;210.595968638888
05;2021-03-19;0;0;0;32.9601271090696;10.9909785719784;90;43.9511056810479
05;2021-03-19;0;0;0;3061.43020057959;2935.56979942041;0;5997
06;2021-03-19;2;0;2;42583;42380;09;84963
06;2021-03-19;4;2;6;33369;31925;19;65294
06;2021-03-19;4;2;6;21571;15080;29;36651
06;2021-03-19;2;3;5;21550;16147;39;37697
06;2021-03-19;4;2;6;14193;13939;49;28132
06;2021-03-19;2;2;4;7171;7597;59;14768
06;2021-03-19;4;0;4;3629;4117;69;7746
06;2021-03-19;0;0;0;1577;1457;79;3034
06;2021-03-19;1;0;1;531;474;89;1005
06;2021-03-19;0;0;0;88;93;90;181
06;2021-03-19;23;11;34;146262;133209;0;279471
07;2021-03-19;0;0;0;485;549;09;1034
07;2021-03-19;2;2;4;403;432;19;835
07;2021-03-19;2;0;2;764;841;29;1605
07;2021-03-19;2;2;4;824;928;39;1752
07;2021-03-19;1;1;2;788;1020;49;1808
07;2021-03-19;2;0;2;678;870;59;1548
07;2021-03-19;0;0;0;360;382;69;742
07;2021-03-19;0;0;0;231;190;79;421
07;2021-03-19;0;0;0;114;67;89;181
07;2021-03-19;0;0;0;24;11;90;35
07;2021-03-19;9;5;14;4671;5290;0;9961
08;2021-03-19;0;1;1;2715.22592983026;2997.75551488675;09;5712.98144471701
08;2021-03-19;0;3;3;2778.51901080978;3160.9156459093;19;5939.43465671908
08;2021-03-19;1;0;1;2080.8882988764;1718.16634315323;29;3799.05464202964
08;2021-03-19;1;0;1;2701.8582062647;1896.52641413317;39;4598.38462039786
08;2021-03-19;1;0;1;3151.45861023308;2460.52498233809;49;5611.98359257117
08;2021-03-19;1;0;1;2620.29868333099;2422.23566154656;59;5042.53434487755
08;2021-03-19;0;0;0;1621.44173420671;1438.58325779464;69;3060.02499200135
08;2021-03-19;1;0;1;626.575909335673;526.358467843651;79;1152.93437717932
08;2021-03-19;0;0;0;205.018522985054;140.993639349697;89;346.012162334751
08;2021-03-19;0;0;0;50.0325684687745;20.62259870351;90;70.6551671722846
08;2021-03-19;5;4;9;18551.3174743414;16782.6825256586;0;35334
11;2021-03-19;445;420;906;783071;811785;09;1594856
11;2021-03-19;894;931;1916;761456;784653;19;1546109
11;2021-03-19;1016;894;1918;850145;801772;29;1651917
11;2021-03-19;1182;936;2126;914360;843488;39;1757848
11;2021-03-19;1036;834;1880;845609;826202;49;1671811
11;2021-03-19;738;730;1479;793566;745070;59;1538636
11;2021-03-19;493;458;970;628649;549192;69;1177841
11;2021-03-19;196;179;377;434606;358356;79;792962
11;2021-03-19;107;70;177;261425;162933;89;424358
11;2021-03-19;41;17;58;89253;32619;90;121872
11;2021-03-19;6148;5471;11810;6362140;5916070;0;12278210
24;2021-03-19;30;31;62;139720;144686;09;284406
24;2021-03-19;97;104;204;152979;161185;19;314164
24;2021-03-19;93;68;162;122237;126536;29;248773
24;2021-03-19;87;72;159;150359;142009;39;292368
24;2021-03-19;101;71;173;161829;158758;49;320587
24;2021-03-19;89;64;153;172552;168011;59;340563
24;2021-03-19;52;49;101;172509;158177;69;330686
24;2021-03-19;23;34;57;129428;110593;79;240021
24;2021-03-19;28;11;39;87342;56882;89;144224
24;2021-03-19;6;5;11;31210;12071;90;43281
24;2021-03-19;606;509;1122;1320165;1238908;0;2559073
27;2021-03-19;44;28;73;143373;149679;09;293052
27;2021-03-19;97;109;206;160962;173003;19;333965
27;2021-03-19;67;87;154;133746;142254;29;276000
27;2021-03-19;85;76;161;160004;155407;39;315411
27;2021-03-19;66;62;128;172333;169564;49;341897
27;2021-03-19;77;65;142;189979;183788;59;373767
27;2021-03-19;56;56;112;192591;178206;69;370797
27;2021-03-19;29;44;73;146876;127546;79;274422
27;2021-03-19;19;9;28;96896;61575;89;158471
27;2021-03-19;13;5;18;33148;12109;90;45257
27;2021-03-19;553;541;1095;1429908;1353131;0;2783039
28;2021-03-19;50;48;102;180735;186856;09;367591
28;2021-03-19;100;149;250;200125;213621;19;413746
28;2021-03-19;110;117;227;168922;173007;29;341929
28;2021-03-19;152;91;243;196628;188487;39;385115
28;2021-03-19;139;127;266;205396;201699;49;407095
28;2021-03-19;129;99;228;222002;213866;59;435868
28;2021-03-19;96;100;196;224688;203758;69;428446
28;2021-03-19;55;33;88;163192;135543;79;298735
28;2021-03-19;39;27;66;109691;65377;89;175068
28;2021-03-19;25;7;32;37222;12685;90;49907
28;2021-03-19;895;798;1698;1708601;1594899;0;3303500
32;2021-03-19;179;223;403;358062;373689;09;731751
32;2021-03-19;365;343;708;387045;406742;19;793787
32;2021-03-19;362;332;694;342304;348587;29;690891
32;2021-03-19;390;315;706;382485;369972;39;752457
32;2021-03-19;383;357;740;382510;376716;49;759226
32;2021-03-19;328;301;629;386937;376527;59;763464
32;2021-03-19;200;197;397;371211;330938;69;702149
32;2021-03-19;128;118;246;250542;201459;79;452001
32;2021-03-19;92;53;145;163399;89786;89;253185
32;2021-03-19;31;13;44;48384;15367;90;63751
32;2021-03-19;2459;2254;4715;3072879;2889783;0;5962662
44;2021-03-19;105;77;186;291525;306839;09;598364
44;2021-03-19;168;183;354;320255;339504;19;659759
44;2021-03-19;223;192;416;302020;314428;29;616448
44;2021-03-19;183;177;361;342222;333292;39;675514
44;2021-03-19;169;163;333;349727;344491;49;694218
44;2021-03-19;171;155;328;381371;373239;59;754610
44;2021-03-19;116;120;236;367165;335850;69;703015
44;2021-03-19;64;63;128;250387;215436;79;465823
44;2021-03-19;39;29;69;170825;105192;89;276017
44;2021-03-19;26;8;34;51248;16731;90;67979
44;2021-03-19;1264;1167;2445;2826745;2685002;0;5511747
52;2021-03-19;44;51;98;213594;223900;09;437494
52;2021-03-19;98;140;239;240818;255197;19;496015
52;2021-03-19;104;108;212;197010;200630;29;397640
52;2021-03-19;104;79;183;231204;224885;39;456089
52;2021-03-19;103;95;198;243874;243418;49;487292
52;2021-03-19;90;85;176;244100;239116;59;483216
52;2021-03-19;72;68;140;241796;221345;69;463141
52;2021-03-19;33;34;67;177805;149903;79;327708
52;2021-03-19;24;14;38;119561;75822;89;195383
52;2021-03-19;13;4;17;42559;15260;90;57819
52;2021-03-19;685;678;1368;1952321;1849476;0;3801797
53;2021-03-19;29;33;63;173813;182358;09;356171
53;2021-03-19;85;106;194;202720;214740;19;417460
53;2021-03-19;90;80;170;163116;173196;29;336312
53;2021-03-19;67;61;128;190526;187674;39;378200
53;2021-03-19;79;60;139;212098;212015;49;424113
53;2021-03-19;57;56;113;223699;219176;59;442875
53;2021-03-19;48;38;86;227435;209274;69;436709
53;2021-03-19;24;10;34;169992;140910;79;310902
53;2021-03-19;6;6;12;118117;69883;89;188000
53;2021-03-19;5;5;10;37370;12267;90;49637
53;2021-03-19;490;455;950;1718886;1621493;0;3340379
75;2021-03-19;59;44;103;293104;305291;09;598395
75;2021-03-19;173;174;347;337141;357785;19;694926
75;2021-03-19;113;125;239;295024;300618;29;595642
75;2021-03-19;126;106;232;347871;331233;39;679104
75;2021-03-19;126;138;264;384742;372771;49;757513
75;2021-03-19;98;100;198;413361;390880;59;804241
75;2021-03-19;79;61;140;425623;384060;69;809683
75;2021-03-19;36;39;75;325086;276298;79;601384
75;2021-03-19;27;26;53;213986;139308;89;353294
75;2021-03-19;17;8;25;77600;28200;90;105800
75;2021-03-19;854;822;1677;3113538;2886444;0;5999982
76;2021-03-19;84;83;170;305956;318589;09;624545
76;2021-03-19;185;188;381;338942;356969;19;695911
76;2021-03-19;176;165;341;316210;319570;29;635780
76;2021-03-19;209;164;373;356758;337587;39;694345
76;2021-03-19;173;173;346;376541;363812;49;740353
76;2021-03-19;154;125;280;402608;383750;59;786358
76;2021-03-19;101;95;196;394889;358997;69;753886
76;2021-03-19;70;61;132;308664;263806;79;572470
76;2021-03-19;44;32;76;195838;129272;89;325110
76;2021-03-19;24;9;33;69372;26728;90;96100
76;2021-03-19;1221;1095;2330;3065778;2859080;0;5924858
84;2021-03-19;134;122;259;459549;481088;09;940637
84;2021-03-19;327;369;700;487711;511905;19;999616
84;2021-03-19;293;262;556;443824;451094;29;894918
84;2021-03-19;356;248;605;512522;493262;39;1005784
84;2021-03-19;328;244;572;520248;515106;49;1035354
84;2021-03-19;255;259;514;529611;514848;59;1044459
84;2021-03-19;185;168;353;486720;439940;69;926660
84;2021-03-19;107;100;207;372151;315211;79;687362
84;2021-03-19;35;45;80;237198;150524;89;387722
84;2021-03-19;26;10;37;81185;28680;90;109865
84;2021-03-19;2046;1827;3883;4130719;3901658;0;8032377
93;2021-03-19;99;100;200;268834;283093;09;551927
93;2021-03-19;200;226;426;280751;296087;19;576838
93;2021-03-19;248;240;489;254404;255552;29;509956
93;2021-03-19;288;219;507;310704;288398;39;599102
93;2021-03-19;222;221;444;325559;305827;49;631386
93;2021-03-19;201;214;415;353104;325389;59;678493
93;2021-03-19;152;111;263;336327;296459;69;632786
93;2021-03-19;96;85;181;279820;229699;79;509519
93;2021-03-19;66;33;99;171274;113716;89;284990
93;2021-03-19;28;11;40;58896;21758;90;80654
93;2021-03-19;1600;1460;3065;2639673;2415978;0;5055651
94;2021-03-19;3;1;4;16311;17433;09;33744
94;2021-03-19;10;6;16;16679;18132;19;34811
94;2021-03-19;5;6;11;16782;16579;29;33361
94;2021-03-19;9;5;14;23044;20580;39;43624
94;2021-03-19;5;7;12;23065;22140;49;45205
94;2021-03-19;9;4;13;24549;23421;59;47970
94;2021-03-19;4;8;12;23212;21883;69;45095
94;2021-03-19;5;2;7;19544;17141;79;36685
94;2021-03-19;0;2;2;11227;8178;89;19405
94;2021-03-19;0;0;0;3332;1447;90;4779
94;2021-03-19;50;41;91;177745;166934;0;344679
01;2021-03-20;0;0;0;19979;20155;09;40134
01;2021-03-20;4;0;4;24994;25489;19;50483
01;2021-03-20;1;1;2;17868;16690;29;34558
01;2021-03-20;4;2;6;22328;14821;39;37149
01;2021-03-20;3;3;6;28652;20276;49;48928
01;2021-03-20;2;0;2;33264;27260;59;60524
01;2021-03-20;4;1;5;27135;23978;69;51113
01;2021-03-20;0;0;0;18401;14661;79;33062
01;2021-03-20;1;0;1;9633;6375;89;16008
01;2021-03-20;0;0;0;3410;1510;90;4920
01;2021-03-20;19;7;26;205664;171215;0;376879
02;2021-03-20;2;0;2;16881;17110;09;33991
02;2021-03-20;1;1;2;21410;21604;19;43014
02;2021-03-20;1;1;2;16017;15479;29;31496
02;2021-03-20;7;4;11;19825;14455;39;34280
02;2021-03-20;1;2;3;24719;18248;49;42967
02;2021-03-20;3;4;7;34361;28310;59;62671
02;2021-03-20;1;3;4;28061;24495;69;52556
02;2021-03-20;0;1;1;18231;15278;79;33509
02;2021-03-20;0;1;1;11090;7677;89;18767
02;2021-03-20;0;0;0;3992;1506;90;5498
02;2021-03-20;16;17;33;194587;164162;0;358749
03;2021-03-20;0;1;1;31123;30920;09;62043
03;2021-03-20;0;2;2;29370;29268;19;58638
03;2021-03-20;0;0;0;21458;18963;29;40421
03;2021-03-20;1;1;2;21276;18326;39;39602
03;2021-03-20;2;0;2;18164;16593;49;34757
03;2021-03-20;0;1;1;13469;13557;59;27026
03;2021-03-20;0;0;0;8776;8670;69;17446
03;2021-03-20;0;0;0;3777;3591;79;7368
03;2021-03-20;0;0;0;1649;1072;89;2721
03;2021-03-20;0;0;0;485;184;90;669
03;2021-03-20;3;5;8;149547;141144;0;290691
04;2021-03-20;5;3;8;60314;61377;09;121691
04;2021-03-20;14;7;21;66065;68387;19;134452
04;2021-03-20;10;4;14;51059;47156;29;98215
04;2021-03-20;7;4;11;58788;45780;39;104568
04;2021-03-20;11;12;23;61408;52207;49;113615
04;2021-03-20;13;10;23;64838;60759;59;125597
04;2021-03-20;6;4;10;47008;42843;69;89851
04;2021-03-20;3;2;5;25509;21184;79;46693
04;2021-03-20;1;1;2;13168;7647;89;20815
04;2021-03-20;0;0;0;3209;1253;90;4462
04;2021-03-20;70;47;117;451366;408593;0;859959
05;2021-03-20;0;0;0;362.366008612902;341.338819562748;09;703.704828175651
05;2021-03-20;0;0;0;353.376145114279;370.349735405642;19;723.725880519921
05;2021-03-20;0;0;0;218.593559489256;256.539602589476;29;475.133162078732
05;2021-03-20;0;0;0;404.225408693299;360.321910454353;39;764.547319147651
05;2021-03-20;0;0;0;520.067953604221;497.108383964256;49;1017.17633756848
05;2021-03-20;0;0;0;468.146063921917;510.087601910415;59;978.233665832332
05;2021-03-20;0;0;0;340.368470050554;334.366842191253;69;674.735312241807
05;2021-03-20;0;0;0;212.598666888387;192.597753227106;79;405.196420115493
05;2021-03-20;0;0;0;148.727797095705;61.8681715431829;89;210.595968638888
05;2021-03-20;0;0;0;32.9601271090696;10.9909785719784;90;43.9511056810479
05;2021-03-20;0;0;0;3061.43020057959;2935.56979942041;0;5997
06;2021-03-20;0;0;0;42583;42380;09;84963
06;2021-03-20;0;0;0;33369;31925;19;65294
06;2021-03-20;2;0;2;21571;15080;29;36651
06;2021-03-20;1;0;1;21550;16147;39;37697
06;2021-03-20;4;2;6;14193;13939;49;28132
06;2021-03-20;2;2;4;7171;7597;59;14768
06;2021-03-20;0;1;1;3629;4117;69;7746
06;2021-03-20;0;0;0;1577;1457;79;3034
06;2021-03-20;0;0;0;531;474;89;1005
06;2021-03-20;0;0;0;88;93;90;181
06;2021-03-20;9;5;14;146262;133209;0;279471
07;2021-03-20;0;0;0;485;549;09;1034
07;2021-03-20;0;1;1;403;432;19;835
07;2021-03-20;0;0;0;764;841;29;1605
07;2021-03-20;1;1;2;824;928;39;1752
07;2021-03-20;0;1;1;788;1020;49;1808
07;2021-03-20;0;2;2;678;870;59;1548
07;2021-03-20;0;1;1;360;382;69;742
07;2021-03-20;0;0;0;231;190;79;421
07;2021-03-20;0;0;0;114;67;89;181
07;2021-03-20;0;0;0;24;11;90;35
07;2021-03-20;1;6;7;4671;5290;0;9961
08;2021-03-20;0;0;0;2715.22592983026;2997.75551488675;09;5712.98144471701
08;2021-03-20;0;0;0;2778.51901080978;3160.9156459093;19;5939.43465671908
08;2021-03-20;0;0;0;2080.8882988764;1718.16634315323;29;3799.05464202964
08;2021-03-20;0;0;0;2701.8582062647;1896.52641413317;39;4598.38462039786
08;2021-03-20;1;0;1;3151.45861023308;2460.52498233809;49;5611.98359257117
08;2021-03-20;0;0;0;2620.29868333099;2422.23566154656;59;5042.53434487755
08;2021-03-20;0;0;0;1621.44173420671;1438.58325779464;69;3060.02499200135
08;2021-03-20;0;0;0;626.575909335673;526.358467843651;79;1152.93437717932
08;2021-03-20;0;0;0;205.018522985054;140.993639349697;89;346.012162334751
08;2021-03-20;0;0;0;50.0325684687745;20.62259870351;90;70.6551671722846
08;2021-03-20;1;0;1;18551.3174743414;16782.6825256586;0;35334
11;2021-03-20;238;271;539;783071;811785;09;1594856
11;2021-03-20;630;620;1302;761456;784653;19;1546109
11;2021-03-20;638;549;1189;850145;801772;29;1651917
11;2021-03-20;780;628;1412;914360;843488;39;1757848
11;2021-03-20;688;657;1347;845609;826202;49;1671811
11;2021-03-20;519;525;1047;793566;745070;59;1538636
11;2021-03-20;337;328;680;628649;549192;69;1177841
11;2021-03-20;141;135;276;434606;358356;79;792962
11;2021-03-20;56;34;90;261425;162933;89;424358
11;2021-03-20;33;14;47;89253;32619;90;121872
11;2021-03-20;4061;3761;7930;6362140;5916070;0;12278210
24;2021-03-20;17;26;44;139720;144686;09;284406
24;2021-03-20;57;59;120;152979;161185;19;314164
24;2021-03-20;53;44;97;122237;126536;29;248773
24;2021-03-20;50;40;90;150359;142009;39;292368
24;2021-03-20;60;46;106;161829;158758;49;320587
24;2021-03-20;48;38;86;172552;168011;59;340563
24;2021-03-20;25;39;64;172509;158177;69;330686
24;2021-03-20;16;14;30;129428;110593;79;240021
24;2021-03-20;13;7;20;87342;56882;89;144224
24;2021-03-20;3;1;4;31210;12071;90;43281
24;2021-03-20;342;314;661;1320165;1238908;0;2559073
27;2021-03-20;20;24;45;143373;149679;09;293052
27;2021-03-20;49;43;93;160962;173003;19;333965
27;2021-03-20;39;51;90;133746;142254;29;276000
27;2021-03-20;50;50;100;160004;155407;39;315411
27;2021-03-20;51;48;99;172333;169564;49;341897
27;2021-03-20;37;60;97;189979;183788;59;373767
27;2021-03-20;48;34;82;192591;178206;69;370797
27;2021-03-20;24;30;54;146876;127546;79;274422
27;2021-03-20;17;10;27;96896;61575;89;158471
27;2021-03-20;8;7;15;33148;12109;90;45257
27;2021-03-20;343;357;702;1429908;1353131;0;2783039
28;2021-03-20;27;23;50;180735;186856;09;367591
28;2021-03-20;70;91;162;200125;213621;19;413746
28;2021-03-20;83;66;149;168922;173007;29;341929
28;2021-03-20;78;51;129;196628;188487;39;385115
28;2021-03-20;74;65;139;205396;201699;49;407095
28;2021-03-20;71;78;149;222002;213866;59;435868
28;2021-03-20;52;52;104;224688;203758;69;428446
28;2021-03-20;21;27;48;163192;135543;79;298735
28;2021-03-20;26;17;43;109691;65377;89;175068
28;2021-03-20;8;2;10;37222;12685;90;49907
28;2021-03-20;510;473;984;1708601;1594899;0;3303500
32;2021-03-20;110;104;216;358062;373689;09;731751
32;2021-03-20;244;217;461;387045;406742;19;793787
32;2021-03-20;244;216;461;342304;348587;29;690891
32;2021-03-20;261;219;481;382485;369972;39;752457
32;2021-03-20;236;214;450;382510;376716;49;759226
32;2021-03-20;201;188;389;386937;376527;59;763464
32;2021-03-20;128;105;233;371211;330938;69;702149
32;2021-03-20;76;69;145;250542;201459;79;452001
32;2021-03-20;57;36;93;163399;89786;89;253185
32;2021-03-20;30;1;31;48384;15367;90;63751
32;2021-03-20;1587;1370;2961;3072879;2889783;0;5962662
44;2021-03-20;41;45;87;291525;306839;09;598364
44;2021-03-20;111;140;251;320255;339504;19;659759
44;2021-03-20;129;113;242;302020;314428;29;616448
44;2021-03-20;126;100;226;342222;333292;39;675514
44;2021-03-20;112;113;225;349727;344491;49;694218
44;2021-03-20;125;111;236;381371;373239;59;754610
44;2021-03-20;63;79;142;367165;335850;69;703015
44;2021-03-20;49;42;91;250387;215436;79;465823
44;2021-03-20;27;13;40;170825;105192;89;276017
44;2021-03-20;12;6;18;51248;16731;90;67979
44;2021-03-20;795;762;1558;2826745;2685002;0;5511747
52;2021-03-20;29;33;64;213594;223900;09;437494
52;2021-03-20;94;67;161;240818;255197;19;496015
52;2021-03-20;64;85;149;197010;200630;29;397640
52;2021-03-20;64;55;119;231204;224885;39;456089
52;2021-03-20;66;61;127;243874;243418;49;487292
52;2021-03-20;55;57;112;244100;239116;59;483216
52;2021-03-20;45;38;83;241796;221345;69;463141
52;2021-03-20;29;27;56;177805;149903;79;327708
52;2021-03-20;14;18;32;119561;75822;89;195383
52;2021-03-20;6;4;10;42559;15260;90;57819
52;2021-03-20;466;445;913;1952321;1849476;0;3801797
53;2021-03-20;21;21;42;173813;182358;09;356171
53;2021-03-20;57;58;115;202720;214740;19;417460
53;2021-03-20;39;46;85;163116;173196;29;336312
53;2021-03-20;38;51;89;190526;187674;39;378200
53;2021-03-20;52;40;92;212098;212015;49;424113
53;2021-03-20;31;24;55;223699;219176;59;442875
53;2021-03-20;23;21;44;227435;209274;69;436709
53;2021-03-20;11;10;21;169992;140910;79;310902
53;2021-03-20;4;8;12;118117;69883;89;188000
53;2021-03-20;4;1;5;37370;12267;90;49637
53;2021-03-20;280;280;560;1718886;1621493;0;3340379
75;2021-03-20;30;28;58;293104;305291;09;598395
75;2021-03-20;83;103;187;337141;357785;19;694926
75;2021-03-20;63;58;121;295024;300618;29;595642
75;2021-03-20;75;57;132;347871;331233;39;679104
75;2021-03-20;89;88;177;384742;372771;49;757513
75;2021-03-20;58;68;126;413361;390880;59;804241
75;2021-03-20;41;42;83;425623;384060;69;809683
75;2021-03-20;29;25;55;325086;276298;79;601384
75;2021-03-20;20;5;25;213986;139308;89;353294
75;2021-03-20;7;3;10;77600;28200;90;105800
75;2021-03-20;495;477;974;3113538;2886444;0;5999982
76;2021-03-20;32;34;66;305956;318589;09;624545
76;2021-03-20;107;82;190;338942;356969;19;695911
76;2021-03-20;81;68;149;316210;319570;29;635780
76;2021-03-20;86;90;176;356758;337587;39;694345
76;2021-03-20;92;78;170;376541;363812;49;740353
76;2021-03-20;85;83;168;402608;383750;59;786358
76;2021-03-20;51;54;105;394889;358997;69;753886
76;2021-03-20;26;45;71;308664;263806;79;572470
76;2021-03-20;25;14;39;195838;129272;89;325110
76;2021-03-20;10;3;13;69372;26728;90;96100
76;2021-03-20;595;552;1148;3065778;2859080;0;5924858
84;2021-03-20;70;83;153;459549;481088;09;940637
84;2021-03-20;203;210;416;487711;511905;19;999616
84;2021-03-20;194;172;367;443824;451094;29;894918
84;2021-03-20;216;166;382;512522;493262;39;1005784
84;2021-03-20;223;214;437;520248;515106;49;1035354
84;2021-03-20;182;150;332;529611;514848;59;1044459
84;2021-03-20;95;107;202;486720;439940;69;926660
84;2021-03-20;54;58;112;372151;315211;79;687362
84;2021-03-20;29;15;44;237198;150524;89;387722
84;2021-03-20;11;3;14;81185;28680;90;109865
84;2021-03-20;1277;1178;2459;4130719;3901658;0;8032377
93;2021-03-20;46;33;79;268834;283093;09;551927
93;2021-03-20;131;132;263;280751;296087;19;576838
93;2021-03-20;143;120;264;254404;255552;29;509956
93;2021-03-20;140;127;267;310704;288398;39;599102
93;2021-03-20;145;139;284;325559;305827;49;631386
93;2021-03-20;136;134;270;353104;325389;59;678493
93;2021-03-20;82;71;153;336327;296459;69;632786
93;2021-03-20;50;38;88;279820;229699;79;509519
93;2021-03-20;20;19;39;171274;113716;89;284990
93;2021-03-20;11;10;21;58896;21758;90;80654
93;2021-03-20;904;823;1728;2639673;2415978;0;5055651
94;2021-03-20;2;5;7;16311;17433;09;33744
94;2021-03-20;0;2;2;16679;18132;19;34811
94;2021-03-20;8;5;13;16782;16579;29;33361
94;2021-03-20;5;0;5;23044;20580;39;43624
94;2021-03-20;4;1;5;23065;22140;49;45205
94;2021-03-20;4;2;6;24549;23421;59;47970
94;2021-03-20;0;4;4;23212;21883;69;45095
94;2021-03-20;1;1;2;19544;17141;79;36685
94;2021-03-20;0;0;0;11227;8178;89;19405
94;2021-03-20;0;0;0;3332;1447;90;4779
94;2021-03-20;24;20;44;177745;166934;0;344679
01;2021-03-21;0;0;0;19979;20155;09;40134
01;2021-03-21;1;0;1;24994;25489;19;50483
01;2021-03-21;0;0;0;17868;16690;29;34558
01;2021-03-21;1;0;1;22328;14821;39;37149
01;2021-03-21;0;0;0;28652;20276;49;48928
01;2021-03-21;2;1;3;33264;27260;59;60524
01;2021-03-21;1;3;4;27135;23978;69;51113
01;2021-03-21;0;2;2;18401;14661;79;33062
01;2021-03-21;0;0;0;9633;6375;89;16008
01;2021-03-21;2;0;2;3410;1510;90;4920
01;2021-03-21;7;6;13;205664;171215;0;376879
02;2021-03-21;0;0;0;16881;17110;09;33991
02;2021-03-21;0;0;0;21410;21604;19;43014
02;2021-03-21;0;0;0;16017;15479;29;31496
02;2021-03-21;0;0;0;19825;14455;39;34280
02;2021-03-21;0;0;0;24719;18248;49;42967
02;2021-03-21;0;0;0;34361;28310;59;62671
02;2021-03-21;0;0;0;28061;24495;69;52556
02;2021-03-21;2;0;2;18231;15278;79;33509
02;2021-03-21;0;0;0;11090;7677;89;18767
02;2021-03-21;0;0;0;3992;1506;90;5498
02;2021-03-21;2;0;2;194587;164162;0;358749
03;2021-03-21;0;0;0;31123;30920;09;62043
03;2021-03-21;0;0;0;29370;29268;19;58638
03;2021-03-21;0;0;0;21458;18963;29;40421
03;2021-03-21;0;0;0;21276;18326;39;39602
03;2021-03-21;0;0;0;18164;16593;49;34757
03;2021-03-21;0;0;0;13469;13557;59;27026
03;2021-03-21;0;0;0;8776;8670;69;17446
03;2021-03-21;0;0;0;3777;3591;79;7368
03;2021-03-21;0;0;0;1649;1072;89;2721
03;2021-03-21;0;0;0;485;184;90;669
03;2021-03-21;0;0;0;149547;141144;0;290691
04;2021-03-21;0;1;1;60314;61377;09;121691
04;2021-03-21;6;0;6;66065;68387;19;134452
04;2021-03-21;5;2;7;51059;47156;29;98215
04;2021-03-21;3;0;3;58788;45780;39;104568
04;2021-03-21;2;2;4;61408;52207;49;113615
04;2021-03-21;5;2;7;64838;60759;59;125597
04;2021-03-21;0;1;1;47008;42843;69;89851
04;2021-03-21;1;2;3;25509;21184;79;46693
04;2021-03-21;1;0;1;13168;7647;89;20815
04;2021-03-21;0;0;0;3209;1253;90;4462
04;2021-03-21;23;10;33;451366;408593;0;859959
05;2021-03-21;0;0;0;362.366008612902;341.338819562748;09;703.704828175651
05;2021-03-21;0;0;0;353.376145114279;370.349735405642;19;723.725880519921
05;2021-03-21;0;0;0;218.593559489256;256.539602589476;29;475.133162078732
05;2021-03-21;0;0;0;404.225408693299;360.321910454353;39;764.547319147651
05;2021-03-21;0;0;0;520.067953604221;497.108383964256;49;1017.17633756848
05;2021-03-21;0;0;0;468.146063921917;510.087601910415;59;978.233665832332
05;2021-03-21;0;0;0;340.368470050554;334.366842191253;69;674.735312241807
05;2021-03-21;0;0;0;212.598666888387;192.597753227106;79;405.196420115493
05;2021-03-21;0;0;0;148.727797095705;61.8681715431829;89;210.595968638888
05;2021-03-21;0;0;0;32.9601271090696;10.9909785719784;90;43.9511056810479
05;2021-03-21;0;0;0;3061.43020057959;2935.56979942041;0;5997
06;2021-03-21;1;0;1;42583;42380;09;84963
06;2021-03-21;1;2;3;33369;31925;19;65294
06;2021-03-21;1;0;1;21571;15080;29;36651
06;2021-03-21;2;0;2;21550;16147;39;37697
06;2021-03-21;0;0;0;14193;13939;49;28132
06;2021-03-21;1;0;1;7171;7597;59;14768
06;2021-03-21;0;0;0;3629;4117;69;7746
06;2021-03-21;0;0;0;1577;1457;79;3034
06;2021-03-21;0;0;0;531;474;89;1005
06;2021-03-21;0;0;0;88;93;90;181
06;2021-03-21;6;2;8;146262;133209;0;279471
07;2021-03-21;0;0;0;485;549;09;1034
07;2021-03-21;0;0;0;403;432;19;835
07;2021-03-21;0;1;1;764;841;29;1605
07;2021-03-21;0;0;0;824;928;39;1752
07;2021-03-21;0;0;0;788;1020;49;1808
07;2021-03-21;0;0;0;678;870;59;1548
07;2021-03-21;2;0;2;360;382;69;742
07;2021-03-21;0;0;0;231;190;79;421
07;2021-03-21;0;0;0;114;67;89;181
07;2021-03-21;0;0;0;24;11;90;35
07;2021-03-21;2;1;3;4671;5290;0;9961
08;2021-03-21;0;0;0;2715.22592983026;2997.75551488675;09;5712.98144471701
08;2021-03-21;0;0;0;2778.51901080978;3160.9156459093;19;5939.43465671908
08;2021-03-21;0;0;0;2080.8882988764;1718.16634315323;29;3799.05464202964
08;2021-03-21;0;0;0;2701.8582062647;1896.52641413317;39;4598.38462039786
08;2021-03-21;0;0;0;3151.45861023308;2460.52498233809;49;5611.98359257117
08;2021-03-21;0;0;0;2620.29868333099;2422.23566154656;59;5042.53434487755
08;2021-03-21;0;0;0;1621.44173420671;1438.58325779464;69;3060.02499200135
08;2021-03-21;0;0;0;626.575909335673;526.358467843651;79;1152.93437717932
08;2021-03-21;0;0;0;205.018522985054;140.993639349697;89;346.012162334751
08;2021-03-21;0;0;0;50.0325684687745;20.62259870351;90;70.6551671722846
08;2021-03-21;0;0;0;18551.3174743414;16782.6825256586;0;35334
11;2021-03-21;55;78;137;783071;811785;09;1594856
11;2021-03-21;143;150;297;761456;784653;19;1546109
11;2021-03-21;224;178;402;850145;801772;29;1651917
11;2021-03-21;260;203;463;914360;843488;39;1757848
11;2021-03-21;195;214;410;845609;826202;49;1671811
11;2021-03-21;134;142;276;793566;745070;59;1538636
11;2021-03-21;97;82;180;628649;549192;69;1177841
11;2021-03-21;42;52;94;434606;358356;79;792962
11;2021-03-21;38;29;67;261425;162933;89;424358
11;2021-03-21;22;7;29;89253;32619;90;121872
11;2021-03-21;1210;1135;2355;6362140;5916070;0;12278210
24;2021-03-21;7;5;12;139720;144686;09;284406
24;2021-03-21;7;6;13;152979;161185;19;314164
24;2021-03-21;6;8;14;122237;126536;29;248773
24;2021-03-21;6;10;16;150359;142009;39;292368
24;2021-03-21;2;8;10;161829;158758;49;320587
24;2021-03-21;3;4;7;172552;168011;59;340563
24;2021-03-21;5;4;9;172509;158177;69;330686
24;2021-03-21;4;2;6;129428;110593;79;240021
24;2021-03-21;7;3;10;87342;56882;89;144224
24;2021-03-21;2;1;3;31210;12071;90;43281
24;2021-03-21;49;51;100;1320165;1238908;0;2559073
27;2021-03-21;2;2;4;143373;149679;09;293052
27;2021-03-21;2;6;8;160962;173003;19;333965
27;2021-03-21;11;6;17;133746;142254;29;276000
27;2021-03-21;4;6;10;160004;155407;39;315411
27;2021-03-21;8;3;11;172333;169564;49;341897
27;2021-03-21;9;9;18;189979;183788;59;373767
27;2021-03-21;2;7;9;192591;178206;69;370797
27;2021-03-21;2;3;5;146876;127546;79;274422
27;2021-03-21;3;6;9;96896;61575;89;158471
27;2021-03-21;1;1;2;33148;12109;90;45257
27;2021-03-21;44;49;93;1429908;1353131;0;2783039
28;2021-03-21;5;6;11;180735;186856;09;367591
28;2021-03-21;9;8;17;200125;213621;19;413746
28;2021-03-21;15;12;27;168922;173007;29;341929
28;2021-03-21;21;22;43;196628;188487;39;385115
28;2021-03-21;21;14;35;205396;201699;49;407095
28;2021-03-21;18;17;35;222002;213866;59;435868
28;2021-03-21;12;9;21;224688;203758;69;428446
28;2021-03-21;4;8;12;163192;135543;79;298735
28;2021-03-21;7;6;13;109691;65377;89;175068
28;2021-03-21;7;0;7;37222;12685;90;49907
28;2021-03-21;119;102;221;1708601;1594899;0;3303500
32;2021-03-21;17;28;45;358062;373689;09;731751
32;2021-03-21;48;45;93;387045;406742;19;793787
32;2021-03-21;50;49;99;342304;348587;29;690891
32;2021-03-21;59;54;113;382485;369972;39;752457
32;2021-03-21;50;48;98;382510;376716;49;759226
32;2021-03-21;37;41;78;386937;376527;59;763464
32;2021-03-21;21;43;64;371211;330938;69;702149
32;2021-03-21;20;16;36;250542;201459;79;452001
32;2021-03-21;18;7;25;163399;89786;89;253185
32;2021-03-21;8;1;9;48384;15367;90;63751
32;2021-03-21;328;332;660;3072879;2889783;0;5962662
44;2021-03-21;8;8;16;291525;306839;09;598364
44;2021-03-21;19;20;39;320255;339504;19;659759
44;2021-03-21;17;15;32;302020;314428;29;616448
44;2021-03-21;27;19;46;342222;333292;39;675514
44;2021-03-21;14;24;38;349727;344491;49;694218
44;2021-03-21;14;15;29;381371;373239;59;754610
44;2021-03-21;15;17;32;367165;335850;69;703015
44;2021-03-21;16;9;25;250387;215436;79;465823
44;2021-03-21;6;7;13;170825;105192;89;276017
44;2021-03-21;6;0;6;51248;16731;90;67979
44;2021-03-21;142;134;276;2826745;2685002;0;5511747
52;2021-03-21;6;8;14;213594;223900;09;437494
52;2021-03-21;14;24;38;240818;255197;19;496015
52;2021-03-21;16;15;31;197010;200630;29;397640
52;2021-03-21;24;27;51;231204;224885;39;456089
52;2021-03-21;19;15;34;243874;243418;49;487292
52;2021-03-21;8;12;20;244100;239116;59;483216
52;2021-03-21;11;11;22;241796;221345;69;463141
52;2021-03-21;5;4;9;177805;149903;79;327708
52;2021-03-21;5;6;11;119561;75822;89;195383
52;2021-03-21;4;0;4;42559;15260;90;57819
52;2021-03-21;112;123;235;1952321;1849476;0;3801797
53;2021-03-21;4;5;9;173813;182358;09;356171
53;2021-03-21;7;6;13;202720;214740;19;417460
53;2021-03-21;13;10;23;163116;173196;29;336312
53;2021-03-21;14;10;24;190526;187674;39;378200
53;2021-03-21;9;9;18;212098;212015;49;424113
53;2021-03-21;11;4;15;223699;219176;59;442875
53;2021-03-21;2;3;5;227435;209274;69;436709
53;2021-03-21;6;4;10;169992;140910;79;310902
53;2021-03-21;2;4;6;118117;69883;89;188000
53;2021-03-21;1;1;2;37370;12267;90;49637
53;2021-03-21;69;56;125;1718886;1621493;0;3340379
75;2021-03-21;6;10;16;293104;305291;09;598395
75;2021-03-21;10;14;24;337141;357785;19;694926
75;2021-03-21;8;9;17;295024;300618;29;595642
75;2021-03-21;11;4;15;347871;331233;39;679104
75;2021-03-21;17;10;27;384742;372771;49;757513
75;2021-03-21;10;8;18;413361;390880;59;804241
75;2021-03-21;4;7;11;425623;384060;69;809683
75;2021-03-21;3;2;5;325086;276298;79;601384
75;2021-03-21;5;2;7;213986;139308;89;353294
75;2021-03-21;4;1;5;77600;28200;90;105800
75;2021-03-21;78;67;145;3113538;2886444;0;5999982
76;2021-03-21;7;8;15;305956;318589;09;624545
76;2021-03-21;14;14;28;338942;356969;19;695911
76;2021-03-21;18;15;33;316210;319570;29;635780
76;2021-03-21;28;15;43;356758;337587;39;694345
76;2021-03-21;25;22;47;376541;363812;49;740353
76;2021-03-21;13;11;24;402608;383750;59;786358
76;2021-03-21;9;12;21;394889;358997;69;753886
76;2021-03-21;13;15;28;308664;263806;79;572470
76;2021-03-21;9;9;18;195838;129272;89;325110
76;2021-03-21;6;3;9;69372;26728;90;96100
76;2021-03-21;142;124;266;3065778;2859080;0;5924858
84;2021-03-21;15;10;25;459549;481088;09;940637
84;2021-03-21;44;27;71;487711;511905;19;999616
84;2021-03-21;25;18;43;443824;451094;29;894918
84;2021-03-21;36;33;69;512522;493262;39;1005784
84;2021-03-21;36;29;65;520248;515106;49;1035354
84;2021-03-21;26;29;55;529611;514848;59;1044459
84;2021-03-21;21;29;50;486720;439940;69;926660
84;2021-03-21;20;22;42;372151;315211;79;687362
84;2021-03-21;20;13;33;237198;150524;89;387722
84;2021-03-21;9;2;11;81185;28680;90;109865
84;2021-03-21;252;212;464;4130719;3901658;0;8032377
93;2021-03-21;9;13;22;268834;283093;09;551927
93;2021-03-21;24;28;52;280751;296087;19;576838
93;2021-03-21;34;30;64;254404;255552;29;509956
93;2021-03-21;39;37;77;310704;288398;39;599102
93;2021-03-21;39;34;73;325559;305827;49;631386
93;2021-03-21;38;27;65;353104;325389;59;678493
93;2021-03-21;22;19;41;336327;296459;69;632786
93;2021-03-21;8;25;33;279820;229699;79;509519
93;2021-03-21;10;8;18;171274;113716;89;284990
93;2021-03-21;3;4;7;58896;21758;90;80654
93;2021-03-21;226;225;452;2639673;2415978;0;5055651
94;2021-03-21;0;0;0;16311;17433;09;33744
94;2021-03-21;0;1;1;16679;18132;19;34811
94;2021-03-21;0;0;0;16782;16579;29;33361
94;2021-03-21;0;1;1;23044;20580;39;43624
94;2021-03-21;0;1;1;23065;22140;49;45205
94;2021-03-21;0;0;0;24549;23421;59;47970
94;2021-03-21;1;0;1;23212;21883;69;45095
94;2021-03-21;0;0;0;19544;17141;79;36685
94;2021-03-21;0;0;0;11227;8178;89;19405
94;2021-03-21;0;0;0;3332;1447;90;4779
94;2021-03-21;1;3;4;177745;166934;0;344679
01;2021-03-22;1;1;2;19979;20155;09;40134
01;2021-03-22;1;2;3;24994;25489;19;50483
01;2021-03-22;5;3;8;17868;16690;29;34558
01;2021-03-22;4;2;6;22328;14821;39;37149
01;2021-03-22;10;8;18;28652;20276;49;48928
01;2021-03-22;13;6;19;33264;27260;59;60524
01;2021-03-22;3;4;7;27135;23978;69;51113
01;2021-03-22;2;1;3;18401;14661;79;33062
01;2021-03-22;0;1;1;9633;6375;89;16008
01;2021-03-22;1;0;1;3410;1510;90;4920
01;2021-03-22;40;28;68;205664;171215;0;376879
02;2021-03-22;0;0;0;16881;17110;09;33991
02;2021-03-22;7;5;12;21410;21604;19;43014
02;2021-03-22;12;6;18;16017;15479;29;31496
02;2021-03-22;7;4;11;19825;14455;39;34280
02;2021-03-22;7;8;15;24719;18248;49;42967
02;2021-03-22;16;6;22;34361;28310;59;62671
02;2021-03-22;9;12;21;28061;24495;69;52556
02;2021-03-22;0;4;4;18231;15278;79;33509
02;2021-03-22;1;1;2;11090;7677;89;18767
02;2021-03-22;0;0;0;3992;1506;90;5498
02;2021-03-22;59;46;105;194587;164162;0;358749
03;2021-03-22;1;0;1;31123;30920;09;62043
03;2021-03-22;2;3;5;29370;29268;19;58638
03;2021-03-22;4;0;4;21458;18963;29;40421
03;2021-03-22;4;1;5;21276;18326;39;39602
03;2021-03-22;0;3;3;18164;16593;49;34757
03;2021-03-22;1;3;4;13469;13557;59;27026
03;2021-03-22;1;4;5;8776;8670;69;17446
03;2021-03-22;0;0;0;3777;3591;79;7368
03;2021-03-22;0;0;0;1649;1072;89;2721
03;2021-03-22;0;0;0;485;184;90;669
03;2021-03-22;13;14;27;149547;141144;0;290691
04;2021-03-22;12;5;17;60314;61377;09;121691
04;2021-03-22;17;12;29;66065;68387;19;134452
04;2021-03-22;26;17;43;51059;47156;29;98215
04;2021-03-22;27;19;46;58788;45780;39;104568
04;2021-03-22;17;16;33;61408;52207;49;113615
04;2021-03-22;18;15;33;64838;60759;59;125597
04;2021-03-22;14;15;29;47008;42843;69;89851
04;2021-03-22;1;3;4;25509;21184;79;46693
04;2021-03-22;2;1;3;13168;7647;89;20815
04;2021-03-22;2;0;2;3209;1253;90;4462
04;2021-03-22;136;103;239;451366;408593;0;859959
05;2021-03-22;0;0;0;362.366008612902;341.338819562748;09;703.704828175651
05;2021-03-22;0;0;0;353.376145114279;370.349735405642;19;723.725880519921
05;2021-03-22;0;0;0;218.593559489256;256.539602589476;29;475.133162078732
05;2021-03-22;0;0;0;404.225408693299;360.321910454353;39;764.547319147651
05;2021-03-22;0;0;0;520.067953604221;497.108383964256;49;1017.17633756848
05;2021-03-22;0;0;0;468.146063921917;510.087601910415;59;978.233665832332
05;2021-03-22;0;0;0;340.368470050554;334.366842191253;69;674.735312241807
05;2021-03-22;0;0;0;212.598666888387;192.597753227106;79;405.196420115493
05;2021-03-22;0;0;0;148.727797095705;61.8681715431829;89;210.595968638888
05;2021-03-22;0;0;0;32.9601271090696;10.9909785719784;90;43.9511056810479
05;2021-03-22;0;0;0;3061.43020057959;2935.56979942041;0;5997
06;2021-03-22;0;1;1;42583;42380;09;84963
06;2021-03-22;5;1;6;33369;31925;19;65294
06;2021-03-22;6;4;10;21571;15080;29;36651
06;2021-03-22;7;3;10;21550;16147;39;37697
06;2021-03-22;8;3;11;14193;13939;49;28132
06;2021-03-22;2;2;4;7171;7597;59;14768
06;2021-03-22;3;1;4;3629;4117;69;7746
06;2021-03-22;0;0;0;1577;1457;79;3034
06;2021-03-22;2;0;2;531;474;89;1005
06;2021-03-22;0;0;0;88;93;90;181
06;2021-03-22;33;15;48;146262;133209;0;279471
07;2021-03-22;0;0;0;485;549;09;1034
07;2021-03-22;1;0;1;403;432;19;835
07;2021-03-22;4;4;8;764;841;29;1605
07;2021-03-22;6;2;8;824;928;39;1752
07;2021-03-22;1;1;2;788;1020;49;1808
07;2021-03-22;1;1;2;678;870;59;1548
07;2021-03-22;0;0;0;360;382;69;742
07;2021-03-22;0;0;0;231;190;79;421
07;2021-03-22;0;0;0;114;67;89;181
07;2021-03-22;0;0;0;24;11;90;35
07;2021-03-22;13;8;21;4671;5290;0;9961
08;2021-03-22;0;0;0;2715.22592983026;2997.75551488675;09;5712.98144471701
08;2021-03-22;0;0;0;2778.51901080978;3160.9156459093;19;5939.43465671908
08;2021-03-22;2;0;2;2080.8882988764;1718.16634315323;29;3799.05464202964
08;2021-03-22;1;0;1;2701.8582062647;1896.52641413317;39;4598.38462039786
08;2021-03-22;0;0;0;3151.45861023308;2460.52498233809;49;5611.98359257117
08;2021-03-22;1;3;4;2620.29868333099;2422.23566154656;59;5042.53434487755
08;2021-03-22;0;0;0;1621.44173420671;1438.58325779464;69;3060.02499200135
08;2021-03-22;0;0;0;626.575909335673;526.358467843651;79;1152.93437717932
08;2021-03-22;0;0;0;205.018522985054;140.993639349697;89;346.012162334751
08;2021-03-22;0;0;0;50.0325684687745;20.62259870351;90;70.6551671722846
08;2021-03-22;4;3;7;18551.3174743414;16782.6825256586;0;35334
11;2021-03-22;496;564;1106;783071;811785;09;1594856
11;2021-03-22;1288;1291;2672;761456;784653;19;1546109
11;2021-03-22;1486;1249;2743;850145;801772;29;1651917
11;2021-03-22;1713;1508;3226;914360;843488;39;1757848
11;2021-03-22;1636;1418;3065;845609;826202;49;1671811
11;2021-03-22;1114;1149;2276;793566;745070;59;1538636
11;2021-03-22;670;705;1397;628649;549192;69;1177841
11;2021-03-22;299;282;581;434606;358356;79;792962
11;2021-03-22;141;105;246;261425;162933;89;424358
11;2021-03-22;61;19;81;89253;32619;90;121872
11;2021-03-22;8906;8294;17399;6362140;5916070;0;12278210
24;2021-03-22;34;28;62;139720;144686;09;284406
24;2021-03-22;89;106;196;152979;161185;19;314164
24;2021-03-22;110;85;195;122237;126536;29;248773
24;2021-03-22;134;106;241;150359;142009;39;292368
24;2021-03-22;133;120;253;161829;158758;49;320587
24;2021-03-22;98;102;200;172552;168011;59;340563
24;2021-03-22;70;59;130;172509;158177;69;330686
24;2021-03-22;44;55;99;129428;110593;79;240021
24;2021-03-22;13;13;26;87342;56882;89;144224
24;2021-03-22;17;7;24;31210;12071;90;43281
24;2021-03-22;742;681;1426;1320165;1238908;0;2559073
27;2021-03-22;35;31;66;143373;149679;09;293052
27;2021-03-22;118;154;272;160962;173003;19;333965
27;2021-03-22;101;104;205;133746;142254;29;276000
27;2021-03-22;102;105;208;160004;155407;39;315411
27;2021-03-22;147;132;279;172333;169564;49;341897
27;2021-03-22;100;128;228;189979;183788;59;373767
27;2021-03-22;68;80;148;192591;178206;69;370797
27;2021-03-22;35;50;85;146876;127546;79;274422
27;2021-03-22;28;19;47;96896;61575;89;158471
27;2021-03-22;13;4;17;33148;12109;90;45257
27;2021-03-22;747;807;1555;1429908;1353131;0;2783039
28;2021-03-22;79;70;152;180735;186856;09;367591
28;2021-03-22;158;145;307;200125;213621;19;413746
28;2021-03-22;168;163;332;168922;173007;29;341929
28;2021-03-22;173;158;331;196628;188487;39;385115
28;2021-03-22;166;146;312;205396;201699;49;407095
28;2021-03-22;172;153;325;222002;213866;59;435868
28;2021-03-22;127;104;231;224688;203758;69;428446
28;2021-03-22;68;72;140;163192;135543;79;298735
28;2021-03-22;54;35;89;109691;65377;89;175068
28;2021-03-22;17;11;28;37222;12685;90;49907
28;2021-03-22;1182;1057;2247;1708601;1594899;0;3303500
32;2021-03-22;275;240;515;358062;373689;09;731751
32;2021-03-22;492;535;1030;387045;406742;19;793787
32;2021-03-22;548;483;1031;342304;348587;29;690891
32;2021-03-22;564;482;1046;382485;369972;39;752457
32;2021-03-22;514;484;999;382510;376716;49;759226
32;2021-03-22;490;454;944;386937;376527;59;763464
32;2021-03-22;300;277;577;371211;330938;69;702149
32;2021-03-22;168;154;322;250542;201459;79;452001
32;2021-03-22;126;67;193;163399;89786;89;253185
32;2021-03-22;52;16;68;48384;15367;90;63751
32;2021-03-22;3529;3193;6726;3072879;2889783;0;5962662
44;2021-03-22;122;111;239;291525;306839;09;598364
44;2021-03-22;240;271;514;320255;339504;19;659759
44;2021-03-22;257;241;498;302020;314428;29;616448
44;2021-03-22;286;257;545;342222;333292;39;675514
44;2021-03-22;289;282;572;349727;344491;49;694218
44;2021-03-22;231;231;462;381371;373239;59;754610
44;2021-03-22;154;164;320;367165;335850;69;703015
44;2021-03-22;100;86;187;250387;215436;79;465823
44;2021-03-22;47;44;93;170825;105192;89;276017
44;2021-03-22;26;7;34;51248;16731;90;67979
44;2021-03-22;1752;1694;3464;2826745;2685002;0;5511747
52;2021-03-22;55;55;111;213594;223900;09;437494
52;2021-03-22;135;168;305;240818;255197;19;496015
52;2021-03-22;150;113;263;197010;200630;29;397640
52;2021-03-22;162;126;288;231204;224885;39;456089
52;2021-03-22;132;134;266;243874;243418;49;487292
52;2021-03-22;130;101;231;244100;239116;59;483216
52;2021-03-22;113;96;209;241796;221345;69;463141
52;2021-03-22;58;42;100;177805;149903;79;327708
52;2021-03-22;44;19;64;119561;75822;89;195383
52;2021-03-22;14;12;26;42559;15260;90;57819
52;2021-03-22;993;866;1863;1952321;1849476;0;3801797
53;2021-03-22;32;34;66;173813;182358;09;356171
53;2021-03-22;118;102;221;202720;214740;19;417460
53;2021-03-22;110;87;200;163116;173196;29;336312
53;2021-03-22;102;91;193;190526;187674;39;378200
53;2021-03-22;108;88;196;212098;212015;49;424113
53;2021-03-22;75;78;153;223699;219176;59;442875
53;2021-03-22;48;57;105;227435;209274;69;436709
53;2021-03-22;30;28;58;169992;140910;79;310902
53;2021-03-22;14;9;23;118117;69883;89;188000
53;2021-03-22;4;3;7;37370;12267;90;49637
53;2021-03-22;641;577;1223;1718886;1621493;0;3340379
75;2021-03-22;68;74;142;293104;305291;09;598395
75;2021-03-22;163;220;385;337141;357785;19;694926
75;2021-03-22;169;128;297;295024;300618;29;595642
75;2021-03-22;181;156;338;347871;331233;39;679104
75;2021-03-22;202;175;377;384742;372771;49;757513
75;2021-03-22;155;168;323;413361;390880;59;804241
75;2021-03-22;101;113;214;425623;384060;69;809683
75;2021-03-22;53;67;120;325086;276298;79;601384
75;2021-03-22;32;20;52;213986;139308;89;353294
75;2021-03-22;29;15;44;77600;28200;90;105800
75;2021-03-22;1154;1137;2294;3113538;2886444;0;5999982
76;2021-03-22;86;90;183;305956;318589;09;624545
76;2021-03-22;251;248;504;338942;356969;19;695911
76;2021-03-22;245;212;457;316210;319570;29;635780
76;2021-03-22;288;230;518;356758;337587;39;694345
76;2021-03-22;288;263;551;376541;363812;49;740353
76;2021-03-22;244;226;473;402608;383750;59;786358
76;2021-03-22;154;156;310;394889;358997;69;753886
76;2021-03-22;90;101;191;308664;263806;79;572470
76;2021-03-22;51;41;92;195838;129272;89;325110
76;2021-03-22;24;11;35;69372;26728;90;96100
76;2021-03-22;1721;1581;3317;3065778;2859080;0;5924858
84;2021-03-22;156;159;318;459549;481088;09;940637
84;2021-03-22;437;472;914;487711;511905;19;999616
84;2021-03-22;456;372;828;443824;451094;29;894918
84;2021-03-22;487;377;865;512522;493262;39;1005784
84;2021-03-22;454;417;872;520248;515106;49;1035354
84;2021-03-22;414;381;795;529611;514848;59;1044459
84;2021-03-22;263;235;500;486720;439940;69;926660
84;2021-03-22;155;142;297;372151;315211;79;687362
84;2021-03-22;97;73;170;237198;150524;89;387722
84;2021-03-22;40;21;61;81185;28680;90;109865
84;2021-03-22;2959;2650;5621;4130719;3901658;0;8032377
93;2021-03-22;100;97;198;268834;283093;09;551927
93;2021-03-22;362;329;694;280751;296087;19;576838
93;2021-03-22;356;298;655;254404;255552;29;509956
93;2021-03-22;425;361;786;310704;288398;39;599102
93;2021-03-22;470;395;865;325559;305827;49;631386
93;2021-03-22;399;329;729;353104;325389;59;678493
93;2021-03-22;266;248;515;336327;296459;69;632786
93;2021-03-22;155;131;287;279820;229699;79;509519
93;2021-03-22;68;51;119;171274;113716;89;284990
93;2021-03-22;38;10;48;58896;21758;90;80654
93;2021-03-22;2639;2250;4897;2639673;2415978;0;5055651
94;2021-03-22;4;5;9;16311;17433;09;33744
94;2021-03-22;4;4;8;16679;18132;19;34811
94;2021-03-22;9;6;15;16782;16579;29;33361
94;2021-03-22;17;2;19;23044;20580;39;43624
94;2021-03-22;8;10;18;23065;22140;49;45205
94;2021-03-22;10;9;19;24549;23421;59;47970
94;2021-03-22;10;6;16;23212;21883;69;45095
94;2021-03-22;5;10;15;19544;17141;79;36685
94;2021-03-22;3;2;5;11227;8178;89;19405
94;2021-03-22;8;0;8;3332;1447;90;4779
94;2021-03-22;78;54;132;177745;166934;0;344679
01;2021-03-23;0;2;2;19979;20155;09;40134
01;2021-03-23;5;3;8;24994;25489;19;50483
01;2021-03-23;5;3;8;17868;16690;29;34558
01;2021-03-23;6;2;8;22328;14821;39;37149
01;2021-03-23;4;7;11;28652;20276;49;48928
01;2021-03-23;14;4;18;33264;27260;59;60524
01;2021-03-23;6;5;11;27135;23978;69;51113
01;2021-03-23;3;2;5;18401;14661;79;33062
01;2021-03-23;1;2;3;9633;6375;89;16008
01;2021-03-23;0;0;0;3410;1510;90;4920
01;2021-03-23;44;30;74;205664;171215;0;376879
02;2021-03-23;2;0;2;16881;17110;09;33991
02;2021-03-23;5;4;9;21410;21604;19;43014
02;2021-03-23;8;9;17;16017;15479;29;31496
02;2021-03-23;6;6;12;19825;14455;39;34280
02;2021-03-23;11;10;21;24719;18248;49;42967
02;2021-03-23;21;8;29;34361;28310;59;62671
02;2021-03-23;4;9;13;28061;24495;69;52556
02;2021-03-23;4;1;5;18231;15278;79;33509
02;2021-03-23;1;0;1;11090;7677;89;18767
02;2021-03-23;1;0;1;3992;1506;90;5498
02;2021-03-23;63;47;110;194587;164162;0;358749
03;2021-03-23;0;0;0;31123;30920;09;62043
03;2021-03-23;2;1;3;29370;29268;19;58638
03;2021-03-23;0;1;1;21458;18963;29;40421
03;2021-03-23;3;1;4;21276;18326;39;39602
03;2021-03-23;0;1;1;18164;16593;49;34757
03;2021-03-23;2;1;3;13469;13557;59;27026
03;2021-03-23;0;0;0;8776;8670;69;17446
03;2021-03-23;0;0;0;3777;3591;79;7368
03;2021-03-23;0;0;0;1649;1072;89;2721
03;2021-03-23;0;0;0;485;184;90;669
03;2021-03-23;7;5;12;149547;141144;0;290691
04;2021-03-23;9;4;13;60314;61377;09;121691
04;2021-03-23;17;22;39;66065;68387;19;134452
04;2021-03-23;18;10;28;51059;47156;29;98215
04;2021-03-23;22;16;38;58788;45780;39;104568
04;2021-03-23;26;16;42;61408;52207;49;113615
04;2021-03-23;14;12;26;64838;60759;59;125597
04;2021-03-23;13;13;26;47008;42843;69;89851
04;2021-03-23;1;6;7;25509;21184;79;46693
04;2021-03-23;2;1;3;13168;7647;89;20815
04;2021-03-23;0;0;0;3209;1253;90;4462
04;2021-03-23;122;100;222;451366;408593;0;859959
05;2021-03-23;0;0;0;362.366008612902;341.338819562748;09;703.704828175651
05;2021-03-23;0;0;0;353.376145114279;370.349735405642;19;723.725880519921
05;2021-03-23;0;0;0;218.593559489256;256.539602589476;29;475.133162078732
05;2021-03-23;0;0;0;404.225408693299;360.321910454353;39;764.547319147651
05;2021-03-23;0;0;0;520.067953604221;497.108383964256;49;1017.17633756848
05;2021-03-23;0;0;0;468.146063921917;510.087601910415;59;978.233665832332
05;2021-03-23;0;0;0;340.368470050554;334.366842191253;69;674.735312241807
05;2021-03-23;0;0;0;212.598666888387;192.597753227106;79;405.196420115493
05;2021-03-23;0;0;0;148.727797095705;61.8681715431829;89;210.595968638888
05;2021-03-23;0;0;0;32.9601271090696;10.9909785719784;90;43.9511056810479
05;2021-03-23;0;0;0;3061.43020057959;2935.56979942041;0;5997
06;2021-03-23;0;0;0;42583;42380;09;84963
06;2021-03-23;1;2;3;33369;31925;19;65294
06;2021-03-23;4;5;9;21571;15080;29;36651
06;2021-03-23;5;1;6;21550;16147;39;37697
06;2021-03-23;2;4;6;14193;13939;49;28132
06;2021-03-23;2;3;5;7171;7597;59;14768
06;2021-03-23;0;2;2;3629;4117;69;7746
06;2021-03-23;2;0;2;1577;1457;79;3034
06;2021-03-23;0;0;0;531;474;89;1005
06;2021-03-23;0;0;0;88;93;90;181
06;2021-03-23;16;17;33;146262;133209;0;279471
07;2021-03-23;0;1;1;485;549;09;1034
07;2021-03-23;1;0;1;403;432;19;835
07;2021-03-23;0;1;1;764;841;29;1605
07;2021-03-23;0;2;2;824;928;39;1752
07;2021-03-23;1;0;1;788;1020;49;1808
07;2021-03-23;0;0;0;678;870;59;1548
07;2021-03-23;0;1;1;360;382;69;742
07;2021-03-23;1;0;1;231;190;79;421
07;2021-03-23;0;0;0;114;67;89;181
07;2021-03-23;0;0;0;24;11;90;35
07;2021-03-23;3;5;8;4671;5290;0;9961
08;2021-03-23;0;0;0;2715.22592983026;2997.75551488675;09;5712.98144471701
08;2021-03-23;0;1;1;2778.51901080978;3160.9156459093;19;5939.43465671908
08;2021-03-23;0;0;0;2080.8882988764;1718.16634315323;29;3799.05464202964
08;2021-03-23;1;0;1;2701.8582062647;1896.52641413317;39;4598.38462039786
08;2021-03-23;1;1;2;3151.45861023308;2460.52498233809;49;5611.98359257117
08;2021-03-23;0;0;0;2620.29868333099;2422.23566154656;59;5042.53434487755
08;2021-03-23;0;0;0;1621.44173420671;1438.58325779464;69;3060.02499200135
08;2021-03-23;0;0;0;626.575909335673;526.358467843651;79;1152.93437717932
08;2021-03-23;0;0;0;205.018522985054;140.993639349697;89;346.012162334751
08;2021-03-23;0;0;0;50.0325684687745;20.62259870351;90;70.6551671722846
08;2021-03-23;2;2;4;18551.3174743414;16782.6825256586;0;35334
11;2021-03-23;428;450;928;783071;811785;09;1594856
11;2021-03-23;1084;1131;2296;761456;784653;19;1546109
11;2021-03-23;1316;1102;2428;850145;801772;29;1651917
11;2021-03-23;1419;1185;2617;914360;843488;39;1757848
11;2021-03-23;1270;1170;2450;845609;826202;49;1671811
11;2021-03-23;907;888;1801;793566;745070;59;1538636
11;2021-03-23;553;577;1156;628649;549192;69;1177841
11;2021-03-23;237;222;459;434606;358356;79;792962
11;2021-03-23;118;90;209;261425;162933;89;424358
11;2021-03-23;53;37;90;89253;32619;90;121872
11;2021-03-23;7386;6855;14442;6362140;5916070;0;12278210
24;2021-03-23;33;34;68;139720;144686;09;284406
24;2021-03-23;95;101;198;152979;161185;19;314164
24;2021-03-23;93;86;179;122237;126536;29;248773
24;2021-03-23;114;66;180;150359;142009;39;292368
24;2021-03-23;108;110;219;161829;158758;49;320587
24;2021-03-23;111;99;210;172552;168011;59;340563
24;2021-03-23;56;57;113;172509;158177;69;330686
24;2021-03-23;36;50;86;129428;110593;79;240021
24;2021-03-23;26;10;36;87342;56882;89;144224
24;2021-03-23;11;4;15;31210;12071;90;43281
24;2021-03-23;683;617;1304;1320165;1238908;0;2559073
27;2021-03-23;30;40;70;143373;149679;09;293052
27;2021-03-23;120;125;245;160962;173003;19;333965
27;2021-03-23;98;99;197;133746;142254;29;276000
27;2021-03-23;106;90;196;160004;155407;39;315411
27;2021-03-23;97;113;210;172333;169564;49;341897
27;2021-03-23;104;107;211;189979;183788;59;373767
27;2021-03-23;65;82;147;192591;178206;69;370797
27;2021-03-23;44;42;86;146876;127546;79;274422
27;2021-03-23;24;14;38;96896;61575;89;158471
27;2021-03-23;16;3;19;33148;12109;90;45257
27;2021-03-23;704;715;1419;1429908;1353131;0;2783039
28;2021-03-23;63;74;140;180735;186856;09;367591
28;2021-03-23;167;153;324;200125;213621;19;413746
28;2021-03-23;143;113;256;168922;173007;29;341929
28;2021-03-23;163;116;279;196628;188487;39;385115
28;2021-03-23;174;132;306;205396;201699;49;407095
28;2021-03-23;131;114;245;222002;213866;59;435868
28;2021-03-23;101;80;181;224688;203758;69;428446
28;2021-03-23;49;59;108;163192;135543;79;298735
28;2021-03-23;48;16;64;109691;65377;89;175068
28;2021-03-23;18;7;25;37222;12685;90;49907
28;2021-03-23;1057;864;1928;1708601;1594899;0;3303500
32;2021-03-23;189;207;398;358062;373689;09;731751
32;2021-03-23;412;403;815;387045;406742;19;793787
32;2021-03-23;417;366;784;342304;348587;29;690891
32;2021-03-23;406;372;778;382485;369972;39;752457
32;2021-03-23;412;363;775;382510;376716;49;759226
32;2021-03-23;407;301;711;386937;376527;59;763464
32;2021-03-23;214;192;407;371211;330938;69;702149
32;2021-03-23;133;119;252;250542;201459;79;452001
32;2021-03-23;90;29;119;163399;89786;89;253185
32;2021-03-23;50;17;67;48384;15367;90;63751
32;2021-03-23;2730;2369;5106;3072879;2889783;0;5962662
44;2021-03-23;85;104;190;291525;306839;09;598364
44;2021-03-23;236;248;485;320255;339504;19;659759
44;2021-03-23;170;195;367;302020;314428;29;616448
44;2021-03-23;222;161;385;342222;333292;39;675514
44;2021-03-23;225;191;417;349727;344491;49;694218
44;2021-03-23;196;184;383;381371;373239;59;754610
44;2021-03-23;123;120;245;367165;335850;69;703015
44;2021-03-23;69;69;138;250387;215436;79;465823
44;2021-03-23;49;32;83;170825;105192;89;276017
44;2021-03-23;24;8;32;51248;16731;90;67979
44;2021-03-23;1399;1313;2726;2826745;2685002;0;5511747
52;2021-03-23;44;52;98;213594;223900;09;437494
52;2021-03-23;117;115;234;240818;255197;19;496015
52;2021-03-23;111;106;217;197010;200630;29;397640
52;2021-03-23;122;117;239;231204;224885;39;456089
52;2021-03-23;106;102;208;243874;243418;49;487292
52;2021-03-23;95;84;179;244100;239116;59;483216
52;2021-03-23;80;77;157;241796;221345;69;463141
52;2021-03-23;50;34;84;177805;149903;79;327708
52;2021-03-23;26;20;46;119561;75822;89;195383
52;2021-03-23;12;4;16;42559;15260;90;57819
52;2021-03-23;763;711;1478;1952321;1849476;0;3801797
53;2021-03-23;44;44;88;173813;182358;09;356171
53;2021-03-23;112;122;234;202720;214740;19;417460
53;2021-03-23;83;91;179;163116;173196;29;336312
53;2021-03-23;95;59;154;190526;187674;39;378200
53;2021-03-23;84;59;143;212098;212015;49;424113
53;2021-03-23;67;58;125;223699;219176;59;442875
53;2021-03-23;41;29;70;227435;209274;69;436709
53;2021-03-23;32;25;57;169992;140910;79;310902
53;2021-03-23;19;10;29;118117;69883;89;188000
53;2021-03-23;6;3;9;37370;12267;90;49637
53;2021-03-23;583;500;1088;1718886;1621493;0;3340379
75;2021-03-23;68;73;142;293104;305291;09;598395
75;2021-03-23;173;203;377;337141;357785;19;694926
75;2021-03-23;152;154;306;295024;300618;29;595642
75;2021-03-23;164;138;302;347871;331233;39;679104
75;2021-03-23;170;146;316;384742;372771;49;757513
75;2021-03-23;120;132;252;413361;390880;59;804241
75;2021-03-23;77;95;172;425623;384060;69;809683
75;2021-03-23;43;53;96;325086;276298;79;601384
75;2021-03-23;35;20;55;213986;139308;89;353294
75;2021-03-23;15;4;19;77600;28200;90;105800
75;2021-03-23;1017;1019;2038;3113538;2886444;0;5999982
76;2021-03-23;58;65;128;305956;318589;09;624545
76;2021-03-23;231;254;489;338942;356969;19;695911
76;2021-03-23;216;178;394;316210;319570;29;635780
76;2021-03-23;240;202;443;356758;337587;39;694345
76;2021-03-23;232;198;430;376541;363812;49;740353
76;2021-03-23;158;149;307;402608;383750;59;786358
76;2021-03-23;121;118;239;394889;358997;69;753886
76;2021-03-23;85;76;161;308664;263806;79;572470
76;2021-03-23;57;38;95;195838;129272;89;325110
76;2021-03-23;28;12;40;69372;26728;90;96100
76;2021-03-23;1428;1292;2730;3065778;2859080;0;5924858
84;2021-03-23;116;132;248;459549;481088;09;940637
84;2021-03-23;397;412;810;487711;511905;19;999616
84;2021-03-23;347;342;690;443824;451094;29;894918
84;2021-03-23;398;320;719;512522;493262;39;1005784
84;2021-03-23;363;368;731;520248;515106;49;1035354
84;2021-03-23;305;303;608;529611;514848;59;1044459
84;2021-03-23;185;199;384;486720;439940;69;926660
84;2021-03-23;127;102;229;372151;315211;79;687362
84;2021-03-23;76;48;124;237198;150524;89;387722
84;2021-03-23;33;11;44;81185;28680;90;109865
84;2021-03-23;2348;2237;4592;4130719;3901658;0;8032377
93;2021-03-23;85;104;190;268834;283093;09;551927
93;2021-03-23;269;261;531;280751;296087;19;576838
93;2021-03-23;316;225;541;254404;255552;29;509956
93;2021-03-23;366;288;654;310704;288398;39;599102
93;2021-03-23;311;272;585;325559;305827;49;631386
93;2021-03-23;309;244;553;353104;325389;59;678493
93;2021-03-23;200;177;378;336327;296459;69;632786
93;2021-03-23;96;123;219;279820;229699;79;509519
93;2021-03-23;65;39;104;171274;113716;89;284990
93;2021-03-23;39;9;48;58896;21758;90;80654
93;2021-03-23;2056;1742;3803;2639673;2415978;0;5055651
94;2021-03-23;2;1;3;16311;17433;09;33744
94;2021-03-23;9;6;15;16679;18132;19;34811
94;2021-03-23;4;4;8;16782;16579;29;33361
94;2021-03-23;7;8;15;23044;20580;39;43624
94;2021-03-23;7;5;12;23065;22140;49;45205
94;2021-03-23;3;3;6;24549;23421;59;47970
94;2021-03-23;7;5;12;23212;21883;69;45095
94;2021-03-23;4;5;9;19544;17141;79;36685
94;2021-03-23;1;2;3;11227;8178;89;19405
94;2021-03-23;1;0;1;3332;1447;90;4779
94;2021-03-23;45;39;84;177745;166934;0;344679
01;2021-03-24;0;2;2;19979;20155;09;40134
01;2021-03-24;3;7;10;24994;25489;19;50483
01;2021-03-24;5;4;9;17868;16690;29;34558
01;2021-03-24;4;4;8;22328;14821;39;37149
01;2021-03-24;8;1;9;28652;20276;49;48928
01;2021-03-24;4;7;11;33264;27260;59;60524
01;2021-03-24;8;3;11;27135;23978;69;51113
01;2021-03-24;3;0;3;18401;14661;79;33062
01;2021-03-24;6;1;7;9633;6375;89;16008
01;2021-03-24;0;0;0;3410;1510;90;4920
01;2021-03-24;41;29;70;205664;171215;0;376879
02;2021-03-24;1;0;1;16881;17110;09;33991
02;2021-03-24;8;12;20;21410;21604;19;43014
02;2021-03-24;11;4;15;16017;15479;29;31496
02;2021-03-24;8;6;14;19825;14455;39;34280
02;2021-03-24;9;8;17;24719;18248;49;42967
02;2021-03-24;7;4;11;34361;28310;59;62671
02;2021-03-24;6;5;11;28061;24495;69;52556
02;2021-03-24;6;3;9;18231;15278;79;33509
02;2021-03-24;2;1;3;11090;7677;89;18767
02;2021-03-24;1;0;1;3992;1506;90;5498
02;2021-03-24;59;43;102;194587;164162;0;358749
03;2021-03-24;0;1;1;31123;30920;09;62043
03;2021-03-24;0;0;0;29370;29268;19;58638
03;2021-03-24;3;2;5;21458;18963;29;40421
03;2021-03-24;4;1;5;21276;18326;39;39602
03;2021-03-24;2;4;6;18164;16593;49;34757
03;2021-03-24;4;4;8;13469;13557;59;27026
03;2021-03-24;2;2;4;8776;8670;69;17446
03;2021-03-24;1;0;1;3777;3591;79;7368
03;2021-03-24;1;0;1;1649;1072;89;2721
03;2021-03-24;0;0;0;485;184;90;669
03;2021-03-24;17;14;31;149547;141144;0;290691
04;2021-03-24;6;4;10;60314;61377;09;121691
04;2021-03-24;14;17;31;66065;68387;19;134452
04;2021-03-24;13;16;29;51059;47156;29;98215
04;2021-03-24;20;16;36;58788;45780;39;104568
04;2021-03-24;18;13;31;61408;52207;49;113615
04;2021-03-24;18;16;34;64838;60759;59;125597
04;2021-03-24;6;10;16;47008;42843;69;89851
04;2021-03-24;5;6;11;25509;21184;79;46693
04;2021-03-24;3;1;4;13168;7647;89;20815
04;2021-03-24;1;0;1;3209;1253;90;4462
04;2021-03-24;104;99;203;451366;408593;0;859959
05;2021-03-24;0;0;0;362.366008612902;341.338819562748;09;703.704828175651
05;2021-03-24;0;0;0;353.376145114279;370.349735405642;19;723.725880519921
05;2021-03-24;0;0;0;218.593559489256;256.539602589476;29;475.133162078732
05;2021-03-24;0;0;0;404.225408693299;360.321910454353;39;764.547319147651
05;2021-03-24;0;0;0;520.067953604221;497.108383964256;49;1017.17633756848
05;2021-03-24;0;0;0;468.146063921917;510.087601910415;59;978.233665832332
05;2021-03-24;0;0;0;340.368470050554;334.366842191253;69;674.735312241807
05;2021-03-24;0;0;0;212.598666888387;192.597753227106;79;405.196420115493
05;2021-03-24;0;0;0;148.727797095705;61.8681715431829;89;210.595968638888
05;2021-03-24;0;0;0;32.9601271090696;10.9909785719784;90;43.9511056810479
05;2021-03-24;0;0;0;3061.43020057959;2935.56979942041;0;5997
06;2021-03-24;0;0;0;42583;42380;09;84963
06;2021-03-24;1;3;4;33369;31925;19;65294
06;2021-03-24;3;1;4;21571;15080;29;36651
06;2021-03-24;4;3;7;21550;16147;39;37697
06;2021-03-24;2;2;4;14193;13939;49;28132
06;2021-03-24;1;0;1;7171;7597;59;14768
06;2021-03-24;2;4;6;3629;4117;69;7746
06;2021-03-24;0;0;0;1577;1457;79;3034
06;2021-03-24;0;0;0;531;474;89;1005
06;2021-03-24;0;0;0;88;93;90;181
06;2021-03-24;13;13;26;146262;133209;0;279471
07;2021-03-24;0;0;0;485;549;09;1034
07;2021-03-24;0;0;0;403;432;19;835
07;2021-03-24;0;2;2;764;841;29;1605
07;2021-03-24;1;0;1;824;928;39;1752
07;2021-03-24;1;0;1;788;1020;49;1808
07;2021-03-24;1;0;1;678;870;59;1548
07;2021-03-24;0;1;1;360;382;69;742
07;2021-03-24;0;0;0;231;190;79;421
07;2021-03-24;0;0;0;114;67;89;181
07;2021-03-24;0;0;0;24;11;90;35
07;2021-03-24;3;3;6;4671;5290;0;9961
08;2021-03-24;0;0;0;2715.22592983026;2997.75551488675;09;5712.98144471701
08;2021-03-24;0;0;0;2778.51901080978;3160.9156459093;19;5939.43465671908
08;2021-03-24;0;0;0;2080.8882988764;1718.16634315323;29;3799.05464202964
08;2021-03-24;0;1;1;2701.8582062647;1896.52641413317;39;4598.38462039786
08;2021-03-24;2;1;3;3151.45861023308;2460.52498233809;49;5611.98359257117
08;2021-03-24;1;2;3;2620.29868333099;2422.23566154656;59;5042.53434487755
08;2021-03-24;1;0;1;1621.44173420671;1438.58325779464;69;3060.02499200135
08;2021-03-24;0;0;0;626.575909335673;526.358467843651;79;1152.93437717932
08;2021-03-24;0;0;0;205.018522985054;140.993639349697;89;346.012162334751
08;2021-03-24;0;0;0;50.0325684687745;20.62259870351;90;70.6551671722846
08;2021-03-24;4;4;8;18551.3174743414;16782.6825256586;0;35334
11;2021-03-24;419;477;930;783071;811785;09;1594856
11;2021-03-24;1133;1099;2321;761456;784653;19;1546109
11;2021-03-24;1270;1080;2359;850145;801772;29;1651917
11;2021-03-24;1332;1094;2431;914360;843488;39;1757848
11;2021-03-24;1135;1036;2180;845609;826202;49;1671811
11;2021-03-24;836;806;1646;793566;745070;59;1538636
11;2021-03-24;532;511;1071;628649;549192;69;1177841
11;2021-03-24;194;208;403;434606;358356;79;792962
11;2021-03-24;120;69;189;261425;162933;89;424358
11;2021-03-24;50;25;75;89253;32619;90;121872
11;2021-03-24;7022;6409;13610;6362140;5916070;0;12278210
24;2021-03-24;37;33;74;139720;144686;09;284406
24;2021-03-24;105;108;215;152979;161185;19;314164
24;2021-03-24;97;82;179;122237;126536;29;248773
24;2021-03-24;114;79;194;150359;142009;39;292368
24;2021-03-24;110;90;200;161829;158758;49;320587
24;2021-03-24;106;86;192;172552;168011;59;340563
24;2021-03-24;60;59;119;172509;158177;69;330686
24;2021-03-24;44;33;77;129428;110593;79;240021
24;2021-03-24;19;11;30;87342;56882;89;144224
24;2021-03-24;14;2;16;31210;12071;90;43281
24;2021-03-24;706;583;1296;1320165;1238908;0;2559073
27;2021-03-24;28;38;66;143373;149679;09;293052
27;2021-03-24;108;116;228;160962;173003;19;333965
27;2021-03-24;90;96;186;133746;142254;29;276000
27;2021-03-24;86;73;159;160004;155407;39;315411
27;2021-03-24;107;85;192;172333;169564;49;341897
27;2021-03-24;82;94;176;189979;183788;59;373767
27;2021-03-24;79;63;142;192591;178206;69;370797
27;2021-03-24;49;38;87;146876;127546;79;274422
27;2021-03-24;31;18;49;96896;61575;89;158471
27;2021-03-24;14;4;18;33148;12109;90;45257
27;2021-03-24;674;625;1303;1429908;1353131;0;2783039
28;2021-03-24;51;54;109;180735;186856;09;367591
28;2021-03-24;168;155;327;200125;213621;19;413746
28;2021-03-24;142;113;255;168922;173007;29;341929
28;2021-03-24;166;144;310;196628;188487;39;385115
28;2021-03-24;128;125;253;205396;201699;49;407095
28;2021-03-24;128;128;256;222002;213866;59;435868
28;2021-03-24;76;78;154;224688;203758;69;428446
28;2021-03-24;47;36;83;163192;135543;79;298735
28;2021-03-24;41;23;64;109691;65377;89;175068
28;2021-03-24;23;2;25;37222;12685;90;49907
28;2021-03-24;970;858;1836;1708601;1594899;0;3303500
32;2021-03-24;138;181;320;358062;373689;09;731751
32;2021-03-24;368;376;746;387045;406742;19;793787
32;2021-03-24;429;355;785;342304;348587;29;690891
32;2021-03-24;405;359;764;382485;369972;39;752457
32;2021-03-24;398;352;750;382510;376716;49;759226
32;2021-03-24;321;316;637;386937;376527;59;763464
32;2021-03-24;207;206;413;371211;330938;69;702149
32;2021-03-24;135;120;255;250542;201459;79;452001
32;2021-03-24;85;48;133;163399;89786;89;253185
32;2021-03-24;38;10;48;48384;15367;90;63751
32;2021-03-24;2525;2323;4852;3072879;2889783;0;5962662
44;2021-03-24;65;95;160;291525;306839;09;598364
44;2021-03-24;209;211;421;320255;339504;19;659759
44;2021-03-24;181;171;352;302020;314428;29;616448
44;2021-03-24;200;140;340;342222;333292;39;675514
44;2021-03-24;192;181;374;349727;344491;49;694218
44;2021-03-24;168;161;332;381371;373239;59;754610
44;2021-03-24;106;115;222;367165;335850;69;703015
44;2021-03-24;70;72;142;250387;215436;79;465823
44;2021-03-24;41;30;72;170825;105192;89;276017
44;2021-03-24;28;10;38;51248;16731;90;67979
44;2021-03-24;1260;1186;2453;2826745;2685002;0;5511747
52;2021-03-24;47;46;97;213594;223900;09;437494
52;2021-03-24;145;139;288;240818;255197;19;496015
52;2021-03-24;117;126;243;197010;200630;29;397640
52;2021-03-24;138;147;285;231204;224885;39;456089
52;2021-03-24;132;127;259;243874;243418;49;487292
52;2021-03-24;119;108;227;244100;239116;59;483216
52;2021-03-24;75;60;135;241796;221345;69;463141
52;2021-03-24;45;46;91;177805;149903;79;327708
52;2021-03-24;25;18;43;119561;75822;89;195383
52;2021-03-24;16;3;19;42559;15260;90;57819
52;2021-03-24;859;820;1687;1952321;1849476;0;3801797
53;2021-03-24;38;33;71;173813;182358;09;356171
53;2021-03-24;94;92;188;202720;214740;19;417460
53;2021-03-24;87;100;190;163116;173196;29;336312
53;2021-03-24;98;92;190;190526;187674;39;378200
53;2021-03-24;67;61;129;212098;212015;49;424113
53;2021-03-24;67;69;136;223699;219176;59;442875
53;2021-03-24;55;53;108;227435;209274;69;436709
53;2021-03-24;27;17;44;169992;140910;79;310902
53;2021-03-24;18;14;32;118117;69883;89;188000
53;2021-03-24;5;5;10;37370;12267;90;49637
53;2021-03-24;557;536;1099;1718886;1621493;0;3340379
75;2021-03-24;55;64;119;293104;305291;09;598395
75;2021-03-24;150;221;371;337141;357785;19;694926
75;2021-03-24;157;156;313;295024;300618;29;595642
75;2021-03-24;151;136;287;347871;331233;39;679104
75;2021-03-24;167;128;295;384742;372771;49;757513
75;2021-03-24;123;109;232;413361;390880;59;804241
75;2021-03-24;83;74;157;425623;384060;69;809683
75;2021-03-24;49;43;92;325086;276298;79;601384
75;2021-03-24;30;21;51;213986;139308;89;353294
75;2021-03-24;12;3;15;77600;28200;90;105800
75;2021-03-24;977;956;1933;3113538;2886444;0;5999982
76;2021-03-24;70;74;150;305956;318589;09;624545
76;2021-03-24;251;223;479;338942;356969;19;695911
76;2021-03-24;206;182;388;316210;319570;29;635780
76;2021-03-24;203;184;388;356758;337587;39;694345
76;2021-03-24;213;199;412;376541;363812;49;740353
76;2021-03-24;170;156;326;402608;383750;59;786358
76;2021-03-24;133;107;240;394889;358997;69;753886
76;2021-03-24;75;67;143;308664;263806;79;572470
76;2021-03-24;67;34;101;195838;129272;89;325110
76;2021-03-24;18;14;32;69372;26728;90;96100
76;2021-03-24;1408;1240;2661;3065778;2859080;0;5924858
84;2021-03-24;142;143;286;459549;481088;09;940637
84;2021-03-24;391;421;814;487711;511905;19;999616
84;2021-03-24;369;366;735;443824;451094;29;894918
84;2021-03-24;409;324;733;512522;493262;39;1005784
84;2021-03-24;391;354;745;520248;515106;49;1035354
84;2021-03-24;320;300;620;529611;514848;59;1044459
84;2021-03-24;172;178;350;486720;439940;69;926660
84;2021-03-24;109;111;220;372151;315211;79;687362
84;2021-03-24;69;48;117;237198;150524;89;387722
84;2021-03-24;28;15;43;81185;28680;90;109865
84;2021-03-24;2400;2260;4663;4130719;3901658;0;8032377
93;2021-03-24;96;87;185;268834;283093;09;551927
93;2021-03-24;298;317;618;280751;296087;19;576838
93;2021-03-24;345;277;623;254404;255552;29;509956
93;2021-03-24;347;277;625;310704;288398;39;599102
93;2021-03-24;323;261;584;325559;305827;49;631386
93;2021-03-24;283;277;560;353104;325389;59;678493
93;2021-03-24;163;176;339;336327;296459;69;632786
93;2021-03-24;115;103;218;279820;229699;79;509519
93;2021-03-24;80;60;140;171274;113716;89;284990
93;2021-03-24;21;10;31;58896;21758;90;80654
93;2021-03-24;2072;1847;3926;2639673;2415978;0;5055651
94;2021-03-24;0;0;0;16311;17433;09;33744
94;2021-03-24;1;6;7;16679;18132;19;34811
94;2021-03-24;5;4;9;16782;16579;29;33361
94;2021-03-24;7;5;12;23044;20580;39;43624
94;2021-03-24;5;3;8;23065;22140;49;45205
94;2021-03-24;7;6;13;24549;23421;59;47970
94;2021-03-24;3;7;10;23212;21883;69;45095
94;2021-03-24;5;3;8;19544;17141;79;36685
94;2021-03-24;3;1;4;11227;8178;89;19405
94;2021-03-24;1;0;1;3332;1447;90;4779
94;2021-03-24;37;35;72;177745;166934;0;344679
01;2021-03-25;0;3;3;19979;20155;09;40134
01;2021-03-25;3;5;8;24994;25489;19;50483
01;2021-03-25;5;2;7;17868;16690;29;34558
01;2021-03-25;3;3;6;22328;14821;39;37149
01;2021-03-25;6;1;7;28652;20276;49;48928
01;2021-03-25;4;8;12;33264;27260;59;60524
01;2021-03-25;4;5;9;27135;23978;69;51113
01;2021-03-25;2;3;5;18401;14661;79;33062
01;2021-03-25;0;0;0;9633;6375;89;16008
01;2021-03-25;0;0;0;3410;1510;90;4920
01;2021-03-25;27;30;57;205664;171215;0;376879
02;2021-03-25;0;1;1;16881;17110;09;33991
02;2021-03-25;10;4;14;21410;21604;19;43014
02;2021-03-25;11;4;15;16017;15479;29;31496
02;2021-03-25;16;12;28;19825;14455;39;34280
02;2021-03-25;13;12;25;24719;18248;49;42967
02;2021-03-25;10;8;18;34361;28310;59;62671
02;2021-03-25;7;6;13;28061;24495;69;52556
02;2021-03-25;3;7;10;18231;15278;79;33509
02;2021-03-25;2;0;2;11090;7677;89;18767
02;2021-03-25;0;0;0;3992;1506;90;5498
02;2021-03-25;72;54;126;194587;164162;0;358749
03;2021-03-25;1;0;1;31123;30920;09;62043
03;2021-03-25;1;0;1;29370;29268;19;58638
03;2021-03-25;0;1;1;21458;18963;29;40421
03;2021-03-25;6;4;10;21276;18326;39;39602
03;2021-03-25;2;5;7;18164;16593;49;34757
03;2021-03-25;0;5;5;13469;13557;59;27026
03;2021-03-25;3;1;4;8776;8670;69;17446
03;2021-03-25;0;1;1;3777;3591;79;7368
03;2021-03-25;2;1;3;1649;1072;89;2721
03;2021-03-25;0;0;0;485;184;90;669
03;2021-03-25;15;18;33;149547;141144;0;290691
04;2021-03-25;1;4;5;60314;61377;09;121691
04;2021-03-25;10;13;23;66065;68387;19;134452
04;2021-03-25;10;15;26;51059;47156;29;98215
04;2021-03-25;10;4;14;58788;45780;39;104568
04;2021-03-25;3;6;9;61408;52207;49;113615
04;2021-03-25;14;10;24;64838;60759;59;125597
04;2021-03-25;10;9;19;47008;42843;69;89851
04;2021-03-25;4;4;8;25509;21184;79;46693
04;2021-03-25;1;2;3;13168;7647;89;20815
04;2021-03-25;1;0;1;3209;1253;90;4462
04;2021-03-25;64;67;132;451366;408593;0;859959
05;2021-03-25;0;0;0;362.366008612902;341.338819562748;09;703.704828175651
05;2021-03-25;0;0;0;353.376145114279;370.349735405642;19;723.725880519921
05;2021-03-25;0;0;0;218.593559489256;256.539602589476;29;475.133162078732
05;2021-03-25;0;0;0;404.225408693299;360.321910454353;39;764.547319147651
05;2021-03-25;0;0;0;520.067953604221;497.108383964256;49;1017.17633756848
05;2021-03-25;0;0;0;468.146063921917;510.087601910415;59;978.233665832332
05;2021-03-25;0;0;0;340.368470050554;334.366842191253;69;674.735312241807
05;2021-03-25;0;0;0;212.598666888387;192.597753227106;79;405.196420115493
05;2021-03-25;0;0;0;148.727797095705;61.8681715431829;89;210.595968638888
05;2021-03-25;0;0;0;32.9601271090696;10.9909785719784;90;43.9511056810479
05;2021-03-25;0;0;0;3061.43020057959;2935.56979942041;0;5997
06;2021-03-25;0;0;0;42583;42380;09;84963
06;2021-03-25;2;2;4;33369;31925;19;65294
06;2021-03-25;2;0;2;21571;15080;29;36651
06;2021-03-25;5;5;10;21550;16147;39;37697
06;2021-03-25;1;4;5;14193;13939;49;28132
06;2021-03-25;1;2;3;7171;7597;59;14768
06;2021-03-25;0;4;4;3629;4117;69;7746
06;2021-03-25;0;0;0;1577;1457;79;3034
06;2021-03-25;0;0;0;531;474;89;1005
06;2021-03-25;0;0;0;88;93;90;181
06;2021-03-25;11;17;28;146262;133209;0;279471
07;2021-03-25;0;0;0;485;549;09;1034
07;2021-03-25;0;0;0;403;432;19;835
07;2021-03-25;1;0;1;764;841;29;1605
07;2021-03-25;1;0;1;824;928;39;1752
07;2021-03-25;1;0;1;788;1020;49;1808
07;2021-03-25;1;1;2;678;870;59;1548
07;2021-03-25;0;0;0;360;382;69;742
07;2021-03-25;0;0;0;231;190;79;421
07;2021-03-25;0;0;0;114;67;89;181
07;2021-03-25;0;0;0;24;11;90;35
07;2021-03-25;4;1;5;4671;5290;0;9961
08;2021-03-25;0;0;0;2715.22592983026;2997.75551488675;09;5712.98144471701
08;2021-03-25;0;0;0;2778.51901080978;3160.9156459093;19;5939.43465671908
08;2021-03-25;1;1;2;2080.8882988764;1718.16634315323;29;3799.05464202964
08;2021-03-25;0;0;0;2701.8582062647;1896.52641413317;39;4598.38462039786
08;2021-03-25;1;0;1;3151.45861023308;2460.52498233809;49;5611.98359257117
08;2021-03-25;1;1;2;2620.29868333099;2422.23566154656;59;5042.53434487755
08;2021-03-25;0;0;0;1621.44173420671;1438.58325779464;69;3060.02499200135
08;2021-03-25;0;0;0;626.575909335673;526.358467843651;79;1152.93437717932
08;2021-03-25;0;0;0;205.018522985054;140.993639349697;89;346.012162334751
08;2021-03-25;0;0;0;50.0325684687745;20.62259870351;90;70.6551671722846
08;2021-03-25;3;2;5;18551.3174743414;16782.6825256586;0;35334
11;2021-03-25;418;435;894;783071;811785;09;1594856
11;2021-03-25;1085;1068;2221;761456;784653;19;1546109
11;2021-03-25;1190;1017;2217;850145;801772;29;1651917
11;2021-03-25;1312;1078;2397;914360;843488;39;1757848
11;2021-03-25;1156;959;2121;845609;826202;49;1671811
11;2021-03-25;800;802;1609;793566;745070;59;1538636
11;2021-03-25;525;488;1043;628649;549192;69;1177841
11;2021-03-25;209;192;403;434606;358356;79;792962
11;2021-03-25;123;81;205;261425;162933;89;424358
11;2021-03-25;65;26;91;89253;32619;90;121872
11;2021-03-25;6886;6149;13208;6362140;5916070;0;12278210
24;2021-03-25;47;42;93;139720;144686;09;284406
24;2021-03-25;98;116;217;152979;161185;19;314164
24;2021-03-25;108;107;216;122237;126536;29;248773
24;2021-03-25;103;108;211;150359;142009;39;292368
24;2021-03-25;126;104;230;161829;158758;49;320587
24;2021-03-25;101;95;196;172552;168011;59;340563
24;2021-03-25;58;61;119;172509;158177;69;330686
24;2021-03-25;34;30;64;129428;110593;79;240021
24;2021-03-25;21;15;36;87342;56882;89;144224
24;2021-03-25;13;9;22;31210;12071;90;43281
24;2021-03-25;709;687;1404;1320165;1238908;0;2559073
27;2021-03-25;40;43;84;143373;149679;09;293052
27;2021-03-25;104;113;217;160962;173003;19;333965
27;2021-03-25;97;99;196;133746;142254;29;276000
27;2021-03-25;116;101;217;160004;155407;39;315411
27;2021-03-25;109;112;221;172333;169564;49;341897
27;2021-03-25;87;90;177;189979;183788;59;373767
27;2021-03-25;73;76;149;192591;178206;69;370797
27;2021-03-25;27;39;66;146876;127546;79;274422
27;2021-03-25;8;13;21;96896;61575;89;158471
27;2021-03-25;8;7;15;33148;12109;90;45257
27;2021-03-25;669;693;1363;1429908;1353131;0;2783039
28;2021-03-25;59;61;124;180735;186856;09;367591
28;2021-03-25;167;155;326;200125;213621;19;413746
28;2021-03-25;151;143;295;168922;173007;29;341929
28;2021-03-25;151;145;296;196628;188487;39;385115
28;2021-03-25;153;125;278;205396;201699;49;407095
28;2021-03-25;134;115;249;222002;213866;59;435868
28;2021-03-25;91;102;193;224688;203758;69;428446
28;2021-03-25;59;59;118;163192;135543;79;298735
28;2021-03-25;31;14;45;109691;65377;89;175068
28;2021-03-25;10;5;15;37222;12685;90;49907
28;2021-03-25;1006;924;1939;1708601;1594899;0;3303500
32;2021-03-25;206;220;426;358062;373689;09;731751
32;2021-03-25;436;468;904;387045;406742;19;793787
32;2021-03-25;427;374;802;342304;348587;29;690891
32;2021-03-25;449;389;838;382485;369972;39;752457
32;2021-03-25;396;381;777;382510;376716;49;759226
32;2021-03-25;356;298;654;386937;376527;59;763464
32;2021-03-25;205;195;400;371211;330938;69;702149
32;2021-03-25;111;84;195;250542;201459;79;452001
32;2021-03-25;83;41;124;163399;89786;89;253185
32;2021-03-25;35;16;51;48384;15367;90;63751
32;2021-03-25;2706;2466;5173;3072879;2889783;0;5962662
44;2021-03-25;75;107;183;291525;306839;09;598364
44;2021-03-25;207;233;443;320255;339504;19;659759
44;2021-03-25;195;211;407;302020;314428;29;616448
44;2021-03-25;187;164;354;342222;333292;39;675514
44;2021-03-25;223;195;418;349727;344491;49;694218
44;2021-03-25;184;174;358;381371;373239;59;754610
44;2021-03-25;157;141;299;367165;335850;69;703015
44;2021-03-25;67;65;132;250387;215436;79;465823
44;2021-03-25;50;26;76;170825;105192;89;276017
44;2021-03-25;16;7;23;51248;16731;90;67979
44;2021-03-25;1361;1323;2693;2826745;2685002;0;5511747
52;2021-03-25;66;52;121;213594;223900;09;437494
52;2021-03-25;159;131;293;240818;255197;19;496015
52;2021-03-25;148;124;272;197010;200630;29;397640
52;2021-03-25;142;126;268;231204;224885;39;456089
52;2021-03-25;146;114;260;243874;243418;49;487292
52;2021-03-25;117;100;217;244100;239116;59;483216
52;2021-03-25;81;60;142;241796;221345;69;463141
52;2021-03-25;37;37;74;177805;149903;79;327708
52;2021-03-25;31;18;49;119561;75822;89;195383
52;2021-03-25;13;3;16;42559;15260;90;57819
52;2021-03-25;940;765;1712;1952321;1849476;0;3801797
53;2021-03-25;44;50;94;173813;182358;09;356171
53;2021-03-25;77;122;201;202720;214740;19;417460
53;2021-03-25;91;99;192;163116;173196;29;336312
53;2021-03-25;86;61;148;190526;187674;39;378200
53;2021-03-25;65;66;131;212098;212015;49;424113
53;2021-03-25;52;59;111;223699;219176;59;442875
53;2021-03-25;32;53;85;227435;209274;69;436709
53;2021-03-25;20;22;42;169992;140910;79;310902
53;2021-03-25;16;14;30;118117;69883;89;188000
53;2021-03-25;1;3;4;37370;12267;90;49637
53;2021-03-25;485;549;1039;1718886;1621493;0;3340379
75;2021-03-25;67;61;128;293104;305291;09;598395
75;2021-03-25;187;197;385;337141;357785;19;694926
75;2021-03-25;157;170;327;295024;300618;29;595642
75;2021-03-25;124;125;249;347871;331233;39;679104
75;2021-03-25;184;148;332;384742;372771;49;757513
75;2021-03-25;142;141;283;413361;390880;59;804241
75;2021-03-25;93;67;160;425623;384060;69;809683
75;2021-03-25;43;50;93;325086;276298;79;601384
75;2021-03-25;38;18;56;213986;139308;89;353294
75;2021-03-25;15;7;22;77600;28200;90;105800
75;2021-03-25;1050;984;2035;3113538;2886444;0;5999982
76;2021-03-25;97;80;182;305956;318589;09;624545
76;2021-03-25;246;256;506;338942;356969;19;695911
76;2021-03-25;209;184;393;316210;319570;29;635780
76;2021-03-25;222;196;418;356758;337587;39;694345
76;2021-03-25;231;229;460;376541;363812;49;740353
76;2021-03-25;193;190;383;402608;383750;59;786358
76;2021-03-25;165;130;295;394889;358997;69;753886
76;2021-03-25;76;68;144;308664;263806;79;572470
76;2021-03-25;50;38;88;195838;129272;89;325110
76;2021-03-25;21;11;32;69372;26728;90;96100
76;2021-03-25;1512;1383;2904;3065778;2859080;0;5924858
84;2021-03-25;146;151;299;459549;481088;09;940637
84;2021-03-25;405;463;871;487711;511905;19;999616
84;2021-03-25;375;392;767;443824;451094;29;894918
84;2021-03-25;449;338;787;512522;493262;39;1005784
84;2021-03-25;402;362;764;520248;515106;49;1035354
84;2021-03-25;316;342;658;529611;514848;59;1044459
84;2021-03-25;199;190;389;486720;439940;69;926660
84;2021-03-25;122;118;240;372151;315211;79;687362
84;2021-03-25;71;45;116;237198;150524;89;387722
84;2021-03-25;37;14;51;81185;28680;90;109865
84;2021-03-25;2523;2415;4943;4130719;3901658;0;8032377
93;2021-03-25;99;102;202;268834;283093;09;551927
93;2021-03-25;302;337;643;280751;296087;19;576838
93;2021-03-25;347;294;641;254404;255552;29;509956
93;2021-03-25;388;320;708;310704;288398;39;599102
93;2021-03-25;284;285;570;325559;305827;49;631386
93;2021-03-25;270;235;506;353104;325389;59;678493
93;2021-03-25;210;173;383;336327;296459;69;632786
93;2021-03-25;104;108;212;279820;229699;79;509519
93;2021-03-25;64;32;96;171274;113716;89;284990
93;2021-03-25;40;5;45;58896;21758;90;80654
93;2021-03-25;2108;1891;4006;2639673;2415978;0;5055651
94;2021-03-25;1;2;3;16311;17433;09;33744
94;2021-03-25;3;4;7;16679;18132;19;34811
94;2021-03-25;6;5;11;16782;16579;29;33361
94;2021-03-25;7;10;17;23044;20580;39;43624
94;2021-03-25;5;4;9;23065;22140;49;45205
94;2021-03-25;8;5;13;24549;23421;59;47970
94;2021-03-25;9;9;18;23212;21883;69;45095
94;2021-03-25;7;4;11;19544;17141;79;36685
94;2021-03-25;3;1;4;11227;8178;89;19405
94;2021-03-25;1;0;1;3332;1447;90;4779
94;2021-03-25;50;44;94;177745;166934;0;344679
01;2021-03-26;0;0;0;19979;20155;09;40134
01;2021-03-26;3;5;8;24994;25489;19;50483
01;2021-03-26;7;8;15;17868;16690;29;34558
01;2021-03-26;6;2;8;22328;14821;39;37149
01;2021-03-26;5;10;15;28652;20276;49;48928
01;2021-03-26;5;11;16;33264;27260;59;60524
01;2021-03-26;2;6;8;27135;23978;69;51113
01;2021-03-26;4;2;6;18401;14661;79;33062
01;2021-03-26;0;0;0;9633;6375;89;16008
01;2021-03-26;0;0;0;3410;1510;90;4920
01;2021-03-26;32;44;76;205664;171215;0;376879
02;2021-03-26;0;2;2;16881;17110;09;33991
02;2021-03-26;9;3;12;21410;21604;19;43014
02;2021-03-26;9;7;16;16017;15479;29;31496
02;2021-03-26;10;3;13;19825;14455;39;34280
02;2021-03-26;10;10;20;24719;18248;49;42967
02;2021-03-26;7;10;17;34361;28310;59;62671
02;2021-03-26;4;11;15;28061;24495;69;52556
02;2021-03-26;5;5;10;18231;15278;79;33509
02;2021-03-26;1;4;5;11090;7677;89;18767
02;2021-03-26;1;0;1;3992;1506;90;5498
02;2021-03-26;56;55;111;194587;164162;0;358749
03;2021-03-26;0;0;0;31123;30920;09;62043
03;2021-03-26;1;1;2;29370;29268;19;58638
03;2021-03-26;1;2;3;21458;18963;29;40421
03;2021-03-26;4;0;4;21276;18326;39;39602
03;2021-03-26;3;4;7;18164;16593;49;34757
03;2021-03-26;3;1;4;13469;13557;59;27026
03;2021-03-26;5;2;7;8776;8670;69;17446
03;2021-03-26;1;0;1;3777;3591;79;7368
03;2021-03-26;0;0;0;1649;1072;89;2721
03;2021-03-26;0;0;0;485;184;90;669
03;2021-03-26;18;10;28;149547;141144;0;290691
04;2021-03-26;6;6;12;60314;61377;09;121691
04;2021-03-26;23;12;35;66065;68387;19;134452
04;2021-03-26;12;7;19;51059;47156;29;98215
04;2021-03-26;18;12;30;58788;45780;39;104568
04;2021-03-26;10;12;22;61408;52207;49;113615
04;2021-03-26;15;19;34;64838;60759;59;125597
04;2021-03-26;13;10;23;47008;42843;69;89851
04;2021-03-26;2;3;5;25509;21184;79;46693
04;2021-03-26;0;0;0;13168;7647;89;20815
04;2021-03-26;2;0;2;3209;1253;90;4462
04;2021-03-26;101;81;182;451366;408593;0;859959
05;2021-03-26;0;0;0;362.366008612902;341.338819562748;09;703.704828175651
05;2021-03-26;0;0;0;353.376145114279;370.349735405642;19;723.725880519921
05;2021-03-26;0;0;0;218.593559489256;256.539602589476;29;475.133162078732
05;2021-03-26;0;0;0;404.225408693299;360.321910454353;39;764.547319147651
05;2021-03-26;0;0;0;520.067953604221;497.108383964256;49;1017.17633756848
05;2021-03-26;0;0;0;468.146063921917;510.087601910415;59;978.233665832332
05;2021-03-26;0;0;0;340.368470050554;334.366842191253;69;674.735312241807
05;2021-03-26;0;0;0;212.598666888387;192.597753227106;79;405.196420115493
05;2021-03-26;0;0;0;148.727797095705;61.8681715431829;89;210.595968638888
05;2021-03-26;0;0;0;32.9601271090696;10.9909785719784;90;43.9511056810479
05;2021-03-26;0;0;0;3061.43020057959;2935.56979942041;0;5997
06;2021-03-26;2;1;3;42583;42380;09;84963
06;2021-03-26;2;5;7;33369;31925;19;65294
06;2021-03-26;5;4;9;21571;15080;29;36651
06;2021-03-26;5;0;5;21550;16147;39;37697
06;2021-03-26;1;1;2;14193;13939;49;28132
06;2021-03-26;1;1;2;7171;7597;59;14768
06;2021-03-26;12;3;15;3629;4117;69;7746
06;2021-03-26;0;0;0;1577;1457;79;3034
06;2021-03-26;0;0;0;531;474;89;1005
06;2021-03-26;0;0;0;88;93;90;181
06;2021-03-26;28;15;43;146262;133209;0;279471
07;2021-03-26;0;0;0;485;549;09;1034
07;2021-03-26;0;0;0;403;432;19;835
07;2021-03-26;2;1;3;764;841;29;1605
07;2021-03-26;0;4;4;824;928;39;1752
07;2021-03-26;1;0;1;788;1020;49;1808
07;2021-03-26;2;1;3;678;870;59;1548
07;2021-03-26;0;0;0;360;382;69;742
07;2021-03-26;0;0;0;231;190;79;421
07;2021-03-26;0;0;0;114;67;89;181
07;2021-03-26;0;0;0;24;11;90;35
07;2021-03-26;5;6;11;4671;5290;0;9961
08;2021-03-26;0;0;0;2715.22592983026;2997.75551488675;09;5712.98144471701
08;2021-03-26;0;0;0;2778.51901080978;3160.9156459093;19;5939.43465671908
08;2021-03-26;1;0;1;2080.8882988764;1718.16634315323;29;3799.05464202964
08;2021-03-26;0;0;0;2701.8582062647;1896.52641413317;39;4598.38462039786
08;2021-03-26;1;1;2;3151.45861023308;2460.52498233809;49;5611.98359257117
08;2021-03-26;0;0;0;2620.29868333099;2422.23566154656;59;5042.53434487755
08;2021-03-26;0;0;0;1621.44173420671;1438.58325779464;69;3060.02499200135
08;2021-03-26;1;0;1;626.575909335673;526.358467843651;79;1152.93437717932
08;2021-03-26;0;0;0;205.018522985054;140.993639349697;89;346.012162334751
08;2021-03-26;0;0;0;50.0325684687745;20.62259870351;90;70.6551671722846
08;2021-03-26;3;1;4;18551.3174743414;16782.6825256586;0;35334
11;2021-03-26;476;457;988;783071;811785;09;1594856
11;2021-03-26;1151;1242;2490;761456;784653;19;1546109
11;2021-03-26;1185;1074;2265;850145;801772;29;1651917
11;2021-03-26;1353;1005;2363;914360;843488;39;1757848
11;2021-03-26;1246;1079;2334;845609;826202;49;1671811
11;2021-03-26;802;797;1607;793566;745070;59;1538636
11;2021-03-26;561;501;1081;628649;549192;69;1177841
11;2021-03-26;225;200;426;434606;358356;79;792962
11;2021-03-26;120;80;202;261425;162933;89;424358
11;2021-03-26;62;21;83;89253;32619;90;121872
11;2021-03-26;7182;6457;13841;6362140;5916070;0;12278210
24;2021-03-26;46;47;96;139720;144686;09;284406
24;2021-03-26;149;138;293;152979;161185;19;314164
24;2021-03-26;112;80;192;122237;126536;29;248773
24;2021-03-26;115;98;213;150359;142009;39;292368
24;2021-03-26;130;84;215;161829;158758;49;320587
24;2021-03-26;97;93;190;172552;168011;59;340563
24;2021-03-26;65;67;132;172509;158177;69;330686
24;2021-03-26;40;45;85;129428;110593;79;240021
24;2021-03-26;25;18;43;87342;56882;89;144224
24;2021-03-26;7;6;13;31210;12071;90;43281
24;2021-03-26;786;676;1472;1320165;1238908;0;2559073
27;2021-03-26;53;47;101;143373;149679;09;293052
27;2021-03-26;155;151;307;160962;173003;19;333965
27;2021-03-26;108;85;193;133746;142254;29;276000
27;2021-03-26;120;93;213;160004;155407;39;315411
27;2021-03-26;128;107;235;172333;169564;49;341897
27;2021-03-26;93;89;182;189979;183788;59;373767
27;2021-03-26;77;81;158;192591;178206;69;370797
27;2021-03-26;39;35;74;146876;127546;79;274422
27;2021-03-26;29;19;48;96896;61575;89;158471
27;2021-03-26;6;5;11;33148;12109;90;45257
27;2021-03-26;808;712;1522;1429908;1353131;0;2783039
28;2021-03-26;66;72;143;180735;186856;09;367591
28;2021-03-26;168;196;367;200125;213621;19;413746
28;2021-03-26;156;127;283;168922;173007;29;341929
28;2021-03-26;158;136;295;196628;188487;39;385115
28;2021-03-26;149;141;290;205396;201699;49;407095
28;2021-03-26;136;136;272;222002;213866;59;435868
28;2021-03-26;96;93;189;224688;203758;69;428446
28;2021-03-26;63;51;114;163192;135543;79;298735
28;2021-03-26;27;27;54;109691;65377;89;175068
28;2021-03-26;10;6;16;37222;12685;90;49907
28;2021-03-26;1029;985;2023;1708601;1594899;0;3303500
32;2021-03-26;216;230;447;358062;373689;09;731751
32;2021-03-26;497;462;961;387045;406742;19;793787
32;2021-03-26;404;336;740;342304;348587;29;690891
32;2021-03-26;451;374;827;382485;369972;39;752457
32;2021-03-26;410;382;792;382510;376716;49;759226
32;2021-03-26;345;308;653;386937;376527;59;763464
32;2021-03-26;215;195;411;371211;330938;69;702149
32;2021-03-26;119;112;231;250542;201459;79;452001
32;2021-03-26;75;56;131;163399;89786;89;253185
32;2021-03-26;36;11;47;48384;15367;90;63751
32;2021-03-26;2769;2466;5241;3072879;2889783;0;5962662
44;2021-03-26;126;137;268;291525;306839;09;598364
44;2021-03-26;305;241;546;320255;339504;19;659759
44;2021-03-26;218;203;421;302020;314428;29;616448
44;2021-03-26;221;216;438;342222;333292;39;675514
44;2021-03-26;205;199;405;349727;344491;49;694218
44;2021-03-26;181;184;370;381371;373239;59;754610
44;2021-03-26;154;139;294;367165;335850;69;703015
44;2021-03-26;73;81;156;250387;215436;79;465823
44;2021-03-26;63;25;88;170825;105192;89;276017
44;2021-03-26;29;7;36;51248;16731;90;67979
44;2021-03-26;1575;1432;3023;2826745;2685002;0;5511747
52;2021-03-26;94;75;169;213594;223900;09;437494
52;2021-03-26;190;194;387;240818;255197;19;496015
52;2021-03-26;109;123;232;197010;200630;29;397640
52;2021-03-26;118;118;236;231204;224885;39;456089
52;2021-03-26;136;139;275;243874;243418;49;487292
52;2021-03-26;111;111;222;244100;239116;59;483216
52;2021-03-26;69;78;147;241796;221345;69;463141
52;2021-03-26;42;47;89;177805;149903;79;327708
52;2021-03-26;32;19;51;119561;75822;89;195383
52;2021-03-26;10;6;16;42559;15260;90;57819
52;2021-03-26;911;910;1824;1952321;1849476;0;3801797
53;2021-03-26;43;62;105;173813;182358;09;356171
53;2021-03-26;81;145;226;202720;214740;19;417460
53;2021-03-26;84;80;165;163116;173196;29;336312
53;2021-03-26;77;66;143;190526;187674;39;378200
53;2021-03-26;90;68;158;212098;212015;49;424113
53;2021-03-26;58;57;115;223699;219176;59;442875
53;2021-03-26;41;49;90;227435;209274;69;436709
53;2021-03-26;24;23;47;169992;140910;79;310902
53;2021-03-26;18;15;33;118117;69883;89;188000
53;2021-03-26;2;3;5;37370;12267;90;49637
53;2021-03-26;518;568;1088;1718886;1621493;0;3340379
75;2021-03-26;57;61;119;293104;305291;09;598395
75;2021-03-26;193;211;405;337141;357785;19;694926
75;2021-03-26;175;150;325;295024;300618;29;595642
75;2021-03-26;166;167;333;347871;331233;39;679104
75;2021-03-26;167;162;329;384742;372771;49;757513
75;2021-03-26;140;129;269;413361;390880;59;804241
75;2021-03-26;87;97;184;425623;384060;69;809683
75;2021-03-26;38;42;80;325086;276298;79;601384
75;2021-03-26;32;18;50;213986;139308;89;353294
75;2021-03-26;21;8;29;77600;28200;90;105800
75;2021-03-26;1076;1045;2123;3113538;2886444;0;5999982
76;2021-03-26;88;92;184;305956;318589;09;624545
76;2021-03-26;242;289;539;338942;356969;19;695911
76;2021-03-26;247;189;436;316210;319570;29;635780
76;2021-03-26;289;215;504;356758;337587;39;694345
76;2021-03-26;231;229;460;376541;363812;49;740353
76;2021-03-26;219;205;424;402608;383750;59;786358
76;2021-03-26;131;143;274;394889;358997;69;753886
76;2021-03-26;76;67;143;308664;263806;79;572470
76;2021-03-26;46;37;83;195838;129272;89;325110
76;2021-03-26;30;16;46;69372;26728;90;96100
76;2021-03-26;1602;1482;3096;3065778;2859080;0;5924858
84;2021-03-26;168;176;347;459549;481088;09;940637
84;2021-03-26;450;496;949;487711;511905;19;999616
84;2021-03-26;356;343;700;443824;451094;29;894918
84;2021-03-26;440;362;803;512522;493262;39;1005784
84;2021-03-26;398;375;774;520248;515106;49;1035354
84;2021-03-26;349;360;709;529611;514848;59;1044459
84;2021-03-26;238;206;444;486720;439940;69;926660
84;2021-03-26;133;114;247;372151;315211;79;687362
84;2021-03-26;68;48;116;237198;150524;89;387722
84;2021-03-26;31;11;42;81185;28680;90;109865
84;2021-03-26;2632;2492;5134;4130719;3901658;0;8032377
93;2021-03-26;89;123;215;268834;283093;09;551927
93;2021-03-26;336;318;659;280751;296087;19;576838
93;2021-03-26;378;307;685;254404;255552;29;509956
93;2021-03-26;403;283;686;310704;288398;39;599102
93;2021-03-26;281;278;561;325559;305827;49;631386
93;2021-03-26;307;262;569;353104;325389;59;678493
93;2021-03-26;212;180;392;336327;296459;69;632786
93;2021-03-26;115;93;208;279820;229699;79;509519
93;2021-03-26;82;57;139;171274;113716;89;284990
93;2021-03-26;28;12;40;58896;21758;90;80654
93;2021-03-26;2231;1913;4155;2639673;2415978;0;5055651
94;2021-03-26;1;2;3;16311;17433;09;33744
94;2021-03-26;5;3;8;16679;18132;19;34811
94;2021-03-26;10;7;17;16782;16579;29;33361
94;2021-03-26;8;9;17;23044;20580;39;43624
94;2021-03-26;4;11;15;23065;22140;49;45205
94;2021-03-26;9;8;17;24549;23421;59;47970
94;2021-03-26;7;3;10;23212;21883;69;45095
94;2021-03-26;2;3;5;19544;17141;79;36685
94;2021-03-26;2;2;4;11227;8178;89;19405
94;2021-03-26;1;0;1;3332;1447;90;4779
94;2021-03-26;49;48;97;177745;166934;0;344679
01;2021-03-27;0;0;0;19979;20155;09;40134
01;2021-03-27;0;0;0;24994;25489;19;50483
01;2021-03-27;4;2;6;17868;16690;29;34558
01;2021-03-27;2;3;5;22328;14821;39;37149
01;2021-03-27;1;2;3;28652;20276;49;48928
01;2021-03-27;0;2;2;33264;27260;59;60524
01;2021-03-27;5;1;6;27135;23978;69;51113
01;2021-03-27;1;2;3;18401;14661;79;33062
01;2021-03-27;0;0;0;9633;6375;89;16008
01;2021-03-27;1;0;1;3410;1510;90;4920
01;2021-03-27;14;12;26;205664;171215;0;376879
02;2021-03-27;0;0;0;16881;17110;09;33991
02;2021-03-27;3;3;6;21410;21604;19;43014
02;2021-03-27;6;2;8;16017;15479;29;31496
02;2021-03-27;6;4;10;19825;14455;39;34280
02;2021-03-27;7;3;10;24719;18248;49;42967
02;2021-03-27;3;7;10;34361;28310;59;62671
02;2021-03-27;3;1;4;28061;24495;69;52556
02;2021-03-27;1;2;4;18231;15278;79;33509
02;2021-03-27;1;0;1;11090;7677;89;18767
02;2021-03-27;1;0;1;3992;1506;90;5498
02;2021-03-27;31;22;54;194587;164162;0;358749
03;2021-03-27;1;2;3;31123;30920;09;62043
03;2021-03-27;3;2;5;29370;29268;19;58638
03;2021-03-27;0;1;1;21458;18963;29;40421
03;2021-03-27;3;3;7;21276;18326;39;39602
03;2021-03-27;0;6;6;18164;16593;49;34757
03;2021-03-27;4;4;8;13469;13557;59;27026
03;2021-03-27;6;1;7;8776;8670;69;17446
03;2021-03-27;1;0;1;3777;3591;79;7368
03;2021-03-27;0;0;0;1649;1072;89;2721
03;2021-03-27;0;0;0;485;184;90;669
03;2021-03-27;18;19;38;149547;141144;0;290691
04;2021-03-27;2;1;3;60314;61377;09;121691
04;2021-03-27;3;8;11;66065;68387;19;134452
04;2021-03-27;10;5;15;51059;47156;29;98215
04;2021-03-27;5;10;15;58788;45780;39;104568
04;2021-03-27;7;5;12;61408;52207;49;113615
04;2021-03-27;9;10;19;64838;60759;59;125597
04;2021-03-27;7;10;17;47008;42843;69;89851
04;2021-03-27;0;4;4;25509;21184;79;46693
04;2021-03-27;4;2;6;13168;7647;89;20815
04;2021-03-27;0;0;0;3209;1253;90;4462
04;2021-03-27;47;55;102;451366;408593;0;859959
05;2021-03-27;0;0;0;362.366008612902;341.338819562748;09;703.704828175651
05;2021-03-27;0;0;0;353.376145114279;370.349735405642;19;723.725880519921
05;2021-03-27;0;0;0;218.593559489256;256.539602589476;29;475.133162078732
05;2021-03-27;0;0;0;404.225408693299;360.321910454353;39;764.547319147651
05;2021-03-27;0;0;0;520.067953604221;497.108383964256;49;1017.17633756848
05;2021-03-27;0;0;0;468.146063921917;510.087601910415;59;978.233665832332
05;2021-03-27;0;0;0;340.368470050554;334.366842191253;69;674.735312241807
05;2021-03-27;0;0;0;212.598666888387;192.597753227106;79;405.196420115493
05;2021-03-27;0;0;0;148.727797095705;61.8681715431829;89;210.595968638888
05;2021-03-27;0;0;0;32.9601271090696;10.9909785719784;90;43.9511056810479
05;2021-03-27;0;0;0;3061.43020057959;2935.56979942041;0;5997
06;2021-03-27;0;0;0;42583;42380;09;84963
06;2021-03-27;0;0;0;33369;31925;19;65294
06;2021-03-27;0;0;0;21571;15080;29;36651
06;2021-03-27;0;2;2;21550;16147;39;37697
06;2021-03-27;1;1;2;14193;13939;49;28132
06;2021-03-27;0;2;2;7171;7597;59;14768
06;2021-03-27;0;0;0;3629;4117;69;7746
06;2021-03-27;0;0;0;1577;1457;79;3034
06;2021-03-27;0;0;0;531;474;89;1005
06;2021-03-27;0;0;0;88;93;90;181
06;2021-03-27;1;5;6;146262;133209;0;279471
07;2021-03-27;0;0;0;485;549;09;1034
07;2021-03-27;0;0;0;403;432;19;835
07;2021-03-27;1;1;2;764;841;29;1605
07;2021-03-27;0;1;1;824;928;39;1752
07;2021-03-27;0;0;0;788;1020;49;1808
07;2021-03-27;0;0;0;678;870;59;1548
07;2021-03-27;0;0;0;360;382;69;742
07;2021-03-27;1;0;1;231;190;79;421
07;2021-03-27;0;0;0;114;67;89;181
07;2021-03-27;0;0;0;24;11;90;35
07;2021-03-27;2;2;4;4671;5290;0;9961
08;2021-03-27;0;0;0;2715.22592983026;2997.75551488675;09;5712.98144471701
08;2021-03-27;0;0;0;2778.51901080978;3160.9156459093;19;5939.43465671908
08;2021-03-27;1;0;1;2080.8882988764;1718.16634315323;29;3799.05464202964
08;2021-03-27;0;0;0;2701.8582062647;1896.52641413317;39;4598.38462039786
08;2021-03-27;0;0;0;3151.45861023308;2460.52498233809;49;5611.98359257117
08;2021-03-27;0;0;0;2620.29868333099;2422.23566154656;59;5042.53434487755
08;2021-03-27;0;0;0;1621.44173420671;1438.58325779464;69;3060.02499200135
08;2021-03-27;1;0;1;626.575909335673;526.358467843651;79;1152.93437717932
08;2021-03-27;0;0;0;205.018522985054;140.993639349697;89;346.012162334751
08;2021-03-27;0;0;0;50.0325684687745;20.62259870351;90;70.6551671722846
08;2021-03-27;2;0;2;18551.3174743414;16782.6825256586;0;35334
11;2021-03-27;254;265;541;783071;811785;09;1594856
11;2021-03-27;736;804;1594;761456;784653;19;1546109
11;2021-03-27;770;668;1438;850145;801772;29;1651917
11;2021-03-27;840;691;1533;914360;843488;39;1757848
11;2021-03-27;768;705;1474;845609;826202;49;1671811
11;2021-03-27;590;518;1108;793566;745070;59;1538636
11;2021-03-27;366;335;717;628649;549192;69;1177841
11;2021-03-27;150;119;270;434606;358356;79;792962
11;2021-03-27;55;58;113;261425;162933;89;424358
11;2021-03-27;26;14;40;89253;32619;90;121872
11;2021-03-27;4556;4178;8830;6362140;5916070;0;12278210
24;2021-03-27;15;22;38;139720;144686;09;284406
24;2021-03-27;66;60;127;152979;161185;19;314164
24;2021-03-27;60;62;122;122237;126536;29;248773
24;2021-03-27;68;63;131;150359;142009;39;292368
24;2021-03-27;84;67;151;161829;158758;49;320587
24;2021-03-27;49;53;102;172552;168011;59;340563
24;2021-03-27;28;38;66;172509;158177;69;330686
24;2021-03-27;14;14;28;129428;110593;79;240021
24;2021-03-27;13;5;18;87342;56882;89;144224
24;2021-03-27;3;1;4;31210;12071;90;43281
24;2021-03-27;400;385;787;1320165;1238908;0;2559073
27;2021-03-27;30;40;70;143373;149679;09;293052
27;2021-03-27;92;80;172;160962;173003;19;333965
27;2021-03-27;57;53;110;133746;142254;29;276000
27;2021-03-27;74;72;146;160004;155407;39;315411
27;2021-03-27;81;73;154;172333;169564;49;341897
27;2021-03-27;62;71;133;189979;183788;59;373767
27;2021-03-27;49;45;94;192591;178206;69;370797
27;2021-03-27;37;33;70;146876;127546;79;274422
27;2021-03-27;11;11;22;96896;61575;89;158471
27;2021-03-27;5;2;7;33148;12109;90;45257
27;2021-03-27;498;480;978;1429908;1353131;0;2783039
28;2021-03-27;54;32;90;180735;186856;09;367591
28;2021-03-27;86;97;184;200125;213621;19;413746
28;2021-03-27;96;85;181;168922;173007;29;341929
28;2021-03-27;108;103;211;196628;188487;39;385115
28;2021-03-27;86;82;168;205396;201699;49;407095
28;2021-03-27;86;78;164;222002;213866;59;435868
28;2021-03-27;51;48;99;224688;203758;69;428446
28;2021-03-27;50;23;73;163192;135543;79;298735
28;2021-03-27;19;18;37;109691;65377;89;175068
28;2021-03-27;10;2;12;37222;12685;90;49907
28;2021-03-27;646;568;1219;1708601;1594899;0;3303500
32;2021-03-27;113;137;250;358062;373689;09;731751
32;2021-03-27;274;251;526;387045;406742;19;793787
32;2021-03-27;299;229;528;342304;348587;29;690891
32;2021-03-27;284;279;563;382485;369972;39;752457
32;2021-03-27;283;258;541;382510;376716;49;759226
32;2021-03-27;205;237;442;386937;376527;59;763464
32;2021-03-27;135;115;251;371211;330938;69;702149
32;2021-03-27;74;61;135;250542;201459;79;452001
32;2021-03-27;52;36;88;163399;89786;89;253185
32;2021-03-27;25;17;42;48384;15367;90;63751
32;2021-03-27;1744;1620;3366;3072879;2889783;0;5962662
44;2021-03-27;53;70;123;291525;306839;09;598364
44;2021-03-27;170;156;326;320255;339504;19;659759
44;2021-03-27;143;115;258;302020;314428;29;616448
44;2021-03-27;161;159;320;342222;333292;39;675514
44;2021-03-27;175;154;329;349727;344491;49;694218
44;2021-03-27;114;159;273;381371;373239;59;754610
44;2021-03-27;101;79;180;367165;335850;69;703015
44;2021-03-27;43;51;94;250387;215436;79;465823
44;2021-03-27;37;22;59;170825;105192;89;276017
44;2021-03-27;11;10;21;51248;16731;90;67979
44;2021-03-27;1008;975;1983;2826745;2685002;0;5511747
52;2021-03-27;52;39;91;213594;223900;09;437494
52;2021-03-27;124;124;250;240818;255197;19;496015
52;2021-03-27;85;84;169;197010;200630;29;397640
52;2021-03-27;118;91;209;231204;224885;39;456089
52;2021-03-27;114;74;188;243874;243418;49;487292
52;2021-03-27;68;91;159;244100;239116;59;483216
52;2021-03-27;55;47;102;241796;221345;69;463141
52;2021-03-27;26;26;52;177805;149903;79;327708
52;2021-03-27;16;11;27;119561;75822;89;195383
52;2021-03-27;11;6;17;42559;15260;90;57819
52;2021-03-27;669;593;1264;1952321;1849476;0;3801797
53;2021-03-27;35;31;66;173813;182358;09;356171
53;2021-03-27;59;65;126;202720;214740;19;417460
53;2021-03-27;54;67;121;163116;173196;29;336312
53;2021-03-27;51;52;103;190526;187674;39;378200
53;2021-03-27;48;47;95;212098;212015;49;424113
53;2021-03-27;44;57;101;223699;219176;59;442875
53;2021-03-27;38;29;68;227435;209274;69;436709
53;2021-03-27;17;15;32;169992;140910;79;310902
53;2021-03-27;8;10;18;118117;69883;89;188000
53;2021-03-27;1;2;3;37370;12267;90;49637
53;2021-03-27;355;375;733;1718886;1621493;0;3340379
75;2021-03-27;32;38;71;293104;305291;09;598395
75;2021-03-27;137;132;271;337141;357785;19;694926
75;2021-03-27;101;105;206;295024;300618;29;595642
75;2021-03-27;105;105;210;347871;331233;39;679104
75;2021-03-27;124;104;228;384742;372771;49;757513
75;2021-03-27;90;87;177;413361;390880;59;804241
75;2021-03-27;51;55;106;425623;384060;69;809683
75;2021-03-27;25;33;58;325086;276298;79;601384
75;2021-03-27;15;11;26;213986;139308;89;353294
75;2021-03-27;12;3;15;77600;28200;90;105800
75;2021-03-27;693;673;1369;3113538;2886444;0;5999982
76;2021-03-27;46;48;95;305956;318589;09;624545
76;2021-03-27;139;133;276;338942;356969;19;695911
76;2021-03-27;125;142;267;316210;319570;29;635780
76;2021-03-27;147;116;263;356758;337587;39;694345
76;2021-03-27;128;139;267;376541;363812;49;740353
76;2021-03-27;104;106;210;402608;383750;59;786358
76;2021-03-27;73;63;136;394889;358997;69;753886
76;2021-03-27;48;32;80;308664;263806;79;572470
76;2021-03-27;24;11;35;195838;129272;89;325110
76;2021-03-27;10;3;13;69372;26728;90;96100
76;2021-03-27;845;793;1643;3065778;2859080;0;5924858
84;2021-03-27;99;89;188;459549;481088;09;940637
84;2021-03-27;257;260;519;487711;511905;19;999616
84;2021-03-27;248;219;467;443824;451094;29;894918
84;2021-03-27;252;190;442;512522;493262;39;1005784
84;2021-03-27;276;221;497;520248;515106;49;1035354
84;2021-03-27;232;200;432;529611;514848;59;1044459
84;2021-03-27;111;115;226;486720;439940;69;926660
84;2021-03-27;86;77;163;372151;315211;79;687362
84;2021-03-27;50;34;84;237198;150524;89;387722
84;2021-03-27;19;9;28;81185;28680;90;109865
84;2021-03-27;1630;1414;3046;4130719;3901658;0;8032377
93;2021-03-27;59;66;125;268834;283093;09;551927
93;2021-03-27;179;165;347;280751;296087;19;576838
93;2021-03-27;189;183;372;254404;255552;29;509956
93;2021-03-27;187;175;363;310704;288398;39;599102
93;2021-03-27;193;195;388;325559;305827;49;631386
93;2021-03-27;176;163;339;353104;325389;59;678493
93;2021-03-27;119;91;210;336327;296459;69;632786
93;2021-03-27;65;47;112;279820;229699;79;509519
93;2021-03-27;40;22;62;171274;113716;89;284990
93;2021-03-27;18;4;22;58896;21758;90;80654
93;2021-03-27;1225;1111;2340;2639673;2415978;0;5055651
94;2021-03-27;0;1;1;16311;17433;09;33744
94;2021-03-27;2;4;6;16679;18132;19;34811
94;2021-03-27;3;6;9;16782;16579;29;33361
94;2021-03-27;2;3;5;23044;20580;39;43624
94;2021-03-27;4;1;5;23065;22140;49;45205
94;2021-03-27;3;4;7;24549;23421;59;47970
94;2021-03-27;3;3;6;23212;21883;69;45095
94;2021-03-27;1;2;3;19544;17141;79;36685
94;2021-03-27;1;1;2;11227;8178;89;19405
94;2021-03-27;0;0;0;3332;1447;90;4779
94;2021-03-27;19;25;44;177745;166934;0;344679
01;2021-03-28;0;1;1;19979;20155;09;40134
01;2021-03-28;0;0;0;24994;25489;19;50483
01;2021-03-28;1;0;1;17868;16690;29;34558
01;2021-03-28;1;1;2;22328;14821;39;37149
01;2021-03-28;1;1;2;28652;20276;49;48928
01;2021-03-28;0;1;1;33264;27260;59;60524
01;2021-03-28;2;0;2;27135;23978;69;51113
01;2021-03-28;2;0;2;18401;14661;79;33062
01;2021-03-28;0;0;0;9633;6375;89;16008
01;2021-03-28;0;0;0;3410;1510;90;4920
01;2021-03-28;7;4;11;205664;171215;0;376879
02;2021-03-28;0;0;0;16881;17110;09;33991
02;2021-03-28;1;0;1;21410;21604;19;43014
02;2021-03-28;0;0;0;16017;15479;29;31496
02;2021-03-28;0;0;0;19825;14455;39;34280
02;2021-03-28;1;0;1;24719;18248;49;42967
02;2021-03-28;1;1;2;34361;28310;59;62671
02;2021-03-28;1;1;2;28061;24495;69;52556
02;2021-03-28;1;1;2;18231;15278;79;33509
02;2021-03-28;1;0;1;11090;7677;89;18767
02;2021-03-28;0;0;0;3992;1506;90;5498
02;2021-03-28;6;3;9;194587;164162;0;358749
03;2021-03-28;0;0;0;31123;30920;09;62043
03;2021-03-28;0;0;0;29370;29268;19;58638
03;2021-03-28;0;0;0;21458;18963;29;40421
03;2021-03-28;1;0;1;21276;18326;39;39602
03;2021-03-28;1;0;1;18164;16593;49;34757
03;2021-03-28;0;0;0;13469;13557;59;27026
03;2021-03-28;2;0;2;8776;8670;69;17446
03;2021-03-28;0;0;0;3777;3591;79;7368
03;2021-03-28;0;0;0;1649;1072;89;2721
03;2021-03-28;0;0;0;485;184;90;669
03;2021-03-28;4;0;4;149547;141144;0;290691
04;2021-03-28;0;1;1;60314;61377;09;121691
04;2021-03-28;2;3;5;66065;68387;19;134452
04;2021-03-28;5;3;8;51059;47156;29;98215
04;2021-03-28;6;2;8;58788;45780;39;104568
04;2021-03-28;5;3;8;61408;52207;49;113615
04;2021-03-28;0;0;0;64838;60759;59;125597
04;2021-03-28;0;2;2;47008;42843;69;89851
04;2021-03-28;1;0;1;25509;21184;79;46693
04;2021-03-28;0;0;0;13168;7647;89;20815
04;2021-03-28;0;0;0;3209;1253;90;4462
04;2021-03-28;19;14;33;451366;408593;0;859959
05;2021-03-28;0;0;0;362.366008612902;341.338819562748;09;703.704828175651
05;2021-03-28;0;0;0;353.376145114279;370.349735405642;19;723.725880519921
05;2021-03-28;0;0;0;218.593559489256;256.539602589476;29;475.133162078732
05;2021-03-28;0;0;0;404.225408693299;360.321910454353;39;764.547319147651
05;2021-03-28;0;0;0;520.067953604221;497.108383964256;49;1017.17633756848
05;2021-03-28;0;0;0;468.146063921917;510.087601910415;59;978.233665832332
05;2021-03-28;0;0;0;340.368470050554;334.366842191253;69;674.735312241807
05;2021-03-28;0;0;0;212.598666888387;192.597753227106;79;405.196420115493
05;2021-03-28;0;0;0;148.727797095705;61.8681715431829;89;210.595968638888
05;2021-03-28;0;0;0;32.9601271090696;10.9909785719784;90;43.9511056810479
05;2021-03-28;0;0;0;3061.43020057959;2935.56979942041;0;5997
06;2021-03-28;0;0;0;42583;42380;09;84963
06;2021-03-28;0;1;1;33369;31925;19;65294
06;2021-03-28;0;0;0;21571;15080;29;36651
06;2021-03-28;0;0;0;21550;16147;39;37697
06;2021-03-28;2;0;2;14193;13939;49;28132
06;2021-03-28;1;0;1;7171;7597;59;14768
06;2021-03-28;0;1;1;3629;4117;69;7746
06;2021-03-28;0;0;0;1577;1457;79;3034
06;2021-03-28;0;0;0;531;474;89;1005
06;2021-03-28;0;0;0;88;93;90;181
06;2021-03-28;3;2;5;146262;133209;0;279471
07;2021-03-28;0;0;0;485;549;09;1034
07;2021-03-28;0;0;0;403;432;19;835
07;2021-03-28;0;0;0;764;841;29;1605
07;2021-03-28;0;0;0;824;928;39;1752
07;2021-03-28;0;0;0;788;1020;49;1808
07;2021-03-28;0;0;0;678;870;59;1548
07;2021-03-28;0;0;0;360;382;69;742
07;2021-03-28;0;0;0;231;190;79;421
07;2021-03-28;0;0;0;114;67;89;181
07;2021-03-28;0;0;0;24;11;90;35
07;2021-03-28;0;0;0;4671;5290;0;9961
08;2021-03-28;0;0;0;2715.22592983026;2997.75551488675;09;5712.98144471701
08;2021-03-28;0;1;1;2778.51901080978;3160.9156459093;19;5939.43465671908
08;2021-03-28;1;0;1;2080.8882988764;1718.16634315323;29;3799.05464202964
08;2021-03-28;0;0;0;2701.8582062647;1896.52641413317;39;4598.38462039786
08;2021-03-28;0;0;0;3151.45861023308;2460.52498233809;49;5611.98359257117
08;2021-03-28;0;0;0;2620.29868333099;2422.23566154656;59;5042.53434487755
08;2021-03-28;0;0;0;1621.44173420671;1438.58325779464;69;3060.02499200135
08;2021-03-28;0;0;0;626.575909335673;526.358467843651;79;1152.93437717932
08;2021-03-28;0;0;0;205.018522985054;140.993639349697;89;346.012162334751
08;2021-03-28;0;0;0;50.0325684687745;20.62259870351;90;70.6551671722846
08;2021-03-28;1;1;2;18551.3174743414;16782.6825256586;0;35334
11;2021-03-28;70;67;142;783071;811785;09;1594856
11;2021-03-28;134;127;264;761456;784653;19;1546109
11;2021-03-28;160;138;299;850145;801772;29;1651917
11;2021-03-28;225;158;383;914360;843488;39;1757848
11;2021-03-28;156;165;322;845609;826202;49;1671811
11;2021-03-28;118;122;240;793566;745070;59;1538636
11;2021-03-28;90;63;154;628649;549192;69;1177841
11;2021-03-28;51;34;85;434606;358356;79;792962
11;2021-03-28;37;34;71;261425;162933;89;424358
11;2021-03-28;18;4;22;89253;32619;90;121872
11;2021-03-28;1059;913;1983;6362140;5916070;0;12278210
24;2021-03-28;2;5;7;139720;144686;09;284406
24;2021-03-28;11;7;18;152979;161185;19;314164
24;2021-03-28;12;10;22;122237;126536;29;248773
24;2021-03-28;12;13;25;150359;142009;39;292368
24;2021-03-28;12;9;21;161829;158758;49;320587
24;2021-03-28;7;9;16;172552;168011;59;340563
24;2021-03-28;5;2;7;172509;158177;69;330686
24;2021-03-28;5;10;15;129428;110593;79;240021
24;2021-03-28;3;5;8;87342;56882;89;144224
24;2021-03-28;0;1;1;31210;12071;90;43281
24;2021-03-28;69;71;140;1320165;1238908;0;2559073
27;2021-03-28;1;1;2;143373;149679;09;293052
27;2021-03-28;6;6;12;160962;173003;19;333965
27;2021-03-28;12;4;16;133746;142254;29;276000
27;2021-03-28;12;6;18;160004;155407;39;315411
27;2021-03-28;17;10;27;172333;169564;49;341897
27;2021-03-28;13;9;22;189979;183788;59;373767
27;2021-03-28;8;12;20;192591;178206;69;370797
27;2021-03-28;6;7;13;146876;127546;79;274422
27;2021-03-28;3;6;9;96896;61575;89;158471
27;2021-03-28;1;1;2;33148;12109;90;45257
27;2021-03-28;79;62;141;1429908;1353131;0;2783039
28;2021-03-28;7;6;13;180735;186856;09;367591
28;2021-03-28;18;13;31;200125;213621;19;413746
28;2021-03-28;18;16;34;168922;173007;29;341929
28;2021-03-28;14;20;34;196628;188487;39;385115
28;2021-03-28;9;15;24;205396;201699;49;407095
28;2021-03-28;15;22;37;222002;213866;59;435868
28;2021-03-28;7;6;13;224688;203758;69;428446
28;2021-03-28;6;12;18;163192;135543;79;298735
28;2021-03-28;6;4;10;109691;65377;89;175068
28;2021-03-28;1;6;7;37222;12685;90;49907
28;2021-03-28;102;120;222;1708601;1594899;0;3303500
32;2021-03-28;37;31;68;358062;373689;09;731751
32;2021-03-28;51;54;105;387045;406742;19;793787
32;2021-03-28;64;43;108;342304;348587;29;690891
32;2021-03-28;53;58;111;382485;369972;39;752457
32;2021-03-28;61;66;127;382510;376716;49;759226
32;2021-03-28;39;43;82;386937;376527;59;763464
32;2021-03-28;32;21;53;371211;330938;69;702149
32;2021-03-28;13;16;29;250542;201459;79;452001
32;2021-03-28;19;13;32;163399;89786;89;253185
32;2021-03-28;10;3;13;48384;15367;90;63751
32;2021-03-28;379;349;729;3072879;2889783;0;5962662
44;2021-03-28;6;11;17;291525;306839;09;598364
44;2021-03-28;16;17;33;320255;339504;19;659759
44;2021-03-28;16;13;29;302020;314428;29;616448
44;2021-03-28;24;26;50;342222;333292;39;675514
44;2021-03-28;27;23;50;349727;344491;49;694218
44;2021-03-28;13;15;28;381371;373239;59;754610
44;2021-03-28;15;12;27;367165;335850;69;703015
44;2021-03-28;11;9;20;250387;215436;79;465823
44;2021-03-28;14;10;24;170825;105192;89;276017
44;2021-03-28;3;3;6;51248;16731;90;67979
44;2021-03-28;145;139;284;2826745;2685002;0;5511747
52;2021-03-28;7;14;22;213594;223900;09;437494
52;2021-03-28;22;26;48;240818;255197;19;496015
52;2021-03-28;28;19;47;197010;200630;29;397640
52;2021-03-28;25;33;58;231204;224885;39;456089
52;2021-03-28;46;23;69;243874;243418;49;487292
52;2021-03-28;10;17;27;244100;239116;59;483216
52;2021-03-28;17;13;30;241796;221345;69;463141
52;2021-03-28;9;8;17;177805;149903;79;327708
52;2021-03-28;9;5;14;119561;75822;89;195383
52;2021-03-28;5;3;8;42559;15260;90;57819
52;2021-03-28;178;161;340;1952321;1849476;0;3801797
53;2021-03-28;4;4;8;173813;182358;09;356171
53;2021-03-28;8;11;19;202720;214740;19;417460
53;2021-03-28;15;7;22;163116;173196;29;336312
53;2021-03-28;11;7;18;190526;187674;39;378200
53;2021-03-28;15;12;27;212098;212015;49;424113
53;2021-03-28;8;8;16;223699;219176;59;442875
53;2021-03-28;4;5;9;227435;209274;69;436709
53;2021-03-28;6;2;8;169992;140910;79;310902
53;2021-03-28;2;0;2;118117;69883;89;188000
53;2021-03-28;0;1;1;37370;12267;90;49637
53;2021-03-28;73;57;130;1718886;1621493;0;3340379
75;2021-03-28;1;4;5;293104;305291;09;598395
75;2021-03-28;20;29;49;337141;357785;19;694926
75;2021-03-28;15;10;25;295024;300618;29;595642
75;2021-03-28;16;11;27;347871;331233;39;679104
75;2021-03-28;14;16;30;384742;372771;49;757513
75;2021-03-28;11;7;18;413361;390880;59;804241
75;2021-03-28;6;8;14;425623;384060;69;809683
75;2021-03-28;4;11;15;325086;276298;79;601384
75;2021-03-28;8;5;13;213986;139308;89;353294
75;2021-03-28;3;1;4;77600;28200;90;105800
75;2021-03-28;98;102;200;3113538;2886444;0;5999982
76;2021-03-28;7;14;21;305956;318589;09;624545
76;2021-03-28;19;15;35;338942;356969;19;695911
76;2021-03-28;24;16;40;316210;319570;29;635780
76;2021-03-28;18;18;36;356758;337587;39;694345
76;2021-03-28;21;22;44;376541;363812;49;740353
76;2021-03-28;17;15;32;402608;383750;59;786358
76;2021-03-28;14;11;25;394889;358997;69;753886
76;2021-03-28;12;9;21;308664;263806;79;572470
76;2021-03-28;12;5;17;195838;129272;89;325110
76;2021-03-28;2;0;2;69372;26728;90;96100
76;2021-03-28;147;125;274;3065778;2859080;0;5924858
84;2021-03-28;15;24;39;459549;481088;09;940637
84;2021-03-28;36;38;74;487711;511905;19;999616
84;2021-03-28;47;25;72;443824;451094;29;894918
84;2021-03-28;43;30;73;512522;493262;39;1005784
84;2021-03-28;37;45;83;520248;515106;49;1035354
84;2021-03-28;36;39;75;529611;514848;59;1044459
84;2021-03-28;27;21;48;486720;439940;69;926660
84;2021-03-28;25;24;49;372151;315211;79;687362
84;2021-03-28;18;20;38;237198;150524;89;387722
84;2021-03-28;6;4;10;81185;28680;90;109865
84;2021-03-28;290;270;561;4130719;3901658;0;8032377
93;2021-03-28;16;14;30;268834;283093;09;551927
93;2021-03-28;24;33;57;280751;296087;19;576838
93;2021-03-28;42;37;79;254404;255552;29;509956
93;2021-03-28;44;40;84;310704;288398;39;599102
93;2021-03-28;49;49;98;325559;305827;49;631386
93;2021-03-28;29;33;63;353104;325389;59;678493
93;2021-03-28;22;34;56;336327;296459;69;632786
93;2021-03-28;21;12;33;279820;229699;79;509519
93;2021-03-28;17;10;27;171274;113716;89;284990
93;2021-03-28;9;1;10;58896;21758;90;80654
93;2021-03-28;273;264;545;2639673;2415978;0;5055651
94;2021-03-28;0;0;0;16311;17433;09;33744
94;2021-03-28;1;1;2;16679;18132;19;34811
94;2021-03-28;0;0;0;16782;16579;29;33361
94;2021-03-28;0;1;1;23044;20580;39;43624
94;2021-03-28;1;0;1;23065;22140;49;45205
94;2021-03-28;0;1;1;24549;23421;59;47970
94;2021-03-28;1;0;1;23212;21883;69;45095
94;2021-03-28;0;1;1;19544;17141;79;36685
94;2021-03-28;0;1;1;11227;8178;89;19405
94;2021-03-28;0;0;0;3332;1447;90;4779
94;2021-03-28;3;5;8;177745;166934;0;344679
01;2021-03-29;0;1;1;19979;20155;09;40134
01;2021-03-29;1;2;3;24994;25489;19;50483
01;2021-03-29;5;3;8;17868;16690;29;34558
01;2021-03-29;7;4;11;22328;14821;39;37149
01;2021-03-29;7;3;10;28652;20276;49;48928
01;2021-03-29;10;11;21;33264;27260;59;60524
01;2021-03-29;9;6;15;27135;23978;69;51113
01;2021-03-29;1;2;3;18401;14661;79;33062
01;2021-03-29;2;1;3;9633;6375;89;16008
01;2021-03-29;1;0;1;3410;1510;90;4920
01;2021-03-29;43;33;76;205664;171215;0;376879
02;2021-03-29;3;1;4;16881;17110;09;33991
02;2021-03-29;15;7;22;21410;21604;19;43014
02;2021-03-29;7;10;17;16017;15479;29;31496
02;2021-03-29;15;9;24;19825;14455;39;34280
02;2021-03-29;25;14;39;24719;18248;49;42967
02;2021-03-29;15;14;29;34361;28310;59;62671
02;2021-03-29;8;7;15;28061;24495;69;52556
02;2021-03-29;4;9;13;18231;15278;79;33509
02;2021-03-29;1;0;1;11090;7677;89;18767
02;2021-03-29;0;0;0;3992;1506;90;5498
02;2021-03-29;93;71;164;194587;164162;0;358749
03;2021-03-29;0;0;0;31123;30920;09;62043
03;2021-03-29;2;1;3;29370;29268;19;58638
03;2021-03-29;3;2;5;21458;18963;29;40421
03;2021-03-29;3;5;8;21276;18326;39;39602
03;2021-03-29;6;2;8;18164;16593;49;34757
03;2021-03-29;10;6;16;13469;13557;59;27026
03;2021-03-29;3;3;6;8776;8670;69;17446
03;2021-03-29;3;1;4;3777;3591;79;7368
03;2021-03-29;3;0;3;1649;1072;89;2721
03;2021-03-29;0;0;0;485;184;90;669
03;2021-03-29;33;20;53;149547;141144;0;290691
04;2021-03-29;10;11;21;60314;61377;09;121691
04;2021-03-29;16;14;30;66065;68387;19;134452
04;2021-03-29;13;15;28;51059;47156;29;98215
04;2021-03-29;21;19;40;58788;45780;39;104568
04;2021-03-29;8;20;28;61408;52207;49;113615
04;2021-03-29;16;11;27;64838;60759;59;125597
04;2021-03-29;11;9;20;47008;42843;69;89851
04;2021-03-29;5;7;12;25509;21184;79;46693
04;2021-03-29;0;2;2;13168;7647;89;20815
04;2021-03-29;2;0;2;3209;1253;90;4462
04;2021-03-29;102;108;210;451366;408593;0;859959
05;2021-03-29;0;0;0;362.366008612902;341.338819562748;09;703.704828175651
05;2021-03-29;0;0;0;353.376145114279;370.349735405642;19;723.725880519921
05;2021-03-29;0;0;0;218.593559489256;256.539602589476;29;475.133162078732
05;2021-03-29;0;0;0;404.225408693299;360.321910454353;39;764.547319147651
05;2021-03-29;0;0;0;520.067953604221;497.108383964256;49;1017.17633756848
05;2021-03-29;0;0;0;468.146063921917;510.087601910415;59;978.233665832332
05;2021-03-29;0;0;0;340.368470050554;334.366842191253;69;674.735312241807
05;2021-03-29;0;0;0;212.598666888387;192.597753227106;79;405.196420115493
05;2021-03-29;0;0;0;148.727797095705;61.8681715431829;89;210.595968638888
05;2021-03-29;0;0;0;32.9601271090696;10.9909785719784;90;43.9511056810479
05;2021-03-29;0;0;0;3061.43020057959;2935.56979942041;0;5997
06;2021-03-29;4;0;4;42583;42380;09;84963
06;2021-03-29;6;4;10;33369;31925;19;65294
06;2021-03-29;5;2;7;21571;15080;29;36651
06;2021-03-29;5;1;6;21550;16147;39;37697
06;2021-03-29;5;2;7;14193;13939;49;28132
06;2021-03-29;1;1;2;7171;7597;59;14768
06;2021-03-29;3;2;5;3629;4117;69;7746
06;2021-03-29;1;0;1;1577;1457;79;3034
06;2021-03-29;0;0;0;531;474;89;1005
06;2021-03-29;0;0;0;88;93;90;181
06;2021-03-29;30;12;42;146262;133209;0;279471
07;2021-03-29;0;0;0;485;549;09;1034
07;2021-03-29;0;0;0;403;432;19;835
07;2021-03-29;1;0;1;764;841;29;1605
07;2021-03-29;1;1;2;824;928;39;1752
07;2021-03-29;1;1;2;788;1020;49;1808
07;2021-03-29;0;2;2;678;870;59;1548
07;2021-03-29;0;0;0;360;382;69;742
07;2021-03-29;0;0;0;231;190;79;421
07;2021-03-29;0;0;0;114;67;89;181
07;2021-03-29;0;0;0;24;11;90;35
07;2021-03-29;3;4;7;4671;5290;0;9961
08;2021-03-29;0;0;0;2715.22592983026;2997.75551488675;09;5712.98144471701
08;2021-03-29;0;1;1;2778.51901080978;3160.9156459093;19;5939.43465671908
08;2021-03-29;1;0;1;2080.8882988764;1718.16634315323;29;3799.05464202964
08;2021-03-29;1;0;1;2701.8582062647;1896.52641413317;39;4598.38462039786
08;2021-03-29;2;0;2;3151.45861023308;2460.52498233809;49;5611.98359257117
08;2021-03-29;0;2;2;2620.29868333099;2422.23566154656;59;5042.53434487755
08;2021-03-29;0;0;0;1621.44173420671;1438.58325779464;69;3060.02499200135
08;2021-03-29;0;0;0;626.575909335673;526.358467843651;79;1152.93437717932
08;2021-03-29;0;0;0;205.018522985054;140.993639349697;89;346.012162334751
08;2021-03-29;0;0;0;50.0325684687745;20.62259870351;90;70.6551671722846
08;2021-03-29;4;3;7;18551.3174743414;16782.6825256586;0;35334
11;2021-03-29;550;587;1189;783071;811785;09;1594856
11;2021-03-29;1518;1517;3157;761456;784653;19;1546109
11;2021-03-29;1488;1285;2785;850145;801772;29;1651917
11;2021-03-29;1752;1532;3292;914360;843488;39;1757848
11;2021-03-29;1628;1492;3139;845609;826202;49;1671811
11;2021-03-29;1190;1113;2314;793566;745070;59;1538636
11;2021-03-29;700;696;1442;628649;549192;69;1177841
11;2021-03-29;271;265;538;434606;358356;79;792962
11;2021-03-29;168;111;280;261425;162933;89;424358
11;2021-03-29;82;29;111;89253;32619;90;121872
11;2021-03-29;9349;8634;18257;6362140;5916070;0;12278210
24;2021-03-29;40;56;99;139720;144686;09;284406
24;2021-03-29;118;142;265;152979;161185;19;314164
24;2021-03-29;147;116;263;122237;126536;29;248773
24;2021-03-29;144;140;286;150359;142009;39;292368
24;2021-03-29;152;135;287;161829;158758;49;320587
24;2021-03-29;123;127;250;172552;168011;59;340563
24;2021-03-29;68;75;143;172509;158177;69;330686
24;2021-03-29;57;46;103;129428;110593;79;240021
24;2021-03-29;18;12;30;87342;56882;89;144224
24;2021-03-29;8;5;13;31210;12071;90;43281
24;2021-03-29;875;854;1740;1320165;1238908;0;2559073
27;2021-03-29;60;78;140;143373;149679;09;293052
27;2021-03-29;134;129;263;160962;173003;19;333965
27;2021-03-29;128;128;256;133746;142254;29;276000
27;2021-03-29;168;133;301;160004;155407;39;315411
27;2021-03-29;168;152;320;172333;169564;49;341897
27;2021-03-29;126;126;252;189979;183788;59;373767
27;2021-03-29;105;96;201;192591;178206;69;370797
27;2021-03-29;66;58;124;146876;127546;79;274422
27;2021-03-29;44;20;64;96896;61575;89;158471
27;2021-03-29;9;10;19;33148;12109;90;45257
27;2021-03-29;1008;930;1940;1429908;1353131;0;2783039
28;2021-03-29;83;83;169;180735;186856;09;367591
28;2021-03-29;207;195;409;200125;213621;19;413746
28;2021-03-29;164;179;343;168922;173007;29;341929
28;2021-03-29;177;165;342;196628;188487;39;385115
28;2021-03-29;197;177;374;205396;201699;49;407095
28;2021-03-29;159;173;332;222002;213866;59;435868
28;2021-03-29;122;127;249;224688;203758;69;428446
28;2021-03-29;87;54;141;163192;135543;79;298735
28;2021-03-29;53;23;76;109691;65377;89;175068
28;2021-03-29;23;12;35;37222;12685;90;49907
28;2021-03-29;1272;1189;2471;1708601;1594899;0;3303500
32;2021-03-29;240;214;457;358062;373689;09;731751
32;2021-03-29;491;568;1060;387045;406742;19;793787
32;2021-03-29;489;460;952;342304;348587;29;690891
32;2021-03-29;575;516;1092;382485;369972;39;752457
32;2021-03-29;552;504;1056;382510;376716;49;759226
32;2021-03-29;505;481;986;386937;376527;59;763464
32;2021-03-29;303;254;557;371211;330938;69;702149
32;2021-03-29;156;147;303;250542;201459;79;452001
32;2021-03-29;103;64;167;163399;89786;89;253185
32;2021-03-29;42;20;62;48384;15367;90;63751
32;2021-03-29;3457;3228;6693;3072879;2889783;0;5962662
44;2021-03-29;125;137;265;291525;306839;09;598364
44;2021-03-29;354;303;663;320255;339504;19;659759
44;2021-03-29;285;301;589;302020;314428;29;616448
44;2021-03-29;357;316;676;342222;333292;39;675514
44;2021-03-29;324;311;636;349727;344491;49;694218
44;2021-03-29;287;273;562;381371;373239;59;754610
44;2021-03-29;213;194;411;367165;335850;69;703015
44;2021-03-29;116;102;218;250387;215436;79;465823
44;2021-03-29;73;41;116;170825;105192;89;276017
44;2021-03-29;27;8;35;51248;16731;90;67979
44;2021-03-29;2161;1986;4171;2826745;2685002;0;5511747
52;2021-03-29;70;64;136;213594;223900;09;437494
52;2021-03-29;187;224;412;240818;255197;19;496015
52;2021-03-29;198;165;363;197010;200630;29;397640
52;2021-03-29;159;149;308;231204;224885;39;456089
52;2021-03-29;185;152;337;243874;243418;49;487292
52;2021-03-29;139;155;294;244100;239116;59;483216
52;2021-03-29;88;98;186;241796;221345;69;463141
52;2021-03-29;75;69;144;177805;149903;79;327708
52;2021-03-29;39;25;64;119561;75822;89;195383
52;2021-03-29;19;6;25;42559;15260;90;57819
52;2021-03-29;1160;1108;2271;1952321;1849476;0;3801797
53;2021-03-29;50;65;116;173813;182358;09;356171
53;2021-03-29;132;135;269;202720;214740;19;417460
53;2021-03-29;101;106;208;163116;173196;29;336312
53;2021-03-29;94;100;194;190526;187674;39;378200
53;2021-03-29;102;106;208;212098;212015;49;424113
53;2021-03-29;98;96;194;223699;219176;59;442875
53;2021-03-29;56;66;122;227435;209274;69;436709
53;2021-03-29;35;29;64;169992;140910;79;310902
53;2021-03-29;15;17;32;118117;69883;89;188000
53;2021-03-29;3;4;7;37370;12267;90;49637
53;2021-03-29;686;724;1415;1718886;1621493;0;3340379
75;2021-03-29;76;81;158;293104;305291;09;598395
75;2021-03-29;243;265;510;337141;357785;19;694926
75;2021-03-29;231;211;442;295024;300618;29;595642
75;2021-03-29;215;170;385;347871;331233;39;679104
75;2021-03-29;258;212;470;384742;372771;49;757513
75;2021-03-29;173;193;366;413361;390880;59;804241
75;2021-03-29;134;128;262;425623;384060;69;809683
75;2021-03-29;69;70;140;325086;276298;79;601384
75;2021-03-29;34;23;57;213986;139308;89;353294
75;2021-03-29;37;14;51;77600;28200;90;105800
75;2021-03-29;1471;1367;2842;3113538;2886444;0;5999982
76;2021-03-29;99;100;205;305956;318589;09;624545
76;2021-03-29;310;343;665;338942;356969;19;695911
76;2021-03-29;305;273;578;316210;319570;29;635780
76;2021-03-29;332;287;621;356758;337587;39;694345
76;2021-03-29;368;323;691;376541;363812;49;740353
76;2021-03-29;288;304;593;402608;383750;59;786358
76;2021-03-29;185;174;359;394889;358997;69;753886
76;2021-03-29;103;89;192;308664;263806;79;572470
76;2021-03-29;77;45;122;195838;129272;89;325110
76;2021-03-29;48;24;72;69372;26728;90;96100
76;2021-03-29;2116;1962;4099;3065778;2859080;0;5924858
84;2021-03-29;201;181;385;459549;481088;09;940637
84;2021-03-29;539;606;1147;487711;511905;19;999616
84;2021-03-29;538;534;1072;443824;451094;29;894918
84;2021-03-29;574;462;1036;512522;493262;39;1005784
84;2021-03-29;635;540;1176;520248;515106;49;1035354
84;2021-03-29;493;498;992;529611;514848;59;1044459
84;2021-03-29;306;279;585;486720;439940;69;926660
84;2021-03-29;206;175;381;372151;315211;79;687362
84;2021-03-29;85;84;169;237198;150524;89;387722
84;2021-03-29;40;16;56;81185;28680;90;109865
84;2021-03-29;3618;3376;7001;4130719;3901658;0;8032377
93;2021-03-29;115;165;280;268834;283093;09;551927
93;2021-03-29;444;476;926;280751;296087;19;576838
93;2021-03-29;460;397;859;254404;255552;29;509956
93;2021-03-29;482;407;890;310704;288398;39;599102
93;2021-03-29;507;455;964;325559;305827;49;631386
93;2021-03-29;472;421;894;353104;325389;59;678493
93;2021-03-29;282;274;558;336327;296459;69;632786
93;2021-03-29;147;151;298;279820;229699;79;509519
93;2021-03-29;92;55;147;171274;113716;89;284990
93;2021-03-29;30;13;43;58896;21758;90;80654
93;2021-03-29;3031;2816;5865;2639673;2415978;0;5055651
94;2021-03-29;5;3;8;16311;17433;09;33744
94;2021-03-29;7;8;15;16679;18132;19;34811
94;2021-03-29;6;12;18;16782;16579;29;33361
94;2021-03-29;9;7;16;23044;20580;39;43624
94;2021-03-29;10;19;29;23065;22140;49;45205
94;2021-03-29;5;9;14;24549;23421;59;47970
94;2021-03-29;7;9;16;23212;21883;69;45095
94;2021-03-29;3;1;4;19544;17141;79;36685
94;2021-03-29;0;2;2;11227;8178;89;19405
94;2021-03-29;0;0;0;3332;1447;90;4779
94;2021-03-29;52;70;122;177745;166934;0;344679
01;2021-03-30;0;0;0;19979;20155;09;40134
01;2021-03-30;1;1;2;24994;25489;19;50483
01;2021-03-30;8;7;15;17868;16690;29;34558
01;2021-03-30;13;4;17;22328;14821;39;37149
01;2021-03-30;12;11;23;28652;20276;49;48928
01;2021-03-30;9;8;17;33264;27260;59;60524
01;2021-03-30;4;8;12;27135;23978;69;51113
01;2021-03-30;4;4;8;18401;14661;79;33062
01;2021-03-30;1;0;1;9633;6375;89;16008
01;2021-03-30;0;0;0;3410;1510;90;4920
01;2021-03-30;52;43;95;205664;171215;0;376879
02;2021-03-30;1;1;2;16881;17110;09;33991
02;2021-03-30;6;3;9;21410;21604;19;43014
02;2021-03-30;12;8;20;16017;15479;29;31496
02;2021-03-30;8;11;19;19825;14455;39;34280
02;2021-03-30;8;10;18;24719;18248;49;42967
02;2021-03-30;17;8;25;34361;28310;59;62671
02;2021-03-30;15;14;29;28061;24495;69;52556
02;2021-03-30;4;7;11;18231;15278;79;33509
02;2021-03-30;1;3;4;11090;7677;89;18767
02;2021-03-30;0;1;1;3992;1506;90;5498
02;2021-03-30;72;66;138;194587;164162;0;358749
03;2021-03-30;0;1;1;31123;30920;09;62043
03;2021-03-30;1;1;2;29370;29268;19;58638
03;2021-03-30;3;0;3;21458;18963;29;40421
03;2021-03-30;4;4;8;21276;18326;39;39602
03;2021-03-30;3;5;8;18164;16593;49;34757
03;2021-03-30;2;5;7;13469;13557;59;27026
03;2021-03-30;0;2;2;8776;8670;69;17446
03;2021-03-30;0;0;0;3777;3591;79;7368
03;2021-03-30;0;0;0;1649;1072;89;2721
03;2021-03-30;0;0;0;485;184;90;669
03;2021-03-30;13;18;31;149547;141144;0;290691
04;2021-03-30;6;5;11;60314;61377;09;121691
04;2021-03-30;11;13;24;66065;68387;19;134452
04;2021-03-30;10;11;21;51059;47156;29;98215
04;2021-03-30;11;10;21;58788;45780;39;104568
04;2021-03-30;11;6;17;61408;52207;49;113615
04;2021-03-30;16;10;26;64838;60759;59;125597
04;2021-03-30;10;7;17;47008;42843;69;89851
04;2021-03-30;3;4;7;25509;21184;79;46693
04;2021-03-30;2;1;3;13168;7647;89;20815
04;2021-03-30;0;0;0;3209;1253;90;4462
04;2021-03-30;80;67;147;451366;408593;0;859959
05;2021-03-30;0;0;0;362.366008612902;341.338819562748;09;703.704828175651
05;2021-03-30;0;0;0;353.376145114279;370.349735405642;19;723.725880519921
05;2021-03-30;0;0;0;218.593559489256;256.539602589476;29;475.133162078732
05;2021-03-30;0;0;0;404.225408693299;360.321910454353;39;764.547319147651
05;2021-03-30;0;0;0;520.067953604221;497.108383964256;49;1017.17633756848
05;2021-03-30;0;0;0;468.146063921917;510.087601910415;59;978.233665832332
05;2021-03-30;0;0;0;340.368470050554;334.366842191253;69;674.735312241807
05;2021-03-30;0;0;0;212.598666888387;192.597753227106;79;405.196420115493
05;2021-03-30;0;0;0;148.727797095705;61.8681715431829;89;210.595968638888
05;2021-03-30;0;0;0;32.9601271090696;10.9909785719784;90;43.9511056810479
05;2021-03-30;0;0;0;3061.43020057959;2935.56979942041;0;5997
06;2021-03-30;1;0;1;42583;42380;09;84963
06;2021-03-30;5;0;5;33369;31925;19;65294
06;2021-03-30;1;2;3;21571;15080;29;36651
06;2021-03-30;4;2;6;21550;16147;39;37697
06;2021-03-30;2;1;3;14193;13939;49;28132
06;2021-03-30;2;0;2;7171;7597;59;14768
06;2021-03-30;1;1;2;3629;4117;69;7746
06;2021-03-30;0;0;0;1577;1457;79;3034
06;2021-03-30;0;0;0;531;474;89;1005
06;2021-03-30;0;0;0;88;93;90;181
06;2021-03-30;16;6;22;146262;133209;0;279471
07;2021-03-30;0;0;0;485;549;09;1034
07;2021-03-30;0;0;0;403;432;19;835
07;2021-03-30;0;0;0;764;841;29;1605
07;2021-03-30;1;0;1;824;928;39;1752
07;2021-03-30;0;1;1;788;1020;49;1808
07;2021-03-30;1;0;1;678;870;59;1548
07;2021-03-30;0;1;1;360;382;69;742
07;2021-03-30;1;0;1;231;190;79;421
07;2021-03-30;0;0;0;114;67;89;181
07;2021-03-30;0;0;0;24;11;90;35
07;2021-03-30;3;2;5;4671;5290;0;9961
08;2021-03-30;0;0;0;2715.22592983026;2997.75551488675;09;5712.98144471701
08;2021-03-30;0;0;0;2778.51901080978;3160.9156459093;19;5939.43465671908
08;2021-03-30;1;0;1;2080.8882988764;1718.16634315323;29;3799.05464202964
08;2021-03-30;0;0;0;2701.8582062647;1896.52641413317;39;4598.38462039786
08;2021-03-30;1;0;1;3151.45861023308;2460.52498233809;49;5611.98359257117
08;2021-03-30;0;0;0;2620.29868333099;2422.23566154656;59;5042.53434487755
08;2021-03-30;1;0;1;1621.44173420671;1438.58325779464;69;3060.02499200135
08;2021-03-30;0;0;0;626.575909335673;526.358467843651;79;1152.93437717932
08;2021-03-30;0;0;0;205.018522985054;140.993639349697;89;346.012162334751
08;2021-03-30;0;0;0;50.0325684687745;20.62259870351;90;70.6551671722846
08;2021-03-30;3;0;3;18551.3174743414;16782.6825256586;0;35334
11;2021-03-30;519;536;1117;783071;811785;09;1594856
11;2021-03-30;1276;1373;2750;761456;784653;19;1546109
11;2021-03-30;1362;1229;2593;850145;801772;29;1651917
11;2021-03-30;1486;1276;2766;914360;843488;39;1757848
11;2021-03-30;1315;1286;2604;845609;826202;49;1671811
11;2021-03-30;921;966;1894;793566;745070;59;1538636
11;2021-03-30;565;536;1117;628649;549192;69;1177841
11;2021-03-30;218;211;433;434606;358356;79;792962
11;2021-03-30;123;99;222;261425;162933;89;424358
11;2021-03-30;62;37;99;89253;32619;90;121872
11;2021-03-30;7848;7550;15602;6362140;5916070;0;12278210
24;2021-03-30;34;40;77;139720;144686;09;284406
24;2021-03-30;124;138;264;152979;161185;19;314164
24;2021-03-30;119;99;218;122237;126536;29;248773
24;2021-03-30;139;119;259;150359;142009;39;292368
24;2021-03-30;97;123;220;161829;158758;49;320587
24;2021-03-30;112;117;229;172552;168011;59;340563
24;2021-03-30;62;72;135;172509;158177;69;330686
24;2021-03-30;45;48;93;129428;110593;79;240021
24;2021-03-30;26;11;37;87342;56882;89;144224
24;2021-03-30;9;8;17;31210;12071;90;43281
24;2021-03-30;767;775;1549;1320165;1238908;0;2559073
27;2021-03-30;41;44;86;143373;149679;09;293052
27;2021-03-30;142;130;274;160962;173003;19;333965
27;2021-03-30;138;124;262;133746;142254;29;276000
27;2021-03-30;136;103;239;160004;155407;39;315411
27;2021-03-30;146;123;269;172333;169564;49;341897
27;2021-03-30;103;99;202;189979;183788;59;373767
27;2021-03-30;81;86;167;192591;178206;69;370797
27;2021-03-30;58;43;101;146876;127546;79;274422
27;2021-03-30;39;22;61;96896;61575;89;158471
27;2021-03-30;15;7;22;33148;12109;90;45257
27;2021-03-30;899;782;1684;1429908;1353131;0;2783039
28;2021-03-30;51;60;117;180735;186856;09;367591
28;2021-03-30;174;218;399;200125;213621;19;413746
28;2021-03-30;190;154;344;168922;173007;29;341929
28;2021-03-30;137;116;254;196628;188487;39;385115
28;2021-03-30;162;166;328;205396;201699;49;407095
28;2021-03-30;148;130;278;222002;213866;59;435868
28;2021-03-30;90;101;191;224688;203758;69;428446
28;2021-03-30;67;64;131;163192;135543;79;298735
28;2021-03-30;46;22;68;109691;65377;89;175068
28;2021-03-30;24;11;35;37222;12685;90;49907
28;2021-03-30;1089;1042;2145;1708601;1594899;0;3303500
32;2021-03-30;219;213;434;358062;373689;09;731751
32;2021-03-30;459;515;974;387045;406742;19;793787
32;2021-03-30;439;334;774;342304;348587;29;690891
32;2021-03-30;420;352;772;382485;369972;39;752457
32;2021-03-30;402;375;777;382510;376716;49;759226
32;2021-03-30;349;334;684;386937;376527;59;763464
32;2021-03-30;249;204;454;371211;330938;69;702149
32;2021-03-30;111;106;217;250542;201459;79;452001
32;2021-03-30;88;64;152;163399;89786;89;253185
32;2021-03-30;36;19;55;48384;15367;90;63751
32;2021-03-30;2772;2516;5293;3072879;2889783;0;5962662
44;2021-03-30;145;121;269;291525;306839;09;598364
44;2021-03-30;255;320;579;320255;339504;19;659759
44;2021-03-30;238;215;453;302020;314428;29;616448
44;2021-03-30;269;226;497;342222;333292;39;675514
44;2021-03-30;243;242;489;349727;344491;49;694218
44;2021-03-30;178;212;392;381371;373239;59;754610
44;2021-03-30;150;119;269;367165;335850;69;703015
44;2021-03-30;90;102;195;250387;215436;79;465823
44;2021-03-30;54;30;85;170825;105192;89;276017
44;2021-03-30;26;14;40;51248;16731;90;67979
44;2021-03-30;1649;1601;3269;2826745;2685002;0;5511747
52;2021-03-30;80;66;147;213594;223900;09;437494
52;2021-03-30;199;197;397;240818;255197;19;496015
52;2021-03-30;150;169;319;197010;200630;29;397640
52;2021-03-30;148;144;292;231204;224885;39;456089
52;2021-03-30;151;139;290;243874;243418;49;487292
52;2021-03-30;109;110;219;244100;239116;59;483216
52;2021-03-30;79;84;163;241796;221345;69;463141
52;2021-03-30;43;41;84;177805;149903;79;327708
52;2021-03-30;21;19;40;119561;75822;89;195383
52;2021-03-30;8;7;15;42559;15260;90;57819
52;2021-03-30;988;976;1966;1952321;1849476;0;3801797
53;2021-03-30;52;32;85;173813;182358;09;356171
53;2021-03-30;104;113;218;202720;214740;19;417460
53;2021-03-30;94;94;190;163116;173196;29;336312
53;2021-03-30;92;72;165;190526;187674;39;378200
53;2021-03-30;93;87;180;212098;212015;49;424113
53;2021-03-30;72;77;149;223699;219176;59;442875
53;2021-03-30;31;48;79;227435;209274;69;436709
53;2021-03-30;46;31;77;169992;140910;79;310902
53;2021-03-30;14;9;23;118117;69883;89;188000
53;2021-03-30;9;1;10;37370;12267;90;49637
53;2021-03-30;607;564;1176;1718886;1621493;0;3340379
75;2021-03-30;71;77;150;293104;305291;09;598395
75;2021-03-30;239;231;471;337141;357785;19;694926
75;2021-03-30;191;182;373;295024;300618;29;595642
75;2021-03-30;178;163;341;347871;331233;39;679104
75;2021-03-30;181;171;352;384742;372771;49;757513
75;2021-03-30;145;164;309;413361;390880;59;804241
75;2021-03-30;112;89;201;425623;384060;69;809683
75;2021-03-30;52;55;107;325086;276298;79;601384
75;2021-03-30;32;18;50;213986;139308;89;353294
75;2021-03-30;14;5;19;77600;28200;90;105800
75;2021-03-30;1215;1156;2374;3113538;2886444;0;5999982
76;2021-03-30;88;99;190;305956;318589;09;624545
76;2021-03-30;264;278;547;338942;356969;19;695911
76;2021-03-30;246;246;493;316210;319570;29;635780
76;2021-03-30;293;210;503;356758;337587;39;694345
76;2021-03-30;331;263;594;376541;363812;49;740353
76;2021-03-30;238;218;456;402608;383750;59;786358
76;2021-03-30;164;130;295;394889;358997;69;753886
76;2021-03-30;98;83;181;308664;263806;79;572470
76;2021-03-30;60;31;91;195838;129272;89;325110
76;2021-03-30;21;15;36;69372;26728;90;96100
76;2021-03-30;1803;1575;3388;3065778;2859080;0;5924858
84;2021-03-30;164;177;342;459549;481088;09;940637
84;2021-03-30;476;555;1032;487711;511905;19;999616
84;2021-03-30;441;421;862;443824;451094;29;894918
84;2021-03-30;462;375;839;512522;493262;39;1005784
84;2021-03-30;430;423;853;520248;515106;49;1035354
84;2021-03-30;395;369;764;529611;514848;59;1044459
84;2021-03-30;265;224;489;486720;439940;69;926660
84;2021-03-30;129;126;255;372151;315211;79;687362
84;2021-03-30;84;70;154;237198;150524;89;387722
84;2021-03-30;40;11;51;81185;28680;90;109865
84;2021-03-30;2886;2751;5641;4130719;3901658;0;8032377
93;2021-03-30;126;119;249;268834;283093;09;551927
93;2021-03-30;369;356;732;280751;296087;19;576838
93;2021-03-30;374;302;678;254404;255552;29;509956
93;2021-03-30;414;335;751;310704;288398;39;599102
93;2021-03-30;406;305;711;325559;305827;49;631386
93;2021-03-30;356;289;647;353104;325389;59;678493
93;2021-03-30;243;217;460;336327;296459;69;632786
93;2021-03-30;121;101;222;279820;229699;79;509519
93;2021-03-30;57;51;108;171274;113716;89;284990
93;2021-03-30;24;14;38;58896;21758;90;80654
93;2021-03-30;2490;2090;4598;2639673;2415978;0;5055651
94;2021-03-30;0;2;3;16311;17433;09;33744
94;2021-03-30;2;4;6;16679;18132;19;34811
94;2021-03-30;6;8;14;16782;16579;29;33361
94;2021-03-30;13;11;24;23044;20580;39;43624
94;2021-03-30;4;9;13;23065;22140;49;45205
94;2021-03-30;8;6;14;24549;23421;59;47970
94;2021-03-30;10;2;12;23212;21883;69;45095
94;2021-03-30;3;3;6;19544;17141;79;36685
94;2021-03-30;2;1;3;11227;8178;89;19405
94;2021-03-30;1;2;3;3332;1447;90;4779
94;2021-03-30;49;48;98;177745;166934;0;344679
01;2021-03-31;1;0;1;19979;20155;09;40134
01;2021-03-31;1;2;3;24994;25489;19;50483
01;2021-03-31;8;3;11;17868;16690;29;34558
01;2021-03-31;12;3;15;22328;14821;39;37149
01;2021-03-31;5;6;11;28652;20276;49;48928
01;2021-03-31;11;13;24;33264;27260;59;60524
01;2021-03-31;6;2;8;27135;23978;69;51113
01;2021-03-31;6;2;8;18401;14661;79;33062
01;2021-03-31;2;3;5;9633;6375;89;16008
01;2021-03-31;0;0;0;3410;1510;90;4920
01;2021-03-31;52;34;86;205664;171215;0;376879
02;2021-03-31;1;2;3;16881;17110;09;33991
02;2021-03-31;7;7;14;21410;21604;19;43014
02;2021-03-31;15;9;24;16017;15479;29;31496
02;2021-03-31;14;10;24;19825;14455;39;34280
02;2021-03-31;12;9;21;24719;18248;49;42967
02;2021-03-31;14;15;29;34361;28310;59;62671
02;2021-03-31;15;10;25;28061;24495;69;52556
02;2021-03-31;4;10;14;18231;15278;79;33509
02;2021-03-31;3;3;6;11090;7677;89;18767
02;2021-03-31;1;0;1;3992;1506;90;5498
02;2021-03-31;86;75;161;194587;164162;0;358749
03;2021-03-31;2;0;2;31123;30920;09;62043
03;2021-03-31;3;1;4;29370;29268;19;58638
03;2021-03-31;4;2;6;21458;18963;29;40421
03;2021-03-31;1;3;4;21276;18326;39;39602
03;2021-03-31;6;6;12;18164;16593;49;34757
03;2021-03-31;2;4;6;13469;13557;59;27026
03;2021-03-31;2;1;3;8776;8670;69;17446
03;2021-03-31;0;0;0;3777;3591;79;7368
03;2021-03-31;1;0;1;1649;1072;89;2721
03;2021-03-31;0;0;0;485;184;90;669
03;2021-03-31;21;17;38;149547;141144;0;290691
04;2021-03-31;8;8;16;60314;61377;09;121691
04;2021-03-31;11;9;20;66065;68387;19;134452
04;2021-03-31;14;12;26;51059;47156;29;98215
04;2021-03-31;11;14;25;58788;45780;39;104568
04;2021-03-31;13;13;26;61408;52207;49;113615
04;2021-03-31;15;9;24;64838;60759;59;125597
04;2021-03-31;8;5;13;47008;42843;69;89851
04;2021-03-31;5;4;9;25509;21184;79;46693
04;2021-03-31;1;1;2;13168;7647;89;20815
04;2021-03-31;0;0;0;3209;1253;90;4462
04;2021-03-31;86;75;161;451366;408593;0;859959
05;2021-03-31;0;0;0;362.366008612902;341.338819562748;09;703.704828175651
05;2021-03-31;0;0;0;353.376145114279;370.349735405642;19;723.725880519921
05;2021-03-31;0;0;0;218.593559489256;256.539602589476;29;475.133162078732
05;2021-03-31;0;0;0;404.225408693299;360.321910454353;39;764.547319147651
05;2021-03-31;0;0;0;520.067953604221;497.108383964256;49;1017.17633756848
05;2021-03-31;0;0;0;468.146063921917;510.087601910415;59;978.233665832332
05;2021-03-31;0;0;0;340.368470050554;334.366842191253;69;674.735312241807
05;2021-03-31;0;0;0;212.598666888387;192.597753227106;79;405.196420115493
05;2021-03-31;0;0;0;148.727797095705;61.8681715431829;89;210.595968638888
05;2021-03-31;0;0;0;32.9601271090696;10.9909785719784;90;43.9511056810479
05;2021-03-31;0;0;0;3061.43020057959;2935.56979942041;0;5997
06;2021-03-31;0;0;0;42583;42380;09;84963
06;2021-03-31;5;4;10;33369;31925;19;65294
06;2021-03-31;5;5;10;21571;15080;29;36651
06;2021-03-31;2;4;6;21550;16147;39;37697
06;2021-03-31;4;0;4;14193;13939;49;28132
06;2021-03-31;2;1;3;7171;7597;59;14768
06;2021-03-31;1;1;2;3629;4117;69;7746
06;2021-03-31;0;0;0;1577;1457;79;3034
06;2021-03-31;0;1;1;531;474;89;1005
06;2021-03-31;0;0;0;88;93;90;181
06;2021-03-31;19;16;36;146262;133209;0;279471
07;2021-03-31;0;0;0;485;549;09;1034
07;2021-03-31;0;0;0;403;432;19;835
07;2021-03-31;0;0;0;764;841;29;1605
07;2021-03-31;0;0;0;824;928;39;1752
07;2021-03-31;0;0;0;788;1020;49;1808
07;2021-03-31;0;0;0;678;870;59;1548
07;2021-03-31;0;0;0;360;382;69;742
07;2021-03-31;0;0;0;231;190;79;421
07;2021-03-31;0;0;0;114;67;89;181
07;2021-03-31;0;0;0;24;11;90;35
07;2021-03-31;0;0;0;4671;5290;0;9961
08;2021-03-31;0;0;0;2715.22592983026;2997.75551488675;09;5712.98144471701
08;2021-03-31;0;0;0;2778.51901080978;3160.9156459093;19;5939.43465671908
08;2021-03-31;0;0;0;2080.8882988764;1718.16634315323;29;3799.05464202964
08;2021-03-31;0;0;0;2701.8582062647;1896.52641413317;39;4598.38462039786
08;2021-03-31;0;0;0;3151.45861023308;2460.52498233809;49;5611.98359257117
08;2021-03-31;0;0;0;2620.29868333099;2422.23566154656;59;5042.53434487755
08;2021-03-31;0;1;1;1621.44173420671;1438.58325779464;69;3060.02499200135
08;2021-03-31;0;0;0;626.575909335673;526.358467843651;79;1152.93437717932
08;2021-03-31;0;0;0;205.018522985054;140.993639349697;89;346.012162334751
08;2021-03-31;0;0;0;50.0325684687745;20.62259870351;90;70.6551671722846
08;2021-03-31;0;1;1;18551.3174743414;16782.6825256586;0;35334
11;2021-03-31;416;438;897;783071;811785;09;1594856
11;2021-03-31;1188;1209;2479;761456;784653;19;1546109
11;2021-03-31;1227;1154;2392;850145;801772;29;1651917
11;2021-03-31;1311;1108;2423;914360;843488;39;1757848
11;2021-03-31;1196;1114;2324;845609;826202;49;1671811
11;2021-03-31;887;891;1781;793566;745070;59;1538636
11;2021-03-31;486;411;901;628649;549192;69;1177841
11;2021-03-31;211;210;422;434606;358356;79;792962
11;2021-03-31;136;95;231;261425;162933;89;424358
11;2021-03-31;56;21;77;89253;32619;90;121872
11;2021-03-31;7116;6656;13935;6362140;5916070;0;12278210
24;2021-03-31;25;47;73;139720;144686;09;284406
24;2021-03-31;111;118;236;152979;161185;19;314164
24;2021-03-31;123;111;234;122237;126536;29;248773
24;2021-03-31;135;109;244;150359;142009;39;292368
24;2021-03-31;90;100;190;161829;158758;49;320587
24;2021-03-31;96;79;175;172552;168011;59;340563
24;2021-03-31;50;59;109;172509;158177;69;330686
24;2021-03-31;47;41;88;129428;110593;79;240021
24;2021-03-31;26;16;42;87342;56882;89;144224
24;2021-03-31;15;6;21;31210;12071;90;43281
24;2021-03-31;718;686;1412;1320165;1238908;0;2559073
27;2021-03-31;42;47;89;143373;149679;09;293052
27;2021-03-31;121;164;286;160962;173003;19;333965
27;2021-03-31;126;121;247;133746;142254;29;276000
27;2021-03-31;104;89;193;160004;155407;39;315411
27;2021-03-31;115;122;237;172333;169564;49;341897
27;2021-03-31;100;87;187;189979;183788;59;373767
27;2021-03-31;70;65;135;192591;178206;69;370797
27;2021-03-31;45;42;87;146876;127546;79;274422
27;2021-03-31;21;7;28;96896;61575;89;158471
27;2021-03-31;15;2;17;33148;12109;90;45257
27;2021-03-31;759;746;1506;1429908;1353131;0;2783039
28;2021-03-31;70;57;134;180735;186856;09;367591
28;2021-03-31;153;180;337;200125;213621;19;413746
28;2021-03-31;148;137;286;168922;173007;29;341929
28;2021-03-31;125;130;255;196628;188487;39;385115
28;2021-03-31;167;135;302;205396;201699;49;407095
28;2021-03-31;141;133;274;222002;213866;59;435868
28;2021-03-31;86;87;173;224688;203758;69;428446
28;2021-03-31;45;39;84;163192;135543;79;298735
28;2021-03-31;42;18;60;109691;65377;89;175068
28;2021-03-31;13;13;26;37222;12685;90;49907
28;2021-03-31;990;931;1933;1708601;1594899;0;3303500
32;2021-03-31;179;187;366;358062;373689;09;731751
32;2021-03-31;443;444;888;387045;406742;19;793787
32;2021-03-31;375;353;728;342304;348587;29;690891
32;2021-03-31;441;340;782;382485;369972;39;752457
32;2021-03-31;365;371;736;382510;376716;49;759226
32;2021-03-31;308;330;638;386937;376527;59;763464
32;2021-03-31;217;174;391;371211;330938;69;702149
32;2021-03-31;123;94;217;250542;201459;79;452001
32;2021-03-31;83;33;116;163399;89786;89;253185
32;2021-03-31;31;13;44;48384;15367;90;63751
32;2021-03-31;2566;2339;4907;3072879;2889783;0;5962662
44;2021-03-31;84;98;182;291525;306839;09;598364
44;2021-03-31;260;232;495;320255;339504;19;659759
44;2021-03-31;201;206;407;302020;314428;29;616448
44;2021-03-31;228;201;430;342222;333292;39;675514
44;2021-03-31;227;214;442;349727;344491;49;694218
44;2021-03-31;207;188;396;381371;373239;59;754610
44;2021-03-31;124;150;274;367165;335850;69;703015
44;2021-03-31;75;71;146;250387;215436;79;465823
44;2021-03-31;42;31;74;170825;105192;89;276017
44;2021-03-31;15;5;20;51248;16731;90;67979
44;2021-03-31;1464;1396;2868;2826745;2685002;0;5511747
52;2021-03-31;47;53;101;213594;223900;09;437494
52;2021-03-31;195;185;382;240818;255197;19;496015
52;2021-03-31;172;163;335;197010;200630;29;397640
52;2021-03-31;162;117;279;231204;224885;39;456089
52;2021-03-31;163;137;300;243874;243418;49;487292
52;2021-03-31;115;109;224;244100;239116;59;483216
52;2021-03-31;62;63;125;241796;221345;69;463141
52;2021-03-31;38;34;72;177805;149903;79;327708
52;2021-03-31;28;20;48;119561;75822;89;195383
52;2021-03-31;9;4;13;42559;15260;90;57819
52;2021-03-31;991;885;1879;1952321;1849476;0;3801797
53;2021-03-31;45;38;83;173813;182358;09;356171
53;2021-03-31;111;134;245;202720;214740;19;417460
53;2021-03-31;95;83;179;163116;173196;29;336312
53;2021-03-31;85;88;173;190526;187674;39;378200
53;2021-03-31;100;90;190;212098;212015;49;424113
53;2021-03-31;81;73;154;223699;219176;59;442875
53;2021-03-31;50;45;95;227435;209274;69;436709
53;2021-03-31;27;26;53;169992;140910;79;310902
53;2021-03-31;13;5;18;118117;69883;89;188000
53;2021-03-31;7;5;12;37370;12267;90;49637
53;2021-03-31;614;587;1202;1718886;1621493;0;3340379
75;2021-03-31;48;40;89;293104;305291;09;598395
75;2021-03-31;242;241;485;337141;357785;19;694926
75;2021-03-31;172;193;365;295024;300618;29;595642
75;2021-03-31;160;132;293;347871;331233;39;679104
75;2021-03-31;175;189;365;384742;372771;49;757513
75;2021-03-31;148;123;271;413361;390880;59;804241
75;2021-03-31;94;91;185;425623;384060;69;809683
75;2021-03-31;32;50;82;325086;276298;79;601384
75;2021-03-31;26;20;46;213986;139308;89;353294
75;2021-03-31;16;7;23;77600;28200;90;105800
75;2021-03-31;1114;1086;2205;3113538;2886444;0;5999982
76;2021-03-31;79;62;143;305956;318589;09;624545
76;2021-03-31;259;296;560;338942;356969;19;695911
76;2021-03-31;248;245;493;316210;319570;29;635780
76;2021-03-31;257;219;476;356758;337587;39;694345
76;2021-03-31;271;210;481;376541;363812;49;740353
76;2021-03-31;208;199;409;402608;383750;59;786358
76;2021-03-31;140;117;257;394889;358997;69;753886
76;2021-03-31;99;78;177;308664;263806;79;572470
76;2021-03-31;57;35;92;195838;129272;89;325110
76;2021-03-31;29;12;41;69372;26728;90;96100
76;2021-03-31;1650;1475;3134;3065778;2859080;0;5924858
84;2021-03-31;144;155;301;459549;481088;09;940637
84;2021-03-31;455;489;948;487711;511905;19;999616
84;2021-03-31;409;383;793;443824;451094;29;894918
84;2021-03-31;434;376;810;512522;493262;39;1005784
84;2021-03-31;429;385;815;520248;515106;49;1035354
84;2021-03-31;372;350;722;529611;514848;59;1044459
84;2021-03-31;200;174;374;486720;439940;69;926660
84;2021-03-31;129;112;241;372151;315211;79;687362
84;2021-03-31;65;53;118;237198;150524;89;387722
84;2021-03-31;26;12;38;81185;28680;90;109865
84;2021-03-31;2664;2489;5161;4130719;3901658;0;8032377
93;2021-03-31;103;94;199;268834;283093;09;551927
93;2021-03-31;326;297;627;280751;296087;19;576838
93;2021-03-31;333;311;645;254404;255552;29;509956
93;2021-03-31;332;278;612;310704;288398;39;599102
93;2021-03-31;367;316;683;325559;305827;49;631386
93;2021-03-31;311;278;589;353104;325389;59;678493
93;2021-03-31;203;192;395;336327;296459;69;632786
93;2021-03-31;108;86;194;279820;229699;79;509519
93;2021-03-31;55;42;98;171274;113716;89;284990
93;2021-03-31;34;7;41;58896;21758;90;80654
93;2021-03-31;2173;1903;4090;2639673;2415978;0;5055651
94;2021-03-31;2;0;2;16311;17433;09;33744
94;2021-03-31;4;12;16;16679;18132;19;34811
94;2021-03-31;4;5;9;16782;16579;29;33361
94;2021-03-31;9;5;14;23044;20580;39;43624
94;2021-03-31;4;8;12;23065;22140;49;45205
94;2021-03-31;8;5;14;24549;23421;59;47970
94;2021-03-31;3;7;10;23212;21883;69;45095
94;2021-03-31;3;1;4;19544;17141;79;36685
94;2021-03-31;5;2;7;11227;8178;89;19405
94;2021-03-31;0;0;0;3332;1447;90;4779
94;2021-03-31;42;45;88;177745;166934;0;344679
01;2021-04-01;0;1;1;19979;20155;09;40134
01;2021-04-01;1;7;8;24994;25489;19;50483
01;2021-04-01;6;2;8;17868;16690;29;34558
01;2021-04-01;9;9;18;22328;14821;39;37149
01;2021-04-01;3;6;9;28652;20276;49;48928
01;2021-04-01;12;7;19;33264;27260;59;60524
01;2021-04-01;6;1;7;27135;23978;69;51113
01;2021-04-01;5;3;8;18401;14661;79;33062
01;2021-04-01;3;3;6;9633;6375;89;16008
01;2021-04-01;1;0;1;3410;1510;90;4920
01;2021-04-01;46;39;85;205664;171215;0;376879
02;2021-04-01;1;3;4;16881;17110;09;33991
02;2021-04-01;4;3;7;21410;21604;19;43014
02;2021-04-01;6;10;16;16017;15479;29;31496
02;2021-04-01;13;8;21;19825;14455;39;34280
02;2021-04-01;16;9;25;24719;18248;49;42967
02;2021-04-01;19;18;37;34361;28310;59;62671
02;2021-04-01;11;14;25;28061;24495;69;52556
02;2021-04-01;7;6;13;18231;15278;79;33509
02;2021-04-01;1;2;3;11090;7677;89;18767
02;2021-04-01;0;0;0;3992;1506;90;5498
02;2021-04-01;78;73;151;194587;164162;0;358749
03;2021-04-01;0;0;0;31123;30920;09;62043
03;2021-04-01;2;3;5;29370;29268;19;58638
03;2021-04-01;3;3;6;21458;18963;29;40421
03;2021-04-01;3;1;4;21276;18326;39;39602
03;2021-04-01;4;3;7;18164;16593;49;34757
03;2021-04-01;1;6;7;13469;13557;59;27026
03;2021-04-01;5;1;6;8776;8670;69;17446
03;2021-04-01;0;0;0;3777;3591;79;7368
03;2021-04-01;0;0;0;1649;1072;89;2721
03;2021-04-01;0;0;0;485;184;90;669
03;2021-04-01;18;17;35;149547;141144;0;290691
04;2021-04-01;4;3;7;60314;61377;09;121691
04;2021-04-01;13;16;29;66065;68387;19;134452
04;2021-04-01;13;7;20;51059;47156;29;98215
04;2021-04-01;17;14;31;58788;45780;39;104568
04;2021-04-01;16;4;20;61408;52207;49;113615
04;2021-04-01;13;9;22;64838;60759;59;125597
04;2021-04-01;5;3;8;47008;42843;69;89851
04;2021-04-01;4;3;7;25509;21184;79;46693
04;2021-04-01;2;0;2;13168;7647;89;20815
04;2021-04-01;0;0;0;3209;1253;90;4462
04;2021-04-01;87;59;146;451366;408593;0;859959
05;2021-04-01;0;0;0;362.366008612902;341.338819562748;09;703.704828175651
05;2021-04-01;0;0;0;353.376145114279;370.349735405642;19;723.725880519921
05;2021-04-01;0;0;0;218.593559489256;256.539602589476;29;475.133162078732
05;2021-04-01;0;0;0;404.225408693299;360.321910454353;39;764.547319147651
05;2021-04-01;1;0;1;520.067953604221;497.108383964256;49;1017.17633756848
05;2021-04-01;0;0;0;468.146063921917;510.087601910415;59;978.233665832332
05;2021-04-01;0;0;0;340.368470050554;334.366842191253;69;674.735312241807
05;2021-04-01;0;0;0;212.598666888387;192.597753227106;79;405.196420115493
05;2021-04-01;0;0;0;148.727797095705;61.8681715431829;89;210.595968638888
05;2021-04-01;0;0;0;32.9601271090696;10.9909785719784;90;43.9511056810479
05;2021-04-01;1;0;1;3061.43020057959;2935.56979942041;0;5997
06;2021-04-01;1;0;1;42583;42380;09;84963
06;2021-04-01;4;3;7;33369;31925;19;65294
06;2021-04-01;2;2;4;21571;15080;29;36651
06;2021-04-01;2;2;4;21550;16147;39;37697
06;2021-04-01;2;0;2;14193;13939;49;28132
06;2021-04-01;2;1;3;7171;7597;59;14768
06;2021-04-01;0;1;1;3629;4117;69;7746
06;2021-04-01;0;0;0;1577;1457;79;3034
06;2021-04-01;0;0;0;531;474;89;1005
06;2021-04-01;0;0;0;88;93;90;181
06;2021-04-01;13;9;22;146262;133209;0;279471
07;2021-04-01;0;0;0;485;549;09;1034
07;2021-04-01;1;0;1;403;432;19;835
07;2021-04-01;1;1;2;764;841;29;1605
07;2021-04-01;0;0;0;824;928;39;1752
07;2021-04-01;0;0;0;788;1020;49;1808
07;2021-04-01;0;0;0;678;870;59;1548
07;2021-04-01;2;1;3;360;382;69;742
07;2021-04-01;0;0;0;231;190;79;421
07;2021-04-01;0;0;0;114;67;89;181
07;2021-04-01;0;0;0;24;11;90;35
07;2021-04-01;4;2;6;4671;5290;0;9961
08;2021-04-01;0;0;0;2715.22592983026;2997.75551488675;09;5712.98144471701
08;2021-04-01;1;1;2;2778.51901080978;3160.9156459093;19;5939.43465671908
08;2021-04-01;0;0;0;2080.8882988764;1718.16634315323;29;3799.05464202964
08;2021-04-01;0;0;0;2701.8582062647;1896.52641413317;39;4598.38462039786
08;2021-04-01;0;0;0;3151.45861023308;2460.52498233809;49;5611.98359257117
08;2021-04-01;0;0;0;2620.29868333099;2422.23566154656;59;5042.53434487755
08;2021-04-01;0;0;0;1621.44173420671;1438.58325779464;69;3060.02499200135
08;2021-04-01;0;0;0;626.575909335673;526.358467843651;79;1152.93437717932
08;2021-04-01;0;0;0;205.018522985054;140.993639349697;89;346.012162334751
08;2021-04-01;0;0;0;50.0325684687745;20.62259870351;90;70.6551671722846
08;2021-04-01;1;1;2;18551.3174743414;16782.6825256586;0;35334
11;2021-04-01;421;394;864;783071;811785;09;1594856
11;2021-04-01;975;962;2010;761456;784653;19;1546109
11;2021-04-01;1222;1107;2337;850145;801772;29;1651917
11;2021-04-01;1348;1112;2468;914360;843488;39;1757848
11;2021-04-01;1223;1103;2337;845609;826202;49;1671811
11;2021-04-01;841;854;1701;793566;745070;59;1538636
11;2021-04-01;474;423;905;628649;549192;69;1177841
11;2021-04-01;222;201;425;434606;358356;79;792962
11;2021-04-01;153;80;234;261425;162933;89;424358
11;2021-04-01;53;28;81;89253;32619;90;121872
11;2021-04-01;6935;6266;13367;6362140;5916070;0;12278210
24;2021-04-01;40;24;64;139720;144686;09;284406
24;2021-04-01;112;121;234;152979;161185;19;314164
24;2021-04-01;131;119;250;122237;126536;29;248773
24;2021-04-01;123;93;216;150359;142009;39;292368
24;2021-04-01;112;113;225;161829;158758;49;320587
24;2021-04-01;111;93;204;172552;168011;59;340563
24;2021-04-01;63;71;134;172509;158177;69;330686
24;2021-04-01;47;37;84;129428;110593;79;240021
24;2021-04-01;27;21;48;87342;56882;89;144224
24;2021-04-01;13;10;23;31210;12071;90;43281
24;2021-04-01;780;702;1483;1320165;1238908;0;2559073
27;2021-04-01;38;39;77;143373;149679;09;293052
27;2021-04-01;131;132;265;160962;173003;19;333965
27;2021-04-01;106;125;231;133746;142254;29;276000
27;2021-04-01;130;132;262;160004;155407;39;315411
27;2021-04-01;114;117;231;172333;169564;49;341897
27;2021-04-01;115;126;241;189979;183788;59;373767
27;2021-04-01;87;80;167;192591;178206;69;370797
27;2021-04-01;48;42;90;146876;127546;79;274422
27;2021-04-01;26;24;50;96896;61575;89;158471
27;2021-04-01;25;7;32;33148;12109;90;45257
27;2021-04-01;820;824;1646;1429908;1353131;0;2783039
28;2021-04-01;48;65;118;180735;186856;09;367591
28;2021-04-01;140;148;294;200125;213621;19;413746
28;2021-04-01;139;128;269;168922;173007;29;341929
28;2021-04-01;160;136;296;196628;188487;39;385115
28;2021-04-01;144;156;300;205396;201699;49;407095
28;2021-04-01;109;111;220;222002;213866;59;435868
28;2021-04-01;99;80;179;224688;203758;69;428446
28;2021-04-01;48;45;93;163192;135543;79;298735
28;2021-04-01;36;11;47;109691;65377;89;175068
28;2021-04-01;21;3;24;37222;12685;90;49907
28;2021-04-01;944;884;1841;1708601;1594899;0;3303500
32;2021-04-01;153;184;337;358062;373689;09;731751
32;2021-04-01;470;401;872;387045;406742;19;793787
32;2021-04-01;391;356;748;342304;348587;29;690891
32;2021-04-01;390;367;757;382485;369972;39;752457
32;2021-04-01;375;346;721;382510;376716;49;759226
32;2021-04-01;336;278;614;386937;376527;59;763464
32;2021-04-01;217;196;413;371211;330938;69;702149
32;2021-04-01;112;105;217;250542;201459;79;452001
32;2021-04-01;71;48;119;163399;89786;89;253185
32;2021-04-01;44;15;59;48384;15367;90;63751
32;2021-04-01;2559;2296;4857;3072879;2889783;0;5962662
44;2021-04-01;96;103;200;291525;306839;09;598364
44;2021-04-01;235;233;471;320255;339504;19;659759
44;2021-04-01;256;229;485;302020;314428;29;616448
44;2021-04-01;216;208;424;342222;333292;39;675514
44;2021-04-01;218;190;408;349727;344491;49;694218
44;2021-04-01;185;198;384;381371;373239;59;754610
44;2021-04-01;139;138;277;367165;335850;69;703015
44;2021-04-01;60;69;130;250387;215436;79;465823
44;2021-04-01;45;30;77;170825;105192;89;276017
44;2021-04-01;23;13;36;51248;16731;90;67979
44;2021-04-01;1473;1411;2892;2826745;2685002;0;5511747
52;2021-04-01;61;58;123;213594;223900;09;437494
52;2021-04-01;180;175;360;240818;255197;19;496015
52;2021-04-01;165;162;328;197010;200630;29;397640
52;2021-04-01;174;135;309;231204;224885;39;456089
52;2021-04-01;136;128;265;243874;243418;49;487292
52;2021-04-01;119;108;227;244100;239116;59;483216
52;2021-04-01;81;74;155;241796;221345;69;463141
52;2021-04-01;52;48;100;177805;149903;79;327708
52;2021-04-01;22;21;43;119561;75822;89;195383
52;2021-04-01;15;6;21;42559;15260;90;57819
52;2021-04-01;1005;915;1931;1952321;1849476;0;3801797
53;2021-04-01;27;29;57;173813;182358;09;356171
53;2021-04-01;89;109;198;202720;214740;19;417460
53;2021-04-01;105;98;205;163116;173196;29;336312
53;2021-04-01;88;75;163;190526;187674;39;378200
53;2021-04-01;81;77;158;212098;212015;49;424113
53;2021-04-01;68;78;146;223699;219176;59;442875
53;2021-04-01;34;45;79;227435;209274;69;436709
53;2021-04-01;34;18;52;169992;140910;79;310902
53;2021-04-01;13;19;32;118117;69883;89;188000
53;2021-04-01;8;2;10;37370;12267;90;49637
53;2021-04-01;547;550;1101;1718886;1621493;0;3340379
75;2021-04-01;55;49;104;293104;305291;09;598395
75;2021-04-01;206;201;408;337141;357785;19;694926
75;2021-04-01;210;200;410;295024;300618;29;595642
75;2021-04-01;191;160;351;347871;331233;39;679104
75;2021-04-01;192;164;357;384742;372771;49;757513
75;2021-04-01;147;149;296;413361;390880;59;804241
75;2021-04-01;83;93;176;425623;384060;69;809683
75;2021-04-01;41;54;95;325086;276298;79;601384
75;2021-04-01;29;24;53;213986;139308;89;353294
75;2021-04-01;18;10;28;77600;28200;90;105800
75;2021-04-01;1172;1106;2280;3113538;2886444;0;5999982
76;2021-04-01;70;85;157;305956;318589;09;624545
76;2021-04-01;236;270;508;338942;356969;19;695911
76;2021-04-01;271;266;538;316210;319570;29;635780
76;2021-04-01;253;207;460;356758;337587;39;694345
76;2021-04-01;244;257;502;376541;363812;49;740353
76;2021-04-01;205;183;389;402608;383750;59;786358
76;2021-04-01;142;117;259;394889;358997;69;753886
76;2021-04-01;76;86;162;308664;263806;79;572470
76;2021-04-01;59;33;92;195838;129272;89;325110
76;2021-04-01;47;14;61;69372;26728;90;96100
76;2021-04-01;1606;1519;3132;3065778;2859080;0;5924858
84;2021-04-01;145;172;321;459549;481088;09;940637
84;2021-04-01;487;483;977;487711;511905;19;999616
84;2021-04-01;441;442;884;443824;451094;29;894918
84;2021-04-01;474;372;846;512522;493262;39;1005784
84;2021-04-01;413;378;792;520248;515106;49;1035354
84;2021-04-01;360;353;713;529611;514848;59;1044459
84;2021-04-01;229;229;458;486720;439940;69;926660
84;2021-04-01;134;149;283;372151;315211;79;687362
84;2021-04-01;84;44;128;237198;150524;89;387722
84;2021-04-01;27;19;46;81185;28680;90;109865
84;2021-04-01;2794;2641;5448;4130719;3901658;0;8032377
93;2021-04-01;101;97;198;268834;283093;09;551927
93;2021-04-01;269;292;561;280751;296087;19;576838
93;2021-04-01;318;305;625;254404;255552;29;509956
93;2021-04-01;382;300;683;310704;288398;39;599102
93;2021-04-01;312;291;603;325559;305827;49;631386
93;2021-04-01;312;283;596;353104;325389;59;678493
93;2021-04-01;181;168;349;336327;296459;69;632786
93;2021-04-01;114;101;215;279820;229699;79;509519
93;2021-04-01;54;54;108;171274;113716;89;284990
93;2021-04-01;32;9;41;58896;21758;90;80654
93;2021-04-01;2075;1901;3980;2639673;2415978;0;5055651
94;2021-04-01;4;4;8;16311;17433;09;33744
94;2021-04-01;5;7;12;16679;18132;19;34811
94;2021-04-01;4;6;10;16782;16579;29;33361
94;2021-04-01;8;1;9;23044;20580;39;43624
94;2021-04-01;10;9;19;23065;22140;49;45205
94;2021-04-01;10;3;13;24549;23421;59;47970
94;2021-04-01;4;4;8;23212;21883;69;45095
94;2021-04-01;7;4;11;19544;17141;79;36685
94;2021-04-01;1;0;1;11227;8178;89;19405
94;2021-04-01;0;1;1;3332;1447;90;4779
94;2021-04-01;53;39;92;177745;166934;0;344679
01;2021-04-02;0;0;0;19979;20155;09;40134
01;2021-04-02;2;0;2;24994;25489;19;50483
01;2021-04-02;2;0;2;17868;16690;29;34558
01;2021-04-02;3;2;5;22328;14821;39;37149
01;2021-04-02;2;1;3;28652;20276;49;48928
01;2021-04-02;1;1;2;33264;27260;59;60524
01;2021-04-02;4;2;6;27135;23978;69;51113
01;2021-04-02;1;1;2;18401;14661;79;33062
01;2021-04-02;1;1;2;9633;6375;89;16008
01;2021-04-02;1;0;1;3410;1510;90;4920
01;2021-04-02;17;8;25;205664;171215;0;376879
02;2021-04-02;0;0;0;16881;17110;09;33991
02;2021-04-02;1;2;3;21410;21604;19;43014
02;2021-04-02;2;3;5;16017;15479;29;31496
02;2021-04-02;2;1;3;19825;14455;39;34280
02;2021-04-02;4;6;10;24719;18248;49;42967
02;2021-04-02;1;1;2;34361;28310;59;62671
02;2021-04-02;1;3;6;28061;24495;69;52556
02;2021-04-02;1;1;2;18231;15278;79;33509
02;2021-04-02;1;1;2;11090;7677;89;18767
02;2021-04-02;0;0;0;3992;1506;90;5498
02;2021-04-02;13;18;33;194587;164162;0;358749
03;2021-04-02;2;0;2;31123;30920;09;62043
03;2021-04-02;0;0;0;29370;29268;19;58638
03;2021-04-02;3;3;6;21458;18963;29;40421
03;2021-04-02;4;4;8;21276;18326;39;39602
03;2021-04-02;6;6;12;18164;16593;49;34757
03;2021-04-02;2;6;9;13469;13557;59;27026
03;2021-04-02;2;3;5;8776;8670;69;17446
03;2021-04-02;0;1;1;3777;3591;79;7368
03;2021-04-02;0;0;0;1649;1072;89;2721
03;2021-04-02;0;0;0;485;184;90;669
03;2021-04-02;19;23;43;149547;141144;0;290691
04;2021-04-02;11;8;19;60314;61377;09;121691
04;2021-04-02;20;19;39;66065;68387;19;134452
04;2021-04-02;21;15;36;51059;47156;29;98215
04;2021-04-02;24;18;42;58788;45780;39;104568
04;2021-04-02;13;15;28;61408;52207;49;113615
04;2021-04-02;17;6;23;64838;60759;59;125597
04;2021-04-02;2;4;6;47008;42843;69;89851
04;2021-04-02;2;4;6;25509;21184;79;46693
04;2021-04-02;2;2;4;13168;7647;89;20815
04;2021-04-02;1;0;1;3209;1253;90;4462
04;2021-04-02;113;91;204;451366;408593;0;859959
05;2021-04-02;0;0;0;362.366008612902;341.338819562748;09;703.704828175651
05;2021-04-02;0;0;0;353.376145114279;370.349735405642;19;723.725880519921
05;2021-04-02;0;0;0;218.593559489256;256.539602589476;29;475.133162078732
05;2021-04-02;0;0;0;404.225408693299;360.321910454353;39;764.547319147651
05;2021-04-02;0;0;0;520.067953604221;497.108383964256;49;1017.17633756848
05;2021-04-02;0;0;0;468.146063921917;510.087601910415;59;978.233665832332
05;2021-04-02;0;0;0;340.368470050554;334.366842191253;69;674.735312241807
05;2021-04-02;0;0;0;212.598666888387;192.597753227106;79;405.196420115493
05;2021-04-02;0;0;0;148.727797095705;61.8681715431829;89;210.595968638888
05;2021-04-02;0;0;0;32.9601271090696;10.9909785719784;90;43.9511056810479
05;2021-04-02;0;0;0;3061.43020057959;2935.56979942041;0;5997
06;2021-04-02;0;0;0;42583;42380;09;84963
06;2021-04-02;2;1;4;33369;31925;19;65294
06;2021-04-02;9;6;15;21571;15080;29;36651
06;2021-04-02;2;5;7;21550;16147;39;37697
06;2021-04-02;5;1;6;14193;13939;49;28132
06;2021-04-02;2;4;6;7171;7597;59;14768
06;2021-04-02;0;0;0;3629;4117;69;7746
06;2021-04-02;2;1;3;1577;1457;79;3034
06;2021-04-02;0;0;0;531;474;89;1005
06;2021-04-02;0;0;0;88;93;90;181
06;2021-04-02;22;18;41;146262;133209;0;279471
07;2021-04-02;0;0;0;485;549;09;1034
07;2021-04-02;0;0;0;403;432;19;835
07;2021-04-02;0;0;0;764;841;29;1605
07;2021-04-02;0;1;1;824;928;39;1752
07;2021-04-02;0;0;0;788;1020;49;1808
07;2021-04-02;0;0;0;678;870;59;1548
07;2021-04-02;0;0;0;360;382;69;742
07;2021-04-02;0;0;0;231;190;79;421
07;2021-04-02;0;0;0;114;67;89;181
07;2021-04-02;0;0;0;24;11;90;35
07;2021-04-02;0;1;1;4671;5290;0;9961
08;2021-04-02;0;0;0;2715.22592983026;2997.75551488675;09;5712.98144471701
08;2021-04-02;2;1;3;2778.51901080978;3160.9156459093;19;5939.43465671908
08;2021-04-02;0;0;0;2080.8882988764;1718.16634315323;29;3799.05464202964
08;2021-04-02;1;0;1;2701.8582062647;1896.52641413317;39;4598.38462039786
08;2021-04-02;0;0;0;3151.45861023308;2460.52498233809;49;5611.98359257117
08;2021-04-02;0;0;0;2620.29868333099;2422.23566154656;59;5042.53434487755
08;2021-04-02;0;0;0;1621.44173420671;1438.58325779464;69;3060.02499200135
08;2021-04-02;0;0;0;626.575909335673;526.358467843651;79;1152.93437717932
08;2021-04-02;0;0;0;205.018522985054;140.993639349697;89;346.012162334751
08;2021-04-02;0;0;0;50.0325684687745;20.62259870351;90;70.6551671722846
08;2021-04-02;3;1;4;18551.3174743414;16782.6825256586;0;35334
11;2021-04-02;379;411;836;783071;811785;09;1594856
11;2021-04-02;991;969;2038;761456;784653;19;1546109
11;2021-04-02;1210;1132;2352;850145;801772;29;1651917
11;2021-04-02;1265;1171;2447;914360;843488;39;1757848
11;2021-04-02;1165;1130;2304;845609;826202;49;1671811
11;2021-04-02;824;818;1652;793566;745070;59;1538636
11;2021-04-02;492;431;928;628649;549192;69;1177841
11;2021-04-02;195;205;401;434606;358356;79;792962
11;2021-04-02;110;78;190;261425;162933;89;424358
11;2021-04-02;56;27;83;89253;32619;90;121872
11;2021-04-02;6687;6376;13235;6362140;5916070;0;12278210
24;2021-04-02;37;32;70;139720;144686;09;284406
24;2021-04-02;107;126;235;152979;161185;19;314164
24;2021-04-02;106;112;218;122237;126536;29;248773
24;2021-04-02;119;95;216;150359;142009;39;292368
24;2021-04-02;131;112;243;161829;158758;49;320587
24;2021-04-02;103;94;197;172552;168011;59;340563
24;2021-04-02;75;58;133;172509;158177;69;330686
24;2021-04-02;38;45;84;129428;110593;79;240021
24;2021-04-02;26;22;48;87342;56882;89;144224
24;2021-04-02;11;6;17;31210;12071;90;43281
24;2021-04-02;754;702;1462;1320165;1238908;0;2559073
27;2021-04-02;36;39;76;143373;149679;09;293052
27;2021-04-02;141;121;263;160962;173003;19;333965
27;2021-04-02;116;107;223;133746;142254;29;276000
27;2021-04-02;123;88;211;160004;155407;39;315411
27;2021-04-02;111;116;227;172333;169564;49;341897
27;2021-04-02;125;107;232;189979;183788;59;373767
27;2021-04-02;89;91;180;192591;178206;69;370797
27;2021-04-02;50;38;88;146876;127546;79;274422
27;2021-04-02;41;25;66;96896;61575;89;158471
27;2021-04-02;18;7;25;33148;12109;90;45257
27;2021-04-02;850;739;1591;1429908;1353131;0;2783039
28;2021-04-02;67;71;140;180735;186856;09;367591
28;2021-04-02;172;192;364;200125;213621;19;413746
28;2021-04-02;132;146;280;168922;173007;29;341929
28;2021-04-02;161;144;306;196628;188487;39;385115
28;2021-04-02;140;142;283;205396;201699;49;407095
28;2021-04-02;134;130;264;222002;213866;59;435868
28;2021-04-02;107;99;206;224688;203758;69;428446
28;2021-04-02;55;50;105;163192;135543;79;298735
28;2021-04-02;45;28;73;109691;65377;89;175068
28;2021-04-02;13;4;17;37222;12685;90;49907
28;2021-04-02;1026;1006;2038;1708601;1594899;0;3303500
32;2021-04-02;170;168;339;358062;373689;09;731751
32;2021-04-02;382;401;787;387045;406742;19;793787
32;2021-04-02;357;351;708;342304;348587;29;690891
32;2021-04-02;395;333;730;382485;369972;39;752457
32;2021-04-02;349;352;702;382510;376716;49;759226
32;2021-04-02;320;315;636;386937;376527;59;763464
32;2021-04-02;195;177;373;371211;330938;69;702149
32;2021-04-02;118;113;231;250542;201459;79;452001
32;2021-04-02;81;50;131;163399;89786;89;253185
32;2021-04-02;28;6;34;48384;15367;90;63751
32;2021-04-02;2397;2269;4676;3072879;2889783;0;5962662
44;2021-04-02;38;34;73;291525;306839;09;598364
44;2021-04-02;136;161;297;320255;339504;19;659759
44;2021-04-02;137;130;267;302020;314428;29;616448
44;2021-04-02;142;122;264;342222;333292;39;675514
44;2021-04-02;138;125;263;349727;344491;49;694218
44;2021-04-02;112;138;250;381371;373239;59;754610
44;2021-04-02;99;82;181;367165;335850;69;703015
44;2021-04-02;45;58;103;250387;215436;79;465823
44;2021-04-02;40;26;66;170825;105192;89;276017
44;2021-04-02;14;1;15;51248;16731;90;67979
44;2021-04-02;901;877;1779;2826745;2685002;0;5511747
52;2021-04-02;54;53;107;213594;223900;09;437494
52;2021-04-02;173;177;352;240818;255197;19;496015
52;2021-04-02;161;195;357;197010;200630;29;397640
52;2021-04-02;147;115;262;231204;224885;39;456089
52;2021-04-02;161;133;294;243874;243418;49;487292
52;2021-04-02;131;98;229;244100;239116;59;483216
52;2021-04-02;85;107;192;241796;221345;69;463141
52;2021-04-02;54;49;103;177805;149903;79;327708
52;2021-04-02;25;21;46;119561;75822;89;195383
52;2021-04-02;8;12;20;42559;15260;90;57819
52;2021-04-02;999;960;1962;1952321;1849476;0;3801797
53;2021-04-02;37;46;83;173813;182358;09;356171
53;2021-04-02;107;122;232;202720;214740;19;417460
53;2021-04-02;92;103;195;163116;173196;29;336312
53;2021-04-02;90;91;181;190526;187674;39;378200
53;2021-04-02;105;95;200;212098;212015;49;424113
53;2021-04-02;69;74;143;223699;219176;59;442875
53;2021-04-02;38;48;86;227435;209274;69;436709
53;2021-04-02;33;23;56;169992;140910;79;310902
53;2021-04-02;27;12;39;118117;69883;89;188000
53;2021-04-02;10;4;14;37370;12267;90;49637
53;2021-04-02;608;619;1230;1718886;1621493;0;3340379
75;2021-04-02;65;58;123;293104;305291;09;598395
75;2021-04-02;222;210;436;337141;357785;19;694926
75;2021-04-02;198;251;450;295024;300618;29;595642
75;2021-04-02;177;135;314;347871;331233;39;679104
75;2021-04-02;194;196;390;384742;372771;49;757513
75;2021-04-02;169;145;314;413361;390880;59;804241
75;2021-04-02;106;109;215;425623;384060;69;809683
75;2021-04-02;62;57;119;325086;276298;79;601384
75;2021-04-02;35;22;57;213986;139308;89;353294
75;2021-04-02;18;6;24;77600;28200;90;105800
75;2021-04-02;1246;1190;2443;3113538;2886444;0;5999982
76;2021-04-02;86;95;187;305956;318589;09;624545
76;2021-04-02;221;246;475;338942;356969;19;695911
76;2021-04-02;281;242;523;316210;319570;29;635780
76;2021-04-02;266;215;482;356758;337587;39;694345
76;2021-04-02;283;253;536;376541;363812;49;740353
76;2021-04-02;211;226;438;402608;383750;59;786358
76;2021-04-02;156;131;287;394889;358997;69;753886
76;2021-04-02;99;86;185;308664;263806;79;572470
76;2021-04-02;82;46;128;195838;129272;89;325110
76;2021-04-02;39;21;60;69372;26728;90;96100
76;2021-04-02;1724;1563;3303;3065778;2859080;0;5924858
84;2021-04-02;150;151;303;459549;481088;09;940637
84;2021-04-02;495;489;986;487711;511905;19;999616
84;2021-04-02;471;441;916;443824;451094;29;894918
84;2021-04-02;441;380;821;512522;493262;39;1005784
84;2021-04-02;444;402;847;520248;515106;49;1035354
84;2021-04-02;348;377;725;529611;514848;59;1044459
84;2021-04-02;229;236;465;486720;439940;69;926660
84;2021-04-02;144;119;263;372151;315211;79;687362
84;2021-04-02;80;52;132;237198;150524;89;387722
84;2021-04-02;26;15;41;81185;28680;90;109865
84;2021-04-02;2828;2663;5501;4130719;3901658;0;8032377
93;2021-04-02;101;95;197;268834;283093;09;551927
93;2021-04-02;297;336;637;280751;296087;19;576838
93;2021-04-02;373;303;676;254404;255552;29;509956
93;2021-04-02;380;298;680;310704;288398;39;599102
93;2021-04-02;405;340;745;325559;305827;49;631386
93;2021-04-02;320;263;584;353104;325389;59;678493
93;2021-04-02;219;169;388;336327;296459;69;632786
93;2021-04-02;126;87;213;279820;229699;79;509519
93;2021-04-02;76;39;115;171274;113716;89;284990
93;2021-04-02;31;13;44;58896;21758;90;80654
93;2021-04-02;2329;1944;4285;2639673;2415978;0;5055651
94;2021-04-02;2;2;4;16311;17433;09;33744
94;2021-04-02;6;4;10;16679;18132;19;34811
94;2021-04-02;5;7;12;16782;16579;29;33361
94;2021-04-02;11;5;16;23044;20580;39;43624
94;2021-04-02;13;6;19;23065;22140;49;45205
94;2021-04-02;5;6;11;24549;23421;59;47970
94;2021-04-02;4;6;10;23212;21883;69;45095
94;2021-04-02;10;1;11;19544;17141;79;36685
94;2021-04-02;1;3;4;11227;8178;89;19405
94;2021-04-02;1;0;1;3332;1447;90;4779
94;2021-04-02;58;40;98;177745;166934;0;344679
01;2021-04-03;0;0;0;19979;20155;09;40134
01;2021-04-03;3;2;5;24994;25489;19;50483
01;2021-04-03;3;1;4;17868;16690;29;34558
01;2021-04-03;7;2;9;22328;14821;39;37149
01;2021-04-03;5;4;9;28652;20276;49;48928
01;2021-04-03;5;3;8;33264;27260;59;60524
01;2021-04-03;7;5;12;27135;23978;69;51113
01;2021-04-03;1;0;1;18401;14661;79;33062
01;2021-04-03;2;0;2;9633;6375;89;16008
01;2021-04-03;1;0;1;3410;1510;90;4920
01;2021-04-03;34;17;51;205664;171215;0;376879
02;2021-04-03;0;1;1;16881;17110;09;33991
02;2021-04-03;3;1;4;21410;21604;19;43014
02;2021-04-03;7;1;9;16017;15479;29;31496
02;2021-04-03;3;3;6;19825;14455;39;34280
02;2021-04-03;9;5;14;24719;18248;49;42967
02;2021-04-03;18;5;23;34361;28310;59;62671
02;2021-04-03;3;4;7;28061;24495;69;52556
02;2021-04-03;5;1;6;18231;15278;79;33509
02;2021-04-03;1;2;3;11090;7677;89;18767
02;2021-04-03;1;0;1;3992;1506;90;5498
02;2021-04-03;50;23;74;194587;164162;0;358749
03;2021-04-03;0;2;2;31123;30920;09;62043
03;2021-04-03;2;3;5;29370;29268;19;58638
03;2021-04-03;3;2;5;21458;18963;29;40421
03;2021-04-03;2;0;2;21276;18326;39;39602
03;2021-04-03;4;4;8;18164;16593;49;34757
03;2021-04-03;3;4;7;13469;13557;59;27026
03;2021-04-03;4;2;6;8776;8670;69;17446
03;2021-04-03;2;1;3;3777;3591;79;7368
03;2021-04-03;0;1;1;1649;1072;89;2721
03;2021-04-03;0;0;0;485;184;90;669
03;2021-04-03;20;19;39;149547;141144;0;290691
04;2021-04-03;3;5;8;60314;61377;09;121691
04;2021-04-03;12;12;24;66065;68387;19;134452
04;2021-04-03;8;7;15;51059;47156;29;98215
04;2021-04-03;6;6;12;58788;45780;39;104568
04;2021-04-03;12;11;23;61408;52207;49;113615
04;2021-04-03;5;4;9;64838;60759;59;125597
04;2021-04-03;3;6;9;47008;42843;69;89851
04;2021-04-03;1;0;1;25509;21184;79;46693
04;2021-04-03;0;1;1;13168;7647;89;20815
04;2021-04-03;1;0;1;3209;1253;90;4462
04;2021-04-03;51;52;103;451366;408593;0;859959
05;2021-04-03;0;0;0;362.366008612902;341.338819562748;09;703.704828175651
05;2021-04-03;0;0;0;353.376145114279;370.349735405642;19;723.725880519921
05;2021-04-03;0;0;0;218.593559489256;256.539602589476;29;475.133162078732
05;2021-04-03;0;0;0;404.225408693299;360.321910454353;39;764.547319147651
05;2021-04-03;0;0;0;520.067953604221;497.108383964256;49;1017.17633756848
05;2021-04-03;0;0;0;468.146063921917;510.087601910415;59;978.233665832332
05;2021-04-03;0;0;0;340.368470050554;334.366842191253;69;674.735312241807
05;2021-04-03;0;0;0;212.598666888387;192.597753227106;79;405.196420115493
05;2021-04-03;0;0;0;148.727797095705;61.8681715431829;89;210.595968638888
05;2021-04-03;0;0;0;32.9601271090696;10.9909785719784;90;43.9511056810479
05;2021-04-03;0;0;0;3061.43020057959;2935.56979942041;0;5997
06;2021-04-03;0;0;0;42583;42380;09;84963
06;2021-04-03;2;2;4;33369;31925;19;65294
06;2021-04-03;2;0;2;21571;15080;29;36651
06;2021-04-03;0;1;1;21550;16147;39;37697
06;2021-04-03;0;0;0;14193;13939;49;28132
06;2021-04-03;2;0;2;7171;7597;59;14768
06;2021-04-03;0;0;0;3629;4117;69;7746
06;2021-04-03;0;0;0;1577;1457;79;3034
06;2021-04-03;0;0;0;531;474;89;1005
06;2021-04-03;0;0;0;88;93;90;181
06;2021-04-03;6;3;9;146262;133209;0;279471
07;2021-04-03;0;0;0;485;549;09;1034
07;2021-04-03;0;0;0;403;432;19;835
07;2021-04-03;0;0;0;764;841;29;1605
07;2021-04-03;0;0;0;824;928;39;1752
07;2021-04-03;1;0;1;788;1020;49;1808
07;2021-04-03;0;0;0;678;870;59;1548
07;2021-04-03;0;0;0;360;382;69;742
07;2021-04-03;0;0;0;231;190;79;421
07;2021-04-03;0;0;0;114;67;89;181
07;2021-04-03;0;0;0;24;11;90;35
07;2021-04-03;1;0;1;4671;5290;0;9961
08;2021-04-03;0;0;0;2715.22592983026;2997.75551488675;09;5712.98144471701
08;2021-04-03;0;0;0;2778.51901080978;3160.9156459093;19;5939.43465671908
08;2021-04-03;0;0;0;2080.8882988764;1718.16634315323;29;3799.05464202964
08;2021-04-03;1;0;1;2701.8582062647;1896.52641413317;39;4598.38462039786
08;2021-04-03;0;0;0;3151.45861023308;2460.52498233809;49;5611.98359257117
08;2021-04-03;0;0;0;2620.29868333099;2422.23566154656;59;5042.53434487755
08;2021-04-03;0;0;0;1621.44173420671;1438.58325779464;69;3060.02499200135
08;2021-04-03;0;0;0;626.575909335673;526.358467843651;79;1152.93437717932
08;2021-04-03;0;0;0;205.018522985054;140.993639349697;89;346.012162334751
08;2021-04-03;0;0;0;50.0325684687745;20.62259870351;90;70.6551671722846
08;2021-04-03;1;0;1;18551.3174743414;16782.6825256586;0;35334
11;2021-04-03;205;190;423;783071;811785;09;1594856
11;2021-04-03;657;566;1289;761456;784653;19;1546109
11;2021-04-03;762;616;1381;850145;801772;29;1651917
11;2021-04-03;815;709;1528;914360;843488;39;1757848
11;2021-04-03;733;669;1405;845609;826202;49;1671811
11;2021-04-03;554;508;1064;793566;745070;59;1538636
11;2021-04-03;293;284;578;628649;549192;69;1177841
11;2021-04-03;134;120;254;434606;358356;79;792962
11;2021-04-03;54;49;103;261425;162933;89;424358
11;2021-04-03;36;16;52;89253;32619;90;121872
11;2021-04-03;4245;3729;8081;6362140;5916070;0;12278210
24;2021-04-03;24;17;41;139720;144686;09;284406
24;2021-04-03;73;66;143;152979;161185;19;314164
24;2021-04-03;71;62;133;122237;126536;29;248773
24;2021-04-03;71;50;121;150359;142009;39;292368
24;2021-04-03;95;73;169;161829;158758;49;320587
24;2021-04-03;62;76;139;172552;168011;59;340563
24;2021-04-03;34;49;84;172509;158177;69;330686
24;2021-04-03;16;23;39;129428;110593;79;240021
24;2021-04-03;14;4;18;87342;56882;89;144224
24;2021-04-03;5;4;9;31210;12071;90;43281
24;2021-04-03;465;424;896;1320165;1238908;0;2559073
27;2021-04-03;27;22;49;143373;149679;09;293052
27;2021-04-03;84;85;169;160962;173003;19;333965
27;2021-04-03;76;75;151;133746;142254;29;276000
27;2021-04-03;83;59;142;160004;155407;39;315411
27;2021-04-03;94;85;179;172333;169564;49;341897
27;2021-04-03;79;82;161;189979;183788;59;373767
27;2021-04-03;43;51;94;192591;178206;69;370797
27;2021-04-03;27;27;54;146876;127546;79;274422
27;2021-04-03;22;9;31;96896;61575;89;158471
27;2021-04-03;8;1;9;33148;12109;90;45257
27;2021-04-03;543;496;1039;1429908;1353131;0;2783039
28;2021-04-03;24;23;49;180735;186856;09;367591
28;2021-04-03;77;98;175;200125;213621;19;413746
28;2021-04-03;71;77;148;168922;173007;29;341929
28;2021-04-03;73;82;156;196628;188487;39;385115
28;2021-04-03;88;92;180;205396;201699;49;407095
28;2021-04-03;72;94;166;222002;213866;59;435868
28;2021-04-03;60;57;117;224688;203758;69;428446
28;2021-04-03;22;23;45;163192;135543;79;298735
28;2021-04-03;12;9;21;109691;65377;89;175068
28;2021-04-03;12;6;18;37222;12685;90;49907
28;2021-04-03;512;561;1076;1708601;1594899;0;3303500
32;2021-04-03;91;106;199;358062;373689;09;731751
32;2021-04-03;257;256;514;387045;406742;19;793787
32;2021-04-03;251;247;498;342304;348587;29;690891
32;2021-04-03;251;209;460;382485;369972;39;752457
32;2021-04-03;270;239;511;382510;376716;49;759226
32;2021-04-03;208;221;431;386937;376527;59;763464
32;2021-04-03;129;108;237;371211;330938;69;702149
32;2021-04-03;64;73;137;250542;201459;79;452001
32;2021-04-03;65;28;93;163399;89786;89;253185
32;2021-04-03;14;8;22;48384;15367;90;63751
32;2021-04-03;1602;1496;3105;3072879;2889783;0;5962662
44;2021-04-03;66;69;135;291525;306839;09;598364
44;2021-04-03;159;161;321;320255;339504;19;659759
44;2021-04-03;233;181;414;302020;314428;29;616448
44;2021-04-03;184;164;349;342222;333292;39;675514
44;2021-04-03;180;194;374;349727;344491;49;694218
44;2021-04-03;162;182;344;381371;373239;59;754610
44;2021-04-03;121;114;235;367165;335850;69;703015
44;2021-04-03;57;58;115;250387;215436;79;465823
44;2021-04-03;43;24;67;170825;105192;89;276017
44;2021-04-03;22;8;30;51248;16731;90;67979
44;2021-04-03;1227;1155;2384;2826745;2685002;0;5511747
52;2021-04-03;28;42;71;213594;223900;09;437494
52;2021-04-03;106;123;230;240818;255197;19;496015
52;2021-04-03;105;108;213;197010;200630;29;397640
52;2021-04-03;85;96;181;231204;224885;39;456089
52;2021-04-03;105;100;205;243874;243418;49;487292
52;2021-04-03;103;99;202;244100;239116;59;483216
52;2021-04-03;58;50;108;241796;221345;69;463141
52;2021-04-03;26;33;59;177805;149903;79;327708
52;2021-04-03;20;10;30;119561;75822;89;195383
52;2021-04-03;4;2;6;42559;15260;90;57819
52;2021-04-03;640;663;1305;1952321;1849476;0;3801797
53;2021-04-03;15;24;39;173813;182358;09;356171
53;2021-04-03;69;56;125;202720;214740;19;417460
53;2021-04-03;37;50;87;163116;173196;29;336312
53;2021-04-03;63;50;113;190526;187674;39;378200
53;2021-04-03;69;49;119;212098;212015;49;424113
53;2021-04-03;48;41;89;223699;219176;59;442875
53;2021-04-03;30;30;60;227435;209274;69;436709
53;2021-04-03;23;23;46;169992;140910;79;310902
53;2021-04-03;12;7;19;118117;69883;89;188000
53;2021-04-03;3;0;3;37370;12267;90;49637
53;2021-04-03;369;330;700;1718886;1621493;0;3340379
75;2021-04-03;35;27;63;293104;305291;09;598395
75;2021-04-03;102;148;251;337141;357785;19;694926
75;2021-04-03;113;111;225;295024;300618;29;595642
75;2021-04-03;104;82;186;347871;331233;39;679104
75;2021-04-03;119;95;214;384742;372771;49;757513
75;2021-04-03;84;87;171;413361;390880;59;804241
75;2021-04-03;59;58;117;425623;384060;69;809683
75;2021-04-03;22;33;55;325086;276298;79;601384
75;2021-04-03;21;11;33;213986;139308;89;353294
75;2021-04-03;5;2;7;77600;28200;90;105800
75;2021-04-03;664;654;1322;3113538;2886444;0;5999982
76;2021-04-03;35;40;77;305956;318589;09;624545
76;2021-04-03;129;116;248;338942;356969;19;695911
76;2021-04-03;163;133;296;316210;319570;29;635780
76;2021-04-03;145;133;279;356758;337587;39;694345
76;2021-04-03;139;114;255;376541;363812;49;740353
76;2021-04-03;137;122;259;402608;383750;59;786358
76;2021-04-03;75;85;160;394889;358997;69;753886
76;2021-04-03;49;34;84;308664;263806;79;572470
76;2021-04-03;27;21;48;195838;129272;89;325110
76;2021-04-03;11;5;16;69372;26728;90;96100
76;2021-04-03;910;804;1723;3065778;2859080;0;5924858
84;2021-04-03;65;61;126;459549;481088;09;940637
84;2021-04-03;241;270;512;487711;511905;19;999616
84;2021-04-03;273;246;520;443824;451094;29;894918
84;2021-04-03;265;238;503;512522;493262;39;1005784
84;2021-04-03;267;236;503;520248;515106;49;1035354
84;2021-04-03;220;220;440;529611;514848;59;1044459
84;2021-04-03;128;129;258;486720;439940;69;926660
84;2021-04-03;81;83;164;372151;315211;79;687362
84;2021-04-03;49;42;91;237198;150524;89;387722
84;2021-04-03;19;5;24;81185;28680;90;109865
84;2021-04-03;1609;1531;3143;4130719;3901658;0;8032377
93;2021-04-03;51;39;90;268834;283093;09;551927
93;2021-04-03;126;131;259;280751;296087;19;576838
93;2021-04-03;183;165;348;254404;255552;29;509956
93;2021-04-03;192;160;355;310704;288398;39;599102
93;2021-04-03;180;181;361;325559;305827;49;631386
93;2021-04-03;204;155;359;353104;325389;59;678493
93;2021-04-03;112;127;239;336327;296459;69;632786
93;2021-04-03;54;56;110;279820;229699;79;509519
93;2021-04-03;38;33;72;171274;113716;89;284990
93;2021-04-03;18;10;28;58896;21758;90;80654
93;2021-04-03;1158;1057;2221;2639673;2415978;0;5055651
94;2021-04-03;0;4;4;16311;17433;09;33744
94;2021-04-03;2;2;4;16679;18132;19;34811
94;2021-04-03;2;1;3;16782;16579;29;33361
94;2021-04-03;2;5;7;23044;20580;39;43624
94;2021-04-03;5;2;7;23065;22140;49;45205
94;2021-04-03;2;4;6;24549;23421;59;47970
94;2021-04-03;2;4;6;23212;21883;69;45095
94;2021-04-03;4;0;4;19544;17141;79;36685
94;2021-04-03;0;1;1;11227;8178;89;19405
94;2021-04-03;1;1;2;3332;1447;90;4779
94;2021-04-03;20;24;44;177745;166934;0;344679
01;2021-04-04;0;0;0;19979;20155;09;40134
01;2021-04-04;0;1;1;24994;25489;19;50483
01;2021-04-04;3;1;4;17868;16690;29;34558
01;2021-04-04;2;0;2;22328;14821;39;37149
01;2021-04-04;1;0;1;28652;20276;49;48928
01;2021-04-04;2;2;4;33264;27260;59;60524
01;2021-04-04;1;2;3;27135;23978;69;51113
01;2021-04-04;2;1;3;18401;14661;79;33062
01;2021-04-04;2;0;2;9633;6375;89;16008
01;2021-04-04;1;0;1;3410;1510;90;4920
01;2021-04-04;14;7;21;205664;171215;0;376879
02;2021-04-04;0;0;0;16881;17110;09;33991
02;2021-04-04;0;0;0;21410;21604;19;43014
02;2021-04-04;1;0;1;16017;15479;29;31496
02;2021-04-04;0;0;0;19825;14455;39;34280
02;2021-04-04;1;0;1;24719;18248;49;42967
02;2021-04-04;1;2;3;34361;28310;59;62671
02;2021-04-04;0;0;0;28061;24495;69;52556
02;2021-04-04;2;3;5;18231;15278;79;33509
02;2021-04-04;2;0;2;11090;7677;89;18767
02;2021-04-04;0;0;0;3992;1506;90;5498
02;2021-04-04;7;5;12;194587;164162;0;358749
03;2021-04-04;0;0;0;31123;30920;09;62043
03;2021-04-04;0;0;0;29370;29268;19;58638
03;2021-04-04;0;0;0;21458;18963;29;40421
03;2021-04-04;2;0;2;21276;18326;39;39602
03;2021-04-04;1;1;2;18164;16593;49;34757
03;2021-04-04;1;0;1;13469;13557;59;27026
03;2021-04-04;0;0;0;8776;8670;69;17446
03;2021-04-04;0;0;0;3777;3591;79;7368
03;2021-04-04;0;0;0;1649;1072;89;2721
03;2021-04-04;0;1;1;485;184;90;669
03;2021-04-04;4;2;6;149547;141144;0;290691
04;2021-04-04;1;0;1;60314;61377;09;121691
04;2021-04-04;4;0;4;66065;68387;19;134452
04;2021-04-04;3;1;4;51059;47156;29;98215
04;2021-04-04;3;4;7;58788;45780;39;104568
04;2021-04-04;1;3;4;61408;52207;49;113615
04;2021-04-04;0;3;3;64838;60759;59;125597
04;2021-04-04;2;1;3;47008;42843;69;89851
04;2021-04-04;1;3;4;25509;21184;79;46693
04;2021-04-04;2;1;3;13168;7647;89;20815
04;2021-04-04;0;0;0;3209;1253;90;4462
04;2021-04-04;17;16;33;451366;408593;0;859959
05;2021-04-04;0;0;0;362.366008612902;341.338819562748;09;703.704828175651
05;2021-04-04;0;0;0;353.376145114279;370.349735405642;19;723.725880519921
05;2021-04-04;0;0;0;218.593559489256;256.539602589476;29;475.133162078732
05;2021-04-04;0;0;0;404.225408693299;360.321910454353;39;764.547319147651
05;2021-04-04;0;0;0;520.067953604221;497.108383964256;49;1017.17633756848
05;2021-04-04;0;0;0;468.146063921917;510.087601910415;59;978.233665832332
05;2021-04-04;0;0;0;340.368470050554;334.366842191253;69;674.735312241807
05;2021-04-04;0;0;0;212.598666888387;192.597753227106;79;405.196420115493
05;2021-04-04;0;0;0;148.727797095705;61.8681715431829;89;210.595968638888
05;2021-04-04;0;0;0;32.9601271090696;10.9909785719784;90;43.9511056810479
05;2021-04-04;0;0;0;3061.43020057959;2935.56979942041;0;5997
06;2021-04-04;0;0;0;42583;42380;09;84963
06;2021-04-04;0;0;0;33369;31925;19;65294
06;2021-04-04;0;0;0;21571;15080;29;36651
06;2021-04-04;1;1;2;21550;16147;39;37697
06;2021-04-04;1;0;1;14193;13939;49;28132
06;2021-04-04;0;1;1;7171;7597;59;14768
06;2021-04-04;0;0;0;3629;4117;69;7746
06;2021-04-04;0;0;0;1577;1457;79;3034
06;2021-04-04;0;0;0;531;474;89;1005
06;2021-04-04;0;0;0;88;93;90;181
06;2021-04-04;2;2;4;146262;133209;0;279471
07;2021-04-04;0;0;0;485;549;09;1034
07;2021-04-04;0;0;0;403;432;19;835
07;2021-04-04;0;0;0;764;841;29;1605
07;2021-04-04;0;0;0;824;928;39;1752
07;2021-04-04;0;0;0;788;1020;49;1808
07;2021-04-04;0;0;0;678;870;59;1548
07;2021-04-04;0;0;0;360;382;69;742
07;2021-04-04;0;0;0;231;190;79;421
07;2021-04-04;0;0;0;114;67;89;181
07;2021-04-04;0;0;0;24;11;90;35
07;2021-04-04;0;0;0;4671;5290;0;9961
08;2021-04-04;0;0;0;2715.22592983026;2997.75551488675;09;5712.98144471701
08;2021-04-04;0;0;0;2778.51901080978;3160.9156459093;19;5939.43465671908
08;2021-04-04;0;0;0;2080.8882988764;1718.16634315323;29;3799.05464202964
08;2021-04-04;0;0;0;2701.8582062647;1896.52641413317;39;4598.38462039786
08;2021-04-04;0;0;0;3151.45861023308;2460.52498233809;49;5611.98359257117
08;2021-04-04;0;0;0;2620.29868333099;2422.23566154656;59;5042.53434487755
08;2021-04-04;0;0;0;1621.44173420671;1438.58325779464;69;3060.02499200135
08;2021-04-04;0;0;0;626.575909335673;526.358467843651;79;1152.93437717932
08;2021-04-04;0;0;0;205.018522985054;140.993639349697;89;346.012162334751
08;2021-04-04;0;0;0;50.0325684687745;20.62259870351;90;70.6551671722846
08;2021-04-04;0;0;0;18551.3174743414;16782.6825256586;0;35334
11;2021-04-04;39;45;88;783071;811785;09;1594856
11;2021-04-04;88;99;190;761456;784653;19;1546109
11;2021-04-04;151;135;289;850145;801772;29;1651917
11;2021-04-04;171;182;356;914360;843488;39;1757848
11;2021-04-04;126;163;290;845609;826202;49;1671811
11;2021-04-04;103;115;219;793566;745070;59;1538636
11;2021-04-04;62;71;133;628649;549192;69;1177841
11;2021-04-04;40;46;86;434606;358356;79;792962
11;2021-04-04;32;34;66;261425;162933;89;424358
11;2021-04-04;13;11;24;89253;32619;90;121872
11;2021-04-04;825;901;1741;6362140;5916070;0;12278210
24;2021-04-04;2;3;5;139720;144686;09;284406
24;2021-04-04;10;6;16;152979;161185;19;314164
24;2021-04-04;10;6;16;122237;126536;29;248773
24;2021-04-04;9;10;19;150359;142009;39;292368
24;2021-04-04;9;12;21;161829;158758;49;320587
24;2021-04-04;10;8;18;172552;168011;59;340563
24;2021-04-04;9;13;22;172509;158177;69;330686
24;2021-04-04;3;6;9;129428;110593;79;240021
24;2021-04-04;6;3;9;87342;56882;89;144224
24;2021-04-04;4;0;4;31210;12071;90;43281
24;2021-04-04;72;67;139;1320165;1238908;0;2559073
27;2021-04-04;3;1;4;143373;149679;09;293052
27;2021-04-04;9;9;18;160962;173003;19;333965
27;2021-04-04;12;13;25;133746;142254;29;276000
27;2021-04-04;11;10;21;160004;155407;39;315411
27;2021-04-04;13;9;22;172333;169564;49;341897
27;2021-04-04;13;10;23;189979;183788;59;373767
27;2021-04-04;12;9;21;192591;178206;69;370797
27;2021-04-04;7;3;10;146876;127546;79;274422
27;2021-04-04;6;6;12;96896;61575;89;158471
27;2021-04-04;4;2;6;33148;12109;90;45257
27;2021-04-04;90;72;162;1429908;1353131;0;2783039
28;2021-04-04;9;2;11;180735;186856;09;367591
28;2021-04-04;3;14;17;200125;213621;19;413746
28;2021-04-04;19;15;34;168922;173007;29;341929
28;2021-04-04;13;17;30;196628;188487;39;385115
28;2021-04-04;14;12;26;205396;201699;49;407095
28;2021-04-04;22;14;36;222002;213866;59;435868
28;2021-04-04;7;9;16;224688;203758;69;428446
28;2021-04-04;9;4;13;163192;135543;79;298735
28;2021-04-04;4;3;7;109691;65377;89;175068
28;2021-04-04;3;2;5;37222;12685;90;49907
28;2021-04-04;103;92;196;1708601;1594899;0;3303500
32;2021-04-04;24;14;38;358062;373689;09;731751
32;2021-04-04;45;35;80;387045;406742;19;793787
32;2021-04-04;68;51;119;342304;348587;29;690891
32;2021-04-04;73;61;134;382485;369972;39;752457
32;2021-04-04;60;51;111;382510;376716;49;759226
32;2021-04-04;37;56;93;386937;376527;59;763464
32;2021-04-04;27;29;56;371211;330938;69;702149
32;2021-04-04;18;15;33;250542;201459;79;452001
32;2021-04-04;10;12;22;163399;89786;89;253185
32;2021-04-04;3;4;7;48384;15367;90;63751
32;2021-04-04;365;328;693;3072879;2889783;0;5962662
44;2021-04-04;6;4;10;291525;306839;09;598364
44;2021-04-04;19;18;37;320255;339504;19;659759
44;2021-04-04;20;21;41;302020;314428;29;616448
44;2021-04-04;23;17;40;342222;333292;39;675514
44;2021-04-04;19;25;44;349727;344491;49;694218
44;2021-04-04;15;19;34;381371;373239;59;754610
44;2021-04-04;22;16;38;367165;335850;69;703015
44;2021-04-04;8;7;15;250387;215436;79;465823
44;2021-04-04;12;12;25;170825;105192;89;276017
44;2021-04-04;6;3;9;51248;16731;90;67979
44;2021-04-04;150;142;293;2826745;2685002;0;5511747
52;2021-04-04;10;10;20;213594;223900;09;437494
52;2021-04-04;18;25;44;240818;255197;19;496015
52;2021-04-04;34;31;65;197010;200630;29;397640
52;2021-04-04;25;26;51;231204;224885;39;456089
52;2021-04-04;28;34;62;243874;243418;49;487292
52;2021-04-04;24;24;48;244100;239116;59;483216
52;2021-04-04;18;9;27;241796;221345;69;463141
52;2021-04-04;14;7;21;177805;149903;79;327708
52;2021-04-04;5;3;8;119561;75822;89;195383
52;2021-04-04;0;5;5;42559;15260;90;57819
52;2021-04-04;176;174;351;1952321;1849476;0;3801797
53;2021-04-04;5;6;11;173813;182358;09;356171
53;2021-04-04;13;6;19;202720;214740;19;417460
53;2021-04-04;13;14;27;163116;173196;29;336312
53;2021-04-04;12;10;22;190526;187674;39;378200
53;2021-04-04;9;6;15;212098;212015;49;424113
53;2021-04-04;11;10;21;223699;219176;59;442875
53;2021-04-04;3;8;11;227435;209274;69;436709
53;2021-04-04;4;1;5;169992;140910;79;310902
53;2021-04-04;1;2;3;118117;69883;89;188000
53;2021-04-04;0;2;2;37370;12267;90;49637
53;2021-04-04;71;65;136;1718886;1621493;0;3340379
75;2021-04-04;1;4;5;293104;305291;09;598395
75;2021-04-04;20;9;29;337141;357785;19;694926
75;2021-04-04;20;12;32;295024;300618;29;595642
75;2021-04-04;10;8;18;347871;331233;39;679104
75;2021-04-04;17;14;31;384742;372771;49;757513
75;2021-04-04;11;12;23;413361;390880;59;804241
75;2021-04-04;8;5;13;425623;384060;69;809683
75;2021-04-04;4;7;11;325086;276298;79;601384
75;2021-04-04;2;6;8;213986;139308;89;353294
75;2021-04-04;1;0;1;77600;28200;90;105800
75;2021-04-04;94;77;171;3113538;2886444;0;5999982
76;2021-04-04;13;9;22;305956;318589;09;624545
76;2021-04-04;24;15;39;338942;356969;19;695911
76;2021-04-04;25;23;48;316210;319570;29;635780
76;2021-04-04;22;22;44;356758;337587;39;694345
76;2021-04-04;17;20;37;376541;363812;49;740353
76;2021-04-04;14;25;39;402608;383750;59;786358
76;2021-04-04;11;16;27;394889;358997;69;753886
76;2021-04-04;12;21;33;308664;263806;79;572470
76;2021-04-04;6;8;14;195838;129272;89;325110
76;2021-04-04;9;2;11;69372;26728;90;96100
76;2021-04-04;153;161;314;3065778;2859080;0;5924858
84;2021-04-04;18;11;30;459549;481088;09;940637
84;2021-04-04;37;28;65;487711;511905;19;999616
84;2021-04-04;37;36;73;443824;451094;29;894918
84;2021-04-04;58;46;104;512522;493262;39;1005784
84;2021-04-04;63;39;102;520248;515106;49;1035354
84;2021-04-04;36;32;68;529611;514848;59;1044459
84;2021-04-04;23;30;53;486720;439940;69;926660
84;2021-04-04;19;25;44;372151;315211;79;687362
84;2021-04-04;18;13;31;237198;150524;89;387722
84;2021-04-04;6;4;10;81185;28680;90;109865
84;2021-04-04;315;264;580;4130719;3901658;0;8032377
93;2021-04-04;20;16;36;268834;283093;09;551927
93;2021-04-04;29;22;51;280751;296087;19;576838
93;2021-04-04;42;39;81;254404;255552;29;509956
93;2021-04-04;47;56;103;310704;288398;39;599102
93;2021-04-04;51;41;92;325559;305827;49;631386
93;2021-04-04;52;52;104;353104;325389;59;678493
93;2021-04-04;27;19;46;336327;296459;69;632786
93;2021-04-04;22;22;44;279820;229699;79;509519
93;2021-04-04;17;12;29;171274;113716;89;284990
93;2021-04-04;9;2;11;58896;21758;90;80654
93;2021-04-04;316;281;597;2639673;2415978;0;5055651
94;2021-04-04;0;0;0;16311;17433;09;33744
94;2021-04-04;0;0;0;16679;18132;19;34811
94;2021-04-04;0;0;0;16782;16579;29;33361
94;2021-04-04;0;0;0;23044;20580;39;43624
94;2021-04-04;2;0;2;23065;22140;49;45205
94;2021-04-04;0;0;0;24549;23421;59;47970
94;2021-04-04;1;1;2;23212;21883;69;45095
94;2021-04-04;1;0;1;19544;17141;79;36685
94;2021-04-04;1;0;1;11227;8178;89;19405
94;2021-04-04;0;0;0;3332;1447;90;4779
94;2021-04-04;5;1;6;177745;166934;0;344679
01;2021-04-05;0;0;0;19979;20155;09;40134
01;2021-04-05;2;1;3;24994;25489;19;50483
01;2021-04-05;1;2;3;17868;16690;29;34558
01;2021-04-05;2;3;5;22328;14821;39;37149
01;2021-04-05;5;4;9;28652;20276;49;48928
01;2021-04-05;6;0;6;33264;27260;59;60524
01;2021-04-05;3;5;8;27135;23978;69;51113
01;2021-04-05;1;0;1;18401;14661;79;33062
01;2021-04-05;1;2;3;9633;6375;89;16008
01;2021-04-05;0;0;0;3410;1510;90;4920
01;2021-04-05;21;17;38;205664;171215;0;376879
02;2021-04-05;0;0;0;16881;17110;09;33991
02;2021-04-05;0;1;1;21410;21604;19;43014
02;2021-04-05;0;0;0;16017;15479;29;31496
02;2021-04-05;2;1;3;19825;14455;39;34280
02;2021-04-05;2;1;3;24719;18248;49;42967
02;2021-04-05;3;5;8;34361;28310;59;62671
02;2021-04-05;4;2;6;28061;24495;69;52556
02;2021-04-05;1;3;4;18231;15278;79;33509
02;2021-04-05;0;0;0;11090;7677;89;18767
02;2021-04-05;1;0;1;3992;1506;90;5498
02;2021-04-05;13;13;26;194587;164162;0;358749
03;2021-04-05;0;0;0;31123;30920;09;62043
03;2021-04-05;1;0;1;29370;29268;19;58638
03;2021-04-05;1;0;1;21458;18963;29;40421
03;2021-04-05;6;1;7;21276;18326;39;39602
03;2021-04-05;2;1;3;18164;16593;49;34757
03;2021-04-05;0;0;0;13469;13557;59;27026
03;2021-04-05;1;0;1;8776;8670;69;17446
03;2021-04-05;0;0;0;3777;3591;79;7368
03;2021-04-05;0;1;1;1649;1072;89;2721
03;2021-04-05;0;0;0;485;184;90;669
03;2021-04-05;11;3;14;149547;141144;0;290691
04;2021-04-05;2;3;5;60314;61377;09;121691
04;2021-04-05;5;4;9;66065;68387;19;134452
04;2021-04-05;5;1;6;51059;47156;29;98215
04;2021-04-05;3;5;8;58788;45780;39;104568
04;2021-04-05;5;2;7;61408;52207;49;113615
04;2021-04-05;6;3;9;64838;60759;59;125597
04;2021-04-05;1;0;1;47008;42843;69;89851
04;2021-04-05;0;1;1;25509;21184;79;46693
04;2021-04-05;0;0;0;13168;7647;89;20815
04;2021-04-05;0;0;0;3209;1253;90;4462
04;2021-04-05;27;19;46;451366;408593;0;859959
05;2021-04-05;0;0;0;362.366008612902;341.338819562748;09;703.704828175651
05;2021-04-05;0;0;0;353.376145114279;370.349735405642;19;723.725880519921
05;2021-04-05;0;0;0;218.593559489256;256.539602589476;29;475.133162078732
05;2021-04-05;0;0;0;404.225408693299;360.321910454353;39;764.547319147651
05;2021-04-05;0;0;0;520.067953604221;497.108383964256;49;1017.17633756848
05;2021-04-05;0;0;0;468.146063921917;510.087601910415;59;978.233665832332
05;2021-04-05;0;0;0;340.368470050554;334.366842191253;69;674.735312241807
05;2021-04-05;0;0;0;212.598666888387;192.597753227106;79;405.196420115493
05;2021-04-05;0;0;0;148.727797095705;61.8681715431829;89;210.595968638888
05;2021-04-05;0;0;0;32.9601271090696;10.9909785719784;90;43.9511056810479
05;2021-04-05;0;0;0;3061.43020057959;2935.56979942041;0;5997
06;2021-04-05;0;0;0;42583;42380;09;84963
06;2021-04-05;0;1;1;33369;31925;19;65294
06;2021-04-05;1;0;1;21571;15080;29;36651
06;2021-04-05;0;2;2;21550;16147;39;37697
06;2021-04-05;2;1;3;14193;13939;49;28132
06;2021-04-05;0;1;1;7171;7597;59;14768
06;2021-04-05;1;0;1;3629;4117;69;7746
06;2021-04-05;0;0;0;1577;1457;79;3034
06;2021-04-05;0;0;0;531;474;89;1005
06;2021-04-05;0;0;0;88;93;90;181
06;2021-04-05;4;5;9;146262;133209;0;279471
07;2021-04-05;0;0;0;485;549;09;1034
07;2021-04-05;0;0;0;403;432;19;835
07;2021-04-05;0;0;0;764;841;29;1605
07;2021-04-05;0;0;0;824;928;39;1752
07;2021-04-05;0;0;0;788;1020;49;1808
07;2021-04-05;0;0;0;678;870;59;1548
07;2021-04-05;0;0;0;360;382;69;742
07;2021-04-05;0;0;0;231;190;79;421
07;2021-04-05;0;0;0;114;67;89;181
07;2021-04-05;0;0;0;24;11;90;35
07;2021-04-05;0;0;0;4671;5290;0;9961
08;2021-04-05;0;0;0;2715.22592983026;2997.75551488675;09;5712.98144471701
08;2021-04-05;0;0;0;2778.51901080978;3160.9156459093;19;5939.43465671908
08;2021-04-05;0;0;0;2080.8882988764;1718.16634315323;29;3799.05464202964
08;2021-04-05;0;0;0;2701.8582062647;1896.52641413317;39;4598.38462039786
08;2021-04-05;0;0;0;3151.45861023308;2460.52498233809;49;5611.98359257117
08;2021-04-05;0;0;0;2620.29868333099;2422.23566154656;59;5042.53434487755
08;2021-04-05;0;0;0;1621.44173420671;1438.58325779464;69;3060.02499200135
08;2021-04-05;0;0;0;626.575909335673;526.358467843651;79;1152.93437717932
08;2021-04-05;0;0;0;205.018522985054;140.993639349697;89;346.012162334751
08;2021-04-05;0;0;0;50.0325684687745;20.62259870351;90;70.6551671722846
08;2021-04-05;0;0;0;18551.3174743414;16782.6825256586;0;35334
11;2021-04-05;48;46;98;783071;811785;09;1594856
11;2021-04-05;176;175;359;761456;784653;19;1546109
11;2021-04-05;324;289;614;850145;801772;29;1651917
11;2021-04-05;317;328;648;914360;843488;39;1757848
11;2021-04-05;241;274;515;845609;826202;49;1671811
11;2021-04-05;197;212;409;793566;745070;59;1538636
11;2021-04-05;108;124;232;628649;549192;69;1177841
11;2021-04-05;63;58;121;434606;358356;79;792962
11;2021-04-05;48;34;82;261425;162933;89;424358
11;2021-04-05;22;11;33;89253;32619;90;121872
11;2021-04-05;1545;1551;3112;6362140;5916070;0;12278210
24;2021-04-05;6;4;10;139720;144686;09;284406
24;2021-04-05;9;16;25;152979;161185;19;314164
24;2021-04-05;17;25;42;122237;126536;29;248773
24;2021-04-05;28;7;35;150359;142009;39;292368
24;2021-04-05;25;17;42;161829;158758;49;320587
24;2021-04-05;24;12;36;172552;168011;59;340563
24;2021-04-05;9;12;21;172509;158177;69;330686
24;2021-04-05;5;7;12;129428;110593;79;240021
24;2021-04-05;2;2;4;87342;56882;89;144224
24;2021-04-05;1;0;1;31210;12071;90;43281
24;2021-04-05;126;102;228;1320165;1238908;0;2559073
27;2021-04-05;5;3;8;143373;149679;09;293052
27;2021-04-05;12;12;24;160962;173003;19;333965
27;2021-04-05;18;12;30;133746;142254;29;276000
27;2021-04-05;23;19;42;160004;155407;39;315411
27;2021-04-05;14;10;24;172333;169564;49;341897
27;2021-04-05;17;16;33;189979;183788;59;373767
27;2021-04-05;12;11;23;192591;178206;69;370797
27;2021-04-05;8;9;17;146876;127546;79;274422
27;2021-04-05;12;7;19;96896;61575;89;158471
27;2021-04-05;4;0;4;33148;12109;90;45257
27;2021-04-05;125;99;224;1429908;1353131;0;2783039
28;2021-04-05;4;9;13;180735;186856;09;367591
28;2021-04-05;11;15;26;200125;213621;19;413746
28;2021-04-05;28;18;46;168922;173007;29;341929
28;2021-04-05;25;16;41;196628;188487;39;385115
28;2021-04-05;18;24;42;205396;201699;49;407095
28;2021-04-05;23;19;42;222002;213866;59;435868
28;2021-04-05;9;9;18;224688;203758;69;428446
28;2021-04-05;8;9;17;163192;135543;79;298735
28;2021-04-05;12;8;20;109691;65377;89;175068
28;2021-04-05;3;0;3;37222;12685;90;49907
28;2021-04-05;141;127;268;1708601;1594899;0;3303500
32;2021-04-05;37;21;58;358062;373689;09;731751
32;2021-04-05;67;69;136;387045;406742;19;793787
32;2021-04-05;108;64;172;342304;348587;29;690891
32;2021-04-05;97;90;187;382485;369972;39;752457
32;2021-04-05;87;99;186;382510;376716;49;759226
32;2021-04-05;55;65;120;386937;376527;59;763464
32;2021-04-05;37;38;75;371211;330938;69;702149
32;2021-04-05;21;18;39;250542;201459;79;452001
32;2021-04-05;17;17;34;163399;89786;89;253185
32;2021-04-05;8;8;16;48384;15367;90;63751
32;2021-04-05;535;489;1024;3072879;2889783;0;5962662
44;2021-04-05;7;14;21;291525;306839;09;598364
44;2021-04-05;21;25;47;320255;339504;19;659759
44;2021-04-05;44;42;86;302020;314428;29;616448
44;2021-04-05;61;40;101;342222;333292;39;675514
44;2021-04-05;42;42;85;349727;344491;49;694218
44;2021-04-05;23;38;61;381371;373239;59;754610
44;2021-04-05;19;31;50;367165;335850;69;703015
44;2021-04-05;15;20;35;250387;215436;79;465823
44;2021-04-05;15;16;31;170825;105192;89;276017
44;2021-04-05;7;2;9;51248;16731;90;67979
44;2021-04-05;254;270;526;2826745;2685002;0;5511747
52;2021-04-05;8;11;20;213594;223900;09;437494
52;2021-04-05;31;44;76;240818;255197;19;496015
52;2021-04-05;44;40;84;197010;200630;29;397640
52;2021-04-05;46;38;84;231204;224885;39;456089
52;2021-04-05;56;38;94;243874;243418;49;487292
52;2021-04-05;34;43;77;244100;239116;59;483216
52;2021-04-05;21;29;50;241796;221345;69;463141
52;2021-04-05;8;14;22;177805;149903;79;327708
52;2021-04-05;6;7;13;119561;75822;89;195383
52;2021-04-05;7;3;10;42559;15260;90;57819
52;2021-04-05;261;267;530;1952321;1849476;0;3801797
53;2021-04-05;11;8;19;173813;182358;09;356171
53;2021-04-05;25;23;48;202720;214740;19;417460
53;2021-04-05;32;31;63;163116;173196;29;336312
53;2021-04-05;27;26;53;190526;187674;39;378200
53;2021-04-05;24;21;45;212098;212015;49;424113
53;2021-04-05;21;20;41;223699;219176;59;442875
53;2021-04-05;11;10;21;227435;209274;69;436709
53;2021-04-05;4;3;7;169992;140910;79;310902
53;2021-04-05;3;3;6;118117;69883;89;188000
53;2021-04-05;4;0;4;37370;12267;90;49637
53;2021-04-05;162;145;307;1718886;1621493;0;3340379
75;2021-04-05;11;10;21;293104;305291;09;598395
75;2021-04-05;15;22;39;337141;357785;19;694926
75;2021-04-05;27;19;46;295024;300618;29;595642
75;2021-04-05;28;33;61;347871;331233;39;679104
75;2021-04-05;28;23;51;384742;372771;49;757513
75;2021-04-05;35;20;55;413361;390880;59;804241
75;2021-04-05;10;15;25;425623;384060;69;809683
75;2021-04-05;9;10;19;325086;276298;79;601384
75;2021-04-05;9;8;17;213986;139308;89;353294
75;2021-04-05;8;1;9;77600;28200;90;105800
75;2021-04-05;180;161;343;3113538;2886444;0;5999982
76;2021-04-05;9;12;21;305956;318589;09;624545
76;2021-04-05;19;31;52;338942;356969;19;695911
76;2021-04-05;50;42;92;316210;319570;29;635780
76;2021-04-05;42;36;78;356758;337587;39;694345
76;2021-04-05;53;45;99;376541;363812;49;740353
76;2021-04-05;47;31;78;402608;383750;59;786358
76;2021-04-05;33;23;56;394889;358997;69;753886
76;2021-04-05;18;22;40;308664;263806;79;572470
76;2021-04-05;27;14;41;195838;129272;89;325110
76;2021-04-05;11;3;14;69372;26728;90;96100
76;2021-04-05;309;259;571;3065778;2859080;0;5924858
84;2021-04-05;21;16;37;459549;481088;09;940637
84;2021-04-05;73;55;128;487711;511905;19;999616
84;2021-04-05;73;93;166;443824;451094;29;894918
84;2021-04-05;118;99;217;512522;493262;39;1005784
84;2021-04-05;115;110;225;520248;515106;49;1035354
84;2021-04-05;68;85;153;529611;514848;59;1044459
84;2021-04-05;49;45;94;486720;439940;69;926660
84;2021-04-05;35;43;78;372151;315211;79;687362
84;2021-04-05;31;27;58;237198;150524;89;387722
84;2021-04-05;16;7;23;81185;28680;90;109865
84;2021-04-05;601;580;1181;4130719;3901658;0;8032377
93;2021-04-05;14;14;28;268834;283093;09;551927
93;2021-04-05;45;44;89;280751;296087;19;576838
93;2021-04-05;101;72;174;254404;255552;29;509956
93;2021-04-05;81;76;157;310704;288398;39;599102
93;2021-04-05;87;78;165;325559;305827;49;631386
93;2021-04-05;75;46;123;353104;325389;59;678493
93;2021-04-05;39;49;88;336327;296459;69;632786
93;2021-04-05;16;29;47;279820;229699;79;509519
93;2021-04-05;25;17;42;171274;113716;89;284990
93;2021-04-05;12;5;17;58896;21758;90;80654
93;2021-04-05;495;430;930;2639673;2415978;0;5055651
94;2021-04-05;0;2;2;16311;17433;09;33744
94;2021-04-05;1;0;1;16679;18132;19;34811
94;2021-04-05;3;0;3;16782;16579;29;33361
94;2021-04-05;0;1;1;23044;20580;39;43624
94;2021-04-05;1;2;3;23065;22140;49;45205
94;2021-04-05;1;3;4;24549;23421;59;47970
94;2021-04-05;1;0;1;23212;21883;69;45095
94;2021-04-05;2;2;4;19544;17141;79;36685
94;2021-04-05;0;1;1;11227;8178;89;19405
94;2021-04-05;0;0;0;3332;1447;90;4779
94;2021-04-05;9;11;20;177745;166934;0;344679
01;2021-04-06;1;0;1;19979;20155;09;40134
01;2021-04-06;3;2;5;24994;25489;19;50483
01;2021-04-06;9;4;13;17868;16690;29;34558
01;2021-04-06;10;8;18;22328;14821;39;37149
01;2021-04-06;15;14;29;28652;20276;49;48928
01;2021-04-06;12;10;22;33264;27260;59;60524
01;2021-04-06;15;4;19;27135;23978;69;51113
01;2021-04-06;4;5;9;18401;14661;79;33062
01;2021-04-06;0;1;1;9633;6375;89;16008
01;2021-04-06;0;0;0;3410;1510;90;4920
01;2021-04-06;69;48;117;205664;171215;0;376879
02;2021-04-06;1;3;4;16881;17110;09;33991
02;2021-04-06;6;5;11;21410;21604;19;43014
02;2021-04-06;6;7;13;16017;15479;29;31496
02;2021-04-06;17;10;27;19825;14455;39;34280
02;2021-04-06;23;18;41;24719;18248;49;42967
02;2021-04-06;23;20;43;34361;28310;59;62671
02;2021-04-06;20;17;37;28061;24495;69;52556
02;2021-04-06;5;3;8;18231;15278;79;33509
02;2021-04-06;3;3;6;11090;7677;89;18767
02;2021-04-06;1;0;1;3992;1506;90;5498
02;2021-04-06;105;86;191;194587;164162;0;358749
03;2021-04-06;0;0;0;31123;30920;09;62043
03;2021-04-06;2;3;5;29370;29268;19;58638
03;2021-04-06;14;8;22;21458;18963;29;40421
03;2021-04-06;12;7;19;21276;18326;39;39602
03;2021-04-06;6;11;17;18164;16593;49;34757
03;2021-04-06;9;11;20;13469;13557;59;27026
03;2021-04-06;4;4;8;8776;8670;69;17446
03;2021-04-06;0;2;2;3777;3591;79;7368
03;2021-04-06;0;1;1;1649;1072;89;2721
03;2021-04-06;1;0;1;485;184;90;669
03;2021-04-06;49;47;96;149547;141144;0;290691
04;2021-04-06;11;7;18;60314;61377;09;121691
04;2021-04-06;19;26;45;66065;68387;19;134452
04;2021-04-06;23;19;42;51059;47156;29;98215
04;2021-04-06;20;24;44;58788;45780;39;104568
04;2021-04-06;12;20;32;61408;52207;49;113615
04;2021-04-06;13;12;25;64838;60759;59;125597
04;2021-04-06;9;5;14;47008;42843;69;89851
04;2021-04-06;7;2;9;25509;21184;79;46693
04;2021-04-06;1;1;2;13168;7647;89;20815
04;2021-04-06;0;0;0;3209;1253;90;4462
04;2021-04-06;115;116;231;451366;408593;0;859959
05;2021-04-06;0;0;0;362.366008612902;341.338819562748;09;703.704828175651
05;2021-04-06;0;0;0;353.376145114279;370.349735405642;19;723.725880519921
05;2021-04-06;0;0;0;218.593559489256;256.539602589476;29;475.133162078732
05;2021-04-06;0;0;0;404.225408693299;360.321910454353;39;764.547319147651
05;2021-04-06;0;0;0;520.067953604221;497.108383964256;49;1017.17633756848
05;2021-04-06;0;0;0;468.146063921917;510.087601910415;59;978.233665832332
05;2021-04-06;0;0;0;340.368470050554;334.366842191253;69;674.735312241807
05;2021-04-06;0;0;0;212.598666888387;192.597753227106;79;405.196420115493
05;2021-04-06;0;0;0;148.727797095705;61.8681715431829;89;210.595968638888
05;2021-04-06;0;0;0;32.9601271090696;10.9909785719784;90;43.9511056810479
05;2021-04-06;0;0;0;3061.43020057959;2935.56979942041;0;5997
06;2021-04-06;0;1;1;42583;42380;09;84963
06;2021-04-06;7;2;9;33369;31925;19;65294
06;2021-04-06;2;1;3;21571;15080;29;36651
06;2021-04-06;2;2;4;21550;16147;39;37697
06;2021-04-06;5;3;8;14193;13939;49;28132
06;2021-04-06;0;1;1;7171;7597;59;14768
06;2021-04-06;2;0;2;3629;4117;69;7746
06;2021-04-06;0;0;0;1577;1457;79;3034
06;2021-04-06;0;0;0;531;474;89;1005
06;2021-04-06;0;0;0;88;93;90;181
06;2021-04-06;18;10;28;146262;133209;0;279471
07;2021-04-06;0;0;0;485;549;09;1034
07;2021-04-06;1;0;1;403;432;19;835
07;2021-04-06;1;0;1;764;841;29;1605
07;2021-04-06;1;1;2;824;928;39;1752
07;2021-04-06;0;2;2;788;1020;49;1808
07;2021-04-06;1;0;1;678;870;59;1548
07;2021-04-06;1;0;1;360;382;69;742
07;2021-04-06;0;0;0;231;190;79;421
07;2021-04-06;0;0;0;114;67;89;181
07;2021-04-06;0;0;0;24;11;90;35
07;2021-04-06;5;3;8;4671;5290;0;9961
08;2021-04-06;0;0;0;2715.22592983026;2997.75551488675;09;5712.98144471701
08;2021-04-06;0;0;0;2778.51901080978;3160.9156459093;19;5939.43465671908
08;2021-04-06;0;0;0;2080.8882988764;1718.16634315323;29;3799.05464202964
08;2021-04-06;0;0;0;2701.8582062647;1896.52641413317;39;4598.38462039786
08;2021-04-06;0;0;0;3151.45861023308;2460.52498233809;49;5611.98359257117
08;2021-04-06;0;0;0;2620.29868333099;2422.23566154656;59;5042.53434487755
08;2021-04-06;0;0;0;1621.44173420671;1438.58325779464;69;3060.02499200135
08;2021-04-06;0;0;0;626.575909335673;526.358467843651;79;1152.93437717932
08;2021-04-06;0;0;0;205.018522985054;140.993639349697;89;346.012162334751
08;2021-04-06;0;0;0;50.0325684687745;20.62259870351;90;70.6551671722846
08;2021-04-06;0;0;0;18551.3174743414;16782.6825256586;0;35334
11;2021-04-06;380;390;829;783071;811785;09;1594856
11;2021-04-06;1045;1070;2204;761456;784653;19;1546109
11;2021-04-06;1601;1482;3103;850145;801772;29;1651917
11;2021-04-06;1809;1565;3396;914360;843488;39;1757848
11;2021-04-06;1681;1598;3300;845609;826202;49;1671811
11;2021-04-06;1317;1270;2600;793566;745070;59;1538636
11;2021-04-06;666;632;1304;628649;549192;69;1177841
11;2021-04-06;312;283;597;434606;358356;79;792962
11;2021-04-06;146;90;237;261425;162933;89;424358
11;2021-04-06;76;33;109;89253;32619;90;121872
11;2021-04-06;9035;8419;17688;6362140;5916070;0;12278210
24;2021-04-06;32;38;76;139720;144686;09;284406
24;2021-04-06;106;135;246;152979;161185;19;314164
24;2021-04-06;151;119;271;122237;126536;29;248773
24;2021-04-06;144;122;266;150359;142009;39;292368
24;2021-04-06;177;139;317;161829;158758;49;320587
24;2021-04-06;146;148;294;172552;168011;59;340563
24;2021-04-06;91;85;176;172509;158177;69;330686
24;2021-04-06;51;46;97;129428;110593;79;240021
24;2021-04-06;31;15;46;87342;56882;89;144224
24;2021-04-06;17;5;22;31210;12071;90;43281
24;2021-04-06;946;852;1811;1320165;1238908;0;2559073
27;2021-04-06;49;41;90;143373;149679;09;293052
27;2021-04-06;176;134;311;160962;173003;19;333965
27;2021-04-06;200;159;359;133746;142254;29;276000
27;2021-04-06;171;157;328;160004;155407;39;315411
27;2021-04-06;181;190;371;172333;169564;49;341897
27;2021-04-06;165;199;364;189979;183788;59;373767
27;2021-04-06;127;136;263;192591;178206;69;370797
27;2021-04-06;68;68;136;146876;127546;79;274422
27;2021-04-06;31;22;53;96896;61575;89;158471
27;2021-04-06;24;7;31;33148;12109;90;45257
27;2021-04-06;1192;1113;2306;1429908;1353131;0;2783039
28;2021-04-06;54;73;134;180735;186856;09;367591
28;2021-04-06;190;191;387;200125;213621;19;413746
28;2021-04-06;220;212;433;168922;173007;29;341929
28;2021-04-06;207;199;406;196628;188487;39;385115
28;2021-04-06;243;209;452;205396;201699;49;407095
28;2021-04-06;194;187;381;222002;213866;59;435868
28;2021-04-06;151;152;304;224688;203758;69;428446
28;2021-04-06;65;61;126;163192;135543;79;298735
28;2021-04-06;40;21;61;109691;65377;89;175068
28;2021-04-06;21;10;31;37222;12685;90;49907
28;2021-04-06;1385;1316;2716;1708601;1594899;0;3303500
32;2021-04-06;170;167;337;358062;373689;09;731751
32;2021-04-06;435;424;862;387045;406742;19;793787
32;2021-04-06;566;510;1078;342304;348587;29;690891
32;2021-04-06;563;478;1042;382485;369972;39;752457
32;2021-04-06;539;480;1019;382510;376716;49;759226
32;2021-04-06;453;439;893;386937;376527;59;763464
32;2021-04-06;317;233;550;371211;330938;69;702149
32;2021-04-06;150;127;277;250542;201459;79;452001
32;2021-04-06;127;61;188;163399;89786;89;253185
32;2021-04-06;42;22;64;48384;15367;90;63751
32;2021-04-06;3363;2943;6313;3072879;2889783;0;5962662
44;2021-04-06;89;124;214;291525;306839;09;598364
44;2021-04-06;311;313;626;320255;339504;19;659759
44;2021-04-06;379;345;725;302020;314428;29;616448
44;2021-04-06;361;327;690;342222;333292;39;675514
44;2021-04-06;407;392;801;349727;344491;49;694218
44;2021-04-06;333;342;677;381371;373239;59;754610
44;2021-04-06;214;217;432;367165;335850;69;703015
44;2021-04-06;109;106;217;250387;215436;79;465823
44;2021-04-06;62;47;111;170825;105192;89;276017
44;2021-04-06;25;11;36;51248;16731;90;67979
44;2021-04-06;2290;2225;4530;2826745;2685002;0;5511747
52;2021-04-06;62;56;122;213594;223900;09;437494
52;2021-04-06;155;153;311;240818;255197;19;496015
52;2021-04-06;194;197;391;197010;200630;29;397640
52;2021-04-06;178;144;322;231204;224885;39;456089
52;2021-04-06;177;186;363;243874;243418;49;487292
52;2021-04-06;173;160;333;244100;239116;59;483216
52;2021-04-06;125;115;240;241796;221345;69;463141
52;2021-04-06;53;64;117;177805;149903;79;327708
52;2021-04-06;26;22;48;119561;75822;89;195383
52;2021-04-06;16;7;23;42559;15260;90;57819
52;2021-04-06;1159;1104;2270;1952321;1849476;0;3801797
53;2021-04-06;37;41;78;173813;182358;09;356171
53;2021-04-06;118;132;250;202720;214740;19;417460
53;2021-04-06;141;130;274;163116;173196;29;336312
53;2021-04-06;122;87;209;190526;187674;39;378200
53;2021-04-06;121;119;240;212098;212015;49;424113
53;2021-04-06;98;104;202;223699;219176;59;442875
53;2021-04-06;82;50;132;227435;209274;69;436709
53;2021-04-06;33;27;60;169992;140910;79;310902
53;2021-04-06;9;10;19;118117;69883;89;188000
53;2021-04-06;7;11;18;37370;12267;90;49637
53;2021-04-06;768;712;1483;1718886;1621493;0;3340379
75;2021-04-06;59;64;124;293104;305291;09;598395
75;2021-04-06;214;209;428;337141;357785;19;694926
75;2021-04-06;268;273;542;295024;300618;29;595642
75;2021-04-06;223;207;430;347871;331233;39;679104
75;2021-04-06;284;254;538;384742;372771;49;757513
75;2021-04-06;254;229;483;413361;390880;59;804241
75;2021-04-06;141;145;286;425623;384060;69;809683
75;2021-04-06;89;82;171;325086;276298;79;601384
75;2021-04-06;49;22;71;213986;139308;89;353294
75;2021-04-06;24;11;35;77600;28200;90;105800
75;2021-04-06;1605;1497;3109;3113538;2886444;0;5999982
76;2021-04-06;69;80;153;305956;318589;09;624545
76;2021-04-06;269;277;551;338942;356969;19;695911
76;2021-04-06;352;340;696;316210;319570;29;635780
76;2021-04-06;345;329;675;356758;337587;39;694345
76;2021-04-06;390;351;742;376541;363812;49;740353
76;2021-04-06;367;311;678;402608;383750;59;786358
76;2021-04-06;221;200;422;394889;358997;69;753886
76;2021-04-06;123;106;229;308664;263806;79;572470
76;2021-04-06;84;42;126;195838;129272;89;325110
76;2021-04-06;50;16;66;69372;26728;90;96100
76;2021-04-06;2270;2054;4340;3065778;2859080;0;5924858
84;2021-04-06;132;133;265;459549;481088;09;940637
84;2021-04-06;555;544;1101;487711;511905;19;999616
84;2021-04-06;599;562;1162;443824;451094;29;894918
84;2021-04-06;643;567;1210;512522;493262;39;1005784
84;2021-04-06;696;571;1268;520248;515106;49;1035354
84;2021-04-06;583;539;1122;529611;514848;59;1044459
84;2021-04-06;351;274;625;486720;439940;69;926660
84;2021-04-06;206;179;385;372151;315211;79;687362
84;2021-04-06;105;85;190;237198;150524;89;387722
84;2021-04-06;59;17;76;81185;28680;90;109865
84;2021-04-06;3929;3471;7404;4130719;3901658;0;8032377
93;2021-04-06;91;90;181;268834;283093;09;551927
93;2021-04-06;351;342;695;280751;296087;19;576838
93;2021-04-06;470;455;926;254404;255552;29;509956
93;2021-04-06;513;434;949;310704;288398;39;599102
93;2021-04-06;528;434;962;325559;305827;49;631386
93;2021-04-06;489;425;918;353104;325389;59;678493
93;2021-04-06;280;283;563;336327;296459;69;632786
93;2021-04-06;127;140;267;279820;229699;79;509519
93;2021-04-06;79;83;162;171274;113716;89;284990
93;2021-04-06;27;9;36;58896;21758;90;80654
93;2021-04-06;2956;2696;5661;2639673;2415978;0;5055651
94;2021-04-06;1;6;7;16311;17433;09;33744
94;2021-04-06;3;4;8;16679;18132;19;34811
94;2021-04-06;8;7;15;16782;16579;29;33361
94;2021-04-06;7;11;18;23044;20580;39;43624
94;2021-04-06;7;9;16;23065;22140;49;45205
94;2021-04-06;10;9;19;24549;23421;59;47970
94;2021-04-06;7;10;17;23212;21883;69;45095
94;2021-04-06;3;5;8;19544;17141;79;36685
94;2021-04-06;5;4;9;11227;8178;89;19405
94;2021-04-06;1;0;1;3332;1447;90;4779
94;2021-04-06;52;65;118;177745;166934;0;344679
01;2021-04-07;1;1;2;19979;20155;09;40134
01;2021-04-07;5;1;6;24994;25489;19;50483
01;2021-04-07;9;8;17;17868;16690;29;34558
01;2021-04-07;15;6;21;22328;14821;39;37149
01;2021-04-07;18;9;27;28652;20276;49;48928
01;2021-04-07;8;9;17;33264;27260;59;60524
01;2021-04-07;9;10;19;27135;23978;69;51113
01;2021-04-07;5;4;9;18401;14661;79;33062
01;2021-04-07;1;2;3;9633;6375;89;16008
01;2021-04-07;0;0;0;3410;1510;90;4920
01;2021-04-07;71;50;121;205664;171215;0;376879
02;2021-04-07;4;4;8;16881;17110;09;33991
02;2021-04-07;6;2;8;21410;21604;19;43014
02;2021-04-07;8;13;21;16017;15479;29;31496
02;2021-04-07;11;10;21;19825;14455;39;34280
02;2021-04-07;16;14;30;24719;18248;49;42967
02;2021-04-07;26;18;44;34361;28310;59;62671
02;2021-04-07;19;17;36;28061;24495;69;52556
02;2021-04-07;4;8;12;18231;15278;79;33509
02;2021-04-07;2;0;2;11090;7677;89;18767
02;2021-04-07;2;0;2;3992;1506;90;5498
02;2021-04-07;98;86;184;194587;164162;0;358749
03;2021-04-07;3;2;5;31123;30920;09;62043
03;2021-04-07;5;2;7;29370;29268;19;58638
03;2021-04-07;7;11;18;21458;18963;29;40421
03;2021-04-07;8;8;16;21276;18326;39;39602
03;2021-04-07;14;6;20;18164;16593;49;34757
03;2021-04-07;6;2;8;13469;13557;59;27026
03;2021-04-07;8;3;11;8776;8670;69;17446
03;2021-04-07;1;1;2;3777;3591;79;7368
03;2021-04-07;1;0;1;1649;1072;89;2721
03;2021-04-07;0;0;0;485;184;90;669
03;2021-04-07;53;35;88;149547;141144;0;290691
04;2021-04-07;15;12;27;60314;61377;09;121691
04;2021-04-07;25;20;45;66065;68387;19;134452
04;2021-04-07;24;17;41;51059;47156;29;98215
04;2021-04-07;22;15;37;58788;45780;39;104568
04;2021-04-07;23;15;38;61408;52207;49;113615
04;2021-04-07;13;11;24;64838;60759;59;125597
04;2021-04-07;4;5;9;47008;42843;69;89851
04;2021-04-07;3;5;8;25509;21184;79;46693
04;2021-04-07;2;1;3;13168;7647;89;20815
04;2021-04-07;1;0;1;3209;1253;90;4462
04;2021-04-07;132;101;233;451366;408593;0;859959
05;2021-04-07;0;0;0;362.366008612902;341.338819562748;09;703.704828175651
05;2021-04-07;0;0;0;353.376145114279;370.349735405642;19;723.725880519921
05;2021-04-07;0;0;0;218.593559489256;256.539602589476;29;475.133162078732
05;2021-04-07;0;0;0;404.225408693299;360.321910454353;39;764.547319147651
05;2021-04-07;0;0;0;520.067953604221;497.108383964256;49;1017.17633756848
05;2021-04-07;0;0;0;468.146063921917;510.087601910415;59;978.233665832332
05;2021-04-07;0;0;0;340.368470050554;334.366842191253;69;674.735312241807
05;2021-04-07;0;0;0;212.598666888387;192.597753227106;79;405.196420115493
05;2021-04-07;0;0;0;148.727797095705;61.8681715431829;89;210.595968638888
05;2021-04-07;0;0;0;32.9601271090696;10.9909785719784;90;43.9511056810479
05;2021-04-07;0;0;0;3061.43020057959;2935.56979942041;0;5997
06;2021-04-07;2;0;2;42583;42380;09;84963
06;2021-04-07;5;1;6;33369;31925;19;65294
06;2021-04-07;2;2;4;21571;15080;29;36651
06;2021-04-07;2;3;5;21550;16147;39;37697
06;2021-04-07;3;2;5;14193;13939;49;28132
06;2021-04-07;0;2;2;7171;7597;59;14768
06;2021-04-07;1;0;1;3629;4117;69;7746
06;2021-04-07;0;0;0;1577;1457;79;3034
06;2021-04-07;0;0;0;531;474;89;1005
06;2021-04-07;0;0;0;88;93;90;181
06;2021-04-07;15;10;25;146262;133209;0;279471
07;2021-04-07;0;0;0;485;549;09;1034
07;2021-04-07;0;0;0;403;432;19;835
07;2021-04-07;1;1;2;764;841;29;1605
07;2021-04-07;1;0;1;824;928;39;1752
07;2021-04-07;0;0;0;788;1020;49;1808
07;2021-04-07;0;0;0;678;870;59;1548
07;2021-04-07;0;0;0;360;382;69;742
07;2021-04-07;1;0;1;231;190;79;421
07;2021-04-07;0;0;0;114;67;89;181
07;2021-04-07;0;0;0;24;11;90;35
07;2021-04-07;3;1;4;4671;5290;0;9961
08;2021-04-07;0;0;0;2715.22592983026;2997.75551488675;09;5712.98144471701
08;2021-04-07;0;0;0;2778.51901080978;3160.9156459093;19;5939.43465671908
08;2021-04-07;0;0;0;2080.8882988764;1718.16634315323;29;3799.05464202964
08;2021-04-07;0;0;0;2701.8582062647;1896.52641413317;39;4598.38462039786
08;2021-04-07;1;0;1;3151.45861023308;2460.52498233809;49;5611.98359257117
08;2021-04-07;0;0;0;2620.29868333099;2422.23566154656;59;5042.53434487755
08;2021-04-07;0;0;0;1621.44173420671;1438.58325779464;69;3060.02499200135
08;2021-04-07;0;0;0;626.575909335673;526.358467843651;79;1152.93437717932
08;2021-04-07;0;0;0;205.018522985054;140.993639349697;89;346.012162334751
08;2021-04-07;0;0;0;50.0325684687745;20.62259870351;90;70.6551671722846
08;2021-04-07;1;0;1;18551.3174743414;16782.6825256586;0;35334
11;2021-04-07;259;289;589;783071;811785;09;1594856
11;2021-04-07;865;810;1754;761456;784653;19;1546109
11;2021-04-07;1348;1163;2521;850145;801772;29;1651917
11;2021-04-07;1377;1196;2582;914360;843488;39;1757848
11;2021-04-07;1234;1152;2399;845609;826202;49;1671811
11;2021-04-07;970;873;1861;793566;745070;59;1538636
11;2021-04-07;473;468;951;628649;549192;69;1177841
11;2021-04-07;239;195;435;434606;358356;79;792962
11;2021-04-07;125;70;196;261425;162933;89;424358
11;2021-04-07;59;27;87;89253;32619;90;121872
11;2021-04-07;6952;6246;13382;6362140;5916070;0;12278210
24;2021-04-07;19;34;57;139720;144686;09;284406
24;2021-04-07;89;86;181;152979;161185;19;314164
24;2021-04-07;146;108;254;122237;126536;29;248773
24;2021-04-07;127;100;227;150359;142009;39;292368
24;2021-04-07;132;106;238;161829;158758;49;320587
24;2021-04-07;113;120;234;172552;168011;59;340563
24;2021-04-07;78;57;135;172509;158177;69;330686
24;2021-04-07;40;44;84;129428;110593;79;240021
24;2021-04-07;23;11;34;87342;56882;89;144224
24;2021-04-07;13;8;21;31210;12071;90;43281
24;2021-04-07;780;674;1465;1320165;1238908;0;2559073
27;2021-04-07;36;25;61;143373;149679;09;293052
27;2021-04-07;126;135;261;160962;173003;19;333965
27;2021-04-07;138;142;280;133746;142254;29;276000
27;2021-04-07;121;123;244;160004;155407;39;315411
27;2021-04-07;128;113;241;172333;169564;49;341897
27;2021-04-07;112;122;234;189979;183788;59;373767
27;2021-04-07;92;85;177;192591;178206;69;370797
27;2021-04-07;45;46;91;146876;127546;79;274422
27;2021-04-07;30;25;55;96896;61575;89;158471
27;2021-04-07;20;8;28;33148;12109;90;45257
27;2021-04-07;848;824;1672;1429908;1353131;0;2783039
28;2021-04-07;45;48;97;180735;186856;09;367591
28;2021-04-07;173;156;333;200125;213621;19;413746
28;2021-04-07;173;164;337;168922;173007;29;341929
28;2021-04-07;181;161;343;196628;188487;39;385115
28;2021-04-07;177;156;334;205396;201699;49;407095
28;2021-04-07;146;136;282;222002;213866;59;435868
28;2021-04-07;91;94;185;224688;203758;69;428446
28;2021-04-07;50;47;98;163192;135543;79;298735
28;2021-04-07;43;27;70;109691;65377;89;175068
28;2021-04-07;11;7;18;37222;12685;90;49907
28;2021-04-07;1090;998;2099;1708601;1594899;0;3303500
32;2021-04-07;108;121;231;358062;373689;09;731751
32;2021-04-07;334;322;656;387045;406742;19;793787
32;2021-04-07;426;381;814;342304;348587;29;690891
32;2021-04-07;408;335;744;382485;369972;39;752457
32;2021-04-07;356;311;668;382510;376716;49;759226
32;2021-04-07;305;307;612;386937;376527;59;763464
32;2021-04-07;184;197;381;371211;330938;69;702149
32;2021-04-07;115;124;239;250542;201459;79;452001
32;2021-04-07;80;48;128;163399;89786;89;253185
32;2021-04-07;43;10;53;48384;15367;90;63751
32;2021-04-07;2362;2156;4529;3072879;2889783;0;5962662
44;2021-04-07;62;82;145;291525;306839;09;598364
44;2021-04-07;185;221;409;320255;339504;19;659759
44;2021-04-07;250;233;483;302020;314428;29;616448
44;2021-04-07;289;236;526;342222;333292;39;675514
44;2021-04-07;241;253;496;349727;344491;49;694218
44;2021-04-07;198;214;414;381371;373239;59;754610
44;2021-04-07;143;130;273;367165;335850;69;703015
44;2021-04-07;73;75;150;250387;215436;79;465823
44;2021-04-07;61;34;96;170825;105192;89;276017
44;2021-04-07;11;7;18;51248;16731;90;67979
44;2021-04-07;1513;1485;3010;2826745;2685002;0;5511747
52;2021-04-07;42;54;99;213594;223900;09;437494
52;2021-04-07;120;155;278;240818;255197;19;496015
52;2021-04-07;159;160;319;197010;200630;29;397640
52;2021-04-07;143;109;252;231204;224885;39;456089
52;2021-04-07;160;152;312;243874;243418;49;487292
52;2021-04-07;123;138;261;244100;239116;59;483216
52;2021-04-07;80;81;161;241796;221345;69;463141
52;2021-04-07;50;47;97;177805;149903;79;327708
52;2021-04-07;39;23;62;119561;75822;89;195383
52;2021-04-07;16;6;22;42559;15260;90;57819
52;2021-04-07;933;925;1864;1952321;1849476;0;3801797
53;2021-04-07;25;37;62;173813;182358;09;356171
53;2021-04-07;105;119;224;202720;214740;19;417460
53;2021-04-07;105;118;224;163116;173196;29;336312
53;2021-04-07;110;75;185;190526;187674;39;378200
53;2021-04-07;98;100;198;212098;212015;49;424113
53;2021-04-07;71;78;149;223699;219176;59;442875
53;2021-04-07;48;43;91;227435;209274;69;436709
53;2021-04-07;24;32;56;169992;140910;79;310902
53;2021-04-07;21;10;31;118117;69883;89;188000
53;2021-04-07;6;7;13;37370;12267;90;49637
53;2021-04-07;613;619;1233;1718886;1621493;0;3340379
75;2021-04-07;53;57;111;293104;305291;09;598395
75;2021-04-07;167;170;338;337141;357785;19;694926
75;2021-04-07;183;171;354;295024;300618;29;595642
75;2021-04-07;183;143;327;347871;331233;39;679104
75;2021-04-07;193;163;356;384742;372771;49;757513
75;2021-04-07;168;169;337;413361;390880;59;804241
75;2021-04-07;108;117;225;425623;384060;69;809683
75;2021-04-07;65;56;121;325086;276298;79;601384
75;2021-04-07;36;20;56;213986;139308;89;353294
75;2021-04-07;26;12;38;77600;28200;90;105800
75;2021-04-07;1183;1078;2264;3113538;2886444;0;5999982
76;2021-04-07;52;51;108;305956;318589;09;624545
76;2021-04-07;197;201;406;338942;356969;19;695911
76;2021-04-07;283;240;523;316210;319570;29;635780
76;2021-04-07;239;233;472;356758;337587;39;694345
76;2021-04-07;263;249;513;376541;363812;49;740353
76;2021-04-07;229;224;453;402608;383750;59;786358
76;2021-04-07;164;149;313;394889;358997;69;753886
76;2021-04-07;87;78;165;308664;263806;79;572470
76;2021-04-07;46;37;83;195838;129272;89;325110
76;2021-04-07;35;12;47;69372;26728;90;96100
76;2021-04-07;1596;1475;3085;3065778;2859080;0;5924858
84;2021-04-07;90;122;212;459549;481088;09;940637
84;2021-04-07;419;413;841;487711;511905;19;999616
84;2021-04-07;475;411;886;443824;451094;29;894918
84;2021-04-07;472;411;883;512522;493262;39;1005784
84;2021-04-07;506;412;918;520248;515106;49;1035354
84;2021-04-07;385;415;800;529611;514848;59;1044459
84;2021-04-07;236;226;462;486720;439940;69;926660
84;2021-04-07;142;115;257;372151;315211;79;687362
84;2021-04-07;81;54;135;237198;150524;89;387722
84;2021-04-07;38;19;57;81185;28680;90;109865
84;2021-04-07;2844;2599;5452;4130719;3901658;0;8032377
93;2021-04-07;66;62;129;268834;283093;09;551927
93;2021-04-07;243;241;485;280751;296087;19;576838
93;2021-04-07;324;264;588;254404;255552;29;509956
93;2021-04-07;359;284;643;310704;288398;39;599102
93;2021-04-07;332;322;654;325559;305827;49;631386
93;2021-04-07;320;264;586;353104;325389;59;678493
93;2021-04-07;225;191;416;336327;296459;69;632786
93;2021-04-07;91;88;179;279820;229699;79;509519
93;2021-04-07;69;44;113;171274;113716;89;284990
93;2021-04-07;33;16;49;58896;21758;90;80654
93;2021-04-07;2062;1777;3843;2639673;2415978;0;5055651
94;2021-04-07;2;1;3;16311;17433;09;33744
94;2021-04-07;1;7;8;16679;18132;19;34811
94;2021-04-07;2;7;9;16782;16579;29;33361
94;2021-04-07;8;10;18;23044;20580;39;43624
94;2021-04-07;7;6;13;23065;22140;49;45205
94;2021-04-07;10;7;17;24549;23421;59;47970
94;2021-04-07;7;3;10;23212;21883;69;45095
94;2021-04-07;0;4;4;19544;17141;79;36685
94;2021-04-07;0;1;1;11227;8178;89;19405
94;2021-04-07;0;0;0;3332;1447;90;4779
94;2021-04-07;37;46;83;177745;166934;0;344679
01;2021-04-08;3;1;4;19979;20155;09;40134
01;2021-04-08;11;10;21;24994;25489;19;50483
01;2021-04-08;8;6;14;17868;16690;29;34558
01;2021-04-08;13;9;22;22328;14821;39;37149
01;2021-04-08;15;8;23;28652;20276;49;48928
01;2021-04-08;21;12;33;33264;27260;59;60524
01;2021-04-08;12;10;22;27135;23978;69;51113
01;2021-04-08;10;5;15;18401;14661;79;33062
01;2021-04-08;3;0;3;9633;6375;89;16008
01;2021-04-08;0;1;1;3410;1510;90;4920
01;2021-04-08;96;62;158;205664;171215;0;376879
02;2021-04-08;1;4;5;16881;17110;09;33991
02;2021-04-08;10;14;24;21410;21604;19;43014
02;2021-04-08;12;7;19;16017;15479;29;31496
02;2021-04-08;20;9;29;19825;14455;39;34280
02;2021-04-08;16;10;26;24719;18248;49;42967
02;2021-04-08;35;19;54;34361;28310;59;62671
02;2021-04-08;18;11;29;28061;24495;69;52556
02;2021-04-08;6;4;10;18231;15278;79;33509
02;2021-04-08;5;6;11;11090;7677;89;18767
02;2021-04-08;3;1;4;3992;1506;90;5498
02;2021-04-08;126;85;211;194587;164162;0;358749
03;2021-04-08;1;2;3;31123;30920;09;62043
03;2021-04-08;6;6;12;29370;29268;19;58638
03;2021-04-08;11;6;17;21458;18963;29;40421
03;2021-04-08;11;8;19;21276;18326;39;39602
03;2021-04-08;6;8;14;18164;16593;49;34757
03;2021-04-08;7;2;9;13469;13557;59;27026
03;2021-04-08;5;5;10;8776;8670;69;17446
03;2021-04-08;2;2;4;3777;3591;79;7368
03;2021-04-08;0;0;0;1649;1072;89;2721
03;2021-04-08;0;0;0;485;184;90;669
03;2021-04-08;49;39;88;149547;141144;0;290691
04;2021-04-08;10;7;17;60314;61377;09;121691
04;2021-04-08;8;16;24;66065;68387;19;134452
04;2021-04-08;18;11;29;51059;47156;29;98215
04;2021-04-08;12;10;22;58788;45780;39;104568
04;2021-04-08;17;7;24;61408;52207;49;113615
04;2021-04-08;8;8;16;64838;60759;59;125597
04;2021-04-08;4;4;8;47008;42843;69;89851
04;2021-04-08;1;4;5;25509;21184;79;46693
04;2021-04-08;3;0;3;13168;7647;89;20815
04;2021-04-08;1;1;2;3209;1253;90;4462
04;2021-04-08;82;68;150;451366;408593;0;859959
05;2021-04-08;0;0;0;362.366008612902;341.338819562748;09;703.704828175651
05;2021-04-08;0;0;0;353.376145114279;370.349735405642;19;723.725880519921
05;2021-04-08;0;0;0;218.593559489256;256.539602589476;29;475.133162078732
05;2021-04-08;0;0;0;404.225408693299;360.321910454353;39;764.547319147651
05;2021-04-08;0;0;0;520.067953604221;497.108383964256;49;1017.17633756848
05;2021-04-08;0;0;0;468.146063921917;510.087601910415;59;978.233665832332
05;2021-04-08;1;0;1;340.368470050554;334.366842191253;69;674.735312241807
05;2021-04-08;0;0;0;212.598666888387;192.597753227106;79;405.196420115493
05;2021-04-08;0;0;0;148.727797095705;61.8681715431829;89;210.595968638888
05;2021-04-08;0;0;0;32.9601271090696;10.9909785719784;90;43.9511056810479
05;2021-04-08;1;0;1;3061.43020057959;2935.56979942041;0;5997
06;2021-04-08;1;0;1;42583;42380;09;84963
06;2021-04-08;1;1;2;33369;31925;19;65294
06;2021-04-08;2;0;2;21571;15080;29;36651
06;2021-04-08;0;1;1;21550;16147;39;37697
06;2021-04-08;0;2;2;14193;13939;49;28132
06;2021-04-08;1;1;2;7171;7597;59;14768
06;2021-04-08;0;0;0;3629;4117;69;7746
06;2021-04-08;0;1;1;1577;1457;79;3034
06;2021-04-08;0;0;0;531;474;89;1005
06;2021-04-08;0;0;0;88;93;90;181
06;2021-04-08;5;6;11;146262;133209;0;279471
07;2021-04-08;0;0;0;485;549;09;1034
07;2021-04-08;0;0;0;403;432;19;835
07;2021-04-08;0;0;0;764;841;29;1605
07;2021-04-08;0;1;1;824;928;39;1752
07;2021-04-08;1;1;2;788;1020;49;1808
07;2021-04-08;0;0;0;678;870;59;1548
07;2021-04-08;3;0;3;360;382;69;742
07;2021-04-08;0;0;0;231;190;79;421
07;2021-04-08;0;1;1;114;67;89;181
07;2021-04-08;0;0;0;24;11;90;35
07;2021-04-08;4;3;7;4671;5290;0;9961
08;2021-04-08;0;0;0;2715.22592983026;2997.75551488675;09;5712.98144471701
08;2021-04-08;0;0;0;2778.51901080978;3160.9156459093;19;5939.43465671908
08;2021-04-08;0;0;0;2080.8882988764;1718.16634315323;29;3799.05464202964
08;2021-04-08;0;0;0;2701.8582062647;1896.52641413317;39;4598.38462039786
08;2021-04-08;1;0;1;3151.45861023308;2460.52498233809;49;5611.98359257117
08;2021-04-08;0;0;0;2620.29868333099;2422.23566154656;59;5042.53434487755
08;2021-04-08;0;0;0;1621.44173420671;1438.58325779464;69;3060.02499200135
08;2021-04-08;1;0;1;626.575909335673;526.358467843651;79;1152.93437717932
08;2021-04-08;0;0;0;205.018522985054;140.993639349697;89;346.012162334751
08;2021-04-08;0;0;0;50.0325684687745;20.62259870351;90;70.6551671722846
08;2021-04-08;2;0;2;18551.3174743414;16782.6825256586;0;35334
11;2021-04-08;254;269;558;783071;811785;09;1594856
11;2021-04-08;801;689;1553;761456;784653;19;1546109
11;2021-04-08;1280;1184;2469;850145;801772;29;1651917
11;2021-04-08;1273;1147;2428;914360;843488;39;1757848
11;2021-04-08;1097;993;2096;845609;826202;49;1671811
11;2021-04-08;822;837;1667;793566;745070;59;1538636
11;2021-04-08;462;406;870;628649;549192;69;1177841
11;2021-04-08;205;201;406;434606;358356;79;792962
11;2021-04-08;116;74;190;261425;162933;89;424358
11;2021-04-08;44;21;65;89253;32619;90;121872
11;2021-04-08;6355;5824;12311;6362140;5916070;0;12278210
24;2021-04-08;30;22;55;139720;144686;09;284406
24;2021-04-08;94;96;193;152979;161185;19;314164
24;2021-04-08;116;104;221;122237;126536;29;248773
24;2021-04-08;131;106;237;150359;142009;39;292368
24;2021-04-08;141;109;250;161829;158758;49;320587
24;2021-04-08;105;124;229;172552;168011;59;340563
24;2021-04-08;85;74;159;172509;158177;69;330686
24;2021-04-08;31;39;70;129428;110593;79;240021
24;2021-04-08;25;17;42;87342;56882;89;144224
24;2021-04-08;9;8;17;31210;12071;90;43281
24;2021-04-08;768;699;1474;1320165;1238908;0;2559073
27;2021-04-08;23;28;52;143373;149679;09;293052
27;2021-04-08;130;116;250;160962;173003;19;333965
27;2021-04-08;135;137;272;133746;142254;29;276000
27;2021-04-08;121;100;221;160004;155407;39;315411
27;2021-04-08;150;117;267;172333;169564;49;341897
27;2021-04-08;87;85;172;189979;183788;59;373767
27;2021-04-08;70;91;161;192591;178206;69;370797
27;2021-04-08;44;44;88;146876;127546;79;274422
27;2021-04-08;31;18;49;96896;61575;89;158471
27;2021-04-08;11;4;15;33148;12109;90;45257
27;2021-04-08;802;740;1547;1429908;1353131;0;2783039
28;2021-04-08;49;51;103;180735;186856;09;367591
28;2021-04-08;136;137;275;200125;213621;19;413746
28;2021-04-08;124;150;275;168922;173007;29;341929
28;2021-04-08;169;142;312;196628;188487;39;385115
28;2021-04-08;167;162;329;205396;201699;49;407095
28;2021-04-08;138;109;247;222002;213866;59;435868
28;2021-04-08;96;71;167;224688;203758;69;428446
28;2021-04-08;48;58;106;163192;135543;79;298735
28;2021-04-08;32;22;54;109691;65377;89;175068
28;2021-04-08;15;8;24;37222;12685;90;49907
28;2021-04-08;974;910;1892;1708601;1594899;0;3303500
32;2021-04-08;141;159;300;358062;373689;09;731751
32;2021-04-08;354;348;704;387045;406742;19;793787
32;2021-04-08;355;326;685;342304;348587;29;690891
32;2021-04-08;391;315;709;382485;369972;39;752457
32;2021-04-08;350;347;699;382510;376716;49;759226
32;2021-04-08;323;265;590;386937;376527;59;763464
32;2021-04-08;209;178;387;371211;330938;69;702149
32;2021-04-08;105;99;204;250542;201459;79;452001
32;2021-04-08;65;34;99;163399;89786;89;253185
32;2021-04-08;28;9;37;48384;15367;90;63751
32;2021-04-08;2323;2080;4416;3072879;2889783;0;5962662
44;2021-04-08;63;57;122;291525;306839;09;598364
44;2021-04-08;200;220;421;320255;339504;19;659759
44;2021-04-08;272;229;504;302020;314428;29;616448
44;2021-04-08;238;218;456;342222;333292;39;675514
44;2021-04-08;259;222;481;349727;344491;49;694218
44;2021-04-08;185;204;392;381371;373239;59;754610
44;2021-04-08;128;102;232;367165;335850;69;703015
44;2021-04-08;80;62;142;250387;215436;79;465823
44;2021-04-08;40;33;74;170825;105192;89;276017
44;2021-04-08;30;10;41;51248;16731;90;67979
44;2021-04-08;1496;1357;2866;2826745;2685002;0;5511747
52;2021-04-08;57;39;99;213594;223900;09;437494
52;2021-04-08;155;154;310;240818;255197;19;496015
52;2021-04-08;164;168;332;197010;200630;29;397640
52;2021-04-08;157;133;290;231204;224885;39;456089
52;2021-04-08;160;141;301;243874;243418;49;487292
52;2021-04-08;114;127;241;244100;239116;59;483216
52;2021-04-08;89;80;169;241796;221345;69;463141
52;2021-04-08;54;44;98;177805;149903;79;327708
52;2021-04-08;34;27;61;119561;75822;89;195383
52;2021-04-08;12;10;22;42559;15260;90;57819
52;2021-04-08;996;923;1923;1952321;1849476;0;3801797
53;2021-04-08;28;34;62;173813;182358;09;356171
53;2021-04-08;99;90;192;202720;214740;19;417460
53;2021-04-08;97;113;212;163116;173196;29;336312
53;2021-04-08;97;65;162;190526;187674;39;378200
53;2021-04-08;93;96;189;212098;212015;49;424113
53;2021-04-08;64;85;149;223699;219176;59;442875
53;2021-04-08;34;47;81;227435;209274;69;436709
53;2021-04-08;31;26;57;169992;140910;79;310902
53;2021-04-08;11;12;23;118117;69883;89;188000
53;2021-04-08;8;4;12;37370;12267;90;49637
53;2021-04-08;562;572;1140;1718886;1621493;0;3340379
75;2021-04-08;59;49;108;293104;305291;09;598395
75;2021-04-08;185;184;370;337141;357785;19;694926
75;2021-04-08;208;206;416;295024;300618;29;595642
75;2021-04-08;190;150;340;347871;331233;39;679104
75;2021-04-08;173;167;340;384742;372771;49;757513
75;2021-04-08;170;172;342;413361;390880;59;804241
75;2021-04-08;111;99;210;425623;384060;69;809683
75;2021-04-08;46;49;95;325086;276298;79;601384
75;2021-04-08;36;14;50;213986;139308;89;353294
75;2021-04-08;16;8;24;77600;28200;90;105800
75;2021-04-08;1195;1098;2296;3113538;2886444;0;5999982
76;2021-04-08;61;60;124;305956;318589;09;624545
76;2021-04-08;170;191;365;338942;356969;19;695911
76;2021-04-08;286;225;511;316210;319570;29;635780
76;2021-04-08;246;183;429;356758;337587;39;694345
76;2021-04-08;281;204;485;376541;363812;49;740353
76;2021-04-08;217;176;394;402608;383750;59;786358
76;2021-04-08;142;134;276;394889;358997;69;753886
76;2021-04-08;87;65;152;308664;263806;79;572470
76;2021-04-08;64;38;102;195838;129272;89;325110
76;2021-04-08;51;14;65;69372;26728;90;96100
76;2021-04-08;1606;1290;2904;3065778;2859080;0;5924858
84;2021-04-08;110;108;219;459549;481088;09;940637
84;2021-04-08;382;451;835;487711;511905;19;999616
84;2021-04-08;456;415;871;443824;451094;29;894918
84;2021-04-08;398;354;753;512522;493262;39;1005784
84;2021-04-08;461;355;816;520248;515106;49;1035354
84;2021-04-08;349;310;659;529611;514848;59;1044459
84;2021-04-08;219;211;430;486720;439940;69;926660
84;2021-04-08;129;126;255;372151;315211;79;687362
84;2021-04-08;75;58;133;237198;150524;89;387722
84;2021-04-08;31;8;39;81185;28680;90;109865
84;2021-04-08;2611;2396;5011;4130719;3901658;0;8032377
93;2021-04-08;61;64;127;268834;283093;09;551927
93;2021-04-08;231;207;443;280751;296087;19;576838
93;2021-04-08;291;276;568;254404;255552;29;509956
93;2021-04-08;306;235;541;310704;288398;39;599102
93;2021-04-08;282;257;541;325559;305827;49;631386
93;2021-04-08;250;270;522;353104;325389;59;678493
93;2021-04-08;163;144;308;336327;296459;69;632786
93;2021-04-08;113;90;203;279820;229699;79;509519
93;2021-04-08;69;47;116;171274;113716;89;284990
93;2021-04-08;19;11;30;58896;21758;90;80654
93;2021-04-08;1786;1601;3400;2639673;2415978;0;5055651
94;2021-04-08;2;3;5;16311;17433;09;33744
94;2021-04-08;7;4;11;16679;18132;19;34811
94;2021-04-08;8;1;9;16782;16579;29;33361
94;2021-04-08;8;5;13;23044;20580;39;43624
94;2021-04-08;9;8;17;23065;22140;49;45205
94;2021-04-08;4;4;8;24549;23421;59;47970
94;2021-04-08;0;5;5;23212;21883;69;45095
94;2021-04-08;2;2;4;19544;17141;79;36685
94;2021-04-08;5;1;6;11227;8178;89;19405
94;2021-04-08;1;0;1;3332;1447;90;4779
94;2021-04-08;46;33;79;177745;166934;0;344679
01;2021-04-09;1;1;2;19979;20155;09;40134
01;2021-04-09;5;4;9;24994;25489;19;50483
01;2021-04-09;11;9;20;17868;16690;29;34558
01;2021-04-09;8;4;12;22328;14821;39;37149
01;2021-04-09;12;10;22;28652;20276;49;48928
01;2021-04-09;17;16;33;33264;27260;59;60524
01;2021-04-09;10;7;17;27135;23978;69;51113
01;2021-04-09;5;4;9;18401;14661;79;33062
01;2021-04-09;2;2;4;9633;6375;89;16008
01;2021-04-09;1;0;1;3410;1510;90;4920
01;2021-04-09;72;57;129;205664;171215;0;376879
02;2021-04-09;5;3;8;16881;17110;09;33991
02;2021-04-09;6;7;13;21410;21604;19;43014
02;2021-04-09;11;10;21;16017;15479;29;31496
02;2021-04-09;20;8;28;19825;14455;39;34280
02;2021-04-09;18;14;32;24719;18248;49;42967
02;2021-04-09;19;23;42;34361;28310;59;62671
02;2021-04-09;13;16;29;28061;24495;69;52556
02;2021-04-09;9;8;17;18231;15278;79;33509
02;2021-04-09;1;1;2;11090;7677;89;18767
02;2021-04-09;0;1;1;3992;1506;90;5498
02;2021-04-09;102;91;193;194587;164162;0;358749
03;2021-04-09;1;3;4;31123;30920;09;62043
03;2021-04-09;4;2;6;29370;29268;19;58638
03;2021-04-09;7;11;18;21458;18963;29;40421
03;2021-04-09;8;8;16;21276;18326;39;39602
03;2021-04-09;4;4;8;18164;16593;49;34757
03;2021-04-09;4;5;9;13469;13557;59;27026
03;2021-04-09;6;2;8;8776;8670;69;17446
03;2021-04-09;2;0;2;3777;3591;79;7368
03;2021-04-09;1;0;1;1649;1072;89;2721
03;2021-04-09;0;0;0;485;184;90;669
03;2021-04-09;37;35;72;149547;141144;0;290691
04;2021-04-09;10;12;22;60314;61377;09;121691
04;2021-04-09;23;13;36;66065;68387;19;134452
04;2021-04-09;15;14;29;51059;47156;29;98215
04;2021-04-09;14;12;26;58788;45780;39;104568
04;2021-04-09;13;19;32;61408;52207;49;113615
04;2021-04-09;9;16;25;64838;60759;59;125597
04;2021-04-09;3;6;9;47008;42843;69;89851
04;2021-04-09;6;1;7;25509;21184;79;46693
04;2021-04-09;3;0;3;13168;7647;89;20815
04;2021-04-09;1;0;1;3209;1253;90;4462
04;2021-04-09;97;93;190;451366;408593;0;859959
05;2021-04-09;0;0;0;362.366008612902;341.338819562748;09;703.704828175651
05;2021-04-09;0;0;0;353.376145114279;370.349735405642;19;723.725880519921
05;2021-04-09;0;0;0;218.593559489256;256.539602589476;29;475.133162078732
05;2021-04-09;0;0;0;404.225408693299;360.321910454353;39;764.547319147651
05;2021-04-09;0;0;0;520.067953604221;497.108383964256;49;1017.17633756848
05;2021-04-09;0;0;0;468.146063921917;510.087601910415;59;978.233665832332
05;2021-04-09;0;0;0;340.368470050554;334.366842191253;69;674.735312241807
05;2021-04-09;0;0;0;212.598666888387;192.597753227106;79;405.196420115493
05;2021-04-09;0;0;0;148.727797095705;61.8681715431829;89;210.595968638888
05;2021-04-09;0;0;0;32.9601271090696;10.9909785719784;90;43.9511056810479
05;2021-04-09;0;0;0;3061.43020057959;2935.56979942041;0;5997
06;2021-04-09;2;0;2;42583;42380;09;84963
06;2021-04-09;6;6;12;33369;31925;19;65294
06;2021-04-09;5;6;12;21571;15080;29;36651
06;2021-04-09;3;2;5;21550;16147;39;37697
06;2021-04-09;3;2;5;14193;13939;49;28132
06;2021-04-09;3;1;4;7171;7597;59;14768
06;2021-04-09;0;0;0;3629;4117;69;7746
06;2021-04-09;0;0;0;1577;1457;79;3034
06;2021-04-09;0;0;0;531;474;89;1005
06;2021-04-09;0;0;0;88;93;90;181
06;2021-04-09;22;17;40;146262;133209;0;279471
07;2021-04-09;0;0;0;485;549;09;1034
07;2021-04-09;0;0;0;403;432;19;835
07;2021-04-09;0;0;0;764;841;29;1605
07;2021-04-09;0;0;0;824;928;39;1752
07;2021-04-09;0;0;0;788;1020;49;1808
07;2021-04-09;2;0;2;678;870;59;1548
07;2021-04-09;0;0;0;360;382;69;742
07;2021-04-09;0;0;0;231;190;79;421
07;2021-04-09;0;0;0;114;67;89;181
07;2021-04-09;0;0;0;24;11;90;35
07;2021-04-09;2;0;2;4671;5290;0;9961
08;2021-04-09;0;0;0;2715.22592983026;2997.75551488675;09;5712.98144471701
08;2021-04-09;0;0;0;2778.51901080978;3160.9156459093;19;5939.43465671908
08;2021-04-09;1;0;1;2080.8882988764;1718.16634315323;29;3799.05464202964
08;2021-04-09;0;0;0;2701.8582062647;1896.52641413317;39;4598.38462039786
08;2021-04-09;1;0;1;3151.45861023308;2460.52498233809;49;5611.98359257117
08;2021-04-09;0;0;0;2620.29868333099;2422.23566154656;59;5042.53434487755
08;2021-04-09;0;0;0;1621.44173420671;1438.58325779464;69;3060.02499200135
08;2021-04-09;0;0;0;626.575909335673;526.358467843651;79;1152.93437717932
08;2021-04-09;0;0;0;205.018522985054;140.993639349697;89;346.012162334751
08;2021-04-09;0;0;0;50.0325684687745;20.62259870351;90;70.6551671722846
08;2021-04-09;2;0;2;18551.3174743414;16782.6825256586;0;35334
11;2021-04-09;310;303;663;783071;811785;09;1594856
11;2021-04-09;830;745;1644;761456;784653;19;1546109
11;2021-04-09;1243;1103;2362;850145;801772;29;1651917
11;2021-04-09;1270;1089;2372;914360;843488;39;1757848
11;2021-04-09;1117;1023;2149;845609;826202;49;1671811
11;2021-04-09;839;821;1674;793566;745070;59;1538636
11;2021-04-09;518;461;986;628649;549192;69;1177841
11;2021-04-09;206;231;437;434606;358356;79;792962
11;2021-04-09;113;68;181;261425;162933;89;424358
11;2021-04-09;42;21;64;89253;32619;90;121872
11;2021-04-09;6488;5866;12535;6362140;5916070;0;12278210
24;2021-04-09;30;37;67;139720;144686;09;284406
24;2021-04-09;133;112;248;152979;161185;19;314164
24;2021-04-09;104;107;211;122237;126536;29;248773
24;2021-04-09;115;104;219;150359;142009;39;292368
24;2021-04-09;126;124;250;161829;158758;49;320587
24;2021-04-09;102;100;203;172552;168011;59;340563
24;2021-04-09;58;63;121;172509;158177;69;330686
24;2021-04-09;37;31;68;129428;110593;79;240021
24;2021-04-09;19;10;29;87342;56882;89;144224
24;2021-04-09;13;2;15;31210;12071;90;43281
24;2021-04-09;737;690;1431;1320165;1238908;0;2559073
27;2021-04-09;46;37;83;143373;149679;09;293052
27;2021-04-09;121;136;257;160962;173003;19;333965
27;2021-04-09;114;118;232;133746;142254;29;276000
27;2021-04-09;123;97;220;160004;155407;39;315411
27;2021-04-09;129;117;246;172333;169564;49;341897
27;2021-04-09;102;107;209;189979;183788;59;373767
27;2021-04-09;81;79;160;192591;178206;69;370797
27;2021-04-09;58;41;99;146876;127546;79;274422
27;2021-04-09;33;17;50;96896;61575;89;158471
27;2021-04-09;12;2;14;33148;12109;90;45257
27;2021-04-09;819;751;1570;1429908;1353131;0;2783039
28;2021-04-09;56;67;128;180735;186856;09;367591
28;2021-04-09;152;161;314;200125;213621;19;413746
28;2021-04-09;169;175;345;168922;173007;29;341929
28;2021-04-09;176;146;322;196628;188487;39;385115
28;2021-04-09;170;109;280;205396;201699;49;407095
28;2021-04-09;155;140;296;222002;213866;59;435868
28;2021-04-09;91;102;193;224688;203758;69;428446
28;2021-04-09;65;48;113;163192;135543;79;298735
28;2021-04-09;34;20;54;109691;65377;89;175068
28;2021-04-09;12;6;18;37222;12685;90;49907
28;2021-04-09;1080;974;2063;1708601;1594899;0;3303500
32;2021-04-09;135;136;271;358062;373689;09;731751
32;2021-04-09;388;339;733;387045;406742;19;793787
32;2021-04-09;377;386;767;342304;348587;29;690891
32;2021-04-09;373;352;725;382485;369972;39;752457
32;2021-04-09;361;311;673;382510;376716;49;759226
32;2021-04-09;295;272;569;386937;376527;59;763464
32;2021-04-09;211;173;384;371211;330938;69;702149
32;2021-04-09;121;89;211;250542;201459;79;452001
32;2021-04-09;67;33;100;163399;89786;89;253185
32;2021-04-09;24;12;36;48384;15367;90;63751
32;2021-04-09;2352;2106;4472;3072879;2889783;0;5962662
44;2021-04-09;78;73;151;291525;306839;09;598364
44;2021-04-09;243;207;457;320255;339504;19;659759
44;2021-04-09;280;241;524;302020;314428;29;616448
44;2021-04-09;231;236;469;342222;333292;39;675514
44;2021-04-09;259;234;494;349727;344491;49;694218
44;2021-04-09;233;189;422;381371;373239;59;754610
44;2021-04-09;163;140;305;367165;335850;69;703015
44;2021-04-09;93;75;171;250387;215436;79;465823
44;2021-04-09;54;42;97;170825;105192;89;276017
44;2021-04-09;13;5;18;51248;16731;90;67979
44;2021-04-09;1647;1442;3108;2826745;2685002;0;5511747
52;2021-04-09;45;58;104;213594;223900;09;437494
52;2021-04-09;182;154;338;240818;255197;19;496015
52;2021-04-09;152;186;338;197010;200630;29;397640
52;2021-04-09;140;123;263;231204;224885;39;456089
52;2021-04-09;147;163;310;243874;243418;49;487292
52;2021-04-09;126;108;234;244100;239116;59;483216
52;2021-04-09;94;85;179;241796;221345;69;463141
52;2021-04-09;54;55;110;177805;149903;79;327708
52;2021-04-09;27;21;48;119561;75822;89;195383
52;2021-04-09;16;6;22;42559;15260;90;57819
52;2021-04-09;983;960;1947;1952321;1849476;0;3801797
53;2021-04-09;24;33;58;173813;182358;09;356171
53;2021-04-09;103;118;222;202720;214740;19;417460
53;2021-04-09;97;99;196;163116;173196;29;336312
53;2021-04-09;92;64;156;190526;187674;39;378200
53;2021-04-09;76;89;165;212098;212015;49;424113
53;2021-04-09;67;75;142;223699;219176;59;442875
53;2021-04-09;49;44;93;227435;209274;69;436709
53;2021-04-09;34;25;59;169992;140910;79;310902
53;2021-04-09;20;7;27;118117;69883;89;188000
53;2021-04-09;9;1;10;37370;12267;90;49637
53;2021-04-09;571;555;1128;1718886;1621493;0;3340379
75;2021-04-09;46;62;109;293104;305291;09;598395
75;2021-04-09;162;196;361;337141;357785;19;694926
75;2021-04-09;190;164;354;295024;300618;29;595642
75;2021-04-09;177;150;328;347871;331233;39;679104
75;2021-04-09;190;158;349;384742;372771;49;757513
75;2021-04-09;152;137;289;413361;390880;59;804241
75;2021-04-09;121;86;207;425623;384060;69;809683
75;2021-04-09;55;73;128;325086;276298;79;601384
75;2021-04-09;31;21;52;213986;139308;89;353294
75;2021-04-09;9;6;15;77600;28200;90;105800
75;2021-04-09;1134;1054;2194;3113538;2886444;0;5999982
76;2021-04-09;59;70;131;305956;318589;09;624545
76;2021-04-09;225;204;432;338942;356969;19;695911
76;2021-04-09;263;213;477;316210;319570;29;635780
76;2021-04-09;239;190;429;356758;337587;39;694345
76;2021-04-09;235;213;448;376541;363812;49;740353
76;2021-04-09;202;195;397;402608;383750;59;786358
76;2021-04-09;144;140;284;394889;358997;69;753886
76;2021-04-09;89;87;176;308664;263806;79;572470
76;2021-04-09;61;29;90;195838;129272;89;325110
76;2021-04-09;40;17;57;69372;26728;90;96100
76;2021-04-09;1561;1358;2925;3065778;2859080;0;5924858
84;2021-04-09;127;126;256;459549;481088;09;940637
84;2021-04-09;409;408;821;487711;511905;19;999616
84;2021-04-09;412;404;817;443824;451094;29;894918
84;2021-04-09;398;397;795;512522;493262;39;1005784
84;2021-04-09;445;371;817;520248;515106;49;1035354
84;2021-04-09;323;359;682;529611;514848;59;1044459
84;2021-04-09;234;201;435;486720;439940;69;926660
84;2021-04-09;138;104;242;372151;315211;79;687362
84;2021-04-09;71;57;128;237198;150524;89;387722
84;2021-04-09;43;10;53;81185;28680;90;109865
84;2021-04-09;2602;2440;5051;4130719;3901658;0;8032377
93;2021-04-09;58;62;120;268834;283093;09;551927
93;2021-04-09;255;226;481;280751;296087;19;576838
93;2021-04-09;331;268;600;254404;255552;29;509956
93;2021-04-09;286;250;536;310704;288398;39;599102
93;2021-04-09;319;244;564;325559;305827;49;631386
93;2021-04-09;292;255;547;353104;325389;59;678493
93;2021-04-09;200;171;372;336327;296459;69;632786
93;2021-04-09;105;97;202;279820;229699;79;509519
93;2021-04-09;74;53;127;171274;113716;89;284990
93;2021-04-09;12;14;26;58896;21758;90;80654
93;2021-04-09;1932;1640;3576;2639673;2415978;0;5055651
94;2021-04-09;2;3;5;16311;17433;09;33744
94;2021-04-09;7;9;17;16679;18132;19;34811
94;2021-04-09;17;4;21;16782;16579;29;33361
94;2021-04-09;9;6;15;23044;20580;39;43624
94;2021-04-09;11;10;21;23065;22140;49;45205
94;2021-04-09;9;7;16;24549;23421;59;47970
94;2021-04-09;3;5;8;23212;21883;69;45095
94;2021-04-09;0;3;3;19544;17141;79;36685
94;2021-04-09;1;0;1;11227;8178;89;19405
94;2021-04-09;0;0;0;3332;1447;90;4779
94;2021-04-09;59;47;107;177745;166934;0;344679
01;2021-04-10;1;1;2;19979;20155;09;40134
01;2021-04-10;4;3;7;24994;25489;19;50483
01;2021-04-10;4;0;4;17868;16690;29;34558
01;2021-04-10;4;4;8;22328;14821;39;37149
01;2021-04-10;10;2;12;28652;20276;49;48928
01;2021-04-10;6;4;10;33264;27260;59;60524
01;2021-04-10;4;4;8;27135;23978;69;51113
01;2021-04-10;2;5;7;18401;14661;79;33062
01;2021-04-10;0;1;1;9633;6375;89;16008
01;2021-04-10;0;0;0;3410;1510;90;4920
01;2021-04-10;35;24;59;205664;171215;0;376879
02;2021-04-10;0;2;2;16881;17110;09;33991
02;2021-04-10;2;1;3;21410;21604;19;43014
02;2021-04-10;5;0;5;16017;15479;29;31496
02;2021-04-10;4;3;7;19825;14455;39;34280
02;2021-04-10;8;7;15;24719;18248;49;42967
02;2021-04-10;11;2;13;34361;28310;59;62671
02;2021-04-10;5;2;7;28061;24495;69;52556
02;2021-04-10;2;2;4;18231;15278;79;33509
02;2021-04-10;0;2;2;11090;7677;89;18767
02;2021-04-10;0;0;0;3992;1506;90;5498
02;2021-04-10;37;21;58;194587;164162;0;358749
03;2021-04-10;4;3;7;31123;30920;09;62043
03;2021-04-10;3;2;5;29370;29268;19;58638
03;2021-04-10;5;3;8;21458;18963;29;40421
03;2021-04-10;7;8;15;21276;18326;39;39602
03;2021-04-10;7;4;11;18164;16593;49;34757
03;2021-04-10;4;1;5;13469;13557;59;27026
03;2021-04-10;4;2;6;8776;8670;69;17446
03;2021-04-10;0;0;0;3777;3591;79;7368
03;2021-04-10;0;0;0;1649;1072;89;2721
03;2021-04-10;0;0;0;485;184;90;669
03;2021-04-10;34;23;57;149547;141144;0;290691
04;2021-04-10;5;4;9;60314;61377;09;121691
04;2021-04-10;13;9;22;66065;68387;19;134452
04;2021-04-10;8;5;13;51059;47156;29;98215
04;2021-04-10;8;10;18;58788;45780;39;104568
04;2021-04-10;11;10;21;61408;52207;49;113615
04;2021-04-10;8;10;18;64838;60759;59;125597
04;2021-04-10;5;2;7;47008;42843;69;89851
04;2021-04-10;2;2;4;25509;21184;79;46693
04;2021-04-10;3;0;3;13168;7647;89;20815
04;2021-04-10;0;1;1;3209;1253;90;4462
04;2021-04-10;63;53;116;451366;408593;0;859959
05;2021-04-10;0;0;0;362.366008612902;341.338819562748;09;703.704828175651
05;2021-04-10;0;0;0;353.376145114279;370.349735405642;19;723.725880519921
05;2021-04-10;0;0;0;218.593559489256;256.539602589476;29;475.133162078732
05;2021-04-10;0;0;0;404.225408693299;360.321910454353;39;764.547319147651
05;2021-04-10;0;0;0;520.067953604221;497.108383964256;49;1017.17633756848
05;2021-04-10;0;0;0;468.146063921917;510.087601910415;59;978.233665832332
05;2021-04-10;0;0;0;340.368470050554;334.366842191253;69;674.735312241807
05;2021-04-10;0;0;0;212.598666888387;192.597753227106;79;405.196420115493
05;2021-04-10;0;0;0;148.727797095705;61.8681715431829;89;210.595968638888
05;2021-04-10;0;0;0;32.9601271090696;10.9909785719784;90;43.9511056810479
05;2021-04-10;0;0;0;3061.43020057959;2935.56979942041;0;5997
06;2021-04-10;0;0;0;42583;42380;09;84963
06;2021-04-10;2;0;2;33369;31925;19;65294
06;2021-04-10;1;0;1;21571;15080;29;36651
06;2021-04-10;4;2;6;21550;16147;39;37697
06;2021-04-10;7;0;7;14193;13939;49;28132
06;2021-04-10;0;0;0;7171;7597;59;14768
06;2021-04-10;0;0;0;3629;4117;69;7746
06;2021-04-10;0;0;0;1577;1457;79;3034
06;2021-04-10;1;0;1;531;474;89;1005
06;2021-04-10;0;0;0;88;93;90;181
06;2021-04-10;15;2;17;146262;133209;0;279471
07;2021-04-10;0;0;0;485;549;09;1034
07;2021-04-10;0;0;0;403;432;19;835
07;2021-04-10;1;0;1;764;841;29;1605
07;2021-04-10;0;0;0;824;928;39;1752
07;2021-04-10;0;0;0;788;1020;49;1808
07;2021-04-10;0;0;0;678;870;59;1548
07;2021-04-10;1;0;1;360;382;69;742
07;2021-04-10;0;1;1;231;190;79;421
07;2021-04-10;0;0;0;114;67;89;181
07;2021-04-10;0;0;0;24;11;90;35
07;2021-04-10;2;1;3;4671;5290;0;9961
08;2021-04-10;0;0;0;2715.22592983026;2997.75551488675;09;5712.98144471701
08;2021-04-10;0;0;0;2778.51901080978;3160.9156459093;19;5939.43465671908
08;2021-04-10;0;1;1;2080.8882988764;1718.16634315323;29;3799.05464202964
08;2021-04-10;0;0;0;2701.8582062647;1896.52641413317;39;4598.38462039786
08;2021-04-10;0;0;0;3151.45861023308;2460.52498233809;49;5611.98359257117
08;2021-04-10;0;0;0;2620.29868333099;2422.23566154656;59;5042.53434487755
08;2021-04-10;0;0;0;1621.44173420671;1438.58325779464;69;3060.02499200135
08;2021-04-10;0;0;0;626.575909335673;526.358467843651;79;1152.93437717932
08;2021-04-10;1;0;1;205.018522985054;140.993639349697;89;346.012162334751
08;2021-04-10;0;0;0;50.0325684687745;20.62259870351;90;70.6551671722846
08;2021-04-10;1;1;2;18551.3174743414;16782.6825256586;0;35334
11;2021-04-10;163;172;361;783071;811785;09;1594856
11;2021-04-10;544;503;1113;761456;784653;19;1546109
11;2021-04-10;758;735;1500;850145;801772;29;1651917
11;2021-04-10;783;730;1523;914360;843488;39;1757848
11;2021-04-10;669;705;1384;845609;826202;49;1671811
11;2021-04-10;553;537;1097;793566;745070;59;1538636
11;2021-04-10;352;281;634;628649;549192;69;1177841
11;2021-04-10;134;135;269;434606;358356;79;792962
11;2021-04-10;57;41;98;261425;162933;89;424358
11;2021-04-10;33;8;41;89253;32619;90;121872
11;2021-04-10;4046;3850;8023;6362140;5916070;0;12278210
24;2021-04-10;19;21;40;139720;144686;09;284406
24;2021-04-10;80;54;137;152979;161185;19;314164
24;2021-04-10;78;78;156;122237;126536;29;248773
24;2021-04-10;84;83;168;150359;142009;39;292368
24;2021-04-10;73;69;142;161829;158758;49;320587
24;2021-04-10;62;65;127;172552;168011;59;340563
24;2021-04-10;40;34;74;172509;158177;69;330686
24;2021-04-10;27;14;41;129428;110593;79;240021
24;2021-04-10;13;4;17;87342;56882;89;144224
24;2021-04-10;0;2;2;31210;12071;90;43281
24;2021-04-10;477;424;905;1320165;1238908;0;2559073
27;2021-04-10;17;19;37;143373;149679;09;293052
27;2021-04-10;80;95;175;160962;173003;19;333965
27;2021-04-10;83;95;179;133746;142254;29;276000
27;2021-04-10;73;45;118;160004;155407;39;315411
27;2021-04-10;100;70;171;172333;169564;49;341897
27;2021-04-10;69;65;134;189979;183788;59;373767
27;2021-04-10;63;56;119;192591;178206;69;370797
27;2021-04-10;25;27;52;146876;127546;79;274422
27;2021-04-10;26;10;36;96896;61575;89;158471
27;2021-04-10;5;1;6;33148;12109;90;45257
27;2021-04-10;541;483;1027;1429908;1353131;0;2783039
28;2021-04-10;21;21;44;180735;186856;09;367591
28;2021-04-10;89;90;185;200125;213621;19;413746
28;2021-04-10;98;89;187;168922;173007;29;341929
28;2021-04-10;88;83;172;196628;188487;39;385115
28;2021-04-10;103;83;186;205396;201699;49;407095
28;2021-04-10;77;93;171;222002;213866;59;435868
28;2021-04-10;56;54;110;224688;203758;69;428446
28;2021-04-10;27;18;45;163192;135543;79;298735
28;2021-04-10;14;15;29;109691;65377;89;175068
28;2021-04-10;9;2;11;37222;12685;90;49907
28;2021-04-10;582;548;1140;1708601;1594899;0;3303500
32;2021-04-10;82;73;157;358062;373689;09;731751
32;2021-04-10;252;175;431;387045;406742;19;793787
32;2021-04-10;248;249;508;342304;348587;29;690891
32;2021-04-10;259;217;477;382485;369972;39;752457
32;2021-04-10;231;204;435;382510;376716;49;759226
32;2021-04-10;203;212;416;386937;376527;59;763464
32;2021-04-10;126;128;254;371211;330938;69;702149
32;2021-04-10;75;54;130;250542;201459;79;452001
32;2021-04-10;30;23;53;163399;89786;89;253185
32;2021-04-10;17;9;26;48384;15367;90;63751
32;2021-04-10;1524;1344;2888;3072879;2889783;0;5962662
44;2021-04-10;46;39;85;291525;306839;09;598364
44;2021-04-10;138;168;308;320255;339504;19;659759
44;2021-04-10;187;144;332;302020;314428;29;616448
44;2021-04-10;161;151;312;342222;333292;39;675514
44;2021-04-10;145;162;308;349727;344491;49;694218
44;2021-04-10;147;172;319;381371;373239;59;754610
44;2021-04-10;96;103;199;367165;335850;69;703015
44;2021-04-10;59;51;110;250387;215436;79;465823
44;2021-04-10;42;27;69;170825;105192;89;276017
44;2021-04-10;12;4;16;51248;16731;90;67979
44;2021-04-10;1033;1021;2058;2826745;2685002;0;5511747
52;2021-04-10;40;30;72;213594;223900;09;437494
52;2021-04-10;123;130;253;240818;255197;19;496015
52;2021-04-10;120;104;224;197010;200630;29;397640
52;2021-04-10;91;100;191;231204;224885;39;456089
52;2021-04-10;132;114;246;243874;243418;49;487292
52;2021-04-10;105;103;208;244100;239116;59;483216
52;2021-04-10;81;81;162;241796;221345;69;463141
52;2021-04-10;44;34;78;177805;149903;79;327708
52;2021-04-10;21;15;36;119561;75822;89;195383
52;2021-04-10;8;2;10;42559;15260;90;57819
52;2021-04-10;765;713;1480;1952321;1849476;0;3801797
53;2021-04-10;16;15;31;173813;182358;09;356171
53;2021-04-10;53;72;125;202720;214740;19;417460
53;2021-04-10;54;66;120;163116;173196;29;336312
53;2021-04-10;45;48;93;190526;187674;39;378200
53;2021-04-10;49;70;119;212098;212015;49;424113
53;2021-04-10;42;52;95;223699;219176;59;442875
53;2021-04-10;25;36;61;227435;209274;69;436709
53;2021-04-10;14;10;24;169992;140910;79;310902
53;2021-04-10;9;4;13;118117;69883;89;188000
53;2021-04-10;1;1;2;37370;12267;90;49637
53;2021-04-10;308;374;683;1718886;1621493;0;3340379
75;2021-04-10;34;25;60;293104;305291;09;598395
75;2021-04-10;117;118;237;337141;357785;19;694926
75;2021-04-10;141;117;258;295024;300618;29;595642
75;2021-04-10;109;99;208;347871;331233;39;679104
75;2021-04-10;138;101;239;384742;372771;49;757513
75;2021-04-10;114;108;222;413361;390880;59;804241
75;2021-04-10;65;66;131;425623;384060;69;809683
75;2021-04-10;37;33;70;325086;276298;79;601384
75;2021-04-10;18;16;34;213986;139308;89;353294
75;2021-04-10;8;4;12;77600;28200;90;105800
75;2021-04-10;782;687;1472;3113538;2886444;0;5999982
76;2021-04-10;25;42;69;305956;318589;09;624545
76;2021-04-10;101;128;231;338942;356969;19;695911
76;2021-04-10;154;161;315;316210;319570;29;635780
76;2021-04-10;122;108;231;356758;337587;39;694345
76;2021-04-10;139;133;272;376541;363812;49;740353
76;2021-04-10;128;103;233;402608;383750;59;786358
76;2021-04-10;72;64;136;394889;358997;69;753886
76;2021-04-10;47;44;91;308664;263806;79;572470
76;2021-04-10;18;23;41;195838;129272;89;325110
76;2021-04-10;12;4;16;69372;26728;90;96100
76;2021-04-10;818;810;1635;3065778;2859080;0;5924858
84;2021-04-10;69;63;132;459549;481088;09;940637
84;2021-04-10;250;239;490;487711;511905;19;999616
84;2021-04-10;242;252;494;443824;451094;29;894918
84;2021-04-10;241;228;470;512522;493262;39;1005784
84;2021-04-10;257;231;488;520248;515106;49;1035354
84;2021-04-10;214;206;420;529611;514848;59;1044459
84;2021-04-10;132;120;252;486720;439940;69;926660
84;2021-04-10;81;78;159;372151;315211;79;687362
84;2021-04-10;53;45;98;237198;150524;89;387722
84;2021-04-10;15;14;29;81185;28680;90;109865
84;2021-04-10;1554;1476;3032;4130719;3901658;0;8032377
93;2021-04-10;41;25;67;268834;283093;09;551927
93;2021-04-10;138;121;262;280751;296087;19;576838
93;2021-04-10;173;136;309;254404;255552;29;509956
93;2021-04-10;160;140;300;310704;288398;39;599102
93;2021-04-10;189;170;360;325559;305827;49;631386
93;2021-04-10;165;159;324;353104;325389;59;678493
93;2021-04-10;114;91;205;336327;296459;69;632786
93;2021-04-10;61;63;124;279820;229699;79;509519
93;2021-04-10;35;33;68;171274;113716;89;284990
93;2021-04-10;15;6;21;58896;21758;90;80654
93;2021-04-10;1091;945;2041;2639673;2415978;0;5055651
94;2021-04-10;1;2;3;16311;17433;09;33744
94;2021-04-10;4;4;8;16679;18132;19;34811
94;2021-04-10;8;4;12;16782;16579;29;33361
94;2021-04-10;6;5;11;23044;20580;39;43624
94;2021-04-10;2;3;5;23065;22140;49;45205
94;2021-04-10;5;3;8;24549;23421;59;47970
94;2021-04-10;0;4;4;23212;21883;69;45095
94;2021-04-10;3;1;4;19544;17141;79;36685
94;2021-04-10;4;1;5;11227;8178;89;19405
94;2021-04-10;1;0;1;3332;1447;90;4779
94;2021-04-10;34;27;61;177745;166934;0;344679
01;2021-04-11;0;0;0;19979;20155;09;40134
01;2021-04-11;2;1;3;24994;25489;19;50483
01;2021-04-11;3;0;3;17868;16690;29;34558
01;2021-04-11;8;0;8;22328;14821;39;37149
01;2021-04-11;5;2;7;28652;20276;49;48928
01;2021-04-11;3;2;5;33264;27260;59;60524
01;2021-04-11;2;1;3;27135;23978;69;51113
01;2021-04-11;4;2;6;18401;14661;79;33062
01;2021-04-11;0;1;1;9633;6375;89;16008
01;2021-04-11;0;0;0;3410;1510;90;4920
01;2021-04-11;27;9;36;205664;171215;0;376879
02;2021-04-11;0;0;0;16881;17110;09;33991
02;2021-04-11;0;0;0;21410;21604;19;43014
02;2021-04-11;1;0;1;16017;15479;29;31496
02;2021-04-11;0;0;0;19825;14455;39;34280
02;2021-04-11;0;1;1;24719;18248;49;42967
02;2021-04-11;0;2;2;34361;28310;59;62671
02;2021-04-11;1;0;1;28061;24495;69;52556
02;2021-04-11;2;1;3;18231;15278;79;33509
02;2021-04-11;0;1;1;11090;7677;89;18767
02;2021-04-11;0;1;1;3992;1506;90;5498
02;2021-04-11;4;6;10;194587;164162;0;358749
03;2021-04-11;0;0;0;31123;30920;09;62043
03;2021-04-11;0;0;0;29370;29268;19;58638
03;2021-04-11;0;0;0;21458;18963;29;40421
03;2021-04-11;0;0;0;21276;18326;39;39602
03;2021-04-11;0;2;2;18164;16593;49;34757
03;2021-04-11;0;0;0;13469;13557;59;27026
03;2021-04-11;1;0;1;8776;8670;69;17446
03;2021-04-11;0;0;0;3777;3591;79;7368
03;2021-04-11;0;0;0;1649;1072;89;2721
03;2021-04-11;0;0;0;485;184;90;669
03;2021-04-11;1;2;3;149547;141144;0;290691
04;2021-04-11;2;1;3;60314;61377;09;121691
04;2021-04-11;2;1;3;66065;68387;19;134452
04;2021-04-11;3;2;5;51059;47156;29;98215
04;2021-04-11;6;1;7;58788;45780;39;104568
04;2021-04-11;3;2;5;61408;52207;49;113615
04;2021-04-11;2;3;5;64838;60759;59;125597
04;2021-04-11;1;4;5;47008;42843;69;89851
04;2021-04-11;0;0;0;25509;21184;79;46693
04;2021-04-11;0;0;0;13168;7647;89;20815
04;2021-04-11;0;0;0;3209;1253;90;4462
04;2021-04-11;19;14;33;451366;408593;0;859959
05;2021-04-11;0;0;0;362.366008612902;341.338819562748;09;703.704828175651
05;2021-04-11;0;0;0;353.376145114279;370.349735405642;19;723.725880519921
05;2021-04-11;0;0;0;218.593559489256;256.539602589476;29;475.133162078732
05;2021-04-11;0;0;0;404.225408693299;360.321910454353;39;764.547319147651
05;2021-04-11;0;0;0;520.067953604221;497.108383964256;49;1017.17633756848
05;2021-04-11;0;0;0;468.146063921917;510.087601910415;59;978.233665832332
05;2021-04-11;0;0;0;340.368470050554;334.366842191253;69;674.735312241807
05;2021-04-11;0;0;0;212.598666888387;192.597753227106;79;405.196420115493
05;2021-04-11;0;0;0;148.727797095705;61.8681715431829;89;210.595968638888
05;2021-04-11;0;0;0;32.9601271090696;10.9909785719784;90;43.9511056810479
05;2021-04-11;0;0;0;3061.43020057959;2935.56979942041;0;5997
06;2021-04-11;0;0;0;42583;42380;09;84963
06;2021-04-11;0;0;0;33369;31925;19;65294
06;2021-04-11;0;3;3;21571;15080;29;36651
06;2021-04-11;0;0;0;21550;16147;39;37697
06;2021-04-11;0;1;1;14193;13939;49;28132
06;2021-04-11;0;0;0;7171;7597;59;14768
06;2021-04-11;1;0;1;3629;4117;69;7746
06;2021-04-11;0;0;0;1577;1457;79;3034
06;2021-04-11;0;0;0;531;474;89;1005
06;2021-04-11;0;0;0;88;93;90;181
06;2021-04-11;1;4;5;146262;133209;0;279471
07;2021-04-11;0;0;0;485;549;09;1034
07;2021-04-11;0;0;0;403;432;19;835
07;2021-04-11;0;0;0;764;841;29;1605
07;2021-04-11;0;0;0;824;928;39;1752
07;2021-04-11;0;0;0;788;1020;49;1808
07;2021-04-11;1;2;3;678;870;59;1548
07;2021-04-11;0;0;0;360;382;69;742
07;2021-04-11;0;0;0;231;190;79;421
07;2021-04-11;0;0;0;114;67;89;181
07;2021-04-11;0;0;0;24;11;90;35
07;2021-04-11;1;2;3;4671;5290;0;9961
08;2021-04-11;0;0;0;2715.22592983026;2997.75551488675;09;5712.98144471701
08;2021-04-11;0;0;0;2778.51901080978;3160.9156459093;19;5939.43465671908
08;2021-04-11;0;0;0;2080.8882988764;1718.16634315323;29;3799.05464202964
08;2021-04-11;0;0;0;2701.8582062647;1896.52641413317;39;4598.38462039786
08;2021-04-11;0;0;0;3151.45861023308;2460.52498233809;49;5611.98359257117
08;2021-04-11;0;0;0;2620.29868333099;2422.23566154656;59;5042.53434487755
08;2021-04-11;0;0;0;1621.44173420671;1438.58325779464;69;3060.02499200135
08;2021-04-11;0;0;0;626.575909335673;526.358467843651;79;1152.93437717932
08;2021-04-11;0;0;0;205.018522985054;140.993639349697;89;346.012162334751
08;2021-04-11;0;0;0;50.0325684687745;20.62259870351;90;70.6551671722846
08;2021-04-11;0;0;0;18551.3174743414;16782.6825256586;0;35334
11;2021-04-11;31;46;77;783071;811785;09;1594856
11;2021-04-11;92;90;186;761456;784653;19;1546109
11;2021-04-11;170;191;362;850145;801772;29;1651917
11;2021-04-11;175;153;331;914360;843488;39;1757848
11;2021-04-11;143;163;308;845609;826202;49;1671811
11;2021-04-11;123;121;245;793566;745070;59;1538636
11;2021-04-11;69;81;150;628649;549192;69;1177841
11;2021-04-11;44;44;88;434606;358356;79;792962
11;2021-04-11;38;28;66;261425;162933;89;424358
11;2021-04-11;18;9;27;89253;32619;90;121872
11;2021-04-11;903;926;1840;6362140;5916070;0;12278210
24;2021-04-11;3;2;6;139720;144686;09;284406
24;2021-04-11;14;6;20;152979;161185;19;314164
24;2021-04-11;9;8;17;122237;126536;29;248773
24;2021-04-11;11;5;16;150359;142009;39;292368
24;2021-04-11;11;5;16;161829;158758;49;320587
24;2021-04-11;8;9;17;172552;168011;59;340563
24;2021-04-11;5;7;12;172509;158177;69;330686
24;2021-04-11;11;5;16;129428;110593;79;240021
24;2021-04-11;7;6;13;87342;56882;89;144224
24;2021-04-11;0;0;0;31210;12071;90;43281
24;2021-04-11;79;53;133;1320165;1238908;0;2559073
27;2021-04-11;5;6;11;143373;149679;09;293052
27;2021-04-11;11;10;21;160962;173003;19;333965
27;2021-04-11;10;12;22;133746;142254;29;276000
27;2021-04-11;13;10;23;160004;155407;39;315411
27;2021-04-11;7;12;19;172333;169564;49;341897
27;2021-04-11;7;13;20;189979;183788;59;373767
27;2021-04-11;8;7;15;192591;178206;69;370797
27;2021-04-11;6;3;9;146876;127546;79;274422
27;2021-04-11;5;6;11;96896;61575;89;158471
27;2021-04-11;4;3;7;33148;12109;90;45257
27;2021-04-11;76;82;158;1429908;1353131;0;2783039
28;2021-04-11;6;8;15;180735;186856;09;367591
28;2021-04-11;18;14;34;200125;213621;19;413746
28;2021-04-11;27;26;53;168922;173007;29;341929
28;2021-04-11;17;26;43;196628;188487;39;385115
28;2021-04-11;20;20;41;205396;201699;49;407095
28;2021-04-11;10;16;26;222002;213866;59;435868
28;2021-04-11;9;6;15;224688;203758;69;428446
28;2021-04-11;7;7;14;163192;135543;79;298735
28;2021-04-11;5;5;10;109691;65377;89;175068
28;2021-04-11;6;3;9;37222;12685;90;49907
28;2021-04-11;125;131;260;1708601;1594899;0;3303500
32;2021-04-11;24;15;39;358062;373689;09;731751
32;2021-04-11;42;34;77;387045;406742;19;793787
32;2021-04-11;51;46;101;342304;348587;29;690891
32;2021-04-11;76;51;130;382485;369972;39;752457
32;2021-04-11;46;50;96;382510;376716;49;759226
32;2021-04-11;41;38;79;386937;376527;59;763464
32;2021-04-11;20;26;46;371211;330938;69;702149
32;2021-04-11;20;19;39;250542;201459;79;452001
32;2021-04-11;11;7;18;163399;89786;89;253185
32;2021-04-11;6;5;11;48384;15367;90;63751
32;2021-04-11;338;291;637;3072879;2889783;0;5962662
44;2021-04-11;6;9;15;291525;306839;09;598364
44;2021-04-11;16;19;35;320255;339504;19;659759
44;2021-04-11;23;16;39;302020;314428;29;616448
44;2021-04-11;26;27;53;342222;333292;39;675514
44;2021-04-11;17;17;34;349727;344491;49;694218
44;2021-04-11;11;18;29;381371;373239;59;754610
44;2021-04-11;18;15;33;367165;335850;69;703015
44;2021-04-11;7;16;23;250387;215436;79;465823
44;2021-04-11;14;11;25;170825;105192;89;276017
44;2021-04-11;4;2;6;51248;16731;90;67979
44;2021-04-11;142;150;293;2826745;2685002;0;5511747
52;2021-04-11;8;7;15;213594;223900;09;437494
52;2021-04-11;31;26;58;240818;255197;19;496015
52;2021-04-11;31;27;58;197010;200630;29;397640
52;2021-04-11;33;27;60;231204;224885;39;456089
52;2021-04-11;23;25;48;243874;243418;49;487292
52;2021-04-11;21;26;47;244100;239116;59;483216
52;2021-04-11;14;8;22;241796;221345;69;463141
52;2021-04-11;5;9;14;177805;149903;79;327708
52;2021-04-11;5;1;6;119561;75822;89;195383
52;2021-04-11;1;1;2;42559;15260;90;57819
52;2021-04-11;172;157;330;1952321;1849476;0;3801797
53;2021-04-11;2;2;4;173813;182358;09;356171
53;2021-04-11;6;7;13;202720;214740;19;417460
53;2021-04-11;15;14;29;163116;173196;29;336312
53;2021-04-11;5;8;13;190526;187674;39;378200
53;2021-04-11;14;9;23;212098;212015;49;424113
53;2021-04-11;7;5;12;223699;219176;59;442875
53;2021-04-11;4;7;11;227435;209274;69;436709
53;2021-04-11;4;6;10;169992;140910;79;310902
53;2021-04-11;1;5;6;118117;69883;89;188000
53;2021-04-11;4;4;8;37370;12267;90;49637
53;2021-04-11;62;67;129;1718886;1621493;0;3340379
75;2021-04-11;5;6;11;293104;305291;09;598395
75;2021-04-11;17;16;33;337141;357785;19;694926
75;2021-04-11;30;16;46;295024;300618;29;595642
75;2021-04-11;17;13;30;347871;331233;39;679104
75;2021-04-11;16;18;35;384742;372771;49;757513
75;2021-04-11;12;13;26;413361;390880;59;804241
75;2021-04-11;13;8;21;425623;384060;69;809683
75;2021-04-11;7;2;9;325086;276298;79;601384
75;2021-04-11;8;4;12;213986;139308;89;353294
75;2021-04-11;2;1;3;77600;28200;90;105800
75;2021-04-11;127;97;226;3113538;2886444;0;5999982
76;2021-04-11;11;6;17;305956;318589;09;624545
76;2021-04-11;14;22;36;338942;356969;19;695911
76;2021-04-11;25;18;43;316210;319570;29;635780
76;2021-04-11;26;15;41;356758;337587;39;694345
76;2021-04-11;27;17;44;376541;363812;49;740353
76;2021-04-11;28;19;47;402608;383750;59;786358
76;2021-04-11;8;16;24;394889;358997;69;753886
76;2021-04-11;11;17;28;308664;263806;79;572470
76;2021-04-11;13;2;15;195838;129272;89;325110
76;2021-04-11;2;2;4;69372;26728;90;96100
76;2021-04-11;165;134;299;3065778;2859080;0;5924858
84;2021-04-11;11;13;24;459549;481088;09;940637
84;2021-04-11;28;36;64;487711;511905;19;999616
84;2021-04-11;44;33;77;443824;451094;29;894918
84;2021-04-11;47;44;91;512522;493262;39;1005784
84;2021-04-11;45;47;92;520248;515106;49;1035354
84;2021-04-11;25;40;65;529611;514848;59;1044459
84;2021-04-11;29;30;59;486720;439940;69;926660
84;2021-04-11;10;22;32;372151;315211;79;687362
84;2021-04-11;20;22;42;237198;150524;89;387722
84;2021-04-11;12;1;13;81185;28680;90;109865
84;2021-04-11;271;288;559;4130719;3901658;0;8032377
93;2021-04-11;8;14;22;268834;283093;09;551927
93;2021-04-11;18;28;46;280751;296087;19;576838
93;2021-04-11;44;42;86;254404;255552;29;509956
93;2021-04-11;53;57;110;310704;288398;39;599102
93;2021-04-11;46;51;97;325559;305827;49;631386
93;2021-04-11;39;52;91;353104;325389;59;678493
93;2021-04-11;26;31;57;336327;296459;69;632786
93;2021-04-11;19;26;45;279820;229699;79;509519
93;2021-04-11;9;16;25;171274;113716;89;284990
93;2021-04-11;6;3;9;58896;21758;90;80654
93;2021-04-11;268;320;588;2639673;2415978;0;5055651
94;2021-04-11;0;0;0;16311;17433;09;33744
94;2021-04-11;1;1;2;16679;18132;19;34811
94;2021-04-11;0;0;0;16782;16579;29;33361
94;2021-04-11;2;0;2;23044;20580;39;43624
94;2021-04-11;1;0;1;23065;22140;49;45205
94;2021-04-11;2;0;2;24549;23421;59;47970
94;2021-04-11;0;1;1;23212;21883;69;45095
94;2021-04-11;0;0;0;19544;17141;79;36685
94;2021-04-11;1;0;1;11227;8178;89;19405
94;2021-04-11;1;0;1;3332;1447;90;4779
94;2021-04-11;8;2;10;177745;166934;0;344679
01;2021-04-12;2;3;5;19979;20155;09;40134
01;2021-04-12;12;7;19;24994;25489;19;50483
01;2021-04-12;14;10;24;17868;16690;29;34558
01;2021-04-12;19;5;24;22328;14821;39;37149
01;2021-04-12;19;10;29;28652;20276;49;48928
01;2021-04-12;19;16;35;33264;27260;59;60524
01;2021-04-12;13;11;24;27135;23978;69;51113
01;2021-04-12;5;5;10;18401;14661;79;33062
01;2021-04-12;1;2;3;9633;6375;89;16008
01;2021-04-12;1;0;1;3410;1510;90;4920
01;2021-04-12;105;69;174;205664;171215;0;376879
02;2021-04-12;3;0;3;16881;17110;09;33991
02;2021-04-12;6;9;15;21410;21604;19;43014
02;2021-04-12;9;6;15;16017;15479;29;31496
02;2021-04-12;11;9;20;19825;14455;39;34280
02;2021-04-12;11;7;18;24719;18248;49;42967
02;2021-04-12;20;17;37;34361;28310;59;62671
02;2021-04-12;11;6;17;28061;24495;69;52556
02;2021-04-12;8;5;13;18231;15278;79;33509
02;2021-04-12;1;1;2;11090;7677;89;18767
02;2021-04-12;0;1;1;3992;1506;90;5498
02;2021-04-12;80;61;141;194587;164162;0;358749
03;2021-04-12;2;4;6;31123;30920;09;62043
03;2021-04-12;4;4;8;29370;29268;19;58638
03;2021-04-12;20;10;30;21458;18963;29;40421
03;2021-04-12;8;6;14;21276;18326;39;39602
03;2021-04-12;11;6;17;18164;16593;49;34757
03;2021-04-12;3;8;11;13469;13557;59;27026
03;2021-04-12;6;9;15;8776;8670;69;17446
03;2021-04-12;4;2;6;3777;3591;79;7368
03;2021-04-12;0;0;0;1649;1072;89;2721
03;2021-04-12;0;0;0;485;184;90;669
03;2021-04-12;58;49;107;149547;141144;0;290691
04;2021-04-12;12;6;18;60314;61377;09;121691
04;2021-04-12;25;20;45;66065;68387;19;134452
04;2021-04-12;20;12;32;51059;47156;29;98215
04;2021-04-12;15;13;28;58788;45780;39;104568
04;2021-04-12;15;13;28;61408;52207;49;113615
04;2021-04-12;18;12;30;64838;60759;59;125597
04;2021-04-12;8;8;16;47008;42843;69;89851
04;2021-04-12;6;8;14;25509;21184;79;46693
04;2021-04-12;2;0;2;13168;7647;89;20815
04;2021-04-12;1;0;1;3209;1253;90;4462
04;2021-04-12;122;92;214;451366;408593;0;859959
05;2021-04-12;0;0;0;362.366008612902;341.338819562748;09;703.704828175651
05;2021-04-12;0;0;0;353.376145114279;370.349735405642;19;723.725880519921
05;2021-04-12;0;0;0;218.593559489256;256.539602589476;29;475.133162078732
05;2021-04-12;0;0;0;404.225408693299;360.321910454353;39;764.547319147651
05;2021-04-12;0;0;0;520.067953604221;497.108383964256;49;1017.17633756848
05;2021-04-12;0;0;0;468.146063921917;510.087601910415;59;978.233665832332
05;2021-04-12;0;0;0;340.368470050554;334.366842191253;69;674.735312241807
05;2021-04-12;0;0;0;212.598666888387;192.597753227106;79;405.196420115493
05;2021-04-12;0;0;0;148.727797095705;61.8681715431829;89;210.595968638888
05;2021-04-12;0;0;0;32.9601271090696;10.9909785719784;90;43.9511056810479
05;2021-04-12;0;0;0;3061.43020057959;2935.56979942041;0;5997
06;2021-04-12;0;0;0;42583;42380;09;84963
06;2021-04-12;4;2;6;33369;31925;19;65294
06;2021-04-12;5;2;7;21571;15080;29;36651
06;2021-04-12;4;1;5;21550;16147;39;37697
06;2021-04-12;2;3;5;14193;13939;49;28132
06;2021-04-12;1;6;7;7171;7597;59;14768
06;2021-04-12;2;0;2;3629;4117;69;7746
06;2021-04-12;0;0;0;1577;1457;79;3034
06;2021-04-12;0;0;0;531;474;89;1005
06;2021-04-12;1;0;1;88;93;90;181
06;2021-04-12;19;14;33;146262;133209;0;279471
07;2021-04-12;0;0;0;485;549;09;1034
07;2021-04-12;0;0;0;403;432;19;835
07;2021-04-12;1;1;2;764;841;29;1605
07;2021-04-12;3;0;3;824;928;39;1752
07;2021-04-12;1;0;1;788;1020;49;1808
07;2021-04-12;3;1;4;678;870;59;1548
07;2021-04-12;3;1;4;360;382;69;742
07;2021-04-12;0;0;0;231;190;79;421
07;2021-04-12;0;0;0;114;67;89;181
07;2021-04-12;0;0;0;24;11;90;35
07;2021-04-12;11;3;14;4671;5290;0;9961
08;2021-04-12;0;0;0;2715.22592983026;2997.75551488675;09;5712.98144471701
08;2021-04-12;1;1;2;2778.51901080978;3160.9156459093;19;5939.43465671908
08;2021-04-12;0;0;0;2080.8882988764;1718.16634315323;29;3799.05464202964
08;2021-04-12;1;0;1;2701.8582062647;1896.52641413317;39;4598.38462039786
08;2021-04-12;0;0;0;3151.45861023308;2460.52498233809;49;5611.98359257117
08;2021-04-12;0;0;0;2620.29868333099;2422.23566154656;59;5042.53434487755
08;2021-04-12;0;0;0;1621.44173420671;1438.58325779464;69;3060.02499200135
08;2021-04-12;0;0;0;626.575909335673;526.358467843651;79;1152.93437717932
08;2021-04-12;0;0;0;205.018522985054;140.993639349697;89;346.012162334751
08;2021-04-12;0;0;0;50.0325684687745;20.62259870351;90;70.6551671722846
08;2021-04-12;2;1;3;18551.3174743414;16782.6825256586;0;35334
11;2021-04-12;273;304;616;783071;811785;09;1594856
11;2021-04-12;897;824;1786;761456;784653;19;1546109
11;2021-04-12;1428;1377;2822;850145;801772;29;1651917
11;2021-04-12;1439;1383;2844;914360;843488;39;1757848
11;2021-04-12;1361;1228;2596;845609;826202;49;1671811
11;2021-04-12;1039;1142;2198;793566;745070;59;1538636
11;2021-04-12;616;575;1201;628649;549192;69;1177841
11;2021-04-12;247;275;522;434606;358356;79;792962
11;2021-04-12;116;103;219;261425;162933;89;424358
11;2021-04-12;46;32;78;89253;32619;90;121872
11;2021-04-12;7464;7245;14887;6362140;5916070;0;12278210
24;2021-04-12;33;33;67;139720;144686;09;284406
24;2021-04-12;117;136;254;152979;161185;19;314164
24;2021-04-12;138;130;268;122237;126536;29;248773
24;2021-04-12;129;135;264;150359;142009;39;292368
24;2021-04-12;138;107;245;161829;158758;49;320587
24;2021-04-12;112;142;255;172552;168011;59;340563
24;2021-04-12;82;87;169;172509;158177;69;330686
24;2021-04-12;40;57;97;129428;110593;79;240021
24;2021-04-12;28;24;52;87342;56882;89;144224
24;2021-04-12;10;5;15;31210;12071;90;43281
24;2021-04-12;827;857;1687;1320165;1238908;0;2559073
27;2021-04-12;33;37;72;143373;149679;09;293052
27;2021-04-12;132;104;236;160962;173003;19;333965
27;2021-04-12;145;145;291;133746;142254;29;276000
27;2021-04-12;133;127;260;160004;155407;39;315411
27;2021-04-12;157;125;282;172333;169564;49;341897
27;2021-04-12;146;127;273;189979;183788;59;373767
27;2021-04-12;103;101;204;192591;178206;69;370797
27;2021-04-12;63;65;128;146876;127546;79;274422
27;2021-04-12;38;21;59;96896;61575;89;158471
27;2021-04-12;18;6;24;33148;12109;90;45257
27;2021-04-12;968;858;1829;1429908;1353131;0;2783039
28;2021-04-12;69;51;126;180735;186856;09;367591
28;2021-04-12;165;171;340;200125;213621;19;413746
28;2021-04-12;164;191;355;168922;173007;29;341929
28;2021-04-12;187;158;347;196628;188487;39;385115
28;2021-04-12;177;188;366;205396;201699;49;407095
28;2021-04-12;190;204;396;222002;213866;59;435868
28;2021-04-12;119;100;219;224688;203758;69;428446
28;2021-04-12;70;66;136;163192;135543;79;298735
28;2021-04-12;38;22;60;109691;65377;89;175068
28;2021-04-12;19;7;26;37222;12685;90;49907
28;2021-04-12;1198;1158;2371;1708601;1594899;0;3303500
32;2021-04-12;121;154;276;358062;373689;09;731751
32;2021-04-12;418;391;809;387045;406742;19;793787
32;2021-04-12;512;401;916;342304;348587;29;690891
32;2021-04-12;481;424;908;382485;369972;39;752457
32;2021-04-12;441;425;871;382510;376716;49;759226
32;2021-04-12;403;371;778;386937;376527;59;763464
32;2021-04-12;243;220;465;371211;330938;69;702149
32;2021-04-12;146;97;244;250542;201459;79;452001
32;2021-04-12;75;59;135;163399;89786;89;253185
32;2021-04-12;30;10;40;48384;15367;90;63751
32;2021-04-12;2873;2553;5446;3072879;2889783;0;5962662
44;2021-04-12;74;91;168;291525;306839;09;598364
44;2021-04-12;282;256;542;320255;339504;19;659759
44;2021-04-12;309;313;623;302020;314428;29;616448
44;2021-04-12;326;312;640;342222;333292;39;675514
44;2021-04-12;306;294;600;349727;344491;49;694218
44;2021-04-12;277;306;586;381371;373239;59;754610
44;2021-04-12;199;158;358;367165;335850;69;703015
44;2021-04-12;116;98;217;250387;215436;79;465823
44;2021-04-12;63;37;102;170825;105192;89;276017
44;2021-04-12;26;11;37;51248;16731;90;67979
44;2021-04-12;1979;1876;3874;2826745;2685002;0;5511747
52;2021-04-12;45;45;94;213594;223900;09;437494
52;2021-04-12;174;167;348;240818;255197;19;496015
52;2021-04-12;198;213;411;197010;200630;29;397640
52;2021-04-12;181;158;339;231204;224885;39;456089
52;2021-04-12;181;164;345;243874;243418;49;487292
52;2021-04-12;191;165;356;244100;239116;59;483216
52;2021-04-12;130;124;254;241796;221345;69;463141
52;2021-04-12;57;53;110;177805;149903;79;327708
52;2021-04-12;29;25;54;119561;75822;89;195383
52;2021-04-12;23;3;26;42559;15260;90;57819
52;2021-04-12;1209;1117;2337;1952321;1849476;0;3801797
53;2021-04-12;27;33;60;173813;182358;09;356171
53;2021-04-12;103;118;223;202720;214740;19;417460
53;2021-04-12;131;134;267;163116;173196;29;336312
53;2021-04-12;90;105;195;190526;187674;39;378200
53;2021-04-12;133;114;247;212098;212015;49;424113
53;2021-04-12;91;92;184;223699;219176;59;442875
53;2021-04-12;66;63;129;227435;209274;69;436709
53;2021-04-12;41;31;72;169992;140910;79;310902
53;2021-04-12;31;11;42;118117;69883;89;188000
53;2021-04-12;8;7;15;37370;12267;90;49637
53;2021-04-12;721;708;1434;1718886;1621493;0;3340379
75;2021-04-12;46;56;102;293104;305291;09;598395
75;2021-04-12;199;209;411;337141;357785;19;694926
75;2021-04-12;242;214;456;295024;300618;29;595642
75;2021-04-12;239;149;390;347871;331233;39;679104
75;2021-04-12;244;215;459;384742;372771;49;757513
75;2021-04-12;213;198;413;413361;390880;59;804241
75;2021-04-12;135;132;269;425623;384060;69;809683
75;2021-04-12;81;62;143;325086;276298;79;601384
75;2021-04-12;35;29;64;213986;139308;89;353294
75;2021-04-12;34;8;42;77600;28200;90;105800
75;2021-04-12;1468;1273;2750;3113538;2886444;0;5999982
76;2021-04-12;51;64;120;305956;318589;09;624545
76;2021-04-12;220;200;428;338942;356969;19;695911
76;2021-04-12;300;307;609;316210;319570;29;635780
76;2021-04-12;335;243;581;356758;337587;39;694345
76;2021-04-12;310;276;589;376541;363812;49;740353
76;2021-04-12;275;253;530;402608;383750;59;786358
76;2021-04-12;190;173;364;394889;358997;69;753886
76;2021-04-12;119;111;231;308664;263806;79;572470
76;2021-04-12;70;52;122;195838;129272;89;325110
76;2021-04-12;31;12;43;69372;26728;90;96100
76;2021-04-12;1904;1691;3620;3065778;2859080;0;5924858
84;2021-04-12;122;140;265;459549;481088;09;940637
84;2021-04-12;414;430;847;487711;511905;19;999616
84;2021-04-12;487;517;1007;443824;451094;29;894918
84;2021-04-12;572;495;1068;512522;493262;39;1005784
84;2021-04-12;540;574;1114;520248;515106;49;1035354
84;2021-04-12;471;479;951;529611;514848;59;1044459
84;2021-04-12;305;280;585;486720;439940;69;926660
84;2021-04-12;163;152;315;372151;315211;79;687362
84;2021-04-12;84;77;161;237198;150524;89;387722
84;2021-04-12;32;15;47;81185;28680;90;109865
84;2021-04-12;3192;3159;6362;4130719;3901658;0;8032377
93;2021-04-12;65;81;148;268834;283093;09;551927
93;2021-04-12;282;290;576;280751;296087;19;576838
93;2021-04-12;403;355;761;254404;255552;29;509956
93;2021-04-12;401;320;722;310704;288398;39;599102
93;2021-04-12;416;411;828;325559;305827;49;631386
93;2021-04-12;403;362;766;353104;325389;59;678493
93;2021-04-12;248;200;448;336327;296459;69;632786
93;2021-04-12;137;117;254;279820;229699;79;509519
93;2021-04-12;81;51;132;171274;113716;89;284990
93;2021-04-12;28;12;40;58896;21758;90;80654
93;2021-04-12;2465;2201;4678;2639673;2415978;0;5055651
94;2021-04-12;2;5;7;16311;17433;09;33744
94;2021-04-12;10;13;23;16679;18132;19;34811
94;2021-04-12;13;11;24;16782;16579;29;33361
94;2021-04-12;13;10;23;23044;20580;39;43624
94;2021-04-12;13;10;23;23065;22140;49;45205
94;2021-04-12;8;8;16;24549;23421;59;47970
94;2021-04-12;10;9;19;23212;21883;69;45095
94;2021-04-12;4;5;9;19544;17141;79;36685
94;2021-04-12;2;0;2;11227;8178;89;19405
94;2021-04-12;0;1;1;3332;1447;90;4779
94;2021-04-12;75;72;147;177745;166934;0;344679
01;2021-04-13;1;4;5;19979;20155;09;40134
01;2021-04-13;6;6;12;24994;25489;19;50483
01;2021-04-13;12;7;19;17868;16690;29;34558
01;2021-04-13;18;8;26;22328;14821;39;37149
01;2021-04-13;25;12;37;28652;20276;49;48928
01;2021-04-13;9;12;21;33264;27260;59;60524
01;2021-04-13;5;8;13;27135;23978;69;51113
01;2021-04-13;6;5;11;18401;14661;79;33062
01;2021-04-13;1;3;4;9633;6375;89;16008
01;2021-04-13;1;0;1;3410;1510;90;4920
01;2021-04-13;84;65;149;205664;171215;0;376879
02;2021-04-13;1;1;2;16881;17110;09;33991
02;2021-04-13;11;7;18;21410;21604;19;43014
02;2021-04-13;9;4;13;16017;15479;29;31496
02;2021-04-13;5;4;9;19825;14455;39;34280
02;2021-04-13;19;5;24;24719;18248;49;42967
02;2021-04-13;16;17;33;34361;28310;59;62671
02;2021-04-13;15;12;27;28061;24495;69;52556
02;2021-04-13;2;3;5;18231;15278;79;33509
02;2021-04-13;4;0;4;11090;7677;89;18767
02;2021-04-13;0;0;0;3992;1506;90;5498
02;2021-04-13;82;53;135;194587;164162;0;358749
03;2021-04-13;0;2;2;31123;30920;09;62043
03;2021-04-13;6;2;8;29370;29268;19;58638
03;2021-04-13;22;6;28;21458;18963;29;40421
03;2021-04-13;10;10;20;21276;18326;39;39602
03;2021-04-13;5;6;11;18164;16593;49;34757
03;2021-04-13;8;4;12;13469;13557;59;27026
03;2021-04-13;5;3;8;8776;8670;69;17446
03;2021-04-13;1;1;2;3777;3591;79;7368
03;2021-04-13;1;0;1;1649;1072;89;2721
03;2021-04-13;0;0;0;485;184;90;669
03;2021-04-13;58;34;92;149547;141144;0;290691
04;2021-04-13;7;8;15;60314;61377;09;121691
04;2021-04-13;9;10;19;66065;68387;19;134452
04;2021-04-13;15;7;22;51059;47156;29;98215
04;2021-04-13;12;10;22;58788;45780;39;104568
04;2021-04-13;8;7;15;61408;52207;49;113615
04;2021-04-13;10;12;22;64838;60759;59;125597
04;2021-04-13;5;8;13;47008;42843;69;89851
04;2021-04-13;0;2;2;25509;21184;79;46693
04;2021-04-13;1;0;1;13168;7647;89;20815
04;2021-04-13;0;0;0;3209;1253;90;4462
04;2021-04-13;67;64;131;451366;408593;0;859959
05;2021-04-13;0;0;0;362.366008612902;341.338819562748;09;703.704828175651
05;2021-04-13;0;0;0;353.376145114279;370.349735405642;19;723.725880519921
05;2021-04-13;0;0;0;218.593559489256;256.539602589476;29;475.133162078732
05;2021-04-13;0;0;0;404.225408693299;360.321910454353;39;764.547319147651
05;2021-04-13;0;0;0;520.067953604221;497.108383964256;49;1017.17633756848
05;2021-04-13;0;0;0;468.146063921917;510.087601910415;59;978.233665832332
05;2021-04-13;0;0;0;340.368470050554;334.366842191253;69;674.735312241807
05;2021-04-13;0;0;0;212.598666888387;192.597753227106;79;405.196420115493
05;2021-04-13;0;0;0;148.727797095705;61.8681715431829;89;210.595968638888
05;2021-04-13;0;0;0;32.9601271090696;10.9909785719784;90;43.9511056810479
05;2021-04-13;0;0;0;3061.43020057959;2935.56979942041;0;5997
06;2021-04-13;1;0;1;42583;42380;09;84963
06;2021-04-13;2;4;6;33369;31925;19;65294
06;2021-04-13;2;7;9;21571;15080;29;36651
06;2021-04-13;0;3;3;21550;16147;39;37697
06;2021-04-13;2;1;3;14193;13939;49;28132
06;2021-04-13;3;2;5;7171;7597;59;14768
06;2021-04-13;0;0;0;3629;4117;69;7746
06;2021-04-13;1;0;1;1577;1457;79;3034
06;2021-04-13;0;1;1;531;474;89;1005
06;2021-04-13;0;0;0;88;93;90;181
06;2021-04-13;11;18;29;146262;133209;0;279471
07;2021-04-13;0;0;0;485;549;09;1034
07;2021-04-13;0;0;0;403;432;19;835
07;2021-04-13;0;1;1;764;841;29;1605
07;2021-04-13;0;0;0;824;928;39;1752
07;2021-04-13;0;0;0;788;1020;49;1808
07;2021-04-13;0;1;1;678;870;59;1548
07;2021-04-13;0;0;0;360;382;69;742
07;2021-04-13;0;0;0;231;190;79;421
07;2021-04-13;0;0;0;114;67;89;181
07;2021-04-13;0;0;0;24;11;90;35
07;2021-04-13;0;2;2;4671;5290;0;9961
08;2021-04-13;0;0;0;2715.22592983026;2997.75551488675;09;5712.98144471701
08;2021-04-13;0;0;0;2778.51901080978;3160.9156459093;19;5939.43465671908
08;2021-04-13;0;0;0;2080.8882988764;1718.16634315323;29;3799.05464202964
08;2021-04-13;0;0;0;2701.8582062647;1896.52641413317;39;4598.38462039786
08;2021-04-13;0;0;0;3151.45861023308;2460.52498233809;49;5611.98359257117
08;2021-04-13;2;0;2;2620.29868333099;2422.23566154656;59;5042.53434487755
08;2021-04-13;0;1;1;1621.44173420671;1438.58325779464;69;3060.02499200135
08;2021-04-13;0;0;0;626.575909335673;526.358467843651;79;1152.93437717932
08;2021-04-13;0;0;0;205.018522985054;140.993639349697;89;346.012162334751
08;2021-04-13;0;0;0;50.0325684687745;20.62259870351;90;70.6551671722846
08;2021-04-13;2;1;3;18551.3174743414;16782.6825256586;0;35334
11;2021-04-13;196;194;429;783071;811785;09;1594856
11;2021-04-13;679;646;1382;761456;784653;19;1546109
11;2021-04-13;1166;1008;2185;850145;801772;29;1651917
11;2021-04-13;1141;1079;2236;914360;843488;39;1757848
11;2021-04-13;984;988;1984;845609;826202;49;1671811
11;2021-04-13;788;811;1610;793566;745070;59;1538636
11;2021-04-13;484;448;939;628649;549192;69;1177841
11;2021-04-13;224;208;433;434606;358356;79;792962
11;2021-04-13;101;70;171;261425;162933;89;424358
11;2021-04-13;45;18;63;89253;32619;90;121872
11;2021-04-13;5808;5471;11441;6362140;5916070;0;12278210
24;2021-04-13;24;17;42;139720;144686;09;284406
24;2021-04-13;99;88;188;152979;161185;19;314164
24;2021-04-13;83;103;186;122237;126536;29;248773
24;2021-04-13;126;99;225;150359;142009;39;292368
24;2021-04-13;122;105;227;161829;158758;49;320587
24;2021-04-13;112;113;225;172552;168011;59;340563
24;2021-04-13;69;63;132;172509;158177;69;330686
24;2021-04-13;38;37;75;129428;110593;79;240021
24;2021-04-13;25;14;39;87342;56882;89;144224
24;2021-04-13;15;5;20;31210;12071;90;43281
24;2021-04-13;713;644;1359;1320165;1238908;0;2559073
27;2021-04-13;23;21;45;143373;149679;09;293052
27;2021-04-13;82;101;183;160962;173003;19;333965
27;2021-04-13;123;120;244;133746;142254;29;276000
27;2021-04-13;98;104;202;160004;155407;39;315411
27;2021-04-13;97;101;198;172333;169564;49;341897
27;2021-04-13;118;114;232;189979;183788;59;373767
27;2021-04-13;83;87;170;192591;178206;69;370797
27;2021-04-13;47;37;84;146876;127546;79;274422
27;2021-04-13;26;19;45;96896;61575;89;158471
27;2021-04-13;17;4;21;33148;12109;90;45257
27;2021-04-13;714;708;1424;1429908;1353131;0;2783039
28;2021-04-13;48;40;90;180735;186856;09;367591
28;2021-04-13;125;112;241;200125;213621;19;413746
28;2021-04-13;148;147;295;168922;173007;29;341929
28;2021-04-13;159;122;282;196628;188487;39;385115
28;2021-04-13;126;117;243;205396;201699;49;407095
28;2021-04-13;131;124;255;222002;213866;59;435868
28;2021-04-13;110;83;194;224688;203758;69;428446
28;2021-04-13;58;44;102;163192;135543;79;298735
28;2021-04-13;32;21;53;109691;65377;89;175068
28;2021-04-13;15;3;18;37222;12685;90;49907
28;2021-04-13;952;813;1774;1708601;1594899;0;3303500
32;2021-04-13;84;92;176;358062;373689;09;731751
32;2021-04-13;250;277;529;387045;406742;19;793787
32;2021-04-13;343;293;644;342304;348587;29;690891
32;2021-04-13;327;280;609;382485;369972;39;752457
32;2021-04-13;263;306;574;382510;376716;49;759226
32;2021-04-13;265;248;513;386937;376527;59;763464
32;2021-04-13;190;150;341;371211;330938;69;702149
32;2021-04-13;101;83;185;250542;201459;79;452001
32;2021-04-13;90;43;133;163399;89786;89;253185
32;2021-04-13;36;20;56;48384;15367;90;63751
32;2021-04-13;1949;1793;3761;3072879;2889783;0;5962662
44;2021-04-13;70;63;134;291525;306839;09;598364
44;2021-04-13;215;216;433;320255;339504;19;659759
44;2021-04-13;231;229;462;302020;314428;29;616448
44;2021-04-13;204;206;410;342222;333292;39;675514
44;2021-04-13;213;205;418;349727;344491;49;694218
44;2021-04-13;191;210;403;381371;373239;59;754610
44;2021-04-13;128;116;244;367165;335850;69;703015
44;2021-04-13;73;65;138;250387;215436;79;465823
44;2021-04-13;58;41;99;170825;105192;89;276017
44;2021-04-13;16;6;22;51248;16731;90;67979
44;2021-04-13;1399;1357;2763;2826745;2685002;0;5511747
52;2021-04-13;49;45;94;213594;223900;09;437494
52;2021-04-13;139;156;299;240818;255197;19;496015
52;2021-04-13;164;142;306;197010;200630;29;397640
52;2021-04-13;139;132;271;231204;224885;39;456089
52;2021-04-13;153;138;291;243874;243418;49;487292
52;2021-04-13;138;138;276;244100;239116;59;483216
52;2021-04-13;87;64;151;241796;221345;69;463141
52;2021-04-13;52;39;91;177805;149903;79;327708
52;2021-04-13;33;12;46;119561;75822;89;195383
52;2021-04-13;22;6;28;42559;15260;90;57819
52;2021-04-13;976;872;1853;1952321;1849476;0;3801797
53;2021-04-13;37;35;72;173813;182358;09;356171
53;2021-04-13;116;97;215;202720;214740;19;417460
53;2021-04-13;90;103;194;163116;173196;29;336312
53;2021-04-13;97;99;196;190526;187674;39;378200
53;2021-04-13;109;98;208;212098;212015;49;424113
53;2021-04-13;76;71;147;223699;219176;59;442875
53;2021-04-13;50;52;102;227435;209274;69;436709
53;2021-04-13;27;34;61;169992;140910;79;310902
53;2021-04-13;18;16;34;118117;69883;89;188000
53;2021-04-13;8;4;12;37370;12267;90;49637
53;2021-04-13;628;609;1241;1718886;1621493;0;3340379
75;2021-04-13;53;41;96;293104;305291;09;598395
75;2021-04-13;152;145;299;337141;357785;19;694926
75;2021-04-13;157;171;329;295024;300618;29;595642
75;2021-04-13;173;149;322;347871;331233;39;679104
75;2021-04-13;197;174;371;384742;372771;49;757513
75;2021-04-13;155;164;319;413361;390880;59;804241
75;2021-04-13;101;92;193;425623;384060;69;809683
75;2021-04-13;63;61;124;325086;276298;79;601384
75;2021-04-13;55;36;91;213986;139308;89;353294
75;2021-04-13;28;3;31;77600;28200;90;105800
75;2021-04-13;1135;1037;2177;3113538;2886444;0;5999982
76;2021-04-13;52;42;96;305956;318589;09;624545
76;2021-04-13;188;195;388;338942;356969;19;695911
76;2021-04-13;227;227;454;316210;319570;29;635780
76;2021-04-13;214;191;405;356758;337587;39;694345
76;2021-04-13;238;192;432;376541;363812;49;740353
76;2021-04-13;212;196;409;402608;383750;59;786358
76;2021-04-13;128;108;236;394889;358997;69;753886
76;2021-04-13;81;78;159;308664;263806;79;572470
76;2021-04-13;52;42;94;195838;129272;89;325110
76;2021-04-13;54;17;71;69372;26728;90;96100
76;2021-04-13;1446;1288;2744;3065778;2859080;0;5924858
84;2021-04-13;80;111;193;459549;481088;09;940637
84;2021-04-13;338;326;666;487711;511905;19;999616
84;2021-04-13;401;372;773;443824;451094;29;894918
84;2021-04-13;381;370;752;512522;493262;39;1005784
84;2021-04-13;414;348;762;520248;515106;49;1035354
84;2021-04-13;338;367;706;529611;514848;59;1044459
84;2021-04-13;246;182;428;486720;439940;69;926660
84;2021-04-13;141;126;267;372151;315211;79;687362
84;2021-04-13;84;44;128;237198;150524;89;387722
84;2021-04-13;40;15;55;81185;28680;90;109865
84;2021-04-13;2464;2262;4732;4130719;3901658;0;8032377
93;2021-04-13;57;58;116;268834;283093;09;551927
93;2021-04-13;216;187;404;280751;296087;19;576838
93;2021-04-13;268;260;529;254404;255552;29;509956
93;2021-04-13;290;230;520;310704;288398;39;599102
93;2021-04-13;298;213;513;325559;305827;49;631386
93;2021-04-13;253;261;514;353104;325389;59;678493
93;2021-04-13;176;156;332;336327;296459;69;632786
93;2021-04-13;111;99;210;279820;229699;79;509519
93;2021-04-13;64;47;111;171274;113716;89;284990
93;2021-04-13;23;8;31;58896;21758;90;80654
93;2021-04-13;1756;1519;3280;2639673;2415978;0;5055651
94;2021-04-13;0;1;1;16311;17433;09;33744
94;2021-04-13;3;12;15;16679;18132;19;34811
94;2021-04-13;9;8;17;16782;16579;29;33361
94;2021-04-13;12;8;20;23044;20580;39;43624
94;2021-04-13;6;13;19;23065;22140;49;45205
94;2021-04-13;4;11;15;24549;23421;59;47970
94;2021-04-13;7;6;13;23212;21883;69;45095
94;2021-04-13;3;1;4;19544;17141;79;36685
94;2021-04-13;3;3;6;11227;8178;89;19405
94;2021-04-13;0;0;0;3332;1447;90;4779
94;2021-04-13;47;63;110;177745;166934;0;344679
01;2021-04-14;2;3;5;19979;20155;09;40134
01;2021-04-14;9;12;21;24994;25489;19;50483
01;2021-04-14;11;6;17;17868;16690;29;34558
01;2021-04-14;8;5;13;22328;14821;39;37149
01;2021-04-14;11;7;18;28652;20276;49;48928
01;2021-04-14;18;22;40;33264;27260;59;60524
01;2021-04-14;10;12;22;27135;23978;69;51113
01;2021-04-14;9;7;16;18401;14661;79;33062
01;2021-04-14;1;2;3;9633;6375;89;16008
01;2021-04-14;1;0;1;3410;1510;90;4920
01;2021-04-14;80;76;156;205664;171215;0;376879
02;2021-04-14;1;1;2;16881;17110;09;33991
02;2021-04-14;7;3;11;21410;21604;19;43014
02;2021-04-14;10;10;20;16017;15479;29;31496
02;2021-04-14;12;9;21;19825;14455;39;34280
02;2021-04-14;13;10;23;24719;18248;49;42967
02;2021-04-14;15;14;29;34361;28310;59;62671
02;2021-04-14;17;10;27;28061;24495;69;52556
02;2021-04-14;6;7;13;18231;15278;79;33509
02;2021-04-14;1;1;2;11090;7677;89;18767
02;2021-04-14;1;0;1;3992;1506;90;5498
02;2021-04-14;83;65;149;194587;164162;0;358749
03;2021-04-14;0;0;0;31123;30920;09;62043
03;2021-04-14;3;9;12;29370;29268;19;58638
03;2021-04-14;10;8;19;21458;18963;29;40421
03;2021-04-14;7;13;20;21276;18326;39;39602
03;2021-04-14;9;13;22;18164;16593;49;34757
03;2021-04-14;7;4;11;13469;13557;59;27026
03;2021-04-14;7;6;13;8776;8670;69;17446
03;2021-04-14;1;0;1;3777;3591;79;7368
03;2021-04-14;0;0;0;1649;1072;89;2721
03;2021-04-14;0;0;0;485;184;90;669
03;2021-04-14;44;53;98;149547;141144;0;290691
04;2021-04-14;8;7;15;60314;61377;09;121691
04;2021-04-14;15;16;31;66065;68387;19;134452
04;2021-04-14;13;8;21;51059;47156;29;98215
04;2021-04-14;13;8;22;58788;45780;39;104568
04;2021-04-14;12;9;21;61408;52207;49;113615
04;2021-04-14;6;5;11;64838;60759;59;125597
04;2021-04-14;15;4;19;47008;42843;69;89851
04;2021-04-14;1;2;3;25509;21184;79;46693
04;2021-04-14;2;0;2;13168;7647;89;20815
04;2021-04-14;1;0;1;3209;1253;90;4462
04;2021-04-14;86;59;146;451366;408593;0;859959
05;2021-04-14;0;0;0;362.366008612902;341.338819562748;09;703.704828175651
05;2021-04-14;0;0;0;353.376145114279;370.349735405642;19;723.725880519921
05;2021-04-14;0;0;0;218.593559489256;256.539602589476;29;475.133162078732
05;2021-04-14;0;0;0;404.225408693299;360.321910454353;39;764.547319147651
05;2021-04-14;0;0;0;520.067953604221;497.108383964256;49;1017.17633756848
05;2021-04-14;0;0;0;468.146063921917;510.087601910415;59;978.233665832332
05;2021-04-14;0;0;0;340.368470050554;334.366842191253;69;674.735312241807
05;2021-04-14;0;0;0;212.598666888387;192.597753227106;79;405.196420115493
05;2021-04-14;0;0;0;148.727797095705;61.8681715431829;89;210.595968638888
05;2021-04-14;0;0;0;32.9601271090696;10.9909785719784;90;43.9511056810479
05;2021-04-14;0;0;0;3061.43020057959;2935.56979942041;0;5997
06;2021-04-14;0;0;0;42583;42380;09;84963
06;2021-04-14;1;3;4;33369;31925;19;65294
06;2021-04-14;5;9;14;21571;15080;29;36651
06;2021-04-14;3;3;6;21550;16147;39;37697
06;2021-04-14;1;2;3;14193;13939;49;28132
06;2021-04-14;0;5;5;7171;7597;59;14768
06;2021-04-14;0;0;0;3629;4117;69;7746
06;2021-04-14;0;0;0;1577;1457;79;3034
06;2021-04-14;0;0;0;531;474;89;1005
06;2021-04-14;0;0;0;88;93;90;181
06;2021-04-14;10;22;32;146262;133209;0;279471
07;2021-04-14;0;0;0;485;549;09;1034
07;2021-04-14;0;0;0;403;432;19;835
07;2021-04-14;0;0;0;764;841;29;1605
07;2021-04-14;2;0;2;824;928;39;1752
07;2021-04-14;1;1;2;788;1020;49;1808
07;2021-04-14;0;0;0;678;870;59;1548
07;2021-04-14;1;0;1;360;382;69;742
07;2021-04-14;0;1;1;231;190;79;421
07;2021-04-14;0;0;0;114;67;89;181
07;2021-04-14;0;0;0;24;11;90;35
07;2021-04-14;4;2;6;4671;5290;0;9961
08;2021-04-14;0;0;0;2715.22592983026;2997.75551488675;09;5712.98144471701
08;2021-04-14;0;0;0;2778.51901080978;3160.9156459093;19;5939.43465671908
08;2021-04-14;0;0;0;2080.8882988764;1718.16634315323;29;3799.05464202964
08;2021-04-14;0;0;0;2701.8582062647;1896.52641413317;39;4598.38462039786
08;2021-04-14;0;0;0;3151.45861023308;2460.52498233809;49;5611.98359257117
08;2021-04-14;0;1;1;2620.29868333099;2422.23566154656;59;5042.53434487755
08;2021-04-14;0;0;0;1621.44173420671;1438.58325779464;69;3060.02499200135
08;2021-04-14;0;0;0;626.575909335673;526.358467843651;79;1152.93437717932
08;2021-04-14;0;0;0;205.018522985054;140.993639349697;89;346.012162334751
08;2021-04-14;0;0;0;50.0325684687745;20.62259870351;90;70.6551671722846
08;2021-04-14;0;1;1;18551.3174743414;16782.6825256586;0;35334
11;2021-04-14;193;204;419;783071;811785;09;1594856
11;2021-04-14;607;574;1218;761456;784653;19;1546109
11;2021-04-14;1108;1016;2136;850145;801772;29;1651917
11;2021-04-14;992;950;1965;914360;843488;39;1757848
11;2021-04-14;920;851;1780;845609;826202;49;1671811
11;2021-04-14;670;681;1362;793566;745070;59;1538636
11;2021-04-14;432;366;802;628649;549192;69;1177841
11;2021-04-14;161;179;343;434606;358356;79;792962
11;2021-04-14;104;73;177;261425;162933;89;424358
11;2021-04-14;51;17;68;89253;32619;90;121872
11;2021-04-14;5239;4912;10272;6362140;5916070;0;12278210
24;2021-04-14;21;26;48;139720;144686;09;284406
24;2021-04-14;81;99;181;152979;161185;19;314164
24;2021-04-14;81;92;174;122237;126536;29;248773
24;2021-04-14;93;85;178;150359;142009;39;292368
24;2021-04-14;97;96;193;161829;158758;49;320587
24;2021-04-14;109;100;209;172552;168011;59;340563
24;2021-04-14;67;60;127;172509;158177;69;330686
24;2021-04-14;38;34;73;129428;110593;79;240021
24;2021-04-14;21;6;27;87342;56882;89;144224
24;2021-04-14;8;7;15;31210;12071;90;43281
24;2021-04-14;616;605;1225;1320165;1238908;0;2559073
27;2021-04-14;19;24;43;143373;149679;09;293052
27;2021-04-14;81;99;181;160962;173003;19;333965
27;2021-04-14;103;101;204;133746;142254;29;276000
27;2021-04-14;107;84;191;160004;155407;39;315411
27;2021-04-14;107;75;182;172333;169564;49;341897
27;2021-04-14;107;108;215;189979;183788;59;373767
27;2021-04-14;58;49;107;192591;178206;69;370797
27;2021-04-14;35;39;74;146876;127546;79;274422
27;2021-04-14;21;15;36;96896;61575;89;158471
27;2021-04-14;12;6;18;33148;12109;90;45257
27;2021-04-14;650;600;1251;1429908;1353131;0;2783039
28;2021-04-14;37;43;81;180735;186856;09;367591
28;2021-04-14;128;104;233;200125;213621;19;413746
28;2021-04-14;120;114;234;168922;173007;29;341929
28;2021-04-14;132;113;245;196628;188487;39;385115
28;2021-04-14;128;124;255;205396;201699;49;407095
28;2021-04-14;126;125;251;222002;213866;59;435868
28;2021-04-14;62;72;134;224688;203758;69;428446
28;2021-04-14;44;39;83;163192;135543;79;298735
28;2021-04-14;27;18;45;109691;65377;89;175068
28;2021-04-14;11;8;19;37222;12685;90;49907
28;2021-04-14;815;760;1580;1708601;1594899;0;3303500
32;2021-04-14;106;114;221;358062;373689;09;731751
32;2021-04-14;309;309;625;387045;406742;19;793787
32;2021-04-14;309;311;623;342304;348587;29;690891
32;2021-04-14;307;310;620;382485;369972;39;752457
32;2021-04-14;318;284;605;382510;376716;49;759226
32;2021-04-14;248;250;500;386937;376527;59;763464
32;2021-04-14;178;160;339;371211;330938;69;702149
32;2021-04-14;70;95;165;250542;201459;79;452001
32;2021-04-14;68;35;103;163399;89786;89;253185
32;2021-04-14;26;7;33;48384;15367;90;63751
32;2021-04-14;1939;1875;3834;3072879;2889783;0;5962662
44;2021-04-14;64;65;129;291525;306839;09;598364
44;2021-04-14;188;169;358;320255;339504;19;659759
44;2021-04-14;226;179;408;302020;314428;29;616448
44;2021-04-14;227;167;396;342222;333292;39;675514
44;2021-04-14;195;157;354;349727;344491;49;694218
44;2021-04-14;188;174;365;381371;373239;59;754610
44;2021-04-14;104;116;221;367165;335850;69;703015
44;2021-04-14;72;65;138;250387;215436;79;465823
44;2021-04-14;53;25;78;170825;105192;89;276017
44;2021-04-14;22;3;26;51248;16731;90;67979
44;2021-04-14;1339;1120;2473;2826745;2685002;0;5511747
52;2021-04-14;49;48;100;213594;223900;09;437494
52;2021-04-14;120;134;256;240818;255197;19;496015
52;2021-04-14;140;172;312;197010;200630;29;397640
52;2021-04-14;129;117;246;231204;224885;39;456089
52;2021-04-14;144;156;300;243874;243418;49;487292
52;2021-04-14;133;134;267;244100;239116;59;483216
52;2021-04-14;71;85;156;241796;221345;69;463141
52;2021-04-14;25;47;72;177805;149903;79;327708
52;2021-04-14;18;19;37;119561;75822;89;195383
52;2021-04-14;8;7;15;42559;15260;90;57819
52;2021-04-14;837;919;1761;1952321;1849476;0;3801797
53;2021-04-14;25;33;59;173813;182358;09;356171
53;2021-04-14;75;80;155;202720;214740;19;417460
53;2021-04-14;98;103;205;163116;173196;29;336312
53;2021-04-14;84;59;144;190526;187674;39;378200
53;2021-04-14;76;81;157;212098;212015;49;424113
53;2021-04-14;90;64;154;223699;219176;59;442875
53;2021-04-14;44;59;103;227435;209274;69;436709
53;2021-04-14;26;30;56;169992;140910;79;310902
53;2021-04-14;16;10;26;118117;69883;89;188000
53;2021-04-14;2;5;7;37370;12267;90;49637
53;2021-04-14;536;524;1066;1718886;1621493;0;3340379
75;2021-04-14;45;38;84;293104;305291;09;598395
75;2021-04-14;138;131;269;337141;357785;19;694926
75;2021-04-14;169;167;336;295024;300618;29;595642
75;2021-04-14;158;146;304;347871;331233;39;679104
75;2021-04-14;151;137;288;384742;372771;49;757513
75;2021-04-14;135;148;283;413361;390880;59;804241
75;2021-04-14;89;83;172;425623;384060;69;809683
75;2021-04-14;51;50;101;325086;276298;79;601384
75;2021-04-14;35;19;54;213986;139308;89;353294
75;2021-04-14;17;6;23;77600;28200;90;105800
75;2021-04-14;988;925;1914;3113538;2886444;0;5999982
76;2021-04-14;28;47;76;305956;318589;09;624545
76;2021-04-14;139;183;325;338942;356969;19;695911
76;2021-04-14;237;223;460;316210;319570;29;635780
76;2021-04-14;184;154;341;356758;337587;39;694345
76;2021-04-14;210;162;372;376541;363812;49;740353
76;2021-04-14;210;153;365;402608;383750;59;786358
76;2021-04-14;135;127;264;394889;358997;69;753886
76;2021-04-14;76;56;132;308664;263806;79;572470
76;2021-04-14;64;34;98;195838;129272;89;325110
76;2021-04-14;41;19;60;69372;26728;90;96100
76;2021-04-14;1324;1159;2494;3065778;2859080;0;5924858
84;2021-04-14;103;80;183;459549;481088;09;940637
84;2021-04-14;351;301;653;487711;511905;19;999616
84;2021-04-14;339;362;703;443824;451094;29;894918
84;2021-04-14;371;344;715;512522;493262;39;1005784
84;2021-04-14;353;335;689;520248;515106;49;1035354
84;2021-04-14;306;295;602;529611;514848;59;1044459
84;2021-04-14;189;194;384;486720;439940;69;926660
84;2021-04-14;99;128;228;372151;315211;79;687362
84;2021-04-14;73;43;117;237198;150524;89;387722
84;2021-04-14;24;19;43;81185;28680;90;109865
84;2021-04-14;2208;2101;4318;4130719;3901658;0;8032377
93;2021-04-14;44;53;97;268834;283093;09;551927
93;2021-04-14;175;191;367;280751;296087;19;576838
93;2021-04-14;258;244;503;254404;255552;29;509956
93;2021-04-14;249;208;457;310704;288398;39;599102
93;2021-04-14;248;227;476;325559;305827;49;631386
93;2021-04-14;265;214;481;353104;325389;59;678493
93;2021-04-14;146;170;316;336327;296459;69;632786
93;2021-04-14;68;90;158;279820;229699;79;509519
93;2021-04-14;58;35;93;171274;113716;89;284990
93;2021-04-14;15;8;23;58896;21758;90;80654
93;2021-04-14;1526;1440;2971;2639673;2415978;0;5055651
94;2021-04-14;2;0;2;16311;17433;09;33744
94;2021-04-14;5;6;11;16679;18132;19;34811
94;2021-04-14;7;5;12;16782;16579;29;33361
94;2021-04-14;4;12;16;23044;20580;39;43624
94;2021-04-14;7;3;10;23065;22140;49;45205
94;2021-04-14;5;10;15;24549;23421;59;47970
94;2021-04-14;4;6;10;23212;21883;69;45095
94;2021-04-14;2;5;7;19544;17141;79;36685
94;2021-04-14;1;0;1;11227;8178;89;19405
94;2021-04-14;0;0;0;3332;1447;90;4779
94;2021-04-14;37;47;84;177745;166934;0;344679
01;2021-04-15;1;0;1;19979;20155;09;40134
01;2021-04-15;9;5;14;24994;25489;19;50483
01;2021-04-15;14;13;27;17868;16690;29;34558
01;2021-04-15;13;8;21;22328;14821;39;37149
01;2021-04-15;8;8;16;28652;20276;49;48928
01;2021-04-15;12;12;24;33264;27260;59;60524
01;2021-04-15;10;7;17;27135;23978;69;51113
01;2021-04-15;7;5;12;18401;14661;79;33062
01;2021-04-15;4;6;10;9633;6375;89;16008
01;2021-04-15;0;0;0;3410;1510;90;4920
01;2021-04-15;78;64;142;205664;171215;0;376879
02;2021-04-15;0;5;5;16881;17110;09;33991
02;2021-04-15;6;8;14;21410;21604;19;43014
02;2021-04-15;11;3;14;16017;15479;29;31496
02;2021-04-15;7;6;13;19825;14455;39;34280
02;2021-04-15;13;8;21;24719;18248;49;42967
02;2021-04-15;27;12;39;34361;28310;59;62671
02;2021-04-15;8;7;15;28061;24495;69;52556
02;2021-04-15;5;2;7;18231;15278;79;33509
02;2021-04-15;2;0;2;11090;7677;89;18767
02;2021-04-15;0;0;0;3992;1506;90;5498
02;2021-04-15;79;51;130;194587;164162;0;358749
03;2021-04-15;2;2;4;31123;30920;09;62043
03;2021-04-15;8;7;15;29370;29268;19;58638
03;2021-04-15;10;13;23;21458;18963;29;40421
03;2021-04-15;16;7;23;21276;18326;39;39602
03;2021-04-15;5;7;12;18164;16593;49;34757
03;2021-04-15;10;9;19;13469;13557;59;27026
03;2021-04-15;3;5;8;8776;8670;69;17446
03;2021-04-15;0;0;0;3777;3591;79;7368
03;2021-04-15;1;1;2;1649;1072;89;2721
03;2021-04-15;0;0;0;485;184;90;669
03;2021-04-15;55;51;106;149547;141144;0;290691
04;2021-04-15;6;5;11;60314;61377;09;121691
04;2021-04-15;8;14;22;66065;68387;19;134452
04;2021-04-15;10;5;15;51059;47156;29;98215
04;2021-04-15;13;10;23;58788;45780;39;104568
04;2021-04-15;15;9;24;61408;52207;49;113615
04;2021-04-15;6;4;10;64838;60759;59;125597
04;2021-04-15;6;5;11;47008;42843;69;89851
04;2021-04-15;3;3;6;25509;21184;79;46693
04;2021-04-15;4;4;8;13168;7647;89;20815
04;2021-04-15;0;0;0;3209;1253;90;4462
04;2021-04-15;71;59;130;451366;408593;0;859959
05;2021-04-15;0;0;0;362.366008612902;341.338819562748;09;703.704828175651
05;2021-04-15;0;0;0;353.376145114279;370.349735405642;19;723.725880519921
05;2021-04-15;0;0;0;218.593559489256;256.539602589476;29;475.133162078732
05;2021-04-15;0;0;0;404.225408693299;360.321910454353;39;764.547319147651
05;2021-04-15;0;0;0;520.067953604221;497.108383964256;49;1017.17633756848
05;2021-04-15;0;0;0;468.146063921917;510.087601910415;59;978.233665832332
05;2021-04-15;0;0;0;340.368470050554;334.366842191253;69;674.735312241807
05;2021-04-15;0;0;0;212.598666888387;192.597753227106;79;405.196420115493
05;2021-04-15;0;0;0;148.727797095705;61.8681715431829;89;210.595968638888
05;2021-04-15;0;0;0;32.9601271090696;10.9909785719784;90;43.9511056810479
05;2021-04-15;0;0;0;3061.43020057959;2935.56979942041;0;5997
06;2021-04-15;0;0;0;42583;42380;09;84963
06;2021-04-15;2;2;4;33369;31925;19;65294
06;2021-04-15;1;2;3;21571;15080;29;36651
06;2021-04-15;4;1;5;21550;16147;39;37697
06;2021-04-15;0;3;3;14193;13939;49;28132
06;2021-04-15;1;2;3;7171;7597;59;14768
06;2021-04-15;0;0;0;3629;4117;69;7746
06;2021-04-15;0;0;0;1577;1457;79;3034
06;2021-04-15;0;1;1;531;474;89;1005
06;2021-04-15;0;0;0;88;93;90;181
06;2021-04-15;8;11;19;146262;133209;0;279471
07;2021-04-15;0;0;0;485;549;09;1034
07;2021-04-15;0;0;0;403;432;19;835
07;2021-04-15;0;0;0;764;841;29;1605
07;2021-04-15;1;0;1;824;928;39;1752
07;2021-04-15;0;0;0;788;1020;49;1808
07;2021-04-15;0;0;0;678;870;59;1548
07;2021-04-15;0;0;0;360;382;69;742
07;2021-04-15;0;0;0;231;190;79;421
07;2021-04-15;0;0;0;114;67;89;181
07;2021-04-15;0;0;0;24;11;90;35
07;2021-04-15;1;0;1;4671;5290;0;9961
08;2021-04-15;0;0;0;2715.22592983026;2997.75551488675;09;5712.98144471701
08;2021-04-15;1;0;1;2778.51901080978;3160.9156459093;19;5939.43465671908
08;2021-04-15;0;0;0;2080.8882988764;1718.16634315323;29;3799.05464202964
08;2021-04-15;1;1;2;2701.8582062647;1896.52641413317;39;4598.38462039786
08;2021-04-15;0;0;0;3151.45861023308;2460.52498233809;49;5611.98359257117
08;2021-04-15;0;1;1;2620.29868333099;2422.23566154656;59;5042.53434487755
08;2021-04-15;0;0;0;1621.44173420671;1438.58325779464;69;3060.02499200135
08;2021-04-15;0;0;0;626.575909335673;526.358467843651;79;1152.93437717932
08;2021-04-15;0;0;0;205.018522985054;140.993639349697;89;346.012162334751
08;2021-04-15;0;0;0;50.0325684687745;20.62259870351;90;70.6551671722846
08;2021-04-15;2;2;4;18551.3174743414;16782.6825256586;0;35334
11;2021-04-15;178;173;378;783071;811785;09;1594856
11;2021-04-15;607;565;1236;761456;784653;19;1546109
11;2021-04-15;1068;966;2048;850145;801772;29;1651917
11;2021-04-15;961;932;1904;914360;843488;39;1757848
11;2021-04-15;855;846;1711;845609;826202;49;1671811
11;2021-04-15;745;683;1441;793566;745070;59;1538636
11;2021-04-15;372;360;736;628649;549192;69;1177841
11;2021-04-15;182;172;355;434606;358356;79;792962
11;2021-04-15;98;68;167;261425;162933;89;424358
11;2021-04-15;32;17;49;89253;32619;90;121872
11;2021-04-15;5099;4784;10032;6362140;5916070;0;12278210
24;2021-04-15;25;33;59;139720;144686;09;284406
24;2021-04-15;87;123;212;152979;161185;19;314164
24;2021-04-15;112;101;214;122237;126536;29;248773
24;2021-04-15;83;90;173;150359;142009;39;292368
24;2021-04-15;111;104;215;161829;158758;49;320587
24;2021-04-15;97;100;197;172552;168011;59;340563
24;2021-04-15;69;92;161;172509;158177;69;330686
24;2021-04-15;40;37;77;129428;110593;79;240021
24;2021-04-15;22;13;35;87342;56882;89;144224
24;2021-04-15;9;4;13;31210;12071;90;43281
24;2021-04-15;655;697;1356;1320165;1238908;0;2559073
27;2021-04-15;30;24;54;143373;149679;09;293052
27;2021-04-15;90;96;186;160962;173003;19;333965
27;2021-04-15;112;111;223;133746;142254;29;276000
27;2021-04-15;107;93;200;160004;155407;39;315411
27;2021-04-15;91;112;203;172333;169564;49;341897
27;2021-04-15;111;87;198;189979;183788;59;373767
27;2021-04-15;76;77;153;192591;178206;69;370797
27;2021-04-15;37;36;73;146876;127546;79;274422
27;2021-04-15;29;14;43;96896;61575;89;158471
27;2021-04-15;10;6;16;33148;12109;90;45257
27;2021-04-15;693;656;1349;1429908;1353131;0;2783039
28;2021-04-15;51;45;101;180735;186856;09;367591
28;2021-04-15;105;108;216;200125;213621;19;413746
28;2021-04-15;129;112;244;168922;173007;29;341929
28;2021-04-15;133;129;262;196628;188487;39;385115
28;2021-04-15;138;118;258;205396;201699;49;407095
28;2021-04-15;115;136;252;222002;213866;59;435868
28;2021-04-15;78;79;157;224688;203758;69;428446
28;2021-04-15;44;47;91;163192;135543;79;298735
28;2021-04-15;19;25;44;109691;65377;89;175068
28;2021-04-15;23;2;25;37222;12685;90;49907
28;2021-04-15;835;801;1651;1708601;1594899;0;3303500
32;2021-04-15;109;111;221;358062;373689;09;731751
32;2021-04-15;285;255;544;387045;406742;19;793787
32;2021-04-15;352;328;683;342304;348587;29;690891
32;2021-04-15;335;299;639;382485;369972;39;752457
32;2021-04-15;301;282;586;382510;376716;49;759226
32;2021-04-15;249;282;531;386937;376527;59;763464
32;2021-04-15;174;138;313;371211;330938;69;702149
32;2021-04-15;91;72;163;250542;201459;79;452001
32;2021-04-15;70;18;88;163399;89786;89;253185
32;2021-04-15;50;18;68;48384;15367;90;63751
32;2021-04-15;2017;1803;3837;3072879;2889783;0;5962662
44;2021-04-15;51;63;114;291525;306839;09;598364
44;2021-04-15;179;181;364;320255;339504;19;659759
44;2021-04-15;211;181;395;302020;314428;29;616448
44;2021-04-15;196;182;380;342222;333292;39;675514
44;2021-04-15;175;162;337;349727;344491;49;694218
44;2021-04-15;171;184;357;381371;373239;59;754610
44;2021-04-15;118;110;228;367165;335850;69;703015
44;2021-04-15;70;69;141;250387;215436;79;465823
44;2021-04-15;50;29;79;170825;105192;89;276017
44;2021-04-15;23;8;33;51248;16731;90;67979
44;2021-04-15;1244;1169;2428;2826745;2685002;0;5511747
52;2021-04-15;49;49;99;213594;223900;09;437494
52;2021-04-15;153;171;327;240818;255197;19;496015
52;2021-04-15;147;157;304;197010;200630;29;397640
52;2021-04-15;138;98;236;231204;224885;39;456089
52;2021-04-15;140;139;279;243874;243418;49;487292
52;2021-04-15;101;89;190;244100;239116;59;483216
52;2021-04-15;59;86;145;241796;221345;69;463141
52;2021-04-15;40;37;77;177805;149903;79;327708
52;2021-04-15;27;16;43;119561;75822;89;195383
52;2021-04-15;24;6;30;42559;15260;90;57819
52;2021-04-15;878;848;1730;1952321;1849476;0;3801797
53;2021-04-15;26;31;57;173813;182358;09;356171
53;2021-04-15;69;73;143;202720;214740;19;417460
53;2021-04-15;95;90;188;163116;173196;29;336312
53;2021-04-15;86;76;162;190526;187674;39;378200
53;2021-04-15;59;65;124;212098;212015;49;424113
53;2021-04-15;59;75;134;223699;219176;59;442875
53;2021-04-15;49;38;87;227435;209274;69;436709
53;2021-04-15;22;18;40;169992;140910;79;310902
53;2021-04-15;19;15;34;118117;69883;89;188000
53;2021-04-15;11;5;16;37370;12267;90;49637
53;2021-04-15;495;486;985;1718886;1621493;0;3340379
75;2021-04-15;26;38;64;293104;305291;09;598395
75;2021-04-15;171;134;306;337141;357785;19;694926
75;2021-04-15;147;176;323;295024;300618;29;595642
75;2021-04-15;149;147;297;347871;331233;39;679104
75;2021-04-15;165;147;312;384742;372771;49;757513
75;2021-04-15;133;140;273;413361;390880;59;804241
75;2021-04-15;93;100;193;425623;384060;69;809683
75;2021-04-15;53;44;98;325086;276298;79;601384
75;2021-04-15;39;21;60;213986;139308;89;353294
75;2021-04-15;34;7;41;77600;28200;90;105800
75;2021-04-15;1011;954;1968;3113538;2886444;0;5999982
76;2021-04-15;56;49;106;305956;318589;09;624545
76;2021-04-15;178;172;355;338942;356969;19;695911
76;2021-04-15;199;214;415;316210;319570;29;635780
76;2021-04-15;194;130;325;356758;337587;39;694345
76;2021-04-15;200;178;379;376541;363812;49;740353
76;2021-04-15;157;153;311;402608;383750;59;786358
76;2021-04-15;86;84;172;394889;358997;69;753886
76;2021-04-15;63;62;125;308664;263806;79;572470
76;2021-04-15;46;27;73;195838;129272;89;325110
76;2021-04-15;25;13;38;69372;26728;90;96100
76;2021-04-15;1207;1084;2304;3065778;2859080;0;5924858
84;2021-04-15;109;94;204;459549;481088;09;940637
84;2021-04-15;310;303;614;487711;511905;19;999616
84;2021-04-15;347;358;707;443824;451094;29;894918
84;2021-04-15;337;325;664;512522;493262;39;1005784
84;2021-04-15;332;294;626;520248;515106;49;1035354
84;2021-04-15;311;282;594;529611;514848;59;1044459
84;2021-04-15;190;184;375;486720;439940;69;926660
84;2021-04-15;108;130;238;372151;315211;79;687362
84;2021-04-15;65;47;112;237198;150524;89;387722
84;2021-04-15;23;17;40;81185;28680;90;109865
84;2021-04-15;2132;2034;4174;4130719;3901658;0;8032377
93;2021-04-15;64;61;125;268834;283093;09;551927
93;2021-04-15;170;170;340;280751;296087;19;576838
93;2021-04-15;278;238;518;254404;255552;29;509956
93;2021-04-15;266;221;488;310704;288398;39;599102
93;2021-04-15;251;215;468;325559;305827;49;631386
93;2021-04-15;235;223;458;353104;325389;59;678493
93;2021-04-15;168;142;310;336327;296459;69;632786
93;2021-04-15;68;77;145;279820;229699;79;509519
93;2021-04-15;62;34;96;171274;113716;89;284990
93;2021-04-15;22;13;35;58896;21758;90;80654
93;2021-04-15;1585;1394;2984;2639673;2415978;0;5055651
94;2021-04-15;3;0;3;16311;17433;09;33744
94;2021-04-15;5;11;17;16679;18132;19;34811
94;2021-04-15;7;2;9;16782;16579;29;33361
94;2021-04-15;6;2;8;23044;20580;39;43624
94;2021-04-15;2;6;8;23065;22140;49;45205
94;2021-04-15;9;6;15;24549;23421;59;47970
94;2021-04-15;5;2;7;23212;21883;69;45095
94;2021-04-15;1;1;2;19544;17141;79;36685
94;2021-04-15;3;0;3;11227;8178;89;19405
94;2021-04-15;2;2;4;3332;1447;90;4779
94;2021-04-15;43;32;76;177745;166934;0;344679
01;2021-04-16;2;1;3;19979;20155;09;40134
01;2021-04-16;9;10;19;24994;25489;19;50483
01;2021-04-16;11;6;17;17868;16690;29;34558
01;2021-04-16;14;9;23;22328;14821;39;37149
01;2021-04-16;10;10;20;28652;20276;49;48928
01;2021-04-16;18;9;27;33264;27260;59;60524
01;2021-04-16;9;9;18;27135;23978;69;51113
01;2021-04-16;5;2;7;18401;14661;79;33062
01;2021-04-16;1;3;4;9633;6375;89;16008
01;2021-04-16;0;0;0;3410;1510;90;4920
01;2021-04-16;79;59;138;205664;171215;0;376879
02;2021-04-16;2;3;5;16881;17110;09;33991
02;2021-04-16;9;7;16;21410;21604;19;43014
02;2021-04-16;7;3;10;16017;15479;29;31496
02;2021-04-16;14;7;21;19825;14455;39;34280
02;2021-04-16;13;8;21;24719;18248;49;42967
02;2021-04-16;16;16;32;34361;28310;59;62671
02;2021-04-16;10;7;17;28061;24495;69;52556
02;2021-04-16;3;1;4;18231;15278;79;33509
02;2021-04-16;3;1;4;11090;7677;89;18767
02;2021-04-16;0;0;0;3992;1506;90;5498
02;2021-04-16;77;53;130;194587;164162;0;358749
03;2021-04-16;1;1;2;31123;30920;09;62043
03;2021-04-16;9;8;17;29370;29268;19;58638
03;2021-04-16;7;11;18;21458;18963;29;40421
03;2021-04-16;20;10;30;21276;18326;39;39602
03;2021-04-16;6;7;13;18164;16593;49;34757
03;2021-04-16;8;2;10;13469;13557;59;27026
03;2021-04-16;7;3;10;8776;8670;69;17446
03;2021-04-16;2;1;3;3777;3591;79;7368
03;2021-04-16;0;0;0;1649;1072;89;2721
03;2021-04-16;0;0;0;485;184;90;669
03;2021-04-16;60;43;103;149547;141144;0;290691
04;2021-04-16;6;5;11;60314;61377;09;121691
04;2021-04-16;8;24;32;66065;68387;19;134452
04;2021-04-16;20;4;24;51059;47156;29;98215
04;2021-04-16;15;12;28;58788;45780;39;104568
04;2021-04-16;17;18;35;61408;52207;49;113615
04;2021-04-16;17;14;31;64838;60759;59;125597
04;2021-04-16;6;4;10;47008;42843;69;89851
04;2021-04-16;2;1;3;25509;21184;79;46693
04;2021-04-16;2;2;4;13168;7647;89;20815
04;2021-04-16;0;0;0;3209;1253;90;4462
04;2021-04-16;93;84;178;451366;408593;0;859959
05;2021-04-16;0;0;0;362.366008612902;341.338819562748;09;703.704828175651
05;2021-04-16;0;0;0;353.376145114279;370.349735405642;19;723.725880519921
05;2021-04-16;0;0;0;218.593559489256;256.539602589476;29;475.133162078732
05;2021-04-16;0;0;0;404.225408693299;360.321910454353;39;764.547319147651
05;2021-04-16;0;0;0;520.067953604221;497.108383964256;49;1017.17633756848
05;2021-04-16;0;0;0;468.146063921917;510.087601910415;59;978.233665832332
05;2021-04-16;0;0;0;340.368470050554;334.366842191253;69;674.735312241807
05;2021-04-16;0;0;0;212.598666888387;192.597753227106;79;405.196420115493
05;2021-04-16;0;0;0;148.727797095705;61.8681715431829;89;210.595968638888
05;2021-04-16;0;0;0;32.9601271090696;10.9909785719784;90;43.9511056810479
05;2021-04-16;0;0;0;3061.43020057959;2935.56979942041;0;5997
06;2021-04-16;0;0;0;42583;42380;09;84963
06;2021-04-16;0;0;0;33369;31925;19;65294
06;2021-04-16;5;2;7;21571;15080;29;36651
06;2021-04-16;0;5;5;21550;16147;39;37697
06;2021-04-16;3;4;7;14193;13939;49;28132
06;2021-04-16;0;2;2;7171;7597;59;14768
06;2021-04-16;1;0;1;3629;4117;69;7746
06;2021-04-16;0;0;0;1577;1457;79;3034
06;2021-04-16;0;0;0;531;474;89;1005
06;2021-04-16;0;0;0;88;93;90;181
06;2021-04-16;9;13;22;146262;133209;0;279471
07;2021-04-16;0;0;0;485;549;09;1034
07;2021-04-16;0;0;0;403;432;19;835
07;2021-04-16;0;0;0;764;841;29;1605
07;2021-04-16;0;0;0;824;928;39;1752
07;2021-04-16;0;0;0;788;1020;49;1808
07;2021-04-16;0;2;2;678;870;59;1548
07;2021-04-16;0;0;0;360;382;69;742
07;2021-04-16;0;0;0;231;190;79;421
07;2021-04-16;0;0;0;114;67;89;181
07;2021-04-16;0;0;0;24;11;90;35
07;2021-04-16;0;2;2;4671;5290;0;9961
08;2021-04-16;0;0;0;2715.22592983026;2997.75551488675;09;5712.98144471701
08;2021-04-16;0;0;0;2778.51901080978;3160.9156459093;19;5939.43465671908
08;2021-04-16;1;0;1;2080.8882988764;1718.16634315323;29;3799.05464202964
08;2021-04-16;0;1;1;2701.8582062647;1896.52641413317;39;4598.38462039786
08;2021-04-16;0;1;1;3151.45861023308;2460.52498233809;49;5611.98359257117
08;2021-04-16;0;1;1;2620.29868333099;2422.23566154656;59;5042.53434487755
08;2021-04-16;0;0;0;1621.44173420671;1438.58325779464;69;3060.02499200135
08;2021-04-16;0;0;0;626.575909335673;526.358467843651;79;1152.93437717932
08;2021-04-16;0;0;0;205.018522985054;140.993639349697;89;346.012162334751
08;2021-04-16;0;0;0;50.0325684687745;20.62259870351;90;70.6551671722846
08;2021-04-16;1;3;4;18551.3174743414;16782.6825256586;0;35334
11;2021-04-16;207;203;432;783071;811785;09;1594856
11;2021-04-16;594;587;1233;761456;784653;19;1546109
11;2021-04-16;1083;1017;2117;850145;801772;29;1651917
11;2021-04-16;1035;936;1987;914360;843488;39;1757848
11;2021-04-16;883;860;1761;845609;826202;49;1671811
11;2021-04-16;753;681;1444;793566;745070;59;1538636
11;2021-04-16;396;384;782;628649;549192;69;1177841
11;2021-04-16;185;173;361;434606;358356;79;792962
11;2021-04-16;87;74;162;261425;162933;89;424358
11;2021-04-16;48;23;71;89253;32619;90;121872
11;2021-04-16;5273;4939;10363;6362140;5916070;0;12278210
24;2021-04-16;18;27;47;139720;144686;09;284406
24;2021-04-16;100;113;215;152979;161185;19;314164
24;2021-04-16;93;104;197;122237;126536;29;248773
24;2021-04-16;110;101;214;150359;142009;39;292368
24;2021-04-16;102;105;207;161829;158758;49;320587
24;2021-04-16;93;85;178;172552;168011;59;340563
24;2021-04-16;64;63;127;172509;158177;69;330686
24;2021-04-16;33;41;74;129428;110593;79;240021
24;2021-04-16;21;6;27;87342;56882;89;144224
24;2021-04-16;16;6;22;31210;12071;90;43281
24;2021-04-16;650;651;1308;1320165;1238908;0;2559073
27;2021-04-16;12;42;54;143373;149679;09;293052
27;2021-04-16;103;109;213;160962;173003;19;333965
27;2021-04-16;89;133;222;133746;142254;29;276000
27;2021-04-16;96;66;163;160004;155407;39;315411
27;2021-04-16;106;92;198;172333;169564;49;341897
27;2021-04-16;73;93;166;189979;183788;59;373767
27;2021-04-16;54;51;105;192591;178206;69;370797
27;2021-04-16;31;36;67;146876;127546;79;274422
27;2021-04-16;21;25;46;96896;61575;89;158471
27;2021-04-16;12;6;18;33148;12109;90;45257
27;2021-04-16;597;653;1252;1429908;1353131;0;2783039
28;2021-04-16;50;50;105;180735;186856;09;367591
28;2021-04-16;123;113;238;200125;213621;19;413746
28;2021-04-16;131;115;247;168922;173007;29;341929
28;2021-04-16;135;137;274;196628;188487;39;385115
28;2021-04-16;134;121;255;205396;201699;49;407095
28;2021-04-16;104;121;227;222002;213866;59;435868
28;2021-04-16;93;95;189;224688;203758;69;428446
28;2021-04-16;51;40;91;163192;135543;79;298735
28;2021-04-16;24;21;45;109691;65377;89;175068
28;2021-04-16;23;4;27;37222;12685;90;49907
28;2021-04-16;868;817;1699;1708601;1594899;0;3303500
32;2021-04-16;131;119;251;358062;373689;09;731751
32;2021-04-16;343;311;661;387045;406742;19;793787
32;2021-04-16;354;305;665;342304;348587;29;690891
32;2021-04-16;356;332;689;382485;369972;39;752457
32;2021-04-16;299;332;635;382510;376716;49;759226
32;2021-04-16;282;279;562;386937;376527;59;763464
32;2021-04-16;171;155;326;371211;330938;69;702149
32;2021-04-16;84;72;156;250542;201459;79;452001
32;2021-04-16;47;28;75;163399;89786;89;253185
32;2021-04-16;21;5;26;48384;15367;90;63751
32;2021-04-16;2089;1939;4048;3072879;2889783;0;5962662
44;2021-04-16;58;60;119;291525;306839;09;598364
44;2021-04-16;161;182;346;320255;339504;19;659759
44;2021-04-16;202;191;394;302020;314428;29;616448
44;2021-04-16;211;189;400;342222;333292;39;675514
44;2021-04-16;187;182;369;349727;344491;49;694218
44;2021-04-16;200;179;379;381371;373239;59;754610
44;2021-04-16;124;114;241;367165;335850;69;703015
44;2021-04-16;62;78;143;250387;215436;79;465823
44;2021-04-16;39;29;68;170825;105192;89;276017
44;2021-04-16;19;4;23;51248;16731;90;67979
44;2021-04-16;1263;1208;2482;2826745;2685002;0;5511747
52;2021-04-16;42;50;95;213594;223900;09;437494
52;2021-04-16;139;148;289;240818;255197;19;496015
52;2021-04-16;135;141;276;197010;200630;29;397640
52;2021-04-16;132;105;237;231204;224885;39;456089
52;2021-04-16;126;131;258;243874;243418;49;487292
52;2021-04-16;117;127;244;244100;239116;59;483216
52;2021-04-16;83;69;152;241796;221345;69;463141
52;2021-04-16;32;36;68;177805;149903;79;327708
52;2021-04-16;31;17;48;119561;75822;89;195383
52;2021-04-16;20;6;26;42559;15260;90;57819
52;2021-04-16;857;830;1693;1952321;1849476;0;3801797
53;2021-04-16;28;20;49;173813;182358;09;356171
53;2021-04-16;90;90;181;202720;214740;19;417460
53;2021-04-16;87;97;185;163116;173196;29;336312
53;2021-04-16;86;84;171;190526;187674;39;378200
53;2021-04-16;87;75;162;212098;212015;49;424113
53;2021-04-16;67;69;136;223699;219176;59;442875
53;2021-04-16;38;58;96;227435;209274;69;436709
53;2021-04-16;26;17;43;169992;140910;79;310902
53;2021-04-16;20;12;32;118117;69883;89;188000
53;2021-04-16;11;2;13;37370;12267;90;49637
53;2021-04-16;540;524;1069;1718886;1621493;0;3340379
75;2021-04-16;32;45;79;293104;305291;09;598395
75;2021-04-16;147;131;279;337141;357785;19;694926
75;2021-04-16;169;150;320;295024;300618;29;595642
75;2021-04-16;150;120;271;347871;331233;39;679104
75;2021-04-16;166;139;305;384742;372771;49;757513
75;2021-04-16;153;133;286;413361;390880;59;804241
75;2021-04-16;93;91;184;425623;384060;69;809683
75;2021-04-16;43;59;102;325086;276298;79;601384
75;2021-04-16;31;31;62;213986;139308;89;353294
75;2021-04-16;18;4;22;77600;28200;90;105800
75;2021-04-16;1002;904;1911;3113538;2886444;0;5999982
76;2021-04-16;47;38;87;305956;318589;09;624545
76;2021-04-16;169;196;369;338942;356969;19;695911
76;2021-04-16;218;241;461;316210;319570;29;635780
76;2021-04-16;212;180;395;356758;337587;39;694345
76;2021-04-16;203;196;399;376541;363812;49;740353
76;2021-04-16;160;179;341;402608;383750;59;786358
76;2021-04-16;113;105;218;394889;358997;69;753886
76;2021-04-16;66;55;122;308664;263806;79;572470
76;2021-04-16;40;28;68;195838;129272;89;325110
76;2021-04-16;31;15;46;69372;26728;90;96100
76;2021-04-16;1261;1235;2510;3065778;2859080;0;5924858
84;2021-04-16;103;105;210;459549;481088;09;940637
84;2021-04-16;393;333;728;487711;511905;19;999616
84;2021-04-16;360;326;687;443824;451094;29;894918
84;2021-04-16;325;304;629;512522;493262;39;1005784
84;2021-04-16;339;350;690;520248;515106;49;1035354
84;2021-04-16;294;280;575;529611;514848;59;1044459
84;2021-04-16;169;196;365;486720;439940;69;926660
84;2021-04-16;127;99;227;372151;315211;79;687362
84;2021-04-16;64;41;105;237198;150524;89;387722
84;2021-04-16;27;11;38;81185;28680;90;109865
84;2021-04-16;2201;2047;4256;4130719;3901658;0;8032377
93;2021-04-16;75;91;167;268834;283093;09;551927
93;2021-04-16;196;232;428;280751;296087;19;576838
93;2021-04-16;271;264;535;254404;255552;29;509956
93;2021-04-16;295;218;514;310704;288398;39;599102
93;2021-04-16;278;222;500;325559;305827;49;631386
93;2021-04-16;244;240;484;353104;325389;59;678493
93;2021-04-16;181;166;347;336327;296459;69;632786
93;2021-04-16;83;85;168;279820;229699;79;509519
93;2021-04-16;45;35;80;171274;113716;89;284990
93;2021-04-16;26;8;34;58896;21758;90;80654
93;2021-04-16;1695;1562;3259;2639673;2415978;0;5055651
94;2021-04-16;5;3;8;16311;17433;09;33744
94;2021-04-16;9;11;20;16679;18132;19;34811
94;2021-04-16;7;6;13;16782;16579;29;33361
94;2021-04-16;6;7;13;23044;20580;39;43624
94;2021-04-16;8;8;16;23065;22140;49;45205
94;2021-04-16;9;10;19;24549;23421;59;47970
94;2021-04-16;3;7;10;23212;21883;69;45095
94;2021-04-16;3;0;3;19544;17141;79;36685
94;2021-04-16;4;1;5;11227;8178;89;19405
94;2021-04-16;2;0;2;3332;1447;90;4779
94;2021-04-16;56;53;109;177745;166934;0;344679
01;2021-04-17;1;0;1;19979;20155;09;40134
01;2021-04-17;5;3;8;24994;25489;19;50483
01;2021-04-17;2;7;9;17868;16690;29;34558
01;2021-04-17;8;5;13;22328;14821;39;37149
01;2021-04-17;6;4;10;28652;20276;49;48928
01;2021-04-17;12;12;24;33264;27260;59;60524
01;2021-04-17;5;5;10;27135;23978;69;51113
01;2021-04-17;2;1;3;18401;14661;79;33062
01;2021-04-17;1;1;2;9633;6375;89;16008
01;2021-04-17;0;1;1;3410;1510;90;4920
01;2021-04-17;42;39;81;205664;171215;0;376879
02;2021-04-17;0;1;1;16881;17110;09;33991
02;2021-04-17;2;0;2;21410;21604;19;43014
02;2021-04-17;2;3;5;16017;15479;29;31496
02;2021-04-17;3;1;4;19825;14455;39;34280
02;2021-04-17;2;4;6;24719;18248;49;42967
02;2021-04-17;6;3;9;34361;28310;59;62671
02;2021-04-17;2;5;7;28061;24495;69;52556
02;2021-04-17;1;0;1;18231;15278;79;33509
02;2021-04-17;2;1;3;11090;7677;89;18767
02;2021-04-17;2;0;2;3992;1506;90;5498
02;2021-04-17;22;18;40;194587;164162;0;358749
03;2021-04-17;1;2;3;31123;30920;09;62043
03;2021-04-17;3;6;9;29370;29268;19;58638
03;2021-04-17;2;5;7;21458;18963;29;40421
03;2021-04-17;3;5;8;21276;18326;39;39602
03;2021-04-17;5;6;11;18164;16593;49;34757
03;2021-04-17;5;3;8;13469;13557;59;27026
03;2021-04-17;2;1;3;8776;8670;69;17446
03;2021-04-17;2;1;3;3777;3591;79;7368
03;2021-04-17;0;0;0;1649;1072;89;2721
03;2021-04-17;0;0;0;485;184;90;669
03;2021-04-17;23;29;52;149547;141144;0;290691
04;2021-04-17;5;4;9;60314;61377;09;121691
04;2021-04-17;11;8;19;66065;68387;19;134452
04;2021-04-17;7;8;15;51059;47156;29;98215
04;2021-04-17;12;6;18;58788;45780;39;104568
04;2021-04-17;5;8;13;61408;52207;49;113615
04;2021-04-17;8;9;17;64838;60759;59;125597
04;2021-04-17;2;1;3;47008;42843;69;89851
04;2021-04-17;2;1;3;25509;21184;79;46693
04;2021-04-17;1;1;2;13168;7647;89;20815
04;2021-04-17;0;0;0;3209;1253;90;4462
04;2021-04-17;53;46;99;451366;408593;0;859959
05;2021-04-17;0;0;0;362.366008612902;341.338819562748;09;703.704828175651
05;2021-04-17;0;0;0;353.376145114279;370.349735405642;19;723.725880519921
05;2021-04-17;0;0;0;218.593559489256;256.539602589476;29;475.133162078732
05;2021-04-17;0;0;0;404.225408693299;360.321910454353;39;764.547319147651
05;2021-04-17;0;0;0;520.067953604221;497.108383964256;49;1017.17633756848
05;2021-04-17;0;0;0;468.146063921917;510.087601910415;59;978.233665832332
05;2021-04-17;0;0;0;340.368470050554;334.366842191253;69;674.735312241807
05;2021-04-17;0;0;0;212.598666888387;192.597753227106;79;405.196420115493
05;2021-04-17;0;0;0;148.727797095705;61.8681715431829;89;210.595968638888
05;2021-04-17;0;0;0;32.9601271090696;10.9909785719784;90;43.9511056810479
05;2021-04-17;0;0;0;3061.43020057959;2935.56979942041;0;5997
06;2021-04-17;0;0;0;42583;42380;09;84963
06;2021-04-17;1;1;2;33369;31925;19;65294
06;2021-04-17;0;1;1;21571;15080;29;36651
06;2021-04-17;0;0;0;21550;16147;39;37697
06;2021-04-17;1;0;1;14193;13939;49;28132
06;2021-04-17;1;0;1;7171;7597;59;14768
06;2021-04-17;0;0;0;3629;4117;69;7746
06;2021-04-17;0;0;0;1577;1457;79;3034
06;2021-04-17;0;0;0;531;474;89;1005
06;2021-04-17;0;0;0;88;93;90;181
06;2021-04-17;3;2;5;146262;133209;0;279471
07;2021-04-17;0;0;0;485;549;09;1034
07;2021-04-17;0;1;1;403;432;19;835
07;2021-04-17;0;0;0;764;841;29;1605
07;2021-04-17;0;0;0;824;928;39;1752
07;2021-04-17;0;0;0;788;1020;49;1808
07;2021-04-17;0;0;0;678;870;59;1548
07;2021-04-17;0;0;0;360;382;69;742
07;2021-04-17;0;0;0;231;190;79;421
07;2021-04-17;0;0;0;114;67;89;181
07;2021-04-17;0;0;0;24;11;90;35
07;2021-04-17;0;1;1;4671;5290;0;9961
08;2021-04-17;0;0;0;2715.22592983026;2997.75551488675;09;5712.98144471701
08;2021-04-17;2;0;2;2778.51901080978;3160.9156459093;19;5939.43465671908
08;2021-04-17;0;0;0;2080.8882988764;1718.16634315323;29;3799.05464202964
08;2021-04-17;0;0;0;2701.8582062647;1896.52641413317;39;4598.38462039786
08;2021-04-17;0;0;0;3151.45861023308;2460.52498233809;49;5611.98359257117
08;2021-04-17;0;0;0;2620.29868333099;2422.23566154656;59;5042.53434487755
08;2021-04-17;1;1;2;1621.44173420671;1438.58325779464;69;3060.02499200135
08;2021-04-17;0;0;0;626.575909335673;526.358467843651;79;1152.93437717932
08;2021-04-17;0;0;0;205.018522985054;140.993639349697;89;346.012162334751
08;2021-04-17;0;0;0;50.0325684687745;20.62259870351;90;70.6551671722846
08;2021-04-17;3;1;4;18551.3174743414;16782.6825256586;0;35334
11;2021-04-17;125;130;276;783071;811785;09;1594856
11;2021-04-17;412;336;779;761456;784653;19;1546109
11;2021-04-17;720;677;1413;850145;801772;29;1651917
11;2021-04-17;618;661;1292;914360;843488;39;1757848
11;2021-04-17;562;591;1163;845609;826202;49;1671811
11;2021-04-17;458;462;922;793566;745070;59;1538636
11;2021-04-17;278;264;544;628649;549192;69;1177841
11;2021-04-17;118;109;227;434606;358356;79;792962
11;2021-04-17;52;55;109;261425;162933;89;424358
11;2021-04-17;24;9;33;89253;32619;90;121872
11;2021-04-17;3368;3294;6759;6362140;5916070;0;12278210
24;2021-04-17;19;14;33;139720;144686;09;284406
24;2021-04-17;53;41;95;152979;161185;19;314164
24;2021-04-17;62;57;120;122237;126536;29;248773
24;2021-04-17;54;62;117;150359;142009;39;292368
24;2021-04-17;62;50;112;161829;158758;49;320587
24;2021-04-17;51;55;107;172552;168011;59;340563
24;2021-04-17;27;30;58;172509;158177;69;330686
24;2021-04-17;20;21;41;129428;110593;79;240021
24;2021-04-17;10;11;21;87342;56882;89;144224
24;2021-04-17;3;4;7;31210;12071;90;43281
24;2021-04-17;361;345;711;1320165;1238908;0;2559073
27;2021-04-17;20;23;43;143373;149679;09;293052
27;2021-04-17;60;53;113;160962;173003;19;333965
27;2021-04-17;57;54;111;133746;142254;29;276000
27;2021-04-17;68;59;127;160004;155407;39;315411
27;2021-04-17;58;64;122;172333;169564;49;341897
27;2021-04-17;55;67;122;189979;183788;59;373767
27;2021-04-17;53;49;102;192591;178206;69;370797
27;2021-04-17;28;32;60;146876;127546;79;274422
27;2021-04-17;12;16;28;96896;61575;89;158471
27;2021-04-17;5;1;6;33148;12109;90;45257
27;2021-04-17;416;418;834;1429908;1353131;0;2783039
28;2021-04-17;19;26;47;180735;186856;09;367591
28;2021-04-17;65;79;147;200125;213621;19;413746
28;2021-04-17;87;61;149;168922;173007;29;341929
28;2021-04-17;67;75;143;196628;188487;39;385115
28;2021-04-17;88;72;160;205396;201699;49;407095
28;2021-04-17;86;80;166;222002;213866;59;435868
28;2021-04-17;45;56;102;224688;203758;69;428446
28;2021-04-17;23;24;47;163192;135543;79;298735
28;2021-04-17;19;8;27;109691;65377;89;175068
28;2021-04-17;11;4;15;37222;12685;90;49907
28;2021-04-17;510;485;1003;1708601;1594899;0;3303500
32;2021-04-17;72;84;156;358062;373689;09;731751
32;2021-04-17;174;193;370;387045;406742;19;793787
32;2021-04-17;239;211;453;342304;348587;29;690891
32;2021-04-17;208;227;440;382485;369972;39;752457
32;2021-04-17;194;226;423;382510;376716;49;759226
32;2021-04-17;169;198;368;386937;376527;59;763464
32;2021-04-17;91;112;204;371211;330938;69;702149
32;2021-04-17;56;54;110;250542;201459;79;452001
32;2021-04-17;39;19;58;163399;89786;89;253185
32;2021-04-17;18;6;24;48384;15367;90;63751
32;2021-04-17;1260;1330;2606;3072879;2889783;0;5962662
44;2021-04-17;35;43;78;291525;306839;09;598364
44;2021-04-17;123;109;233;320255;339504;19;659759
44;2021-04-17;143;118;261;302020;314428;29;616448
44;2021-04-17;124;144;269;342222;333292;39;675514
44;2021-04-17;118;123;241;349727;344491;49;694218
44;2021-04-17;117;125;242;381371;373239;59;754610
44;2021-04-17;73;70;143;367165;335850;69;703015
44;2021-04-17;33;37;70;250387;215436;79;465823
44;2021-04-17;26;21;47;170825;105192;89;276017
44;2021-04-17;11;5;16;51248;16731;90;67979
44;2021-04-17;803;795;1600;2826745;2685002;0;5511747
52;2021-04-17;34;28;62;213594;223900;09;437494
52;2021-04-17;113;90;207;240818;255197;19;496015
52;2021-04-17;88;104;192;197010;200630;29;397640
52;2021-04-17;90;94;184;231204;224885;39;456089
52;2021-04-17;115;97;212;243874;243418;49;487292
52;2021-04-17;81;85;166;244100;239116;59;483216
52;2021-04-17;61;48;109;241796;221345;69;463141
52;2021-04-17;21;17;38;177805;149903;79;327708
52;2021-04-17;10;12;22;119561;75822;89;195383
52;2021-04-17;2;4;6;42559;15260;90;57819
52;2021-04-17;615;579;1198;1952321;1849476;0;3801797
53;2021-04-17;21;33;54;173813;182358;09;356171
53;2021-04-17;78;63;141;202720;214740;19;417460
53;2021-04-17;71;56;127;163116;173196;29;336312
53;2021-04-17;60;84;144;190526;187674;39;378200
53;2021-04-17;59;77;136;212098;212015;49;424113
53;2021-04-17;48;72;120;223699;219176;59;442875
53;2021-04-17;30;26;56;227435;209274;69;436709
53;2021-04-17;17;15;32;169992;140910;79;310902
53;2021-04-17;12;10;22;118117;69883;89;188000
53;2021-04-17;3;3;6;37370;12267;90;49637
53;2021-04-17;399;439;838;1718886;1621493;0;3340379
75;2021-04-17;23;32;55;293104;305291;09;598395
75;2021-04-17;81;92;176;337141;357785;19;694926
75;2021-04-17;85;81;166;295024;300618;29;595642
75;2021-04-17;94;86;182;347871;331233;39;679104
75;2021-04-17;104;99;203;384742;372771;49;757513
75;2021-04-17;72;101;173;413361;390880;59;804241
75;2021-04-17;52;47;99;425623;384060;69;809683
75;2021-04-17;35;27;63;325086;276298;79;601384
75;2021-04-17;20;11;31;213986;139308;89;353294
75;2021-04-17;10;4;14;77600;28200;90;105800
75;2021-04-17;576;580;1162;3113538;2886444;0;5999982
76;2021-04-17;19;35;55;305956;318589;09;624545
76;2021-04-17;108;91;205;338942;356969;19;695911
76;2021-04-17;139;111;252;316210;319570;29;635780
76;2021-04-17;99;103;204;356758;337587;39;694345
76;2021-04-17;96;126;222;376541;363812;49;740353
76;2021-04-17;90;108;198;402608;383750;59;786358
76;2021-04-17;65;65;130;394889;358997;69;753886
76;2021-04-17;42;39;81;308664;263806;79;572470
76;2021-04-17;22;22;45;195838;129272;89;325110
76;2021-04-17;5;9;14;69372;26728;90;96100
76;2021-04-17;685;709;1406;3065778;2859080;0;5924858
84;2021-04-17;64;66;132;459549;481088;09;940637
84;2021-04-17;175;196;374;487711;511905;19;999616
84;2021-04-17;215;211;426;443824;451094;29;894918
84;2021-04-17;236;201;438;512522;493262;39;1005784
84;2021-04-17;235;219;454;520248;515106;49;1035354
84;2021-04-17;194;239;434;529611;514848;59;1044459
84;2021-04-17;141;128;269;486720;439940;69;926660
84;2021-04-17;55;41;96;372151;315211;79;687362
84;2021-04-17;45;23;68;237198;150524;89;387722
84;2021-04-17;12;8;20;81185;28680;90;109865
84;2021-04-17;1372;1333;2712;4130719;3901658;0;8032377
93;2021-04-17;22;23;45;268834;283093;09;551927
93;2021-04-17;109;124;233;280751;296087;19;576838
93;2021-04-17;174;119;293;254404;255552;29;509956
93;2021-04-17;155;109;265;310704;288398;39;599102
93;2021-04-17;138;148;286;325559;305827;49;631386
93;2021-04-17;144;129;273;353104;325389;59;678493
93;2021-04-17;67;74;141;336327;296459;69;632786
93;2021-04-17;39;45;84;279820;229699;79;509519
93;2021-04-17;25;15;40;171274;113716;89;284990
93;2021-04-17;8;4;12;58896;21758;90;80654
93;2021-04-17;881;790;1672;2639673;2415978;0;5055651
94;2021-04-17;0;0;0;16311;17433;09;33744
94;2021-04-17;1;2;3;16679;18132;19;34811
94;2021-04-17;1;2;3;16782;16579;29;33361
94;2021-04-17;4;3;7;23044;20580;39;43624
94;2021-04-17;2;3;5;23065;22140;49;45205
94;2021-04-17;6;2;8;24549;23421;59;47970
94;2021-04-17;1;2;3;23212;21883;69;45095
94;2021-04-17;0;2;2;19544;17141;79;36685
94;2021-04-17;2;0;2;11227;8178;89;19405
94;2021-04-17;2;0;2;3332;1447;90;4779
94;2021-04-17;19;16;35;177745;166934;0;344679
01;2021-04-18;0;0;0;19979;20155;09;40134
01;2021-04-18;2;1;3;24994;25489;19;50483
01;2021-04-18;4;0;4;17868;16690;29;34558
01;2021-04-18;0;2;2;22328;14821;39;37149
01;2021-04-18;0;1;1;28652;20276;49;48928
01;2021-04-18;1;3;4;33264;27260;59;60524
01;2021-04-18;0;2;2;27135;23978;69;51113
01;2021-04-18;0;2;2;18401;14661;79;33062
01;2021-04-18;0;2;2;9633;6375;89;16008
01;2021-04-18;0;0;0;3410;1510;90;4920
01;2021-04-18;7;13;20;205664;171215;0;376879
02;2021-04-18;0;0;0;16881;17110;09;33991
02;2021-04-18;0;0;0;21410;21604;19;43014
02;2021-04-18;1;0;1;16017;15479;29;31496
02;2021-04-18;3;0;3;19825;14455;39;34280
02;2021-04-18;0;0;0;24719;18248;49;42967
02;2021-04-18;3;3;6;34361;28310;59;62671
02;2021-04-18;0;0;0;28061;24495;69;52556
02;2021-04-18;0;1;1;18231;15278;79;33509
02;2021-04-18;0;0;0;11090;7677;89;18767
02;2021-04-18;0;0;0;3992;1506;90;5498
02;2021-04-18;7;4;11;194587;164162;0;358749
03;2021-04-18;0;0;0;31123;30920;09;62043
03;2021-04-18;0;0;0;29370;29268;19;58638
03;2021-04-18;2;1;3;21458;18963;29;40421
03;2021-04-18;1;0;1;21276;18326;39;39602
03;2021-04-18;3;0;3;18164;16593;49;34757
03;2021-04-18;0;0;0;13469;13557;59;27026
03;2021-04-18;0;1;1;8776;8670;69;17446
03;2021-04-18;1;1;2;3777;3591;79;7368
03;2021-04-18;0;0;0;1649;1072;89;2721
03;2021-04-18;0;0;0;485;184;90;669
03;2021-04-18;7;3;10;149547;141144;0;290691
04;2021-04-18;3;1;4;60314;61377;09;121691
04;2021-04-18;4;1;5;66065;68387;19;134452
04;2021-04-18;2;6;8;51059;47156;29;98215
04;2021-04-18;4;3;7;58788;45780;39;104568
04;2021-04-18;6;3;9;61408;52207;49;113615
04;2021-04-18;3;4;7;64838;60759;59;125597
04;2021-04-18;0;0;0;47008;42843;69;89851
04;2021-04-18;0;0;0;25509;21184;79;46693
04;2021-04-18;0;0;0;13168;7647;89;20815
04;2021-04-18;0;0;0;3209;1253;90;4462
04;2021-04-18;22;18;40;451366;408593;0;859959
05;2021-04-18;0;0;0;362.366008612902;341.338819562748;09;703.704828175651
05;2021-04-18;0;0;0;353.376145114279;370.349735405642;19;723.725880519921
05;2021-04-18;0;0;0;218.593559489256;256.539602589476;29;475.133162078732
05;2021-04-18;0;0;0;404.225408693299;360.321910454353;39;764.547319147651
05;2021-04-18;0;0;0;520.067953604221;497.108383964256;49;1017.17633756848
05;2021-04-18;0;0;0;468.146063921917;510.087601910415;59;978.233665832332
05;2021-04-18;0;0;0;340.368470050554;334.366842191253;69;674.735312241807
05;2021-04-18;0;0;0;212.598666888387;192.597753227106;79;405.196420115493
05;2021-04-18;0;0;0;148.727797095705;61.8681715431829;89;210.595968638888
05;2021-04-18;0;0;0;32.9601271090696;10.9909785719784;90;43.9511056810479
05;2021-04-18;0;0;0;3061.43020057959;2935.56979942041;0;5997
06;2021-04-18;0;0;0;42583;42380;09;84963
06;2021-04-18;0;0;0;33369;31925;19;65294
06;2021-04-18;0;0;0;21571;15080;29;36651
06;2021-04-18;1;1;2;21550;16147;39;37697
06;2021-04-18;1;0;1;14193;13939;49;28132
06;2021-04-18;0;0;0;7171;7597;59;14768
06;2021-04-18;0;0;0;3629;4117;69;7746
06;2021-04-18;0;0;0;1577;1457;79;3034
06;2021-04-18;0;0;0;531;474;89;1005
06;2021-04-18;0;0;0;88;93;90;181
06;2021-04-18;2;1;3;146262;133209;0;279471
07;2021-04-18;0;0;0;485;549;09;1034
07;2021-04-18;0;0;0;403;432;19;835
07;2021-04-18;0;0;0;764;841;29;1605
07;2021-04-18;0;0;0;824;928;39;1752
07;2021-04-18;0;0;0;788;1020;49;1808
07;2021-04-18;0;0;0;678;870;59;1548
07;2021-04-18;0;0;0;360;382;69;742
07;2021-04-18;0;0;0;231;190;79;421
07;2021-04-18;0;0;0;114;67;89;181
07;2021-04-18;0;0;0;24;11;90;35
07;2021-04-18;0;0;0;4671;5290;0;9961
08;2021-04-18;0;0;0;2715.22592983026;2997.75551488675;09;5712.98144471701
08;2021-04-18;0;0;0;2778.51901080978;3160.9156459093;19;5939.43465671908
08;2021-04-18;0;0;0;2080.8882988764;1718.16634315323;29;3799.05464202964
08;2021-04-18;0;0;0;2701.8582062647;1896.52641413317;39;4598.38462039786
08;2021-04-18;0;0;0;3151.45861023308;2460.52498233809;49;5611.98359257117
08;2021-04-18;0;0;0;2620.29868333099;2422.23566154656;59;5042.53434487755
08;2021-04-18;0;0;0;1621.44173420671;1438.58325779464;69;3060.02499200135
08;2021-04-18;0;0;0;626.575909335673;526.358467843651;79;1152.93437717932
08;2021-04-18;0;0;0;205.018522985054;140.993639349697;89;346.012162334751
08;2021-04-18;0;0;0;50.0325684687745;20.62259870351;90;70.6551671722846
08;2021-04-18;0;0;0;18551.3174743414;16782.6825256586;0;35334
11;2021-04-18;26;28;55;783071;811785;09;1594856
11;2021-04-18;88;82;172;761456;784653;19;1546109
11;2021-04-18;225;182;412;850145;801772;29;1651917
11;2021-04-18;172;190;363;914360;843488;39;1757848
11;2021-04-18;122;137;263;845609;826202;49;1671811
11;2021-04-18;98;128;228;793566;745070;59;1538636
11;2021-04-18;72;71;144;628649;549192;69;1177841
11;2021-04-18;33;28;61;434606;358356;79;792962
11;2021-04-18;20;25;45;261425;162933;89;424358
11;2021-04-18;11;6;17;89253;32619;90;121872
11;2021-04-18;867;877;1760;6362140;5916070;0;12278210
24;2021-04-18;1;3;4;139720;144686;09;284406
24;2021-04-18;5;5;10;152979;161185;19;314164
24;2021-04-18;4;7;11;122237;126536;29;248773
24;2021-04-18;9;9;18;150359;142009;39;292368
24;2021-04-18;9;11;20;161829;158758;49;320587
24;2021-04-18;5;6;11;172552;168011;59;340563
24;2021-04-18;9;5;14;172509;158177;69;330686
24;2021-04-18;3;4;7;129428;110593;79;240021
24;2021-04-18;5;6;11;87342;56882;89;144224
24;2021-04-18;2;2;4;31210;12071;90;43281
24;2021-04-18;52;58;110;1320165;1238908;0;2559073
27;2021-04-18;2;2;4;143373;149679;09;293052
27;2021-04-18;8;7;15;160962;173003;19;333965
27;2021-04-18;4;9;13;133746;142254;29;276000
27;2021-04-18;3;9;12;160004;155407;39;315411
27;2021-04-18;8;7;16;172333;169564;49;341897
27;2021-04-18;8;6;14;189979;183788;59;373767
27;2021-04-18;12;11;23;192591;178206;69;370797
27;2021-04-18;5;5;10;146876;127546;79;274422
27;2021-04-18;5;2;7;96896;61575;89;158471
27;2021-04-18;1;2;3;33148;12109;90;45257
27;2021-04-18;56;60;117;1429908;1353131;0;2783039
28;2021-04-18;1;3;4;180735;186856;09;367591
28;2021-04-18;9;12;21;200125;213621;19;413746
28;2021-04-18;16;20;36;168922;173007;29;341929
28;2021-04-18;25;20;45;196628;188487;39;385115
28;2021-04-18;20;17;37;205396;201699;49;407095
28;2021-04-18;18;22;40;222002;213866;59;435868
28;2021-04-18;16;12;28;224688;203758;69;428446
28;2021-04-18;9;21;30;163192;135543;79;298735
28;2021-04-18;5;2;7;109691;65377;89;175068
28;2021-04-18;1;3;4;37222;12685;90;49907
28;2021-04-18;120;132;252;1708601;1594899;0;3303500
32;2021-04-18;16;15;31;358062;373689;09;731751
32;2021-04-18;28;33;62;387045;406742;19;793787
32;2021-04-18;59;51;113;342304;348587;29;690891
32;2021-04-18;43;59;103;382485;369972;39;752457
32;2021-04-18;54;38;98;382510;376716;49;759226
32;2021-04-18;43;29;72;386937;376527;59;763464
32;2021-04-18;18;15;33;371211;330938;69;702149
32;2021-04-18;11;14;25;250542;201459;79;452001
32;2021-04-18;13;10;23;163399;89786;89;253185
32;2021-04-18;5;5;10;48384;15367;90;63751
32;2021-04-18;290;269;571;3072879;2889783;0;5962662
44;2021-04-18;5;5;10;291525;306839;09;598364
44;2021-04-18;13;9;22;320255;339504;19;659759
44;2021-04-18;31;19;50;302020;314428;29;616448
44;2021-04-18;26;22;48;342222;333292;39;675514
44;2021-04-18;25;24;49;349727;344491;49;694218
44;2021-04-18;13;23;36;381371;373239;59;754610
44;2021-04-18;10;16;26;367165;335850;69;703015
44;2021-04-18;9;6;15;250387;215436;79;465823
44;2021-04-18;9;10;19;170825;105192;89;276017
44;2021-04-18;4;1;5;51248;16731;90;67979
44;2021-04-18;145;135;280;2826745;2685002;0;5511747
52;2021-04-18;7;4;14;213594;223900;09;437494
52;2021-04-18;16;14;30;240818;255197;19;496015
52;2021-04-18;24;24;48;197010;200630;29;397640
52;2021-04-18;25;28;53;231204;224885;39;456089
52;2021-04-18;35;26;61;243874;243418;49;487292
52;2021-04-18;19;24;43;244100;239116;59;483216
52;2021-04-18;12;13;25;241796;221345;69;463141
52;2021-04-18;5;9;14;177805;149903;79;327708
52;2021-04-18;7;4;11;119561;75822;89;195383
52;2021-04-18;3;1;4;42559;15260;90;57819
52;2021-04-18;153;147;303;1952321;1849476;0;3801797
53;2021-04-18;3;4;7;173813;182358;09;356171
53;2021-04-18;5;10;15;202720;214740;19;417460
53;2021-04-18;13;17;30;163116;173196;29;336312
53;2021-04-18;10;11;21;190526;187674;39;378200
53;2021-04-18;16;7;23;212098;212015;49;424113
53;2021-04-18;9;9;18;223699;219176;59;442875
53;2021-04-18;4;4;8;227435;209274;69;436709
53;2021-04-18;4;2;6;169992;140910;79;310902
53;2021-04-18;3;1;4;118117;69883;89;188000
53;2021-04-18;1;0;1;37370;12267;90;49637
53;2021-04-18;68;65;133;1718886;1621493;0;3340379
75;2021-04-18;3;3;6;293104;305291;09;598395
75;2021-04-18;5;12;17;337141;357785;19;694926
75;2021-04-18;11;15;26;295024;300618;29;595642
75;2021-04-18;10;22;32;347871;331233;39;679104
75;2021-04-18;17;10;27;384742;372771;49;757513
75;2021-04-18;10;6;16;413361;390880;59;804241
75;2021-04-18;5;9;14;425623;384060;69;809683
75;2021-04-18;6;5;11;325086;276298;79;601384
75;2021-04-18;7;7;14;213986;139308;89;353294
75;2021-04-18;13;2;15;77600;28200;90;105800
75;2021-04-18;87;91;178;3113538;2886444;0;5999982
76;2021-04-18;3;7;10;305956;318589;09;624545
76;2021-04-18;19;20;39;338942;356969;19;695911
76;2021-04-18;34;32;66;316210;319570;29;635780
76;2021-04-18;22;28;50;356758;337587;39;694345
76;2021-04-18;32;22;54;376541;363812;49;740353
76;2021-04-18;11;20;31;402608;383750;59;786358
76;2021-04-18;8;17;25;394889;358997;69;753886
76;2021-04-18;8;15;23;308664;263806;79;572470
76;2021-04-18;10;5;15;195838;129272;89;325110
76;2021-04-18;9;2;11;69372;26728;90;96100
76;2021-04-18;156;168;324;3065778;2859080;0;5924858
84;2021-04-18;11;16;27;459549;481088;09;940637
84;2021-04-18;26;31;57;487711;511905;19;999616
84;2021-04-18;30;36;66;443824;451094;29;894918
84;2021-04-18;44;31;75;512522;493262;39;1005784
84;2021-04-18;41;35;76;520248;515106;49;1035354
84;2021-04-18;24;32;56;529611;514848;59;1044459
84;2021-04-18;20;24;45;486720;439940;69;926660
84;2021-04-18;19;14;33;372151;315211;79;687362
84;2021-04-18;18;17;35;237198;150524;89;387722
84;2021-04-18;9;2;11;81185;28680;90;109865
84;2021-04-18;242;238;481;4130719;3901658;0;8032377
93;2021-04-18;10;23;34;268834;283093;09;551927
93;2021-04-18;17;17;34;280751;296087;19;576838
93;2021-04-18;48;36;84;254404;255552;29;509956
93;2021-04-18;27;38;65;310704;288398;39;599102
93;2021-04-18;45;35;80;325559;305827;49;631386
93;2021-04-18;26;31;57;353104;325389;59;678493
93;2021-04-18;21;21;42;336327;296459;69;632786
93;2021-04-18;12;18;30;279820;229699;79;509519
93;2021-04-18;13;14;27;171274;113716;89;284990
93;2021-04-18;4;2;6;58896;21758;90;80654
93;2021-04-18;223;235;459;2639673;2415978;0;5055651
94;2021-04-18;0;0;0;16311;17433;09;33744
94;2021-04-18;0;1;1;16679;18132;19;34811
94;2021-04-18;3;1;4;16782;16579;29;33361
94;2021-04-18;1;0;1;23044;20580;39;43624
94;2021-04-18;1;1;2;23065;22140;49;45205
94;2021-04-18;2;1;3;24549;23421;59;47970
94;2021-04-18;0;2;2;23212;21883;69;45095
94;2021-04-18;1;0;1;19544;17141;79;36685
94;2021-04-18;0;2;2;11227;8178;89;19405
94;2021-04-18;1;1;2;3332;1447;90;4779
94;2021-04-18;9;9;18;177745;166934;0;344679
01;2021-04-19;2;0;2;19979;20155;09;40134
01;2021-04-19;14;9;23;24994;25489;19;50483
01;2021-04-19;16;7;23;17868;16690;29;34558
01;2021-04-19;15;7;22;22328;14821;39;37149
01;2021-04-19;17;15;32;28652;20276;49;48928
01;2021-04-19;30;19;49;33264;27260;59;60524
01;2021-04-19;8;8;16;27135;23978;69;51113
01;2021-04-19;5;3;8;18401;14661;79;33062
01;2021-04-19;3;1;4;9633;6375;89;16008
01;2021-04-19;2;0;2;3410;1510;90;4920
01;2021-04-19;112;69;181;205664;171215;0;376879
02;2021-04-19;2;3;5;16881;17110;09;33991
02;2021-04-19;8;5;14;21410;21604;19;43014
02;2021-04-19;11;8;19;16017;15479;29;31496
02;2021-04-19;20;10;30;19825;14455;39;34280
02;2021-04-19;13;13;26;24719;18248;49;42967
02;2021-04-19;18;18;36;34361;28310;59;62671
02;2021-04-19;10;14;24;28061;24495;69;52556
02;2021-04-19;7;7;14;18231;15278;79;33509
02;2021-04-19;6;0;6;11090;7677;89;18767
02;2021-04-19;0;0;0;3992;1506;90;5498
02;2021-04-19;95;78;174;194587;164162;0;358749
03;2021-04-19;7;6;13;31123;30920;09;62043
03;2021-04-19;18;11;29;29370;29268;19;58638
03;2021-04-19;15;19;34;21458;18963;29;40421
03;2021-04-19;26;17;43;21276;18326;39;39602
03;2021-04-19;13;10;23;18164;16593;49;34757
03;2021-04-19;11;10;21;13469;13557;59;27026
03;2021-04-19;3;6;9;8776;8670;69;17446
03;2021-04-19;4;1;5;3777;3591;79;7368
03;2021-04-19;0;0;0;1649;1072;89;2721
03;2021-04-19;0;0;0;485;184;90;669
03;2021-04-19;97;80;177;149547;141144;0;290691
04;2021-04-19;6;3;9;60314;61377;09;121691
04;2021-04-19;28;26;54;66065;68387;19;134452
04;2021-04-19;11;21;32;51059;47156;29;98215
04;2021-04-19;11;17;28;58788;45780;39;104568
04;2021-04-19;21;13;34;61408;52207;49;113615
04;2021-04-19;17;11;28;64838;60759;59;125597
04;2021-04-19;9;6;15;47008;42843;69;89851
04;2021-04-19;2;2;4;25509;21184;79;46693
04;2021-04-19;2;3;5;13168;7647;89;20815
04;2021-04-19;0;1;1;3209;1253;90;4462
04;2021-04-19;107;103;210;451366;408593;0;859959
05;2021-04-19;0;0;0;362.366008612902;341.338819562748;09;703.704828175651
05;2021-04-19;0;0;0;353.376145114279;370.349735405642;19;723.725880519921
05;2021-04-19;0;0;0;218.593559489256;256.539602589476;29;475.133162078732
05;2021-04-19;0;0;0;404.225408693299;360.321910454353;39;764.547319147651
05;2021-04-19;0;0;0;520.067953604221;497.108383964256;49;1017.17633756848
05;2021-04-19;0;0;0;468.146063921917;510.087601910415;59;978.233665832332
05;2021-04-19;0;0;0;340.368470050554;334.366842191253;69;674.735312241807
05;2021-04-19;0;0;0;212.598666888387;192.597753227106;79;405.196420115493
05;2021-04-19;0;0;0;148.727797095705;61.8681715431829;89;210.595968638888
05;2021-04-19;0;0;0;32.9601271090696;10.9909785719784;90;43.9511056810479
05;2021-04-19;0;0;0;3061.43020057959;2935.56979942041;0;5997
06;2021-04-19;1;1;2;42583;42380;09;84963
06;2021-04-19;9;7;16;33369;31925;19;65294
06;2021-04-19;3;5;8;21571;15080;29;36651
06;2021-04-19;6;4;10;21550;16147;39;37697
06;2021-04-19;4;0;4;14193;13939;49;28132
06;2021-04-19;1;1;2;7171;7597;59;14768
06;2021-04-19;0;3;3;3629;4117;69;7746
06;2021-04-19;0;1;1;1577;1457;79;3034
06;2021-04-19;0;0;0;531;474;89;1005
06;2021-04-19;0;0;0;88;93;90;181
06;2021-04-19;24;22;46;146262;133209;0;279471
07;2021-04-19;0;0;0;485;549;09;1034
07;2021-04-19;0;0;0;403;432;19;835
07;2021-04-19;1;1;2;764;841;29;1605
07;2021-04-19;0;0;0;824;928;39;1752
07;2021-04-19;0;0;0;788;1020;49;1808
07;2021-04-19;0;0;0;678;870;59;1548
07;2021-04-19;0;0;0;360;382;69;742
07;2021-04-19;0;0;0;231;190;79;421
07;2021-04-19;0;0;0;114;67;89;181
07;2021-04-19;0;0;0;24;11;90;35
07;2021-04-19;1;1;2;4671;5290;0;9961
08;2021-04-19;0;0;0;2715.22592983026;2997.75551488675;09;5712.98144471701
08;2021-04-19;0;0;0;2778.51901080978;3160.9156459093;19;5939.43465671908
08;2021-04-19;0;0;0;2080.8882988764;1718.16634315323;29;3799.05464202964
08;2021-04-19;0;0;0;2701.8582062647;1896.52641413317;39;4598.38462039786
08;2021-04-19;0;1;1;3151.45861023308;2460.52498233809;49;5611.98359257117
08;2021-04-19;0;0;0;2620.29868333099;2422.23566154656;59;5042.53434487755
08;2021-04-19;0;1;1;1621.44173420671;1438.58325779464;69;3060.02499200135
08;2021-04-19;0;0;0;626.575909335673;526.358467843651;79;1152.93437717932
08;2021-04-19;0;0;0;205.018522985054;140.993639349697;89;346.012162334751
08;2021-04-19;0;0;0;50.0325684687745;20.62259870351;90;70.6551671722846
08;2021-04-19;0;2;2;18551.3174743414;16782.6825256586;0;35334
11;2021-04-19;263;266;549;783071;811785;09;1594856
11;2021-04-19;737;633;1423;761456;784653;19;1546109
11;2021-04-19;1282;1323;2626;850145;801772;29;1651917
11;2021-04-19;1266;1267;2547;914360;843488;39;1757848
11;2021-04-19;1079;1109;2199;845609;826202;49;1671811
11;2021-04-19;916;973;1900;793566;745070;59;1538636
11;2021-04-19;559;506;1069;628649;549192;69;1177841
11;2021-04-19;205;211;416;434606;358356;79;792962
11;2021-04-19;122;86;208;261425;162933;89;424358
11;2021-04-19;67;34;101;89253;32619;90;121872
11;2021-04-19;6496;6410;13041;6362140;5916070;0;12278210
24;2021-04-19;32;38;76;139720;144686;09;284406
24;2021-04-19;128;124;253;152979;161185;19;314164
24;2021-04-19;114;139;255;122237;126536;29;248773
24;2021-04-19;135;113;249;150359;142009;39;292368
24;2021-04-19;128;141;271;161829;158758;49;320587
24;2021-04-19;127;119;246;172552;168011;59;340563
24;2021-04-19;75;77;152;172509;158177;69;330686
24;2021-04-19;41;51;92;129428;110593;79;240021
24;2021-04-19;17;21;38;87342;56882;89;144224
24;2021-04-19;21;8;29;31210;12071;90;43281
24;2021-04-19;818;832;1662;1320165;1238908;0;2559073
27;2021-04-19;33;39;72;143373;149679;09;293052
27;2021-04-19;120;105;226;160962;173003;19;333965
27;2021-04-19;132;171;303;133746;142254;29;276000
27;2021-04-19;132;112;244;160004;155407;39;315411
27;2021-04-19;141;127;269;172333;169564;49;341897
27;2021-04-19;144;144;289;189979;183788;59;373767
27;2021-04-19;91;94;185;192591;178206;69;370797
27;2021-04-19;53;40;93;146876;127546;79;274422
27;2021-04-19;31;18;49;96896;61575;89;158471
27;2021-04-19;20;8;28;33148;12109;90;45257
27;2021-04-19;897;858;1758;1429908;1353131;0;2783039
28;2021-04-19;43;42;90;180735;186856;09;367591
28;2021-04-19;134;137;277;200125;213621;19;413746
28;2021-04-19;155;164;322;168922;173007;29;341929
28;2021-04-19;158;157;318;196628;188487;39;385115
28;2021-04-19;167;164;332;205396;201699;49;407095
28;2021-04-19;153;177;331;222002;213866;59;435868
28;2021-04-19;112;114;227;224688;203758;69;428446
28;2021-04-19;55;57;112;163192;135543;79;298735
28;2021-04-19;34;28;63;109691;65377;89;175068
28;2021-04-19;22;12;34;37222;12685;90;49907
28;2021-04-19;1033;1052;2107;1708601;1594899;0;3303500
32;2021-04-19;140;119;262;358062;373689;09;731751
32;2021-04-19;364;334;701;387045;406742;19;793787
32;2021-04-19;388;407;801;342304;348587;29;690891
32;2021-04-19;399;412;813;382485;369972;39;752457
32;2021-04-19;420;383;807;382510;376716;49;759226
32;2021-04-19;356;350;709;386937;376527;59;763464
32;2021-04-19;221;197;419;371211;330938;69;702149
32;2021-04-19;143;105;248;250542;201459;79;452001
32;2021-04-19;86;46;132;163399;89786;89;253185
32;2021-04-19;32;10;42;48384;15367;90;63751
32;2021-04-19;2550;2363;4935;3072879;2889783;0;5962662
44;2021-04-19;66;100;168;291525;306839;09;598364
44;2021-04-19;226;206;434;320255;339504;19;659759
44;2021-04-19;270;262;533;302020;314428;29;616448
44;2021-04-19;269;265;535;342222;333292;39;675514
44;2021-04-19;287;270;558;349727;344491;49;694218
44;2021-04-19;279;269;552;381371;373239;59;754610
44;2021-04-19;145;134;279;367165;335850;69;703015
44;2021-04-19;82;80;165;250387;215436;79;465823
44;2021-04-19;54;33;88;170825;105192;89;276017
44;2021-04-19;15;6;21;51248;16731;90;67979
44;2021-04-19;1693;1625;3333;2826745;2685002;0;5511747
52;2021-04-19;51;43;95;213594;223900;09;437494
52;2021-04-19;145;171;323;240818;255197;19;496015
52;2021-04-19;150;201;351;197010;200630;29;397640
52;2021-04-19;153;164;317;231204;224885;39;456089
52;2021-04-19;182;164;347;243874;243418;49;487292
52;2021-04-19;160;179;339;244100;239116;59;483216
52;2021-04-19;99;92;191;241796;221345;69;463141
52;2021-04-19;61;66;127;177805;149903;79;327708
52;2021-04-19;49;17;66;119561;75822;89;195383
52;2021-04-19;18;9;27;42559;15260;90;57819
52;2021-04-19;1068;1106;2183;1952321;1849476;0;3801797
53;2021-04-19;39;44;85;173813;182358;09;356171
53;2021-04-19;77;99;176;202720;214740;19;417460
53;2021-04-19;84;122;206;163116;173196;29;336312
53;2021-04-19;91;92;183;190526;187674;39;378200
53;2021-04-19;92;123;215;212098;212015;49;424113
53;2021-04-19;101;91;192;223699;219176;59;442875
53;2021-04-19;64;59;123;227435;209274;69;436709
53;2021-04-19;35;33;68;169992;140910;79;310902
53;2021-04-19;20;13;33;118117;69883;89;188000
53;2021-04-19;16;6;22;37370;12267;90;49637
53;2021-04-19;619;682;1303;1718886;1621493;0;3340379
75;2021-04-19;33;47;83;293104;305291;09;598395
75;2021-04-19;153;133;286;337141;357785;19;694926
75;2021-04-19;176;203;379;295024;300618;29;595642
75;2021-04-19;179;173;352;347871;331233;39;679104
75;2021-04-19;191;176;368;384742;372771;49;757513
75;2021-04-19;163;173;336;413361;390880;59;804241
75;2021-04-19;127;95;222;425623;384060;69;809683
75;2021-04-19;74;70;144;325086;276298;79;601384
75;2021-04-19;47;27;74;213986;139308;89;353294
75;2021-04-19;24;17;41;77600;28200;90;105800
75;2021-04-19;1167;1114;2285;3113538;2886444;0;5999982
76;2021-04-19;55;55;112;305956;318589;09;624545
76;2021-04-19;210;221;438;338942;356969;19;695911
76;2021-04-19;298;263;563;316210;319570;29;635780
76;2021-04-19;274;228;504;356758;337587;39;694345
76;2021-04-19;298;251;553;376541;363812;49;740353
76;2021-04-19;231;272;504;402608;383750;59;786358
76;2021-04-19;182;174;358;394889;358997;69;753886
76;2021-04-19;96;114;210;308664;263806;79;572470
76;2021-04-19;64;37;101;195838;129272;89;325110
76;2021-04-19;36;8;44;69372;26728;90;96100
76;2021-04-19;1749;1624;3393;3065778;2859080;0;5924858
84;2021-04-19;108;108;217;459549;481088;09;940637
84;2021-04-19;380;411;793;487711;511905;19;999616
84;2021-04-19;493;444;939;443824;451094;29;894918
84;2021-04-19;449;415;868;512522;493262;39;1005784
84;2021-04-19;496;518;1014;520248;515106;49;1035354
84;2021-04-19;420;409;829;529611;514848;59;1044459
84;2021-04-19;285;255;540;486720;439940;69;926660
84;2021-04-19;145;139;284;372151;315211;79;687362
84;2021-04-19;73;39;112;237198;150524;89;387722
84;2021-04-19;28;12;40;81185;28680;90;109865
84;2021-04-19;2877;2750;5636;4130719;3901658;0;8032377
93;2021-04-19;61;97;158;268834;283093;09;551927
93;2021-04-19;225;249;474;280751;296087;19;576838
93;2021-04-19;380;310;692;254404;255552;29;509956
93;2021-04-19;351;341;692;310704;288398;39;599102
93;2021-04-19;382;392;779;325559;305827;49;631386
93;2021-04-19;347;340;688;353104;325389;59;678493
93;2021-04-19;195;215;410;336327;296459;69;632786
93;2021-04-19;102;107;209;279820;229699;79;509519
93;2021-04-19;55;36;91;171274;113716;89;284990
93;2021-04-19;32;7;39;58896;21758;90;80654
93;2021-04-19;2132;2094;4234;2639673;2415978;0;5055651
94;2021-04-19;0;4;4;16311;17433;09;33744
94;2021-04-19;2;5;7;16679;18132;19;34811
94;2021-04-19;3;6;9;16782;16579;29;33361
94;2021-04-19;4;11;15;23044;20580;39;43624
94;2021-04-19;12;13;25;23065;22140;49;45205
94;2021-04-19;11;5;16;24549;23421;59;47970
94;2021-04-19;5;6;11;23212;21883;69;45095
94;2021-04-19;6;4;10;19544;17141;79;36685
94;2021-04-19;2;0;2;11227;8178;89;19405
94;2021-04-19;2;1;3;3332;1447;90;4779
94;2021-04-19;47;55;102;177745;166934;0;344679
01;2021-04-20;0;1;1;19979;20155;09;40134
01;2021-04-20;7;11;18;24994;25489;19;50483
01;2021-04-20;14;8;22;17868;16690;29;34558
01;2021-04-20;12;8;20;22328;14821;39;37149
01;2021-04-20;23;12;35;28652;20276;49;48928
01;2021-04-20;15;18;33;33264;27260;59;60524
01;2021-04-20;8;15;23;27135;23978;69;51113
01;2021-04-20;6;5;11;18401;14661;79;33062
01;2021-04-20;5;3;8;9633;6375;89;16008
01;2021-04-20;0;2;2;3410;1510;90;4920
01;2021-04-20;90;83;173;205664;171215;0;376879
02;2021-04-20;1;4;5;16881;17110;09;33991
02;2021-04-20;5;5;10;21410;21604;19;43014
02;2021-04-20;8;7;15;16017;15479;29;31496
02;2021-04-20;11;10;21;19825;14455;39;34280
02;2021-04-20;11;6;17;24719;18248;49;42967
02;2021-04-20;17;10;27;34361;28310;59;62671
02;2021-04-20;11;11;22;28061;24495;69;52556
02;2021-04-20;4;4;8;18231;15278;79;33509
02;2021-04-20;1;1;2;11090;7677;89;18767
02;2021-04-20;2;1;3;3992;1506;90;5498
02;2021-04-20;71;59;130;194587;164162;0;358749
03;2021-04-20;0;1;1;31123;30920;09;62043
03;2021-04-20;6;12;18;29370;29268;19;58638
03;2021-04-20;12;12;24;21458;18963;29;40421
03;2021-04-20;13;14;27;21276;18326;39;39602
03;2021-04-20;12;11;23;18164;16593;49;34757
03;2021-04-20;7;8;15;13469;13557;59;27026
03;2021-04-20;9;6;15;8776;8670;69;17446
03;2021-04-20;1;2;3;3777;3591;79;7368
03;2021-04-20;1;0;1;1649;1072;89;2721
03;2021-04-20;0;0;0;485;184;90;669
03;2021-04-20;61;66;127;149547;141144;0;290691
04;2021-04-20;5;17;22;60314;61377;09;121691
04;2021-04-20;23;14;37;66065;68387;19;134452
04;2021-04-20;13;7;20;51059;47156;29;98215
04;2021-04-20;13;6;19;58788;45780;39;104568
04;2021-04-20;18;17;35;61408;52207;49;113615
04;2021-04-20;12;23;35;64838;60759;59;125597
04;2021-04-20;7;6;13;47008;42843;69;89851
04;2021-04-20;3;4;7;25509;21184;79;46693
04;2021-04-20;3;1;4;13168;7647;89;20815
04;2021-04-20;0;0;0;3209;1253;90;4462
04;2021-04-20;97;95;192;451366;408593;0;859959
05;2021-04-20;0;0;0;362.366008612902;341.338819562748;09;703.704828175651
05;2021-04-20;0;0;0;353.376145114279;370.349735405642;19;723.725880519921
05;2021-04-20;0;0;0;218.593559489256;256.539602589476;29;475.133162078732
05;2021-04-20;0;0;0;404.225408693299;360.321910454353;39;764.547319147651
05;2021-04-20;0;0;0;520.067953604221;497.108383964256;49;1017.17633756848
05;2021-04-20;0;0;0;468.146063921917;510.087601910415;59;978.233665832332
05;2021-04-20;0;0;0;340.368470050554;334.366842191253;69;674.735312241807
05;2021-04-20;0;0;0;212.598666888387;192.597753227106;79;405.196420115493
05;2021-04-20;0;0;0;148.727797095705;61.8681715431829;89;210.595968638888
05;2021-04-20;0;0;0;32.9601271090696;10.9909785719784;90;43.9511056810479
05;2021-04-20;0;0;0;3061.43020057959;2935.56979942041;0;5997
06;2021-04-20;0;0;0;42583;42380;09;84963
06;2021-04-20;0;4;4;33369;31925;19;65294
06;2021-04-20;3;1;4;21571;15080;29;36651
06;2021-04-20;2;2;4;21550;16147;39;37697
06;2021-04-20;1;0;1;14193;13939;49;28132
06;2021-04-20;1;1;2;7171;7597;59;14768
06;2021-04-20;0;1;1;3629;4117;69;7746
06;2021-04-20;0;0;0;1577;1457;79;3034
06;2021-04-20;0;0;0;531;474;89;1005
06;2021-04-20;0;0;0;88;93;90;181
06;2021-04-20;7;9;16;146262;133209;0;279471
07;2021-04-20;0;0;0;485;549;09;1034
07;2021-04-20;0;0;0;403;432;19;835
07;2021-04-20;1;0;1;764;841;29;1605
07;2021-04-20;0;0;0;824;928;39;1752
07;2021-04-20;0;0;0;788;1020;49;1808
07;2021-04-20;0;0;0;678;870;59;1548
07;2021-04-20;0;0;0;360;382;69;742
07;2021-04-20;0;0;0;231;190;79;421
07;2021-04-20;0;0;0;114;67;89;181
07;2021-04-20;0;0;0;24;11;90;35
07;2021-04-20;1;0;1;4671;5290;0;9961
08;2021-04-20;0;0;0;2715.22592983026;2997.75551488675;09;5712.98144471701
08;2021-04-20;0;0;0;2778.51901080978;3160.9156459093;19;5939.43465671908
08;2021-04-20;0;0;0;2080.8882988764;1718.16634315323;29;3799.05464202964
08;2021-04-20;0;0;0;2701.8582062647;1896.52641413317;39;4598.38462039786
08;2021-04-20;0;0;0;3151.45861023308;2460.52498233809;49;5611.98359257117
08;2021-04-20;0;0;0;2620.29868333099;2422.23566154656;59;5042.53434487755
08;2021-04-20;0;1;1;1621.44173420671;1438.58325779464;69;3060.02499200135
08;2021-04-20;0;0;0;626.575909335673;526.358467843651;79;1152.93437717932
08;2021-04-20;0;0;0;205.018522985054;140.993639349697;89;346.012162334751
08;2021-04-20;0;0;0;50.0325684687745;20.62259870351;90;70.6551671722846
08;2021-04-20;0;1;1;18551.3174743414;16782.6825256586;0;35334
11;2021-04-20;191;183;406;783071;811785;09;1594856
11;2021-04-20;599;537;1183;761456;784653;19;1546109
11;2021-04-20;1082;989;2084;850145;801772;29;1651917
11;2021-04-20;940;930;1882;914360;843488;39;1757848
11;2021-04-20;774;807;1593;845609;826202;49;1671811
11;2021-04-20;684;677;1370;793566;745070;59;1538636
11;2021-04-20;435;400;840;628649;549192;69;1177841
11;2021-04-20;196;150;348;434606;358356;79;792962
11;2021-04-20;86;73;160;261425;162933;89;424358
11;2021-04-20;57;27;84;89253;32619;90;121872
11;2021-04-20;5046;4775;9959;6362140;5916070;0;12278210
24;2021-04-20;20;18;41;139720;144686;09;284406
24;2021-04-20;99;77;178;152979;161185;19;314164
24;2021-04-20;103;90;193;122237;126536;29;248773
24;2021-04-20;100;85;186;150359;142009;39;292368
24;2021-04-20;78;89;167;161829;158758;49;320587
24;2021-04-20;93;91;184;172552;168011;59;340563
24;2021-04-20;63;68;131;172509;158177;69;330686
24;2021-04-20;41;25;66;129428;110593;79;240021
24;2021-04-20;16;9;25;87342;56882;89;144224
24;2021-04-20;8;6;14;31210;12071;90;43281
24;2021-04-20;621;559;1186;1320165;1238908;0;2559073
27;2021-04-20;25;24;49;143373;149679;09;293052
27;2021-04-20;106;101;207;160962;173003;19;333965
27;2021-04-20;142;126;268;133746;142254;29;276000
27;2021-04-20;85;96;181;160004;155407;39;315411
27;2021-04-20;108;105;213;172333;169564;49;341897
27;2021-04-20;80;86;166;189979;183788;59;373767
27;2021-04-20;70;78;148;192591;178206;69;370797
27;2021-04-20;44;41;85;146876;127546;79;274422
27;2021-04-20;24;16;40;96896;61575;89;158471
27;2021-04-20;22;7;29;33148;12109;90;45257
27;2021-04-20;706;680;1386;1429908;1353131;0;2783039
28;2021-04-20;51;50;101;180735;186856;09;367591
28;2021-04-20;146;130;278;200125;213621;19;413746
28;2021-04-20;123;147;271;168922;173007;29;341929
28;2021-04-20;126;105;231;196628;188487;39;385115
28;2021-04-20;148;125;274;205396;201699;49;407095
28;2021-04-20;121;140;262;222002;213866;59;435868
28;2021-04-20;73;82;155;224688;203758;69;428446
28;2021-04-20;63;42;105;163192;135543;79;298735
28;2021-04-20;24;21;45;109691;65377;89;175068
28;2021-04-20;15;5;20;37222;12685;90;49907
28;2021-04-20;891;847;1743;1708601;1594899;0;3303500
32;2021-04-20;96;93;190;358062;373689;09;731751
32;2021-04-20;249;235;484;387045;406742;19;793787
32;2021-04-20;341;323;672;342304;348587;29;690891
32;2021-04-20;288;291;582;382485;369972;39;752457
32;2021-04-20;296;269;567;382510;376716;49;759226
32;2021-04-20;266;256;523;386937;376527;59;763464
32;2021-04-20;165;152;319;371211;330938;69;702149
32;2021-04-20;74;83;157;250542;201459;79;452001
32;2021-04-20;44;34;78;163399;89786;89;253185
32;2021-04-20;19;9;28;48384;15367;90;63751
32;2021-04-20;1839;1745;3601;3072879;2889783;0;5962662
44;2021-04-20;85;68;155;291525;306839;09;598364
44;2021-04-20;185;171;358;320255;339504;19;659759
44;2021-04-20;217;215;433;302020;314428;29;616448
44;2021-04-20;193;204;399;342222;333292;39;675514
44;2021-04-20;205;180;385;349727;344491;49;694218
44;2021-04-20;179;169;349;381371;373239;59;754610
44;2021-04-20;131;104;235;367165;335850;69;703015
44;2021-04-20;60;53;114;250387;215436;79;465823
44;2021-04-20;39;35;74;170825;105192;89;276017
44;2021-04-20;29;11;40;51248;16731;90;67979
44;2021-04-20;1324;1210;2543;2826745;2685002;0;5511747
52;2021-04-20;41;30;72;213594;223900;09;437494
52;2021-04-20;113;113;228;240818;255197;19;496015
52;2021-04-20;129;153;282;197010;200630;29;397640
52;2021-04-20;120;110;230;231204;224885;39;456089
52;2021-04-20;124;124;248;243874;243418;49;487292
52;2021-04-20;123;112;236;244100;239116;59;483216
52;2021-04-20;80;80;160;241796;221345;69;463141
52;2021-04-20;46;40;86;177805;149903;79;327708
52;2021-04-20;36;23;59;119561;75822;89;195383
52;2021-04-20;14;9;23;42559;15260;90;57819
52;2021-04-20;826;794;1624;1952321;1849476;0;3801797
53;2021-04-20;37;37;74;173813;182358;09;356171
53;2021-04-20;78;68;146;202720;214740;19;417460
53;2021-04-20;92;103;198;163116;173196;29;336312
53;2021-04-20;65;65;130;190526;187674;39;378200
53;2021-04-20;77;83;160;212098;212015;49;424113
53;2021-04-20;74;74;148;223699;219176;59;442875
53;2021-04-20;53;42;95;227435;209274;69;436709
53;2021-04-20;26;17;43;169992;140910;79;310902
53;2021-04-20;22;16;38;118117;69883;89;188000
53;2021-04-20;1;1;2;37370;12267;90;49637
53;2021-04-20;525;506;1034;1718886;1621493;0;3340379
75;2021-04-20;29;47;77;293104;305291;09;598395
75;2021-04-20;106;130;237;337141;357785;19;694926
75;2021-04-20;162;165;327;295024;300618;29;595642
75;2021-04-20;162;122;284;347871;331233;39;679104
75;2021-04-20;156;133;290;384742;372771;49;757513
75;2021-04-20;128;150;278;413361;390880;59;804241
75;2021-04-20;104;78;183;425623;384060;69;809683
75;2021-04-20;49;53;104;325086;276298;79;601384
75;2021-04-20;39;16;55;213986;139308;89;353294
75;2021-04-20;14;13;27;77600;28200;90;105800
75;2021-04-20;949;907;1862;3113538;2886444;0;5999982
76;2021-04-20;51;50;102;305956;318589;09;624545
76;2021-04-20;154;175;335;338942;356969;19;695911
76;2021-04-20;225;214;440;316210;319570;29;635780
76;2021-04-20;224;157;383;356758;337587;39;694345
76;2021-04-20;227;186;414;376541;363812;49;740353
76;2021-04-20;184;165;350;402608;383750;59;786358
76;2021-04-20;120;121;241;394889;358997;69;753886
76;2021-04-20;65;72;137;308664;263806;79;572470
76;2021-04-20;57;43;100;195838;129272;89;325110
76;2021-04-20;37;20;57;69372;26728;90;96100
76;2021-04-20;1344;1205;2561;3065778;2859080;0;5924858
84;2021-04-20;78;99;178;459549;481088;09;940637
84;2021-04-20;281;305;586;487711;511905;19;999616
84;2021-04-20;332;336;669;443824;451094;29;894918
84;2021-04-20;330;296;626;512522;493262;39;1005784
84;2021-04-20;312;320;632;520248;515106;49;1035354
84;2021-04-20;281;288;569;529611;514848;59;1044459
84;2021-04-20;189;171;360;486720;439940;69;926660
84;2021-04-20;108;92;200;372151;315211;79;687362
84;2021-04-20;59;38;97;237198;150524;89;387722
84;2021-04-20;21;12;33;81185;28680;90;109865
84;2021-04-20;1993;1957;3953;4130719;3901658;0;8032377
93;2021-04-20;45;49;97;268834;283093;09;551927
93;2021-04-20;177;186;364;280751;296087;19;576838
93;2021-04-20;254;245;499;254404;255552;29;509956
93;2021-04-20;291;247;540;310704;288398;39;599102
93;2021-04-20;247;212;459;325559;305827;49;631386
93;2021-04-20;200;230;430;353104;325389;59;678493
93;2021-04-20;166;123;289;336327;296459;69;632786
93;2021-04-20;85;67;152;279820;229699;79;509519
93;2021-04-20;46;39;85;171274;113716;89;284990
93;2021-04-20;26;8;34;58896;21758;90;80654
93;2021-04-20;1537;1406;2949;2639673;2415978;0;5055651
94;2021-04-20;6;2;8;16311;17433;09;33744
94;2021-04-20;5;11;16;16679;18132;19;34811
94;2021-04-20;7;8;15;16782;16579;29;33361
94;2021-04-20;6;3;9;23044;20580;39;43624
94;2021-04-20;9;6;15;23065;22140;49;45205
94;2021-04-20;3;5;8;24549;23421;59;47970
94;2021-04-20;7;3;10;23212;21883;69;45095
94;2021-04-20;3;2;5;19544;17141;79;36685
94;2021-04-20;0;0;0;11227;8178;89;19405
94;2021-04-20;2;0;2;3332;1447;90;4779
94;2021-04-20;48;40;88;177745;166934;0;344679
01;2021-04-21;4;2;6;19979;20155;09;40134
01;2021-04-21;14;7;21;24994;25489;19;50483
01;2021-04-21;12;10;22;17868;16690;29;34558
01;2021-04-21;11;7;18;22328;14821;39;37149
01;2021-04-21;14;13;27;28652;20276;49;48928
01;2021-04-21;13;11;24;33264;27260;59;60524
01;2021-04-21;17;9;26;27135;23978;69;51113
01;2021-04-21;5;8;13;18401;14661;79;33062
01;2021-04-21;1;1;2;9633;6375;89;16008
01;2021-04-21;1;0;1;3410;1510;90;4920
01;2021-04-21;92;68;160;205664;171215;0;376879
02;2021-04-21;2;3;5;16881;17110;09;33991
02;2021-04-21;7;1;8;21410;21604;19;43014
02;2021-04-21;9;3;12;16017;15479;29;31496
02;2021-04-21;8;4;12;19825;14455;39;34280
02;2021-04-21;9;5;14;24719;18248;49;42967
02;2021-04-21;8;9;17;34361;28310;59;62671
02;2021-04-21;11;7;18;28061;24495;69;52556
02;2021-04-21;3;2;5;18231;15278;79;33509
02;2021-04-21;1;0;1;11090;7677;89;18767
02;2021-04-21;1;0;1;3992;1506;90;5498
02;2021-04-21;59;34;93;194587;164162;0;358749
03;2021-04-21;4;1;5;31123;30920;09;62043
03;2021-04-21;13;12;25;29370;29268;19;58638
03;2021-04-21;14;10;25;21458;18963;29;40421
03;2021-04-21;15;10;25;21276;18326;39;39602
03;2021-04-21;6;8;14;18164;16593;49;34757
03;2021-04-21;10;5;15;13469;13557;59;27026
03;2021-04-21;2;10;12;8776;8670;69;17446
03;2021-04-21;3;0;3;3777;3591;79;7368
03;2021-04-21;3;0;3;1649;1072;89;2721
03;2021-04-21;0;1;1;485;184;90;669
03;2021-04-21;70;57;128;149547;141144;0;290691
04;2021-04-21;8;10;18;60314;61377;09;121691
04;2021-04-21;17;13;30;66065;68387;19;134452
04;2021-04-21;20;18;38;51059;47156;29;98215
04;2021-04-21;15;11;26;58788;45780;39;104568
04;2021-04-21;16;5;21;61408;52207;49;113615
04;2021-04-21;6;9;15;64838;60759;59;125597
04;2021-04-21;8;12;20;47008;42843;69;89851
04;2021-04-21;3;3;6;25509;21184;79;46693
04;2021-04-21;3;1;4;13168;7647;89;20815
04;2021-04-21;1;0;1;3209;1253;90;4462
04;2021-04-21;97;82;179;451366;408593;0;859959
05;2021-04-21;0;0;0;362.366008612902;341.338819562748;09;703.704828175651
05;2021-04-21;0;0;0;353.376145114279;370.349735405642;19;723.725880519921
05;2021-04-21;0;0;0;218.593559489256;256.539602589476;29;475.133162078732
05;2021-04-21;0;0;0;404.225408693299;360.321910454353;39;764.547319147651
05;2021-04-21;0;0;0;520.067953604221;497.108383964256;49;1017.17633756848
05;2021-04-21;0;0;0;468.146063921917;510.087601910415;59;978.233665832332
05;2021-04-21;0;0;0;340.368470050554;334.366842191253;69;674.735312241807
05;2021-04-21;0;0;0;212.598666888387;192.597753227106;79;405.196420115493
05;2021-04-21;0;0;0;148.727797095705;61.8681715431829;89;210.595968638888
05;2021-04-21;0;0;0;32.9601271090696;10.9909785719784;90;43.9511056810479
05;2021-04-21;0;0;0;3061.43020057959;2935.56979942041;0;5997
06;2021-04-21;2;0;2;42583;42380;09;84963
06;2021-04-21;2;0;2;33369;31925;19;65294
06;2021-04-21;4;2;6;21571;15080;29;36651
06;2021-04-21;2;1;3;21550;16147;39;37697
06;2021-04-21;1;1;2;14193;13939;49;28132
06;2021-04-21;2;1;3;7171;7597;59;14768
06;2021-04-21;1;0;1;3629;4117;69;7746
06;2021-04-21;0;0;0;1577;1457;79;3034
06;2021-04-21;0;0;0;531;474;89;1005
06;2021-04-21;0;0;0;88;93;90;181
06;2021-04-21;14;5;19;146262;133209;0;279471
07;2021-04-21;0;0;0;485;549;09;1034
07;2021-04-21;0;0;0;403;432;19;835
07;2021-04-21;0;0;0;764;841;29;1605
07;2021-04-21;0;0;0;824;928;39;1752
07;2021-04-21;0;0;0;788;1020;49;1808
07;2021-04-21;0;1;1;678;870;59;1548
07;2021-04-21;0;0;0;360;382;69;742
07;2021-04-21;0;1;1;231;190;79;421
07;2021-04-21;0;0;0;114;67;89;181
07;2021-04-21;0;0;0;24;11;90;35
07;2021-04-21;0;2;2;4671;5290;0;9961
08;2021-04-21;0;0;0;2715.22592983026;2997.75551488675;09;5712.98144471701
08;2021-04-21;0;0;0;2778.51901080978;3160.9156459093;19;5939.43465671908
08;2021-04-21;1;0;1;2080.8882988764;1718.16634315323;29;3799.05464202964
08;2021-04-21;0;0;0;2701.8582062647;1896.52641413317;39;4598.38462039786
08;2021-04-21;1;1;2;3151.45861023308;2460.52498233809;49;5611.98359257117
08;2021-04-21;2;0;2;2620.29868333099;2422.23566154656;59;5042.53434487755
08;2021-04-21;1;0;1;1621.44173420671;1438.58325779464;69;3060.02499200135
08;2021-04-21;0;0;0;626.575909335673;526.358467843651;79;1152.93437717932
08;2021-04-21;0;0;0;205.018522985054;140.993639349697;89;346.012162334751
08;2021-04-21;1;0;1;50.0325684687745;20.62259870351;90;70.6551671722846
08;2021-04-21;6;1;7;18551.3174743414;16782.6825256586;0;35334
11;2021-04-21;175;212;416;783071;811785;09;1594856
11;2021-04-21;521;508;1074;761456;784653;19;1546109
11;2021-04-21;999;954;1973;850145;801772;29;1651917
11;2021-04-21;953;830;1792;914360;843488;39;1757848
11;2021-04-21;742;734;1491;845609;826202;49;1671811
11;2021-04-21;605;626;1241;793566;745070;59;1538636
11;2021-04-21;356;320;681;628649;549192;69;1177841
11;2021-04-21;147;160;308;434606;358356;79;792962
11;2021-04-21;98;63;161;261425;162933;89;424358
11;2021-04-21;43;25;68;89253;32619;90;121872
11;2021-04-21;4639;4438;9212;6362140;5916070;0;12278210
24;2021-04-21;19;24;44;139720;144686;09;284406
24;2021-04-21;83;78;164;152979;161185;19;314164
24;2021-04-21;106;90;196;122237;126536;29;248773
24;2021-04-21;78;82;160;150359;142009;39;292368
24;2021-04-21;90;59;149;161829;158758;49;320587
24;2021-04-21;85;75;161;172552;168011;59;340563
24;2021-04-21;63;53;116;172509;158177;69;330686
24;2021-04-21;30;23;53;129428;110593;79;240021
24;2021-04-21;23;18;41;87342;56882;89;144224
24;2021-04-21;15;9;24;31210;12071;90;43281
24;2021-04-21;592;511;1108;1320165;1238908;0;2559073
27;2021-04-21;27;30;57;143373;149679;09;293052
27;2021-04-21;101;71;172;160962;173003;19;333965
27;2021-04-21;94;114;208;133746;142254;29;276000
27;2021-04-21;95;74;169;160004;155407;39;315411
27;2021-04-21;83;84;167;172333;169564;49;341897
27;2021-04-21;76;93;169;189979;183788;59;373767
27;2021-04-21;63;45;108;192591;178206;69;370797
27;2021-04-21;36;34;70;146876;127546;79;274422
27;2021-04-21;31;17;48;96896;61575;89;158471
27;2021-04-21;15;5;20;33148;12109;90;45257
27;2021-04-21;621;567;1188;1429908;1353131;0;2783039
28;2021-04-21;38;36;75;180735;186856;09;367591
28;2021-04-21;123;102;227;200125;213621;19;413746
28;2021-04-21;126;139;267;168922;173007;29;341929
28;2021-04-21;123;98;222;196628;188487;39;385115
28;2021-04-21;132;106;238;205396;201699;49;407095
28;2021-04-21;117;120;238;222002;213866;59;435868
28;2021-04-21;99;63;162;224688;203758;69;428446
28;2021-04-21;43;47;90;163192;135543;79;298735
28;2021-04-21;14;14;28;109691;65377;89;175068
28;2021-04-21;26;7;34;37222;12685;90;49907
28;2021-04-21;842;732;1582;1708601;1594899;0;3303500
32;2021-04-21;92;105;197;358062;373689;09;731751
32;2021-04-21;252;230;487;387045;406742;19;793787
32;2021-04-21;370;346;725;342304;348587;29;690891
32;2021-04-21;305;263;570;382485;369972;39;752457
32;2021-04-21;255;262;521;382510;376716;49;759226
32;2021-04-21;230;221;453;386937;376527;59;763464
32;2021-04-21;174;139;313;371211;330938;69;702149
32;2021-04-21;73;62;135;250542;201459;79;452001
32;2021-04-21;60;32;92;163399;89786;89;253185
32;2021-04-21;29;13;42;48384;15367;90;63751
32;2021-04-21;1843;1673;3538;3072879;2889783;0;5962662
44;2021-04-21;50;72;125;291525;306839;09;598364
44;2021-04-21;132;161;295;320255;339504;19;659759
44;2021-04-21;218;185;404;302020;314428;29;616448
44;2021-04-21;176;164;341;342222;333292;39;675514
44;2021-04-21;172;167;340;349727;344491;49;694218
44;2021-04-21;142;144;287;381371;373239;59;754610
44;2021-04-21;102;99;201;367165;335850;69;703015
44;2021-04-21;55;50;105;250387;215436;79;465823
44;2021-04-21;30;26;56;170825;105192;89;276017
44;2021-04-21;19;6;25;51248;16731;90;67979
44;2021-04-21;1096;1075;2181;2826745;2685002;0;5511747
52;2021-04-21;52;50;103;213594;223900;09;437494
52;2021-04-21;135;107;243;240818;255197;19;496015
52;2021-04-21;144;142;287;197010;200630;29;397640
52;2021-04-21;104;102;206;231204;224885;39;456089
52;2021-04-21;101;104;205;243874;243418;49;487292
52;2021-04-21;121;106;229;244100;239116;59;483216
52;2021-04-21;60;78;139;241796;221345;69;463141
52;2021-04-21;48;26;74;177805;149903;79;327708
52;2021-04-21;29;26;55;119561;75822;89;195383
52;2021-04-21;23;6;29;42559;15260;90;57819
52;2021-04-21;817;747;1570;1952321;1849476;0;3801797
53;2021-04-21;25;23;49;173813;182358;09;356171
53;2021-04-21;74;76;150;202720;214740;19;417460
53;2021-04-21;98;100;198;163116;173196;29;336312
53;2021-04-21;79;75;154;190526;187674;39;378200
53;2021-04-21;63;71;134;212098;212015;49;424113
53;2021-04-21;56;79;135;223699;219176;59;442875
53;2021-04-21;32;45;77;227435;209274;69;436709
53;2021-04-21;31;21;52;169992;140910;79;310902
53;2021-04-21;15;13;28;118117;69883;89;188000
53;2021-04-21;14;2;16;37370;12267;90;49637
53;2021-04-21;487;505;993;1718886;1621493;0;3340379
75;2021-04-21;48;41;92;293104;305291;09;598395
75;2021-04-21;125;145;274;337141;357785;19;694926
75;2021-04-21;166;176;342;295024;300618;29;595642
75;2021-04-21;148;107;255;347871;331233;39;679104
75;2021-04-21;150;156;308;384742;372771;49;757513
75;2021-04-21;95;120;215;413361;390880;59;804241
75;2021-04-21;69;93;162;425623;384060;69;809683
75;2021-04-21;54;43;97;325086;276298;79;601384
75;2021-04-21;36;29;65;213986;139308;89;353294
75;2021-04-21;20;5;25;77600;28200;90;105800
75;2021-04-21;913;917;1839;3113538;2886444;0;5999982
76;2021-04-21;43;53;101;305956;318589;09;624545
76;2021-04-21;149;159;311;338942;356969;19;695911
76;2021-04-21;249;194;450;316210;319570;29;635780
76;2021-04-21;155;195;350;356758;337587;39;694345
76;2021-04-21;199;160;359;376541;363812;49;740353
76;2021-04-21;151;178;330;402608;383750;59;786358
76;2021-04-21;81;99;182;394889;358997;69;753886
76;2021-04-21;59;66;125;308664;263806;79;572470
76;2021-04-21;48;34;82;195838;129272;89;325110
76;2021-04-21;27;13;40;69372;26728;90;96100
76;2021-04-21;1161;1154;2333;3065778;2859080;0;5924858
84;2021-04-21;93;90;184;459549;481088;09;940637
84;2021-04-21;283;300;584;487711;511905;19;999616
84;2021-04-21;353;337;691;443824;451094;29;894918
84;2021-04-21;298;296;594;512522;493262;39;1005784
84;2021-04-21;313;325;639;520248;515106;49;1035354
84;2021-04-21;279;276;555;529611;514848;59;1044459
84;2021-04-21;193;181;375;486720;439940;69;926660
84;2021-04-21;81;102;183;372151;315211;79;687362
84;2021-04-21;67;34;101;237198;150524;89;387722
84;2021-04-21;30;13;43;81185;28680;90;109865
84;2021-04-21;1990;1954;3949;4130719;3901658;0;8032377
93;2021-04-21;61;75;136;268834;283093;09;551927
93;2021-04-21;188;189;377;280751;296087;19;576838
93;2021-04-21;255;249;504;254404;255552;29;509956
93;2021-04-21;263;238;502;310704;288398;39;599102
93;2021-04-21;250;246;496;325559;305827;49;631386
93;2021-04-21;181;188;369;353104;325389;59;678493
93;2021-04-21;128;114;242;336327;296459;69;632786
93;2021-04-21;68;71;139;279820;229699;79;509519
93;2021-04-21;48;39;87;171274;113716;89;284990
93;2021-04-21;19;13;32;58896;21758;90;80654
93;2021-04-21;1462;1424;2887;2639673;2415978;0;5055651
94;2021-04-21;4;4;8;16311;17433;09;33744
94;2021-04-21;8;6;14;16679;18132;19;34811
94;2021-04-21;7;5;12;16782;16579;29;33361
94;2021-04-21;7;4;11;23044;20580;39;43624
94;2021-04-21;6;4;10;23065;22140;49;45205
94;2021-04-21;4;4;8;24549;23421;59;47970
94;2021-04-21;2;1;3;23212;21883;69;45095
94;2021-04-21;0;5;5;19544;17141;79;36685
94;2021-04-21;4;1;5;11227;8178;89;19405
94;2021-04-21;3;1;4;3332;1447;90;4779
94;2021-04-21;45;36;81;177745;166934;0;344679
01;2021-04-22;0;2;2;19979;20155;09;40134
01;2021-04-22;16;9;25;24994;25489;19;50483
01;2021-04-22;8;7;15;17868;16690;29;34558
01;2021-04-22;12;8;20;22328;14821;39;37149
01;2021-04-22;17;15;32;28652;20276;49;48928
01;2021-04-22;13;14;27;33264;27260;59;60524
01;2021-04-22;8;5;13;27135;23978;69;51113
01;2021-04-22;8;8;16;18401;14661;79;33062
01;2021-04-22;2;2;4;9633;6375;89;16008
01;2021-04-22;0;0;0;3410;1510;90;4920
01;2021-04-22;84;70;154;205664;171215;0;376879
02;2021-04-22;2;3;5;16881;17110;09;33991
02;2021-04-22;7;2;9;21410;21604;19;43014
02;2021-04-22;10;4;14;16017;15479;29;31496
02;2021-04-22;5;6;11;19825;14455;39;34280
02;2021-04-22;9;10;19;24719;18248;49;42967
02;2021-04-22;15;5;20;34361;28310;59;62671
02;2021-04-22;5;11;16;28061;24495;69;52556
02;2021-04-22;5;3;8;18231;15278;79;33509
02;2021-04-22;1;2;3;11090;7677;89;18767
02;2021-04-22;0;1;1;3992;1506;90;5498
02;2021-04-22;59;47;106;194587;164162;0;358749
03;2021-04-22;2;3;5;31123;30920;09;62043
03;2021-04-22;14;11;26;29370;29268;19;58638
03;2021-04-22;9;10;19;21458;18963;29;40421
03;2021-04-22;19;17;36;21276;18326;39;39602
03;2021-04-22;10;6;16;18164;16593;49;34757
03;2021-04-22;8;6;14;13469;13557;59;27026
03;2021-04-22;3;5;8;8776;8670;69;17446
03;2021-04-22;1;2;3;3777;3591;79;7368
03;2021-04-22;0;2;2;1649;1072;89;2721
03;2021-04-22;0;0;0;485;184;90;669
03;2021-04-22;66;62;129;149547;141144;0;290691
04;2021-04-22;9;7;16;60314;61377;09;121691
04;2021-04-22;17;21;38;66065;68387;19;134452
04;2021-04-22;20;16;36;51059;47156;29;98215
04;2021-04-22;15;13;28;58788;45780;39;104568
04;2021-04-22;13;12;25;61408;52207;49;113615
04;2021-04-22;14;7;21;64838;60759;59;125597
04;2021-04-22;6;7;13;47008;42843;69;89851
04;2021-04-22;2;2;4;25509;21184;79;46693
04;2021-04-22;1;1;2;13168;7647;89;20815
04;2021-04-22;0;0;0;3209;1253;90;4462
04;2021-04-22;97;86;183;451366;408593;0;859959
05;2021-04-22;0;0;0;362.366008612902;341.338819562748;09;703.704828175651
05;2021-04-22;0;0;0;353.376145114279;370.349735405642;19;723.725880519921
05;2021-04-22;0;0;0;218.593559489256;256.539602589476;29;475.133162078732
05;2021-04-22;0;0;0;404.225408693299;360.321910454353;39;764.547319147651
05;2021-04-22;0;0;0;520.067953604221;497.108383964256;49;1017.17633756848
05;2021-04-22;0;0;0;468.146063921917;510.087601910415;59;978.233665832332
05;2021-04-22;0;0;0;340.368470050554;334.366842191253;69;674.735312241807
05;2021-04-22;0;0;0;212.598666888387;192.597753227106;79;405.196420115493
05;2021-04-22;0;0;0;148.727797095705;61.8681715431829;89;210.595968638888
05;2021-04-22;0;0;0;32.9601271090696;10.9909785719784;90;43.9511056810479
05;2021-04-22;0;0;0;3061.43020057959;2935.56979942041;0;5997
06;2021-04-22;0;0;0;42583;42380;09;84963
06;2021-04-22;1;0;1;33369;31925;19;65294
06;2021-04-22;1;12;13;21571;15080;29;36651
06;2021-04-22;2;0;2;21550;16147;39;37697
06;2021-04-22;2;3;5;14193;13939;49;28132
06;2021-04-22;2;4;6;7171;7597;59;14768
06;2021-04-22;0;0;0;3629;4117;69;7746
06;2021-04-22;0;0;0;1577;1457;79;3034
06;2021-04-22;0;0;0;531;474;89;1005
06;2021-04-22;0;0;0;88;93;90;181
06;2021-04-22;8;19;27;146262;133209;0;279471
07;2021-04-22;0;0;0;485;549;09;1034
07;2021-04-22;0;0;0;403;432;19;835
07;2021-04-22;1;0;1;764;841;29;1605
07;2021-04-22;1;0;1;824;928;39;1752
07;2021-04-22;0;1;1;788;1020;49;1808
07;2021-04-22;0;0;0;678;870;59;1548
07;2021-04-22;0;0;0;360;382;69;742
07;2021-04-22;0;0;0;231;190;79;421
07;2021-04-22;0;0;0;114;67;89;181
07;2021-04-22;0;0;0;24;11;90;35
07;2021-04-22;2;1;3;4671;5290;0;9961
08;2021-04-22;0;0;0;2715.22592983026;2997.75551488675;09;5712.98144471701
08;2021-04-22;0;0;0;2778.51901080978;3160.9156459093;19;5939.43465671908
08;2021-04-22;0;1;1;2080.8882988764;1718.16634315323;29;3799.05464202964
08;2021-04-22;0;0;0;2701.8582062647;1896.52641413317;39;4598.38462039786
08;2021-04-22;0;2;2;3151.45861023308;2460.52498233809;49;5611.98359257117
08;2021-04-22;0;0;0;2620.29868333099;2422.23566154656;59;5042.53434487755
08;2021-04-22;0;0;0;1621.44173420671;1438.58325779464;69;3060.02499200135
08;2021-04-22;1;1;2;626.575909335673;526.358467843651;79;1152.93437717932
08;2021-04-22;0;0;0;205.018522985054;140.993639349697;89;346.012162334751
08;2021-04-22;0;0;0;50.0325684687745;20.62259870351;90;70.6551671722846
08;2021-04-22;1;4;5;18551.3174743414;16782.6825256586;0;35334
11;2021-04-22;161;167;350;783071;811785;09;1594856
11;2021-04-22;534;476;1034;761456;784653;19;1546109
11;2021-04-22;925;887;1825;850145;801772;29;1651917
11;2021-04-22;849;797;1656;914360;843488;39;1757848
11;2021-04-22;706;666;1378;845609;826202;49;1671811
11;2021-04-22;635;643;1290;793566;745070;59;1538636
11;2021-04-22;350;330;684;628649;549192;69;1177841
11;2021-04-22;172;124;296;434606;358356;79;792962
11;2021-04-22;72;67;139;261425;162933;89;424358
11;2021-04-22;50;9;59;89253;32619;90;121872
11;2021-04-22;4455;4167;8713;6362140;5916070;0;12278210
24;2021-04-22;24;24;49;139720;144686;09;284406
24;2021-04-22;88;101;191;152979;161185;19;314164
24;2021-04-22;102;104;206;122237;126536;29;248773
24;2021-04-22;98;73;171;150359;142009;39;292368
24;2021-04-22;94;99;193;161829;158758;49;320587
24;2021-04-22;81;67;148;172552;168011;59;340563
24;2021-04-22;56;54;111;172509;158177;69;330686
24;2021-04-22;21;26;47;129428;110593;79;240021
24;2021-04-22;27;10;37;87342;56882;89;144224
24;2021-04-22;16;7;23;31210;12071;90;43281
24;2021-04-22;607;565;1176;1320165;1238908;0;2559073
27;2021-04-22;29;31;60;143373;149679;09;293052
27;2021-04-22;89;76;166;160962;173003;19;333965
27;2021-04-22;90;103;195;133746;142254;29;276000
27;2021-04-22;87;86;173;160004;155407;39;315411
27;2021-04-22;81;86;167;172333;169564;49;341897
27;2021-04-22;74;73;147;189979;183788;59;373767
27;2021-04-22;64;67;131;192591;178206;69;370797
27;2021-04-22;26;45;71;146876;127546;79;274422
27;2021-04-22;18;12;30;96896;61575;89;158471
27;2021-04-22;15;8;23;33148;12109;90;45257
27;2021-04-22;573;587;1163;1429908;1353131;0;2783039
28;2021-04-22;41;30;73;180735;186856;09;367591
28;2021-04-22;107;129;241;200125;213621;19;413746
28;2021-04-22;133;123;257;168922;173007;29;341929
28;2021-04-22;122;110;233;196628;188487;39;385115
28;2021-04-22;139;127;267;205396;201699;49;407095
28;2021-04-22;115;124;239;222002;213866;59;435868
28;2021-04-22;67;74;141;224688;203758;69;428446
28;2021-04-22;45;37;82;163192;135543;79;298735
28;2021-04-22;41;20;61;109691;65377;89;175068
28;2021-04-22;28;13;41;37222;12685;90;49907
28;2021-04-22;838;787;1635;1708601;1594899;0;3303500
32;2021-04-22;94;89;184;358062;373689;09;731751
32;2021-04-22;240;237;479;387045;406742;19;793787
32;2021-04-22;306;281;593;342304;348587;29;690891
32;2021-04-22;262;244;508;382485;369972;39;752457
32;2021-04-22;257;250;507;382510;376716;49;759226
32;2021-04-22;226;243;470;386937;376527;59;763464
32;2021-04-22;163;129;293;371211;330938;69;702149
32;2021-04-22;85;78;163;250542;201459;79;452001
32;2021-04-22;54;32;86;163399;89786;89;253185
32;2021-04-22;18;8;26;48384;15367;90;63751
32;2021-04-22;1705;1591;3309;3072879;2889783;0;5962662
44;2021-04-22;74;65;139;291525;306839;09;598364
44;2021-04-22;158;173;332;320255;339504;19;659759
44;2021-04-22;213;193;407;302020;314428;29;616448
44;2021-04-22;166;163;330;342222;333292;39;675514
44;2021-04-22;165;150;316;349727;344491;49;694218
44;2021-04-22;144;149;293;381371;373239;59;754610
44;2021-04-22;95;92;188;367165;335850;69;703015
44;2021-04-22;47;49;96;250387;215436;79;465823
44;2021-04-22;36;18;54;170825;105192;89;276017
44;2021-04-22;20;5;25;51248;16731;90;67979
44;2021-04-22;1118;1058;2181;2826745;2685002;0;5511747
52;2021-04-22;41;51;94;213594;223900;09;437494
52;2021-04-22;133;134;271;240818;255197;19;496015
52;2021-04-22;135;135;270;197010;200630;29;397640
52;2021-04-22;123;101;224;231204;224885;39;456089
52;2021-04-22;129;130;259;243874;243418;49;487292
52;2021-04-22;104;115;219;244100;239116;59;483216
52;2021-04-22;73;71;144;241796;221345;69;463141
52;2021-04-22;36;29;65;177805;149903;79;327708
52;2021-04-22;29;20;49;119561;75822;89;195383
52;2021-04-22;16;6;22;42559;15260;90;57819
52;2021-04-22;820;792;1618;1952321;1849476;0;3801797
53;2021-04-22;24;29;55;173813;182358;09;356171
53;2021-04-22;90;69;162;202720;214740;19;417460
53;2021-04-22;91;83;175;163116;173196;29;336312
53;2021-04-22;76;66;142;190526;187674;39;378200
53;2021-04-22;82;66;148;212098;212015;49;424113
53;2021-04-22;62;64;126;223699;219176;59;442875
53;2021-04-22;34;39;73;227435;209274;69;436709
53;2021-04-22;20;20;40;169992;140910;79;310902
53;2021-04-22;14;10;24;118117;69883;89;188000
53;2021-04-22;11;4;15;37370;12267;90;49637
53;2021-04-22;504;450;961;1718886;1621493;0;3340379
75;2021-04-22;53;41;96;293104;305291;09;598395
75;2021-04-22;130;112;243;337141;357785;19;694926
75;2021-04-22;139;141;281;295024;300618;29;595642
75;2021-04-22;130;135;265;347871;331233;39;679104
75;2021-04-22;132;138;271;384742;372771;49;757513
75;2021-04-22;120;111;231;413361;390880;59;804241
75;2021-04-22;71;78;149;425623;384060;69;809683
75;2021-04-22;43;50;93;325086;276298;79;601384
75;2021-04-22;29;22;51;213986;139308;89;353294
75;2021-04-22;29;12;45;77600;28200;90;105800
75;2021-04-22;877;841;1728;3113538;2886444;0;5999982
76;2021-04-22;46;57;104;305956;318589;09;624545
76;2021-04-22;141;143;288;338942;356969;19;695911
76;2021-04-22;177;209;390;316210;319570;29;635780
76;2021-04-22;163;171;336;356758;337587;39;694345
76;2021-04-22;159;178;340;376541;363812;49;740353
76;2021-04-22;165;127;293;402608;383750;59;786358
76;2021-04-22;90;90;180;394889;358997;69;753886
76;2021-04-22;65;63;128;308664;263806;79;572470
76;2021-04-22;47;19;66;195838;129272;89;325110
76;2021-04-22;29;10;39;69372;26728;90;96100
76;2021-04-22;1086;1067;2168;3065778;2859080;0;5924858
84;2021-04-22;88;94;184;459549;481088;09;940637
84;2021-04-22;286;226;514;487711;511905;19;999616
84;2021-04-22;330;307;638;443824;451094;29;894918
84;2021-04-22;277;278;556;512522;493262;39;1005784
84;2021-04-22;313;259;572;520248;515106;49;1035354
84;2021-04-22;219;273;492;529611;514848;59;1044459
84;2021-04-22;151;142;293;486720;439940;69;926660
84;2021-04-22;82;73;155;372151;315211;79;687362
84;2021-04-22;56;48;104;237198;150524;89;387722
84;2021-04-22;26;8;34;81185;28680;90;109865
84;2021-04-22;1830;1708;3544;4130719;3901658;0;8032377
93;2021-04-22;67;49;117;268834;283093;09;551927
93;2021-04-22;182;191;375;280751;296087;19;576838
93;2021-04-22;242;262;505;254404;255552;29;509956
93;2021-04-22;266;202;469;310704;288398;39;599102
93;2021-04-22;220;194;414;325559;305827;49;631386
93;2021-04-22;203;201;406;353104;325389;59;678493
93;2021-04-22;130;103;233;336327;296459;69;632786
93;2021-04-22;77;57;134;279820;229699;79;509519
93;2021-04-22;42;31;73;171274;113716;89;284990
93;2021-04-22;25;4;29;58896;21758;90;80654
93;2021-04-22;1456;1296;2759;2639673;2415978;0;5055651
94;2021-04-22;4;5;9;16311;17433;09;33744
94;2021-04-22;3;5;8;16679;18132;19;34811
94;2021-04-22;7;4;11;16782;16579;29;33361
94;2021-04-22;4;3;7;23044;20580;39;43624
94;2021-04-22;3;3;6;23065;22140;49;45205
94;2021-04-22;4;5;9;24549;23421;59;47970
94;2021-04-22;6;7;13;23212;21883;69;45095
94;2021-04-22;2;2;4;19544;17141;79;36685
94;2021-04-22;0;0;0;11227;8178;89;19405
94;2021-04-22;2;1;3;3332;1447;90;4779
94;2021-04-22;35;35;70;177745;166934;0;344679
01;2021-04-23;0;0;0;19979;20155;09;40134
01;2021-04-23;5;10;15;24994;25489;19;50483
01;2021-04-23;14;8;22;17868;16690;29;34558
01;2021-04-23;13;4;17;22328;14821;39;37149
01;2021-04-23;11;8;19;28652;20276;49;48928
01;2021-04-23;15;12;27;33264;27260;59;60524
01;2021-04-23;10;11;21;27135;23978;69;51113
01;2021-04-23;4;1;5;18401;14661;79;33062
01;2021-04-23;0;0;0;9633;6375;89;16008
01;2021-04-23;0;0;0;3410;1510;90;4920
01;2021-04-23;72;54;126;205664;171215;0;376879
02;2021-04-23;5;0;5;16881;17110;09;33991
02;2021-04-23;3;4;7;21410;21604;19;43014
02;2021-04-23;9;6;15;16017;15479;29;31496
02;2021-04-23;4;7;11;19825;14455;39;34280
02;2021-04-23;6;13;19;24719;18248;49;42967
02;2021-04-23;15;11;26;34361;28310;59;62671
02;2021-04-23;11;8;19;28061;24495;69;52556
02;2021-04-23;2;3;5;18231;15278;79;33509
02;2021-04-23;2;2;4;11090;7677;89;18767
02;2021-04-23;0;0;0;3992;1506;90;5498
02;2021-04-23;57;54;111;194587;164162;0;358749
03;2021-04-23;0;3;3;31123;30920;09;62043
03;2021-04-23;7;6;13;29370;29268;19;58638
03;2021-04-23;9;7;16;21458;18963;29;40421
03;2021-04-23;14;6;20;21276;18326;39;39602
03;2021-04-23;7;10;17;18164;16593;49;34757
03;2021-04-23;10;1;11;13469;13557;59;27026
03;2021-04-23;2;6;8;8776;8670;69;17446
03;2021-04-23;2;3;5;3777;3591;79;7368
03;2021-04-23;2;0;2;1649;1072;89;2721
03;2021-04-23;0;0;0;485;184;90;669
03;2021-04-23;53;42;95;149547;141144;0;290691
04;2021-04-23;6;16;22;60314;61377;09;121691
04;2021-04-23;26;19;45;66065;68387;19;134452
04;2021-04-23;12;13;25;51059;47156;29;98215
04;2021-04-23;18;13;31;58788;45780;39;104568
04;2021-04-23;7;9;16;61408;52207;49;113615
04;2021-04-23;9;15;24;64838;60759;59;125597
04;2021-04-23;7;8;15;47008;42843;69;89851
04;2021-04-23;3;0;3;25509;21184;79;46693
04;2021-04-23;2;1;3;13168;7647;89;20815
04;2021-04-23;0;1;1;3209;1253;90;4462
04;2021-04-23;90;95;185;451366;408593;0;859959
05;2021-04-23;0;0;0;362.366008612902;341.338819562748;09;703.704828175651
05;2021-04-23;0;0;0;353.376145114279;370.349735405642;19;723.725880519921
05;2021-04-23;0;0;0;218.593559489256;256.539602589476;29;475.133162078732
05;2021-04-23;0;0;0;404.225408693299;360.321910454353;39;764.547319147651
05;2021-04-23;0;0;0;520.067953604221;497.108383964256;49;1017.17633756848
05;2021-04-23;0;0;0;468.146063921917;510.087601910415;59;978.233665832332
05;2021-04-23;0;0;0;340.368470050554;334.366842191253;69;674.735312241807
05;2021-04-23;0;0;0;212.598666888387;192.597753227106;79;405.196420115493
05;2021-04-23;0;0;0;148.727797095705;61.8681715431829;89;210.595968638888
05;2021-04-23;0;0;0;32.9601271090696;10.9909785719784;90;43.9511056810479
05;2021-04-23;0;0;0;3061.43020057959;2935.56979942041;0;5997
06;2021-04-23;2;0;2;42583;42380;09;84963
06;2021-04-23;5;1;7;33369;31925;19;65294
06;2021-04-23;1;4;5;21571;15080;29;36651
06;2021-04-23;0;5;5;21550;16147;39;37697
06;2021-04-23;3;1;4;14193;13939;49;28132
06;2021-04-23;1;0;1;7171;7597;59;14768
06;2021-04-23;1;1;2;3629;4117;69;7746
06;2021-04-23;0;0;0;1577;1457;79;3034
06;2021-04-23;0;0;0;531;474;89;1005
06;2021-04-23;0;0;0;88;93;90;181
06;2021-04-23;13;12;26;146262;133209;0;279471
07;2021-04-23;0;0;0;485;549;09;1034
07;2021-04-23;0;0;0;403;432;19;835
07;2021-04-23;1;0;1;764;841;29;1605
07;2021-04-23;0;0;0;824;928;39;1752
07;2021-04-23;1;0;1;788;1020;49;1808
07;2021-04-23;0;1;1;678;870;59;1548
07;2021-04-23;0;0;0;360;382;69;742
07;2021-04-23;0;0;0;231;190;79;421
07;2021-04-23;0;0;0;114;67;89;181
07;2021-04-23;0;0;0;24;11;90;35
07;2021-04-23;2;1;3;4671;5290;0;9961
08;2021-04-23;0;0;0;2715.22592983026;2997.75551488675;09;5712.98144471701
08;2021-04-23;0;0;0;2778.51901080978;3160.9156459093;19;5939.43465671908
08;2021-04-23;1;0;1;2080.8882988764;1718.16634315323;29;3799.05464202964
08;2021-04-23;1;1;2;2701.8582062647;1896.52641413317;39;4598.38462039786
08;2021-04-23;0;0;0;3151.45861023308;2460.52498233809;49;5611.98359257117
08;2021-04-23;0;0;0;2620.29868333099;2422.23566154656;59;5042.53434487755
08;2021-04-23;0;0;0;1621.44173420671;1438.58325779464;69;3060.02499200135
08;2021-04-23;0;0;0;626.575909335673;526.358467843651;79;1152.93437717932
08;2021-04-23;0;0;0;205.018522985054;140.993639349697;89;346.012162334751
08;2021-04-23;0;0;0;50.0325684687745;20.62259870351;90;70.6551671722846
08;2021-04-23;2;1;3;18551.3174743414;16782.6825256586;0;35334
11;2021-04-23;221;201;449;783071;811785;09;1594856
11;2021-04-23;512;502;1038;761456;784653;19;1546109
11;2021-04-23;995;900;1909;850145;801772;29;1651917
11;2021-04-23;786;762;1559;914360;843488;39;1757848
11;2021-04-23;690;610;1305;845609;826202;49;1671811
11;2021-04-23;630;578;1215;793566;745070;59;1538636
11;2021-04-23;353;327;684;628649;549192;69;1177841
11;2021-04-23;136;162;298;434606;358356;79;792962
11;2021-04-23;73;42;115;261425;162933;89;424358
11;2021-04-23;49;12;62;89253;32619;90;121872
11;2021-04-23;4447;4099;8644;6362140;5916070;0;12278210
24;2021-04-23;18;25;44;139720;144686;09;284406
24;2021-04-23;83;89;177;152979;161185;19;314164
24;2021-04-23;100;96;196;122237;126536;29;248773
24;2021-04-23;86;74;160;150359;142009;39;292368
24;2021-04-23;99;63;162;161829;158758;49;320587
24;2021-04-23;101;72;173;172552;168011;59;340563
24;2021-04-23;47;52;99;172509;158177;69;330686
24;2021-04-23;29;36;65;129428;110593;79;240021
24;2021-04-23;18;19;37;87342;56882;89;144224
24;2021-04-23;9;8;17;31210;12071;90;43281
24;2021-04-23;590;535;1131;1320165;1238908;0;2559073
27;2021-04-23;32;40;73;143373;149679;09;293052
27;2021-04-23;84;74;158;160962;173003;19;333965
27;2021-04-23;106;88;195;133746;142254;29;276000
27;2021-04-23;100;81;182;160004;155407;39;315411
27;2021-04-23;76;84;160;172333;169564;49;341897
27;2021-04-23;90;111;201;189979;183788;59;373767
27;2021-04-23;77;73;150;192591;178206;69;370797
27;2021-04-23;48;21;69;146876;127546;79;274422
27;2021-04-23;24;22;46;96896;61575;89;158471
27;2021-04-23;17;2;19;33148;12109;90;45257
27;2021-04-23;654;596;1253;1429908;1353131;0;2783039
28;2021-04-23;44;55;100;180735;186856;09;367591
28;2021-04-23;138;126;267;200125;213621;19;413746
28;2021-04-23;122;114;238;168922;173007;29;341929
28;2021-04-23;124;96;220;196628;188487;39;385115
28;2021-04-23;131;115;247;205396;201699;49;407095
28;2021-04-23;97;120;219;222002;213866;59;435868
28;2021-04-23;86;63;149;224688;203758;69;428446
28;2021-04-23;50;50;100;163192;135543;79;298735
28;2021-04-23;21;14;35;109691;65377;89;175068
28;2021-04-23;20;5;25;37222;12685;90;49907
28;2021-04-23;833;758;1601;1708601;1594899;0;3303500
32;2021-04-23;103;120;225;358062;373689;09;731751
32;2021-04-23;238;256;495;387045;406742;19;793787
32;2021-04-23;310;264;580;342304;348587;29;690891
32;2021-04-23;275;250;529;382485;369972;39;752457
32;2021-04-23;253;251;508;382510;376716;49;759226
32;2021-04-23;219;201;422;386937;376527;59;763464
32;2021-04-23;173;128;303;371211;330938;69;702149
32;2021-04-23;84;64;149;250542;201459;79;452001
32;2021-04-23;60;32;92;163399;89786;89;253185
32;2021-04-23;11;5;16;48384;15367;90;63751
32;2021-04-23;1726;1571;3319;3072879;2889783;0;5962662
44;2021-04-23;65;71;139;291525;306839;09;598364
44;2021-04-23;140;170;316;320255;339504;19;659759
44;2021-04-23;163;180;345;302020;314428;29;616448
44;2021-04-23;174;171;348;342222;333292;39;675514
44;2021-04-23;178;167;345;349727;344491;49;694218
44;2021-04-23;172;151;324;381371;373239;59;754610
44;2021-04-23;97;88;186;367165;335850;69;703015
44;2021-04-23;53;56;109;250387;215436;79;465823
44;2021-04-23;43;25;69;170825;105192;89;276017
44;2021-04-23;21;6;27;51248;16731;90;67979
44;2021-04-23;1106;1085;2210;2826745;2685002;0;5511747
52;2021-04-23;57;46;103;213594;223900;09;437494
52;2021-04-23;136;124;265;240818;255197;19;496015
52;2021-04-23;119;144;263;197010;200630;29;397640
52;2021-04-23;110;100;212;231204;224885;39;456089
52;2021-04-23;97;121;218;243874;243418;49;487292
52;2021-04-23;107;95;202;244100;239116;59;483216
52;2021-04-23;61;67;128;241796;221345;69;463141
52;2021-04-23;31;29;60;177805;149903;79;327708
52;2021-04-23;23;20;43;119561;75822;89;195383
52;2021-04-23;20;12;32;42559;15260;90;57819
52;2021-04-23;761;758;1526;1952321;1849476;0;3801797
53;2021-04-23;26;40;67;173813;182358;09;356171
53;2021-04-23;76;68;144;202720;214740;19;417460
53;2021-04-23;89;99;190;163116;173196;29;336312
53;2021-04-23;83;76;159;190526;187674;39;378200
53;2021-04-23;66;63;129;212098;212015;49;424113
53;2021-04-23;67;69;136;223699;219176;59;442875
53;2021-04-23;32;36;68;227435;209274;69;436709
53;2021-04-23;23;23;46;169992;140910;79;310902
53;2021-04-23;10;11;21;118117;69883;89;188000
53;2021-04-23;3;2;5;37370;12267;90;49637
53;2021-04-23;475;487;965;1718886;1621493;0;3340379
75;2021-04-23;55;38;94;293104;305291;09;598395
75;2021-04-23;133;125;261;337141;357785;19;694926
75;2021-04-23;117;158;278;295024;300618;29;595642
75;2021-04-23;145;105;250;347871;331233;39;679104
75;2021-04-23;155;106;262;384742;372771;49;757513
75;2021-04-23;129;127;257;413361;390880;59;804241
75;2021-04-23;98;71;170;425623;384060;69;809683
75;2021-04-23;37;43;80;325086;276298;79;601384
75;2021-04-23;39;24;63;213986;139308;89;353294
75;2021-04-23;30;12;42;77600;28200;90;105800
75;2021-04-23;940;810;1760;3113538;2886444;0;5999982
76;2021-04-23;58;67;127;305956;318589;09;624545
76;2021-04-23;179;191;375;338942;356969;19;695911
76;2021-04-23;200;214;416;316210;319570;29;635780
76;2021-04-23;201;170;371;356758;337587;39;694345
76;2021-04-23;183;170;354;376541;363812;49;740353
76;2021-04-23;158;154;313;402608;383750;59;786358
76;2021-04-23;97;109;208;394889;358997;69;753886
76;2021-04-23;53;51;104;308664;263806;79;572470
76;2021-04-23;46;26;73;195838;129272;89;325110
76;2021-04-23;19;5;24;69372;26728;90;96100
76;2021-04-23;1195;1159;2368;3065778;2859080;0;5924858
84;2021-04-23;116;133;251;459549;481088;09;940637
84;2021-04-23;280;305;587;487711;511905;19;999616
84;2021-04-23;380;359;741;443824;451094;29;894918
84;2021-04-23;319;286;607;512522;493262;39;1005784
84;2021-04-23;290;316;607;520248;515106;49;1035354
84;2021-04-23;266;278;544;529611;514848;59;1044459
84;2021-04-23;201;188;389;486720;439940;69;926660
84;2021-04-23;115;92;207;372151;315211;79;687362
84;2021-04-23;59;42;101;237198;150524;89;387722
84;2021-04-23;29;8;37;81185;28680;90;109865
84;2021-04-23;2055;2007;4071;4130719;3901658;0;8032377
93;2021-04-23;57;58;115;268834;283093;09;551927
93;2021-04-23;147;181;329;280751;296087;19;576838
93;2021-04-23;222;218;442;254404;255552;29;509956
93;2021-04-23;276;204;480;310704;288398;39;599102
93;2021-04-23;235;205;440;325559;305827;49;631386
93;2021-04-23;207;216;425;353104;325389;59;678493
93;2021-04-23;135;115;251;336327;296459;69;632786
93;2021-04-23;70;66;136;279820;229699;79;509519
93;2021-04-23;40;28;68;171274;113716;89;284990
93;2021-04-23;19;8;27;58896;21758;90;80654
93;2021-04-23;1408;1299;2713;2639673;2415978;0;5055651
94;2021-04-23;2;4;6;16311;17433;09;33744
94;2021-04-23;8;9;17;16679;18132;19;34811
94;2021-04-23;7;8;15;16782;16579;29;33361
94;2021-04-23;10;9;19;23044;20580;39;43624
94;2021-04-23;4;6;10;23065;22140;49;45205
94;2021-04-23;3;2;5;24549;23421;59;47970
94;2021-04-23;3;1;4;23212;21883;69;45095
94;2021-04-23;1;1;2;19544;17141;79;36685
94;2021-04-23;2;1;3;11227;8178;89;19405
94;2021-04-23;2;1;3;3332;1447;90;4779
94;2021-04-23;42;42;84;177745;166934;0;344679
01;2021-04-24;0;1;1;19979;20155;09;40134
01;2021-04-24;4;1;5;24994;25489;19;50483
01;2021-04-24;1;2;3;17868;16690;29;34558
01;2021-04-24;5;4;9;22328;14821;39;37149
01;2021-04-24;4;3;7;28652;20276;49;48928
01;2021-04-24;2;6;8;33264;27260;59;60524
01;2021-04-24;1;4;5;27135;23978;69;51113
01;2021-04-24;4;3;7;18401;14661;79;33062
01;2021-04-24;3;1;4;9633;6375;89;16008
01;2021-04-24;0;1;1;3410;1510;90;4920
01;2021-04-24;24;26;50;205664;171215;0;376879
02;2021-04-24;0;0;0;16881;17110;09;33991
02;2021-04-24;1;1;2;21410;21604;19;43014
02;2021-04-24;2;3;5;16017;15479;29;31496
02;2021-04-24;3;0;3;19825;14455;39;34280
02;2021-04-24;1;0;1;24719;18248;49;42967
02;2021-04-24;2;2;4;34361;28310;59;62671
02;2021-04-24;3;2;5;28061;24495;69;52556
02;2021-04-24;1;1;2;18231;15278;79;33509
02;2021-04-24;2;1;3;11090;7677;89;18767
02;2021-04-24;1;0;1;3992;1506;90;5498
02;2021-04-24;16;10;26;194587;164162;0;358749
03;2021-04-24;1;0;1;31123;30920;09;62043
03;2021-04-24;2;2;4;29370;29268;19;58638
03;2021-04-24;4;1;5;21458;18963;29;40421
03;2021-04-24;5;6;11;21276;18326;39;39602
03;2021-04-24;6;5;11;18164;16593;49;34757
03;2021-04-24;3;5;8;13469;13557;59;27026
03;2021-04-24;3;2;5;8776;8670;69;17446
03;2021-04-24;2;2;4;3777;3591;79;7368
03;2021-04-24;0;0;0;1649;1072;89;2721
03;2021-04-24;0;0;0;485;184;90;669
03;2021-04-24;26;23;49;149547;141144;0;290691
04;2021-04-24;5;6;11;60314;61377;09;121691
04;2021-04-24;9;11;20;66065;68387;19;134452
04;2021-04-24;11;7;18;51059;47156;29;98215
04;2021-04-24;7;5;12;58788;45780;39;104568
04;2021-04-24;10;4;14;61408;52207;49;113615
04;2021-04-24;8;5;13;64838;60759;59;125597
04;2021-04-24;2;2;4;47008;42843;69;89851
04;2021-04-24;1;3;4;25509;21184;79;46693
04;2021-04-24;1;0;1;13168;7647;89;20815
04;2021-04-24;0;0;0;3209;1253;90;4462
04;2021-04-24;54;43;97;451366;408593;0;859959
05;2021-04-24;0;0;0;362.366008612902;341.338819562748;09;703.704828175651
05;2021-04-24;0;0;0;353.376145114279;370.349735405642;19;723.725880519921
05;2021-04-24;0;0;0;218.593559489256;256.539602589476;29;475.133162078732
05;2021-04-24;0;0;0;404.225408693299;360.321910454353;39;764.547319147651
05;2021-04-24;0;0;0;520.067953604221;497.108383964256;49;1017.17633756848
05;2021-04-24;0;0;0;468.146063921917;510.087601910415;59;978.233665832332
05;2021-04-24;0;0;0;340.368470050554;334.366842191253;69;674.735312241807
05;2021-04-24;0;0;0;212.598666888387;192.597753227106;79;405.196420115493
05;2021-04-24;0;0;0;148.727797095705;61.8681715431829;89;210.595968638888
05;2021-04-24;0;0;0;32.9601271090696;10.9909785719784;90;43.9511056810479
05;2021-04-24;0;0;0;3061.43020057959;2935.56979942041;0;5997
06;2021-04-24;0;0;0;42583;42380;09;84963
06;2021-04-24;0;0;0;33369;31925;19;65294
06;2021-04-24;3;2;5;21571;15080;29;36651
06;2021-04-24;0;2;2;21550;16147;39;37697
06;2021-04-24;1;0;1;14193;13939;49;28132
06;2021-04-24;1;0;1;7171;7597;59;14768
06;2021-04-24;0;0;0;3629;4117;69;7746
06;2021-04-24;0;0;0;1577;1457;79;3034
06;2021-04-24;0;1;1;531;474;89;1005
06;2021-04-24;0;0;0;88;93;90;181
06;2021-04-24;5;5;10;146262;133209;0;279471
07;2021-04-24;0;0;0;485;549;09;1034
07;2021-04-24;0;0;0;403;432;19;835
07;2021-04-24;0;0;0;764;841;29;1605
07;2021-04-24;0;0;0;824;928;39;1752
07;2021-04-24;0;0;0;788;1020;49;1808
07;2021-04-24;0;0;0;678;870;59;1548
07;2021-04-24;0;0;0;360;382;69;742
07;2021-04-24;0;0;0;231;190;79;421
07;2021-04-24;0;0;0;114;67;89;181
07;2021-04-24;0;0;0;24;11;90;35
07;2021-04-24;0;0;0;4671;5290;0;9961
08;2021-04-24;0;0;0;2715.22592983026;2997.75551488675;09;5712.98144471701
08;2021-04-24;0;0;0;2778.51901080978;3160.9156459093;19;5939.43465671908
08;2021-04-24;0;0;0;2080.8882988764;1718.16634315323;29;3799.05464202964
08;2021-04-24;0;0;0;2701.8582062647;1896.52641413317;39;4598.38462039786
08;2021-04-24;0;0;0;3151.45861023308;2460.52498233809;49;5611.98359257117
08;2021-04-24;0;0;0;2620.29868333099;2422.23566154656;59;5042.53434487755
08;2021-04-24;0;0;0;1621.44173420671;1438.58325779464;69;3060.02499200135
08;2021-04-24;0;0;0;626.575909335673;526.358467843651;79;1152.93437717932
08;2021-04-24;0;0;0;205.018522985054;140.993639349697;89;346.012162334751
08;2021-04-24;0;0;0;50.0325684687745;20.62259870351;90;70.6551671722846
08;2021-04-24;0;0;0;18551.3174743414;16782.6825256586;0;35334
11;2021-04-24;173;154;350;783071;811785;09;1594856
11;2021-04-24;366;320;710;761456;784653;19;1546109
11;2021-04-24;540;544;1089;850145;801772;29;1651917
11;2021-04-24;578;531;1121;914360;843488;39;1757848
11;2021-04-24;465;447;914;845609;826202;49;1671811
11;2021-04-24;384;370;755;793566;745070;59;1538636
11;2021-04-24;199;223;423;628649;549192;69;1177841
11;2021-04-24;100;97;197;434606;358356;79;792962
11;2021-04-24;37;28;65;261425;162933;89;424358
11;2021-04-24;22;8;30;89253;32619;90;121872
11;2021-04-24;2866;2725;5660;6362140;5916070;0;12278210
24;2021-04-24;8;14;23;139720;144686;09;284406
24;2021-04-24;46;47;96;152979;161185;19;314164
24;2021-04-24;52;53;107;122237;126536;29;248773
24;2021-04-24;58;47;105;150359;142009;39;292368
24;2021-04-24;50;56;108;161829;158758;49;320587
24;2021-04-24;49;51;100;172552;168011;59;340563
24;2021-04-24;22;30;52;172509;158177;69;330686
24;2021-04-24;18;13;31;129428;110593;79;240021
24;2021-04-24;7;11;18;87342;56882;89;144224
24;2021-04-24;5;1;6;31210;12071;90;43281
24;2021-04-24;315;323;646;1320165;1238908;0;2559073
27;2021-04-24;24;24;48;143373;149679;09;293052
27;2021-04-24;54;44;100;160962;173003;19;333965
27;2021-04-24;83;67;150;133746;142254;29;276000
27;2021-04-24;62;60;122;160004;155407;39;315411
27;2021-04-24;54;56;110;172333;169564;49;341897
27;2021-04-24;63;68;131;189979;183788;59;373767
27;2021-04-24;39;35;74;192591;178206;69;370797
27;2021-04-24;17;23;40;146876;127546;79;274422
27;2021-04-24;19;4;23;96896;61575;89;158471
27;2021-04-24;2;2;4;33148;12109;90;45257
27;2021-04-24;417;383;802;1429908;1353131;0;2783039
28;2021-04-24;22;31;56;180735;186856;09;367591
28;2021-04-24;82;58;142;200125;213621;19;413746
28;2021-04-24;66;67;134;168922;173007;29;341929
28;2021-04-24;61;56;117;196628;188487;39;385115
28;2021-04-24;73;50;123;205396;201699;49;407095
28;2021-04-24;69;63;132;222002;213866;59;435868
28;2021-04-24;43;54;98;224688;203758;69;428446
28;2021-04-24;28;22;51;163192;135543;79;298735
28;2021-04-24;11;7;18;109691;65377;89;175068
28;2021-04-24;5;3;8;37222;12685;90;49907
28;2021-04-24;460;411;879;1708601;1594899;0;3303500
32;2021-04-24;88;81;169;358062;373689;09;731751
32;2021-04-24;168;166;336;387045;406742;19;793787
32;2021-04-24;189;203;394;342304;348587;29;690891
32;2021-04-24;158;175;336;382485;369972;39;752457
32;2021-04-24;180;202;384;382510;376716;49;759226
32;2021-04-24;138;136;275;386937;376527;59;763464
32;2021-04-24;115;89;205;371211;330938;69;702149
32;2021-04-24;57;51;108;250542;201459;79;452001
32;2021-04-24;29;14;43;163399;89786;89;253185
32;2021-04-24;12;6;18;48384;15367;90;63751
32;2021-04-24;1135;1123;2269;3072879;2889783;0;5962662
44;2021-04-24;31;42;73;291525;306839;09;598364
44;2021-04-24;104;90;194;320255;339504;19;659759
44;2021-04-24;152;115;267;302020;314428;29;616448
44;2021-04-24;120;117;239;342222;333292;39;675514
44;2021-04-24;108;101;209;349727;344491;49;694218
44;2021-04-24;96;111;207;381371;373239;59;754610
44;2021-04-24;54;69;123;367165;335850;69;703015
44;2021-04-24;42;33;76;250387;215436;79;465823
44;2021-04-24;18;11;29;170825;105192;89;276017
44;2021-04-24;6;6;12;51248;16731;90;67979
44;2021-04-24;731;695;1429;2826745;2685002;0;5511747
52;2021-04-24;23;28;54;213594;223900;09;437494
52;2021-04-24;73;79;152;240818;255197;19;496015
52;2021-04-24;92;75;167;197010;200630;29;397640
52;2021-04-24;63;68;131;231204;224885;39;456089
52;2021-04-24;71;68;139;243874;243418;49;487292
52;2021-04-24;75;86;162;244100;239116;59;483216
52;2021-04-24;39;52;91;241796;221345;69;463141
52;2021-04-24;21;35;56;177805;149903;79;327708
52;2021-04-24;13;9;22;119561;75822;89;195383
52;2021-04-24;7;2;9;42559;15260;90;57819
52;2021-04-24;477;502;983;1952321;1849476;0;3801797
53;2021-04-24;34;23;58;173813;182358;09;356171
53;2021-04-24;63;50;113;202720;214740;19;417460
53;2021-04-24;49;59;108;163116;173196;29;336312
53;2021-04-24;50;47;97;190526;187674;39;378200
53;2021-04-24;50;42;92;212098;212015;49;424113
53;2021-04-24;38;44;82;223699;219176;59;442875
53;2021-04-24;31;20;52;227435;209274;69;436709
53;2021-04-24;17;12;29;169992;140910;79;310902
53;2021-04-24;6;7;13;118117;69883;89;188000
53;2021-04-24;5;1;6;37370;12267;90;49637
53;2021-04-24;343;305;650;1718886;1621493;0;3340379
75;2021-04-24;21;37;58;293104;305291;09;598395
75;2021-04-24;74;64;139;337141;357785;19;694926
75;2021-04-24;80;81;161;295024;300618;29;595642
75;2021-04-24;86;87;173;347871;331233;39;679104
75;2021-04-24;99;87;187;384742;372771;49;757513
75;2021-04-24;86;72;158;413361;390880;59;804241
75;2021-04-24;56;37;93;425623;384060;69;809683
75;2021-04-24;22;24;46;325086;276298;79;601384
75;2021-04-24;15;16;31;213986;139308;89;353294
75;2021-04-24;11;4;15;77600;28200;90;105800
75;2021-04-24;550;509;1061;3113538;2886444;0;5999982
76;2021-04-24;38;29;70;305956;318589;09;624545
76;2021-04-24;90;90;183;338942;356969;19;695911
76;2021-04-24;104;94;199;316210;319570;29;635780
76;2021-04-24;101;94;195;356758;337587;39;694345
76;2021-04-24;83;90;173;376541;363812;49;740353
76;2021-04-24;79;76;157;402608;383750;59;786358
76;2021-04-24;62;45;107;394889;358997;69;753886
76;2021-04-24;26;20;46;308664;263806;79;572470
76;2021-04-24;15;14;29;195838;129272;89;325110
76;2021-04-24;6;7;13;69372;26728;90;96100
76;2021-04-24;605;559;1173;3065778;2859080;0;5924858
84;2021-04-24;76;66;142;459549;481088;09;940637
84;2021-04-24;179;149;330;487711;511905;19;999616
84;2021-04-24;205;191;396;443824;451094;29;894918
84;2021-04-24;179;178;357;512522;493262;39;1005784
84;2021-04-24;189;205;394;520248;515106;49;1035354
84;2021-04-24;175;144;320;529611;514848;59;1044459
84;2021-04-24;116;104;221;486720;439940;69;926660
84;2021-04-24;66;61;127;372151;315211;79;687362
84;2021-04-24;44;28;72;237198;150524;89;387722
84;2021-04-24;13;7;20;81185;28680;90;109865
84;2021-04-24;1242;1133;2380;4130719;3901658;0;8032377
93;2021-04-24;28;49;77;268834;283093;09;551927
93;2021-04-24;89;94;185;280751;296087;19;576838
93;2021-04-24;122;123;245;254404;255552;29;509956
93;2021-04-24;126;132;258;310704;288398;39;599102
93;2021-04-24;103;109;213;325559;305827;49;631386
93;2021-04-24;116;117;233;353104;325389;59;678493
93;2021-04-24;82;67;150;336327;296459;69;632786
93;2021-04-24;30;39;69;279820;229699;79;509519
93;2021-04-24;21;16;37;171274;113716;89;284990
93;2021-04-24;7;4;11;58896;21758;90;80654
93;2021-04-24;724;750;1478;2639673;2415978;0;5055651
94;2021-04-24;0;0;0;16311;17433;09;33744
94;2021-04-24;0;5;5;16679;18132;19;34811
94;2021-04-24;5;3;8;16782;16579;29;33361
94;2021-04-24;0;3;3;23044;20580;39;43624
94;2021-04-24;4;2;6;23065;22140;49;45205
94;2021-04-24;2;3;5;24549;23421;59;47970
94;2021-04-24;2;1;3;23212;21883;69;45095
94;2021-04-24;0;3;3;19544;17141;79;36685
94;2021-04-24;0;0;0;11227;8178;89;19405
94;2021-04-24;0;0;0;3332;1447;90;4779
94;2021-04-24;13;20;33;177745;166934;0;344679
01;2021-04-25;0;1;1;19979;20155;09;40134
01;2021-04-25;3;1;4;24994;25489;19;50483
01;2021-04-25;1;0;1;17868;16690;29;34558
01;2021-04-25;3;0;3;22328;14821;39;37149
01;2021-04-25;4;1;5;28652;20276;49;48928
01;2021-04-25;3;5;8;33264;27260;59;60524
01;2021-04-25;2;3;5;27135;23978;69;51113
01;2021-04-25;2;1;3;18401;14661;79;33062
01;2021-04-25;1;1;2;9633;6375;89;16008
01;2021-04-25;0;0;0;3410;1510;90;4920
01;2021-04-25;19;13;32;205664;171215;0;376879
02;2021-04-25;0;0;0;16881;17110;09;33991
02;2021-04-25;0;0;0;21410;21604;19;43014
02;2021-04-25;0;0;0;16017;15479;29;31496
02;2021-04-25;1;0;1;19825;14455;39;34280
02;2021-04-25;0;0;0;24719;18248;49;42967
02;2021-04-25;0;0;0;34361;28310;59;62671
02;2021-04-25;0;0;0;28061;24495;69;52556
02;2021-04-25;2;3;5;18231;15278;79;33509
02;2021-04-25;1;1;2;11090;7677;89;18767
02;2021-04-25;0;0;0;3992;1506;90;5498
02;2021-04-25;4;4;8;194587;164162;0;358749
03;2021-04-25;1;0;1;31123;30920;09;62043
03;2021-04-25;0;0;0;29370;29268;19;58638
03;2021-04-25;0;2;2;21458;18963;29;40421
03;2021-04-25;1;1;2;21276;18326;39;39602
03;2021-04-25;0;1;1;18164;16593;49;34757
03;2021-04-25;1;0;1;13469;13557;59;27026
03;2021-04-25;1;3;4;8776;8670;69;17446
03;2021-04-25;0;1;1;3777;3591;79;7368
03;2021-04-25;0;0;0;1649;1072;89;2721
03;2021-04-25;0;0;0;485;184;90;669
03;2021-04-25;4;8;12;149547;141144;0;290691
04;2021-04-25;0;0;0;60314;61377;09;121691
04;2021-04-25;6;1;7;66065;68387;19;134452
04;2021-04-25;2;5;7;51059;47156;29;98215
04;2021-04-25;6;3;9;58788;45780;39;104568
04;2021-04-25;5;10;15;61408;52207;49;113615
04;2021-04-25;5;1;6;64838;60759;59;125597
04;2021-04-25;4;2;6;47008;42843;69;89851
04;2021-04-25;0;2;2;25509;21184;79;46693
04;2021-04-25;1;0;1;13168;7647;89;20815
04;2021-04-25;0;0;0;3209;1253;90;4462
04;2021-04-25;29;24;53;451366;408593;0;859959
05;2021-04-25;0;0;0;362.366008612902;341.338819562748;09;703.704828175651
05;2021-04-25;0;0;0;353.376145114279;370.349735405642;19;723.725880519921
05;2021-04-25;0;0;0;218.593559489256;256.539602589476;29;475.133162078732
05;2021-04-25;0;0;0;404.225408693299;360.321910454353;39;764.547319147651
05;2021-04-25;0;0;0;520.067953604221;497.108383964256;49;1017.17633756848
05;2021-04-25;0;0;0;468.146063921917;510.087601910415;59;978.233665832332
05;2021-04-25;0;0;0;340.368470050554;334.366842191253;69;674.735312241807
05;2021-04-25;0;0;0;212.598666888387;192.597753227106;79;405.196420115493
05;2021-04-25;0;0;0;148.727797095705;61.8681715431829;89;210.595968638888
05;2021-04-25;0;0;0;32.9601271090696;10.9909785719784;90;43.9511056810479
05;2021-04-25;0;0;0;3061.43020057959;2935.56979942041;0;5997
06;2021-04-25;0;1;1;42583;42380;09;84963
06;2021-04-25;0;0;0;33369;31925;19;65294
06;2021-04-25;0;1;1;21571;15080;29;36651
06;2021-04-25;0;0;0;21550;16147;39;37697
06;2021-04-25;1;0;1;14193;13939;49;28132
06;2021-04-25;0;1;1;7171;7597;59;14768
06;2021-04-25;1;0;1;3629;4117;69;7746
06;2021-04-25;0;0;0;1577;1457;79;3034
06;2021-04-25;0;1;1;531;474;89;1005
06;2021-04-25;0;0;0;88;93;90;181
06;2021-04-25;2;4;6;146262;133209;0;279471
07;2021-04-25;0;0;0;485;549;09;1034
07;2021-04-25;0;0;0;403;432;19;835
07;2021-04-25;0;0;0;764;841;29;1605
07;2021-04-25;1;0;1;824;928;39;1752
07;2021-04-25;0;0;0;788;1020;49;1808
07;2021-04-25;0;0;0;678;870;59;1548
07;2021-04-25;0;0;0;360;382;69;742
07;2021-04-25;0;0;0;231;190;79;421
07;2021-04-25;0;0;0;114;67;89;181
07;2021-04-25;0;0;0;24;11;90;35
07;2021-04-25;1;0;1;4671;5290;0;9961
08;2021-04-25;0;0;0;2715.22592983026;2997.75551488675;09;5712.98144471701
08;2021-04-25;0;0;0;2778.51901080978;3160.9156459093;19;5939.43465671908
08;2021-04-25;1;0;1;2080.8882988764;1718.16634315323;29;3799.05464202964
08;2021-04-25;2;0;2;2701.8582062647;1896.52641413317;39;4598.38462039786
08;2021-04-25;0;0;0;3151.45861023308;2460.52498233809;49;5611.98359257117
08;2021-04-25;0;0;0;2620.29868333099;2422.23566154656;59;5042.53434487755
08;2021-04-25;0;0;0;1621.44173420671;1438.58325779464;69;3060.02499200135
08;2021-04-25;0;0;0;626.575909335673;526.358467843651;79;1152.93437717932
08;2021-04-25;0;0;0;205.018522985054;140.993639349697;89;346.012162334751
08;2021-04-25;0;0;0;50.0325684687745;20.62259870351;90;70.6551671722846
08;2021-04-25;3;0;3;18551.3174743414;16782.6825256586;0;35334
11;2021-04-25;42;41;84;783071;811785;09;1594856
11;2021-04-25;86;75;162;761456;784653;19;1546109
11;2021-04-25;138;100;239;850145;801772;29;1651917
11;2021-04-25;143;162;306;914360;843488;39;1757848
11;2021-04-25;94;106;201;845609;826202;49;1671811
11;2021-04-25;80;82;164;793566;745070;59;1538636
11;2021-04-25;48;53;103;628649;549192;69;1177841
11;2021-04-25;28;24;52;434606;358356;79;792962
11;2021-04-25;20;9;29;261425;162933;89;424358
11;2021-04-25;18;5;23;89253;32619;90;121872
11;2021-04-25;697;657;1363;6362140;5916070;0;12278210
24;2021-04-25;3;3;7;139720;144686;09;284406
24;2021-04-25;4;5;9;152979;161185;19;314164
24;2021-04-25;9;7;16;122237;126536;29;248773
24;2021-04-25;2;5;7;150359;142009;39;292368
24;2021-04-25;2;7;9;161829;158758;49;320587
24;2021-04-25;0;9;9;172552;168011;59;340563
24;2021-04-25;6;2;8;172509;158177;69;330686
24;2021-04-25;3;2;5;129428;110593;79;240021
24;2021-04-25;4;1;5;87342;56882;89;144224
24;2021-04-25;2;1;3;31210;12071;90;43281
24;2021-04-25;35;42;78;1320165;1238908;0;2559073
27;2021-04-25;4;1;5;143373;149679;09;293052
27;2021-04-25;3;4;7;160962;173003;19;333965
27;2021-04-25;8;9;17;133746;142254;29;276000
27;2021-04-25;8;7;15;160004;155407;39;315411
27;2021-04-25;6;10;16;172333;169564;49;341897
27;2021-04-25;5;7;12;189979;183788;59;373767
27;2021-04-25;10;3;13;192591;178206;69;370797
27;2021-04-25;3;6;9;146876;127546;79;274422
27;2021-04-25;6;4;10;96896;61575;89;158471
27;2021-04-25;3;1;4;33148;12109;90;45257
27;2021-04-25;56;52;108;1429908;1353131;0;2783039
28;2021-04-25;4;5;9;180735;186856;09;367591
28;2021-04-25;9;9;18;200125;213621;19;413746
28;2021-04-25;23;14;37;168922;173007;29;341929
28;2021-04-25;14;10;25;196628;188487;39;385115
28;2021-04-25;14;14;28;205396;201699;49;407095
28;2021-04-25;12;21;33;222002;213866;59;435868
28;2021-04-25;9;10;20;224688;203758;69;428446
28;2021-04-25;3;11;14;163192;135543;79;298735
28;2021-04-25;4;4;8;109691;65377;89;175068
28;2021-04-25;3;0;3;37222;12685;90;49907
28;2021-04-25;95;98;195;1708601;1594899;0;3303500
32;2021-04-25;23;14;37;358062;373689;09;731751
32;2021-04-25;25;30;55;387045;406742;19;793787
32;2021-04-25;42;28;72;342304;348587;29;690891
32;2021-04-25;43;31;75;382485;369972;39;752457
32;2021-04-25;33;43;78;382510;376716;49;759226
32;2021-04-25;19;24;43;386937;376527;59;763464
32;2021-04-25;18;15;33;371211;330938;69;702149
32;2021-04-25;10;13;23;250542;201459;79;452001
32;2021-04-25;14;14;28;163399;89786;89;253185
32;2021-04-25;0;1;1;48384;15367;90;63751
32;2021-04-25;227;213;445;3072879;2889783;0;5962662
44;2021-04-25;9;3;12;291525;306839;09;598364
44;2021-04-25;10;11;21;320255;339504;19;659759
44;2021-04-25;15;16;31;302020;314428;29;616448
44;2021-04-25;15;16;31;342222;333292;39;675514
44;2021-04-25;14;15;29;349727;344491;49;694218
44;2021-04-25;21;19;40;381371;373239;59;754610
44;2021-04-25;8;8;16;367165;335850;69;703015
44;2021-04-25;3;10;13;250387;215436;79;465823
44;2021-04-25;4;7;11;170825;105192;89;276017
44;2021-04-25;0;1;1;51248;16731;90;67979
44;2021-04-25;99;106;205;2826745;2685002;0;5511747
52;2021-04-25;7;11;20;213594;223900;09;437494
52;2021-04-25;15;19;34;240818;255197;19;496015
52;2021-04-25;18;18;36;197010;200630;29;397640
52;2021-04-25;15;25;40;231204;224885;39;456089
52;2021-04-25;21;22;43;243874;243418;49;487292
52;2021-04-25;20;15;35;244100;239116;59;483216
52;2021-04-25;7;9;16;241796;221345;69;463141
52;2021-04-25;2;12;14;177805;149903;79;327708
52;2021-04-25;3;4;7;119561;75822;89;195383
52;2021-04-25;2;3;5;42559;15260;90;57819
52;2021-04-25;110;138;250;1952321;1849476;0;3801797
53;2021-04-25;5;5;10;173813;182358;09;356171
53;2021-04-25;13;12;25;202720;214740;19;417460
53;2021-04-25;11;12;23;163116;173196;29;336312
53;2021-04-25;8;12;20;190526;187674;39;378200
53;2021-04-25;6;6;12;212098;212015;49;424113
53;2021-04-25;5;12;17;223699;219176;59;442875
53;2021-04-25;4;10;14;227435;209274;69;436709
53;2021-04-25;3;2;5;169992;140910;79;310902
53;2021-04-25;8;2;10;118117;69883;89;188000
53;2021-04-25;2;0;2;37370;12267;90;49637
53;2021-04-25;65;73;138;1718886;1621493;0;3340379
75;2021-04-25;0;4;4;293104;305291;09;598395
75;2021-04-25;3;5;8;337141;357785;19;694926
75;2021-04-25;9;5;14;295024;300618;29;595642
75;2021-04-25;8;15;24;347871;331233;39;679104
75;2021-04-25;14;13;27;384742;372771;49;757513
75;2021-04-25;11;10;21;413361;390880;59;804241
75;2021-04-25;9;7;16;425623;384060;69;809683
75;2021-04-25;2;3;5;325086;276298;79;601384
75;2021-04-25;8;2;10;213986;139308;89;353294
75;2021-04-25;8;2;11;77600;28200;90;105800
75;2021-04-25;72;66;140;3113538;2886444;0;5999982
76;2021-04-25;4;8;12;305956;318589;09;624545
76;2021-04-25;18;13;31;338942;356969;19;695911
76;2021-04-25;18;15;33;316210;319570;29;635780
76;2021-04-25;19;25;44;356758;337587;39;694345
76;2021-04-25;17;16;33;376541;363812;49;740353
76;2021-04-25;13;16;29;402608;383750;59;786358
76;2021-04-25;9;13;22;394889;358997;69;753886
76;2021-04-25;6;9;15;308664;263806;79;572470
76;2021-04-25;6;10;16;195838;129272;89;325110
76;2021-04-25;6;1;7;69372;26728;90;96100
76;2021-04-25;116;126;242;3065778;2859080;0;5924858
84;2021-04-25;12;9;21;459549;481088;09;940637
84;2021-04-25;9;15;24;487711;511905;19;999616
84;2021-04-25;30;27;57;443824;451094;29;894918
84;2021-04-25;35;33;68;512522;493262;39;1005784
84;2021-04-25;26;26;53;520248;515106;49;1035354
84;2021-04-25;18;27;45;529611;514848;59;1044459
84;2021-04-25;11;10;21;486720;439940;69;926660
84;2021-04-25;9;14;23;372151;315211;79;687362
84;2021-04-25;9;14;23;237198;150524;89;387722
84;2021-04-25;9;6;15;81185;28680;90;109865
84;2021-04-25;168;181;350;4130719;3901658;0;8032377
93;2021-04-25;19;10;29;268834;283093;09;551927
93;2021-04-25;27;14;41;280751;296087;19;576838
93;2021-04-25;35;32;68;254404;255552;29;509956
93;2021-04-25;48;42;90;310704;288398;39;599102
93;2021-04-25;33;28;61;325559;305827;49;631386
93;2021-04-25;27;39;66;353104;325389;59;678493
93;2021-04-25;15;15;30;336327;296459;69;632786
93;2021-04-25;11;10;21;279820;229699;79;509519
93;2021-04-25;12;10;22;171274;113716;89;284990
93;2021-04-25;3;6;9;58896;21758;90;80654
93;2021-04-25;230;206;437;2639673;2415978;0;5055651
94;2021-04-25;0;0;0;16311;17433;09;33744
94;2021-04-25;0;1;1;16679;18132;19;34811
94;2021-04-25;0;0;0;16782;16579;29;33361
94;2021-04-25;0;0;0;23044;20580;39;43624
94;2021-04-25;0;2;2;23065;22140;49;45205
94;2021-04-25;1;1;2;24549;23421;59;47970
94;2021-04-25;0;0;0;23212;21883;69;45095
94;2021-04-25;0;0;0;19544;17141;79;36685
94;2021-04-25;0;0;0;11227;8178;89;19405
94;2021-04-25;0;0;0;3332;1447;90;4779
94;2021-04-25;1;4;5;177745;166934;0;344679
01;2021-04-26;2;4;6;19979;20155;09;40134
01;2021-04-26;11;7;18;24994;25489;19;50483
01;2021-04-26;14;9;23;17868;16690;29;34558
01;2021-04-26;13;13;26;22328;14821;39;37149
01;2021-04-26;20;11;31;28652;20276;49;48928
01;2021-04-26;16;14;30;33264;27260;59;60524
01;2021-04-26;11;13;24;27135;23978;69;51113
01;2021-04-26;3;9;12;18401;14661;79;33062
01;2021-04-26;0;1;1;9633;6375;89;16008
01;2021-04-26;1;1;2;3410;1510;90;4920
01;2021-04-26;91;82;173;205664;171215;0;376879
02;2021-04-26;2;1;3;16881;17110;09;33991
02;2021-04-26;3;5;8;21410;21604;19;43014
02;2021-04-26;10;8;18;16017;15479;29;31496
02;2021-04-26;9;11;20;19825;14455;39;34280
02;2021-04-26;7;12;19;24719;18248;49;42967
02;2021-04-26;16;5;21;34361;28310;59;62671
02;2021-04-26;7;6;13;28061;24495;69;52556
02;2021-04-26;2;1;3;18231;15278;79;33509
02;2021-04-26;0;0;0;11090;7677;89;18767
02;2021-04-26;1;0;1;3992;1506;90;5498
02;2021-04-26;57;49;106;194587;164162;0;358749
03;2021-04-26;2;6;8;31123;30920;09;62043
03;2021-04-26;9;5;17;29370;29268;19;58638
03;2021-04-26;16;8;24;21458;18963;29;40421
03;2021-04-26;13;13;26;21276;18326;39;39602
03;2021-04-26;9;16;25;18164;16593;49;34757
03;2021-04-26;10;9;19;13469;13557;59;27026
03;2021-04-26;5;13;18;8776;8670;69;17446
03;2021-04-26;1;1;2;3777;3591;79;7368
03;2021-04-26;1;2;3;1649;1072;89;2721
03;2021-04-26;0;0;0;485;184;90;669
03;2021-04-26;66;73;142;149547;141144;0;290691
04;2021-04-26;11;4;15;60314;61377;09;121691
04;2021-04-26;20;34;54;66065;68387;19;134452
04;2021-04-26;20;18;38;51059;47156;29;98215
04;2021-04-26;28;15;43;58788;45780;39;104568
04;2021-04-26;16;13;29;61408;52207;49;113615
04;2021-04-26;18;13;31;64838;60759;59;125597
04;2021-04-26;6;18;24;47008;42843;69;89851
04;2021-04-26;6;1;7;25509;21184;79;46693
04;2021-04-26;2;3;5;13168;7647;89;20815
04;2021-04-26;0;1;1;3209;1253;90;4462
04;2021-04-26;127;120;247;451366;408593;0;859959
05;2021-04-26;0;0;0;362.366008612902;341.338819562748;09;703.704828175651
05;2021-04-26;0;0;0;353.376145114279;370.349735405642;19;723.725880519921
05;2021-04-26;0;0;0;218.593559489256;256.539602589476;29;475.133162078732
05;2021-04-26;0;0;0;404.225408693299;360.321910454353;39;764.547319147651
05;2021-04-26;0;0;0;520.067953604221;497.108383964256;49;1017.17633756848
05;2021-04-26;0;0;0;468.146063921917;510.087601910415;59;978.233665832332
05;2021-04-26;0;0;0;340.368470050554;334.366842191253;69;674.735312241807
05;2021-04-26;0;0;0;212.598666888387;192.597753227106;79;405.196420115493
05;2021-04-26;0;0;0;148.727797095705;61.8681715431829;89;210.595968638888
05;2021-04-26;0;0;0;32.9601271090696;10.9909785719784;90;43.9511056810479
05;2021-04-26;0;0;0;3061.43020057959;2935.56979942041;0;5997
06;2021-04-26;0;0;0;42583;42380;09;84963
06;2021-04-26;4;3;7;33369;31925;19;65294
06;2021-04-26;4;2;6;21571;15080;29;36651
06;2021-04-26;1;1;2;21550;16147;39;37697
06;2021-04-26;1;2;3;14193;13939;49;28132
06;2021-04-26;1;1;2;7171;7597;59;14768
06;2021-04-26;0;3;3;3629;4117;69;7746
06;2021-04-26;0;1;1;1577;1457;79;3034
06;2021-04-26;0;0;0;531;474;89;1005
06;2021-04-26;0;0;0;88;93;90;181
06;2021-04-26;11;13;24;146262;133209;0;279471
07;2021-04-26;0;0;0;485;549;09;1034
07;2021-04-26;0;0;0;403;432;19;835
07;2021-04-26;0;1;1;764;841;29;1605
07;2021-04-26;0;0;0;824;928;39;1752
07;2021-04-26;0;0;0;788;1020;49;1808
07;2021-04-26;0;0;0;678;870;59;1548
07;2021-04-26;0;0;0;360;382;69;742
07;2021-04-26;0;0;0;231;190;79;421
07;2021-04-26;0;0;0;114;67;89;181
07;2021-04-26;0;0;0;24;11;90;35
07;2021-04-26;0;1;1;4671;5290;0;9961
08;2021-04-26;0;0;0;2715.22592983026;2997.75551488675;09;5712.98144471701
08;2021-04-26;0;0;0;2778.51901080978;3160.9156459093;19;5939.43465671908
08;2021-04-26;0;0;0;2080.8882988764;1718.16634315323;29;3799.05464202964
08;2021-04-26;0;1;1;2701.8582062647;1896.52641413317;39;4598.38462039786
08;2021-04-26;0;0;0;3151.45861023308;2460.52498233809;49;5611.98359257117
08;2021-04-26;1;0;1;2620.29868333099;2422.23566154656;59;5042.53434487755
08;2021-04-26;0;0;0;1621.44173420671;1438.58325779464;69;3060.02499200135
08;2021-04-26;0;0;0;626.575909335673;526.358467843651;79;1152.93437717932
08;2021-04-26;0;0;0;205.018522985054;140.993639349697;89;346.012162334751
08;2021-04-26;0;0;0;50.0325684687745;20.62259870351;90;70.6551671722846
08;2021-04-26;1;1;2;18551.3174743414;16782.6825256586;0;35334
11;2021-04-26;256;304;592;783071;811785;09;1594856
11;2021-04-26;607;561;1205;761456;784653;19;1546109
11;2021-04-26;1072;997;2081;850145;801772;29;1651917
11;2021-04-26;1043;1036;2089;914360;843488;39;1757848
11;2021-04-26;858;844;1713;845609;826202;49;1671811
11;2021-04-26;736;763;1507;793566;745070;59;1538636
11;2021-04-26;406;358;766;628649;549192;69;1177841
11;2021-04-26;172;192;364;434606;358356;79;792962
11;2021-04-26;111;56;168;261425;162933;89;424358
11;2021-04-26;34;14;48;89253;32619;90;121872
11;2021-04-26;5298;5126;10538;6362140;5916070;0;12278210
24;2021-04-26;26;32;59;139720;144686;09;284406
24;2021-04-26;98;85;188;152979;161185;19;314164
24;2021-04-26;113;92;206;122237;126536;29;248773
24;2021-04-26;108;82;190;150359;142009;39;292368
24;2021-04-26;87;87;174;161829;158758;49;320587
24;2021-04-26;99;113;212;172552;168011;59;340563
24;2021-04-26;66;69;136;172509;158177;69;330686
24;2021-04-26;34;38;72;129428;110593;79;240021
24;2021-04-26;32;15;47;87342;56882;89;144224
24;2021-04-26;14;7;21;31210;12071;90;43281
24;2021-04-26;677;620;1305;1320165;1238908;0;2559073
27;2021-04-26;28;45;73;143373;149679;09;293052
27;2021-04-26;99;87;187;160962;173003;19;333965
27;2021-04-26;102;123;225;133746;142254;29;276000
27;2021-04-26;107;98;205;160004;155407;39;315411
27;2021-04-26;124;107;231;172333;169564;49;341897
27;2021-04-26;113;109;222;189979;183788;59;373767
27;2021-04-26;77;69;146;192591;178206;69;370797
27;2021-04-26;38;37;75;146876;127546;79;274422
27;2021-04-26;28;21;49;96896;61575;89;158471
27;2021-04-26;24;6;30;33148;12109;90;45257
27;2021-04-26;740;702;1443;1429908;1353131;0;2783039
28;2021-04-26;46;56;107;180735;186856;09;367591
28;2021-04-26;143;125;272;200125;213621;19;413746
28;2021-04-26;151;177;331;168922;173007;29;341929
28;2021-04-26;145;143;289;196628;188487;39;385115
28;2021-04-26;142;138;281;205396;201699;49;407095
28;2021-04-26;135;110;245;222002;213866;59;435868
28;2021-04-26;92;83;176;224688;203758;69;428446
28;2021-04-26;43;49;93;163192;135543;79;298735
28;2021-04-26;31;14;45;109691;65377;89;175068
28;2021-04-26;23;11;34;37222;12685;90;49907
28;2021-04-26;951;906;1873;1708601;1594899;0;3303500
32;2021-04-26;126;127;254;358062;373689;09;731751
32;2021-04-26;306;294;603;387045;406742;19;793787
32;2021-04-26;347;394;747;342304;348587;29;690891
32;2021-04-26;328;290;620;382485;369972;39;752457
32;2021-04-26;329;336;670;382510;376716;49;759226
32;2021-04-26;279;284;569;386937;376527;59;763464
32;2021-04-26;190;158;348;371211;330938;69;702149
32;2021-04-26;89;93;182;250542;201459;79;452001
32;2021-04-26;63;25;88;163399;89786;89;253185
32;2021-04-26;34;10;44;48384;15367;90;63751
32;2021-04-26;2091;2013;4128;3072879;2889783;0;5962662
44;2021-04-26;96;82;180;291525;306839;09;598364
44;2021-04-26;216;176;399;320255;339504;19;659759
44;2021-04-26;266;271;538;302020;314428;29;616448
44;2021-04-26;243;197;441;342222;333292;39;675514
44;2021-04-26;223;206;430;349727;344491;49;694218
44;2021-04-26;214;207;423;381371;373239;59;754610
44;2021-04-26;119;142;261;367165;335850;69;703015
44;2021-04-26;60;67;128;250387;215436;79;465823
44;2021-04-26;56;36;93;170825;105192;89;276017
44;2021-04-26;18;14;32;51248;16731;90;67979
44;2021-04-26;1511;1398;2925;2826745;2685002;0;5511747
52;2021-04-26;39;42;84;213594;223900;09;437494
52;2021-04-26;107;128;238;240818;255197;19;496015
52;2021-04-26;131;160;291;197010;200630;29;397640
52;2021-04-26;123;142;265;231204;224885;39;456089
52;2021-04-26;144;127;272;243874;243418;49;487292
52;2021-04-26;117;145;262;244100;239116;59;483216
52;2021-04-26;73;74;147;241796;221345;69;463141
52;2021-04-26;34;31;65;177805;149903;79;327708
52;2021-04-26;33;15;48;119561;75822;89;195383
52;2021-04-26;13;4;17;42559;15260;90;57819
52;2021-04-26;814;868;1689;1952321;1849476;0;3801797
53;2021-04-26;34;39;73;173813;182358;09;356171
53;2021-04-26;80;100;183;202720;214740;19;417460
53;2021-04-26;92;92;184;163116;173196;29;336312
53;2021-04-26;85;74;159;190526;187674;39;378200
53;2021-04-26;71;84;155;212098;212015;49;424113
53;2021-04-26;68;86;154;223699;219176;59;442875
53;2021-04-26;31;47;78;227435;209274;69;436709
53;2021-04-26;25;11;36;169992;140910;79;310902
53;2021-04-26;23;13;36;118117;69883;89;188000
53;2021-04-26;1;6;7;37370;12267;90;49637
53;2021-04-26;510;553;1067;1718886;1621493;0;3340379
75;2021-04-26;53;44;98;293104;305291;09;598395
75;2021-04-26;150;135;286;337141;357785;19;694926
75;2021-04-26;196;172;369;295024;300618;29;595642
75;2021-04-26;152;178;330;347871;331233;39;679104
75;2021-04-26;177;162;340;384742;372771;49;757513
75;2021-04-26;152;172;324;413361;390880;59;804241
75;2021-04-26;112;105;217;425623;384060;69;809683
75;2021-04-26;66;56;122;325086;276298;79;601384
75;2021-04-26;33;23;56;213986;139308;89;353294
75;2021-04-26;27;12;39;77600;28200;90;105800
75;2021-04-26;1118;1059;2181;3113538;2886444;0;5999982
76;2021-04-26;64;63;129;305956;318589;09;624545
76;2021-04-26;160;178;340;338942;356969;19;695911
76;2021-04-26;226;210;438;316210;319570;29;635780
76;2021-04-26;228;193;422;356758;337587;39;694345
76;2021-04-26;217;189;406;376541;363812;49;740353
76;2021-04-26;206;201;407;402608;383750;59;786358
76;2021-04-26;167;149;317;394889;358997;69;753886
76;2021-04-26;65;74;139;308664;263806;79;572470
76;2021-04-26;41;26;67;195838;129272;89;325110
76;2021-04-26;23;18;41;69372;26728;90;96100
76;2021-04-26;1398;1304;2710;3065778;2859080;0;5924858
84;2021-04-26;131;124;257;459549;481088;09;940637
84;2021-04-26;303;326;631;487711;511905;19;999616
84;2021-04-26;364;368;733;443824;451094;29;894918
84;2021-04-26;417;372;790;512522;493262;39;1005784
84;2021-04-26;391;322;714;520248;515106;49;1035354
84;2021-04-26;325;334;661;529611;514848;59;1044459
84;2021-04-26;229;188;417;486720;439940;69;926660
84;2021-04-26;98;94;192;372151;315211;79;687362
84;2021-04-26;58;45;103;237198;150524;89;387722
84;2021-04-26;38;21;59;81185;28680;90;109865
84;2021-04-26;2356;2195;4561;4130719;3901658;0;8032377
93;2021-04-26;82;82;164;268834;283093;09;551927
93;2021-04-26;200;230;432;280751;296087;19;576838
93;2021-04-26;284;264;550;254404;255552;29;509956
93;2021-04-26;296;234;534;310704;288398;39;599102
93;2021-04-26;290;263;554;325559;305827;49;631386
93;2021-04-26;310;283;593;353104;325389;59;678493
93;2021-04-26;166;144;310;336327;296459;69;632786
93;2021-04-26;94;71;165;279820;229699;79;509519
93;2021-04-26;48;24;72;171274;113716;89;284990
93;2021-04-26;15;12;27;58896;21758;90;80654
93;2021-04-26;1786;1608;3413;2639673;2415978;0;5055651
94;2021-04-26;1;2;3;16311;17433;09;33744
94;2021-04-26;7;13;20;16679;18132;19;34811
94;2021-04-26;9;6;15;16782;16579;29;33361
94;2021-04-26;11;11;22;23044;20580;39;43624
94;2021-04-26;7;13;20;23065;22140;49;45205
94;2021-04-26;13;7;20;24549;23421;59;47970
94;2021-04-26;7;4;11;23212;21883;69;45095
94;2021-04-26;1;5;6;19544;17141;79;36685
94;2021-04-26;3;1;4;11227;8178;89;19405
94;2021-04-26;6;1;7;3332;1447;90;4779
94;2021-04-26;65;63;128;177745;166934;0;344679
01;2021-04-27;6;3;9;19979;20155;09;40134
01;2021-04-27;9;10;19;24994;25489;19;50483
01;2021-04-27;13;11;24;17868;16690;29;34558
01;2021-04-27;10;5;15;22328;14821;39;37149
01;2021-04-27;18;12;30;28652;20276;49;48928
01;2021-04-27;14;13;27;33264;27260;59;60524
01;2021-04-27;15;14;29;27135;23978;69;51113
01;2021-04-27;5;4;9;18401;14661;79;33062
01;2021-04-27;2;2;4;9633;6375;89;16008
01;2021-04-27;0;1;1;3410;1510;90;4920
01;2021-04-27;92;75;167;205664;171215;0;376879
02;2021-04-27;0;2;2;16881;17110;09;33991
02;2021-04-27;2;2;4;21410;21604;19;43014
02;2021-04-27;6;7;13;16017;15479;29;31496
02;2021-04-27;5;7;12;19825;14455;39;34280
02;2021-04-27;5;4;9;24719;18248;49;42967
02;2021-04-27;11;3;14;34361;28310;59;62671
02;2021-04-27;5;8;13;28061;24495;69;52556
02;2021-04-27;4;3;7;18231;15278;79;33509
02;2021-04-27;1;0;1;11090;7677;89;18767
02;2021-04-27;1;0;1;3992;1506;90;5498
02;2021-04-27;40;36;76;194587;164162;0;358749
03;2021-04-27;4;3;7;31123;30920;09;62043
03;2021-04-27;11;2;13;29370;29268;19;58638
03;2021-04-27;13;8;21;21458;18963;29;40421
03;2021-04-27;16;18;34;21276;18326;39;39602
03;2021-04-27;19;9;28;18164;16593;49;34757
03;2021-04-27;6;14;20;13469;13557;59;27026
03;2021-04-27;9;6;15;8776;8670;69;17446
03;2021-04-27;0;1;1;3777;3591;79;7368
03;2021-04-27;0;1;1;1649;1072;89;2721
03;2021-04-27;0;0;0;485;184;90;669
03;2021-04-27;78;62;140;149547;141144;0;290691
04;2021-04-27;6;6;12;60314;61377;09;121691
04;2021-04-27;26;22;48;66065;68387;19;134452
04;2021-04-27;16;7;23;51059;47156;29;98215
04;2021-04-27;17;15;32;58788;45780;39;104568
04;2021-04-27;11;10;21;61408;52207;49;113615
04;2021-04-27;15;10;25;64838;60759;59;125597
04;2021-04-27;12;4;16;47008;42843;69;89851
04;2021-04-27;4;3;7;25509;21184;79;46693
04;2021-04-27;3;2;5;13168;7647;89;20815
04;2021-04-27;0;0;0;3209;1253;90;4462
04;2021-04-27;110;79;189;451366;408593;0;859959
05;2021-04-27;0;0;0;362.366008612902;341.338819562748;09;703.704828175651
05;2021-04-27;0;0;0;353.376145114279;370.349735405642;19;723.725880519921
05;2021-04-27;0;0;0;218.593559489256;256.539602589476;29;475.133162078732
05;2021-04-27;0;0;0;404.225408693299;360.321910454353;39;764.547319147651
05;2021-04-27;0;0;0;520.067953604221;497.108383964256;49;1017.17633756848
05;2021-04-27;0;0;0;468.146063921917;510.087601910415;59;978.233665832332
05;2021-04-27;0;0;0;340.368470050554;334.366842191253;69;674.735312241807
05;2021-04-27;0;0;0;212.598666888387;192.597753227106;79;405.196420115493
05;2021-04-27;0;0;0;148.727797095705;61.8681715431829;89;210.595968638888
05;2021-04-27;0;0;0;32.9601271090696;10.9909785719784;90;43.9511056810479
05;2021-04-27;0;0;0;3061.43020057959;2935.56979942041;0;5997
06;2021-04-27;0;0;0;42583;42380;09;84963
06;2021-04-27;0;0;0;33369;31925;19;65294
06;2021-04-27;1;1;2;21571;15080;29;36651
06;2021-04-27;1;2;3;21550;16147;39;37697
06;2021-04-27;0;0;0;14193;13939;49;28132
06;2021-04-27;0;0;0;7171;7597;59;14768
06;2021-04-27;1;0;1;3629;4117;69;7746
06;2021-04-27;0;0;0;1577;1457;79;3034
06;2021-04-27;0;2;2;531;474;89;1005
06;2021-04-27;0;0;0;88;93;90;181
06;2021-04-27;3;5;8;146262;133209;0;279471
07;2021-04-27;0;0;0;485;549;09;1034
07;2021-04-27;0;0;0;403;432;19;835
07;2021-04-27;0;0;0;764;841;29;1605
07;2021-04-27;0;0;0;824;928;39;1752
07;2021-04-27;1;0;1;788;1020;49;1808
07;2021-04-27;0;0;0;678;870;59;1548
07;2021-04-27;0;0;0;360;382;69;742
07;2021-04-27;0;0;0;231;190;79;421
07;2021-04-27;0;0;0;114;67;89;181
07;2021-04-27;0;0;0;24;11;90;35
07;2021-04-27;1;0;1;4671;5290;0;9961
08;2021-04-27;0;0;0;2715.22592983026;2997.75551488675;09;5712.98144471701
08;2021-04-27;0;0;0;2778.51901080978;3160.9156459093;19;5939.43465671908
08;2021-04-27;0;0;0;2080.8882988764;1718.16634315323;29;3799.05464202964
08;2021-04-27;0;0;0;2701.8582062647;1896.52641413317;39;4598.38462039786
08;2021-04-27;0;1;1;3151.45861023308;2460.52498233809;49;5611.98359257117
08;2021-04-27;1;0;1;2620.29868333099;2422.23566154656;59;5042.53434487755
08;2021-04-27;0;2;2;1621.44173420671;1438.58325779464;69;3060.02499200135
08;2021-04-27;0;0;0;626.575909335673;526.358467843651;79;1152.93437717932
08;2021-04-27;0;0;0;205.018522985054;140.993639349697;89;346.012162334751
08;2021-04-27;0;0;0;50.0325684687745;20.62259870351;90;70.6551671722846
08;2021-04-27;1;3;4;18551.3174743414;16782.6825256586;0;35334
11;2021-04-27;195;194;416;783071;811785;09;1594856
11;2021-04-27;473;421;920;761456;784653;19;1546109
11;2021-04-27;775;763;1550;850145;801772;29;1651917
11;2021-04-27;759;695;1464;914360;843488;39;1757848
11;2021-04-27;604;603;1214;845609;826202;49;1671811
11;2021-04-27;543;529;1082;793566;745070;59;1538636
11;2021-04-27;307;284;598;628649;549192;69;1177841
11;2021-04-27;135;150;286;434606;358356;79;792962
11;2021-04-27;72;48;121;261425;162933;89;424358
11;2021-04-27;42;10;52;89253;32619;90;121872
11;2021-04-27;3906;3698;7707;6362140;5916070;0;12278210
24;2021-04-27;18;28;47;139720;144686;09;284406
24;2021-04-27;78;68;148;152979;161185;19;314164
24;2021-04-27;84;60;146;122237;126536;29;248773
24;2021-04-27;69;60;129;150359;142009;39;292368
24;2021-04-27;88;66;154;161829;158758;49;320587
24;2021-04-27;79;53;133;172552;168011;59;340563
24;2021-04-27;56;37;95;172509;158177;69;330686
24;2021-04-27;19;30;49;129428;110593;79;240021
24;2021-04-27;22;12;34;87342;56882;89;144224
24;2021-04-27;6;2;8;31210;12071;90;43281
24;2021-04-27;519;416;943;1320165;1238908;0;2559073
27;2021-04-27;23;19;43;143373;149679;09;293052
27;2021-04-27;81;64;145;160962;173003;19;333965
27;2021-04-27;70;87;157;133746;142254;29;276000
27;2021-04-27;68;67;136;160004;155407;39;315411
27;2021-04-27;83;87;170;172333;169564;49;341897
27;2021-04-27;83;76;159;189979;183788;59;373767
27;2021-04-27;61;53;114;192591;178206;69;370797
27;2021-04-27;35;29;64;146876;127546;79;274422
27;2021-04-27;13;5;18;96896;61575;89;158471
27;2021-04-27;16;5;21;33148;12109;90;45257
27;2021-04-27;533;492;1027;1429908;1353131;0;2783039
28;2021-04-27;43;40;87;180735;186856;09;367591
28;2021-04-27;86;97;185;200125;213621;19;413746
28;2021-04-27;128;112;241;168922;173007;29;341929
28;2021-04-27;101;101;203;196628;188487;39;385115
28;2021-04-27;105;81;189;205396;201699;49;407095
28;2021-04-27;89;83;174;222002;213866;59;435868
28;2021-04-27;80;69;151;224688;203758;69;428446
28;2021-04-27;45;39;84;163192;135543;79;298735
28;2021-04-27;30;9;39;109691;65377;89;175068
28;2021-04-27;14;3;17;37222;12685;90;49907
28;2021-04-27;721;634;1370;1708601;1594899;0;3303500
32;2021-04-27;121;98;219;358062;373689;09;731751
32;2021-04-27;251;211;466;387045;406742;19;793787
32;2021-04-27;263;261;531;342304;348587;29;690891
32;2021-04-27;251;243;501;382485;369972;39;752457
32;2021-04-27;244;222;467;382510;376716;49;759226
32;2021-04-27;212;212;425;386937;376527;59;763464
32;2021-04-27;125;115;240;371211;330938;69;702149
32;2021-04-27;72;61;133;250542;201459;79;452001
32;2021-04-27;33;23;56;163399;89786;89;253185
32;2021-04-27;26;11;37;48384;15367;90;63751
32;2021-04-27;1598;1457;3078;3072879;2889783;0;5962662
44;2021-04-27;67;81;150;291525;306839;09;598364
44;2021-04-27;123;122;246;320255;339504;19;659759
44;2021-04-27;174;172;347;302020;314428;29;616448
44;2021-04-27;149;145;296;342222;333292;39;675514
44;2021-04-27;142;128;270;349727;344491;49;694218
44;2021-04-27;136;144;282;381371;373239;59;754610
44;2021-04-27;105;85;191;367165;335850;69;703015
44;2021-04-27;46;40;86;250387;215436;79;465823
44;2021-04-27;33;20;53;170825;105192;89;276017
44;2021-04-27;21;8;29;51248;16731;90;67979
44;2021-04-27;996;945;1950;2826745;2685002;0;5511747
52;2021-04-27;41;42;85;213594;223900;09;437494
52;2021-04-27;92;94;188;240818;255197;19;496015
52;2021-04-27;99;116;215;197010;200630;29;397640
52;2021-04-27;102;74;176;231204;224885;39;456089
52;2021-04-27;112;82;194;243874;243418;49;487292
52;2021-04-27;99;88;187;244100;239116;59;483216
52;2021-04-27;49;57;106;241796;221345;69;463141
52;2021-04-27;35;32;67;177805;149903;79;327708
52;2021-04-27;31;7;38;119561;75822;89;195383
52;2021-04-27;10;4;14;42559;15260;90;57819
52;2021-04-27;670;596;1270;1952321;1849476;0;3801797
53;2021-04-27;21;26;47;173813;182358;09;356171
53;2021-04-27;62;67;129;202720;214740;19;417460
53;2021-04-27;57;76;136;163116;173196;29;336312
53;2021-04-27;66;62;128;190526;187674;39;378200
53;2021-04-27;60;59;119;212098;212015;49;424113
53;2021-04-27;66;60;126;223699;219176;59;442875
53;2021-04-27;38;32;70;227435;209274;69;436709
53;2021-04-27;17;15;32;169992;140910;79;310902
53;2021-04-27;11;9;20;118117;69883;89;188000
53;2021-04-27;3;2;5;37370;12267;90;49637
53;2021-04-27;401;408;812;1718886;1621493;0;3340379
75;2021-04-27;48;43;91;293104;305291;09;598395
75;2021-04-27;109;103;213;337141;357785;19;694926
75;2021-04-27;129;121;251;295024;300618;29;595642
75;2021-04-27;121;95;217;347871;331233;39;679104
75;2021-04-27;119;98;217;384742;372771;49;757513
75;2021-04-27;107;116;223;413361;390880;59;804241
75;2021-04-27;74;71;145;425623;384060;69;809683
75;2021-04-27;36;47;83;325086;276298;79;601384
75;2021-04-27;32;24;56;213986;139308;89;353294
75;2021-04-27;25;7;32;77600;28200;90;105800
75;2021-04-27;800;725;1528;3113538;2886444;0;5999982
76;2021-04-27;57;59;119;305956;318589;09;624545
76;2021-04-27;126;161;293;338942;356969;19;695911
76;2021-04-27;176;173;355;316210;319570;29;635780
76;2021-04-27;181;151;333;356758;337587;39;694345
76;2021-04-27;195;180;375;376541;363812;49;740353
76;2021-04-27;150;136;288;402608;383750;59;786358
76;2021-04-27;92;88;180;394889;358997;69;753886
76;2021-04-27;58;48;106;308664;263806;79;572470
76;2021-04-27;40;37;77;195838;129272;89;325110
76;2021-04-27;26;9;35;69372;26728;90;96100
76;2021-04-27;1102;1042;2162;3065778;2859080;0;5924858
84;2021-04-27;109;93;202;459549;481088;09;940637
84;2021-04-27;272;265;540;487711;511905;19;999616
84;2021-04-27;303;273;577;443824;451094;29;894918
84;2021-04-27;280;265;545;512522;493262;39;1005784
84;2021-04-27;281;259;541;520248;515106;49;1035354
84;2021-04-27;230;232;462;529611;514848;59;1044459
84;2021-04-27;146;151;298;486720;439940;69;926660
84;2021-04-27;94;78;172;372151;315211;79;687362
84;2021-04-27;53;32;85;237198;150524;89;387722
84;2021-04-27;38;8;46;81185;28680;90;109865
84;2021-04-27;1807;1656;3469;4130719;3901658;0;8032377
93;2021-04-27;55;54;114;268834;283093;09;551927
93;2021-04-27;152;146;299;280751;296087;19;576838
93;2021-04-27;219;196;416;254404;255552;29;509956
93;2021-04-27;218;171;389;310704;288398;39;599102
93;2021-04-27;203;173;376;325559;305827;49;631386
93;2021-04-27;183;194;377;353104;325389;59;678493
93;2021-04-27;132;110;242;336327;296459;69;632786
93;2021-04-27;65;64;129;279820;229699;79;509519
93;2021-04-27;37;30;67;171274;113716;89;284990
93;2021-04-27;31;5;36;58896;21758;90;80654
93;2021-04-27;1295;1143;2445;2639673;2415978;0;5055651
94;2021-04-27;1;2;3;16311;17433;09;33744
94;2021-04-27;11;10;21;16679;18132;19;34811
94;2021-04-27;6;3;9;16782;16579;29;33361
94;2021-04-27;7;5;12;23044;20580;39;43624
94;2021-04-27;6;3;9;23065;22140;49;45205
94;2021-04-27;6;2;8;24549;23421;59;47970
94;2021-04-27;2;4;6;23212;21883;69;45095
94;2021-04-27;0;3;3;19544;17141;79;36685
94;2021-04-27;0;1;1;11227;8178;89;19405
94;2021-04-27;1;1;2;3332;1447;90;4779
94;2021-04-27;40;34;74;177745;166934;0;344679
01;2021-04-28;7;0;7;19979;20155;09;40134
01;2021-04-28;9;10;19;24994;25489;19;50483
01;2021-04-28;18;7;25;17868;16690;29;34558
01;2021-04-28;10;10;20;22328;14821;39;37149
01;2021-04-28;15;13;28;28652;20276;49;48928
01;2021-04-28;18;11;29;33264;27260;59;60524
01;2021-04-28;10;7;17;27135;23978;69;51113
01;2021-04-28;5;4;9;18401;14661;79;33062
01;2021-04-28;1;3;4;9633;6375;89;16008
01;2021-04-28;1;0;1;3410;1510;90;4920
01;2021-04-28;94;65;159;205664;171215;0;376879
02;2021-04-28;2;1;3;16881;17110;09;33991
02;2021-04-28;4;3;7;21410;21604;19;43014
02;2021-04-28;5;5;10;16017;15479;29;31496
02;2021-04-28;3;3;6;19825;14455;39;34280
02;2021-04-28;7;3;10;24719;18248;49;42967
02;2021-04-28;5;8;13;34361;28310;59;62671
02;2021-04-28;3;5;8;28061;24495;69;52556
02;2021-04-28;1;5;6;18231;15278;79;33509
02;2021-04-28;1;0;1;11090;7677;89;18767
02;2021-04-28;0;0;0;3992;1506;90;5498
02;2021-04-28;31;33;64;194587;164162;0;358749
03;2021-04-28;2;6;8;31123;30920;09;62043
03;2021-04-28;6;4;10;29370;29268;19;58638
03;2021-04-28;16;11;27;21458;18963;29;40421
03;2021-04-28;12;7;19;21276;18326;39;39602
03;2021-04-28;12;9;21;18164;16593;49;34757
03;2021-04-28;6;14;20;13469;13557;59;27026
03;2021-04-28;3;4;7;8776;8670;69;17446
03;2021-04-28;0;1;1;3777;3591;79;7368
03;2021-04-28;2;0;2;1649;1072;89;2721
03;2021-04-28;0;0;0;485;184;90;669
03;2021-04-28;59;56;115;149547;141144;0;290691
04;2021-04-28;6;8;14;60314;61377;09;121691
04;2021-04-28;16;19;35;66065;68387;19;134452
04;2021-04-28;16;8;24;51059;47156;29;98215
04;2021-04-28;16;20;36;58788;45780;39;104568
04;2021-04-28;14;10;24;61408;52207;49;113615
04;2021-04-28;11;10;21;64838;60759;59;125597
04;2021-04-28;10;9;19;47008;42843;69;89851
04;2021-04-28;5;3;8;25509;21184;79;46693
04;2021-04-28;1;2;3;13168;7647;89;20815
04;2021-04-28;0;0;0;3209;1253;90;4462
04;2021-04-28;95;89;184;451366;408593;0;859959
05;2021-04-28;0;0;0;362.366008612902;341.338819562748;09;703.704828175651
05;2021-04-28;0;0;0;353.376145114279;370.349735405642;19;723.725880519921
05;2021-04-28;0;0;0;218.593559489256;256.539602589476;29;475.133162078732
05;2021-04-28;0;0;0;404.225408693299;360.321910454353;39;764.547319147651
05;2021-04-28;0;0;0;520.067953604221;497.108383964256;49;1017.17633756848
05;2021-04-28;0;0;0;468.146063921917;510.087601910415;59;978.233665832332
05;2021-04-28;0;0;0;340.368470050554;334.366842191253;69;674.735312241807
05;2021-04-28;0;0;0;212.598666888387;192.597753227106;79;405.196420115493
05;2021-04-28;0;0;0;148.727797095705;61.8681715431829;89;210.595968638888
05;2021-04-28;0;0;0;32.9601271090696;10.9909785719784;90;43.9511056810479
05;2021-04-28;0;0;0;3061.43020057959;2935.56979942041;0;5997
06;2021-04-28;1;0;1;42583;42380;09;84963
06;2021-04-28;1;3;4;33369;31925;19;65294
06;2021-04-28;8;4;12;21571;15080;29;36651
06;2021-04-28;3;0;3;21550;16147;39;37697
06;2021-04-28;1;2;3;14193;13939;49;28132
06;2021-04-28;2;0;2;7171;7597;59;14768
06;2021-04-28;1;1;2;3629;4117;69;7746
06;2021-04-28;0;0;0;1577;1457;79;3034
06;2021-04-28;0;1;1;531;474;89;1005
06;2021-04-28;0;0;0;88;93;90;181
06;2021-04-28;17;11;28;146262;133209;0;279471
07;2021-04-28;0;0;0;485;549;09;1034
07;2021-04-28;0;0;0;403;432;19;835
07;2021-04-28;0;0;0;764;841;29;1605
07;2021-04-28;0;0;0;824;928;39;1752
07;2021-04-28;0;0;0;788;1020;49;1808
07;2021-04-28;0;0;0;678;870;59;1548
07;2021-04-28;0;0;0;360;382;69;742
07;2021-04-28;0;0;0;231;190;79;421
07;2021-04-28;0;0;0;114;67;89;181
07;2021-04-28;0;0;0;24;11;90;35
07;2021-04-28;0;0;0;4671;5290;0;9961
08;2021-04-28;0;0;0;2715.22592983026;2997.75551488675;09;5712.98144471701
08;2021-04-28;0;0;0;2778.51901080978;3160.9156459093;19;5939.43465671908
08;2021-04-28;0;0;0;2080.8882988764;1718.16634315323;29;3799.05464202964
08;2021-04-28;1;0;1;2701.8582062647;1896.52641413317;39;4598.38462039786
08;2021-04-28;0;1;1;3151.45861023308;2460.52498233809;49;5611.98359257117
08;2021-04-28;2;0;2;2620.29868333099;2422.23566154656;59;5042.53434487755
08;2021-04-28;0;1;1;1621.44173420671;1438.58325779464;69;3060.02499200135
08;2021-04-28;0;0;0;626.575909335673;526.358467843651;79;1152.93437717932
08;2021-04-28;0;0;0;205.018522985054;140.993639349697;89;346.012162334751
08;2021-04-28;0;0;0;50.0325684687745;20.62259870351;90;70.6551671722846
08;2021-04-28;3;2;5;18551.3174743414;16782.6825256586;0;35334
11;2021-04-28;170;186;377;783071;811785;09;1594856
11;2021-04-28;459;396;877;761456;784653;19;1546109
11;2021-04-28;755;688;1457;850145;801772;29;1651917
11;2021-04-28;631;621;1264;914360;843488;39;1757848
11;2021-04-28;530;526;1062;845609;826202;49;1671811
11;2021-04-28;445;485;940;793566;745070;59;1538636
11;2021-04-28;261;264;529;628649;549192;69;1177841
11;2021-04-28;110;106;218;434606;358356;79;792962
11;2021-04-28;65;41;106;261425;162933;89;424358
11;2021-04-28;35;22;57;89253;32619;90;121872
11;2021-04-28;3463;3338;6892;6362140;5916070;0;12278210
24;2021-04-28;11;20;32;139720;144686;09;284406
24;2021-04-28;60;58;119;152979;161185;19;314164
24;2021-04-28;65;83;149;122237;126536;29;248773
24;2021-04-28;63;65;128;150359;142009;39;292368
24;2021-04-28;89;66;157;161829;158758;49;320587
24;2021-04-28;53;57;110;172552;168011;59;340563
24;2021-04-28;41;32;73;172509;158177;69;330686
24;2021-04-28;25;16;41;129428;110593;79;240021
24;2021-04-28;17;9;26;87342;56882;89;144224
24;2021-04-28;17;2;19;31210;12071;90;43281
24;2021-04-28;441;408;854;1320165;1238908;0;2559073
27;2021-04-28;36;41;77;143373;149679;09;293052
27;2021-04-28;83;85;168;160962;173003;19;333965
27;2021-04-28;61;87;148;133746;142254;29;276000
27;2021-04-28;78;51;129;160004;155407;39;315411
27;2021-04-28;77;74;151;172333;169564;49;341897
27;2021-04-28;64;64;128;189979;183788;59;373767
27;2021-04-28;45;33;78;192591;178206;69;370797
27;2021-04-28;19;29;48;146876;127546;79;274422
27;2021-04-28;19;13;32;96896;61575;89;158471
27;2021-04-28;12;4;16;33148;12109;90;45257
27;2021-04-28;495;481;976;1429908;1353131;0;2783039
28;2021-04-28;47;42;93;180735;186856;09;367591
28;2021-04-28;74;85;161;200125;213621;19;413746
28;2021-04-28;103;120;225;168922;173007;29;341929
28;2021-04-28;93;87;181;196628;188487;39;385115
28;2021-04-28;85;92;179;205396;201699;49;407095
28;2021-04-28;67;83;152;222002;213866;59;435868
28;2021-04-28;61;59;120;224688;203758;69;428446
28;2021-04-28;29;20;49;163192;135543;79;298735
28;2021-04-28;18;8;26;109691;65377;89;175068
28;2021-04-28;20;4;24;37222;12685;90;49907
28;2021-04-28;597;600;1210;1708601;1594899;0;3303500
32;2021-04-28;80;105;186;358062;373689;09;731751
32;2021-04-28;214;217;436;387045;406742;19;793787
32;2021-04-28;259;231;494;342304;348587;29;690891
32;2021-04-28;219;199;423;382485;369972;39;752457
32;2021-04-28;218;196;415;382510;376716;49;759226
32;2021-04-28;184;181;367;386937;376527;59;763464
32;2021-04-28;121;121;242;371211;330938;69;702149
32;2021-04-28;56;50;106;250542;201459;79;452001
32;2021-04-28;39;30;69;163399;89786;89;253185
32;2021-04-28;26;5;31;48384;15367;90;63751
32;2021-04-28;1416;1335;2769;3072879;2889783;0;5962662
44;2021-04-28;61;57;120;291525;306839;09;598364
44;2021-04-28;136;117;256;320255;339504;19;659759
44;2021-04-28;129;161;290;302020;314428;29;616448
44;2021-04-28;143;126;273;342222;333292;39;675514
44;2021-04-28;143;116;261;349727;344491;49;694218
44;2021-04-28;124;89;214;381371;373239;59;754610
44;2021-04-28;66;81;148;367165;335850;69;703015
44;2021-04-28;41;36;77;250387;215436;79;465823
44;2021-04-28;38;13;51;170825;105192;89;276017
44;2021-04-28;15;8;23;51248;16731;90;67979
44;2021-04-28;896;804;1713;2826745;2685002;0;5511747
52;2021-04-28;31;38;72;213594;223900;09;437494
52;2021-04-28;85;96;183;240818;255197;19;496015
52;2021-04-28;99;101;200;197010;200630;29;397640
52;2021-04-28;84;72;156;231204;224885;39;456089
52;2021-04-28;96;82;179;243874;243418;49;487292
52;2021-04-28;86;95;181;244100;239116;59;483216
52;2021-04-28;46;61;107;241796;221345;69;463141
52;2021-04-28;29;21;51;177805;149903;79;327708
52;2021-04-28;29;8;37;119561;75822;89;195383
52;2021-04-28;18;6;24;42559;15260;90;57819
52;2021-04-28;603;580;1190;1952321;1849476;0;3801797
53;2021-04-28;26;24;51;173813;182358;09;356171
53;2021-04-28;67;47;114;202720;214740;19;417460
53;2021-04-28;74;59;134;163116;173196;29;336312
53;2021-04-28;61;36;97;190526;187674;39;378200
53;2021-04-28;50;48;98;212098;212015;49;424113
53;2021-04-28;34;46;81;223699;219176;59;442875
53;2021-04-28;26;33;59;227435;209274;69;436709
53;2021-04-28;23;10;33;169992;140910;79;310902
53;2021-04-28;7;10;17;118117;69883;89;188000
53;2021-04-28;9;1;10;37370;12267;90;49637
53;2021-04-28;377;314;694;1718886;1621493;0;3340379
75;2021-04-28;48;29;78;293104;305291;09;598395
75;2021-04-28;92;97;189;337141;357785;19;694926
75;2021-04-28;133;127;260;295024;300618;29;595642
75;2021-04-28;119;105;224;347871;331233;39;679104
75;2021-04-28;109;102;212;384742;372771;49;757513
75;2021-04-28;92;85;177;413361;390880;59;804241
75;2021-04-28;56;55;112;425623;384060;69;809683
75;2021-04-28;32;51;83;325086;276298;79;601384
75;2021-04-28;32;22;54;213986;139308;89;353294
75;2021-04-28;17;5;22;77600;28200;90;105800
75;2021-04-28;732;678;1413;3113538;2886444;0;5999982
76;2021-04-28;61;51;117;305956;318589;09;624545
76;2021-04-28;128;137;268;338942;356969;19;695911
76;2021-04-28;149;146;297;316210;319570;29;635780
76;2021-04-28;172;158;331;356758;337587;39;694345
76;2021-04-28;130;128;260;376541;363812;49;740353
76;2021-04-28;122;122;244;402608;383750;59;786358
76;2021-04-28;91;75;167;394889;358997;69;753886
76;2021-04-28;44;41;85;308664;263806;79;572470
76;2021-04-28;37;29;66;195838;129272;89;325110
76;2021-04-28;23;10;33;69372;26728;90;96100
76;2021-04-28;958;898;1870;3065778;2859080;0;5924858
84;2021-04-28;106;108;215;459549;481088;09;940637
84;2021-04-28;217;256;477;487711;511905;19;999616
84;2021-04-28;260;262;523;443824;451094;29;894918
84;2021-04-28;235;237;473;512522;493262;39;1005784
84;2021-04-28;212;222;436;520248;515106;49;1035354
84;2021-04-28;199;200;399;529611;514848;59;1044459
84;2021-04-28;123;116;239;486720;439940;69;926660
84;2021-04-28;81;76;157;372151;315211;79;687362
84;2021-04-28;56;28;84;237198;150524;89;387722
84;2021-04-28;23;11;34;81185;28680;90;109865
84;2021-04-28;1512;1518;3040;4130719;3901658;0;8032377
93;2021-04-28;49;52;101;268834;283093;09;551927
93;2021-04-28;120;131;251;280751;296087;19;576838
93;2021-04-28;148;170;319;254404;255552;29;509956
93;2021-04-28;164;143;309;310704;288398;39;599102
93;2021-04-28;141;129;270;325559;305827;49;631386
93;2021-04-28;159;131;291;353104;325389;59;678493
93;2021-04-28;96;85;181;336327;296459;69;632786
93;2021-04-28;45;40;85;279820;229699;79;509519
93;2021-04-28;29;14;43;171274;113716;89;284990
93;2021-04-28;16;7;23;58896;21758;90;80654
93;2021-04-28;968;902;1910;2639673;2415978;0;5055651
94;2021-04-28;2;3;5;16311;17433;09;33744
94;2021-04-28;3;5;8;16679;18132;19;34811
94;2021-04-28;5;6;11;16782;16579;29;33361
94;2021-04-28;1;4;5;23044;20580;39;43624
94;2021-04-28;5;6;11;23065;22140;49;45205
94;2021-04-28;3;5;8;24549;23421;59;47970
94;2021-04-28;2;0;2;23212;21883;69;45095
94;2021-04-28;1;1;2;19544;17141;79;36685
94;2021-04-28;0;1;1;11227;8178;89;19405
94;2021-04-28;0;0;0;3332;1447;90;4779
94;2021-04-28;22;31;53;177745;166934;0;344679
01;2021-04-29;3;0;3;19979;20155;09;40134
01;2021-04-29;10;7;17;24994;25489;19;50483
01;2021-04-29;8;9;17;17868;16690;29;34558
01;2021-04-29;16;8;24;22328;14821;39;37149
01;2021-04-29;13;6;19;28652;20276;49;48928
01;2021-04-29;16;10;26;33264;27260;59;60524
01;2021-04-29;7;12;19;27135;23978;69;51113
01;2021-04-29;2;4;6;18401;14661;79;33062
01;2021-04-29;1;4;5;9633;6375;89;16008
01;2021-04-29;3;1;4;3410;1510;90;4920
01;2021-04-29;79;61;140;205664;171215;0;376879
02;2021-04-29;2;4;6;16881;17110;09;33991
02;2021-04-29;1;3;4;21410;21604;19;43014
02;2021-04-29;3;4;7;16017;15479;29;31496
02;2021-04-29;3;3;6;19825;14455;39;34280
02;2021-04-29;4;3;7;24719;18248;49;42967
02;2021-04-29;0;6;6;34361;28310;59;62671
02;2021-04-29;3;2;5;28061;24495;69;52556
02;2021-04-29;0;1;1;18231;15278;79;33509
02;2021-04-29;0;0;0;11090;7677;89;18767
02;2021-04-29;0;0;0;3992;1506;90;5498
02;2021-04-29;16;26;42;194587;164162;0;358749
03;2021-04-29;2;6;8;31123;30920;09;62043
03;2021-04-29;16;10;26;29370;29268;19;58638
03;2021-04-29;19;10;30;21458;18963;29;40421
03;2021-04-29;11;10;22;21276;18326;39;39602
03;2021-04-29;10;7;17;18164;16593;49;34757
03;2021-04-29;12;11;23;13469;13557;59;27026
03;2021-04-29;5;4;9;8776;8670;69;17446
03;2021-04-29;3;1;4;3777;3591;79;7368
03;2021-04-29;0;3;3;1649;1072;89;2721
03;2021-04-29;0;0;0;485;184;90;669
03;2021-04-29;78;62;142;149547;141144;0;290691
04;2021-04-29;10;7;17;60314;61377;09;121691
04;2021-04-29;18;16;34;66065;68387;19;134452
04;2021-04-29;18;9;27;51059;47156;29;98215
04;2021-04-29;14;20;34;58788;45780;39;104568
04;2021-04-29;17;15;32;61408;52207;49;113615
04;2021-04-29;18;18;36;64838;60759;59;125597
04;2021-04-29;8;4;12;47008;42843;69;89851
04;2021-04-29;3;2;5;25509;21184;79;46693
04;2021-04-29;3;2;5;13168;7647;89;20815
04;2021-04-29;0;2;2;3209;1253;90;4462
04;2021-04-29;109;95;204;451366;408593;0;859959
05;2021-04-29;0;0;0;362.366008612902;341.338819562748;09;703.704828175651
05;2021-04-29;0;0;0;353.376145114279;370.349735405642;19;723.725880519921
05;2021-04-29;0;0;0;218.593559489256;256.539602589476;29;475.133162078732
05;2021-04-29;0;0;0;404.225408693299;360.321910454353;39;764.547319147651
05;2021-04-29;0;0;0;520.067953604221;497.108383964256;49;1017.17633756848
05;2021-04-29;0;0;0;468.146063921917;510.087601910415;59;978.233665832332
05;2021-04-29;0;0;0;340.368470050554;334.366842191253;69;674.735312241807
05;2021-04-29;0;0;0;212.598666888387;192.597753227106;79;405.196420115493
05;2021-04-29;0;0;0;148.727797095705;61.8681715431829;89;210.595968638888
05;2021-04-29;0;0;0;32.9601271090696;10.9909785719784;90;43.9511056810479
05;2021-04-29;0;0;0;3061.43020057959;2935.56979942041;0;5997
06;2021-04-29;0;0;0;42583;42380;09;84963
06;2021-04-29;1;1;2;33369;31925;19;65294
06;2021-04-29;1;1;2;21571;15080;29;36651
06;2021-04-29;1;1;2;21550;16147;39;37697
06;2021-04-29;0;0;0;14193;13939;49;28132
06;2021-04-29;0;0;0;7171;7597;59;14768
06;2021-04-29;0;0;0;3629;4117;69;7746
06;2021-04-29;0;1;1;1577;1457;79;3034
06;2021-04-29;1;0;1;531;474;89;1005
06;2021-04-29;0;0;0;88;93;90;181
06;2021-04-29;4;4;8;146262;133209;0;279471
07;2021-04-29;0;0;0;485;549;09;1034
07;2021-04-29;0;0;0;403;432;19;835
07;2021-04-29;0;0;0;764;841;29;1605
07;2021-04-29;0;1;1;824;928;39;1752
07;2021-04-29;0;0;0;788;1020;49;1808
07;2021-04-29;1;0;1;678;870;59;1548
07;2021-04-29;0;0;0;360;382;69;742
07;2021-04-29;0;0;0;231;190;79;421
07;2021-04-29;0;0;0;114;67;89;181
07;2021-04-29;0;0;0;24;11;90;35
07;2021-04-29;1;1;2;4671;5290;0;9961
08;2021-04-29;0;0;0;2715.22592983026;2997.75551488675;09;5712.98144471701
08;2021-04-29;0;1;1;2778.51901080978;3160.9156459093;19;5939.43465671908
08;2021-04-29;0;0;0;2080.8882988764;1718.16634315323;29;3799.05464202964
08;2021-04-29;1;0;1;2701.8582062647;1896.52641413317;39;4598.38462039786
08;2021-04-29;0;0;0;3151.45861023308;2460.52498233809;49;5611.98359257117
08;2021-04-29;0;3;3;2620.29868333099;2422.23566154656;59;5042.53434487755
08;2021-04-29;0;1;1;1621.44173420671;1438.58325779464;69;3060.02499200135
08;2021-04-29;0;0;0;626.575909335673;526.358467843651;79;1152.93437717932
08;2021-04-29;0;0;0;205.018522985054;140.993639349697;89;346.012162334751
08;2021-04-29;0;0;0;50.0325684687745;20.62259870351;90;70.6551671722846
08;2021-04-29;1;5;6;18551.3174743414;16782.6825256586;0;35334
11;2021-04-29;186;221;433;783071;811785;09;1594856
11;2021-04-29;455;433;921;761456;784653;19;1546109
11;2021-04-29;672;619;1297;850145;801772;29;1651917
11;2021-04-29;610;645;1262;914360;843488;39;1757848
11;2021-04-29;513;497;1016;845609;826202;49;1671811
11;2021-04-29;417;429;854;793566;745070;59;1538636
11;2021-04-29;214;222;436;628649;549192;69;1177841
11;2021-04-29;98;99;198;434606;358356;79;792962
11;2021-04-29;62;43;105;261425;162933;89;424358
11;2021-04-29;28;15;43;89253;32619;90;121872
11;2021-04-29;3256;3224;6567;6362140;5916070;0;12278210
24;2021-04-29;14;22;38;139720;144686;09;284406
24;2021-04-29;59;62;123;152979;161185;19;314164
24;2021-04-29;83;72;156;122237;126536;29;248773
24;2021-04-29;69;61;131;150359;142009;39;292368
24;2021-04-29;66;57;123;161829;158758;49;320587
24;2021-04-29;57;64;121;172552;168011;59;340563
24;2021-04-29;36;41;77;172509;158177;69;330686
24;2021-04-29;16;29;45;129428;110593;79;240021
24;2021-04-29;20;4;24;87342;56882;89;144224
24;2021-04-29;15;5;20;31210;12071;90;43281
24;2021-04-29;436;417;859;1320165;1238908;0;2559073
27;2021-04-29;35;31;66;143373;149679;09;293052
27;2021-04-29;63;67;130;160962;173003;19;333965
27;2021-04-29;61;65;126;133746;142254;29;276000
27;2021-04-29;78;90;169;160004;155407;39;315411
27;2021-04-29;76;69;145;172333;169564;49;341897
27;2021-04-29;61;61;122;189979;183788;59;373767
27;2021-04-29;49;34;83;192591;178206;69;370797
27;2021-04-29;28;31;59;146876;127546;79;274422
27;2021-04-29;25;9;34;96896;61575;89;158471
27;2021-04-29;13;5;18;33148;12109;90;45257
27;2021-04-29;489;462;952;1429908;1353131;0;2783039
28;2021-04-29;56;57;115;180735;186856;09;367591
28;2021-04-29;91;100;194;200125;213621;19;413746
28;2021-04-29;110;86;196;168922;173007;29;341929
28;2021-04-29;109;116;225;196628;188487;39;385115
28;2021-04-29;99;96;195;205396;201699;49;407095
28;2021-04-29;89;75;164;222002;213866;59;435868
28;2021-04-29;70;58;128;224688;203758;69;428446
28;2021-04-29;30;32;62;163192;135543;79;298735
28;2021-04-29;23;8;31;109691;65377;89;175068
28;2021-04-29;17;5;22;37222;12685;90;49907
28;2021-04-29;694;633;1332;1708601;1594899;0;3303500
32;2021-04-29;98;118;219;358062;373689;09;731751
32;2021-04-29;177;230;409;387045;406742;19;793787
32;2021-04-29;253;231;486;342304;348587;29;690891
32;2021-04-29;210;175;389;382485;369972;39;752457
32;2021-04-29;213;172;387;382510;376716;49;759226
32;2021-04-29;182;182;366;386937;376527;59;763464
32;2021-04-29;122;111;234;371211;330938;69;702149
32;2021-04-29;56;55;111;250542;201459;79;452001
32;2021-04-29;25;21;46;163399;89786;89;253185
32;2021-04-29;26;5;31;48384;15367;90;63751
32;2021-04-29;1363;1300;2679;3072879;2889783;0;5962662
44;2021-04-29;59;62;123;291525;306839;09;598364
44;2021-04-29;118;128;248;320255;339504;19;659759
44;2021-04-29;145;150;297;302020;314428;29;616448
44;2021-04-29;138;131;271;342222;333292;39;675514
44;2021-04-29;135;110;245;349727;344491;49;694218
44;2021-04-29;100;128;228;381371;373239;59;754610
44;2021-04-29;91;66;158;367165;335850;69;703015
44;2021-04-29;50;45;96;250387;215436;79;465823
44;2021-04-29;26;17;44;170825;105192;89;276017
44;2021-04-29;17;3;20;51248;16731;90;67979
44;2021-04-29;879;840;1730;2826745;2685002;0;5511747
52;2021-04-29;32;37;71;213594;223900;09;437494
52;2021-04-29;108;93;203;240818;255197;19;496015
52;2021-04-29;98;94;192;197010;200630;29;397640
52;2021-04-29;93;79;172;231204;224885;39;456089
52;2021-04-29;74;70;144;243874;243418;49;487292
52;2021-04-29;87;72;159;244100;239116;59;483216
52;2021-04-29;48;56;104;241796;221345;69;463141
52;2021-04-29;20;37;57;177805;149903;79;327708
52;2021-04-29;18;7;25;119561;75822;89;195383
52;2021-04-29;12;5;17;42559;15260;90;57819
52;2021-04-29;590;550;1144;1952321;1849476;0;3801797
53;2021-04-29;20;27;48;173813;182358;09;356171
53;2021-04-29;68;57;125;202720;214740;19;417460
53;2021-04-29;73;78;152;163116;173196;29;336312
53;2021-04-29;49;58;107;190526;187674;39;378200
53;2021-04-29;48;43;91;212098;212015;49;424113
53;2021-04-29;49;42;91;223699;219176;59;442875
53;2021-04-29;24;18;42;227435;209274;69;436709
53;2021-04-29;14;12;26;169992;140910;79;310902
53;2021-04-29;8;9;17;118117;69883;89;188000
53;2021-04-29;6;1;7;37370;12267;90;49637
53;2021-04-29;359;346;707;1718886;1621493;0;3340379
75;2021-04-29;38;48;87;293104;305291;09;598395
75;2021-04-29;87;122;212;337141;357785;19;694926
75;2021-04-29;121;107;229;295024;300618;29;595642
75;2021-04-29;99;88;187;347871;331233;39;679104
75;2021-04-29;94;92;186;384742;372771;49;757513
75;2021-04-29;79;91;170;413361;390880;59;804241
75;2021-04-29;69;57;127;425623;384060;69;809683
75;2021-04-29;32;25;57;325086;276298;79;601384
75;2021-04-29;30;24;54;213986;139308;89;353294
75;2021-04-29;22;10;32;77600;28200;90;105800
75;2021-04-29;671;664;1341;3113538;2886444;0;5999982
76;2021-04-29;56;57;114;305956;318589;09;624545
76;2021-04-29;153;124;279;338942;356969;19;695911
76;2021-04-29;143;154;298;316210;319570;29;635780
76;2021-04-29;144;124;268;356758;337587;39;694345
76;2021-04-29;143;121;264;376541;363812;49;740353
76;2021-04-29;115;121;236;402608;383750;59;786358
76;2021-04-29;71;78;149;394889;358997;69;753886
76;2021-04-29;31;39;70;308664;263806;79;572470
76;2021-04-29;28;15;43;195838;129272;89;325110
76;2021-04-29;13;11;24;69372;26728;90;96100
76;2021-04-29;898;845;1748;3065778;2859080;0;5924858
84;2021-04-29;101;109;212;459549;481088;09;940637
84;2021-04-29;228;239;469;487711;511905;19;999616
84;2021-04-29;215;230;445;443824;451094;29;894918
84;2021-04-29;234;194;428;512522;493262;39;1005784
84;2021-04-29;207;208;415;520248;515106;49;1035354
84;2021-04-29;176;202;378;529611;514848;59;1044459
84;2021-04-29;142;95;237;486720;439940;69;926660
84;2021-04-29;72;46;118;372151;315211;79;687362
84;2021-04-29;45;28;73;237198;150524;89;387722
84;2021-04-29;27;4;31;81185;28680;90;109865
84;2021-04-29;1447;1355;2806;4130719;3901658;0;8032377
93;2021-04-29;42;63;105;268834;283093;09;551927
93;2021-04-29;98;113;211;280751;296087;19;576838
93;2021-04-29;140;122;262;254404;255552;29;509956
93;2021-04-29;144;108;252;310704;288398;39;599102
93;2021-04-29;120;129;249;325559;305827;49;631386
93;2021-04-29;127;127;254;353104;325389;59;678493
93;2021-04-29;93;79;172;336327;296459;69;632786
93;2021-04-29;42;40;82;279820;229699;79;509519
93;2021-04-29;33;13;46;171274;113716;89;284990
93;2021-04-29;16;11;27;58896;21758;90;80654
93;2021-04-29;855;805;1660;2639673;2415978;0;5055651
94;2021-04-29;2;5;7;16311;17433;09;33744
94;2021-04-29;0;3;3;16679;18132;19;34811
94;2021-04-29;3;2;5;16782;16579;29;33361
94;2021-04-29;5;3;8;23044;20580;39;43624
94;2021-04-29;6;2;8;23065;22140;49;45205
94;2021-04-29;2;5;7;24549;23421;59;47970
94;2021-04-29;1;1;2;23212;21883;69;45095
94;2021-04-29;0;1;1;19544;17141;79;36685
94;2021-04-29;1;1;2;11227;8178;89;19405
94;2021-04-29;1;0;1;3332;1447;90;4779
94;2021-04-29;21;23;44;177745;166934;0;344679
01;2021-04-30;3;2;5;19979;20155;09;40134
01;2021-04-30;10;3;13;24994;25489;19;50483
01;2021-04-30;8;6;14;17868;16690;29;34558
01;2021-04-30;13;11;24;22328;14821;39;37149
01;2021-04-30;13;6;19;28652;20276;49;48928
01;2021-04-30;10;6;16;33264;27260;59;60524
01;2021-04-30;5;7;12;27135;23978;69;51113
01;2021-04-30;5;6;11;18401;14661;79;33062
01;2021-04-30;1;1;2;9633;6375;89;16008
01;2021-04-30;1;0;1;3410;1510;90;4920
01;2021-04-30;69;48;117;205664;171215;0;376879
02;2021-04-30;2;0;2;16881;17110;09;33991
02;2021-04-30;0;1;1;21410;21604;19;43014
02;2021-04-30;7;3;10;16017;15479;29;31496
02;2021-04-30;8;1;9;19825;14455;39;34280
02;2021-04-30;3;4;7;24719;18248;49;42967
02;2021-04-30;10;2;12;34361;28310;59;62671
02;2021-04-30;2;6;8;28061;24495;69;52556
02;2021-04-30;2;0;2;18231;15278;79;33509
02;2021-04-30;0;0;0;11090;7677;89;18767
02;2021-04-30;0;0;0;3992;1506;90;5498
02;2021-04-30;34;17;51;194587;164162;0;358749
03;2021-04-30;5;7;13;31123;30920;09;62043
03;2021-04-30;14;10;24;29370;29268;19;58638
03;2021-04-30;13;8;21;21458;18963;29;40421
03;2021-04-30;11;3;14;21276;18326;39;39602
03;2021-04-30;9;6;15;18164;16593;49;34757
03;2021-04-30;6;6;12;13469;13557;59;27026
03;2021-04-30;6;8;14;8776;8670;69;17446
03;2021-04-30;3;0;3;3777;3591;79;7368
03;2021-04-30;0;0;0;1649;1072;89;2721
03;2021-04-30;0;0;0;485;184;90;669
03;2021-04-30;67;48;116;149547;141144;0;290691
04;2021-04-30;9;4;13;60314;61377;09;121691
04;2021-04-30;17;20;37;66065;68387;19;134452
04;2021-04-30;16;8;24;51059;47156;29;98215
04;2021-04-30;20;10;30;58788;45780;39;104568
04;2021-04-30;19;12;31;61408;52207;49;113615
04;2021-04-30;14;11;25;64838;60759;59;125597
04;2021-04-30;12;11;23;47008;42843;69;89851
04;2021-04-30;4;4;8;25509;21184;79;46693
04;2021-04-30;3;1;4;13168;7647;89;20815
04;2021-04-30;1;0;1;3209;1253;90;4462
04;2021-04-30;115;81;196;451366;408593;0;859959
05;2021-04-30;0;0;0;362.366008612902;341.338819562748;09;703.704828175651
05;2021-04-30;0;0;0;353.376145114279;370.349735405642;19;723.725880519921
05;2021-04-30;0;0;0;218.593559489256;256.539602589476;29;475.133162078732
05;2021-04-30;0;0;0;404.225408693299;360.321910454353;39;764.547319147651
05;2021-04-30;0;0;0;520.067953604221;497.108383964256;49;1017.17633756848
05;2021-04-30;0;0;0;468.146063921917;510.087601910415;59;978.233665832332
05;2021-04-30;0;0;0;340.368470050554;334.366842191253;69;674.735312241807
05;2021-04-30;0;0;0;212.598666888387;192.597753227106;79;405.196420115493
05;2021-04-30;0;0;0;148.727797095705;61.8681715431829;89;210.595968638888
05;2021-04-30;0;0;0;32.9601271090696;10.9909785719784;90;43.9511056810479
05;2021-04-30;0;0;0;3061.43020057959;2935.56979942041;0;5997
06;2021-04-30;0;0;0;42583;42380;09;84963
06;2021-04-30;0;1;2;33369;31925;19;65294
06;2021-04-30;1;2;3;21571;15080;29;36651
06;2021-04-30;2;2;4;21550;16147;39;37697
06;2021-04-30;0;0;0;14193;13939;49;28132
06;2021-04-30;2;2;4;7171;7597;59;14768
06;2021-04-30;0;3;3;3629;4117;69;7746
06;2021-04-30;0;0;0;1577;1457;79;3034
06;2021-04-30;0;0;0;531;474;89;1005
06;2021-04-30;0;0;0;88;93;90;181
06;2021-04-30;5;10;16;146262;133209;0;279471
07;2021-04-30;0;0;0;485;549;09;1034
07;2021-04-30;0;0;0;403;432;19;835
07;2021-04-30;0;1;1;764;841;29;1605
07;2021-04-30;1;0;1;824;928;39;1752
07;2021-04-30;0;0;0;788;1020;49;1808
07;2021-04-30;0;0;0;678;870;59;1548
07;2021-04-30;0;0;0;360;382;69;742
07;2021-04-30;0;0;0;231;190;79;421
07;2021-04-30;0;0;0;114;67;89;181
07;2021-04-30;0;0;0;24;11;90;35
07;2021-04-30;1;1;2;4671;5290;0;9961
08;2021-04-30;0;0;0;2715.22592983026;2997.75551488675;09;5712.98144471701
08;2021-04-30;0;0;0;2778.51901080978;3160.9156459093;19;5939.43465671908
08;2021-04-30;1;1;2;2080.8882988764;1718.16634315323;29;3799.05464202964
08;2021-04-30;1;0;1;2701.8582062647;1896.52641413317;39;4598.38462039786
08;2021-04-30;2;0;2;3151.45861023308;2460.52498233809;49;5611.98359257117
08;2021-04-30;2;0;2;2620.29868333099;2422.23566154656;59;5042.53434487755
08;2021-04-30;1;0;1;1621.44173420671;1438.58325779464;69;3060.02499200135
08;2021-04-30;0;0;0;626.575909335673;526.358467843651;79;1152.93437717932
08;2021-04-30;0;0;0;205.018522985054;140.993639349697;89;346.012162334751
08;2021-04-30;0;0;0;50.0325684687745;20.62259870351;90;70.6551671722846
08;2021-04-30;7;1;8;18551.3174743414;16782.6825256586;0;35334
11;2021-04-30;242;205;474;783071;811785;09;1594856
11;2021-04-30;520;526;1075;761456;784653;19;1546109
11;2021-04-30;731;632;1378;850145;801772;29;1651917
11;2021-04-30;638;633;1282;914360;843488;39;1757848
11;2021-04-30;553;525;1082;845609;826202;49;1671811
11;2021-04-30;510;444;959;793566;745070;59;1538636
11;2021-04-30;259;258;519;628649;549192;69;1177841
11;2021-04-30;117;92;210;434606;358356;79;792962
11;2021-04-30;70;41;111;261425;162933;89;424358
11;2021-04-30;38;13;51;89253;32619;90;121872
11;2021-04-30;3678;3369;7141;6362140;5916070;0;12278210
24;2021-04-30;31;20;52;139720;144686;09;284406
24;2021-04-30;55;92;148;152979;161185;19;314164
24;2021-04-30;85;84;170;122237;126536;29;248773
24;2021-04-30;68;65;133;150359;142009;39;292368
24;2021-04-30;66;72;138;161829;158758;49;320587
24;2021-04-30;69;66;135;172552;168011;59;340563
24;2021-04-30;47;50;97;172509;158177;69;330686
24;2021-04-30;19;26;45;129428;110593;79;240021
24;2021-04-30;17;13;30;87342;56882;89;144224
24;2021-04-30;1;5;6;31210;12071;90;43281
24;2021-04-30;458;493;954;1320165;1238908;0;2559073
27;2021-04-30;21;17;38;143373;149679;09;293052
27;2021-04-30;79;72;151;160962;173003;19;333965
27;2021-04-30;66;84;150;133746;142254;29;276000
27;2021-04-30;77;49;126;160004;155407;39;315411
27;2021-04-30;65;66;132;172333;169564;49;341897
27;2021-04-30;67;42;109;189979;183788;59;373767
27;2021-04-30;43;53;96;192591;178206;69;370797
27;2021-04-30;28;27;55;146876;127546;79;274422
27;2021-04-30;8;7;15;96896;61575;89;158471
27;2021-04-30;11;2;13;33148;12109;90;45257
27;2021-04-30;465;419;885;1429908;1353131;0;2783039
28;2021-04-30;51;58;115;180735;186856;09;367591
28;2021-04-30;98;111;211;200125;213621;19;413746
28;2021-04-30;124;104;229;168922;173007;29;341929
28;2021-04-30;103;101;204;196628;188487;39;385115
28;2021-04-30;107;99;207;205396;201699;49;407095
28;2021-04-30;86;66;153;222002;213866;59;435868
28;2021-04-30;69;59;128;224688;203758;69;428446
28;2021-04-30;37;28;65;163192;135543;79;298735
28;2021-04-30;24;11;35;109691;65377;89;175068
28;2021-04-30;10;9;19;37222;12685;90;49907
28;2021-04-30;710;646;1367;1708601;1594899;0;3303500
32;2021-04-30;155;143;301;358062;373689;09;731751
32;2021-04-30;232;268;505;387045;406742;19;793787
32;2021-04-30;216;207;427;342304;348587;29;690891
32;2021-04-30;226;219;446;382485;369972;39;752457
32;2021-04-30;220;182;404;382510;376716;49;759226
32;2021-04-30;184;193;377;386937;376527;59;763464
32;2021-04-30;119;106;225;371211;330938;69;702149
32;2021-04-30;57;58;116;250542;201459;79;452001
32;2021-04-30;35;25;60;163399;89786;89;253185
32;2021-04-30;26;8;34;48384;15367;90;63751
32;2021-04-30;1470;1409;2895;3072879;2889783;0;5962662
44;2021-04-30;77;93;172;291525;306839;09;598364
44;2021-04-30;168;136;307;320255;339504;19;659759
44;2021-04-30;174;146;321;302020;314428;29;616448
44;2021-04-30;143;136;280;342222;333292;39;675514
44;2021-04-30;145;117;263;349727;344491;49;694218
44;2021-04-30;112;136;249;381371;373239;59;754610
44;2021-04-30;75;79;157;367165;335850;69;703015
44;2021-04-30;38;50;88;250387;215436;79;465823
44;2021-04-30;26;9;35;170825;105192;89;276017
44;2021-04-30;9;6;15;51248;16731;90;67979
44;2021-04-30;967;908;1887;2826745;2685002;0;5511747
52;2021-04-30;39;63;103;213594;223900;09;437494
52;2021-04-30;129;97;229;240818;255197;19;496015
52;2021-04-30;87;89;176;197010;200630;29;397640
52;2021-04-30;73;71;145;231204;224885;39;456089
52;2021-04-30;109;84;194;243874;243418;49;487292
52;2021-04-30;69;73;142;244100;239116;59;483216
52;2021-04-30;38;74;113;241796;221345;69;463141
52;2021-04-30;21;22;43;177805;149903;79;327708
52;2021-04-30;16;5;21;119561;75822;89;195383
52;2021-04-30;5;4;9;42559;15260;90;57819
52;2021-04-30;586;582;1175;1952321;1849476;0;3801797
53;2021-04-30;43;31;74;173813;182358;09;356171
53;2021-04-30;60;77;137;202720;214740;19;417460
53;2021-04-30;71;78;149;163116;173196;29;336312
53;2021-04-30;59;53;112;190526;187674;39;378200
53;2021-04-30;52;41;93;212098;212015;49;424113
53;2021-04-30;49;67;116;223699;219176;59;442875
53;2021-04-30;29;24;53;227435;209274;69;436709
53;2021-04-30;18;17;35;169992;140910;79;310902
53;2021-04-30;11;8;19;118117;69883;89;188000
53;2021-04-30;10;3;13;37370;12267;90;49637
53;2021-04-30;402;399;801;1718886;1621493;0;3340379
75;2021-04-30;49;47;96;293104;305291;09;598395
75;2021-04-30;98;101;201;337141;357785;19;694926
75;2021-04-30;86;113;199;295024;300618;29;595642
75;2021-04-30;85;78;163;347871;331233;39;679104
75;2021-04-30;106;82;188;384742;372771;49;757513
75;2021-04-30;79;109;189;413361;390880;59;804241
75;2021-04-30;64;60;124;425623;384060;69;809683
75;2021-04-30;25;32;57;325086;276298;79;601384
75;2021-04-30;33;21;54;213986;139308;89;353294
75;2021-04-30;17;4;21;77600;28200;90;105800
75;2021-04-30;643;649;1295;3113538;2886444;0;5999982
76;2021-04-30;52;52;110;305956;318589;09;624545
76;2021-04-30;168;156;330;338942;356969;19;695911
76;2021-04-30;156;157;314;316210;319570;29;635780
76;2021-04-30;117;128;248;356758;337587;39;694345
76;2021-04-30;145;112;258;376541;363812;49;740353
76;2021-04-30;123;119;243;402608;383750;59;786358
76;2021-04-30;74;81;155;394889;358997;69;753886
76;2021-04-30;45;34;79;308664;263806;79;572470
76;2021-04-30;30;17;47;195838;129272;89;325110
76;2021-04-30;13;8;21;69372;26728;90;96100
76;2021-04-30;923;866;1807;3065778;2859080;0;5924858
84;2021-04-30;129;129;258;459549;481088;09;940637
84;2021-04-30;237;268;506;487711;511905;19;999616
84;2021-04-30;249;247;497;443824;451094;29;894918
84;2021-04-30;199;231;431;512522;493262;39;1005784
84;2021-04-30;207;210;418;520248;515106;49;1035354
84;2021-04-30;198;209;407;529611;514848;59;1044459
84;2021-04-30;102;125;227;486720;439940;69;926660
84;2021-04-30;64;62;126;372151;315211;79;687362
84;2021-04-30;52;28;80;237198;150524;89;387722
84;2021-04-30;24;9;33;81185;28680;90;109865
84;2021-04-30;1461;1518;2983;4130719;3901658;0;8032377
93;2021-04-30;67;68;135;268834;283093;09;551927
93;2021-04-30;151;162;314;280751;296087;19;576838
93;2021-04-30;149;127;276;254404;255552;29;509956
93;2021-04-30;169;139;310;310704;288398;39;599102
93;2021-04-30;152;149;301;325559;305827;49;631386
93;2021-04-30;146;134;281;353104;325389;59;678493
93;2021-04-30;97;107;204;336327;296459;69;632786
93;2021-04-30;42;44;86;279820;229699;79;509519
93;2021-04-30;32;25;57;171274;113716;89;284990
93;2021-04-30;17;8;25;58896;21758;90;80654
93;2021-04-30;1022;963;1989;2639673;2415978;0;5055651
94;2021-04-30;1;1;2;16311;17433;09;33744
94;2021-04-30;9;5;14;16679;18132;19;34811
94;2021-04-30;9;10;19;16782;16579;29;33361
94;2021-04-30;5;3;8;23044;20580;39;43624
94;2021-04-30;4;1;5;23065;22140;49;45205
94;2021-04-30;2;3;5;24549;23421;59;47970
94;2021-04-30;0;1;1;23212;21883;69;45095
94;2021-04-30;3;1;4;19544;17141;79;36685
94;2021-04-30;5;1;6;11227;8178;89;19405
94;2021-04-30;3;0;3;3332;1447;90;4779
94;2021-04-30;41;26;67;177745;166934;0;344679
01;2021-05-01;1;0;1;19979;20155;09;40134
01;2021-05-01;0;2;2;24994;25489;19;50483
01;2021-05-01;1;1;2;17868;16690;29;34558
01;2021-05-01;0;2;2;22328;14821;39;37149
01;2021-05-01;3;2;5;28652;20276;49;48928
01;2021-05-01;1;2;3;33264;27260;59;60524
01;2021-05-01;0;2;2;27135;23978;69;51113
01;2021-05-01;3;1;4;18401;14661;79;33062
01;2021-05-01;1;1;2;9633;6375;89;16008
01;2021-05-01;0;0;0;3410;1510;90;4920
01;2021-05-01;10;13;23;205664;171215;0;376879
02;2021-05-01;0;0;0;16881;17110;09;33991
02;2021-05-01;0;0;0;21410;21604;19;43014
02;2021-05-01;0;1;1;16017;15479;29;31496
02;2021-05-01;1;1;2;19825;14455;39;34280
02;2021-05-01;0;0;0;24719;18248;49;42967
02;2021-05-01;2;0;2;34361;28310;59;62671
02;2021-05-01;0;3;3;28061;24495;69;52556
02;2021-05-01;0;2;2;18231;15278;79;33509
02;2021-05-01;0;0;0;11090;7677;89;18767
02;2021-05-01;0;1;1;3992;1506;90;5498
02;2021-05-01;3;8;11;194587;164162;0;358749
03;2021-05-01;0;2;2;31123;30920;09;62043
03;2021-05-01;0;4;4;29370;29268;19;58638
03;2021-05-01;1;2;3;21458;18963;29;40421
03;2021-05-01;2;2;4;21276;18326;39;39602
03;2021-05-01;3;2;5;18164;16593;49;34757
03;2021-05-01;2;0;2;13469;13557;59;27026
03;2021-05-01;1;2;3;8776;8670;69;17446
03;2021-05-01;2;1;3;3777;3591;79;7368
03;2021-05-01;0;0;0;1649;1072;89;2721
03;2021-05-01;0;0;0;485;184;90;669
03;2021-05-01;11;15;26;149547;141144;0;290691
04;2021-05-01;1;1;2;60314;61377;09;121691
04;2021-05-01;3;5;8;66065;68387;19;134452
04;2021-05-01;4;2;6;51059;47156;29;98215
04;2021-05-01;4;2;6;58788;45780;39;104568
04;2021-05-01;3;6;9;61408;52207;49;113615
04;2021-05-01;2;5;7;64838;60759;59;125597
04;2021-05-01;3;3;6;47008;42843;69;89851
04;2021-05-01;4;1;5;25509;21184;79;46693
04;2021-05-01;1;2;3;13168;7647;89;20815
04;2021-05-01;2;0;2;3209;1253;90;4462
04;2021-05-01;27;27;54;451366;408593;0;859959
05;2021-05-01;0;0;0;362.366008612902;341.338819562748;09;703.704828175651
05;2021-05-01;0;0;0;353.376145114279;370.349735405642;19;723.725880519921
05;2021-05-01;0;0;0;218.593559489256;256.539602589476;29;475.133162078732
05;2021-05-01;0;0;0;404.225408693299;360.321910454353;39;764.547319147651
05;2021-05-01;0;0;0;520.067953604221;497.108383964256;49;1017.17633756848
05;2021-05-01;0;0;0;468.146063921917;510.087601910415;59;978.233665832332
05;2021-05-01;0;0;0;340.368470050554;334.366842191253;69;674.735312241807
05;2021-05-01;0;0;0;212.598666888387;192.597753227106;79;405.196420115493
05;2021-05-01;0;0;0;148.727797095705;61.8681715431829;89;210.595968638888
05;2021-05-01;0;0;0;32.9601271090696;10.9909785719784;90;43.9511056810479
05;2021-05-01;0;0;0;3061.43020057959;2935.56979942041;0;5997
06;2021-05-01;0;0;0;42583;42380;09;84963
06;2021-05-01;0;2;2;33369;31925;19;65294
06;2021-05-01;0;0;0;21571;15080;29;36651
06;2021-05-01;0;0;0;21550;16147;39;37697
06;2021-05-01;0;0;0;14193;13939;49;28132
06;2021-05-01;0;0;0;7171;7597;59;14768
06;2021-05-01;0;0;0;3629;4117;69;7746
06;2021-05-01;0;1;1;1577;1457;79;3034
06;2021-05-01;0;0;0;531;474;89;1005
06;2021-05-01;0;0;0;88;93;90;181
06;2021-05-01;0;3;3;146262;133209;0;279471
07;2021-05-01;0;0;0;485;549;09;1034
07;2021-05-01;0;0;0;403;432;19;835
07;2021-05-01;0;0;0;764;841;29;1605
07;2021-05-01;0;0;0;824;928;39;1752
07;2021-05-01;0;0;0;788;1020;49;1808
07;2021-05-01;0;0;0;678;870;59;1548
07;2021-05-01;0;0;0;360;382;69;742
07;2021-05-01;0;0;0;231;190;79;421
07;2021-05-01;0;0;0;114;67;89;181
07;2021-05-01;0;0;0;24;11;90;35
07;2021-05-01;0;0;0;4671;5290;0;9961
08;2021-05-01;0;0;0;2715.22592983026;2997.75551488675;09;5712.98144471701
08;2021-05-01;0;0;0;2778.51901080978;3160.9156459093;19;5939.43465671908
08;2021-05-01;0;1;1;2080.8882988764;1718.16634315323;29;3799.05464202964
08;2021-05-01;0;0;0;2701.8582062647;1896.52641413317;39;4598.38462039786
08;2021-05-01;0;0;0;3151.45861023308;2460.52498233809;49;5611.98359257117
08;2021-05-01;0;0;0;2620.29868333099;2422.23566154656;59;5042.53434487755
08;2021-05-01;1;1;2;1621.44173420671;1438.58325779464;69;3060.02499200135
08;2021-05-01;0;0;0;626.575909335673;526.358467843651;79;1152.93437717932
08;2021-05-01;0;0;0;205.018522985054;140.993639349697;89;346.012162334751
08;2021-05-01;0;0;0;50.0325684687745;20.62259870351;90;70.6551671722846
08;2021-05-01;1;2;3;18551.3174743414;16782.6825256586;0;35334
11;2021-05-01;37;39;79;783071;811785;09;1594856
11;2021-05-01;78;83;167;761456;784653;19;1546109
11;2021-05-01;154;138;294;850145;801772;29;1651917
11;2021-05-01;131;127;261;914360;843488;39;1757848
11;2021-05-01;121;89;212;845609;826202;49;1671811
11;2021-05-01;87;75;162;793566;745070;59;1538636
11;2021-05-01;56;50;106;628649;549192;69;1177841
11;2021-05-01;29;29;58;434606;358356;79;792962
11;2021-05-01;18;8;26;261425;162933;89;424358
11;2021-05-01;8;8;16;89253;32619;90;121872
11;2021-05-01;719;647;1382;6362140;5916070;0;12278210
24;2021-05-01;3;2;5;139720;144686;09;284406
24;2021-05-01;8;8;16;152979;161185;19;314164
24;2021-05-01;18;12;30;122237;126536;29;248773
24;2021-05-01;12;11;23;150359;142009;39;292368
24;2021-05-01;8;12;20;161829;158758;49;320587
24;2021-05-01;17;10;27;172552;168011;59;340563
24;2021-05-01;2;8;10;172509;158177;69;330686
24;2021-05-01;3;5;8;129428;110593;79;240021
24;2021-05-01;4;4;8;87342;56882;89;144224
24;2021-05-01;4;1;5;31210;12071;90;43281
24;2021-05-01;79;73;152;1320165;1238908;0;2559073
27;2021-05-01;5;5;10;143373;149679;09;293052
27;2021-05-01;5;4;9;160962;173003;19;333965
27;2021-05-01;8;10;18;133746;142254;29;276000
27;2021-05-01;11;8;19;160004;155407;39;315411
27;2021-05-01;8;11;19;172333;169564;49;341897
27;2021-05-01;5;3;8;189979;183788;59;373767
27;2021-05-01;7;4;11;192591;178206;69;370797
27;2021-05-01;3;4;7;146876;127546;79;274422
27;2021-05-01;0;5;5;96896;61575;89;158471
27;2021-05-01;4;1;5;33148;12109;90;45257
27;2021-05-01;56;55;111;1429908;1353131;0;2783039
28;2021-05-01;11;4;16;180735;186856;09;367591
28;2021-05-01;22;12;34;200125;213621;19;413746
28;2021-05-01;23;15;38;168922;173007;29;341929
28;2021-05-01;23;19;42;196628;188487;39;385115
28;2021-05-01;22;14;36;205396;201699;49;407095
28;2021-05-01;11;14;25;222002;213866;59;435868
28;2021-05-01;8;7;15;224688;203758;69;428446
28;2021-05-01;6;7;13;163192;135543;79;298735
28;2021-05-01;11;4;15;109691;65377;89;175068
28;2021-05-01;4;1;5;37222;12685;90;49907
28;2021-05-01;141;97;239;1708601;1594899;0;3303500
32;2021-05-01;9;18;27;358062;373689;09;731751
32;2021-05-01;26;36;63;387045;406742;19;793787
32;2021-05-01;49;36;86;342304;348587;29;690891
32;2021-05-01;32;31;63;382485;369972;39;752457
32;2021-05-01;31;40;72;382510;376716;49;759226
32;2021-05-01;25;29;54;386937;376527;59;763464
32;2021-05-01;14;19;33;371211;330938;69;702149
32;2021-05-01;7;9;16;250542;201459;79;452001
32;2021-05-01;6;13;19;163399;89786;89;253185
32;2021-05-01;3;1;4;48384;15367;90;63751
32;2021-05-01;202;232;437;3072879;2889783;0;5962662
44;2021-05-01;4;6;10;291525;306839;09;598364
44;2021-05-01;15;10;25;320255;339504;19;659759
44;2021-05-01;23;26;49;302020;314428;29;616448
44;2021-05-01;28;23;51;342222;333292;39;675514
44;2021-05-01;22;9;31;349727;344491;49;694218
44;2021-05-01;22;24;46;381371;373239;59;754610
44;2021-05-01;8;9;17;367165;335850;69;703015
44;2021-05-01;6;10;16;250387;215436;79;465823
44;2021-05-01;6;4;10;170825;105192;89;276017
44;2021-05-01;4;0;4;51248;16731;90;67979
44;2021-05-01;138;121;259;2826745;2685002;0;5511747
52;2021-05-01;9;12;21;213594;223900;09;437494
52;2021-05-01;20;25;46;240818;255197;19;496015
52;2021-05-01;27;22;49;197010;200630;29;397640
52;2021-05-01;22;17;39;231204;224885;39;456089
52;2021-05-01;28;23;51;243874;243418;49;487292
52;2021-05-01;19;33;52;244100;239116;59;483216
52;2021-05-01;10;6;16;241796;221345;69;463141
52;2021-05-01;3;3;6;177805;149903;79;327708
52;2021-05-01;3;2;5;119561;75822;89;195383
52;2021-05-01;2;2;4;42559;15260;90;57819
52;2021-05-01;143;145;289;1952321;1849476;0;3801797
53;2021-05-01;6;9;15;173813;182358;09;356171
53;2021-05-01;26;13;39;202720;214740;19;417460
53;2021-05-01;27;16;43;163116;173196;29;336312
53;2021-05-01;12;10;22;190526;187674;39;378200
53;2021-05-01;17;8;25;212098;212015;49;424113
53;2021-05-01;9;16;25;223699;219176;59;442875
53;2021-05-01;6;7;13;227435;209274;69;436709
53;2021-05-01;2;6;8;169992;140910;79;310902
53;2021-05-01;3;5;8;118117;69883;89;188000
53;2021-05-01;4;1;5;37370;12267;90;49637
53;2021-05-01;112;91;203;1718886;1621493;0;3340379
75;2021-05-01;8;7;15;293104;305291;09;598395
75;2021-05-01;14;13;27;337141;357785;19;694926
75;2021-05-01;23;26;49;295024;300618;29;595642
75;2021-05-01;17;17;34;347871;331233;39;679104
75;2021-05-01;5;16;21;384742;372771;49;757513
75;2021-05-01;11;14;25;413361;390880;59;804241
75;2021-05-01;6;11;17;425623;384060;69;809683
75;2021-05-01;7;2;9;325086;276298;79;601384
75;2021-05-01;14;5;19;213986;139308;89;353294
75;2021-05-01;2;2;4;77600;28200;90;105800
75;2021-05-01;107;113;220;3113538;2886444;0;5999982
76;2021-05-01;6;7;13;305956;318589;09;624545
76;2021-05-01;20;10;30;338942;356969;19;695911
76;2021-05-01;27;25;52;316210;319570;29;635780
76;2021-05-01;17;21;38;356758;337587;39;694345
76;2021-05-01;15;22;37;376541;363812;49;740353
76;2021-05-01;13;15;28;402608;383750;59;786358
76;2021-05-01;13;9;22;394889;358997;69;753886
76;2021-05-01;11;9;20;308664;263806;79;572470
76;2021-05-01;3;4;7;195838;129272;89;325110
76;2021-05-01;5;1;6;69372;26728;90;96100
76;2021-05-01;130;123;253;3065778;2859080;0;5924858
84;2021-05-01;11;14;26;459549;481088;09;940637
84;2021-05-01;41;26;68;487711;511905;19;999616
84;2021-05-01;38;27;65;443824;451094;29;894918
84;2021-05-01;46;40;86;512522;493262;39;1005784
84;2021-05-01;42;36;78;520248;515106;49;1035354
84;2021-05-01;24;35;59;529611;514848;59;1044459
84;2021-05-01;21;15;36;486720;439940;69;926660
84;2021-05-01;13;12;25;372151;315211;79;687362
84;2021-05-01;8;6;14;237198;150524;89;387722
84;2021-05-01;6;1;7;81185;28680;90;109865
84;2021-05-01;250;212;464;4130719;3901658;0;8032377
93;2021-05-01;3;9;12;268834;283093;09;551927
93;2021-05-01;13;15;28;280751;296087;19;576838
93;2021-05-01;23;11;34;254404;255552;29;509956
93;2021-05-01;31;21;52;310704;288398;39;599102
93;2021-05-01;18;25;43;325559;305827;49;631386
93;2021-05-01;19;26;45;353104;325389;59;678493
93;2021-05-01;11;8;20;336327;296459;69;632786
93;2021-05-01;5;6;11;279820;229699;79;509519
93;2021-05-01;7;3;10;171274;113716;89;284990
93;2021-05-01;3;0;3;58896;21758;90;80654
93;2021-05-01;133;124;258;2639673;2415978;0;5055651
94;2021-05-01;2;0;2;16311;17433;09;33744
94;2021-05-01;0;1;1;16679;18132;19;34811
94;2021-05-01;0;0;0;16782;16579;29;33361
94;2021-05-01;0;2;2;23044;20580;39;43624
94;2021-05-01;1;2;3;23065;22140;49;45205
94;2021-05-01;1;0;1;24549;23421;59;47970
94;2021-05-01;1;1;2;23212;21883;69;45095
94;2021-05-01;0;1;1;19544;17141;79;36685
94;2021-05-01;1;0;1;11227;8178;89;19405
94;2021-05-01;0;0;0;3332;1447;90;4779
94;2021-05-01;6;7;13;177745;166934;0;344679
01;2021-05-02;1;0;1;19979;20155;09;40134
01;2021-05-02;0;1;1;24994;25489;19;50483
01;2021-05-02;0;0;0;17868;16690;29;34558
01;2021-05-02;1;2;3;22328;14821;39;37149
01;2021-05-02;3;2;5;28652;20276;49;48928
01;2021-05-02;3;1;4;33264;27260;59;60524
01;2021-05-02;0;3;3;27135;23978;69;51113
01;2021-05-02;0;1;1;18401;14661;79;33062
01;2021-05-02;1;1;2;9633;6375;89;16008
01;2021-05-02;0;0;0;3410;1510;90;4920
01;2021-05-02;9;11;20;205664;171215;0;376879
02;2021-05-02;0;0;0;16881;17110;09;33991
02;2021-05-02;1;0;1;21410;21604;19;43014
02;2021-05-02;1;0;1;16017;15479;29;31496
02;2021-05-02;0;1;1;19825;14455;39;34280
02;2021-05-02;0;1;1;24719;18248;49;42967
02;2021-05-02;0;1;1;34361;28310;59;62671
02;2021-05-02;2;0;2;28061;24495;69;52556
02;2021-05-02;0;1;1;18231;15278;79;33509
02;2021-05-02;0;0;0;11090;7677;89;18767
02;2021-05-02;1;0;1;3992;1506;90;5498
02;2021-05-02;5;4;9;194587;164162;0;358749
03;2021-05-02;0;0;0;31123;30920;09;62043
03;2021-05-02;0;0;0;29370;29268;19;58638
03;2021-05-02;0;0;0;21458;18963;29;40421
03;2021-05-02;0;1;1;21276;18326;39;39602
03;2021-05-02;1;0;1;18164;16593;49;34757
03;2021-05-02;0;0;0;13469;13557;59;27026
03;2021-05-02;2;2;4;8776;8670;69;17446
03;2021-05-02;0;1;1;3777;3591;79;7368
03;2021-05-02;0;1;1;1649;1072;89;2721
03;2021-05-02;0;0;0;485;184;90;669
03;2021-05-02;3;5;8;149547;141144;0;290691
04;2021-05-02;0;1;1;60314;61377;09;121691
04;2021-05-02;4;4;8;66065;68387;19;134452
04;2021-05-02;5;5;10;51059;47156;29;98215
04;2021-05-02;6;1;7;58788;45780;39;104568
04;2021-05-02;9;6;15;61408;52207;49;113615
04;2021-05-02;5;5;10;64838;60759;59;125597
04;2021-05-02;5;5;10;47008;42843;69;89851
04;2021-05-02;5;1;6;25509;21184;79;46693
04;2021-05-02;3;1;4;13168;7647;89;20815
04;2021-05-02;4;0;4;3209;1253;90;4462
04;2021-05-02;46;29;75;451366;408593;0;859959
05;2021-05-02;0;0;0;362.366008612902;341.338819562748;09;703.704828175651
05;2021-05-02;0;0;0;353.376145114279;370.349735405642;19;723.725880519921
05;2021-05-02;0;0;0;218.593559489256;256.539602589476;29;475.133162078732
05;2021-05-02;0;0;0;404.225408693299;360.321910454353;39;764.547319147651
05;2021-05-02;0;0;0;520.067953604221;497.108383964256;49;1017.17633756848
05;2021-05-02;0;0;0;468.146063921917;510.087601910415;59;978.233665832332
05;2021-05-02;0;0;0;340.368470050554;334.366842191253;69;674.735312241807
05;2021-05-02;0;0;0;212.598666888387;192.597753227106;79;405.196420115493
05;2021-05-02;0;0;0;148.727797095705;61.8681715431829;89;210.595968638888
05;2021-05-02;0;0;0;32.9601271090696;10.9909785719784;90;43.9511056810479
05;2021-05-02;0;0;0;3061.43020057959;2935.56979942041;0;5997
06;2021-05-02;0;0;0;42583;42380;09;84963
06;2021-05-02;0;0;0;33369;31925;19;65294
06;2021-05-02;0;0;0;21571;15080;29;36651
06;2021-05-02;0;0;0;21550;16147;39;37697
06;2021-05-02;0;0;0;14193;13939;49;28132
06;2021-05-02;0;0;0;7171;7597;59;14768
06;2021-05-02;1;0;1;3629;4117;69;7746
06;2021-05-02;0;0;0;1577;1457;79;3034
06;2021-05-02;0;0;0;531;474;89;1005
06;2021-05-02;0;0;0;88;93;90;181
06;2021-05-02;1;0;1;146262;133209;0;279471
07;2021-05-02;0;0;0;485;549;09;1034
07;2021-05-02;0;0;0;403;432;19;835
07;2021-05-02;0;0;0;764;841;29;1605
07;2021-05-02;0;0;0;824;928;39;1752
07;2021-05-02;0;0;0;788;1020;49;1808
07;2021-05-02;0;0;0;678;870;59;1548
07;2021-05-02;0;0;0;360;382;69;742
07;2021-05-02;0;0;0;231;190;79;421
07;2021-05-02;0;0;0;114;67;89;181
07;2021-05-02;0;0;0;24;11;90;35
07;2021-05-02;0;0;0;4671;5290;0;9961
08;2021-05-02;0;0;0;2715.22592983026;2997.75551488675;09;5712.98144471701
08;2021-05-02;0;0;0;2778.51901080978;3160.9156459093;19;5939.43465671908
08;2021-05-02;0;0;0;2080.8882988764;1718.16634315323;29;3799.05464202964
08;2021-05-02;0;0;0;2701.8582062647;1896.52641413317;39;4598.38462039786
08;2021-05-02;0;0;0;3151.45861023308;2460.52498233809;49;5611.98359257117
08;2021-05-02;0;0;0;2620.29868333099;2422.23566154656;59;5042.53434487755
08;2021-05-02;1;0;1;1621.44173420671;1438.58325779464;69;3060.02499200135
08;2021-05-02;0;0;0;626.575909335673;526.358467843651;79;1152.93437717932
08;2021-05-02;0;0;0;205.018522985054;140.993639349697;89;346.012162334751
08;2021-05-02;0;0;0;50.0325684687745;20.62259870351;90;70.6551671722846
08;2021-05-02;1;0;1;18551.3174743414;16782.6825256586;0;35334
11;2021-05-02;46;36;82;783071;811785;09;1594856
11;2021-05-02;76;66;144;761456;784653;19;1546109
11;2021-05-02;131;147;286;850145;801772;29;1651917
11;2021-05-02;130;131;262;914360;843488;39;1757848
11;2021-05-02;79;108;189;845609;826202;49;1671811
11;2021-05-02;68;82;153;793566;745070;59;1538636
11;2021-05-02;32;51;83;628649;549192;69;1177841
11;2021-05-02;25;31;56;434606;358356;79;792962
11;2021-05-02;24;10;34;261425;162933;89;424358
11;2021-05-02;9;5;14;89253;32619;90;121872
11;2021-05-02;620;668;1304;6362140;5916070;0;12278210
24;2021-05-02;0;3;3;139720;144686;09;284406
24;2021-05-02;6;4;10;152979;161185;19;314164
24;2021-05-02;8;6;14;122237;126536;29;248773
24;2021-05-02;5;7;12;150359;142009;39;292368
24;2021-05-02;6;4;10;161829;158758;49;320587
24;2021-05-02;3;6;9;172552;168011;59;340563
24;2021-05-02;6;5;11;172509;158177;69;330686
24;2021-05-02;6;4;10;129428;110593;79;240021
24;2021-05-02;5;6;11;87342;56882;89;144224
24;2021-05-02;3;0;3;31210;12071;90;43281
24;2021-05-02;48;45;93;1320165;1238908;0;2559073
27;2021-05-02;2;5;7;143373;149679;09;293052
27;2021-05-02;6;6;12;160962;173003;19;333965
27;2021-05-02;4;3;7;133746;142254;29;276000
27;2021-05-02;5;3;8;160004;155407;39;315411
27;2021-05-02;5;2;7;172333;169564;49;341897
27;2021-05-02;14;5;19;189979;183788;59;373767
27;2021-05-02;4;3;7;192591;178206;69;370797
27;2021-05-02;5;6;11;146876;127546;79;274422
27;2021-05-02;3;4;7;96896;61575;89;158471
27;2021-05-02;2;1;3;33148;12109;90;45257
27;2021-05-02;50;38;88;1429908;1353131;0;2783039
28;2021-05-02;4;3;7;180735;186856;09;367591
28;2021-05-02;16;14;30;200125;213621;19;413746
28;2021-05-02;14;12;26;168922;173007;29;341929
28;2021-05-02;15;14;29;196628;188487;39;385115
28;2021-05-02;14;11;25;205396;201699;49;407095
28;2021-05-02;9;15;24;222002;213866;59;435868
28;2021-05-02;7;10;17;224688;203758;69;428446
28;2021-05-02;5;6;11;163192;135543;79;298735
28;2021-05-02;1;2;3;109691;65377;89;175068
28;2021-05-02;4;2;6;37222;12685;90;49907
28;2021-05-02;89;89;178;1708601;1594899;0;3303500
32;2021-05-02;25;16;41;358062;373689;09;731751
32;2021-05-02;40;33;75;387045;406742;19;793787
32;2021-05-02;57;47;105;342304;348587;29;690891
32;2021-05-02;41;34;75;382485;369972;39;752457
32;2021-05-02;39;33;72;382510;376716;49;759226
32;2021-05-02;24;44;69;386937;376527;59;763464
32;2021-05-02;14;17;31;371211;330938;69;702149
32;2021-05-02;9;14;23;250542;201459;79;452001
32;2021-05-02;10;8;18;163399;89786;89;253185
32;2021-05-02;6;1;7;48384;15367;90;63751
32;2021-05-02;265;247;517;3072879;2889783;0;5962662
44;2021-05-02;12;2;14;291525;306839;09;598364
44;2021-05-02;13;11;24;320255;339504;19;659759
44;2021-05-02;16;15;31;302020;314428;29;616448
44;2021-05-02;21;14;35;342222;333292;39;675514
44;2021-05-02;12;20;32;349727;344491;49;694218
44;2021-05-02;13;13;26;381371;373239;59;754610
44;2021-05-02;9;6;15;367165;335850;69;703015
44;2021-05-02;6;3;9;250387;215436;79;465823
44;2021-05-02;9;4;13;170825;105192;89;276017
44;2021-05-02;7;1;8;51248;16731;90;67979
44;2021-05-02;118;89;207;2826745;2685002;0;5511747
52;2021-05-02;11;10;23;213594;223900;09;437494
52;2021-05-02;24;25;49;240818;255197;19;496015
52;2021-05-02;15;21;36;197010;200630;29;397640
52;2021-05-02;24;14;38;231204;224885;39;456089
52;2021-05-02;26;21;47;243874;243418;49;487292
52;2021-05-02;19;21;40;244100;239116;59;483216
52;2021-05-02;6;5;11;241796;221345;69;463141
52;2021-05-02;6;2;8;177805;149903;79;327708
52;2021-05-02;4;0;4;119561;75822;89;195383
52;2021-05-02;1;0;1;42559;15260;90;57819
52;2021-05-02;136;119;257;1952321;1849476;0;3801797
53;2021-05-02;3;5;8;173813;182358;09;356171
53;2021-05-02;6;5;11;202720;214740;19;417460
53;2021-05-02;5;7;12;163116;173196;29;336312
53;2021-05-02;10;7;17;190526;187674;39;378200
53;2021-05-02;4;8;12;212098;212015;49;424113
53;2021-05-02;5;10;15;223699;219176;59;442875
53;2021-05-02;2;4;6;227435;209274;69;436709
53;2021-05-02;2;1;3;169992;140910;79;310902
53;2021-05-02;2;1;3;118117;69883;89;188000
53;2021-05-02;1;1;2;37370;12267;90;49637
53;2021-05-02;40;49;89;1718886;1621493;0;3340379
75;2021-05-02;4;4;8;293104;305291;09;598395
75;2021-05-02;6;3;9;337141;357785;19;694926
75;2021-05-02;16;12;28;295024;300618;29;595642
75;2021-05-02;14;6;20;347871;331233;39;679104
75;2021-05-02;10;6;16;384742;372771;49;757513
75;2021-05-02;3;4;7;413361;390880;59;804241
75;2021-05-02;6;4;10;425623;384060;69;809683
75;2021-05-02;3;10;13;325086;276298;79;601384
75;2021-05-02;5;5;10;213986;139308;89;353294
75;2021-05-02;4;4;8;77600;28200;90;105800
75;2021-05-02;71;58;129;3113538;2886444;0;5999982
76;2021-05-02;5;5;10;305956;318589;09;624545
76;2021-05-02;18;12;30;338942;356969;19;695911
76;2021-05-02;18;16;34;316210;319570;29;635780
76;2021-05-02;16;16;32;356758;337587;39;694345
76;2021-05-02;20;28;48;376541;363812;49;740353
76;2021-05-02;23;25;48;402608;383750;59;786358
76;2021-05-02;4;16;20;394889;358997;69;753886
76;2021-05-02;6;5;11;308664;263806;79;572470
76;2021-05-02;8;8;16;195838;129272;89;325110
76;2021-05-02;2;0;2;69372;26728;90;96100
76;2021-05-02;120;131;251;3065778;2859080;0;5924858
84;2021-05-02;7;8;15;459549;481088;09;940637
84;2021-05-02;23;21;44;487711;511905;19;999616
84;2021-05-02;28;15;43;443824;451094;29;894918
84;2021-05-02;19;27;46;512522;493262;39;1005784
84;2021-05-02;18;25;43;520248;515106;49;1035354
84;2021-05-02;15;18;33;529611;514848;59;1044459
84;2021-05-02;11;22;33;486720;439940;69;926660
84;2021-05-02;7;10;17;372151;315211;79;687362
84;2021-05-02;9;8;17;237198;150524;89;387722
84;2021-05-02;4;3;7;81185;28680;90;109865
84;2021-05-02;141;157;299;4130719;3901658;0;8032377
93;2021-05-02;10;14;24;268834;283093;09;551927
93;2021-05-02;16;15;32;280751;296087;19;576838
93;2021-05-02;31;17;48;254404;255552;29;509956
93;2021-05-02;28;16;44;310704;288398;39;599102
93;2021-05-02;19;26;45;325559;305827;49;631386
93;2021-05-02;24;16;40;353104;325389;59;678493
93;2021-05-02;13;17;30;336327;296459;69;632786
93;2021-05-02;11;9;20;279820;229699;79;509519
93;2021-05-02;11;3;14;171274;113716;89;284990
93;2021-05-02;4;1;5;58896;21758;90;80654
93;2021-05-02;168;134;303;2639673;2415978;0;5055651
94;2021-05-02;0;0;0;16311;17433;09;33744
94;2021-05-02;5;1;6;16679;18132;19;34811
94;2021-05-02;0;0;0;16782;16579;29;33361
94;2021-05-02;0;0;0;23044;20580;39;43624
94;2021-05-02;1;0;1;23065;22140;49;45205
94;2021-05-02;0;0;0;24549;23421;59;47970
94;2021-05-02;0;0;0;23212;21883;69;45095
94;2021-05-02;1;1;2;19544;17141;79;36685
94;2021-05-02;0;0;0;11227;8178;89;19405
94;2021-05-02;0;0;0;3332;1447;90;4779
94;2021-05-02;7;2;9;177745;166934;0;344679
01;2021-05-03;5;4;9;19979;20155;09;40134
01;2021-05-03;13;10;23;24994;25489;19;50483
01;2021-05-03;10;5;15;17868;16690;29;34558
01;2021-05-03;14;9;23;22328;14821;39;37149
01;2021-05-03;24;20;44;28652;20276;49;48928
01;2021-05-03;22;8;30;33264;27260;59;60524
01;2021-05-03;12;13;25;27135;23978;69;51113
01;2021-05-03;5;2;7;18401;14661;79;33062
01;2021-05-03;2;0;2;9633;6375;89;16008
01;2021-05-03;0;0;0;3410;1510;90;4920
01;2021-05-03;107;71;178;205664;171215;0;376879
02;2021-05-03;2;1;3;16881;17110;09;33991
02;2021-05-03;3;1;4;21410;21604;19;43014
02;2021-05-03;5;5;10;16017;15479;29;31496
02;2021-05-03;5;2;7;19825;14455;39;34280
02;2021-05-03;5;2;7;24719;18248;49;42967
02;2021-05-03;6;6;12;34361;28310;59;62671
02;2021-05-03;4;2;6;28061;24495;69;52556
02;2021-05-03;2;3;5;18231;15278;79;33509
02;2021-05-03;1;0;1;11090;7677;89;18767
02;2021-05-03;0;0;0;3992;1506;90;5498
02;2021-05-03;33;22;55;194587;164162;0;358749
03;2021-05-03;5;3;8;31123;30920;09;62043
03;2021-05-03;17;27;45;29370;29268;19;58638
03;2021-05-03;21;18;39;21458;18963;29;40421
03;2021-05-03;32;24;56;21276;18326;39;39602
03;2021-05-03;16;15;31;18164;16593;49;34757
03;2021-05-03;13;15;28;13469;13557;59;27026
03;2021-05-03;11;6;17;8776;8670;69;17446
03;2021-05-03;3;8;11;3777;3591;79;7368
03;2021-05-03;1;1;2;1649;1072;89;2721
03;2021-05-03;0;0;0;485;184;90;669
03;2021-05-03;119;117;237;149547;141144;0;290691
04;2021-05-03;6;4;10;60314;61377;09;121691
04;2021-05-03;17;19;37;66065;68387;19;134452
04;2021-05-03;25;12;37;51059;47156;29;98215
04;2021-05-03;29;15;44;58788;45780;39;104568
04;2021-05-03;18;18;36;61408;52207;49;113615
04;2021-05-03;26;18;44;64838;60759;59;125597
04;2021-05-03;14;11;25;47008;42843;69;89851
04;2021-05-03;5;3;8;25509;21184;79;46693
04;2021-05-03;4;1;5;13168;7647;89;20815
04;2021-05-03;0;0;0;3209;1253;90;4462
04;2021-05-03;144;101;246;451366;408593;0;859959
05;2021-05-03;0;0;0;362.366008612902;341.338819562748;09;703.704828175651
05;2021-05-03;0;0;0;353.376145114279;370.349735405642;19;723.725880519921
05;2021-05-03;0;0;0;218.593559489256;256.539602589476;29;475.133162078732
05;2021-05-03;0;0;0;404.225408693299;360.321910454353;39;764.547319147651
05;2021-05-03;0;0;0;520.067953604221;497.108383964256;49;1017.17633756848
05;2021-05-03;0;0;0;468.146063921917;510.087601910415;59;978.233665832332
05;2021-05-03;0;0;0;340.368470050554;334.366842191253;69;674.735312241807
05;2021-05-03;0;0;0;212.598666888387;192.597753227106;79;405.196420115493
05;2021-05-03;0;0;0;148.727797095705;61.8681715431829;89;210.595968638888
05;2021-05-03;0;0;0;32.9601271090696;10.9909785719784;90;43.9511056810479
05;2021-05-03;0;0;0;3061.43020057959;2935.56979942041;0;5997
06;2021-05-03;0;1;1;42583;42380;09;84963
06;2021-05-03;1;1;2;33369;31925;19;65294
06;2021-05-03;0;5;5;21571;15080;29;36651
06;2021-05-03;2;3;5;21550;16147;39;37697
06;2021-05-03;0;1;1;14193;13939;49;28132
06;2021-05-03;1;0;1;7171;7597;59;14768
06;2021-05-03;0;0;0;3629;4117;69;7746
06;2021-05-03;1;0;1;1577;1457;79;3034
06;2021-05-03;0;0;0;531;474;89;1005
06;2021-05-03;0;0;0;88;93;90;181
06;2021-05-03;5;11;16;146262;133209;0;279471
07;2021-05-03;0;0;0;485;549;09;1034
07;2021-05-03;2;0;2;403;432;19;835
07;2021-05-03;2;0;2;764;841;29;1605
07;2021-05-03;0;0;0;824;928;39;1752
07;2021-05-03;2;0;2;788;1020;49;1808
07;2021-05-03;0;0;0;678;870;59;1548
07;2021-05-03;0;0;0;360;382;69;742
07;2021-05-03;0;0;0;231;190;79;421
07;2021-05-03;0;0;0;114;67;89;181
07;2021-05-03;0;0;0;24;11;90;35
07;2021-05-03;6;0;6;4671;5290;0;9961
08;2021-05-03;0;0;0;2715.22592983026;2997.75551488675;09;5712.98144471701
08;2021-05-03;0;0;0;2778.51901080978;3160.9156459093;19;5939.43465671908
08;2021-05-03;2;6;8;2080.8882988764;1718.16634315323;29;3799.05464202964
08;2021-05-03;2;4;6;2701.8582062647;1896.52641413317;39;4598.38462039786
08;2021-05-03;2;1;3;3151.45861023308;2460.52498233809;49;5611.98359257117
08;2021-05-03;3;1;4;2620.29868333099;2422.23566154656;59;5042.53434487755
08;2021-05-03;0;1;1;1621.44173420671;1438.58325779464;69;3060.02499200135
08;2021-05-03;0;1;1;626.575909335673;526.358467843651;79;1152.93437717932
08;2021-05-03;0;0;0;205.018522985054;140.993639349697;89;346.012162334751
08;2021-05-03;0;0;0;50.0325684687745;20.62259870351;90;70.6551671722846
08;2021-05-03;9;14;23;18551.3174743414;16782.6825256586;0;35334
11;2021-05-03;292;325;648;783071;811785;09;1594856
11;2021-05-03;589;596;1222;761456;784653;19;1546109
11;2021-05-03;869;789;1673;850145;801772;29;1651917
11;2021-05-03;964;846;1823;914360;843488;39;1757848
11;2021-05-03;736;756;1504;845609;826202;49;1671811
11;2021-05-03;634;625;1265;793566;745070;59;1538636
11;2021-05-03;336;295;634;628649;549192;69;1177841
11;2021-05-03;117;149;266;434606;358356;79;792962
11;2021-05-03;61;41;104;261425;162933;89;424358
11;2021-05-03;36;16;52;89253;32619;90;121872
11;2021-05-03;4634;4439;9192;6362140;5916070;0;12278210
24;2021-05-03;35;46;84;139720;144686;09;284406
24;2021-05-03;104;103;207;152979;161185;19;314164
24;2021-05-03;90;91;181;122237;126536;29;248773
24;2021-05-03;87;74;161;150359;142009;39;292368
24;2021-05-03;128;67;195;161829;158758;49;320587
24;2021-05-03;89;80;169;172552;168011;59;340563
24;2021-05-03;36;41;78;172509;158177;69;330686
24;2021-05-03;24;22;46;129428;110593;79;240021
24;2021-05-03;17;15;32;87342;56882;89;144224
24;2021-05-03;8;6;14;31210;12071;90;43281
24;2021-05-03;618;545;1167;1320165;1238908;0;2559073
27;2021-05-03;55;35;92;143373;149679;09;293052
27;2021-05-03;115;121;237;160962;173003;19;333965
27;2021-05-03;78;81;159;133746;142254;29;276000
27;2021-05-03;89;96;185;160004;155407;39;315411
27;2021-05-03;88;90;178;172333;169564;49;341897
27;2021-05-03;105;69;174;189979;183788;59;373767
27;2021-05-03;71;75;146;192591;178206;69;370797
27;2021-05-03;25;27;52;146876;127546;79;274422
27;2021-05-03;19;14;33;96896;61575;89;158471
27;2021-05-03;10;4;14;33148;12109;90;45257
27;2021-05-03;655;612;1270;1429908;1353131;0;2783039
28;2021-05-03;62;74;139;180735;186856;09;367591
28;2021-05-03;102;114;218;200125;213621;19;413746
28;2021-05-03;153;138;293;168922;173007;29;341929
28;2021-05-03;122;141;265;196628;188487;39;385115
28;2021-05-03;129;116;247;205396;201699;49;407095
28;2021-05-03;127;114;243;222002;213866;59;435868
28;2021-05-03;75;73;148;224688;203758;69;428446
28;2021-05-03;36;28;64;163192;135543;79;298735
28;2021-05-03;24;19;43;109691;65377;89;175068
28;2021-05-03;11;9;20;37222;12685;90;49907
28;2021-05-03;841;826;1680;1708601;1594899;0;3303500
32;2021-05-03;155;150;305;358062;373689;09;731751
32;2021-05-03;330;276;610;387045;406742;19;793787
32;2021-05-03;330;279;613;342304;348587;29;690891
32;2021-05-03;304;280;586;382485;369972;39;752457
32;2021-05-03;290;280;572;382510;376716;49;759226
32;2021-05-03;224;236;463;386937;376527;59;763464
32;2021-05-03;135;135;271;371211;330938;69;702149
32;2021-05-03;75;64;139;250542;201459;79;452001
32;2021-05-03;66;32;98;163399;89786;89;253185
32;2021-05-03;28;7;35;48384;15367;90;63751
32;2021-05-03;1938;1739;3694;3072879;2889783;0;5962662
44;2021-05-03;72;87;160;291525;306839;09;598364
44;2021-05-03;210;194;411;320255;339504;19;659759
44;2021-05-03;182;190;373;302020;314428;29;616448
44;2021-05-03;195;185;380;342222;333292;39;675514
44;2021-05-03;198;181;380;349727;344491;49;694218
44;2021-05-03;145;194;340;381371;373239;59;754610
44;2021-05-03;117;110;227;367165;335850;69;703015
44;2021-05-03;52;45;99;250387;215436;79;465823
44;2021-05-03;35;18;53;170825;105192;89;276017
44;2021-05-03;11;6;17;51248;16731;90;67979
44;2021-05-03;1217;1210;2440;2826745;2685002;0;5511747
52;2021-05-03;43;63;107;213594;223900;09;437494
52;2021-05-03;109;115;226;240818;255197;19;496015
52;2021-05-03;88;100;188;197010;200630;29;397640
52;2021-05-03;99;82;181;231204;224885;39;456089
52;2021-05-03;123;97;220;243874;243418;49;487292
52;2021-05-03;97;113;210;244100;239116;59;483216
52;2021-05-03;44;59;103;241796;221345;69;463141
52;2021-05-03;29;40;69;177805;149903;79;327708
52;2021-05-03;24;14;38;119561;75822;89;195383
52;2021-05-03;14;3;17;42559;15260;90;57819
52;2021-05-03;670;686;1359;1952321;1849476;0;3801797
53;2021-05-03;42;42;84;173813;182358;09;356171
53;2021-05-03;61;71;133;202720;214740;19;417460
53;2021-05-03;101;89;190;163116;173196;29;336312
53;2021-05-03;61;66;127;190526;187674;39;378200
53;2021-05-03;58;72;130;212098;212015;49;424113
53;2021-05-03;70;60;130;223699;219176;59;442875
53;2021-05-03;22;29;51;227435;209274;69;436709
53;2021-05-03;19;12;31;169992;140910;79;310902
53;2021-05-03;10;13;23;118117;69883;89;188000
53;2021-05-03;9;2;11;37370;12267;90;49637
53;2021-05-03;453;456;910;1718886;1621493;0;3340379
75;2021-05-03;46;68;115;293104;305291;09;598395
75;2021-05-03;107;117;226;337141;357785;19;694926
75;2021-05-03;118;113;231;295024;300618;29;595642
75;2021-05-03;119;97;216;347871;331233;39;679104
75;2021-05-03;141;118;260;384742;372771;49;757513
75;2021-05-03;105;129;234;413361;390880;59;804241
75;2021-05-03;76;66;144;425623;384060;69;809683
75;2021-05-03;44;39;83;325086;276298;79;601384
75;2021-05-03;28;25;53;213986;139308;89;353294
75;2021-05-03;19;6;25;77600;28200;90;105800
75;2021-05-03;805;778;1589;3113538;2886444;0;5999982
76;2021-05-03;64;65;133;305956;318589;09;624545
76;2021-05-03;144;160;310;338942;356969;19;695911
76;2021-05-03;168;179;347;316210;319570;29;635780
76;2021-05-03;167;153;322;356758;337587;39;694345
76;2021-05-03;195;154;351;376541;363812;49;740353
76;2021-05-03;169;136;305;402608;383750;59;786358
76;2021-05-03;98;103;202;394889;358997;69;753886
76;2021-05-03;59;57;116;308664;263806;79;572470
76;2021-05-03;28;24;52;195838;129272;89;325110
76;2021-05-03;22;5;27;69372;26728;90;96100
76;2021-05-03;1114;1039;2169;3065778;2859080;0;5924858
84;2021-05-03;111;148;260;459549;481088;09;940637
84;2021-05-03;262;261;528;487711;511905;19;999616
84;2021-05-03;300;272;572;443824;451094;29;894918
84;2021-05-03;320;281;602;512522;493262;39;1005784
84;2021-05-03;306;303;611;520248;515106;49;1035354
84;2021-05-03;235;275;510;529611;514848;59;1044459
84;2021-05-03;179;162;341;486720;439940;69;926660
84;2021-05-03;84;80;164;372151;315211;79;687362
84;2021-05-03;46;37;83;237198;150524;89;387722
84;2021-05-03;18;2;20;81185;28680;90;109865
84;2021-05-03;1861;1821;3691;4130719;3901658;0;8032377
93;2021-05-03;70;78;149;268834;283093;09;551927
93;2021-05-03;178;160;338;280751;296087;19;576838
93;2021-05-03;219;178;398;254404;255552;29;509956
93;2021-05-03;191;180;371;310704;288398;39;599102
93;2021-05-03;191;190;381;325559;305827;49;631386
93;2021-05-03;192;196;388;353104;325389;59;678493
93;2021-05-03;120;93;214;336327;296459;69;632786
93;2021-05-03;54;66;120;279820;229699;79;509519
93;2021-05-03;37;24;61;171274;113716;89;284990
93;2021-05-03;20;8;28;58896;21758;90;80654
93;2021-05-03;1272;1174;2449;2639673;2415978;0;5055651
94;2021-05-03;2;3;5;16311;17433;09;33744
94;2021-05-03;22;20;42;16679;18132;19;34811
94;2021-05-03;9;9;18;16782;16579;29;33361
94;2021-05-03;5;5;10;23044;20580;39;43624
94;2021-05-03;8;6;14;23065;22140;49;45205
94;2021-05-03;9;8;17;24549;23421;59;47970
94;2021-05-03;4;2;6;23212;21883;69;45095
94;2021-05-03;2;1;3;19544;17141;79;36685
94;2021-05-03;0;1;1;11227;8178;89;19405
94;2021-05-03;0;0;0;3332;1447;90;4779
94;2021-05-03;61;55;116;177745;166934;0;344679
01;2021-05-04;2;2;4;19979;20155;09;40134
01;2021-05-04;7;9;16;24994;25489;19;50483
01;2021-05-04;10;5;15;17868;16690;29;34558
01;2021-05-04;11;5;16;22328;14821;39;37149
01;2021-05-04;18;15;33;28652;20276;49;48928
01;2021-05-04;9;13;22;33264;27260;59;60524
01;2021-05-04;9;8;17;27135;23978;69;51113
01;2021-05-04;8;4;12;18401;14661;79;33062
01;2021-05-04;2;0;2;9633;6375;89;16008
01;2021-05-04;0;0;0;3410;1510;90;4920
01;2021-05-04;76;61;137;205664;171215;0;376879
02;2021-05-04;0;0;0;16881;17110;09;33991
02;2021-05-04;2;0;2;21410;21604;19;43014
02;2021-05-04;1;0;1;16017;15479;29;31496
02;2021-05-04;3;0;3;19825;14455;39;34280
02;2021-05-04;3;4;7;24719;18248;49;42967
02;2021-05-04;3;1;4;34361;28310;59;62671
02;2021-05-04;3;4;7;28061;24495;69;52556
02;2021-05-04;2;0;2;18231;15278;79;33509
02;2021-05-04;1;0;1;11090;7677;89;18767
02;2021-05-04;1;0;1;3992;1506;90;5498
02;2021-05-04;19;9;28;194587;164162;0;358749
03;2021-05-04;1;0;1;31123;30920;09;62043
03;2021-05-04;20;16;37;29370;29268;19;58638
03;2021-05-04;15;16;31;21458;18963;29;40421
03;2021-05-04;14;15;29;21276;18326;39;39602
03;2021-05-04;17;13;30;18164;16593;49;34757
03;2021-05-04;13;10;23;13469;13557;59;27026
03;2021-05-04;2;7;9;8776;8670;69;17446
03;2021-05-04;1;2;3;3777;3591;79;7368
03;2021-05-04;0;0;0;1649;1072;89;2721
03;2021-05-04;0;0;0;485;184;90;669
03;2021-05-04;83;79;163;149547;141144;0;290691
04;2021-05-04;8;6;14;60314;61377;09;121691
04;2021-05-04;17;18;35;66065;68387;19;134452
04;2021-05-04;26;16;42;51059;47156;29;98215
04;2021-05-04;27;14;41;58788;45780;39;104568
04;2021-05-04;16;23;39;61408;52207;49;113615
04;2021-05-04;20;16;36;64838;60759;59;125597
04;2021-05-04;17;9;26;47008;42843;69;89851
04;2021-05-04;6;3;9;25509;21184;79;46693
04;2021-05-04;6;3;9;13168;7647;89;20815
04;2021-05-04;2;0;2;3209;1253;90;4462
04;2021-05-04;145;108;253;451366;408593;0;859959
05;2021-05-04;0;0;0;362.366008612902;341.338819562748;09;703.704828175651
05;2021-05-04;0;0;0;353.376145114279;370.349735405642;19;723.725880519921
05;2021-05-04;0;0;0;218.593559489256;256.539602589476;29;475.133162078732
05;2021-05-04;0;0;0;404.225408693299;360.321910454353;39;764.547319147651
05;2021-05-04;0;0;0;520.067953604221;497.108383964256;49;1017.17633756848
05;2021-05-04;0;0;0;468.146063921917;510.087601910415;59;978.233665832332
05;2021-05-04;0;0;0;340.368470050554;334.366842191253;69;674.735312241807
05;2021-05-04;0;0;0;212.598666888387;192.597753227106;79;405.196420115493
05;2021-05-04;0;0;0;148.727797095705;61.8681715431829;89;210.595968638888
05;2021-05-04;0;0;0;32.9601271090696;10.9909785719784;90;43.9511056810479
05;2021-05-04;0;0;0;3061.43020057959;2935.56979942041;0;5997
06;2021-05-04;0;0;0;42583;42380;09;84963
06;2021-05-04;0;2;2;33369;31925;19;65294
06;2021-05-04;1;2;3;21571;15080;29;36651
06;2021-05-04;0;0;0;21550;16147;39;37697
06;2021-05-04;1;0;1;14193;13939;49;28132
06;2021-05-04;0;0;0;7171;7597;59;14768
06;2021-05-04;0;0;0;3629;4117;69;7746
06;2021-05-04;0;0;0;1577;1457;79;3034
06;2021-05-04;0;0;0;531;474;89;1005
06;2021-05-04;0;0;0;88;93;90;181
06;2021-05-04;2;4;6;146262;133209;0;279471
07;2021-05-04;0;0;0;485;549;09;1034
07;2021-05-04;0;0;0;403;432;19;835
07;2021-05-04;0;0;0;764;841;29;1605
07;2021-05-04;0;0;0;824;928;39;1752
07;2021-05-04;1;0;1;788;1020;49;1808
07;2021-05-04;1;0;1;678;870;59;1548
07;2021-05-04;0;1;1;360;382;69;742
07;2021-05-04;0;0;0;231;190;79;421
07;2021-05-04;1;0;1;114;67;89;181
07;2021-05-04;0;0;0;24;11;90;35
07;2021-05-04;3;1;4;4671;5290;0;9961
08;2021-05-04;0;0;0;2715.22592983026;2997.75551488675;09;5712.98144471701
08;2021-05-04;0;0;0;2778.51901080978;3160.9156459093;19;5939.43465671908
08;2021-05-04;1;1;2;2080.8882988764;1718.16634315323;29;3799.05464202964
08;2021-05-04;0;0;0;2701.8582062647;1896.52641413317;39;4598.38462039786
08;2021-05-04;2;3;5;3151.45861023308;2460.52498233809;49;5611.98359257117
08;2021-05-04;0;0;0;2620.29868333099;2422.23566154656;59;5042.53434487755
08;2021-05-04;0;2;2;1621.44173420671;1438.58325779464;69;3060.02499200135
08;2021-05-04;1;0;1;626.575909335673;526.358467843651;79;1152.93437717932
08;2021-05-04;0;0;0;205.018522985054;140.993639349697;89;346.012162334751
08;2021-05-04;0;0;0;50.0325684687745;20.62259870351;90;70.6551671722846
08;2021-05-04;4;6;10;18551.3174743414;16782.6825256586;0;35334
11;2021-05-04;211;251;490;783071;811785;09;1594856
11;2021-05-04;485;416;935;761456;784653;19;1546109
11;2021-05-04;703;646;1357;850145;801772;29;1651917
11;2021-05-04;606;646;1261;914360;843488;39;1757848
11;2021-05-04;507;454;969;845609;826202;49;1671811
11;2021-05-04;462;415;882;793566;745070;59;1538636
11;2021-05-04;240;219;461;628649;549192;69;1177841
11;2021-05-04;85;91;179;434606;358356;79;792962
11;2021-05-04;64;45;109;261425;162933;89;424358
11;2021-05-04;37;24;61;89253;32619;90;121872
11;2021-05-04;3400;3212;6709;6362140;5916070;0;12278210
24;2021-05-04;25;27;53;139720;144686;09;284406
24;2021-05-04;70;67;139;152979;161185;19;314164
24;2021-05-04;83;69;152;122237;126536;29;248773
24;2021-05-04;67;49;116;150359;142009;39;292368
24;2021-05-04;69;58;127;161829;158758;49;320587
24;2021-05-04;60;50;110;172552;168011;59;340563
24;2021-05-04;38;31;69;172509;158177;69;330686
24;2021-05-04;19;13;32;129428;110593;79;240021
24;2021-05-04;14;6;20;87342;56882;89;144224
24;2021-05-04;8;3;11;31210;12071;90;43281
24;2021-05-04;453;373;829;1320165;1238908;0;2559073
27;2021-05-04;38;29;67;143373;149679;09;293052
27;2021-05-04;76;68;144;160962;173003;19;333965
27;2021-05-04;58;49;107;133746;142254;29;276000
27;2021-05-04;61;56;117;160004;155407;39;315411
27;2021-05-04;55;45;100;172333;169564;49;341897
27;2021-05-04;55;42;97;189979;183788;59;373767
27;2021-05-04;33;39;72;192591;178206;69;370797
27;2021-05-04;14;15;29;146876;127546;79;274422
27;2021-05-04;6;4;10;96896;61575;89;158471
27;2021-05-04;6;1;7;33148;12109;90;45257
27;2021-05-04;402;348;750;1429908;1353131;0;2783039
28;2021-05-04;58;52;114;180735;186856;09;367591
28;2021-05-04;91;120;218;200125;213621;19;413746
28;2021-05-04;101;69;171;168922;173007;29;341929
28;2021-05-04;116;78;194;196628;188487;39;385115
28;2021-05-04;98;98;196;205396;201699;49;407095
28;2021-05-04;87;79;166;222002;213866;59;435868
28;2021-05-04;51;46;98;224688;203758;69;428446
28;2021-05-04;24;29;53;163192;135543;79;298735
28;2021-05-04;16;11;27;109691;65377;89;175068
28;2021-05-04;9;3;12;37222;12685;90;49907
28;2021-05-04;651;585;1249;1708601;1594899;0;3303500
32;2021-05-04;117;120;238;358062;373689;09;731751
32;2021-05-04;179;215;395;387045;406742;19;793787
32;2021-05-04;221;203;430;342304;348587;29;690891
32;2021-05-04;204;205;410;382485;369972;39;752457
32;2021-05-04;202;172;376;382510;376716;49;759226
32;2021-05-04;153;143;296;386937;376527;59;763464
32;2021-05-04;87;122;209;371211;330938;69;702149
32;2021-05-04;48;48;96;250542;201459;79;452001
32;2021-05-04;27;20;47;163399;89786;89;253185
32;2021-05-04;19;2;21;48384;15367;90;63751
32;2021-05-04;1257;1250;2518;3072879;2889783;0;5962662
44;2021-05-04;80;68;150;291525;306839;09;598364
44;2021-05-04;105;126;232;320255;339504;19;659759
44;2021-05-04;160;144;305;302020;314428;29;616448
44;2021-05-04;130;93;224;342222;333292;39;675514
44;2021-05-04;129;97;226;349727;344491;49;694218
44;2021-05-04;100;92;194;381371;373239;59;754610
44;2021-05-04;64;55;120;367165;335850;69;703015
44;2021-05-04;33;31;64;250387;215436;79;465823
44;2021-05-04;25;19;44;170825;105192;89;276017
44;2021-05-04;11;1;12;51248;16731;90;67979
44;2021-05-04;837;726;1573;2826745;2685002;0;5511747
52;2021-05-04;40;32;80;213594;223900;09;437494
52;2021-05-04;79;72;153;240818;255197;19;496015
52;2021-05-04;74;80;154;197010;200630;29;397640
52;2021-05-04;76;57;133;231204;224885;39;456089
52;2021-05-04;70;71;142;243874;243418;49;487292
52;2021-05-04;61;74;135;244100;239116;59;483216
52;2021-05-04;44;41;85;241796;221345;69;463141
52;2021-05-04;22;26;48;177805;149903;79;327708
52;2021-05-04;13;15;29;119561;75822;89;195383
52;2021-05-04;5;3;8;42559;15260;90;57819
52;2021-05-04;484;471;967;1952321;1849476;0;3801797
53;2021-05-04;38;28;66;173813;182358;09;356171
53;2021-05-04;62;62;124;202720;214740;19;417460
53;2021-05-04;63;52;115;163116;173196;29;336312
53;2021-05-04;45;41;86;190526;187674;39;378200
53;2021-05-04;62;41;103;212098;212015;49;424113
53;2021-05-04;44;31;75;223699;219176;59;442875
53;2021-05-04;34;29;63;227435;209274;69;436709
53;2021-05-04;12;13;25;169992;140910;79;310902
53;2021-05-04;6;7;13;118117;69883;89;188000
53;2021-05-04;2;3;5;37370;12267;90;49637
53;2021-05-04;368;307;675;1718886;1621493;0;3340379
75;2021-05-04;41;58;102;293104;305291;09;598395
75;2021-05-04;87;97;187;337141;357785;19;694926
75;2021-05-04;111;112;223;295024;300618;29;595642
75;2021-05-04;109;88;197;347871;331233;39;679104
75;2021-05-04;98;82;180;384742;372771;49;757513
75;2021-05-04;75;73;148;413361;390880;59;804241
75;2021-05-04;51;51;102;425623;384060;69;809683
75;2021-05-04;33;26;59;325086;276298;79;601384
75;2021-05-04;30;18;48;213986;139308;89;353294
75;2021-05-04;25;11;36;77600;28200;90;105800
75;2021-05-04;660;616;1282;3113538;2886444;0;5999982
76;2021-05-04;42;59;106;305956;318589;09;624545
76;2021-05-04;98;99;199;338942;356969;19;695911
76;2021-05-04;109;142;251;316210;319570;29;635780
76;2021-05-04;110;101;212;356758;337587;39;694345
76;2021-05-04;118;103;222;376541;363812;49;740353
76;2021-05-04;100;101;201;402608;383750;59;786358
76;2021-05-04;64;75;139;394889;358997;69;753886
76;2021-05-04;42;43;86;308664;263806;79;572470
76;2021-05-04;28;17;45;195838;129272;89;325110
76;2021-05-04;15;7;22;69372;26728;90;96100
76;2021-05-04;726;747;1483;3065778;2859080;0;5924858
84;2021-05-04;110;113;224;459549;481088;09;940637
84;2021-05-04;204;197;403;487711;511905;19;999616
84;2021-05-04;217;178;396;443824;451094;29;894918
84;2021-05-04;201;190;392;512522;493262;39;1005784
84;2021-05-04;223;162;387;520248;515106;49;1035354
84;2021-05-04;176;186;362;529611;514848;59;1044459
84;2021-05-04;86;81;167;486720;439940;69;926660
84;2021-05-04;56;57;113;372151;315211;79;687362
84;2021-05-04;48;30;78;237198;150524;89;387722
84;2021-05-04;25;13;38;81185;28680;90;109865
84;2021-05-04;1346;1207;2560;4130719;3901658;0;8032377
93;2021-05-04;39;58;98;268834;283093;09;551927
93;2021-05-04;98;109;209;280751;296087;19;576838
93;2021-05-04;154;132;286;254404;255552;29;509956
93;2021-05-04;136;122;260;310704;288398;39;599102
93;2021-05-04;117;126;243;325559;305827;49;631386
93;2021-05-04;104;97;201;353104;325389;59;678493
93;2021-05-04;74;74;148;336327;296459;69;632786
93;2021-05-04;42;33;75;279820;229699;79;509519
93;2021-05-04;18;27;45;171274;113716;89;284990
93;2021-05-04;19;2;21;58896;21758;90;80654
93;2021-05-04;802;780;1587;2639673;2415978;0;5055651
94;2021-05-04;0;3;3;16311;17433;09;33744
94;2021-05-04;5;6;11;16679;18132;19;34811
94;2021-05-04;6;8;14;16782;16579;29;33361
94;2021-05-04;4;3;7;23044;20580;39;43624
94;2021-05-04;6;7;13;23065;22140;49;45205
94;2021-05-04;5;5;10;24549;23421;59;47970
94;2021-05-04;1;1;2;23212;21883;69;45095
94;2021-05-04;2;0;2;19544;17141;79;36685
94;2021-05-04;1;1;2;11227;8178;89;19405
94;2021-05-04;0;0;0;3332;1447;90;4779
94;2021-05-04;30;34;64;177745;166934;0;344679
01;2021-05-05;2;2;4;19979;20155;09;40134
01;2021-05-05;6;3;9;24994;25489;19;50483
01;2021-05-05;10;7;17;17868;16690;29;34558
01;2021-05-05;6;2;8;22328;14821;39;37149
01;2021-05-05;6;12;18;28652;20276;49;48928
01;2021-05-05;10;8;18;33264;27260;59;60524
01;2021-05-05;4;4;8;27135;23978;69;51113
01;2021-05-05;1;6;7;18401;14661;79;33062
01;2021-05-05;2;3;5;9633;6375;89;16008
01;2021-05-05;0;0;0;3410;1510;90;4920
01;2021-05-05;47;47;94;205664;171215;0;376879
02;2021-05-05;1;0;1;16881;17110;09;33991
02;2021-05-05;2;0;2;21410;21604;19;43014
02;2021-05-05;3;2;5;16017;15479;29;31496
02;2021-05-05;3;2;5;19825;14455;39;34280
02;2021-05-05;2;1;3;24719;18248;49;42967
02;2021-05-05;5;2;7;34361;28310;59;62671
02;2021-05-05;3;1;4;28061;24495;69;52556
02;2021-05-05;0;1;1;18231;15278;79;33509
02;2021-05-05;0;1;1;11090;7677;89;18767
02;2021-05-05;0;0;0;3992;1506;90;5498
02;2021-05-05;19;10;29;194587;164162;0;358749
03;2021-05-05;8;3;11;31123;30920;09;62043
03;2021-05-05;17;22;40;29370;29268;19;58638
03;2021-05-05;16;8;24;21458;18963;29;40421
03;2021-05-05;13;13;26;21276;18326;39;39602
03;2021-05-05;14;8;22;18164;16593;49;34757
03;2021-05-05;12;3;15;13469;13557;59;27026
03;2021-05-05;5;7;12;8776;8670;69;17446
03;2021-05-05;2;1;3;3777;3591;79;7368
03;2021-05-05;0;1;1;1649;1072;89;2721
03;2021-05-05;1;0;1;485;184;90;669
03;2021-05-05;89;66;156;149547;141144;0;290691
04;2021-05-05;4;9;13;60314;61377;09;121691
04;2021-05-05;19;20;39;66065;68387;19;134452
04;2021-05-05;17;10;27;51059;47156;29;98215
04;2021-05-05;24;20;44;58788;45780;39;104568
04;2021-05-05;18;18;36;61408;52207;49;113615
04;2021-05-05;19;9;28;64838;60759;59;125597
04;2021-05-05;10;6;16;47008;42843;69;89851
04;2021-05-05;5;4;9;25509;21184;79;46693
04;2021-05-05;2;1;3;13168;7647;89;20815
04;2021-05-05;0;0;0;3209;1253;90;4462
04;2021-05-05;118;97;215;451366;408593;0;859959
05;2021-05-05;0;0;0;362.366008612902;341.338819562748;09;703.704828175651
05;2021-05-05;0;0;0;353.376145114279;370.349735405642;19;723.725880519921
05;2021-05-05;0;0;0;218.593559489256;256.539602589476;29;475.133162078732
05;2021-05-05;0;0;0;404.225408693299;360.321910454353;39;764.547319147651
05;2021-05-05;0;0;0;520.067953604221;497.108383964256;49;1017.17633756848
05;2021-05-05;0;0;0;468.146063921917;510.087601910415;59;978.233665832332
05;2021-05-05;0;0;0;340.368470050554;334.366842191253;69;674.735312241807
05;2021-05-05;0;0;0;212.598666888387;192.597753227106;79;405.196420115493
05;2021-05-05;0;0;0;148.727797095705;61.8681715431829;89;210.595968638888
05;2021-05-05;0;0;0;32.9601271090696;10.9909785719784;90;43.9511056810479
05;2021-05-05;0;0;0;3061.43020057959;2935.56979942041;0;5997
06;2021-05-05;0;0;0;42583;42380;09;84963
06;2021-05-05;1;1;2;33369;31925;19;65294
06;2021-05-05;3;0;3;21571;15080;29;36651
06;2021-05-05;2;1;3;21550;16147;39;37697
06;2021-05-05;0;3;3;14193;13939;49;28132
06;2021-05-05;1;0;1;7171;7597;59;14768
06;2021-05-05;0;0;0;3629;4117;69;7746
06;2021-05-05;0;0;0;1577;1457;79;3034
06;2021-05-05;0;0;0;531;474;89;1005
06;2021-05-05;0;0;0;88;93;90;181
06;2021-05-05;7;5;12;146262;133209;0;279471
07;2021-05-05;0;0;0;485;549;09;1034
07;2021-05-05;0;0;0;403;432;19;835
07;2021-05-05;0;0;0;764;841;29;1605
07;2021-05-05;0;0;0;824;928;39;1752
07;2021-05-05;0;0;0;788;1020;49;1808
07;2021-05-05;0;0;0;678;870;59;1548
07;2021-05-05;0;0;0;360;382;69;742
07;2021-05-05;0;1;1;231;190;79;421
07;2021-05-05;0;0;0;114;67;89;181
07;2021-05-05;0;0;0;24;11;90;35
07;2021-05-05;0;1;1;4671;5290;0;9961
08;2021-05-05;0;0;0;2715.22592983026;2997.75551488675;09;5712.98144471701
08;2021-05-05;1;1;2;2778.51901080978;3160.9156459093;19;5939.43465671908
08;2021-05-05;1;3;4;2080.8882988764;1718.16634315323;29;3799.05464202964
08;2021-05-05;1;4;5;2701.8582062647;1896.52641413317;39;4598.38462039786
08;2021-05-05;0;1;1;3151.45861023308;2460.52498233809;49;5611.98359257117
08;2021-05-05;1;0;1;2620.29868333099;2422.23566154656;59;5042.53434487755
08;2021-05-05;0;1;1;1621.44173420671;1438.58325779464;69;3060.02499200135
08;2021-05-05;0;1;1;626.575909335673;526.358467843651;79;1152.93437717932
08;2021-05-05;0;0;0;205.018522985054;140.993639349697;89;346.012162334751
08;2021-05-05;0;0;0;50.0325684687745;20.62259870351;90;70.6551671722846
08;2021-05-05;4;11;15;18551.3174743414;16782.6825256586;0;35334
11;2021-05-05;197;215;445;783071;811785;09;1594856
11;2021-05-05;451;392;878;761456;784653;19;1546109
11;2021-05-05;620;518;1148;850145;801772;29;1651917
11;2021-05-05;585;495;1092;914360;843488;39;1757848
11;2021-05-05;421;413;839;845609;826202;49;1671811
11;2021-05-05;386;309;705;793566;745070;59;1538636
11;2021-05-05;178;180;361;628649;549192;69;1177841
11;2021-05-05;66;70;137;434606;358356;79;792962
11;2021-05-05;44;31;75;261425;162933;89;424358
11;2021-05-05;22;11;33;89253;32619;90;121872
11;2021-05-05;2973;2634;5716;6362140;5916070;0;12278210
24;2021-05-05;18;20;38;139720;144686;09;284406
24;2021-05-05;57;70;128;152979;161185;19;314164
24;2021-05-05;64;57;121;122237;126536;29;248773
24;2021-05-05;72;46;118;150359;142009;39;292368
24;2021-05-05;66;54;120;161829;158758;49;320587
24;2021-05-05;59;46;105;172552;168011;59;340563
24;2021-05-05;19;24;43;172509;158177;69;330686
24;2021-05-05;12;19;31;129428;110593;79;240021
24;2021-05-05;11;6;17;87342;56882;89;144224
24;2021-05-05;5;2;7;31210;12071;90;43281
24;2021-05-05;383;344;728;1320165;1238908;0;2559073
27;2021-05-05;39;42;81;143373;149679;09;293052
27;2021-05-05;71;55;127;160962;173003;19;333965
27;2021-05-05;54;56;111;133746;142254;29;276000
27;2021-05-05;57;57;114;160004;155407;39;315411
27;2021-05-05;54;42;96;172333;169564;49;341897
27;2021-05-05;47;40;87;189979;183788;59;373767
27;2021-05-05;31;34;65;192591;178206;69;370797
27;2021-05-05;14;11;25;146876;127546;79;274422
27;2021-05-05;9;12;21;96896;61575;89;158471
27;2021-05-05;7;2;9;33148;12109;90;45257
27;2021-05-05;383;351;736;1429908;1353131;0;2783039
28;2021-05-05;25;27;53;180735;186856;09;367591
28;2021-05-05;101;77;179;200125;213621;19;413746
28;2021-05-05;86;109;196;168922;173007;29;341929
28;2021-05-05;84;81;165;196628;188487;39;385115
28;2021-05-05;84;63;147;205396;201699;49;407095
28;2021-05-05;79;65;145;222002;213866;59;435868
28;2021-05-05;38;42;81;224688;203758;69;428446
28;2021-05-05;22;25;47;163192;135543;79;298735
28;2021-05-05;16;13;29;109691;65377;89;175068
28;2021-05-05;15;5;20;37222;12685;90;49907
28;2021-05-05;550;507;1062;1708601;1594899;0;3303500
32;2021-05-05;90;106;197;358062;373689;09;731751
32;2021-05-05;212;198;411;387045;406742;19;793787
32;2021-05-05;210;166;378;342304;348587;29;690891
32;2021-05-05;214;211;426;382485;369972;39;752457
32;2021-05-05;193;159;354;382510;376716;49;759226
32;2021-05-05;122;118;240;386937;376527;59;763464
32;2021-05-05;93;88;181;371211;330938;69;702149
32;2021-05-05;40;45;85;250542;201459;79;452001
32;2021-05-05;20;10;31;163399;89786;89;253185
32;2021-05-05;13;4;17;48384;15367;90;63751
32;2021-05-05;1207;1105;2320;3072879;2889783;0;5962662
44;2021-05-05;36;48;84;291525;306839;09;598364
44;2021-05-05;105;99;205;320255;339504;19;659759
44;2021-05-05;115;100;216;302020;314428;29;616448
44;2021-05-05;98;104;203;342222;333292;39;675514
44;2021-05-05;106;80;186;349727;344491;49;694218
44;2021-05-05;89;68;159;381371;373239;59;754610
44;2021-05-05;54;53;108;367165;335850;69;703015
44;2021-05-05;39;30;69;250387;215436;79;465823
44;2021-05-05;30;14;44;170825;105192;89;276017
44;2021-05-05;17;6;23;51248;16731;90;67979
44;2021-05-05;689;602;1297;2826745;2685002;0;5511747
52;2021-05-05;28;41;71;213594;223900;09;437494
52;2021-05-05;77;79;160;240818;255197;19;496015
52;2021-05-05;66;79;145;197010;200630;29;397640
52;2021-05-05;67;56;123;231204;224885;39;456089
52;2021-05-05;82;53;136;243874;243418;49;487292
52;2021-05-05;65;70;135;244100;239116;59;483216
52;2021-05-05;39;38;77;241796;221345;69;463141
52;2021-05-05;10;17;27;177805;149903;79;327708
52;2021-05-05;22;5;27;119561;75822;89;195383
52;2021-05-05;4;2;6;42559;15260;90;57819
52;2021-05-05;460;440;907;1952321;1849476;0;3801797
53;2021-05-05;26;37;63;173813;182358;09;356171
53;2021-05-05;55;43;98;202720;214740;19;417460
53;2021-05-05;68;68;137;163116;173196;29;336312
53;2021-05-05;51;46;97;190526;187674;39;378200
53;2021-05-05;49;46;95;212098;212015;49;424113
53;2021-05-05;42;47;89;223699;219176;59;442875
53;2021-05-05;25;23;48;227435;209274;69;436709
53;2021-05-05;11;4;15;169992;140910;79;310902
53;2021-05-05;6;2;8;118117;69883;89;188000
53;2021-05-05;5;2;7;37370;12267;90;49637
53;2021-05-05;338;318;657;1718886;1621493;0;3340379
75;2021-05-05;36;47;85;293104;305291;09;598395
75;2021-05-05;93;78;171;337141;357785;19;694926
75;2021-05-05;74;84;158;295024;300618;29;595642
75;2021-05-05;105;76;181;347871;331233;39;679104
75;2021-05-05;79;66;145;384742;372771;49;757513
75;2021-05-05;77;65;142;413361;390880;59;804241
75;2021-05-05;36;40;76;425623;384060;69;809683
75;2021-05-05;30;23;53;325086;276298;79;601384
75;2021-05-05;21;12;33;213986;139308;89;353294
75;2021-05-05;10;6;16;77600;28200;90;105800
75;2021-05-05;561;497;1060;3113538;2886444;0;5999982
76;2021-05-05;51;51;105;305956;318589;09;624545
76;2021-05-05;98;107;208;338942;356969;19;695911
76;2021-05-05;125;114;239;316210;319570;29;635780
76;2021-05-05;83;90;173;356758;337587;39;694345
76;2021-05-05;112;80;192;376541;363812;49;740353
76;2021-05-05;82;73;155;402608;383750;59;786358
76;2021-05-05;61;52;113;394889;358997;69;753886
76;2021-05-05;26;38;66;308664;263806;79;572470
76;2021-05-05;26;16;42;195838;129272;89;325110
76;2021-05-05;17;6;23;69372;26728;90;96100
76;2021-05-05;681;628;1317;3065778;2859080;0;5924858
84;2021-05-05;97;105;204;459549;481088;09;940637
84;2021-05-05;177;200;377;487711;511905;19;999616
84;2021-05-05;213;208;421;443824;451094;29;894918
84;2021-05-05;185;172;358;512522;493262;39;1005784
84;2021-05-05;168;139;307;520248;515106;49;1035354
84;2021-05-05;122;150;272;529611;514848;59;1044459
84;2021-05-05;96;88;184;486720;439940;69;926660
84;2021-05-05;39;54;93;372151;315211;79;687362
84;2021-05-05;27;20;47;237198;150524;89;387722
84;2021-05-05;21;5;26;81185;28680;90;109865
84;2021-05-05;1145;1142;2290;4130719;3901658;0;8032377
93;2021-05-05;34;37;71;268834;283093;09;551927
93;2021-05-05;94;92;186;280751;296087;19;576838
93;2021-05-05;103;107;210;254404;255552;29;509956
93;2021-05-05;124;101;225;310704;288398;39;599102
93;2021-05-05;105;111;216;325559;305827;49;631386
93;2021-05-05;91;85;176;353104;325389;59;678493
93;2021-05-05;61;64;125;336327;296459;69;632786
93;2021-05-05;25;34;60;279820;229699;79;509519
93;2021-05-05;24;15;39;171274;113716;89;284990
93;2021-05-05;9;3;12;58896;21758;90;80654
93;2021-05-05;671;649;1321;2639673;2415978;0;5055651
94;2021-05-05;1;2;3;16311;17433;09;33744
94;2021-05-05;5;4;11;16679;18132;19;34811
94;2021-05-05;4;1;5;16782;16579;29;33361
94;2021-05-05;2;1;3;23044;20580;39;43624
94;2021-05-05;2;1;3;23065;22140;49;45205
94;2021-05-05;3;1;4;24549;23421;59;47970
94;2021-05-05;1;1;2;23212;21883;69;45095
94;2021-05-05;0;0;0;19544;17141;79;36685
94;2021-05-05;2;1;3;11227;8178;89;19405
94;2021-05-05;0;0;0;3332;1447;90;4779
94;2021-05-05;20;12;34;177745;166934;0;344679
01;2021-05-06;3;0;4;19979;20155;09;40134
01;2021-05-06;5;5;10;24994;25489;19;50483
01;2021-05-06;5;4;9;17868;16690;29;34558
01;2021-05-06;8;6;14;22328;14821;39;37149
01;2021-05-06;14;5;20;28652;20276;49;48928
01;2021-05-06;14;5;19;33264;27260;59;60524
01;2021-05-06;6;8;15;27135;23978;69;51113
01;2021-05-06;6;1;7;18401;14661;79;33062
01;2021-05-06;1;3;4;9633;6375;89;16008
01;2021-05-06;1;0;1;3410;1510;90;4920
01;2021-05-06;63;37;103;205664;171215;0;376879
02;2021-05-06;2;0;2;16881;17110;09;33991
02;2021-05-06;3;3;6;21410;21604;19;43014
02;2021-05-06;1;2;3;16017;15479;29;31496
02;2021-05-06;4;0;4;19825;14455;39;34280
02;2021-05-06;3;0;3;24719;18248;49;42967
02;2021-05-06;5;2;7;34361;28310;59;62671
02;2021-05-06;1;1;2;28061;24495;69;52556
02;2021-05-06;1;1;2;18231;15278;79;33509
02;2021-05-06;0;0;0;11090;7677;89;18767
02;2021-05-06;0;0;0;3992;1506;90;5498
02;2021-05-06;20;9;29;194587;164162;0;358749
03;2021-05-06;5;4;9;31123;30920;09;62043
03;2021-05-06;11;21;32;29370;29268;19;58638
03;2021-05-06;21;10;31;21458;18963;29;40421
03;2021-05-06;9;11;20;21276;18326;39;39602
03;2021-05-06;4;13;17;18164;16593;49;34757
03;2021-05-06;7;5;12;13469;13557;59;27026
03;2021-05-06;5;7;12;8776;8670;69;17446
03;2021-05-06;1;1;2;3777;3591;79;7368
03;2021-05-06;0;0;0;1649;1072;89;2721
03;2021-05-06;0;0;0;485;184;90;669
03;2021-05-06;63;72;135;149547;141144;0;290691
04;2021-05-06;3;6;9;60314;61377;09;121691
04;2021-05-06;18;24;42;66065;68387;19;134452
04;2021-05-06;23;21;44;51059;47156;29;98215
04;2021-05-06;23;18;41;58788;45780;39;104568
04;2021-05-06;17;19;36;61408;52207;49;113615
04;2021-05-06;9;12;21;64838;60759;59;125597
04;2021-05-06;6;5;11;47008;42843;69;89851
04;2021-05-06;2;0;2;25509;21184;79;46693
04;2021-05-06;2;1;3;13168;7647;89;20815
04;2021-05-06;3;1;4;3209;1253;90;4462
04;2021-05-06;106;107;213;451366;408593;0;859959
05;2021-05-06;0;0;0;362.366008612902;341.338819562748;09;703.704828175651
05;2021-05-06;0;0;0;353.376145114279;370.349735405642;19;723.725880519921
05;2021-05-06;0;0;0;218.593559489256;256.539602589476;29;475.133162078732
05;2021-05-06;0;0;0;404.225408693299;360.321910454353;39;764.547319147651
05;2021-05-06;0;0;0;520.067953604221;497.108383964256;49;1017.17633756848
05;2021-05-06;0;0;0;468.146063921917;510.087601910415;59;978.233665832332
05;2021-05-06;1;0;1;340.368470050554;334.366842191253;69;674.735312241807
05;2021-05-06;0;0;0;212.598666888387;192.597753227106;79;405.196420115493
05;2021-05-06;0;0;0;148.727797095705;61.8681715431829;89;210.595968638888
05;2021-05-06;0;0;0;32.9601271090696;10.9909785719784;90;43.9511056810479
05;2021-05-06;1;0;1;3061.43020057959;2935.56979942041;0;5997
06;2021-05-06;0;0;0;42583;42380;09;84963
06;2021-05-06;0;1;1;33369;31925;19;65294
06;2021-05-06;0;1;1;21571;15080;29;36651
06;2021-05-06;0;0;0;21550;16147;39;37697
06;2021-05-06;0;2;2;14193;13939;49;28132
06;2021-05-06;0;0;0;7171;7597;59;14768
06;2021-05-06;0;0;0;3629;4117;69;7746
06;2021-05-06;0;0;0;1577;1457;79;3034
06;2021-05-06;0;0;0;531;474;89;1005
06;2021-05-06;0;0;0;88;93;90;181
06;2021-05-06;0;4;4;146262;133209;0;279471
07;2021-05-06;0;0;0;485;549;09;1034
07;2021-05-06;0;0;0;403;432;19;835
07;2021-05-06;0;0;0;764;841;29;1605
07;2021-05-06;0;0;0;824;928;39;1752
07;2021-05-06;0;0;0;788;1020;49;1808
07;2021-05-06;0;0;0;678;870;59;1548
07;2021-05-06;0;0;0;360;382;69;742
07;2021-05-06;0;0;0;231;190;79;421
07;2021-05-06;0;0;0;114;67;89;181
07;2021-05-06;0;0;0;24;11;90;35
07;2021-05-06;0;0;0;4671;5290;0;9961
08;2021-05-06;0;0;0;2715.22592983026;2997.75551488675;09;5712.98144471701
08;2021-05-06;0;0;0;2778.51901080978;3160.9156459093;19;5939.43465671908
08;2021-05-06;0;0;0;2080.8882988764;1718.16634315323;29;3799.05464202964
08;2021-05-06;1;0;1;2701.8582062647;1896.52641413317;39;4598.38462039786
08;2021-05-06;1;1;2;3151.45861023308;2460.52498233809;49;5611.98359257117
08;2021-05-06;1;0;1;2620.29868333099;2422.23566154656;59;5042.53434487755
08;2021-05-06;0;0;0;1621.44173420671;1438.58325779464;69;3060.02499200135
08;2021-05-06;1;0;1;626.575909335673;526.358467843651;79;1152.93437717932
08;2021-05-06;0;0;0;205.018522985054;140.993639349697;89;346.012162334751
08;2021-05-06;0;0;0;50.0325684687745;20.62259870351;90;70.6551671722846
08;2021-05-06;4;1;5;18551.3174743414;16782.6825256586;0;35334
11;2021-05-06;218;215;462;783071;811785;09;1594856
11;2021-05-06;361;362;741;761456;784653;19;1546109
11;2021-05-06;555;563;1127;850145;801772;29;1651917
11;2021-05-06;522;464;996;914360;843488;39;1757848
11;2021-05-06;436;425;866;845609;826202;49;1671811
11;2021-05-06;321;363;691;793566;745070;59;1538636
11;2021-05-06;172;156;330;628649;549192;69;1177841
11;2021-05-06;75;78;153;434606;358356;79;792962
11;2021-05-06;42;28;70;261425;162933;89;424358
11;2021-05-06;31;11;42;89253;32619;90;121872
11;2021-05-06;2734;2665;5479;6362140;5916070;0;12278210
24;2021-05-06;32;23;55;139720;144686;09;284406
24;2021-05-06;56;56;114;152979;161185;19;314164
24;2021-05-06;52;65;118;122237;126536;29;248773
24;2021-05-06;45;68;113;150359;142009;39;292368
24;2021-05-06;65;39;104;161829;158758;49;320587
24;2021-05-06;46;59;105;172552;168011;59;340563
24;2021-05-06;25;32;57;172509;158177;69;330686
24;2021-05-06;15;14;29;129428;110593;79;240021
24;2021-05-06;15;5;20;87342;56882;89;144224
24;2021-05-06;8;2;10;31210;12071;90;43281
24;2021-05-06;360;363;726;1320165;1238908;0;2559073
27;2021-05-06;46;35;81;143373;149679;09;293052
27;2021-05-06;74;74;149;160962;173003;19;333965
27;2021-05-06;51;54;105;133746;142254;29;276000
27;2021-05-06;73;52;125;160004;155407;39;315411
27;2021-05-06;47;54;101;172333;169564;49;341897
27;2021-05-06;46;49;95;189979;183788;59;373767
27;2021-05-06;24;31;55;192591;178206;69;370797
27;2021-05-06;10;18;28;146876;127546;79;274422
27;2021-05-06;14;5;19;96896;61575;89;158471
27;2021-05-06;7;4;11;33148;12109;90;45257
27;2021-05-06;392;376;769;1429908;1353131;0;2783039
28;2021-05-06;53;36;90;180735;186856;09;367591
28;2021-05-06;89;93;184;200125;213621;19;413746
28;2021-05-06;97;83;181;168922;173007;29;341929
28;2021-05-06;96;89;187;196628;188487;39;385115
28;2021-05-06;75;69;144;205396;201699;49;407095
28;2021-05-06;69;75;144;222002;213866;59;435868
28;2021-05-06;45;33;78;224688;203758;69;428446
28;2021-05-06;21;19;41;163192;135543;79;298735
28;2021-05-06;19;14;33;109691;65377;89;175068
28;2021-05-06;10;1;11;37222;12685;90;49907
28;2021-05-06;574;512;1093;1708601;1594899;0;3303500
32;2021-05-06;92;108;201;358062;373689;09;731751
32;2021-05-06;226;200;428;387045;406742;19;793787
32;2021-05-06;157;192;350;342304;348587;29;690891
32;2021-05-06;178;172;355;382485;369972;39;752457
32;2021-05-06;185;161;347;382510;376716;49;759226
32;2021-05-06;146;151;298;386937;376527;59;763464
32;2021-05-06;97;79;176;371211;330938;69;702149
32;2021-05-06;31;36;67;250542;201459;79;452001
32;2021-05-06;21;19;40;163399;89786;89;253185
32;2021-05-06;20;4;24;48384;15367;90;63751
32;2021-05-06;1154;1122;2287;3072879;2889783;0;5962662
44;2021-05-06;48;57;106;291525;306839;09;598364
44;2021-05-06;94;110;204;320255;339504;19;659759
44;2021-05-06;101;110;211;302020;314428;29;616448
44;2021-05-06;97;87;184;342222;333292;39;675514
44;2021-05-06;77;92;169;349727;344491;49;694218
44;2021-05-06;74;87;161;381371;373239;59;754610
44;2021-05-06;42;40;83;367165;335850;69;703015
44;2021-05-06;30;27;57;250387;215436;79;465823
44;2021-05-06;12;8;20;170825;105192;89;276017
44;2021-05-06;10;1;11;51248;16731;90;67979
44;2021-05-06;585;619;1206;2826745;2685002;0;5511747
52;2021-05-06;22;31;55;213594;223900;09;437494
52;2021-05-06;83;78;162;240818;255197;19;496015
52;2021-05-06;73;60;133;197010;200630;29;397640
52;2021-05-06;73;60;133;231204;224885;39;456089
52;2021-05-06;96;73;169;243874;243418;49;487292
52;2021-05-06;63;85;148;244100;239116;59;483216
52;2021-05-06;34;21;55;241796;221345;69;463141
52;2021-05-06;12;15;27;177805;149903;79;327708
52;2021-05-06;10;11;22;119561;75822;89;195383
52;2021-05-06;5;3;8;42559;15260;90;57819
52;2021-05-06;471;437;912;1952321;1849476;0;3801797
53;2021-05-06;39;47;86;173813;182358;09;356171
53;2021-05-06;55;60;116;202720;214740;19;417460
53;2021-05-06;53;79;132;163116;173196;29;336312
53;2021-05-06;31;45;76;190526;187674;39;378200
53;2021-05-06;41;64;105;212098;212015;49;424113
53;2021-05-06;41;31;73;223699;219176;59;442875
53;2021-05-06;19;23;42;227435;209274;69;436709
53;2021-05-06;8;4;12;169992;140910;79;310902
53;2021-05-06;9;4;13;118117;69883;89;188000
53;2021-05-06;3;1;4;37370;12267;90;49637
53;2021-05-06;299;358;659;1718886;1621493;0;3340379
75;2021-05-06;37;36;73;293104;305291;09;598395
75;2021-05-06;63;61;124;337141;357785;19;694926
75;2021-05-06;74;84;159;295024;300618;29;595642
75;2021-05-06;88;71;159;347871;331233;39;679104
75;2021-05-06;64;73;137;384742;372771;49;757513
75;2021-05-06;48;65;113;413361;390880;59;804241
75;2021-05-06;42;39;81;425623;384060;69;809683
75;2021-05-06;19;18;37;325086;276298;79;601384
75;2021-05-06;20;10;30;213986;139308;89;353294
75;2021-05-06;9;3;12;77600;28200;90;105800
75;2021-05-06;464;460;925;3113538;2886444;0;5999982
76;2021-05-06;42;35;80;305956;318589;09;624545
76;2021-05-06;88;88;180;338942;356969;19;695911
76;2021-05-06;107;136;243;316210;319570;29;635780
76;2021-05-06;81;105;187;356758;337587;39;694345
76;2021-05-06;90;102;192;376541;363812;49;740353
76;2021-05-06;72;87;159;402608;383750;59;786358
76;2021-05-06;33;42;75;394889;358997;69;753886
76;2021-05-06;23;25;48;308664;263806;79;572470
76;2021-05-06;23;13;36;195838;129272;89;325110
76;2021-05-06;7;6;13;69372;26728;90;96100
76;2021-05-06;567;639;1214;3065778;2859080;0;5924858
84;2021-05-06;106;116;224;459549;481088;09;940637
84;2021-05-06;161;174;337;487711;511905;19;999616
84;2021-05-06;193;168;362;443824;451094;29;894918
84;2021-05-06;193;168;361;512522;493262;39;1005784
84;2021-05-06;144;115;259;520248;515106;49;1035354
84;2021-05-06;140;132;273;529611;514848;59;1044459
84;2021-05-06;60;64;124;486720;439940;69;926660
84;2021-05-06;49;41;90;372151;315211;79;687362
84;2021-05-06;22;12;34;237198;150524;89;387722
84;2021-05-06;8;4;12;81185;28680;90;109865
84;2021-05-06;1076;994;2076;4130719;3901658;0;8032377
93;2021-05-06;38;67;105;268834;283093;09;551927
93;2021-05-06;78;105;183;280751;296087;19;576838
93;2021-05-06;102;99;202;254404;255552;29;509956
93;2021-05-06;99;83;183;310704;288398;39;599102
93;2021-05-06;89;77;166;325559;305827;49;631386
93;2021-05-06;94;75;169;353104;325389;59;678493
93;2021-05-06;55;47;102;336327;296459;69;632786
93;2021-05-06;23;24;47;279820;229699;79;509519
93;2021-05-06;15;8;23;171274;113716;89;284990
93;2021-05-06;9;10;19;58896;21758;90;80654
93;2021-05-06;603;595;1200;2639673;2415978;0;5055651
94;2021-05-06;2;2;4;16311;17433;09;33744
94;2021-05-06;3;8;11;16679;18132;19;34811
94;2021-05-06;1;9;10;16782;16579;29;33361
94;2021-05-06;1;6;7;23044;20580;39;43624
94;2021-05-06;2;4;6;23065;22140;49;45205
94;2021-05-06;0;3;3;24549;23421;59;47970
94;2021-05-06;1;0;1;23212;21883;69;45095
94;2021-05-06;0;0;0;19544;17141;79;36685
94;2021-05-06;0;0;0;11227;8178;89;19405
94;2021-05-06;3;0;3;3332;1447;90;4779
94;2021-05-06;13;32;45;177745;166934;0;344679
