reg;week;P_f;P_h;P;pop_f;pop_h;cl_age90;pop
01;2020-S21;0;0;0;19979;20155;09;40134
01;2020-S21;1;0;1;24994;25489;19;50483
01;2020-S21;1;0;1;17868;16690;29;34558
01;2020-S21;1;0;1;22328;14821;39;37149
01;2020-S21;1;0;1;28652;20276;49;48928
01;2020-S21;0;1;1;33264;27260;59;60524
01;2020-S21;2;0;2;27135;23978;69;51113
01;2020-S21;0;0;0;18401;14661;79;33062
01;2020-S21;0;0;0;9633;6375;89;16008
01;2020-S21;0;0;0;3410;1510;90;4920
01;2020-S21;6;1;7;205664;171215;0;376879
02;2020-S21;2;0;2;16881;17110;09;33991
02;2020-S21;0;0;0;21410;21604;19;43014
02;2020-S21;2;0;2;16017;15479;29;31496
02;2020-S21;0;0;0;19825;14455;39;34280
02;2020-S21;0;2;2;24719;18248;49;42967
02;2020-S21;0;0;0;34361;28310;59;62671
02;2020-S21;0;0;0;28061;24495;69;52556
02;2020-S21;0;0;0;18231;15278;79;33509
02;2020-S21;0;0;0;11090;7677;89;18767
02;2020-S21;0;0;0;3992;1506;90;5498
02;2020-S21;4;2;6;194587;164162;0;358749
03;2020-S21;0;2;2;31123;30920;09;62043
03;2020-S21;8;9;21;29370;29268;19;58638
03;2020-S21;11;18;30;21458;18963;29;40421
03;2020-S21;8;7;20;21276;18326;39;39602
03;2020-S21;7;12;19;18164;16593;49;34757
03;2020-S21;3;2;6;13469;13557;59;27026
03;2020-S21;1;2;3;8776;8670;69;17446
03;2020-S21;1;0;1;3777;3591;79;7368
03;2020-S21;0;0;0;1649;1072;89;2721
03;2020-S21;0;0;0;485;184;90;669
03;2020-S21;39;52;102;149547;141144;0;290691
04;2020-S21;0;0;0;60314;61377;09;121691
04;2020-S21;1;0;1;66065;68387;19;134452
04;2020-S21;0;1;1;51059;47156;29;98215
04;2020-S21;0;0;0;58788;45780;39;104568
04;2020-S21;0;1;1;61408;52207;49;113615
04;2020-S21;1;2;3;64838;60759;59;125597
04;2020-S21;0;1;1;47008;42843;69;89851
04;2020-S21;0;1;1;25509;21184;79;46693
04;2020-S21;0;1;1;13168;7647;89;20815
04;2020-S21;0;0;0;3209;1253;90;4462
04;2020-S21;2;7;9;451366;408593;0;859959
05;2020-S21;0;0;0;362.366008612902;341.338819562748;09;703.704828175651
05;2020-S21;0;0;0;353.376145114279;370.349735405642;19;723.725880519921
05;2020-S21;0;0;0;218.593559489256;256.539602589476;29;475.133162078732
05;2020-S21;0;0;0;404.225408693299;360.321910454353;39;764.547319147651
05;2020-S21;0;0;0;520.067953604221;497.108383964256;49;1017.17633756848
05;2020-S21;0;0;0;468.146063921917;510.087601910415;59;978.233665832332
05;2020-S21;0;0;0;340.368470050554;334.366842191253;69;674.735312241807
05;2020-S21;0;0;0;212.598666888387;192.597753227106;79;405.196420115493
05;2020-S21;0;0;0;148.727797095705;61.8681715431829;89;210.595968638888
05;2020-S21;0;0;0;32.9601271090696;10.9909785719784;90;43.9511056810479
05;2020-S21;0;0;0;3061.43020057959;2935.56979942041;0;5997
06;2020-S21;0;0;0;42583;42380;09;84963
06;2020-S21;4;1;5;33369;31925;19;65294
06;2020-S21;2;0;2;21571;15080;29;36651
06;2020-S21;3;3;6;21550;16147;39;37697
06;2020-S21;1;1;2;14193;13939;49;28132
06;2020-S21;0;0;0;7171;7597;59;14768
06;2020-S21;0;0;0;3629;4117;69;7746
06;2020-S21;0;0;0;1577;1457;79;3034
06;2020-S21;0;0;0;531;474;89;1005
06;2020-S21;0;0;0;88;93;90;181
06;2020-S21;10;5;15;146262;133209;0;279471
07;2020-S21;0;0;0;485;549;09;1034
07;2020-S21;0;0;0;403;432;19;835
07;2020-S21;0;0;0;764;841;29;1605
07;2020-S21;0;0;0;824;928;39;1752
07;2020-S21;0;0;0;788;1020;49;1808
07;2020-S21;0;0;0;678;870;59;1548
07;2020-S21;0;0;0;360;382;69;742
07;2020-S21;0;0;0;231;190;79;421
07;2020-S21;0;0;0;114;67;89;181
07;2020-S21;0;0;0;24;11;90;35
07;2020-S21;0;0;0;4671;5290;0;9961
08;2020-S21;0;0;0;2715.22592983026;2997.75551488675;09;5712.98144471701
08;2020-S21;0;0;0;2778.51901080978;3160.9156459093;19;5939.43465671908
08;2020-S21;1;0;1;2080.8882988764;1718.16634315323;29;3799.05464202964
08;2020-S21;0;0;0;2701.8582062647;1896.52641413317;39;4598.38462039786
08;2020-S21;0;0;0;3151.45861023308;2460.52498233809;49;5611.98359257117
08;2020-S21;0;0;0;2620.29868333099;2422.23566154656;59;5042.53434487755
08;2020-S21;0;0;0;1621.44173420671;1438.58325779464;69;3060.02499200135
08;2020-S21;0;0;0;626.575909335673;526.358467843651;79;1152.93437717932
08;2020-S21;0;0;0;205.018522985054;140.993639349697;89;346.012162334751
08;2020-S21;0;0;0;50.0325684687745;20.62259870351;90;70.6551671722846
08;2020-S21;1;0;1;18551.3174743414;16782.6825256586;0;35334
11;2020-S21;15;11;28;783071;811785;09;1594856
11;2020-S21;35;22;57;761456;784653;19;1546109
11;2020-S21;69;68;137;850145;801772;29;1651917
11;2020-S21;79;49;130;914360;843488;39;1757848
11;2020-S21;75;63;139;845609;826202;49;1671811
11;2020-S21;60;80;140;793566;745070;59;1538636
11;2020-S21;51;71;122;628649;549192;69;1177841
11;2020-S21;56;66;122;434606;358356;79;792962
11;2020-S21;141;63;204;261425;162933;89;424358
11;2020-S21;138;21;160;89253;32619;90;121872
11;2020-S21;719;514;1241;6362140;5916070;0;12278210
24;2020-S21;6;4;10;139720;144686;09;284406
24;2020-S21;9;4;13;152979;161185;19;314164
24;2020-S21;16;12;28;122237;126536;29;248773
24;2020-S21;11;13;24;150359;142009;39;292368
24;2020-S21;16;8;24;161829;158758;49;320587
24;2020-S21;14;10;24;172552;168011;59;340563
24;2020-S21;10;4;14;172509;158177;69;330686
24;2020-S21;12;9;21;129428;110593;79;240021
24;2020-S21;15;11;26;87342;56882;89;144224
24;2020-S21;9;2;11;31210;12071;90;43281
24;2020-S21;118;77;195;1320165;1238908;0;2559073
27;2020-S21;0;0;1;143373;149679;09;293052
27;2020-S21;3;3;6;160962;173003;19;333965
27;2020-S21;17;5;22;133746;142254;29;276000
27;2020-S21;5;5;10;160004;155407;39;315411
27;2020-S21;14;8;22;172333;169564;49;341897
27;2020-S21;10;9;19;189979;183788;59;373767
27;2020-S21;8;11;19;192591;178206;69;370797
27;2020-S21;10;12;22;146876;127546;79;274422
27;2020-S21;22;10;32;96896;61575;89;158471
27;2020-S21;14;0;14;33148;12109;90;45257
27;2020-S21;103;63;167;1429908;1353131;0;2783039
28;2020-S21;0;2;2;180735;186856;09;367591
28;2020-S21;1;0;2;200125;213621;19;413746
28;2020-S21;10;4;14;168922;173007;29;341929
28;2020-S21;4;2;6;196628;188487;39;385115
28;2020-S21;3;4;7;205396;201699;49;407095
28;2020-S21;6;2;8;222002;213866;59;435868
28;2020-S21;1;9;10;224688;203758;69;428446
28;2020-S21;5;5;10;163192;135543;79;298735
28;2020-S21;10;5;15;109691;65377;89;175068
28;2020-S21;16;3;19;37222;12685;90;49907
28;2020-S21;56;36;93;1708601;1594899;0;3303500
32;2020-S21;5;5;10;358062;373689;09;731751
32;2020-S21;20;13;33;387045;406742;19;793787
32;2020-S21;30;15;45;342304;348587;29;690891
32;2020-S21;33;23;56;382485;369972;39;752457
32;2020-S21;47;29;76;382510;376716;49;759226
32;2020-S21;42;33;75;386937;376527;59;763464
32;2020-S21;23;30;53;371211;330938;69;702149
32;2020-S21;34;22;56;250542;201459;79;452001
32;2020-S21;57;27;84;163399;89786;89;253185
32;2020-S21;67;13;80;48384;15367;90;63751
32;2020-S21;358;210;568;3072879;2889783;0;5962662
44;2020-S21;7;8;15;291525;306839;09;598364
44;2020-S21;27;12;40;320255;339504;19;659759
44;2020-S21;45;24;69;302020;314428;29;616448
44;2020-S21;27;21;48;342222;333292;39;675514
44;2020-S21;45;38;83;349727;344491;49;694218
44;2020-S21;55;34;89;381371;373239;59;754610
44;2020-S21;41;30;71;367165;335850;69;703015
44;2020-S21;24;42;66;250387;215436;79;465823
44;2020-S21;70;27;97;170825;105192;89;276017
44;2020-S21;45;17;62;51248;16731;90;67979
44;2020-S21;386;253;640;2826745;2685002;0;5511747
52;2020-S21;5;2;8;213594;223900;09;437494
52;2020-S21;5;8;13;240818;255197;19;496015
52;2020-S21;16;12;29;197010;200630;29;397640
52;2020-S21;20;15;37;231204;224885;39;456089
52;2020-S21;11;16;27;243874;243418;49;487292
52;2020-S21;20;9;29;244100;239116;59;483216
52;2020-S21;2;10;13;241796;221345;69;463141
52;2020-S21;11;7;18;177805;149903;79;327708
52;2020-S21;13;13;26;119561;75822;89;195383
52;2020-S21;17;10;28;42559;15260;90;57819
52;2020-S21;120;103;229;1952321;1849476;0;3801797
53;2020-S21;9;4;13;173813;182358;09;356171
53;2020-S21;7;5;12;202720;214740;19;417460
53;2020-S21;14;8;22;163116;173196;29;336312
53;2020-S21;20;19;39;190526;187674;39;378200
53;2020-S21;19;14;33;212098;212015;49;424113
53;2020-S21;15;20;35;223699;219176;59;442875
53;2020-S21;3;3;6;227435;209274;69;436709
53;2020-S21;5;3;8;169992;140910;79;310902
53;2020-S21;6;5;11;118117;69883;89;188000
53;2020-S21;11;3;14;37370;12267;90;49637
53;2020-S21;109;84;193;1718886;1621493;0;3340379
75;2020-S21;6;4;10;293104;305291;09;598395
75;2020-S21;12;5;17;337141;357785;19;694926
75;2020-S21;24;17;41;295024;300618;29;595642
75;2020-S21;25;13;39;347871;331233;39;679104
75;2020-S21;23;11;34;384742;372771;49;757513
75;2020-S21;22;16;38;413361;390880;59;804241
75;2020-S21;12;13;25;425623;384060;69;809683
75;2020-S21;4;14;18;325086;276298;79;601384
75;2020-S21;14;16;30;213986;139308;89;353294
75;2020-S21;12;4;16;77600;28200;90;105800
75;2020-S21;154;113;268;3113538;2886444;0;5999982
76;2020-S21;1;3;4;305956;318589;09;624545
76;2020-S21;4;1;5;338942;356969;19;695911
76;2020-S21;11;8;19;316210;319570;29;635780
76;2020-S21;7;18;25;356758;337587;39;694345
76;2020-S21;10;10;20;376541;363812;49;740353
76;2020-S21;11;6;17;402608;383750;59;786358
76;2020-S21;7;5;12;394889;358997;69;753886
76;2020-S21;14;14;28;308664;263806;79;572470
76;2020-S21;28;12;40;195838;129272;89;325110
76;2020-S21;46;15;61;69372;26728;90;96100
76;2020-S21;139;93;233;3065778;2859080;0;5924858
84;2020-S21;4;6;11;459549;481088;09;940637
84;2020-S21;4;14;18;487711;511905;19;999616
84;2020-S21;17;30;47;443824;451094;29;894918
84;2020-S21;21;19;41;512522;493262;39;1005784
84;2020-S21;19;19;38;520248;515106;49;1035354
84;2020-S21;17;11;28;529611;514848;59;1044459
84;2020-S21;11;10;21;486720;439940;69;926660
84;2020-S21;14;14;28;372151;315211;79;687362
84;2020-S21;31;21;52;237198;150524;89;387722
84;2020-S21;25;9;34;81185;28680;90;109865
84;2020-S21;163;153;318;4130719;3901658;0;8032377
93;2020-S21;4;5;9;268834;283093;09;551927
93;2020-S21;4;3;8;280751;296087;19;576838
93;2020-S21;18;6;25;254404;255552;29;509956
93;2020-S21;15;6;22;310704;288398;39;599102
93;2020-S21;23;12;36;325559;305827;49;631386
93;2020-S21;22;20;43;353104;325389;59;678493
93;2020-S21;15;19;36;336327;296459;69;632786
93;2020-S21;12;20;33;279820;229699;79;509519
93;2020-S21;33;13;46;171274;113716;89;284990
93;2020-S21;38;10;48;58896;21758;90;80654
93;2020-S21;184;115;307;2639673;2415978;0;5055651
94;2020-S21;0;0;0;16311;17433;09;33744
94;2020-S21;1;0;1;16679;18132;19;34811
94;2020-S21;1;0;1;16782;16579;29;33361
94;2020-S21;1;2;3;23044;20580;39;43624
94;2020-S21;3;1;4;23065;22140;49;45205
94;2020-S21;0;1;1;24549;23421;59;47970
94;2020-S21;1;1;2;23212;21883;69;45095
94;2020-S21;1;0;1;19544;17141;79;36685
94;2020-S21;0;0;0;11227;8178;89;19405
94;2020-S21;0;0;0;3332;1447;90;4779
94;2020-S21;8;5;13;177745;166934;0;344679
01;2020-S22;0;0;0;19979;20155;09;40134
01;2020-S22;0;1;1;24994;25489;19;50483
01;2020-S22;0;1;1;17868;16690;29;34558
01;2020-S22;0;0;0;22328;14821;39;37149
01;2020-S22;1;0;1;28652;20276;49;48928
01;2020-S22;0;0;0;33264;27260;59;60524
01;2020-S22;0;0;0;27135;23978;69;51113
01;2020-S22;0;0;0;18401;14661;79;33062
01;2020-S22;0;0;0;9633;6375;89;16008
01;2020-S22;0;0;0;3410;1510;90;4920
01;2020-S22;1;2;3;205664;171215;0;376879
02;2020-S22;0;0;0;16881;17110;09;33991
02;2020-S22;0;0;0;21410;21604;19;43014
02;2020-S22;0;0;0;16017;15479;29;31496
02;2020-S22;0;0;0;19825;14455;39;34280
02;2020-S22;0;0;0;24719;18248;49;42967
02;2020-S22;3;1;4;34361;28310;59;62671
02;2020-S22;0;0;0;28061;24495;69;52556
02;2020-S22;0;0;0;18231;15278;79;33509
02;2020-S22;1;0;1;11090;7677;89;18767
02;2020-S22;0;0;0;3992;1506;90;5498
02;2020-S22;4;1;5;194587;164162;0;358749
03;2020-S22;4;1;8;31123;30920;09;62043
03;2020-S22;11;11;26;29370;29268;19;58638
03;2020-S22;6;20;28;21458;18963;29;40421
03;2020-S22;12;17;30;21276;18326;39;39602
03;2020-S22;7;11;23;18164;16593;49;34757
03;2020-S22;5;5;12;13469;13557;59;27026
03;2020-S22;3;7;10;8776;8670;69;17446
03;2020-S22;1;1;3;3777;3591;79;7368
03;2020-S22;0;4;4;1649;1072;89;2721
03;2020-S22;0;1;1;485;184;90;669
03;2020-S22;49;78;145;149547;141144;0;290691
04;2020-S22;0;1;1;60314;61377;09;121691
04;2020-S22;3;1;4;66065;68387;19;134452
04;2020-S22;3;2;5;51059;47156;29;98215
04;2020-S22;1;0;1;58788;45780;39;104568
04;2020-S22;1;2;3;61408;52207;49;113615
04;2020-S22;0;0;0;64838;60759;59;125597
04;2020-S22;0;2;2;47008;42843;69;89851
04;2020-S22;0;0;0;25509;21184;79;46693
04;2020-S22;0;0;0;13168;7647;89;20815
04;2020-S22;0;0;0;3209;1253;90;4462
04;2020-S22;8;8;16;451366;408593;0;859959
05;2020-S22;0;0;0;362.366008612902;341.338819562748;09;703.704828175651
05;2020-S22;0;0;0;353.376145114279;370.349735405642;19;723.725880519921
05;2020-S22;0;0;0;218.593559489256;256.539602589476;29;475.133162078732
05;2020-S22;0;0;0;404.225408693299;360.321910454353;39;764.547319147651
05;2020-S22;0;0;0;520.067953604221;497.108383964256;49;1017.17633756848
05;2020-S22;0;0;0;468.146063921917;510.087601910415;59;978.233665832332
05;2020-S22;0;0;0;340.368470050554;334.366842191253;69;674.735312241807
05;2020-S22;0;0;0;212.598666888387;192.597753227106;79;405.196420115493
05;2020-S22;0;0;0;148.727797095705;61.8681715431829;89;210.595968638888
05;2020-S22;0;0;0;32.9601271090696;10.9909785719784;90;43.9511056810479
05;2020-S22;0;0;0;3061.43020057959;2935.56979942041;0;5997
06;2020-S22;3;0;3;42583;42380;09;84963
06;2020-S22;5;29;34;33369;31925;19;65294
06;2020-S22;25;99;124;21571;15080;29;36651
06;2020-S22;22;37;59;21550;16147;39;37697
06;2020-S22;13;22;35;14193;13939;49;28132
06;2020-S22;10;12;22;7171;7597;59;14768
06;2020-S22;3;5;8;3629;4117;69;7746
06;2020-S22;0;2;2;1577;1457;79;3034
06;2020-S22;0;0;0;531;474;89;1005
06;2020-S22;0;0;0;88;93;90;181
06;2020-S22;81;207;288;146262;133209;0;279471
07;2020-S22;0;0;0;485;549;09;1034
07;2020-S22;0;0;0;403;432;19;835
07;2020-S22;0;0;0;764;841;29;1605
07;2020-S22;0;0;0;824;928;39;1752
07;2020-S22;0;0;0;788;1020;49;1808
07;2020-S22;0;0;0;678;870;59;1548
07;2020-S22;0;0;0;360;382;69;742
07;2020-S22;0;0;0;231;190;79;421
07;2020-S22;0;0;0;114;67;89;181
07;2020-S22;0;0;0;24;11;90;35
07;2020-S22;0;0;0;4671;5290;0;9961
08;2020-S22;0;0;0;2715.22592983026;2997.75551488675;09;5712.98144471701
08;2020-S22;0;0;0;2778.51901080978;3160.9156459093;19;5939.43465671908
08;2020-S22;0;0;0;2080.8882988764;1718.16634315323;29;3799.05464202964
08;2020-S22;0;0;0;2701.8582062647;1896.52641413317;39;4598.38462039786
08;2020-S22;0;0;0;3151.45861023308;2460.52498233809;49;5611.98359257117
08;2020-S22;0;1;1;2620.29868333099;2422.23566154656;59;5042.53434487755
08;2020-S22;0;0;0;1621.44173420671;1438.58325779464;69;3060.02499200135
08;2020-S22;0;0;0;626.575909335673;526.358467843651;79;1152.93437717932
08;2020-S22;0;0;0;205.018522985054;140.993639349697;89;346.012162334751
08;2020-S22;0;0;0;50.0325684687745;20.62259870351;90;70.6551671722846
08;2020-S22;0;1;1;18551.3174743414;16782.6825256586;0;35334
11;2020-S22;17;14;45;783071;811785;09;1594856
11;2020-S22;26;46;73;761456;784653;19;1546109
11;2020-S22;85;57;142;850145;801772;29;1651917
11;2020-S22;77;52;130;914360;843488;39;1757848
11;2020-S22;90;66;156;845609;826202;49;1671811
11;2020-S22;82;48;131;793566;745070;59;1538636
11;2020-S22;57;68;125;628649;549192;69;1177841
11;2020-S22;37;40;77;434606;358356;79;792962
11;2020-S22;100;46;147;261425;162933;89;424358
11;2020-S22;132;11;143;89253;32619;90;121872
11;2020-S22;704;448;1173;6362140;5916070;0;12278210
24;2020-S22;1;2;3;139720;144686;09;284406
24;2020-S22;4;3;7;152979;161185;19;314164
24;2020-S22;12;10;23;122237;126536;29;248773
24;2020-S22;11;8;19;150359;142009;39;292368
24;2020-S22;12;13;25;161829;158758;49;320587
24;2020-S22;7;8;15;172552;168011;59;340563
24;2020-S22;9;10;19;172509;158177;69;330686
24;2020-S22;7;5;12;129428;110593;79;240021
24;2020-S22;11;4;15;87342;56882;89;144224
24;2020-S22;12;4;16;31210;12071;90;43281
24;2020-S22;86;67;154;1320165;1238908;0;2559073
27;2020-S22;1;1;2;143373;149679;09;293052
27;2020-S22;1;0;1;160962;173003;19;333965
27;2020-S22;6;3;9;133746;142254;29;276000
27;2020-S22;4;5;9;160004;155407;39;315411
27;2020-S22;4;3;7;172333;169564;49;341897
27;2020-S22;9;5;14;189979;183788;59;373767
27;2020-S22;3;2;5;192591;178206;69;370797
27;2020-S22;3;9;12;146876;127546;79;274422
27;2020-S22;10;8;18;96896;61575;89;158471
27;2020-S22;7;1;8;33148;12109;90;45257
27;2020-S22;48;37;86;1429908;1353131;0;2783039
28;2020-S22;0;4;4;180735;186856;09;367591
28;2020-S22;1;2;3;200125;213621;19;413746
28;2020-S22;4;3;7;168922;173007;29;341929
28;2020-S22;3;1;4;196628;188487;39;385115
28;2020-S22;2;0;2;205396;201699;49;407095
28;2020-S22;5;3;8;222002;213866;59;435868
28;2020-S22;3;2;5;224688;203758;69;428446
28;2020-S22;1;1;2;163192;135543;79;298735
28;2020-S22;5;4;9;109691;65377;89;175068
28;2020-S22;6;1;7;37222;12685;90;49907
28;2020-S22;30;21;51;1708601;1594899;0;3303500
32;2020-S22;13;7;20;358062;373689;09;731751
32;2020-S22;18;32;50;387045;406742;19;793787
32;2020-S22;36;21;58;342304;348587;29;690891
32;2020-S22;36;19;55;382485;369972;39;752457
32;2020-S22;45;24;69;382510;376716;49;759226
32;2020-S22;34;18;52;386937;376527;59;763464
32;2020-S22;17;19;36;371211;330938;69;702149
32;2020-S22;26;20;46;250542;201459;79;452001
32;2020-S22;55;21;77;163399;89786;89;253185
32;2020-S22;44;6;50;48384;15367;90;63751
32;2020-S22;324;187;513;3072879;2889783;0;5962662
44;2020-S22;5;7;12;291525;306839;09;598364
44;2020-S22;9;8;17;320255;339504;19;659759
44;2020-S22;32;25;58;302020;314428;29;616448
44;2020-S22;26;19;46;342222;333292;39;675514
44;2020-S22;24;21;45;349727;344491;49;694218
44;2020-S22;34;15;50;381371;373239;59;754610
44;2020-S22;26;20;46;367165;335850;69;703015
44;2020-S22;19;21;40;250387;215436;79;465823
44;2020-S22;40;26;66;170825;105192;89;276017
44;2020-S22;37;6;43;51248;16731;90;67979
44;2020-S22;252;168;423;2826745;2685002;0;5511747
52;2020-S22;4;9;14;213594;223900;09;437494
52;2020-S22;9;15;24;240818;255197;19;496015
52;2020-S22;14;15;29;197010;200630;29;397640
52;2020-S22;17;21;38;231204;224885;39;456089
52;2020-S22;17;21;38;243874;243418;49;487292
52;2020-S22;17;16;33;244100;239116;59;483216
52;2020-S22;9;5;14;241796;221345;69;463141
52;2020-S22;10;6;16;177805;149903;79;327708
52;2020-S22;4;6;10;119561;75822;89;195383
52;2020-S22;17;8;25;42559;15260;90;57819
52;2020-S22;118;122;241;1952321;1849476;0;3801797
53;2020-S22;2;1;3;173813;182358;09;356171
53;2020-S22;4;8;12;202720;214740;19;417460
53;2020-S22;6;7;13;163116;173196;29;336312
53;2020-S22;8;7;15;190526;187674;39;378200
53;2020-S22;7;7;14;212098;212015;49;424113
53;2020-S22;4;4;8;223699;219176;59;442875
53;2020-S22;3;2;5;227435;209274;69;436709
53;2020-S22;4;0;4;169992;140910;79;310902
53;2020-S22;5;5;10;118117;69883;89;188000
53;2020-S22;5;1;6;37370;12267;90;49637
53;2020-S22;48;42;90;1718886;1621493;0;3340379
75;2020-S22;5;4;9;293104;305291;09;598395
75;2020-S22;2;5;7;337141;357785;19;694926
75;2020-S22;16;16;32;295024;300618;29;595642
75;2020-S22;6;13;19;347871;331233;39;679104
75;2020-S22;11;20;31;384742;372771;49;757513
75;2020-S22;14;7;21;413361;390880;59;804241
75;2020-S22;7;3;10;425623;384060;69;809683
75;2020-S22;5;6;11;325086;276298;79;601384
75;2020-S22;10;7;17;213986;139308;89;353294
75;2020-S22;8;2;10;77600;28200;90;105800
75;2020-S22;84;83;167;3113538;2886444;0;5999982
76;2020-S22;2;1;3;305956;318589;09;624545
76;2020-S22;2;2;4;338942;356969;19;695911
76;2020-S22;6;6;12;316210;319570;29;635780
76;2020-S22;11;10;21;356758;337587;39;694345
76;2020-S22;11;8;19;376541;363812;49;740353
76;2020-S22;8;8;16;402608;383750;59;786358
76;2020-S22;7;3;10;394889;358997;69;753886
76;2020-S22;4;7;11;308664;263806;79;572470
76;2020-S22;10;2;12;195838;129272;89;325110
76;2020-S22;10;6;16;69372;26728;90;96100
76;2020-S22;71;53;124;3065778;2859080;0;5924858
84;2020-S22;1;3;4;459549;481088;09;940637
84;2020-S22;6;5;11;487711;511905;19;999616
84;2020-S22;14;9;23;443824;451094;29;894918
84;2020-S22;15;10;25;512522;493262;39;1005784
84;2020-S22;21;10;32;520248;515106;49;1035354
84;2020-S22;21;19;40;529611;514848;59;1044459
84;2020-S22;9;16;25;486720;439940;69;926660
84;2020-S22;15;10;26;372151;315211;79;687362
84;2020-S22;17;9;26;237198;150524;89;387722
84;2020-S22;19;2;21;81185;28680;90;109865
84;2020-S22;138;93;260;4130719;3901658;0;8032377
93;2020-S22;2;3;5;268834;283093;09;551927
93;2020-S22;5;2;7;280751;296087;19;576838
93;2020-S22;11;4;18;254404;255552;29;509956
93;2020-S22;10;14;26;310704;288398;39;599102
93;2020-S22;12;26;39;325559;305827;49;631386
93;2020-S22;14;9;24;353104;325389;59;678493
93;2020-S22;14;12;29;336327;296459;69;632786
93;2020-S22;8;12;23;279820;229699;79;509519
93;2020-S22;12;9;22;171274;113716;89;284990
93;2020-S22;19;9;28;58896;21758;90;80654
93;2020-S22;107;100;221;2639673;2415978;0;5055651
94;2020-S22;0;0;0;16311;17433;09;33744
94;2020-S22;0;0;0;16679;18132;19;34811
94;2020-S22;0;0;0;16782;16579;29;33361
94;2020-S22;1;0;1;23044;20580;39;43624
94;2020-S22;0;0;0;23065;22140;49;45205
94;2020-S22;0;0;0;24549;23421;59;47970
94;2020-S22;1;1;2;23212;21883;69;45095
94;2020-S22;0;0;0;19544;17141;79;36685
94;2020-S22;2;1;3;11227;8178;89;19405
94;2020-S22;0;0;0;3332;1447;90;4779
94;2020-S22;4;2;6;177745;166934;0;344679
01;2020-S23;0;0;0;19979;20155;09;40134
01;2020-S23;1;0;1;24994;25489;19;50483
01;2020-S23;1;1;2;17868;16690;29;34558
01;2020-S23;0;0;0;22328;14821;39;37149
01;2020-S23;1;0;1;28652;20276;49;48928
01;2020-S23;1;0;1;33264;27260;59;60524
01;2020-S23;0;2;2;27135;23978;69;51113
01;2020-S23;0;0;0;18401;14661;79;33062
01;2020-S23;0;0;0;9633;6375;89;16008
01;2020-S23;0;0;0;3410;1510;90;4920
01;2020-S23;4;3;7;205664;171215;0;376879
02;2020-S23;0;0;0;16881;17110;09;33991
02;2020-S23;1;0;1;21410;21604;19;43014
02;2020-S23;0;1;1;16017;15479;29;31496
02;2020-S23;2;0;2;19825;14455;39;34280
02;2020-S23;0;0;0;24719;18248;49;42967
02;2020-S23;1;0;1;34361;28310;59;62671
02;2020-S23;1;1;2;28061;24495;69;52556
02;2020-S23;2;0;2;18231;15278;79;33509
02;2020-S23;0;0;0;11090;7677;89;18767
02;2020-S23;0;0;0;3992;1506;90;5498
02;2020-S23;7;2;9;194587;164162;0;358749
03;2020-S23;9;6;15;31123;30920;09;62043
03;2020-S23;17;11;31;29370;29268;19;58638
03;2020-S23;20;18;39;21458;18963;29;40421
03;2020-S23;29;21;51;21276;18326;39;39602
03;2020-S23;23;20;45;18164;16593;49;34757
03;2020-S23;12;19;31;13469;13557;59;27026
03;2020-S23;4;13;17;8776;8670;69;17446
03;2020-S23;2;2;4;3777;3591;79;7368
03;2020-S23;0;3;3;1649;1072;89;2721
03;2020-S23;0;0;0;485;184;90;669
03;2020-S23;116;114;237;149547;141144;0;290691
04;2020-S23;0;0;5;60314;61377;09;121691
04;2020-S23;1;0;1;66065;68387;19;134452
04;2020-S23;1;1;2;51059;47156;29;98215
04;2020-S23;0;0;0;58788;45780;39;104568
04;2020-S23;1;2;3;61408;52207;49;113615
04;2020-S23;1;0;1;64838;60759;59;125597
04;2020-S23;0;0;0;47008;42843;69;89851
04;2020-S23;0;0;0;25509;21184;79;46693
04;2020-S23;0;0;0;13168;7647;89;20815
04;2020-S23;0;0;0;3209;1253;90;4462
04;2020-S23;4;3;12;451366;408593;0;859959
05;2020-S23;0;0;0;362.366008612902;341.338819562748;09;703.704828175651
05;2020-S23;0;0;0;353.376145114279;370.349735405642;19;723.725880519921
05;2020-S23;0;0;0;218.593559489256;256.539602589476;29;475.133162078732
05;2020-S23;1;0;1;404.225408693299;360.321910454353;39;764.547319147651
05;2020-S23;0;0;0;520.067953604221;497.108383964256;49;1017.17633756848
05;2020-S23;0;0;0;468.146063921917;510.087601910415;59;978.233665832332
05;2020-S23;0;0;0;340.368470050554;334.366842191253;69;674.735312241807
05;2020-S23;0;0;0;212.598666888387;192.597753227106;79;405.196420115493
05;2020-S23;0;0;0;148.727797095705;61.8681715431829;89;210.595968638888
05;2020-S23;0;0;0;32.9601271090696;10.9909785719784;90;43.9511056810479
05;2020-S23;1;0;1;3061.43020057959;2935.56979942041;0;5997
06;2020-S23;1;2;3;42583;42380;09;84963
06;2020-S23;12;10;24;33369;31925;19;65294
06;2020-S23;17;24;41;21571;15080;29;36651
06;2020-S23;16;15;31;21550;16147;39;37697
06;2020-S23;14;13;27;14193;13939;49;28132
06;2020-S23;13;10;23;7171;7597;59;14768
06;2020-S23;2;6;8;3629;4117;69;7746
06;2020-S23;2;3;5;1577;1457;79;3034
06;2020-S23;0;2;2;531;474;89;1005
06;2020-S23;0;1;1;88;93;90;181
06;2020-S23;77;86;165;146262;133209;0;279471
07;2020-S23;0;0;0;485;549;09;1034
07;2020-S23;0;0;0;403;432;19;835
07;2020-S23;0;0;0;764;841;29;1605
07;2020-S23;0;0;0;824;928;39;1752
07;2020-S23;0;0;0;788;1020;49;1808
07;2020-S23;0;0;0;678;870;59;1548
07;2020-S23;0;0;0;360;382;69;742
07;2020-S23;0;0;0;231;190;79;421
07;2020-S23;0;0;0;114;67;89;181
07;2020-S23;0;0;0;24;11;90;35
07;2020-S23;0;0;0;4671;5290;0;9961
08;2020-S23;0;0;0;2715.22592983026;2997.75551488675;09;5712.98144471701
08;2020-S23;0;0;0;2778.51901080978;3160.9156459093;19;5939.43465671908
08;2020-S23;0;0;0;2080.8882988764;1718.16634315323;29;3799.05464202964
08;2020-S23;0;0;0;2701.8582062647;1896.52641413317;39;4598.38462039786
08;2020-S23;0;0;0;3151.45861023308;2460.52498233809;49;5611.98359257117
08;2020-S23;0;0;0;2620.29868333099;2422.23566154656;59;5042.53434487755
08;2020-S23;0;0;0;1621.44173420671;1438.58325779464;69;3060.02499200135
08;2020-S23;0;0;0;626.575909335673;526.358467843651;79;1152.93437717932
08;2020-S23;0;0;0;205.018522985054;140.993639349697;89;346.012162334751
08;2020-S23;0;0;0;50.0325684687745;20.62259870351;90;70.6551671722846
08;2020-S23;0;0;0;18551.3174743414;16782.6825256586;0;35334
11;2020-S23;8;13;22;783071;811785;09;1594856
11;2020-S23;15;20;35;761456;784653;19;1546109
11;2020-S23;55;53;111;850145;801772;29;1651917
11;2020-S23;63;48;114;914360;843488;39;1757848
11;2020-S23;66;56;122;845609;826202;49;1671811
11;2020-S23;61;57;118;793566;745070;59;1538636
11;2020-S23;55;54;109;628649;549192;69;1177841
11;2020-S23;34;28;62;434606;358356;79;792962
11;2020-S23;49;23;72;261425;162933;89;424358
11;2020-S23;63;12;75;89253;32619;90;121872
11;2020-S23;469;368;848;6362140;5916070;0;12278210
24;2020-S23;1;0;1;139720;144686;09;284406
24;2020-S23;3;1;4;152979;161185;19;314164
24;2020-S23;5;2;7;122237;126536;29;248773
24;2020-S23;3;0;3;150359;142009;39;292368
24;2020-S23;2;4;6;161829;158758;49;320587
24;2020-S23;6;5;11;172552;168011;59;340563
24;2020-S23;1;1;2;172509;158177;69;330686
24;2020-S23;3;2;5;129428;110593;79;240021
24;2020-S23;9;4;13;87342;56882;89;144224
24;2020-S23;6;3;9;31210;12071;90;43281
24;2020-S23;39;22;61;1320165;1238908;0;2559073
27;2020-S23;0;0;0;143373;149679;09;293052
27;2020-S23;0;2;2;160962;173003;19;333965
27;2020-S23;7;4;11;133746;142254;29;276000
27;2020-S23;6;0;6;160004;155407;39;315411
27;2020-S23;4;0;4;172333;169564;49;341897
27;2020-S23;7;2;9;189979;183788;59;373767
27;2020-S23;1;1;2;192591;178206;69;370797
27;2020-S23;3;7;10;146876;127546;79;274422
27;2020-S23;13;8;21;96896;61575;89;158471
27;2020-S23;10;2;12;33148;12109;90;45257
27;2020-S23;51;26;77;1429908;1353131;0;2783039
28;2020-S23;2;5;7;180735;186856;09;367591
28;2020-S23;0;4;4;200125;213621;19;413746
28;2020-S23;2;6;8;168922;173007;29;341929
28;2020-S23;4;3;7;196628;188487;39;385115
28;2020-S23;3;1;4;205396;201699;49;407095
28;2020-S23;2;1;3;222002;213866;59;435868
28;2020-S23;0;0;0;224688;203758;69;428446
28;2020-S23;1;3;4;163192;135543;79;298735
28;2020-S23;4;1;5;109691;65377;89;175068
28;2020-S23;1;1;2;37222;12685;90;49907
28;2020-S23;19;25;44;1708601;1594899;0;3303500
32;2020-S23;7;13;20;358062;373689;09;731751
32;2020-S23;12;8;20;387045;406742;19;793787
32;2020-S23;29;15;44;342304;348587;29;690891
32;2020-S23;36;17;53;382485;369972;39;752457
32;2020-S23;31;18;49;382510;376716;49;759226
32;2020-S23;17;16;33;386937;376527;59;763464
32;2020-S23;23;21;45;371211;330938;69;702149
32;2020-S23;9;18;28;250542;201459;79;452001
32;2020-S23;40;17;57;163399;89786;89;253185
32;2020-S23;34;12;46;48384;15367;90;63751
32;2020-S23;238;155;396;3072879;2889783;0;5962662
44;2020-S23;8;7;16;291525;306839;09;598364
44;2020-S23;8;7;15;320255;339504;19;659759
44;2020-S23;41;26;67;302020;314428;29;616448
44;2020-S23;40;19;60;342222;333292;39;675514
44;2020-S23;38;21;59;349727;344491;49;694218
44;2020-S23;41;13;55;381371;373239;59;754610
44;2020-S23;23;23;47;367165;335850;69;703015
44;2020-S23;28;27;55;250387;215436;79;465823
44;2020-S23;45;28;73;170825;105192;89;276017
44;2020-S23;33;8;41;51248;16731;90;67979
44;2020-S23;305;179;503;2826745;2685002;0;5511747
52;2020-S23;2;8;10;213594;223900;09;437494
52;2020-S23;6;23;30;240818;255197;19;496015
52;2020-S23;16;3;19;197010;200630;29;397640
52;2020-S23;6;17;23;231204;224885;39;456089
52;2020-S23;11;9;20;243874;243418;49;487292
52;2020-S23;13;7;21;244100;239116;59;483216
52;2020-S23;3;5;8;241796;221345;69;463141
52;2020-S23;9;0;9;177805;149903;79;327708
52;2020-S23;5;4;9;119561;75822;89;195383
52;2020-S23;7;2;10;42559;15260;90;57819
52;2020-S23;78;78;159;1952321;1849476;0;3801797
53;2020-S23;1;2;3;173813;182358;09;356171
53;2020-S23;2;0;2;202720;214740;19;417460
53;2020-S23;1;3;4;163116;173196;29;336312
53;2020-S23;2;2;4;190526;187674;39;378200
53;2020-S23;0;3;3;212098;212015;49;424113
53;2020-S23;3;5;8;223699;219176;59;442875
53;2020-S23;1;0;1;227435;209274;69;436709
53;2020-S23;0;1;1;169992;140910;79;310902
53;2020-S23;2;3;5;118117;69883;89;188000
53;2020-S23;0;0;0;37370;12267;90;49637
53;2020-S23;12;19;31;1718886;1621493;0;3340379
75;2020-S23;2;0;2;293104;305291;09;598395
75;2020-S23;7;2;9;337141;357785;19;694926
75;2020-S23;3;2;5;295024;300618;29;595642
75;2020-S23;5;3;8;347871;331233;39;679104
75;2020-S23;4;1;5;384742;372771;49;757513
75;2020-S23;3;7;10;413361;390880;59;804241
75;2020-S23;4;5;9;425623;384060;69;809683
75;2020-S23;5;8;13;325086;276298;79;601384
75;2020-S23;2;2;4;213986;139308;89;353294
75;2020-S23;2;0;2;77600;28200;90;105800
75;2020-S23;37;31;68;3113538;2886444;0;5999982
76;2020-S23;1;2;4;305956;318589;09;624545
76;2020-S23;3;1;4;338942;356969;19;695911
76;2020-S23;3;10;13;316210;319570;29;635780
76;2020-S23;11;7;18;356758;337587;39;694345
76;2020-S23;9;7;16;376541;363812;49;740353
76;2020-S23;5;8;14;402608;383750;59;786358
76;2020-S23;2;3;5;394889;358997;69;753886
76;2020-S23;1;3;4;308664;263806;79;572470
76;2020-S23;8;5;13;195838;129272;89;325110
76;2020-S23;8;0;8;69372;26728;90;96100
76;2020-S23;51;46;99;3065778;2859080;0;5924858
84;2020-S23;0;1;2;459549;481088;09;940637
84;2020-S23;3;5;8;487711;511905;19;999616
84;2020-S23;17;13;30;443824;451094;29;894918
84;2020-S23;11;9;20;512522;493262;39;1005784
84;2020-S23;12;3;15;520248;515106;49;1035354
84;2020-S23;12;6;18;529611;514848;59;1044459
84;2020-S23;7;5;12;486720;439940;69;926660
84;2020-S23;8;3;11;372151;315211;79;687362
84;2020-S23;20;9;29;237198;150524;89;387722
84;2020-S23;26;8;34;81185;28680;90;109865
84;2020-S23;116;63;185;4130719;3901658;0;8032377
93;2020-S23;4;0;5;268834;283093;09;551927
93;2020-S23;4;1;5;280751;296087;19;576838
93;2020-S23;12;19;32;254404;255552;29;509956
93;2020-S23;22;34;60;310704;288398;39;599102
93;2020-S23;15;34;54;325559;305827;49;631386
93;2020-S23;12;20;32;353104;325389;59;678493
93;2020-S23;8;14;23;336327;296459;69;632786
93;2020-S23;9;12;22;279820;229699;79;509519
93;2020-S23;18;11;29;171274;113716;89;284990
93;2020-S23;17;4;21;58896;21758;90;80654
93;2020-S23;121;149;284;2639673;2415978;0;5055651
94;2020-S23;0;0;0;16311;17433;09;33744
94;2020-S23;0;0;0;16679;18132;19;34811
94;2020-S23;0;0;0;16782;16579;29;33361
94;2020-S23;0;1;1;23044;20580;39;43624
94;2020-S23;1;0;1;23065;22140;49;45205
94;2020-S23;0;1;1;24549;23421;59;47970
94;2020-S23;0;0;0;23212;21883;69;45095
94;2020-S23;0;0;0;19544;17141;79;36685
94;2020-S23;1;1;2;11227;8178;89;19405
94;2020-S23;1;1;2;3332;1447;90;4779
94;2020-S23;3;4;7;177745;166934;0;344679
01;2020-S24;0;0;0;19979;20155;09;40134
01;2020-S24;0;0;0;24994;25489;19;50483
01;2020-S24;0;0;1;17868;16690;29;34558
01;2020-S24;0;0;0;22328;14821;39;37149
01;2020-S24;0;0;0;28652;20276;49;48928
01;2020-S24;1;0;2;33264;27260;59;60524
01;2020-S24;0;0;0;27135;23978;69;51113
01;2020-S24;0;0;1;18401;14661;79;33062
01;2020-S24;0;0;0;9633;6375;89;16008
01;2020-S24;0;0;0;3410;1510;90;4920
01;2020-S24;1;0;4;205664;171215;0;376879
02;2020-S24;1;0;1;16881;17110;09;33991
02;2020-S24;1;1;2;21410;21604;19;43014
02;2020-S24;5;1;6;16017;15479;29;31496
02;2020-S24;0;0;0;19825;14455;39;34280
02;2020-S24;3;1;4;24719;18248;49;42967
02;2020-S24;1;0;1;34361;28310;59;62671
02;2020-S24;0;2;3;28061;24495;69;52556
02;2020-S24;0;0;0;18231;15278;79;33509
02;2020-S24;0;0;0;11090;7677;89;18767
02;2020-S24;0;0;0;3992;1506;90;5498
02;2020-S24;11;5;17;194587;164162;0;358749
03;2020-S24;25;27;56;31123;30920;09;62043
03;2020-S24;32;37;73;29370;29268;19;58638
03;2020-S24;51;37;95;21458;18963;29;40421
03;2020-S24;73;58;136;21276;18326;39;39602
03;2020-S24;44;32;77;18164;16593;49;34757
03;2020-S24;23;29;53;13469;13557;59;27026
03;2020-S24;20;18;39;8776;8670;69;17446
03;2020-S24;13;12;25;3777;3591;79;7368
03;2020-S24;6;3;9;1649;1072;89;2721
03;2020-S24;0;0;0;485;184;90;669
03;2020-S24;287;253;563;149547;141144;0;290691
04;2020-S24;1;0;1;60314;61377;09;121691
04;2020-S24;1;1;2;66065;68387;19;134452
04;2020-S24;1;1;2;51059;47156;29;98215
04;2020-S24;1;0;1;58788;45780;39;104568
04;2020-S24;1;0;1;61408;52207;49;113615
04;2020-S24;0;2;2;64838;60759;59;125597
04;2020-S24;0;1;1;47008;42843;69;89851
04;2020-S24;1;0;1;25509;21184;79;46693
04;2020-S24;0;0;0;13168;7647;89;20815
04;2020-S24;0;0;0;3209;1253;90;4462
04;2020-S24;6;5;11;451366;408593;0;859959
05;2020-S24;0;0;0;362.366008612902;341.338819562748;09;703.704828175651
05;2020-S24;0;0;0;353.376145114279;370.349735405642;19;723.725880519921
05;2020-S24;0;0;0;218.593559489256;256.539602589476;29;475.133162078732
05;2020-S24;0;0;0;404.225408693299;360.321910454353;39;764.547319147651
05;2020-S24;0;0;0;520.067953604221;497.108383964256;49;1017.17633756848
05;2020-S24;0;0;0;468.146063921917;510.087601910415;59;978.233665832332
05;2020-S24;0;0;0;340.368470050554;334.366842191253;69;674.735312241807
05;2020-S24;0;0;0;212.598666888387;192.597753227106;79;405.196420115493
05;2020-S24;0;0;0;148.727797095705;61.8681715431829;89;210.595968638888
05;2020-S24;0;0;0;32.9601271090696;10.9909785719784;90;43.9511056810479
05;2020-S24;0;0;0;3061.43020057959;2935.56979942041;0;5997
06;2020-S24;0;5;5;42583;42380;09;84963
06;2020-S24;6;6;12;33369;31925;19;65294
06;2020-S24;15;15;31;21571;15080;29;36651
06;2020-S24;21;17;38;21550;16147;39;37697
06;2020-S24;9;9;18;14193;13939;49;28132
06;2020-S24;9;6;15;7171;7597;59;14768
06;2020-S24;3;4;7;3629;4117;69;7746
06;2020-S24;2;2;4;1577;1457;79;3034
06;2020-S24;0;2;2;531;474;89;1005
06;2020-S24;0;0;0;88;93;90;181
06;2020-S24;65;66;132;146262;133209;0;279471
07;2020-S24;0;0;0;485;549;09;1034
07;2020-S24;0;0;0;403;432;19;835
07;2020-S24;0;0;0;764;841;29;1605
07;2020-S24;0;0;0;824;928;39;1752
07;2020-S24;0;0;0;788;1020;49;1808
07;2020-S24;0;0;0;678;870;59;1548
07;2020-S24;0;0;0;360;382;69;742
07;2020-S24;0;0;0;231;190;79;421
07;2020-S24;0;0;0;114;67;89;181
07;2020-S24;0;0;0;24;11;90;35
07;2020-S24;0;0;0;4671;5290;0;9961
08;2020-S24;0;0;0;2715.22592983026;2997.75551488675;09;5712.98144471701
08;2020-S24;0;1;1;2778.51901080978;3160.9156459093;19;5939.43465671908
08;2020-S24;0;0;0;2080.8882988764;1718.16634315323;29;3799.05464202964
08;2020-S24;0;0;0;2701.8582062647;1896.52641413317;39;4598.38462039786
08;2020-S24;0;0;0;3151.45861023308;2460.52498233809;49;5611.98359257117
08;2020-S24;0;0;0;2620.29868333099;2422.23566154656;59;5042.53434487755
08;2020-S24;0;0;0;1621.44173420671;1438.58325779464;69;3060.02499200135
08;2020-S24;0;0;0;626.575909335673;526.358467843651;79;1152.93437717932
08;2020-S24;0;0;0;205.018522985054;140.993639349697;89;346.012162334751
08;2020-S24;0;0;0;50.0325684687745;20.62259870351;90;70.6551671722846
08;2020-S24;0;1;1;18551.3174743414;16782.6825256586;0;35334
11;2020-S24;13;24;38;783071;811785;09;1594856
11;2020-S24;30;19;52;761456;784653;19;1546109
11;2020-S24;48;45;101;850145;801772;29;1651917
11;2020-S24;54;51;109;914360;843488;39;1757848
11;2020-S24;51;46;102;845609;826202;49;1671811
11;2020-S24;48;49;103;793566;745070;59;1538636
11;2020-S24;28;43;72;628649;549192;69;1177841
11;2020-S24;23;34;58;434606;358356;79;792962
11;2020-S24;33;21;55;261425;162933;89;424358
11;2020-S24;39;9;48;89253;32619;90;121872
11;2020-S24;367;341;739;6362140;5916070;0;12278210
24;2020-S24;2;2;4;139720;144686;09;284406
24;2020-S24;1;1;2;152979;161185;19;314164
24;2020-S24;3;0;4;122237;126536;29;248773
24;2020-S24;5;2;7;150359;142009;39;292368
24;2020-S24;8;2;10;161829;158758;49;320587
24;2020-S24;4;4;8;172552;168011;59;340563
24;2020-S24;3;8;13;172509;158177;69;330686
24;2020-S24;4;1;5;129428;110593;79;240021
24;2020-S24;6;3;9;87342;56882;89;144224
24;2020-S24;5;1;6;31210;12071;90;43281
24;2020-S24;41;24;68;1320165;1238908;0;2559073
27;2020-S24;0;1;3;143373;149679;09;293052
27;2020-S24;2;0;4;160962;173003;19;333965
27;2020-S24;3;3;10;133746;142254;29;276000
27;2020-S24;1;1;3;160004;155407;39;315411
27;2020-S24;3;1;9;172333;169564;49;341897
27;2020-S24;5;2;9;189979;183788;59;373767
27;2020-S24;0;1;1;192591;178206;69;370797
27;2020-S24;2;3;5;146876;127546;79;274422
27;2020-S24;4;6;13;96896;61575;89;158471
27;2020-S24;5;1;6;33148;12109;90;45257
27;2020-S24;25;19;63;1429908;1353131;0;2783039
28;2020-S24;1;4;5;180735;186856;09;367591
28;2020-S24;3;1;5;200125;213621;19;413746
28;2020-S24;4;6;12;168922;173007;29;341929
28;2020-S24;12;2;14;196628;188487;39;385115
28;2020-S24;2;7;10;205396;201699;49;407095
28;2020-S24;2;2;4;222002;213866;59;435868
28;2020-S24;7;3;10;224688;203758;69;428446
28;2020-S24;4;2;6;163192;135543;79;298735
28;2020-S24;2;2;4;109691;65377;89;175068
28;2020-S24;1;0;1;37222;12685;90;49907
28;2020-S24;38;29;71;1708601;1594899;0;3303500
32;2020-S24;11;13;26;358062;373689;09;731751
32;2020-S24;11;14;29;387045;406742;19;793787
32;2020-S24;24;21;55;342304;348587;29;690891
32;2020-S24;30;17;56;382485;369972;39;752457
32;2020-S24;18;18;46;382510;376716;49;759226
32;2020-S24;10;10;36;386937;376527;59;763464
32;2020-S24;8;13;28;371211;330938;69;702149
32;2020-S24;15;9;25;250542;201459;79;452001
32;2020-S24;21;9;40;163399;89786;89;253185
32;2020-S24;18;3;25;48384;15367;90;63751
32;2020-S24;166;127;366;3072879;2889783;0;5962662
44;2020-S24;1;8;16;291525;306839;09;598364
44;2020-S24;7;7;20;320255;339504;19;659759
44;2020-S24;24;18;49;302020;314428;29;616448
44;2020-S24;24;12;46;342222;333292;39;675514
44;2020-S24;19;11;35;349727;344491;49;694218
44;2020-S24;26;16;48;381371;373239;59;754610
44;2020-S24;19;17;39;367165;335850;69;703015
44;2020-S24;23;17;46;250387;215436;79;465823
44;2020-S24;23;7;36;170825;105192;89;276017
44;2020-S24;20;6;27;51248;16731;90;67979
44;2020-S24;186;119;362;2826745;2685002;0;5511747
52;2020-S24;0;2;6;213594;223900;09;437494
52;2020-S24;4;3;8;240818;255197;19;496015
52;2020-S24;10;11;24;197010;200630;29;397640
52;2020-S24;7;7;14;231204;224885;39;456089
52;2020-S24;9;7;19;243874;243418;49;487292
52;2020-S24;11;6;19;244100;239116;59;483216
52;2020-S24;3;4;7;241796;221345;69;463141
52;2020-S24;4;7;11;177805;149903;79;327708
52;2020-S24;4;4;9;119561;75822;89;195383
52;2020-S24;8;2;13;42559;15260;90;57819
52;2020-S24;60;53;130;1952321;1849476;0;3801797
53;2020-S24;0;1;1;173813;182358;09;356171
53;2020-S24;1;0;2;202720;214740;19;417460
53;2020-S24;0;2;2;163116;173196;29;336312
53;2020-S24;1;3;4;190526;187674;39;378200
53;2020-S24;0;1;1;212098;212015;49;424113
53;2020-S24;1;2;3;223699;219176;59;442875
53;2020-S24;2;1;3;227435;209274;69;436709
53;2020-S24;0;2;2;169992;140910;79;310902
53;2020-S24;0;0;0;118117;69883;89;188000
53;2020-S24;1;2;3;37370;12267;90;49637
53;2020-S24;6;14;21;1718886;1621493;0;3340379
75;2020-S24;1;2;3;293104;305291;09;598395
75;2020-S24;2;0;2;337141;357785;19;694926
75;2020-S24;5;6;14;295024;300618;29;595642
75;2020-S24;1;4;5;347871;331233;39;679104
75;2020-S24;5;3;10;384742;372771;49;757513
75;2020-S24;6;3;9;413361;390880;59;804241
75;2020-S24;4;1;5;425623;384060;69;809683
75;2020-S24;2;2;4;325086;276298;79;601384
75;2020-S24;1;3;4;213986;139308;89;353294
75;2020-S24;1;0;1;77600;28200;90;105800
75;2020-S24;28;24;57;3113538;2886444;0;5999982
76;2020-S24;12;2;14;305956;318589;09;624545
76;2020-S24;12;6;20;338942;356969;19;695911
76;2020-S24;16;22;40;316210;319570;29;635780
76;2020-S24;11;6;19;356758;337587;39;694345
76;2020-S24;27;14;43;376541;363812;49;740353
76;2020-S24;13;23;36;402608;383750;59;786358
76;2020-S24;5;10;15;394889;358997;69;753886
76;2020-S24;3;3;6;308664;263806;79;572470
76;2020-S24;5;3;8;195838;129272;89;325110
76;2020-S24;2;1;3;69372;26728;90;96100
76;2020-S24;106;90;204;3065778;2859080;0;5924858
84;2020-S24;3;0;5;459549;481088;09;940637
84;2020-S24;3;9;23;487711;511905;19;999616
84;2020-S24;14;10;28;443824;451094;29;894918
84;2020-S24;14;8;23;512522;493262;39;1005784
84;2020-S24;12;9;24;520248;515106;49;1035354
84;2020-S24;6;12;22;529611;514848;59;1044459
84;2020-S24;10;7;17;486720;439940;69;926660
84;2020-S24;5;11;18;372151;315211;79;687362
84;2020-S24;19;9;28;237198;150524;89;387722
84;2020-S24;12;6;18;81185;28680;90;109865
84;2020-S24;98;81;206;4130719;3901658;0;8032377
93;2020-S24;1;5;12;268834;283093;09;551927
93;2020-S24;2;6;11;280751;296087;19;576838
93;2020-S24;12;16;30;254404;255552;29;509956
93;2020-S24;17;31;55;310704;288398;39;599102
93;2020-S24;13;41;59;325559;305827;49;631386
93;2020-S24;15;21;37;353104;325389;59;678493
93;2020-S24;6;7;22;336327;296459;69;632786
93;2020-S24;4;4;9;279820;229699;79;509519
93;2020-S24;6;2;12;171274;113716;89;284990
93;2020-S24;5;1;10;58896;21758;90;80654
93;2020-S24;81;134;257;2639673;2415978;0;5055651
94;2020-S24;0;0;0;16311;17433;09;33744
94;2020-S24;0;0;0;16679;18132;19;34811
94;2020-S24;1;0;1;16782;16579;29;33361
94;2020-S24;2;1;3;23044;20580;39;43624
94;2020-S24;0;0;0;23065;22140;49;45205
94;2020-S24;0;0;1;24549;23421;59;47970
94;2020-S24;0;0;0;23212;21883;69;45095
94;2020-S24;0;0;0;19544;17141;79;36685
94;2020-S24;0;0;0;11227;8178;89;19405
94;2020-S24;0;0;0;3332;1447;90;4779
94;2020-S24;3;1;5;177745;166934;0;344679
01;2020-S25;0;0;0;19979;20155;09;40134
01;2020-S25;0;0;0;24994;25489;19;50483
01;2020-S25;0;2;4;17868;16690;29;34558
01;2020-S25;0;1;1;22328;14821;39;37149
01;2020-S25;0;0;1;28652;20276;49;48928
01;2020-S25;1;0;1;33264;27260;59;60524
01;2020-S25;0;0;0;27135;23978;69;51113
01;2020-S25;0;1;1;18401;14661;79;33062
01;2020-S25;0;0;0;9633;6375;89;16008
01;2020-S25;0;0;0;3410;1510;90;4920
01;2020-S25;1;4;8;205664;171215;0;376879
02;2020-S25;0;1;1;16881;17110;09;33991
02;2020-S25;0;0;0;21410;21604;19;43014
02;2020-S25;2;1;3;16017;15479;29;31496
02;2020-S25;0;0;0;19825;14455;39;34280
02;2020-S25;2;0;2;24719;18248;49;42967
02;2020-S25;1;0;1;34361;28310;59;62671
02;2020-S25;0;0;0;28061;24495;69;52556
02;2020-S25;1;0;1;18231;15278;79;33509
02;2020-S25;0;0;0;11090;7677;89;18767
02;2020-S25;0;0;0;3992;1506;90;5498
02;2020-S25;6;2;8;194587;164162;0;358749
03;2020-S25;28;23;61;31123;30920;09;62043
03;2020-S25;83;60;147;29370;29268;19;58638
03;2020-S25;110;100;228;21458;18963;29;40421
03;2020-S25;132;111;261;21276;18326;39;39602
03;2020-S25;88;80;177;18164;16593;49;34757
03;2020-S25;67;75;148;13469;13557;59;27026
03;2020-S25;41;54;98;8776;8670;69;17446
03;2020-S25;17;15;32;3777;3591;79;7368
03;2020-S25;3;7;10;1649;1072;89;2721
03;2020-S25;0;2;2;485;184;90;669
03;2020-S25;569;527;1164;149547;141144;0;290691
04;2020-S25;1;0;1;60314;61377;09;121691
04;2020-S25;0;0;0;66065;68387;19;134452
04;2020-S25;1;0;1;51059;47156;29;98215
04;2020-S25;1;4;5;58788;45780;39;104568
04;2020-S25;0;0;0;61408;52207;49;113615
04;2020-S25;1;1;2;64838;60759;59;125597
04;2020-S25;0;1;1;47008;42843;69;89851
04;2020-S25;0;0;0;25509;21184;79;46693
04;2020-S25;0;0;0;13168;7647;89;20815
04;2020-S25;0;0;0;3209;1253;90;4462
04;2020-S25;4;6;10;451366;408593;0;859959
05;2020-S25;0;0;0;362.366008612902;341.338819562748;09;703.704828175651
05;2020-S25;0;0;0;353.376145114279;370.349735405642;19;723.725880519921
05;2020-S25;0;0;0;218.593559489256;256.539602589476;29;475.133162078732
05;2020-S25;0;0;0;404.225408693299;360.321910454353;39;764.547319147651
05;2020-S25;0;0;0;520.067953604221;497.108383964256;49;1017.17633756848
05;2020-S25;0;0;0;468.146063921917;510.087601910415;59;978.233665832332
05;2020-S25;0;0;0;340.368470050554;334.366842191253;69;674.735312241807
05;2020-S25;0;0;0;212.598666888387;192.597753227106;79;405.196420115493
05;2020-S25;0;0;0;148.727797095705;61.8681715431829;89;210.595968638888
05;2020-S25;0;0;0;32.9601271090696;10.9909785719784;90;43.9511056810479
05;2020-S25;0;0;0;3061.43020057959;2935.56979942041;0;5997
06;2020-S25;3;2;5;42583;42380;09;84963
06;2020-S25;8;2;10;33369;31925;19;65294
06;2020-S25;13;5;20;21571;15080;29;36651
06;2020-S25;14;11;27;21550;16147;39;37697
06;2020-S25;9;6;19;14193;13939;49;28132
06;2020-S25;9;7;20;7171;7597;59;14768
06;2020-S25;5;6;11;3629;4117;69;7746
06;2020-S25;2;1;3;1577;1457;79;3034
06;2020-S25;0;1;1;531;474;89;1005
06;2020-S25;0;0;0;88;93;90;181
06;2020-S25;63;41;116;146262;133209;0;279471
07;2020-S25;0;0;0;485;549;09;1034
07;2020-S25;0;0;0;403;432;19;835
07;2020-S25;0;0;0;764;841;29;1605
07;2020-S25;0;0;0;824;928;39;1752
07;2020-S25;0;0;0;788;1020;49;1808
07;2020-S25;0;0;0;678;870;59;1548
07;2020-S25;0;0;0;360;382;69;742
07;2020-S25;0;1;1;231;190;79;421
07;2020-S25;0;0;0;114;67;89;181
07;2020-S25;0;0;0;24;11;90;35
07;2020-S25;0;1;1;4671;5290;0;9961
08;2020-S25;0;0;0;2715.22592983026;2997.75551488675;09;5712.98144471701
08;2020-S25;0;0;0;2778.51901080978;3160.9156459093;19;5939.43465671908
08;2020-S25;0;0;0;2080.8882988764;1718.16634315323;29;3799.05464202964
08;2020-S25;0;0;0;2701.8582062647;1896.52641413317;39;4598.38462039786
08;2020-S25;0;0;0;3151.45861023308;2460.52498233809;49;5611.98359257117
08;2020-S25;0;0;0;2620.29868333099;2422.23566154656;59;5042.53434487755
08;2020-S25;0;0;0;1621.44173420671;1438.58325779464;69;3060.02499200135
08;2020-S25;0;0;0;626.575909335673;526.358467843651;79;1152.93437717932
08;2020-S25;0;0;0;205.018522985054;140.993639349697;89;346.012162334751
08;2020-S25;0;0;0;50.0325684687745;20.62259870351;90;70.6551671722846
08;2020-S25;0;0;0;18551.3174743414;16782.6825256586;0;35334
11;2020-S25;20;20;52;783071;811785;09;1594856
11;2020-S25;19;30;52;761456;784653;19;1546109
11;2020-S25;44;51;104;850145;801772;29;1651917
11;2020-S25;66;76;150;914360;843488;39;1757848
11;2020-S25;58;55;123;845609;826202;49;1671811
11;2020-S25;53;39;96;793566;745070;59;1538636
11;2020-S25;36;22;64;628649;549192;69;1177841
11;2020-S25;23;25;49;434606;358356;79;792962
11;2020-S25;24;19;44;261425;162933;89;424358
11;2020-S25;20;4;24;89253;32619;90;121872
11;2020-S25;363;341;762;6362140;5916070;0;12278210
24;2020-S25;2;6;8;139720;144686;09;284406
24;2020-S25;0;2;2;152979;161185;19;314164
24;2020-S25;4;2;6;122237;126536;29;248773
24;2020-S25;7;9;16;150359;142009;39;292368
24;2020-S25;7;5;13;161829;158758;49;320587
24;2020-S25;5;5;10;172552;168011;59;340563
24;2020-S25;3;3;6;172509;158177;69;330686
24;2020-S25;2;3;5;129428;110593;79;240021
24;2020-S25;1;3;4;87342;56882;89;144224
24;2020-S25;1;0;1;31210;12071;90;43281
24;2020-S25;32;38;71;1320165;1238908;0;2559073
27;2020-S25;0;2;2;143373;149679;09;293052
27;2020-S25;3;2;5;160962;173003;19;333965
27;2020-S25;3;2;5;133746;142254;29;276000
27;2020-S25;3;2;6;160004;155407;39;315411
27;2020-S25;0;2;5;172333;169564;49;341897
27;2020-S25;2;2;7;189979;183788;59;373767
27;2020-S25;4;2;7;192591;178206;69;370797
27;2020-S25;1;3;5;146876;127546;79;274422
27;2020-S25;3;1;8;96896;61575;89;158471
27;2020-S25;1;1;2;33148;12109;90;45257
27;2020-S25;20;19;52;1429908;1353131;0;2783039
28;2020-S25;7;6;13;180735;186856;09;367591
28;2020-S25;9;2;11;200125;213621;19;413746
28;2020-S25;11;8;19;168922;173007;29;341929
28;2020-S25;11;7;21;196628;188487;39;385115
28;2020-S25;11;7;20;205396;201699;49;407095
28;2020-S25;9;7;16;222002;213866;59;435868
28;2020-S25;8;5;13;224688;203758;69;428446
28;2020-S25;1;3;6;163192;135543;79;298735
28;2020-S25;9;5;15;109691;65377;89;175068
28;2020-S25;6;1;8;37222;12685;90;49907
28;2020-S25;82;51;142;1708601;1594899;0;3303500
32;2020-S25;6;9;19;358062;373689;09;731751
32;2020-S25;8;4;24;387045;406742;19;793787
32;2020-S25;16;14;47;342304;348587;29;690891
32;2020-S25;15;11;36;382485;369972;39;752457
32;2020-S25;9;11;27;382510;376716;49;759226
32;2020-S25;8;14;29;386937;376527;59;763464
32;2020-S25;7;9;21;371211;330938;69;702149
32;2020-S25;13;11;27;250542;201459;79;452001
32;2020-S25;23;9;40;163399;89786;89;253185
32;2020-S25;13;2;15;48384;15367;90;63751
32;2020-S25;118;94;285;3072879;2889783;0;5962662
44;2020-S25;1;3;4;291525;306839;09;598364
44;2020-S25;6;15;26;320255;339504;19;659759
44;2020-S25;14;7;25;302020;314428;29;616448
44;2020-S25;19;11;33;342222;333292;39;675514
44;2020-S25;19;17;42;349727;344491;49;694218
44;2020-S25;15;8;26;381371;373239;59;754610
44;2020-S25;9;19;33;367165;335850;69;703015
44;2020-S25;16;22;44;250387;215436;79;465823
44;2020-S25;18;19;39;170825;105192;89;276017
44;2020-S25;6;6;14;51248;16731;90;67979
44;2020-S25;123;127;286;2826745;2685002;0;5511747
52;2020-S25;2;4;7;213594;223900;09;437494
52;2020-S25;5;5;13;240818;255197;19;496015
52;2020-S25;8;6;17;197010;200630;29;397640
52;2020-S25;7;11;19;231204;224885;39;456089
52;2020-S25;3;5;9;243874;243418;49;487292
52;2020-S25;5;3;8;244100;239116;59;483216
52;2020-S25;2;1;3;241796;221345;69;463141
52;2020-S25;8;6;16;177805;149903;79;327708
52;2020-S25;4;4;8;119561;75822;89;195383
52;2020-S25;3;4;8;42559;15260;90;57819
52;2020-S25;47;49;109;1952321;1849476;0;3801797
53;2020-S25;0;0;0;173813;182358;09;356171
53;2020-S25;2;0;2;202720;214740;19;417460
53;2020-S25;1;2;3;163116;173196;29;336312
53;2020-S25;0;0;0;190526;187674;39;378200
53;2020-S25;2;0;2;212098;212015;49;424113
53;2020-S25;2;1;3;223699;219176;59;442875
53;2020-S25;1;0;1;227435;209274;69;436709
53;2020-S25;1;0;2;169992;140910;79;310902
53;2020-S25;3;2;5;118117;69883;89;188000
53;2020-S25;4;0;4;37370;12267;90;49637
53;2020-S25;16;5;22;1718886;1621493;0;3340379
75;2020-S25;1;0;1;293104;305291;09;598395
75;2020-S25;2;2;6;337141;357785;19;694926
75;2020-S25;5;1;7;295024;300618;29;595642
75;2020-S25;6;2;8;347871;331233;39;679104
75;2020-S25;2;1;6;384742;372771;49;757513
75;2020-S25;2;3;8;413361;390880;59;804241
75;2020-S25;1;1;2;425623;384060;69;809683
75;2020-S25;1;3;5;325086;276298;79;601384
75;2020-S25;0;0;0;213986;139308;89;353294
75;2020-S25;4;0;4;77600;28200;90;105800
75;2020-S25;24;13;47;3113538;2886444;0;5999982
76;2020-S25;9;8;18;305956;318589;09;624545
76;2020-S25;2;2;4;338942;356969;19;695911
76;2020-S25;8;1;11;316210;319570;29;635780
76;2020-S25;9;7;17;356758;337587;39;694345
76;2020-S25;6;7;15;376541;363812;49;740353
76;2020-S25;6;6;16;402608;383750;59;786358
76;2020-S25;7;3;10;394889;358997;69;753886
76;2020-S25;1;2;4;308664;263806;79;572470
76;2020-S25;3;2;6;195838;129272;89;325110
76;2020-S25;1;1;3;69372;26728;90;96100
76;2020-S25;52;39;104;3065778;2859080;0;5924858
84;2020-S25;12;4;25;459549;481088;09;940637
84;2020-S25;8;11;28;487711;511905;19;999616
84;2020-S25;11;10;29;443824;451094;29;894918
84;2020-S25;9;11;34;512522;493262;39;1005784
84;2020-S25;11;8;31;520248;515106;49;1035354
84;2020-S25;6;7;16;529611;514848;59;1044459
84;2020-S25;8;2;12;486720;439940;69;926660
84;2020-S25;3;6;10;372151;315211;79;687362
84;2020-S25;8;5;13;237198;150524;89;387722
84;2020-S25;11;1;13;81185;28680;90;109865
84;2020-S25;87;65;211;4130719;3901658;0;8032377
93;2020-S25;2;2;6;268834;283093;09;551927
93;2020-S25;1;4;8;280751;296087;19;576838
93;2020-S25;4;9;19;254404;255552;29;509956
93;2020-S25;8;11;23;310704;288398;39;599102
93;2020-S25;8;20;35;325559;305827;49;631386
93;2020-S25;9;4;18;353104;325389;59;678493
93;2020-S25;1;4;10;336327;296459;69;632786
93;2020-S25;4;1;11;279820;229699;79;509519
93;2020-S25;3;1;7;171274;113716;89;284990
93;2020-S25;1;0;2;58896;21758;90;80654
93;2020-S25;42;56;144;2639673;2415978;0;5055651
94;2020-S25;0;0;0;16311;17433;09;33744
94;2020-S25;0;0;0;16679;18132;19;34811
94;2020-S25;1;0;1;16782;16579;29;33361
94;2020-S25;0;0;0;23044;20580;39;43624
94;2020-S25;0;1;1;23065;22140;49;45205
94;2020-S25;0;0;0;24549;23421;59;47970
94;2020-S25;1;0;1;23212;21883;69;45095
94;2020-S25;1;0;1;19544;17141;79;36685
94;2020-S25;0;0;0;11227;8178;89;19405
94;2020-S25;0;0;0;3332;1447;90;4779
94;2020-S25;3;1;4;177745;166934;0;344679
01;2020-S26;0;0;0;19979;20155;09;40134
01;2020-S26;1;0;1;24994;25489;19;50483
01;2020-S26;0;1;1;17868;16690;29;34558
01;2020-S26;0;0;0;22328;14821;39;37149
01;2020-S26;2;0;2;28652;20276;49;48928
01;2020-S26;0;0;0;33264;27260;59;60524
01;2020-S26;1;0;1;27135;23978;69;51113
01;2020-S26;0;0;0;18401;14661;79;33062
01;2020-S26;0;0;0;9633;6375;89;16008
01;2020-S26;0;0;0;3410;1510;90;4920
01;2020-S26;4;1;5;205664;171215;0;376879
02;2020-S26;1;0;1;16881;17110;09;33991
02;2020-S26;1;0;1;21410;21604;19;43014
02;2020-S26;1;0;1;16017;15479;29;31496
02;2020-S26;2;0;2;19825;14455;39;34280
02;2020-S26;1;0;1;24719;18248;49;42967
02;2020-S26;0;2;2;34361;28310;59;62671
02;2020-S26;2;0;2;28061;24495;69;52556
02;2020-S26;0;0;0;18231;15278;79;33509
02;2020-S26;0;0;0;11090;7677;89;18767
02;2020-S26;0;0;0;3992;1506;90;5498
02;2020-S26;8;2;10;194587;164162;0;358749
03;2020-S26;22;31;57;31123;30920;09;62043
03;2020-S26;76;55;140;29370;29268;19;58638
03;2020-S26;134;127;270;21458;18963;29;40421
03;2020-S26;153;106;266;21276;18326;39;39602
03;2020-S26;111;107;222;18164;16593;49;34757
03;2020-S26;72;92;167;13469;13557;59;27026
03;2020-S26;45;49;96;8776;8670;69;17446
03;2020-S26;11;33;44;3777;3591;79;7368
03;2020-S26;11;7;18;1649;1072;89;2721
03;2020-S26;3;1;4;485;184;90;669
03;2020-S26;638;608;1284;149547;141144;0;290691
04;2020-S26;0;0;0;60314;61377;09;121691
04;2020-S26;0;1;1;66065;68387;19;134452
04;2020-S26;2;3;5;51059;47156;29;98215
04;2020-S26;1;1;2;58788;45780;39;104568
04;2020-S26;2;1;3;61408;52207;49;113615
04;2020-S26;1;1;2;64838;60759;59;125597
04;2020-S26;1;1;2;47008;42843;69;89851
04;2020-S26;0;1;1;25509;21184;79;46693
04;2020-S26;0;0;0;13168;7647;89;20815
04;2020-S26;0;0;0;3209;1253;90;4462
04;2020-S26;7;9;16;451366;408593;0;859959
05;2020-S26;0;0;0;362.366008612902;341.338819562748;09;703.704828175651
05;2020-S26;0;0;0;353.376145114279;370.349735405642;19;723.725880519921
05;2020-S26;0;0;0;218.593559489256;256.539602589476;29;475.133162078732
05;2020-S26;0;0;0;404.225408693299;360.321910454353;39;764.547319147651
05;2020-S26;0;0;0;520.067953604221;497.108383964256;49;1017.17633756848
05;2020-S26;0;0;0;468.146063921917;510.087601910415;59;978.233665832332
05;2020-S26;0;0;0;340.368470050554;334.366842191253;69;674.735312241807
05;2020-S26;0;0;0;212.598666888387;192.597753227106;79;405.196420115493
05;2020-S26;0;0;0;148.727797095705;61.8681715431829;89;210.595968638888
05;2020-S26;0;0;0;32.9601271090696;10.9909785719784;90;43.9511056810479
05;2020-S26;0;0;0;3061.43020057959;2935.56979942041;0;5997
06;2020-S26;3;1;4;42583;42380;09;84963
06;2020-S26;13;7;20;33369;31925;19;65294
06;2020-S26;16;10;26;21571;15080;29;36651
06;2020-S26;15;12;27;21550;16147;39;37697
06;2020-S26;13;9;22;14193;13939;49;28132
06;2020-S26;9;5;14;7171;7597;59;14768
06;2020-S26;5;5;10;3629;4117;69;7746
06;2020-S26;1;3;4;1577;1457;79;3034
06;2020-S26;0;1;1;531;474;89;1005
06;2020-S26;0;0;0;88;93;90;181
06;2020-S26;75;53;128;146262;133209;0;279471
07;2020-S26;0;0;0;485;549;09;1034
07;2020-S26;0;0;0;403;432;19;835
07;2020-S26;0;1;1;764;841;29;1605
07;2020-S26;0;0;0;824;928;39;1752
07;2020-S26;0;0;0;788;1020;49;1808
07;2020-S26;0;0;0;678;870;59;1548
07;2020-S26;0;0;0;360;382;69;742
07;2020-S26;0;0;0;231;190;79;421
07;2020-S26;0;0;0;114;67;89;181
07;2020-S26;0;0;0;24;11;90;35
07;2020-S26;0;1;1;4671;5290;0;9961
08;2020-S26;0;0;0;2715.22592983026;2997.75551488675;09;5712.98144471701
08;2020-S26;0;0;0;2778.51901080978;3160.9156459093;19;5939.43465671908
08;2020-S26;0;0;0;2080.8882988764;1718.16634315323;29;3799.05464202964
08;2020-S26;0;0;0;2701.8582062647;1896.52641413317;39;4598.38462039786
08;2020-S26;0;0;0;3151.45861023308;2460.52498233809;49;5611.98359257117
08;2020-S26;1;0;1;2620.29868333099;2422.23566154656;59;5042.53434487755
08;2020-S26;0;1;1;1621.44173420671;1438.58325779464;69;3060.02499200135
08;2020-S26;0;0;0;626.575909335673;526.358467843651;79;1152.93437717932
08;2020-S26;0;0;0;205.018522985054;140.993639349697;89;346.012162334751
08;2020-S26;0;0;0;50.0325684687745;20.62259870351;90;70.6551671722846
08;2020-S26;1;1;2;18551.3174743414;16782.6825256586;0;35334
11;2020-S26;18;20;43;783071;811785;09;1594856
11;2020-S26;53;29;82;761456;784653;19;1546109
11;2020-S26;63;64;128;850145;801772;29;1651917
11;2020-S26;57;79;136;914360;843488;39;1757848
11;2020-S26;47;62;109;845609;826202;49;1671811
11;2020-S26;44;50;95;793566;745070;59;1538636
11;2020-S26;30;26;57;628649;549192;69;1177841
11;2020-S26;26;24;50;434606;358356;79;792962
11;2020-S26;29;14;43;261425;162933;89;424358
11;2020-S26;17;7;24;89253;32619;90;121872
11;2020-S26;385;375;768;6362140;5916070;0;12278210
24;2020-S26;1;1;2;139720;144686;09;284406
24;2020-S26;1;2;3;152979;161185;19;314164
24;2020-S26;5;5;10;122237;126536;29;248773
24;2020-S26;10;4;14;150359;142009;39;292368
24;2020-S26;1;8;9;161829;158758;49;320587
24;2020-S26;4;0;4;172552;168011;59;340563
24;2020-S26;3;0;3;172509;158177;69;330686
24;2020-S26;1;1;2;129428;110593;79;240021
24;2020-S26;4;2;6;87342;56882;89;144224
24;2020-S26;3;1;4;31210;12071;90;43281
24;2020-S26;33;24;57;1320165;1238908;0;2559073
27;2020-S26;2;1;3;143373;149679;09;293052
27;2020-S26;1;3;4;160962;173003;19;333965
27;2020-S26;1;2;3;133746;142254;29;276000
27;2020-S26;7;4;11;160004;155407;39;315411
27;2020-S26;4;4;8;172333;169564;49;341897
27;2020-S26;3;4;7;189979;183788;59;373767
27;2020-S26;0;4;4;192591;178206;69;370797
27;2020-S26;1;2;3;146876;127546;79;274422
27;2020-S26;5;3;8;96896;61575;89;158471
27;2020-S26;6;0;6;33148;12109;90;45257
27;2020-S26;30;27;57;1429908;1353131;0;2783039
28;2020-S26;5;7;12;180735;186856;09;367591
28;2020-S26;8;11;19;200125;213621;19;413746
28;2020-S26;10;6;16;168922;173007;29;341929
28;2020-S26;11;11;22;196628;188487;39;385115
28;2020-S26;8;13;21;205396;201699;49;407095
28;2020-S26;11;9;20;222002;213866;59;435868
28;2020-S26;3;1;4;224688;203758;69;428446
28;2020-S26;8;2;10;163192;135543;79;298735
28;2020-S26;5;4;9;109691;65377;89;175068
28;2020-S26;10;0;10;37222;12685;90;49907
28;2020-S26;79;64;143;1708601;1594899;0;3303500
32;2020-S26;13;8;21;358062;373689;09;731751
32;2020-S26;16;17;33;387045;406742;19;793787
32;2020-S26;17;20;37;342304;348587;29;690891
32;2020-S26;31;26;57;382485;369972;39;752457
32;2020-S26;16;19;35;382510;376716;49;759226
32;2020-S26;7;12;19;386937;376527;59;763464
32;2020-S26;13;13;26;371211;330938;69;702149
32;2020-S26;15;14;29;250542;201459;79;452001
32;2020-S26;13;11;24;163399;89786;89;253185
32;2020-S26;10;1;11;48384;15367;90;63751
32;2020-S26;151;141;292;3072879;2889783;0;5962662
44;2020-S26;12;4;16;291525;306839;09;598364
44;2020-S26;4;6;10;320255;339504;19;659759
44;2020-S26;12;11;23;302020;314428;29;616448
44;2020-S26;12;8;20;342222;333292;39;675514
44;2020-S26;11;9;20;349727;344491;49;694218
44;2020-S26;11;10;21;381371;373239;59;754610
44;2020-S26;9;9;18;367165;335850;69;703015
44;2020-S26;8;8;16;250387;215436;79;465823
44;2020-S26;9;8;17;170825;105192;89;276017
44;2020-S26;5;3;8;51248;16731;90;67979
44;2020-S26;93;76;169;2826745;2685002;0;5511747
52;2020-S26;7;4;11;213594;223900;09;437494
52;2020-S26;4;2;6;240818;255197;19;496015
52;2020-S26;7;19;26;197010;200630;29;397640
52;2020-S26;6;9;15;231204;224885;39;456089
52;2020-S26;3;7;10;243874;243418;49;487292
52;2020-S26;5;4;9;244100;239116;59;483216
52;2020-S26;3;0;3;241796;221345;69;463141
52;2020-S26;2;2;4;177805;149903;79;327708
52;2020-S26;2;2;4;119561;75822;89;195383
52;2020-S26;1;1;2;42559;15260;90;57819
52;2020-S26;40;50;90;1952321;1849476;0;3801797
53;2020-S26;0;1;1;173813;182358;09;356171
53;2020-S26;0;1;1;202720;214740;19;417460
53;2020-S26;4;2;6;163116;173196;29;336312
53;2020-S26;3;3;6;190526;187674;39;378200
53;2020-S26;1;5;6;212098;212015;49;424113
53;2020-S26;1;2;3;223699;219176;59;442875
53;2020-S26;0;1;1;227435;209274;69;436709
53;2020-S26;1;1;2;169992;140910;79;310902
53;2020-S26;1;0;1;118117;69883;89;188000
53;2020-S26;2;0;2;37370;12267;90;49637
53;2020-S26;13;16;29;1718886;1621493;0;3340379
75;2020-S26;0;7;7;293104;305291;09;598395
75;2020-S26;3;3;6;337141;357785;19;694926
75;2020-S26;4;2;6;295024;300618;29;595642
75;2020-S26;6;4;10;347871;331233;39;679104
75;2020-S26;5;1;6;384742;372771;49;757513
75;2020-S26;4;5;9;413361;390880;59;804241
75;2020-S26;4;1;5;425623;384060;69;809683
75;2020-S26;0;0;0;325086;276298;79;601384
75;2020-S26;1;0;1;213986;139308;89;353294
75;2020-S26;0;1;1;77600;28200;90;105800
75;2020-S26;27;24;51;3113538;2886444;0;5999982
76;2020-S26;7;4;11;305956;318589;09;624545
76;2020-S26;7;6;13;338942;356969;19;695911
76;2020-S26;14;11;25;316210;319570;29;635780
76;2020-S26;11;13;24;356758;337587;39;694345
76;2020-S26;9;9;18;376541;363812;49;740353
76;2020-S26;8;7;15;402608;383750;59;786358
76;2020-S26;6;6;12;394889;358997;69;753886
76;2020-S26;0;2;2;308664;263806;79;572470
76;2020-S26;1;2;3;195838;129272;89;325110
76;2020-S26;1;3;4;69372;26728;90;96100
76;2020-S26;65;65;130;3065778;2859080;0;5924858
84;2020-S26;6;13;19;459549;481088;09;940637
84;2020-S26;10;15;25;487711;511905;19;999616
84;2020-S26;19;18;38;443824;451094;29;894918
84;2020-S26;16;8;24;512522;493262;39;1005784
84;2020-S26;19;14;33;520248;515106;49;1035354
84;2020-S26;23;12;35;529611;514848;59;1044459
84;2020-S26;8;8;16;486720;439940;69;926660
84;2020-S26;7;11;18;372151;315211;79;687362
84;2020-S26;10;6;16;237198;150524;89;387722
84;2020-S26;6;2;8;81185;28680;90;109865
84;2020-S26;124;107;232;4130719;3901658;0;8032377
93;2020-S26;2;2;4;268834;283093;09;551927
93;2020-S26;3;2;5;280751;296087;19;576838
93;2020-S26;7;10;17;254404;255552;29;509956
93;2020-S26;5;7;12;310704;288398;39;599102
93;2020-S26;6;4;10;325559;305827;49;631386
93;2020-S26;6;7;13;353104;325389;59;678493
93;2020-S26;3;5;8;336327;296459;69;632786
93;2020-S26;1;7;8;279820;229699;79;509519
93;2020-S26;3;3;6;171274;113716;89;284990
93;2020-S26;1;1;2;58896;21758;90;80654
93;2020-S26;37;48;85;2639673;2415978;0;5055651
94;2020-S26;0;0;0;16311;17433;09;33744
94;2020-S26;0;0;0;16679;18132;19;34811
94;2020-S26;0;2;2;16782;16579;29;33361
94;2020-S26;0;0;0;23044;20580;39;43624
94;2020-S26;0;0;0;23065;22140;49;45205
94;2020-S26;0;0;0;24549;23421;59;47970
94;2020-S26;0;0;0;23212;21883;69;45095
94;2020-S26;0;1;1;19544;17141;79;36685
94;2020-S26;1;0;1;11227;8178;89;19405
94;2020-S26;0;0;0;3332;1447;90;4779
94;2020-S26;1;3;4;177745;166934;0;344679
01;2020-S27;0;0;0;19979;20155;09;40134
01;2020-S27;0;0;0;24994;25489;19;50483
01;2020-S27;2;0;2;17868;16690;29;34558
01;2020-S27;0;0;0;22328;14821;39;37149
01;2020-S27;0;1;1;28652;20276;49;48928
01;2020-S27;1;0;1;33264;27260;59;60524
01;2020-S27;2;0;2;27135;23978;69;51113
01;2020-S27;0;1;1;18401;14661;79;33062
01;2020-S27;0;0;0;9633;6375;89;16008
01;2020-S27;0;0;0;3410;1510;90;4920
01;2020-S27;5;2;7;205664;171215;0;376879
02;2020-S27;1;0;1;16881;17110;09;33991
02;2020-S27;2;0;2;21410;21604;19;43014
02;2020-S27;0;2;2;16017;15479;29;31496
02;2020-S27;0;0;0;19825;14455;39;34280
02;2020-S27;0;0;0;24719;18248;49;42967
02;2020-S27;0;1;1;34361;28310;59;62671
02;2020-S27;1;0;1;28061;24495;69;52556
02;2020-S27;0;0;0;18231;15278;79;33509
02;2020-S27;0;0;0;11090;7677;89;18767
02;2020-S27;0;0;0;3992;1506;90;5498
02;2020-S27;4;3;7;194587;164162;0;358749
03;2020-S27;31;24;58;31123;30920;09;62043
03;2020-S27;66;64;136;29370;29268;19;58638
03;2020-S27;130;104;248;21458;18963;29;40421
03;2020-S27;158;120;287;21276;18326;39;39602
03;2020-S27;106;102;215;18164;16593;49;34757
03;2020-S27;78;88;170;13469;13557;59;27026
03;2020-S27;48;70;120;8776;8670;69;17446
03;2020-S27;23;20;43;3777;3591;79;7368
03;2020-S27;6;9;15;1649;1072;89;2721
03;2020-S27;2;2;5;485;184;90;669
03;2020-S27;648;603;1297;149547;141144;0;290691
04;2020-S27;1;2;4;60314;61377;09;121691
04;2020-S27;2;2;4;66065;68387;19;134452
04;2020-S27;2;2;4;51059;47156;29;98215
04;2020-S27;4;1;5;58788;45780;39;104568
04;2020-S27;0;1;1;61408;52207;49;113615
04;2020-S27;0;1;1;64838;60759;59;125597
04;2020-S27;3;1;4;47008;42843;69;89851
04;2020-S27;0;0;0;25509;21184;79;46693
04;2020-S27;0;0;0;13168;7647;89;20815
04;2020-S27;0;0;0;3209;1253;90;4462
04;2020-S27;12;10;23;451366;408593;0;859959
05;2020-S27;0;0;0;362.366008612902;341.338819562748;09;703.704828175651
05;2020-S27;0;0;0;353.376145114279;370.349735405642;19;723.725880519921
05;2020-S27;0;0;0;218.593559489256;256.539602589476;29;475.133162078732
05;2020-S27;0;0;0;404.225408693299;360.321910454353;39;764.547319147651
05;2020-S27;0;0;0;520.067953604221;497.108383964256;49;1017.17633756848
05;2020-S27;0;0;0;468.146063921917;510.087601910415;59;978.233665832332
05;2020-S27;0;0;0;340.368470050554;334.366842191253;69;674.735312241807
05;2020-S27;0;0;0;212.598666888387;192.597753227106;79;405.196420115493
05;2020-S27;0;0;0;148.727797095705;61.8681715431829;89;210.595968638888
05;2020-S27;0;0;0;32.9601271090696;10.9909785719784;90;43.9511056810479
05;2020-S27;0;0;0;3061.43020057959;2935.56979942041;0;5997
06;2020-S27;1;3;4;42583;42380;09;84963
06;2020-S27;7;5;12;33369;31925;19;65294
06;2020-S27;14;8;22;21571;15080;29;36651
06;2020-S27;8;12;20;21550;16147;39;37697
06;2020-S27;11;8;19;14193;13939;49;28132
06;2020-S27;7;5;12;7171;7597;59;14768
06;2020-S27;1;1;2;3629;4117;69;7746
06;2020-S27;0;2;2;1577;1457;79;3034
06;2020-S27;0;0;0;531;474;89;1005
06;2020-S27;0;0;0;88;93;90;181
06;2020-S27;49;44;93;146262;133209;0;279471
07;2020-S27;0;0;0;485;549;09;1034
07;2020-S27;0;0;0;403;432;19;835
07;2020-S27;0;0;0;764;841;29;1605
07;2020-S27;0;0;0;824;928;39;1752
07;2020-S27;0;0;0;788;1020;49;1808
07;2020-S27;0;0;0;678;870;59;1548
07;2020-S27;0;0;0;360;382;69;742
07;2020-S27;0;0;0;231;190;79;421
07;2020-S27;0;0;0;114;67;89;181
07;2020-S27;0;0;0;24;11;90;35
07;2020-S27;0;0;0;4671;5290;0;9961
08;2020-S27;0;0;0;2715.22592983026;2997.75551488675;09;5712.98144471701
08;2020-S27;0;0;0;2778.51901080978;3160.9156459093;19;5939.43465671908
08;2020-S27;0;0;0;2080.8882988764;1718.16634315323;29;3799.05464202964
08;2020-S27;0;0;0;2701.8582062647;1896.52641413317;39;4598.38462039786
08;2020-S27;0;0;0;3151.45861023308;2460.52498233809;49;5611.98359257117
08;2020-S27;0;0;0;2620.29868333099;2422.23566154656;59;5042.53434487755
08;2020-S27;0;0;0;1621.44173420671;1438.58325779464;69;3060.02499200135
08;2020-S27;0;0;0;626.575909335673;526.358467843651;79;1152.93437717932
08;2020-S27;0;0;0;205.018522985054;140.993639349697;89;346.012162334751
08;2020-S27;0;0;0;50.0325684687745;20.62259870351;90;70.6551671722846
08;2020-S27;0;0;0;18551.3174743414;16782.6825256586;0;35334
11;2020-S27;23;19;45;783071;811785;09;1594856
11;2020-S27;39;49;89;761456;784653;19;1546109
11;2020-S27;65;84;149;850145;801772;29;1651917
11;2020-S27;74;70;145;914360;843488;39;1757848
11;2020-S27;58;59;117;845609;826202;49;1671811
11;2020-S27;47;55;102;793566;745070;59;1538636
11;2020-S27;26;39;65;628649;549192;69;1177841
11;2020-S27;18;18;36;434606;358356;79;792962
11;2020-S27;33;10;43;261425;162933;89;424358
11;2020-S27;37;6;43;89253;32619;90;121872
11;2020-S27;420;410;841;6362140;5916070;0;12278210
24;2020-S27;5;5;10;139720;144686;09;284406
24;2020-S27;3;2;5;152979;161185;19;314164
24;2020-S27;10;2;12;122237;126536;29;248773
24;2020-S27;8;3;11;150359;142009;39;292368
24;2020-S27;2;3;5;161829;158758;49;320587
24;2020-S27;8;4;12;172552;168011;59;340563
24;2020-S27;4;1;5;172509;158177;69;330686
24;2020-S27;1;2;3;129428;110593;79;240021
24;2020-S27;2;2;4;87342;56882;89;144224
24;2020-S27;2;1;3;31210;12071;90;43281
24;2020-S27;45;25;71;1320165;1238908;0;2559073
27;2020-S27;2;0;2;143373;149679;09;293052
27;2020-S27;4;5;9;160962;173003;19;333965
27;2020-S27;4;1;5;133746;142254;29;276000
27;2020-S27;3;4;7;160004;155407;39;315411
27;2020-S27;6;6;12;172333;169564;49;341897
27;2020-S27;3;8;11;189979;183788;59;373767
27;2020-S27;4;2;6;192591;178206;69;370797
27;2020-S27;5;4;9;146876;127546;79;274422
27;2020-S27;6;3;9;96896;61575;89;158471
27;2020-S27;2;2;4;33148;12109;90;45257
27;2020-S27;39;35;74;1429908;1353131;0;2783039
28;2020-S27;9;9;18;180735;186856;09;367591
28;2020-S27;8;8;16;200125;213621;19;413746
28;2020-S27;6;9;15;168922;173007;29;341929
28;2020-S27;11;9;20;196628;188487;39;385115
28;2020-S27;8;7;15;205396;201699;49;407095
28;2020-S27;8;7;16;222002;213866;59;435868
28;2020-S27;9;5;14;224688;203758;69;428446
28;2020-S27;4;4;8;163192;135543;79;298735
28;2020-S27;7;7;14;109691;65377;89;175068
28;2020-S27;2;0;2;37222;12685;90;49907
28;2020-S27;72;65;139;1708601;1594899;0;3303500
32;2020-S27;14;21;36;358062;373689;09;731751
32;2020-S27;17;17;34;387045;406742;19;793787
32;2020-S27;17;17;34;342304;348587;29;690891
32;2020-S27;25;16;41;382485;369972;39;752457
32;2020-S27;18;30;48;382510;376716;49;759226
32;2020-S27;15;7;22;386937;376527;59;763464
32;2020-S27;16;11;27;371211;330938;69;702149
32;2020-S27;7;8;15;250542;201459;79;452001
32;2020-S27;15;11;26;163399;89786;89;253185
32;2020-S27;6;1;7;48384;15367;90;63751
32;2020-S27;150;140;299;3072879;2889783;0;5962662
44;2020-S27;3;4;10;291525;306839;09;598364
44;2020-S27;2;1;3;320255;339504;19;659759
44;2020-S27;18;7;25;302020;314428;29;616448
44;2020-S27;8;7;15;342222;333292;39;675514
44;2020-S27;8;9;17;349727;344491;49;694218
44;2020-S27;6;6;12;381371;373239;59;754610
44;2020-S27;13;12;25;367165;335850;69;703015
44;2020-S27;12;9;21;250387;215436;79;465823
44;2020-S27;7;5;12;170825;105192;89;276017
44;2020-S27;5;1;6;51248;16731;90;67979
44;2020-S27;82;61;152;2826745;2685002;0;5511747
52;2020-S27;5;7;12;213594;223900;09;437494
52;2020-S27;5;4;10;240818;255197;19;496015
52;2020-S27;27;35;62;197010;200630;29;397640
52;2020-S27;14;28;42;231204;224885;39;456089
52;2020-S27;16;18;34;243874;243418;49;487292
52;2020-S27;5;14;19;244100;239116;59;483216
52;2020-S27;4;7;11;241796;221345;69;463141
52;2020-S27;0;2;2;177805;149903;79;327708
52;2020-S27;9;5;14;119561;75822;89;195383
52;2020-S27;5;2;7;42559;15260;90;57819
52;2020-S27;90;122;213;1952321;1849476;0;3801797
53;2020-S27;2;3;6;173813;182358;09;356171
53;2020-S27;0;2;2;202720;214740;19;417460
53;2020-S27;1;1;2;163116;173196;29;336312
53;2020-S27;2;4;6;190526;187674;39;378200
53;2020-S27;1;2;3;212098;212015;49;424113
53;2020-S27;0;2;2;223699;219176;59;442875
53;2020-S27;2;2;4;227435;209274;69;436709
53;2020-S27;1;0;1;169992;140910;79;310902
53;2020-S27;0;0;0;118117;69883;89;188000
53;2020-S27;1;1;3;37370;12267;90;49637
53;2020-S27;11;17;31;1718886;1621493;0;3340379
75;2020-S27;0;2;2;293104;305291;09;598395
75;2020-S27;2;4;7;337141;357785;19;694926
75;2020-S27;3;8;11;295024;300618;29;595642
75;2020-S27;9;8;17;347871;331233;39;679104
75;2020-S27;11;3;14;384742;372771;49;757513
75;2020-S27;7;2;9;413361;390880;59;804241
75;2020-S27;1;2;3;425623;384060;69;809683
75;2020-S27;1;5;6;325086;276298;79;601384
75;2020-S27;1;0;1;213986;139308;89;353294
75;2020-S27;0;0;0;77600;28200;90;105800
75;2020-S27;35;35;74;3113538;2886444;0;5999982
76;2020-S27;4;3;10;305956;318589;09;624545
76;2020-S27;9;8;17;338942;356969;19;695911
76;2020-S27;14;8;22;316210;319570;29;635780
76;2020-S27;12;13;25;356758;337587;39;694345
76;2020-S27;12;9;21;376541;363812;49;740353
76;2020-S27;3;8;11;402608;383750;59;786358
76;2020-S27;4;3;7;394889;358997;69;753886
76;2020-S27;4;2;6;308664;263806;79;572470
76;2020-S27;3;1;4;195838;129272;89;325110
76;2020-S27;1;1;2;69372;26728;90;96100
76;2020-S27;66;56;128;3065778;2859080;0;5924858
84;2020-S27;13;7;20;459549;481088;09;940637
84;2020-S27;12;12;25;487711;511905;19;999616
84;2020-S27;13;12;25;443824;451094;29;894918
84;2020-S27;15;11;26;512522;493262;39;1005784
84;2020-S27;12;16;28;520248;515106;49;1035354
84;2020-S27;16;9;26;529611;514848;59;1044459
84;2020-S27;16;7;24;486720;439940;69;926660
84;2020-S27;6;5;12;372151;315211;79;687362
84;2020-S27;7;4;11;237198;150524;89;387722
84;2020-S27;3;0;4;81185;28680;90;109865
84;2020-S27;114;83;208;4130719;3901658;0;8032377
93;2020-S27;2;5;9;268834;283093;09;551927
93;2020-S27;8;7;15;280751;296087;19;576838
93;2020-S27;15;7;22;254404;255552;29;509956
93;2020-S27;6;13;19;310704;288398;39;599102
93;2020-S27;10;7;17;325559;305827;49;631386
93;2020-S27;14;14;28;353104;325389;59;678493
93;2020-S27;7;4;11;336327;296459;69;632786
93;2020-S27;1;10;11;279820;229699;79;509519
93;2020-S27;1;4;5;171274;113716;89;284990
93;2020-S27;3;0;3;58896;21758;90;80654
93;2020-S27;67;71;146;2639673;2415978;0;5055651
94;2020-S27;0;0;0;16311;17433;09;33744
94;2020-S27;0;0;0;16679;18132;19;34811
94;2020-S27;0;0;0;16782;16579;29;33361
94;2020-S27;0;0;0;23044;20580;39;43624
94;2020-S27;0;0;0;23065;22140;49;45205
94;2020-S27;1;0;1;24549;23421;59;47970
94;2020-S27;0;1;1;23212;21883;69;45095
94;2020-S27;0;1;1;19544;17141;79;36685
94;2020-S27;1;0;1;11227;8178;89;19405
94;2020-S27;0;0;0;3332;1447;90;4779
94;2020-S27;2;2;4;177745;166934;0;344679
01;2020-S28;1;0;1;19979;20155;09;40134
01;2020-S28;1;0;1;24994;25489;19;50483
01;2020-S28;0;2;2;17868;16690;29;34558
01;2020-S28;1;0;1;22328;14821;39;37149
01;2020-S28;2;1;3;28652;20276;49;48928
01;2020-S28;0;0;0;33264;27260;59;60524
01;2020-S28;0;0;0;27135;23978;69;51113
01;2020-S28;0;0;0;18401;14661;79;33062
01;2020-S28;0;0;0;9633;6375;89;16008
01;2020-S28;0;0;0;3410;1510;90;4920
01;2020-S28;5;3;8;205664;171215;0;376879
02;2020-S28;0;1;1;16881;17110;09;33991
02;2020-S28;0;0;0;21410;21604;19;43014
02;2020-S28;0;0;0;16017;15479;29;31496
02;2020-S28;0;0;0;19825;14455;39;34280
02;2020-S28;0;1;1;24719;18248;49;42967
02;2020-S28;1;0;1;34361;28310;59;62671
02;2020-S28;0;1;1;28061;24495;69;52556
02;2020-S28;1;0;1;18231;15278;79;33509
02;2020-S28;0;0;0;11090;7677;89;18767
02;2020-S28;0;0;0;3992;1506;90;5498
02;2020-S28;2;3;5;194587;164162;0;358749
03;2020-S28;28;28;57;31123;30920;09;62043
03;2020-S28;52;56;109;29370;29268;19;58638
03;2020-S28;118;92;215;21458;18963;29;40421
03;2020-S28;98;83;189;21276;18326;39;39602
03;2020-S28;85;72;161;18164;16593;49;34757
03;2020-S28;58;54;116;13469;13557;59;27026
03;2020-S28;32;46;79;8776;8670;69;17446
03;2020-S28;14;24;38;3777;3591;79;7368
03;2020-S28;5;4;9;1649;1072;89;2721
03;2020-S28;2;2;4;485;184;90;669
03;2020-S28;492;461;977;149547;141144;0;290691
04;2020-S28;1;1;2;60314;61377;09;121691
04;2020-S28;4;5;9;66065;68387;19;134452
04;2020-S28;4;2;6;51059;47156;29;98215
04;2020-S28;3;2;5;58788;45780;39;104568
04;2020-S28;5;4;9;61408;52207;49;113615
04;2020-S28;3;4;7;64838;60759;59;125597
04;2020-S28;3;2;5;47008;42843;69;89851
04;2020-S28;1;0;1;25509;21184;79;46693
04;2020-S28;0;1;1;13168;7647;89;20815
04;2020-S28;0;0;0;3209;1253;90;4462
04;2020-S28;24;21;45;451366;408593;0;859959
05;2020-S28;0;0;0;362.366008612902;341.338819562748;09;703.704828175651
05;2020-S28;0;0;0;353.376145114279;370.349735405642;19;723.725880519921
05;2020-S28;0;0;0;218.593559489256;256.539602589476;29;475.133162078732
05;2020-S28;0;0;0;404.225408693299;360.321910454353;39;764.547319147651
05;2020-S28;0;0;0;520.067953604221;497.108383964256;49;1017.17633756848
05;2020-S28;0;0;0;468.146063921917;510.087601910415;59;978.233665832332
05;2020-S28;0;0;0;340.368470050554;334.366842191253;69;674.735312241807
05;2020-S28;0;0;0;212.598666888387;192.597753227106;79;405.196420115493
05;2020-S28;0;0;0;148.727797095705;61.8681715431829;89;210.595968638888
05;2020-S28;0;0;0;32.9601271090696;10.9909785719784;90;43.9511056810479
05;2020-S28;0;0;0;3061.43020057959;2935.56979942041;0;5997
06;2020-S28;3;2;5;42583;42380;09;84963
06;2020-S28;1;2;3;33369;31925;19;65294
06;2020-S28;5;5;10;21571;15080;29;36651
06;2020-S28;5;7;12;21550;16147;39;37697
06;2020-S28;3;4;7;14193;13939;49;28132
06;2020-S28;5;4;9;7171;7597;59;14768
06;2020-S28;5;0;5;3629;4117;69;7746
06;2020-S28;0;1;1;1577;1457;79;3034
06;2020-S28;2;0;2;531;474;89;1005
06;2020-S28;0;0;0;88;93;90;181
06;2020-S28;29;25;54;146262;133209;0;279471
07;2020-S28;0;0;0;485;549;09;1034
07;2020-S28;0;0;0;403;432;19;835
07;2020-S28;0;0;0;764;841;29;1605
07;2020-S28;0;0;0;824;928;39;1752
07;2020-S28;0;0;0;788;1020;49;1808
07;2020-S28;0;0;0;678;870;59;1548
07;2020-S28;0;0;0;360;382;69;742
07;2020-S28;0;0;0;231;190;79;421
07;2020-S28;0;0;0;114;67;89;181
07;2020-S28;0;0;0;24;11;90;35
07;2020-S28;0;0;0;4671;5290;0;9961
08;2020-S28;0;0;0;2715.22592983026;2997.75551488675;09;5712.98144471701
08;2020-S28;0;0;0;2778.51901080978;3160.9156459093;19;5939.43465671908
08;2020-S28;0;0;0;2080.8882988764;1718.16634315323;29;3799.05464202964
08;2020-S28;0;0;0;2701.8582062647;1896.52641413317;39;4598.38462039786
08;2020-S28;0;0;0;3151.45861023308;2460.52498233809;49;5611.98359257117
08;2020-S28;0;0;0;2620.29868333099;2422.23566154656;59;5042.53434487755
08;2020-S28;0;0;0;1621.44173420671;1438.58325779464;69;3060.02499200135
08;2020-S28;0;0;0;626.575909335673;526.358467843651;79;1152.93437717932
08;2020-S28;0;0;0;205.018522985054;140.993639349697;89;346.012162334751
08;2020-S28;0;0;0;50.0325684687745;20.62259870351;90;70.6551671722846
08;2020-S28;0;0;0;18551.3174743414;16782.6825256586;0;35334
11;2020-S28;35;30;66;783071;811785;09;1594856
11;2020-S28;48;42;90;761456;784653;19;1546109
11;2020-S28;111;73;184;850145;801772;29;1651917
11;2020-S28;112;71;183;914360;843488;39;1757848
11;2020-S28;64;70;134;845609;826202;49;1671811
11;2020-S28;65;64;129;793566;745070;59;1538636
11;2020-S28;41;49;91;628649;549192;69;1177841
11;2020-S28;21;20;41;434606;358356;79;792962
11;2020-S28;17;16;33;261425;162933;89;424358
11;2020-S28;18;4;22;89253;32619;90;121872
11;2020-S28;532;439;975;6362140;5916070;0;12278210
24;2020-S28;3;2;5;139720;144686;09;284406
24;2020-S28;1;3;4;152979;161185;19;314164
24;2020-S28;6;2;8;122237;126536;29;248773
24;2020-S28;5;8;13;150359;142009;39;292368
24;2020-S28;8;3;11;161829;158758;49;320587
24;2020-S28;4;4;8;172552;168011;59;340563
24;2020-S28;3;2;5;172509;158177;69;330686
24;2020-S28;4;3;7;129428;110593;79;240021
24;2020-S28;2;0;2;87342;56882;89;144224
24;2020-S28;0;0;0;31210;12071;90;43281
24;2020-S28;36;27;64;1320165;1238908;0;2559073
27;2020-S28;1;0;1;143373;149679;09;293052
27;2020-S28;2;2;4;160962;173003;19;333965
27;2020-S28;6;9;15;133746;142254;29;276000
27;2020-S28;3;4;7;160004;155407;39;315411
27;2020-S28;10;3;13;172333;169564;49;341897
27;2020-S28;10;9;19;189979;183788;59;373767
27;2020-S28;8;5;13;192591;178206;69;370797
27;2020-S28;6;4;10;146876;127546;79;274422
27;2020-S28;2;0;2;96896;61575;89;158471
27;2020-S28;4;2;6;33148;12109;90;45257
27;2020-S28;52;38;90;1429908;1353131;0;2783039
28;2020-S28;12;4;17;180735;186856;09;367591
28;2020-S28;12;5;17;200125;213621;19;413746
28;2020-S28;13;6;19;168922;173007;29;341929
28;2020-S28;11;6;18;196628;188487;39;385115
28;2020-S28;8;6;14;205396;201699;49;407095
28;2020-S28;0;6;6;222002;213866;59;435868
28;2020-S28;4;5;9;224688;203758;69;428446
28;2020-S28;3;3;6;163192;135543;79;298735
28;2020-S28;1;0;1;109691;65377;89;175068
28;2020-S28;1;0;1;37222;12685;90;49907
28;2020-S28;65;41;108;1708601;1594899;0;3303500
32;2020-S28;11;8;19;358062;373689;09;731751
32;2020-S28;24;35;59;387045;406742;19;793787
32;2020-S28;20;18;39;342304;348587;29;690891
32;2020-S28;24;25;49;382485;369972;39;752457
32;2020-S28;26;18;44;382510;376716;49;759226
32;2020-S28;20;20;40;386937;376527;59;763464
32;2020-S28;15;13;28;371211;330938;69;702149
32;2020-S28;11;17;28;250542;201459;79;452001
32;2020-S28;17;4;21;163399;89786;89;253185
32;2020-S28;8;1;9;48384;15367;90;63751
32;2020-S28;176;159;336;3072879;2889783;0;5962662
44;2020-S28;4;3;7;291525;306839;09;598364
44;2020-S28;2;5;7;320255;339504;19;659759
44;2020-S28;16;20;36;302020;314428;29;616448
44;2020-S28;6;7;13;342222;333292;39;675514
44;2020-S28;15;16;31;349727;344491;49;694218
44;2020-S28;2;7;9;381371;373239;59;754610
44;2020-S28;11;11;22;367165;335850;69;703015
44;2020-S28;6;10;16;250387;215436;79;465823
44;2020-S28;2;6;8;170825;105192;89;276017
44;2020-S28;3;3;6;51248;16731;90;67979
44;2020-S28;67;88;156;2826745;2685002;0;5511747
52;2020-S28;14;8;23;213594;223900;09;437494
52;2020-S28;20;18;41;240818;255197;19;496015
52;2020-S28;19;30;49;197010;200630;29;397640
52;2020-S28;34;23;57;231204;224885;39;456089
52;2020-S28;22;14;36;243874;243418;49;487292
52;2020-S28;19;16;35;244100;239116;59;483216
52;2020-S28;5;7;12;241796;221345;69;463141
52;2020-S28;5;7;12;177805;149903;79;327708
52;2020-S28;6;2;8;119561;75822;89;195383
52;2020-S28;0;0;0;42559;15260;90;57819
52;2020-S28;144;125;273;1952321;1849476;0;3801797
53;2020-S28;6;3;9;173813;182358;09;356171
53;2020-S28;3;5;8;202720;214740;19;417460
53;2020-S28;9;5;14;163116;173196;29;336312
53;2020-S28;12;6;18;190526;187674;39;378200
53;2020-S28;13;8;21;212098;212015;49;424113
53;2020-S28;7;5;12;223699;219176;59;442875
53;2020-S28;4;4;8;227435;209274;69;436709
53;2020-S28;3;5;8;169992;140910;79;310902
53;2020-S28;1;2;3;118117;69883;89;188000
53;2020-S28;0;0;0;37370;12267;90;49637
53;2020-S28;58;43;101;1718886;1621493;0;3340379
75;2020-S28;6;5;12;293104;305291;09;598395
75;2020-S28;4;8;12;337141;357785;19;694926
75;2020-S28;5;3;8;295024;300618;29;595642
75;2020-S28;5;4;9;347871;331233;39;679104
75;2020-S28;14;11;25;384742;372771;49;757513
75;2020-S28;2;11;13;413361;390880;59;804241
75;2020-S28;5;7;12;425623;384060;69;809683
75;2020-S28;1;2;3;325086;276298;79;601384
75;2020-S28;4;1;5;213986;139308;89;353294
75;2020-S28;1;1;2;77600;28200;90;105800
75;2020-S28;47;53;106;3113538;2886444;0;5999982
76;2020-S28;1;3;4;305956;318589;09;624545
76;2020-S28;9;10;19;338942;356969;19;695911
76;2020-S28;11;12;23;316210;319570;29;635780
76;2020-S28;13;11;24;356758;337587;39;694345
76;2020-S28;7;14;21;376541;363812;49;740353
76;2020-S28;5;8;13;402608;383750;59;786358
76;2020-S28;5;5;10;394889;358997;69;753886
76;2020-S28;2;1;3;308664;263806;79;572470
76;2020-S28;0;1;1;195838;129272;89;325110
76;2020-S28;1;0;1;69372;26728;90;96100
76;2020-S28;54;65;119;3065778;2859080;0;5924858
84;2020-S28;11;10;21;459549;481088;09;940637
84;2020-S28;15;14;29;487711;511905;19;999616
84;2020-S28;37;21;58;443824;451094;29;894918
84;2020-S28;22;18;40;512522;493262;39;1005784
84;2020-S28;19;13;32;520248;515106;49;1035354
84;2020-S28;20;19;39;529611;514848;59;1044459
84;2020-S28;21;10;31;486720;439940;69;926660
84;2020-S28;7;10;17;372151;315211;79;687362
84;2020-S28;7;9;16;237198;150524;89;387722
84;2020-S28;5;2;7;81185;28680;90;109865
84;2020-S28;164;126;290;4130719;3901658;0;8032377
93;2020-S28;9;9;19;268834;283093;09;551927
93;2020-S28;18;13;31;280751;296087;19;576838
93;2020-S28;20;19;39;254404;255552;29;509956
93;2020-S28;23;17;40;310704;288398;39;599102
93;2020-S28;12;22;34;325559;305827;49;631386
93;2020-S28;12;28;40;353104;325389;59;678493
93;2020-S28;9;11;20;336327;296459;69;632786
93;2020-S28;8;8;16;279820;229699;79;509519
93;2020-S28;6;2;8;171274;113716;89;284990
93;2020-S28;2;0;2;58896;21758;90;80654
93;2020-S28;119;129;250;2639673;2415978;0;5055651
94;2020-S28;0;0;0;16311;17433;09;33744
94;2020-S28;0;0;0;16679;18132;19;34811
94;2020-S28;0;4;4;16782;16579;29;33361
94;2020-S28;0;1;1;23044;20580;39;43624
94;2020-S28;0;0;0;23065;22140;49;45205
94;2020-S28;1;0;1;24549;23421;59;47970
94;2020-S28;0;0;0;23212;21883;69;45095
94;2020-S28;0;0;0;19544;17141;79;36685
94;2020-S28;0;0;0;11227;8178;89;19405
94;2020-S28;0;0;0;3332;1447;90;4779
94;2020-S28;1;5;6;177745;166934;0;344679
01;2020-S29;0;0;0;19979;20155;09;40134
01;2020-S29;1;1;2;24994;25489;19;50483
01;2020-S29;2;0;2;17868;16690;29;34558
01;2020-S29;1;1;2;22328;14821;39;37149
01;2020-S29;1;0;1;28652;20276;49;48928
01;2020-S29;1;1;2;33264;27260;59;60524
01;2020-S29;0;1;1;27135;23978;69;51113
01;2020-S29;0;0;0;18401;14661;79;33062
01;2020-S29;0;0;0;9633;6375;89;16008
01;2020-S29;0;0;0;3410;1510;90;4920
01;2020-S29;6;4;10;205664;171215;0;376879
02;2020-S29;0;0;0;16881;17110;09;33991
02;2020-S29;0;0;0;21410;21604;19;43014
02;2020-S29;2;0;2;16017;15479;29;31496
02;2020-S29;1;1;2;19825;14455;39;34280
02;2020-S29;0;1;1;24719;18248;49;42967
02;2020-S29;2;0;2;34361;28310;59;62671
02;2020-S29;1;0;1;28061;24495;69;52556
02;2020-S29;0;0;0;18231;15278;79;33509
02;2020-S29;0;0;0;11090;7677;89;18767
02;2020-S29;0;0;0;3992;1506;90;5498
02;2020-S29;6;2;8;194587;164162;0;358749
03;2020-S29;11;24;35;31123;30920;09;62043
03;2020-S29;37;35;75;29370;29268;19;58638
03;2020-S29;77;69;151;21458;18963;29;40421
03;2020-S29;69;47;120;21276;18326;39;39602
03;2020-S29;61;61;128;18164;16593;49;34757
03;2020-S29;38;59;98;13469;13557;59;27026
03;2020-S29;17;26;43;8776;8670;69;17446
03;2020-S29;4;9;13;3777;3591;79;7368
03;2020-S29;1;2;3;1649;1072;89;2721
03;2020-S29;0;1;1;485;184;90;669
03;2020-S29;315;333;667;149547;141144;0;290691
04;2020-S29;2;2;4;60314;61377;09;121691
04;2020-S29;1;1;2;66065;68387;19;134452
04;2020-S29;2;4;6;51059;47156;29;98215
04;2020-S29;2;5;7;58788;45780;39;104568
04;2020-S29;5;5;10;61408;52207;49;113615
04;2020-S29;1;3;4;64838;60759;59;125597
04;2020-S29;0;2;2;47008;42843;69;89851
04;2020-S29;1;0;1;25509;21184;79;46693
04;2020-S29;0;0;0;13168;7647;89;20815
04;2020-S29;0;0;0;3209;1253;90;4462
04;2020-S29;14;22;36;451366;408593;0;859959
05;2020-S29;0;0;0;362.366008612902;341.338819562748;09;703.704828175651
05;2020-S29;0;0;0;353.376145114279;370.349735405642;19;723.725880519921
05;2020-S29;0;0;0;218.593559489256;256.539602589476;29;475.133162078732
05;2020-S29;0;0;0;404.225408693299;360.321910454353;39;764.547319147651
05;2020-S29;0;0;0;520.067953604221;497.108383964256;49;1017.17633756848
05;2020-S29;0;0;0;468.146063921917;510.087601910415;59;978.233665832332
05;2020-S29;0;0;0;340.368470050554;334.366842191253;69;674.735312241807
05;2020-S29;0;0;0;212.598666888387;192.597753227106;79;405.196420115493
05;2020-S29;0;0;0;148.727797095705;61.8681715431829;89;210.595968638888
05;2020-S29;0;0;0;32.9601271090696;10.9909785719784;90;43.9511056810479
05;2020-S29;0;0;0;3061.43020057959;2935.56979942041;0;5997
06;2020-S29;0;1;1;42583;42380;09;84963
06;2020-S29;6;12;18;33369;31925;19;65294
06;2020-S29;9;12;21;21571;15080;29;36651
06;2020-S29;12;8;20;21550;16147;39;37697
06;2020-S29;9;10;19;14193;13939;49;28132
06;2020-S29;3;0;3;7171;7597;59;14768
06;2020-S29;0;2;2;3629;4117;69;7746
06;2020-S29;1;1;2;1577;1457;79;3034
06;2020-S29;0;0;0;531;474;89;1005
06;2020-S29;0;0;0;88;93;90;181
06;2020-S29;40;46;86;146262;133209;0;279471
07;2020-S29;0;0;0;485;549;09;1034
07;2020-S29;0;0;0;403;432;19;835
07;2020-S29;0;0;0;764;841;29;1605
07;2020-S29;0;0;0;824;928;39;1752
07;2020-S29;0;0;0;788;1020;49;1808
07;2020-S29;0;1;1;678;870;59;1548
07;2020-S29;0;0;0;360;382;69;742
07;2020-S29;0;0;0;231;190;79;421
07;2020-S29;0;1;1;114;67;89;181
07;2020-S29;0;0;0;24;11;90;35
07;2020-S29;0;2;2;4671;5290;0;9961
08;2020-S29;0;0;0;2715.22592983026;2997.75551488675;09;5712.98144471701
08;2020-S29;0;0;0;2778.51901080978;3160.9156459093;19;5939.43465671908
08;2020-S29;0;0;0;2080.8882988764;1718.16634315323;29;3799.05464202964
08;2020-S29;0;0;0;2701.8582062647;1896.52641413317;39;4598.38462039786
08;2020-S29;0;0;0;3151.45861023308;2460.52498233809;49;5611.98359257117
08;2020-S29;0;0;0;2620.29868333099;2422.23566154656;59;5042.53434487755
08;2020-S29;0;1;1;1621.44173420671;1438.58325779464;69;3060.02499200135
08;2020-S29;0;1;1;626.575909335673;526.358467843651;79;1152.93437717932
08;2020-S29;0;0;0;205.018522985054;140.993639349697;89;346.012162334751
08;2020-S29;0;0;0;50.0325684687745;20.62259870351;90;70.6551671722846
08;2020-S29;0;2;2;18551.3174743414;16782.6825256586;0;35334
11;2020-S29;22;33;55;783071;811785;09;1594856
11;2020-S29;60;54;115;761456;784653;19;1546109
11;2020-S29;136;103;239;850145;801772;29;1651917
11;2020-S29;127;121;248;914360;843488;39;1757848
11;2020-S29;95;77;173;845609;826202;49;1671811
11;2020-S29;86;75;161;793566;745070;59;1538636
11;2020-S29;58;54;112;628649;549192;69;1177841
11;2020-S29;33;48;81;434606;358356;79;792962
11;2020-S29;14;18;32;261425;162933;89;424358
11;2020-S29;11;5;16;89253;32619;90;121872
11;2020-S29;643;590;1242;6362140;5916070;0;12278210
24;2020-S29;0;2;2;139720;144686;09;284406
24;2020-S29;0;1;1;152979;161185;19;314164
24;2020-S29;7;3;10;122237;126536;29;248773
24;2020-S29;1;2;3;150359;142009;39;292368
24;2020-S29;3;0;3;161829;158758;49;320587
24;2020-S29;1;8;9;172552;168011;59;340563
24;2020-S29;1;0;1;172509;158177;69;330686
24;2020-S29;3;2;5;129428;110593;79;240021
24;2020-S29;1;3;4;87342;56882;89;144224
24;2020-S29;0;0;0;31210;12071;90;43281
24;2020-S29;17;21;38;1320165;1238908;0;2559073
27;2020-S29;1;1;2;143373;149679;09;293052
27;2020-S29;1;0;1;160962;173003;19;333965
27;2020-S29;5;4;9;133746;142254;29;276000
27;2020-S29;3;7;10;160004;155407;39;315411
27;2020-S29;10;6;16;172333;169564;49;341897
27;2020-S29;5;3;8;189979;183788;59;373767
27;2020-S29;6;7;13;192591;178206;69;370797
27;2020-S29;5;6;11;146876;127546;79;274422
27;2020-S29;1;0;1;96896;61575;89;158471
27;2020-S29;3;0;3;33148;12109;90;45257
27;2020-S29;40;34;74;1429908;1353131;0;2783039
28;2020-S29;4;2;7;180735;186856;09;367591
28;2020-S29;5;7;12;200125;213621;19;413746
28;2020-S29;15;3;18;168922;173007;29;341929
28;2020-S29;8;7;15;196628;188487;39;385115
28;2020-S29;6;5;11;205396;201699;49;407095
28;2020-S29;4;2;6;222002;213866;59;435868
28;2020-S29;5;3;8;224688;203758;69;428446
28;2020-S29;4;5;9;163192;135543;79;298735
28;2020-S29;4;1;5;109691;65377;89;175068
28;2020-S29;0;1;1;37222;12685;90;49907
28;2020-S29;55;36;92;1708601;1594899;0;3303500
32;2020-S29;13;24;38;358062;373689;09;731751
32;2020-S29;17;38;55;387045;406742;19;793787
32;2020-S29;26;33;60;342304;348587;29;690891
32;2020-S29;25;26;51;382485;369972;39;752457
32;2020-S29;21;26;47;382510;376716;49;759226
32;2020-S29;15;22;37;386937;376527;59;763464
32;2020-S29;18;14;32;371211;330938;69;702149
32;2020-S29;13;12;25;250542;201459;79;452001
32;2020-S29;8;4;12;163399;89786;89;253185
32;2020-S29;4;1;5;48384;15367;90;63751
32;2020-S29;160;200;368;3072879;2889783;0;5962662
44;2020-S29;6;9;15;291525;306839;09;598364
44;2020-S29;9;19;29;320255;339504;19;659759
44;2020-S29;20;13;33;302020;314428;29;616448
44;2020-S29;40;37;77;342222;333292;39;675514
44;2020-S29;17;19;36;349727;344491;49;694218
44;2020-S29;28;24;52;381371;373239;59;754610
44;2020-S29;17;25;42;367165;335850;69;703015
44;2020-S29;15;19;34;250387;215436;79;465823
44;2020-S29;11;4;15;170825;105192;89;276017
44;2020-S29;6;0;6;51248;16731;90;67979
44;2020-S29;169;169;339;2826745;2685002;0;5511747
52;2020-S29;18;19;41;213594;223900;09;437494
52;2020-S29;20;41;63;240818;255197;19;496015
52;2020-S29;32;46;78;197010;200630;29;397640
52;2020-S29;37;46;83;231204;224885;39;456089
52;2020-S29;23;21;44;243874;243418;49;487292
52;2020-S29;24;30;54;244100;239116;59;483216
52;2020-S29;17;10;27;241796;221345;69;463141
52;2020-S29;11;5;16;177805;149903;79;327708
52;2020-S29;3;4;7;119561;75822;89;195383
52;2020-S29;5;0;5;42559;15260;90;57819
52;2020-S29;190;222;418;1952321;1849476;0;3801797
53;2020-S29;10;11;21;173813;182358;09;356171
53;2020-S29;13;13;26;202720;214740;19;417460
53;2020-S29;20;14;34;163116;173196;29;336312
53;2020-S29;27;24;51;190526;187674;39;378200
53;2020-S29;14;17;31;212098;212015;49;424113
53;2020-S29;20;14;34;223699;219176;59;442875
53;2020-S29;12;8;20;227435;209274;69;436709
53;2020-S29;7;5;12;169992;140910;79;310902
53;2020-S29;4;5;9;118117;69883;89;188000
53;2020-S29;4;0;4;37370;12267;90;49637
53;2020-S29;131;111;242;1718886;1621493;0;3340379
75;2020-S29;1;5;7;293104;305291;09;598395
75;2020-S29;6;10;16;337141;357785;19;694926
75;2020-S29;22;23;45;295024;300618;29;595642
75;2020-S29;8;14;22;347871;331233;39;679104
75;2020-S29;7;5;12;384742;372771;49;757513
75;2020-S29;4;9;13;413361;390880;59;804241
75;2020-S29;4;7;11;425623;384060;69;809683
75;2020-S29;4;3;7;325086;276298;79;601384
75;2020-S29;8;3;11;213986;139308;89;353294
75;2020-S29;2;2;4;77600;28200;90;105800
75;2020-S29;66;81;148;3113538;2886444;0;5999982
76;2020-S29;4;3;7;305956;318589;09;624545
76;2020-S29;8;5;13;338942;356969;19;695911
76;2020-S29;19;14;33;316210;319570;29;635780
76;2020-S29;12;15;27;356758;337587;39;694345
76;2020-S29;14;10;24;376541;363812;49;740353
76;2020-S29;12;10;22;402608;383750;59;786358
76;2020-S29;9;2;11;394889;358997;69;753886
76;2020-S29;2;4;6;308664;263806;79;572470
76;2020-S29;3;1;4;195838;129272;89;325110
76;2020-S29;0;0;0;69372;26728;90;96100
76;2020-S29;83;64;147;3065778;2859080;0;5924858
84;2020-S29;8;5;13;459549;481088;09;940637
84;2020-S29;17;12;29;487711;511905;19;999616
84;2020-S29;24;26;50;443824;451094;29;894918
84;2020-S29;26;24;50;512522;493262;39;1005784
84;2020-S29;18;23;41;520248;515106;49;1035354
84;2020-S29;17;15;32;529611;514848;59;1044459
84;2020-S29;16;20;36;486720;439940;69;926660
84;2020-S29;18;12;30;372151;315211;79;687362
84;2020-S29;7;7;14;237198;150524;89;387722
84;2020-S29;5;2;7;81185;28680;90;109865
84;2020-S29;156;146;302;4130719;3901658;0;8032377
93;2020-S29;5;6;11;268834;283093;09;551927
93;2020-S29;17;10;27;280751;296087;19;576838
93;2020-S29;14;15;29;254404;255552;29;509956
93;2020-S29;19;19;38;310704;288398;39;599102
93;2020-S29;21;29;50;325559;305827;49;631386
93;2020-S29;18;15;33;353104;325389;59;678493
93;2020-S29;9;15;24;336327;296459;69;632786
93;2020-S29;10;6;16;279820;229699;79;509519
93;2020-S29;3;4;7;171274;113716;89;284990
93;2020-S29;3;1;4;58896;21758;90;80654
93;2020-S29;119;120;240;2639673;2415978;0;5055651
94;2020-S29;0;1;1;16311;17433;09;33744
94;2020-S29;0;1;1;16679;18132;19;34811
94;2020-S29;3;3;6;16782;16579;29;33361
94;2020-S29;1;3;4;23044;20580;39;43624
94;2020-S29;1;2;3;23065;22140;49;45205
94;2020-S29;0;2;2;24549;23421;59;47970
94;2020-S29;1;0;1;23212;21883;69;45095
94;2020-S29;0;1;1;19544;17141;79;36685
94;2020-S29;0;0;0;11227;8178;89;19405
94;2020-S29;0;0;0;3332;1447;90;4779
94;2020-S29;6;13;19;177745;166934;0;344679
01;2020-S30;0;0;0;19979;20155;09;40134
01;2020-S30;2;0;2;24994;25489;19;50483
01;2020-S30;4;4;8;17868;16690;29;34558
01;2020-S30;2;1;3;22328;14821;39;37149
01;2020-S30;0;0;0;28652;20276;49;48928
01;2020-S30;0;0;0;33264;27260;59;60524
01;2020-S30;1;0;1;27135;23978;69;51113
01;2020-S30;0;0;0;18401;14661;79;33062
01;2020-S30;0;0;0;9633;6375;89;16008
01;2020-S30;0;0;0;3410;1510;90;4920
01;2020-S30;9;5;14;205664;171215;0;376879
02;2020-S30;0;0;0;16881;17110;09;33991
02;2020-S30;0;0;0;21410;21604;19;43014
02;2020-S30;2;1;3;16017;15479;29;31496
02;2020-S30;1;1;2;19825;14455;39;34280
02;2020-S30;1;0;1;24719;18248;49;42967
02;2020-S30;0;2;2;34361;28310;59;62671
02;2020-S30;0;0;0;28061;24495;69;52556
02;2020-S30;0;0;0;18231;15278;79;33509
02;2020-S30;0;0;0;11090;7677;89;18767
02;2020-S30;0;0;0;3992;1506;90;5498
02;2020-S30;4;4;8;194587;164162;0;358749
03;2020-S30;26;30;58;31123;30920;09;62043
03;2020-S30;49;34;87;29370;29268;19;58638
03;2020-S30;77;60;140;21458;18963;29;40421
03;2020-S30;73;61;137;21276;18326;39;39602
03;2020-S30;45;50;98;18164;16593;49;34757
03;2020-S30;40;30;76;13469;13557;59;27026
03;2020-S30;24;19;43;8776;8670;69;17446
03;2020-S30;7;13;20;3777;3591;79;7368
03;2020-S30;10;5;15;1649;1072;89;2721
03;2020-S30;0;0;0;485;184;90;669
03;2020-S30;351;302;674;149547;141144;0;290691
04;2020-S30;0;0;0;60314;61377;09;121691
04;2020-S30;5;2;7;66065;68387;19;134452
04;2020-S30;2;5;7;51059;47156;29;98215
04;2020-S30;2;2;4;58788;45780;39;104568
04;2020-S30;1;1;2;61408;52207;49;113615
04;2020-S30;2;0;2;64838;60759;59;125597
04;2020-S30;3;0;3;47008;42843;69;89851
04;2020-S30;0;1;1;25509;21184;79;46693
04;2020-S30;0;1;1;13168;7647;89;20815
04;2020-S30;0;0;0;3209;1253;90;4462
04;2020-S30;15;12;27;451366;408593;0;859959
05;2020-S30;0;0;0;362.366008612902;341.338819562748;09;703.704828175651
05;2020-S30;0;0;0;353.376145114279;370.349735405642;19;723.725880519921
05;2020-S30;0;0;0;218.593559489256;256.539602589476;29;475.133162078732
05;2020-S30;0;0;0;404.225408693299;360.321910454353;39;764.547319147651
05;2020-S30;0;0;0;520.067953604221;497.108383964256;49;1017.17633756848
05;2020-S30;0;0;0;468.146063921917;510.087601910415;59;978.233665832332
05;2020-S30;0;0;0;340.368470050554;334.366842191253;69;674.735312241807
05;2020-S30;0;0;0;212.598666888387;192.597753227106;79;405.196420115493
05;2020-S30;0;0;0;148.727797095705;61.8681715431829;89;210.595968638888
05;2020-S30;0;0;0;32.9601271090696;10.9909785719784;90;43.9511056810479
05;2020-S30;0;0;0;3061.43020057959;2935.56979942041;0;5997
06;2020-S30;3;3;6;42583;42380;09;84963
06;2020-S30;5;8;13;33369;31925;19;65294
06;2020-S30;10;9;19;21571;15080;29;36651
06;2020-S30;13;4;17;21550;16147;39;37697
06;2020-S30;5;7;12;14193;13939;49;28132
06;2020-S30;2;8;10;7171;7597;59;14768
06;2020-S30;2;2;4;3629;4117;69;7746
06;2020-S30;3;2;5;1577;1457;79;3034
06;2020-S30;0;0;0;531;474;89;1005
06;2020-S30;0;0;0;88;93;90;181
06;2020-S30;43;43;86;146262;133209;0;279471
07;2020-S30;0;0;0;485;549;09;1034
07;2020-S30;0;0;0;403;432;19;835
07;2020-S30;0;0;0;764;841;29;1605
07;2020-S30;0;0;0;824;928;39;1752
07;2020-S30;0;0;0;788;1020;49;1808
07;2020-S30;0;0;0;678;870;59;1548
07;2020-S30;0;0;0;360;382;69;742
07;2020-S30;0;0;0;231;190;79;421
07;2020-S30;0;0;0;114;67;89;181
07;2020-S30;0;0;0;24;11;90;35
07;2020-S30;0;0;0;4671;5290;0;9961
08;2020-S30;0;0;0;2715.22592983026;2997.75551488675;09;5712.98144471701
08;2020-S30;0;0;0;2778.51901080978;3160.9156459093;19;5939.43465671908
08;2020-S30;1;0;1;2080.8882988764;1718.16634315323;29;3799.05464202964
08;2020-S30;0;0;0;2701.8582062647;1896.52641413317;39;4598.38462039786
08;2020-S30;1;0;1;3151.45861023308;2460.52498233809;49;5611.98359257117
08;2020-S30;0;0;0;2620.29868333099;2422.23566154656;59;5042.53434487755
08;2020-S30;0;0;0;1621.44173420671;1438.58325779464;69;3060.02499200135
08;2020-S30;1;0;1;626.575909335673;526.358467843651;79;1152.93437717932
08;2020-S30;0;0;0;205.018522985054;140.993639349697;89;346.012162334751
08;2020-S30;0;0;0;50.0325684687745;20.62259870351;90;70.6551671722846
08;2020-S30;3;0;3;18551.3174743414;16782.6825256586;0;35334
11;2020-S30;27;45;74;783071;811785;09;1594856
11;2020-S30;89;76;166;761456;784653;19;1546109
11;2020-S30;242;212;455;850145;801772;29;1651917
11;2020-S30;177;202;379;914360;843488;39;1757848
11;2020-S30;126;150;276;845609;826202;49;1671811
11;2020-S30;117;107;224;793566;745070;59;1538636
11;2020-S30;68;93;161;628649;549192;69;1177841
11;2020-S30;48;50;98;434606;358356;79;792962
11;2020-S30;21;27;48;261425;162933;89;424358
11;2020-S30;22;9;31;89253;32619;90;121872
11;2020-S30;937;973;1923;6362140;5916070;0;12278210
24;2020-S30;4;1;5;139720;144686;09;284406
24;2020-S30;12;4;16;152979;161185;19;314164
24;2020-S30;22;18;40;122237;126536;29;248773
24;2020-S30;12;12;24;150359;142009;39;292368
24;2020-S30;9;17;26;161829;158758;49;320587
24;2020-S30;8;3;11;172552;168011;59;340563
24;2020-S30;12;7;19;172509;158177;69;330686
24;2020-S30;5;3;8;129428;110593;79;240021
24;2020-S30;3;0;3;87342;56882;89;144224
24;2020-S30;0;0;0;31210;12071;90;43281
24;2020-S30;87;65;152;1320165;1238908;0;2559073
27;2020-S30;5;4;9;143373;149679;09;293052
27;2020-S30;5;5;10;160962;173003;19;333965
27;2020-S30;11;12;23;133746;142254;29;276000
27;2020-S30;6;3;9;160004;155407;39;315411
27;2020-S30;6;6;12;172333;169564;49;341897
27;2020-S30;5;3;8;189979;183788;59;373767
27;2020-S30;4;3;7;192591;178206;69;370797
27;2020-S30;8;6;14;146876;127546;79;274422
27;2020-S30;2;1;3;96896;61575;89;158471
27;2020-S30;5;1;6;33148;12109;90;45257
27;2020-S30;57;44;101;1429908;1353131;0;2783039
28;2020-S30;2;8;10;180735;186856;09;367591
28;2020-S30;3;3;6;200125;213621;19;413746
28;2020-S30;11;10;22;168922;173007;29;341929
28;2020-S30;18;8;26;196628;188487;39;385115
28;2020-S30;9;7;16;205396;201699;49;407095
28;2020-S30;5;5;10;222002;213866;59;435868
28;2020-S30;5;2;7;224688;203758;69;428446
28;2020-S30;3;3;6;163192;135543;79;298735
28;2020-S30;4;0;4;109691;65377;89;175068
28;2020-S30;2;0;2;37222;12685;90;49907
28;2020-S30;62;46;109;1708601;1594899;0;3303500
32;2020-S30;20;14;34;358062;373689;09;731751
32;2020-S30;33;28;62;387045;406742;19;793787
32;2020-S30;63;44;107;342304;348587;29;690891
32;2020-S30;57;47;104;382485;369972;39;752457
32;2020-S30;50;37;88;382510;376716;49;759226
32;2020-S30;40;35;75;386937;376527;59;763464
32;2020-S30;22;24;47;371211;330938;69;702149
32;2020-S30;18;18;36;250542;201459;79;452001
32;2020-S30;17;8;25;163399;89786;89;253185
32;2020-S30;9;2;11;48384;15367;90;63751
32;2020-S30;329;257;589;3072879;2889783;0;5962662
44;2020-S30;8;8;16;291525;306839;09;598364
44;2020-S30;19;12;31;320255;339504;19;659759
44;2020-S30;32;25;57;302020;314428;29;616448
44;2020-S30;26;31;57;342222;333292;39;675514
44;2020-S30;31;31;62;349727;344491;49;694218
44;2020-S30;20;27;47;381371;373239;59;754610
44;2020-S30;23;20;43;367165;335850;69;703015
44;2020-S30;17;14;31;250387;215436;79;465823
44;2020-S30;6;3;9;170825;105192;89;276017
44;2020-S30;3;1;4;51248;16731;90;67979
44;2020-S30;185;172;357;2826745;2685002;0;5511747
52;2020-S30;13;6;19;213594;223900;09;437494
52;2020-S30;56;63;119;240818;255197;19;496015
52;2020-S30;77;73;150;197010;200630;29;397640
52;2020-S30;49;46;95;231204;224885;39;456089
52;2020-S30;43;40;83;243874;243418;49;487292
52;2020-S30;48;39;87;244100;239116;59;483216
52;2020-S30;36;24;60;241796;221345;69;463141
52;2020-S30;23;24;47;177805;149903;79;327708
52;2020-S30;19;7;26;119561;75822;89;195383
52;2020-S30;7;4;11;42559;15260;90;57819
52;2020-S30;371;326;697;1952321;1849476;0;3801797
53;2020-S30;3;1;4;173813;182358;09;356171
53;2020-S30;24;37;61;202720;214740;19;417460
53;2020-S30;38;34;72;163116;173196;29;336312
53;2020-S30;10;20;30;190526;187674;39;378200
53;2020-S30;11;14;25;212098;212015;49;424113
53;2020-S30;6;6;12;223699;219176;59;442875
53;2020-S30;6;5;11;227435;209274;69;436709
53;2020-S30;5;4;9;169992;140910;79;310902
53;2020-S30;2;2;4;118117;69883;89;188000
53;2020-S30;2;1;3;37370;12267;90;49637
53;2020-S30;107;124;231;1718886;1621493;0;3340379
75;2020-S30;8;4;12;293104;305291;09;598395
75;2020-S30;8;11;19;337141;357785;19;694926
75;2020-S30;33;24;57;295024;300618;29;595642
75;2020-S30;10;17;27;347871;331233;39;679104
75;2020-S30;10;13;23;384742;372771;49;757513
75;2020-S30;12;9;21;413361;390880;59;804241
75;2020-S30;11;7;18;425623;384060;69;809683
75;2020-S30;8;0;8;325086;276298;79;601384
75;2020-S30;1;1;2;213986;139308;89;353294
75;2020-S30;1;0;1;77600;28200;90;105800
75;2020-S30;102;86;188;3113538;2886444;0;5999982
76;2020-S30;7;16;23;305956;318589;09;624545
76;2020-S30;21;18;40;338942;356969;19;695911
76;2020-S30;46;44;90;316210;319570;29;635780
76;2020-S30;31;37;68;356758;337587;39;694345
76;2020-S30;21;26;47;376541;363812;49;740353
76;2020-S30;29;26;55;402608;383750;59;786358
76;2020-S30;17;11;29;394889;358997;69;753886
76;2020-S30;8;16;24;308664;263806;79;572470
76;2020-S30;5;4;9;195838;129272;89;325110
76;2020-S30;2;2;4;69372;26728;90;96100
76;2020-S30;187;201;390;3065778;2859080;0;5924858
84;2020-S30;23;17;40;459549;481088;09;940637
84;2020-S30;30;22;52;487711;511905;19;999616
84;2020-S30;76;55;131;443824;451094;29;894918
84;2020-S30;52;55;107;512522;493262;39;1005784
84;2020-S30;45;39;84;520248;515106;49;1035354
84;2020-S30;49;27;76;529611;514848;59;1044459
84;2020-S30;31;14;45;486720;439940;69;926660
84;2020-S30;16;17;33;372151;315211;79;687362
84;2020-S30;7;7;14;237198;150524;89;387722
84;2020-S30;5;2;7;81185;28680;90;109865
84;2020-S30;334;255;590;4130719;3901658;0;8032377
93;2020-S30;8;12;20;268834;283093;09;551927
93;2020-S30;16;10;26;280751;296087;19;576838
93;2020-S30;55;31;86;254404;255552;29;509956
93;2020-S30;40;51;91;310704;288398;39;599102
93;2020-S30;22;22;44;325559;305827;49;631386
93;2020-S30;28;31;59;353104;325389;59;678493
93;2020-S30;27;26;54;336327;296459;69;632786
93;2020-S30;21;16;37;279820;229699;79;509519
93;2020-S30;7;8;15;171274;113716;89;284990
93;2020-S30;3;1;4;58896;21758;90;80654
93;2020-S30;227;208;436;2639673;2415978;0;5055651
94;2020-S30;0;0;0;16311;17433;09;33744
94;2020-S30;0;0;0;16679;18132;19;34811
94;2020-S30;0;0;0;16782;16579;29;33361
94;2020-S30;0;0;0;23044;20580;39;43624
94;2020-S30;0;1;1;23065;22140;49;45205
94;2020-S30;0;0;0;24549;23421;59;47970
94;2020-S30;1;1;2;23212;21883;69;45095
94;2020-S30;0;0;0;19544;17141;79;36685
94;2020-S30;0;0;0;11227;8178;89;19405
94;2020-S30;0;0;0;3332;1447;90;4779
94;2020-S30;1;2;3;177745;166934;0;344679
01;2020-S31;0;0;0;19979;20155;09;40134
01;2020-S31;3;3;6;24994;25489;19;50483
01;2020-S31;16;14;30;17868;16690;29;34558
01;2020-S31;2;3;5;22328;14821;39;37149
01;2020-S31;3;4;7;28652;20276;49;48928
01;2020-S31;3;4;7;33264;27260;59;60524
01;2020-S31;2;1;3;27135;23978;69;51113
01;2020-S31;0;0;0;18401;14661;79;33062
01;2020-S31;0;0;0;9633;6375;89;16008
01;2020-S31;0;0;0;3410;1510;90;4920
01;2020-S31;30;29;59;205664;171215;0;376879
02;2020-S31;0;0;0;16881;17110;09;33991
02;2020-S31;2;2;4;21410;21604;19;43014
02;2020-S31;0;1;1;16017;15479;29;31496
02;2020-S31;3;3;6;19825;14455;39;34280
02;2020-S31;0;0;0;24719;18248;49;42967
02;2020-S31;2;3;5;34361;28310;59;62671
02;2020-S31;2;0;2;28061;24495;69;52556
02;2020-S31;0;0;0;18231;15278;79;33509
02;2020-S31;0;0;0;11090;7677;89;18767
02;2020-S31;0;0;0;3992;1506;90;5498
02;2020-S31;9;9;18;194587;164162;0;358749
03;2020-S31;13;15;29;31123;30920;09;62043
03;2020-S31;39;26;72;29370;29268;19;58638
03;2020-S31;55;34;95;21458;18963;29;40421
03;2020-S31;44;38;86;21276;18326;39;39602
03;2020-S31;40;26;69;18164;16593;49;34757
03;2020-S31;21;34;57;13469;13557;59;27026
03;2020-S31;10;20;30;8776;8670;69;17446
03;2020-S31;10;4;14;3777;3591;79;7368
03;2020-S31;2;2;5;1649;1072;89;2721
03;2020-S31;0;0;0;485;184;90;669
03;2020-S31;234;200;458;149547;141144;0;290691
04;2020-S31;0;0;0;60314;61377;09;121691
04;2020-S31;1;1;2;66065;68387;19;134452
04;2020-S31;5;2;7;51059;47156;29;98215
04;2020-S31;5;3;8;58788;45780;39;104568
04;2020-S31;2;1;3;61408;52207;49;113615
04;2020-S31;2;2;4;64838;60759;59;125597
04;2020-S31;2;1;3;47008;42843;69;89851
04;2020-S31;1;0;1;25509;21184;79;46693
04;2020-S31;0;0;0;13168;7647;89;20815
04;2020-S31;0;0;0;3209;1253;90;4462
04;2020-S31;18;10;28;451366;408593;0;859959
05;2020-S31;0;0;0;362.366008612902;341.338819562748;09;703.704828175651
05;2020-S31;0;0;0;353.376145114279;370.349735405642;19;723.725880519921
05;2020-S31;0;0;0;218.593559489256;256.539602589476;29;475.133162078732
05;2020-S31;0;0;0;404.225408693299;360.321910454353;39;764.547319147651
05;2020-S31;0;0;0;520.067953604221;497.108383964256;49;1017.17633756848
05;2020-S31;0;0;0;468.146063921917;510.087601910415;59;978.233665832332
05;2020-S31;0;0;0;340.368470050554;334.366842191253;69;674.735312241807
05;2020-S31;0;0;0;212.598666888387;192.597753227106;79;405.196420115493
05;2020-S31;0;0;0;148.727797095705;61.8681715431829;89;210.595968638888
05;2020-S31;0;0;0;32.9601271090696;10.9909785719784;90;43.9511056810479
05;2020-S31;0;0;0;3061.43020057959;2935.56979942041;0;5997
06;2020-S31;1;1;2;42583;42380;09;84963
06;2020-S31;8;4;12;33369;31925;19;65294
06;2020-S31;8;8;16;21571;15080;29;36651
06;2020-S31;8;5;13;21550;16147;39;37697
06;2020-S31;5;8;13;14193;13939;49;28132
06;2020-S31;4;11;15;7171;7597;59;14768
06;2020-S31;3;0;3;3629;4117;69;7746
06;2020-S31;1;3;4;1577;1457;79;3034
06;2020-S31;0;0;0;531;474;89;1005
06;2020-S31;0;0;0;88;93;90;181
06;2020-S31;38;40;79;146262;133209;0;279471
07;2020-S31;0;0;0;485;549;09;1034
07;2020-S31;0;0;0;403;432;19;835
07;2020-S31;0;1;1;764;841;29;1605
07;2020-S31;0;0;0;824;928;39;1752
07;2020-S31;0;0;0;788;1020;49;1808
07;2020-S31;0;0;0;678;870;59;1548
07;2020-S31;0;0;0;360;382;69;742
07;2020-S31;0;0;0;231;190;79;421
07;2020-S31;0;0;0;114;67;89;181
07;2020-S31;0;0;0;24;11;90;35
07;2020-S31;0;1;1;4671;5290;0;9961
08;2020-S31;0;0;0;2715.22592983026;2997.75551488675;09;5712.98144471701
08;2020-S31;0;0;0;2778.51901080978;3160.9156459093;19;5939.43465671908
08;2020-S31;0;0;0;2080.8882988764;1718.16634315323;29;3799.05464202964
08;2020-S31;0;1;1;2701.8582062647;1896.52641413317;39;4598.38462039786
08;2020-S31;1;1;2;3151.45861023308;2460.52498233809;49;5611.98359257117
08;2020-S31;2;0;2;2620.29868333099;2422.23566154656;59;5042.53434487755
08;2020-S31;0;0;0;1621.44173420671;1438.58325779464;69;3060.02499200135
08;2020-S31;0;0;0;626.575909335673;526.358467843651;79;1152.93437717932
08;2020-S31;0;0;0;205.018522985054;140.993639349697;89;346.012162334751
08;2020-S31;0;0;0;50.0325684687745;20.62259870351;90;70.6551671722846
08;2020-S31;3;2;5;18551.3174743414;16782.6825256586;0;35334
11;2020-S31;38;60;100;783071;811785;09;1594856
11;2020-S31;122;123;250;761456;784653;19;1546109
11;2020-S31;453;428;881;850145;801772;29;1651917
11;2020-S31;297;325;622;914360;843488;39;1757848
11;2020-S31;186;208;394;845609;826202;49;1671811
11;2020-S31;186;159;345;793566;745070;59;1538636
11;2020-S31;143;102;245;628649;549192;69;1177841
11;2020-S31;47;64;111;434606;358356;79;792962
11;2020-S31;32;30;62;261425;162933;89;424358
11;2020-S31;19;6;25;89253;32619;90;121872
11;2020-S31;1523;1508;3049;6362140;5916070;0;12278210
24;2020-S31;5;4;9;139720;144686;09;284406
24;2020-S31;12;16;28;152979;161185;19;314164
24;2020-S31;24;33;57;122237;126536;29;248773
24;2020-S31;21;13;34;150359;142009;39;292368
24;2020-S31;10;5;15;161829;158758;49;320587
24;2020-S31;15;9;24;172552;168011;59;340563
24;2020-S31;8;9;17;172509;158177;69;330686
24;2020-S31;3;4;7;129428;110593;79;240021
24;2020-S31;4;1;5;87342;56882;89;144224
24;2020-S31;1;1;2;31210;12071;90;43281
24;2020-S31;103;95;198;1320165;1238908;0;2559073
27;2020-S31;1;3;4;143373;149679;09;293052
27;2020-S31;6;7;13;160962;173003;19;333965
27;2020-S31;11;12;23;133746;142254;29;276000
27;2020-S31;7;6;13;160004;155407;39;315411
27;2020-S31;8;6;14;172333;169564;49;341897
27;2020-S31;9;9;18;189979;183788;59;373767
27;2020-S31;5;3;8;192591;178206;69;370797
27;2020-S31;8;6;14;146876;127546;79;274422
27;2020-S31;6;3;9;96896;61575;89;158471
27;2020-S31;1;0;1;33148;12109;90;45257
27;2020-S31;62;55;117;1429908;1353131;0;2783039
28;2020-S31;3;2;6;180735;186856;09;367591
28;2020-S31;8;11;19;200125;213621;19;413746
28;2020-S31;15;34;49;168922;173007;29;341929
28;2020-S31;9;8;17;196628;188487;39;385115
28;2020-S31;5;2;7;205396;201699;49;407095
28;2020-S31;9;7;16;222002;213866;59;435868
28;2020-S31;4;5;9;224688;203758;69;428446
28;2020-S31;2;3;5;163192;135543;79;298735
28;2020-S31;0;0;0;109691;65377;89;175068
28;2020-S31;1;0;1;37222;12685;90;49907
28;2020-S31;57;72;130;1708601;1594899;0;3303500
32;2020-S31;31;29;60;358062;373689;09;731751
32;2020-S31;53;45;98;387045;406742;19;793787
32;2020-S31;75;99;174;342304;348587;29;690891
32;2020-S31;71;69;140;382485;369972;39;752457
32;2020-S31;46;52;98;382510;376716;49;759226
32;2020-S31;41;41;82;386937;376527;59;763464
32;2020-S31;46;29;75;371211;330938;69;702149
32;2020-S31;22;23;46;250542;201459;79;452001
32;2020-S31;21;13;34;163399;89786;89;253185
32;2020-S31;8;1;9;48384;15367;90;63751
32;2020-S31;414;401;816;3072879;2889783;0;5962662
44;2020-S31;14;7;22;291525;306839;09;598364
44;2020-S31;22;22;46;320255;339504;19;659759
44;2020-S31;47;61;108;302020;314428;29;616448
44;2020-S31;30;36;66;342222;333292;39;675514
44;2020-S31;35;21;56;349727;344491;49;694218
44;2020-S31;29;28;57;381371;373239;59;754610
44;2020-S31;23;16;39;367165;335850;69;703015
44;2020-S31;11;14;25;250387;215436;79;465823
44;2020-S31;15;6;21;170825;105192;89;276017
44;2020-S31;7;2;9;51248;16731;90;67979
44;2020-S31;233;213;449;2826745;2685002;0;5511747
52;2020-S31;14;8;23;213594;223900;09;437494
52;2020-S31;40;45;85;240818;255197;19;496015
52;2020-S31;58;66;124;197010;200630;29;397640
52;2020-S31;39;30;69;231204;224885;39;456089
52;2020-S31;33;20;53;243874;243418;49;487292
52;2020-S31;29;28;57;244100;239116;59;483216
52;2020-S31;13;10;23;241796;221345;69;463141
52;2020-S31;9;12;21;177805;149903;79;327708
52;2020-S31;5;14;19;119561;75822;89;195383
52;2020-S31;5;1;6;42559;15260;90;57819
52;2020-S31;245;234;480;1952321;1849476;0;3801797
53;2020-S31;8;2;10;173813;182358;09;356171
53;2020-S31;22;29;51;202720;214740;19;417460
53;2020-S31;32;62;94;163116;173196;29;336312
53;2020-S31;15;22;37;190526;187674;39;378200
53;2020-S31;20;13;33;212098;212015;49;424113
53;2020-S31;16;21;37;223699;219176;59;442875
53;2020-S31;8;11;19;227435;209274;69;436709
53;2020-S31;3;1;4;169992;140910;79;310902
53;2020-S31;4;3;7;118117;69883;89;188000
53;2020-S31;4;2;6;37370;12267;90;49637
53;2020-S31;132;166;300;1718886;1621493;0;3340379
75;2020-S31;2;2;4;293104;305291;09;598395
75;2020-S31;11;4;15;337141;357785;19;694926
75;2020-S31;28;27;55;295024;300618;29;595642
75;2020-S31;12;18;30;347871;331233;39;679104
75;2020-S31;5;7;12;384742;372771;49;757513
75;2020-S31;6;8;14;413361;390880;59;804241
75;2020-S31;9;12;21;425623;384060;69;809683
75;2020-S31;0;2;3;325086;276298;79;601384
75;2020-S31;2;3;5;213986;139308;89;353294
75;2020-S31;3;1;4;77600;28200;90;105800
75;2020-S31;78;84;163;3113538;2886444;0;5999982
76;2020-S31;7;14;22;305956;318589;09;624545
76;2020-S31;30;37;67;338942;356969;19;695911
76;2020-S31;86;75;161;316210;319570;29;635780
76;2020-S31;39;52;91;356758;337587;39;694345
76;2020-S31;32;30;62;376541;363812;49;740353
76;2020-S31;31;18;49;402608;383750;59;786358
76;2020-S31;14;18;32;394889;358997;69;753886
76;2020-S31;14;13;27;308664;263806;79;572470
76;2020-S31;7;10;17;195838;129272;89;325110
76;2020-S31;4;1;5;69372;26728;90;96100
76;2020-S31;264;269;534;3065778;2859080;0;5924858
84;2020-S31;16;26;43;459549;481088;09;940637
84;2020-S31;39;49;88;487711;511905;19;999616
84;2020-S31;90;80;170;443824;451094;29;894918
84;2020-S31;73;81;154;512522;493262;39;1005784
84;2020-S31;40;32;72;520248;515106;49;1035354
84;2020-S31;43;34;77;529611;514848;59;1044459
84;2020-S31;25;22;47;486720;439940;69;926660
84;2020-S31;13;18;31;372151;315211;79;687362
84;2020-S31;5;2;7;237198;150524;89;387722
84;2020-S31;2;0;2;81185;28680;90;109865
84;2020-S31;346;345;692;4130719;3901658;0;8032377
93;2020-S31;18;12;30;268834;283093;09;551927
93;2020-S31;65;46;111;280751;296087;19;576838
93;2020-S31;130;127;257;254404;255552;29;509956
93;2020-S31;71;70;141;310704;288398;39;599102
93;2020-S31;54;52;106;325559;305827;49;631386
93;2020-S31;55;41;96;353104;325389;59;678493
93;2020-S31;27;25;52;336327;296459;69;632786
93;2020-S31;19;16;35;279820;229699;79;509519
93;2020-S31;18;7;25;171274;113716;89;284990
93;2020-S31;14;3;17;58896;21758;90;80654
93;2020-S31;472;399;871;2639673;2415978;0;5055651
94;2020-S31;0;0;0;16311;17433;09;33744
94;2020-S31;0;1;1;16679;18132;19;34811
94;2020-S31;0;0;0;16782;16579;29;33361
94;2020-S31;1;0;1;23044;20580;39;43624
94;2020-S31;2;0;2;23065;22140;49;45205
94;2020-S31;0;0;0;24549;23421;59;47970
94;2020-S31;0;0;0;23212;21883;69;45095
94;2020-S31;1;2;3;19544;17141;79;36685
94;2020-S31;0;0;0;11227;8178;89;19405
94;2020-S31;0;0;0;3332;1447;90;4779
94;2020-S31;4;3;7;177745;166934;0;344679
01;2020-S32;0;0;0;19979;20155;09;40134
01;2020-S32;1;2;3;24994;25489;19;50483
01;2020-S32;13;12;25;17868;16690;29;34558
01;2020-S32;5;4;9;22328;14821;39;37149
01;2020-S32;2;4;6;28652;20276;49;48928
01;2020-S32;3;0;3;33264;27260;59;60524
01;2020-S32;1;1;2;27135;23978;69;51113
01;2020-S32;1;2;3;18401;14661;79;33062
01;2020-S32;0;0;0;9633;6375;89;16008
01;2020-S32;0;0;0;3410;1510;90;4920
01;2020-S32;26;25;51;205664;171215;0;376879
02;2020-S32;0;3;3;16881;17110;09;33991
02;2020-S32;5;5;10;21410;21604;19;43014
02;2020-S32;6;5;11;16017;15479;29;31496
02;2020-S32;11;8;19;19825;14455;39;34280
02;2020-S32;4;5;9;24719;18248;49;42967
02;2020-S32;5;4;9;34361;28310;59;62671
02;2020-S32;2;2;4;28061;24495;69;52556
02;2020-S32;2;2;4;18231;15278;79;33509
02;2020-S32;0;0;0;11090;7677;89;18767
02;2020-S32;0;0;0;3992;1506;90;5498
02;2020-S32;35;34;69;194587;164162;0;358749
03;2020-S32;20;13;35;31123;30920;09;62043
03;2020-S32;31;25;58;29370;29268;19;58638
03;2020-S32;44;29;75;21458;18963;29;40421
03;2020-S32;36;34;73;21276;18326;39;39602
03;2020-S32;30;26;56;18164;16593;49;34757
03;2020-S32;13;14;27;13469;13557;59;27026
03;2020-S32;10;8;19;8776;8670;69;17446
03;2020-S32;3;7;10;3777;3591;79;7368
03;2020-S32;2;2;4;1649;1072;89;2721
03;2020-S32;0;0;0;485;184;90;669
03;2020-S32;189;158;357;149547;141144;0;290691
04;2020-S32;0;0;0;60314;61377;09;121691
04;2020-S32;7;5;12;66065;68387;19;134452
04;2020-S32;6;3;9;51059;47156;29;98215
04;2020-S32;3;2;5;58788;45780;39;104568
04;2020-S32;4;5;9;61408;52207;49;113615
04;2020-S32;3;2;5;64838;60759;59;125597
04;2020-S32;1;1;2;47008;42843;69;89851
04;2020-S32;1;1;2;25509;21184;79;46693
04;2020-S32;0;1;1;13168;7647;89;20815
04;2020-S32;0;1;1;3209;1253;90;4462
04;2020-S32;25;21;46;451366;408593;0;859959
05;2020-S32;0;0;0;362.366008612902;341.338819562748;09;703.704828175651
05;2020-S32;0;0;0;353.376145114279;370.349735405642;19;723.725880519921
05;2020-S32;0;0;0;218.593559489256;256.539602589476;29;475.133162078732
05;2020-S32;0;0;0;404.225408693299;360.321910454353;39;764.547319147651
05;2020-S32;0;0;0;520.067953604221;497.108383964256;49;1017.17633756848
05;2020-S32;0;0;0;468.146063921917;510.087601910415;59;978.233665832332
05;2020-S32;0;0;0;340.368470050554;334.366842191253;69;674.735312241807
05;2020-S32;0;0;0;212.598666888387;192.597753227106;79;405.196420115493
05;2020-S32;0;0;0;148.727797095705;61.8681715431829;89;210.595968638888
05;2020-S32;0;0;0;32.9601271090696;10.9909785719784;90;43.9511056810479
05;2020-S32;0;0;0;3061.43020057959;2935.56979942041;0;5997
06;2020-S32;1;1;3;42583;42380;09;84963
06;2020-S32;5;8;13;33369;31925;19;65294
06;2020-S32;4;13;17;21571;15080;29;36651
06;2020-S32;7;7;14;21550;16147;39;37697
06;2020-S32;8;9;17;14193;13939;49;28132
06;2020-S32;9;4;13;7171;7597;59;14768
06;2020-S32;3;2;5;3629;4117;69;7746
06;2020-S32;0;0;0;1577;1457;79;3034
06;2020-S32;0;1;1;531;474;89;1005
06;2020-S32;0;0;0;88;93;90;181
06;2020-S32;37;45;83;146262;133209;0;279471
07;2020-S32;0;0;0;485;549;09;1034
07;2020-S32;0;0;0;403;432;19;835
07;2020-S32;0;2;2;764;841;29;1605
07;2020-S32;0;0;0;824;928;39;1752
07;2020-S32;0;0;0;788;1020;49;1808
07;2020-S32;0;0;0;678;870;59;1548
07;2020-S32;0;0;0;360;382;69;742
07;2020-S32;0;0;0;231;190;79;421
07;2020-S32;0;1;1;114;67;89;181
07;2020-S32;0;0;0;24;11;90;35
07;2020-S32;0;3;3;4671;5290;0;9961
08;2020-S32;2;0;2;2715.22592983026;2997.75551488675;09;5712.98144471701
08;2020-S32;0;1;1;2778.51901080978;3160.9156459093;19;5939.43465671908
08;2020-S32;0;0;0;2080.8882988764;1718.16634315323;29;3799.05464202964
08;2020-S32;2;3;5;2701.8582062647;1896.52641413317;39;4598.38462039786
08;2020-S32;5;2;7;3151.45861023308;2460.52498233809;49;5611.98359257117
08;2020-S32;2;2;4;2620.29868333099;2422.23566154656;59;5042.53434487755
08;2020-S32;3;3;6;1621.44173420671;1438.58325779464;69;3060.02499200135
08;2020-S32;0;0;0;626.575909335673;526.358467843651;79;1152.93437717932
08;2020-S32;0;0;0;205.018522985054;140.993639349697;89;346.012162334751
08;2020-S32;0;0;0;50.0325684687745;20.62259870351;90;70.6551671722846
08;2020-S32;14;11;25;18551.3174743414;16782.6825256586;0;35334
11;2020-S32;56;71;130;783071;811785;09;1594856
11;2020-S32;193;165;363;761456;784653;19;1546109
11;2020-S32;670;642;1314;850145;801772;29;1651917
11;2020-S32;439;492;933;914360;843488;39;1757848
11;2020-S32;283;266;549;845609;826202;49;1671811
11;2020-S32;240;213;454;793566;745070;59;1538636
11;2020-S32;156;148;304;628649;549192;69;1177841
11;2020-S32;78;120;198;434606;358356;79;792962
11;2020-S32;55;41;96;261425;162933;89;424358
11;2020-S32;24;9;33;89253;32619;90;121872
11;2020-S32;2195;2169;4386;6362140;5916070;0;12278210
24;2020-S32;6;2;8;139720;144686;09;284406
24;2020-S32;24;21;45;152979;161185;19;314164
24;2020-S32;45;30;75;122237;126536;29;248773
24;2020-S32;30;17;47;150359;142009;39;292368
24;2020-S32;24;13;37;161829;158758;49;320587
24;2020-S32;11;11;22;172552;168011;59;340563
24;2020-S32;10;10;20;172509;158177;69;330686
24;2020-S32;4;6;10;129428;110593;79;240021
24;2020-S32;1;2;3;87342;56882;89;144224
24;2020-S32;0;0;0;31210;12071;90;43281
24;2020-S32;155;114;269;1320165;1238908;0;2559073
27;2020-S32;0;7;7;143373;149679;09;293052
27;2020-S32;6;6;12;160962;173003;19;333965
27;2020-S32;24;29;53;133746;142254;29;276000
27;2020-S32;15;19;34;160004;155407;39;315411
27;2020-S32;8;10;18;172333;169564;49;341897
27;2020-S32;7;6;13;189979;183788;59;373767
27;2020-S32;8;8;16;192591;178206;69;370797
27;2020-S32;3;5;8;146876;127546;79;274422
27;2020-S32;4;2;6;96896;61575;89;158471
27;2020-S32;2;0;2;33148;12109;90;45257
27;2020-S32;77;92;169;1429908;1353131;0;2783039
28;2020-S32;8;8;17;180735;186856;09;367591
28;2020-S32;21;9;30;200125;213621;19;413746
28;2020-S32;23;24;47;168922;173007;29;341929
28;2020-S32;17;18;35;196628;188487;39;385115
28;2020-S32;12;17;29;205396;201699;49;407095
28;2020-S32;14;5;19;222002;213866;59;435868
28;2020-S32;9;7;16;224688;203758;69;428446
28;2020-S32;5;4;9;163192;135543;79;298735
28;2020-S32;2;0;2;109691;65377;89;175068
28;2020-S32;3;1;4;37222;12685;90;49907
28;2020-S32;114;93;212;1708601;1594899;0;3303500
32;2020-S32;38;27;66;358062;373689;09;731751
32;2020-S32;64;58;122;387045;406742;19;793787
32;2020-S32;117;81;199;342304;348587;29;690891
32;2020-S32;79;77;157;382485;369972;39;752457
32;2020-S32;69;55;125;382510;376716;49;759226
32;2020-S32;44;45;89;386937;376527;59;763464
32;2020-S32;36;21;57;371211;330938;69;702149
32;2020-S32;20;35;55;250542;201459;79;452001
32;2020-S32;20;13;33;163399;89786;89;253185
32;2020-S32;8;4;12;48384;15367;90;63751
32;2020-S32;495;416;915;3072879;2889783;0;5962662
44;2020-S32;13;12;25;291525;306839;09;598364
44;2020-S32;29;26;56;320255;339504;19;659759
44;2020-S32;73;76;149;302020;314428;29;616448
44;2020-S32;50;47;97;342222;333292;39;675514
44;2020-S32;24;32;56;349727;344491;49;694218
44;2020-S32;35;23;58;381371;373239;59;754610
44;2020-S32;19;12;31;367165;335850;69;703015
44;2020-S32;10;19;29;250387;215436;79;465823
44;2020-S32;17;5;22;170825;105192;89;276017
44;2020-S32;16;9;25;51248;16731;90;67979
44;2020-S32;286;261;549;2826745;2685002;0;5511747
52;2020-S32;10;20;32;213594;223900;09;437494
52;2020-S32;46;26;73;240818;255197;19;496015
52;2020-S32;77;60;137;197010;200630;29;397640
52;2020-S32;58;52;110;231204;224885;39;456089
52;2020-S32;23;32;55;243874;243418;49;487292
52;2020-S32;28;27;55;244100;239116;59;483216
52;2020-S32;16;12;28;241796;221345;69;463141
52;2020-S32;16;10;26;177805;149903;79;327708
52;2020-S32;11;13;24;119561;75822;89;195383
52;2020-S32;5;7;12;42559;15260;90;57819
52;2020-S32;290;260;553;1952321;1849476;0;3801797
53;2020-S32;13;22;35;173813;182358;09;356171
53;2020-S32;22;27;49;202720;214740;19;417460
53;2020-S32;46;60;106;163116;173196;29;336312
53;2020-S32;28;32;60;190526;187674;39;378200
53;2020-S32;28;25;53;212098;212015;49;424113
53;2020-S32;17;27;44;223699;219176;59;442875
53;2020-S32;16;12;28;227435;209274;69;436709
53;2020-S32;4;6;10;169992;140910;79;310902
53;2020-S32;8;7;15;118117;69883;89;188000
53;2020-S32;2;0;2;37370;12267;90;49637
53;2020-S32;185;218;403;1718886;1621493;0;3340379
75;2020-S32;5;4;10;293104;305291;09;598395
75;2020-S32;14;12;26;337141;357785;19;694926
75;2020-S32;53;54;107;295024;300618;29;595642
75;2020-S32;18;31;49;347871;331233;39;679104
75;2020-S32;20;12;32;384742;372771;49;757513
75;2020-S32;12;7;19;413361;390880;59;804241
75;2020-S32;13;10;23;425623;384060;69;809683
75;2020-S32;11;4;15;325086;276298;79;601384
75;2020-S32;2;7;9;213986;139308;89;353294
75;2020-S32;0;0;0;77600;28200;90;105800
75;2020-S32;148;141;290;3113538;2886444;0;5999982
76;2020-S32;20;11;32;305956;318589;09;624545
76;2020-S32;54;61;115;338942;356969;19;695911
76;2020-S32;138;143;281;316210;319570;29;635780
76;2020-S32;61;72;133;356758;337587;39;694345
76;2020-S32;60;49;109;376541;363812;49;740353
76;2020-S32;43;38;81;402608;383750;59;786358
76;2020-S32;29;27;56;394889;358997;69;753886
76;2020-S32;15;20;35;308664;263806;79;572470
76;2020-S32;11;7;18;195838;129272;89;325110
76;2020-S32;1;0;1;69372;26728;90;96100
76;2020-S32;433;429;863;3065778;2859080;0;5924858
84;2020-S32;20;20;40;459549;481088;09;940637
84;2020-S32;51;46;97;487711;511905;19;999616
84;2020-S32;122;116;238;443824;451094;29;894918
84;2020-S32;66;76;142;512522;493262;39;1005784
84;2020-S32;53;59;112;520248;515106;49;1035354
84;2020-S32;45;26;71;529611;514848;59;1044459
84;2020-S32;31;24;55;486720;439940;69;926660
84;2020-S32;12;15;27;372151;315211;79;687362
84;2020-S32;8;15;23;237198;150524;89;387722
84;2020-S32;11;5;16;81185;28680;90;109865
84;2020-S32;419;402;821;4130719;3901658;0;8032377
93;2020-S32;26;17;43;268834;283093;09;551927
93;2020-S32;95;72;168;280751;296087;19;576838
93;2020-S32;255;279;534;254404;255552;29;509956
93;2020-S32;130;180;310;310704;288398;39;599102
93;2020-S32;114;110;226;325559;305827;49;631386
93;2020-S32;91;102;193;353104;325389;59;678493
93;2020-S32;52;57;109;336327;296459;69;632786
93;2020-S32;30;40;70;279820;229699;79;509519
93;2020-S32;25;19;44;171274;113716;89;284990
93;2020-S32;11;4;15;58896;21758;90;80654
93;2020-S32;829;880;1712;2639673;2415978;0;5055651
94;2020-S32;1;1;2;16311;17433;09;33744
94;2020-S32;1;0;1;16679;18132;19;34811
94;2020-S32;2;7;9;16782;16579;29;33361
94;2020-S32;0;0;0;23044;20580;39;43624
94;2020-S32;2;0;2;23065;22140;49;45205
94;2020-S32;1;1;2;24549;23421;59;47970
94;2020-S32;0;1;1;23212;21883;69;45095
94;2020-S32;0;0;0;19544;17141;79;36685
94;2020-S32;0;0;0;11227;8178;89;19405
94;2020-S32;1;1;2;3332;1447;90;4779
94;2020-S32;8;11;19;177745;166934;0;344679
01;2020-S33;2;5;7;19979;20155;09;40134
01;2020-S33;8;6;14;24994;25489;19;50483
01;2020-S33;29;23;52;17868;16690;29;34558
01;2020-S33;25;21;46;22328;14821;39;37149
01;2020-S33;11;10;21;28652;20276;49;48928
01;2020-S33;8;7;15;33264;27260;59;60524
01;2020-S33;8;8;16;27135;23978;69;51113
01;2020-S33;3;2;5;18401;14661;79;33062
01;2020-S33;1;0;1;9633;6375;89;16008
01;2020-S33;1;0;1;3410;1510;90;4920
01;2020-S33;96;82;179;205664;171215;0;376879
02;2020-S33;2;3;5;16881;17110;09;33991
02;2020-S33;6;2;8;21410;21604;19;43014
02;2020-S33;17;15;32;16017;15479;29;31496
02;2020-S33;5;16;21;19825;14455;39;34280
02;2020-S33;11;11;22;24719;18248;49;42967
02;2020-S33;8;13;21;34361;28310;59;62671
02;2020-S33;4;6;10;28061;24495;69;52556
02;2020-S33;2;0;3;18231;15278;79;33509
02;2020-S33;2;1;3;11090;7677;89;18767
02;2020-S33;0;0;0;3992;1506;90;5498
02;2020-S33;57;67;125;194587;164162;0;358749
03;2020-S33;25;18;44;31123;30920;09;62043
03;2020-S33;22;19;41;29370;29268;19;58638
03;2020-S33;45;26;72;21458;18963;29;40421
03;2020-S33;30;18;48;21276;18326;39;39602
03;2020-S33;26;26;53;18164;16593;49;34757
03;2020-S33;11;10;21;13469;13557;59;27026
03;2020-S33;7;8;15;8776;8670;69;17446
03;2020-S33;3;5;8;3777;3591;79;7368
03;2020-S33;1;1;2;1649;1072;89;2721
03;2020-S33;0;0;0;485;184;90;669
03;2020-S33;170;131;304;149547;141144;0;290691
04;2020-S33;9;3;12;60314;61377;09;121691
04;2020-S33;35;19;54;66065;68387;19;134452
04;2020-S33;27;13;40;51059;47156;29;98215
04;2020-S33;20;6;26;58788;45780;39;104568
04;2020-S33;25;17;42;61408;52207;49;113615
04;2020-S33;14;16;30;64838;60759;59;125597
04;2020-S33;6;6;12;47008;42843;69;89851
04;2020-S33;2;6;8;25509;21184;79;46693
04;2020-S33;1;4;5;13168;7647;89;20815
04;2020-S33;0;1;1;3209;1253;90;4462
04;2020-S33;139;91;230;451366;408593;0;859959
05;2020-S33;0;0;0;362.366008612902;341.338819562748;09;703.704828175651
05;2020-S33;0;0;0;353.376145114279;370.349735405642;19;723.725880519921
05;2020-S33;0;0;0;218.593559489256;256.539602589476;29;475.133162078732
05;2020-S33;0;0;0;404.225408693299;360.321910454353;39;764.547319147651
05;2020-S33;0;0;0;520.067953604221;497.108383964256;49;1017.17633756848
05;2020-S33;0;0;0;468.146063921917;510.087601910415;59;978.233665832332
05;2020-S33;0;0;0;340.368470050554;334.366842191253;69;674.735312241807
05;2020-S33;0;0;0;212.598666888387;192.597753227106;79;405.196420115493
05;2020-S33;0;0;0;148.727797095705;61.8681715431829;89;210.595968638888
05;2020-S33;0;0;0;32.9601271090696;10.9909785719784;90;43.9511056810479
05;2020-S33;0;0;0;3061.43020057959;2935.56979942041;0;5997
06;2020-S33;0;1;1;42583;42380;09;84963
06;2020-S33;8;9;17;33369;31925;19;65294
06;2020-S33;8;14;22;21571;15080;29;36651
06;2020-S33;8;9;17;21550;16147;39;37697
06;2020-S33;3;12;15;14193;13939;49;28132
06;2020-S33;1;4;5;7171;7597;59;14768
06;2020-S33;2;3;5;3629;4117;69;7746
06;2020-S33;0;0;0;1577;1457;79;3034
06;2020-S33;0;1;1;531;474;89;1005
06;2020-S33;0;0;0;88;93;90;181
06;2020-S33;30;53;83;146262;133209;0;279471
07;2020-S33;0;0;0;485;549;09;1034
07;2020-S33;0;1;1;403;432;19;835
07;2020-S33;0;0;0;764;841;29;1605
07;2020-S33;0;0;0;824;928;39;1752
07;2020-S33;0;0;0;788;1020;49;1808
07;2020-S33;0;0;0;678;870;59;1548
07;2020-S33;0;0;0;360;382;69;742
07;2020-S33;0;0;0;231;190;79;421
07;2020-S33;0;0;0;114;67;89;181
07;2020-S33;0;0;0;24;11;90;35
07;2020-S33;0;1;1;4671;5290;0;9961
08;2020-S33;0;0;0;2715.22592983026;2997.75551488675;09;5712.98144471701
08;2020-S33;0;1;1;2778.51901080978;3160.9156459093;19;5939.43465671908
08;2020-S33;3;1;4;2080.8882988764;1718.16634315323;29;3799.05464202964
08;2020-S33;4;2;6;2701.8582062647;1896.52641413317;39;4598.38462039786
08;2020-S33;2;2;4;3151.45861023308;2460.52498233809;49;5611.98359257117
08;2020-S33;1;1;2;2620.29868333099;2422.23566154656;59;5042.53434487755
08;2020-S33;7;12;19;1621.44173420671;1438.58325779464;69;3060.02499200135
08;2020-S33;1;1;2;626.575909335673;526.358467843651;79;1152.93437717932
08;2020-S33;0;0;0;205.018522985054;140.993639349697;89;346.012162334751
08;2020-S33;0;0;0;50.0325684687745;20.62259870351;90;70.6551671722846
08;2020-S33;18;20;38;18551.3174743414;16782.6825256586;0;35334
11;2020-S33;66;91;162;783071;811785;09;1594856
11;2020-S33;271;240;514;761456;784653;19;1546109
11;2020-S33;908;964;1872;850145;801772;29;1651917
11;2020-S33;491;642;1133;914360;843488;39;1757848
11;2020-S33;326;383;709;845609;826202;49;1671811
11;2020-S33;267;278;545;793566;745070;59;1538636
11;2020-S33;171;156;327;628649;549192;69;1177841
11;2020-S33;89;108;197;434606;358356;79;792962
11;2020-S33;54;33;87;261425;162933;89;424358
11;2020-S33;21;9;30;89253;32619;90;121872
11;2020-S33;2665;2905;5587;6362140;5916070;0;12278210
24;2020-S33;17;12;29;139720;144686;09;284406
24;2020-S33;51;29;80;152979;161185;19;314164
24;2020-S33;57;62;119;122237;126536;29;248773
24;2020-S33;48;38;86;150359;142009;39;292368
24;2020-S33;37;28;65;161829;158758;49;320587
24;2020-S33;27;30;57;172552;168011;59;340563
24;2020-S33;19;7;26;172509;158177;69;330686
24;2020-S33;9;12;21;129428;110593;79;240021
24;2020-S33;8;6;14;87342;56882;89;144224
24;2020-S33;7;1;8;31210;12071;90;43281
24;2020-S33;280;225;505;1320165;1238908;0;2559073
27;2020-S33;7;3;10;143373;149679;09;293052
27;2020-S33;22;14;36;160962;173003;19;333965
27;2020-S33;37;41;78;133746;142254;29;276000
27;2020-S33;25;22;47;160004;155407;39;315411
27;2020-S33;17;10;27;172333;169564;49;341897
27;2020-S33;16;19;35;189979;183788;59;373767
27;2020-S33;8;12;20;192591;178206;69;370797
27;2020-S33;8;2;10;146876;127546;79;274422
27;2020-S33;2;5;7;96896;61575;89;158471
27;2020-S33;0;2;2;33148;12109;90;45257
27;2020-S33;142;130;272;1429908;1353131;0;2783039
28;2020-S33;1;12;13;180735;186856;09;367591
28;2020-S33;15;16;31;200125;213621;19;413746
28;2020-S33;49;46;95;168922;173007;29;341929
28;2020-S33;19;24;43;196628;188487;39;385115
28;2020-S33;20;20;40;205396;201699;49;407095
28;2020-S33;16;10;26;222002;213866;59;435868
28;2020-S33;12;9;21;224688;203758;69;428446
28;2020-S33;6;3;9;163192;135543;79;298735
28;2020-S33;9;9;18;109691;65377;89;175068
28;2020-S33;10;4;14;37222;12685;90;49907
28;2020-S33;157;153;310;1708601;1594899;0;3303500
32;2020-S33;27;19;46;358062;373689;09;731751
32;2020-S33;68;69;140;387045;406742;19;793787
32;2020-S33;121;136;258;342304;348587;29;690891
32;2020-S33;83;77;160;382485;369972;39;752457
32;2020-S33;73;59;132;382510;376716;49;759226
32;2020-S33;52;62;114;386937;376527;59;763464
32;2020-S33;30;30;60;371211;330938;69;702149
32;2020-S33;29;27;56;250542;201459;79;452001
32;2020-S33;21;17;38;163399;89786;89;253185
32;2020-S33;6;1;7;48384;15367;90;63751
32;2020-S33;510;497;1011;3072879;2889783;0;5962662
44;2020-S33;11;13;24;291525;306839;09;598364
44;2020-S33;43;39;82;320255;339504;19;659759
44;2020-S33;88;96;184;302020;314428;29;616448
44;2020-S33;61;57;118;342222;333292;39;675514
44;2020-S33;39;49;88;349727;344491;49;694218
44;2020-S33;28;38;66;381371;373239;59;754610
44;2020-S33;17;14;31;367165;335850;69;703015
44;2020-S33;21;21;42;250387;215436;79;465823
44;2020-S33;18;12;30;170825;105192;89;276017
44;2020-S33;7;7;14;51248;16731;90;67979
44;2020-S33;333;346;679;2826745;2685002;0;5511747
52;2020-S33;31;29;61;213594;223900;09;437494
52;2020-S33;50;58;111;240818;255197;19;496015
52;2020-S33;91;83;174;197010;200630;29;397640
52;2020-S33;63;68;131;231204;224885;39;456089
52;2020-S33;62;46;108;243874;243418;49;487292
52;2020-S33;48;52;100;244100;239116;59;483216
52;2020-S33;25;31;56;241796;221345;69;463141
52;2020-S33;14;17;31;177805;149903;79;327708
52;2020-S33;16;8;24;119561;75822;89;195383
52;2020-S33;10;1;11;42559;15260;90;57819
52;2020-S33;410;393;807;1952321;1849476;0;3801797
53;2020-S33;5;7;12;173813;182358;09;356171
53;2020-S33;14;16;31;202720;214740;19;417460
53;2020-S33;43;72;115;163116;173196;29;336312
53;2020-S33;22;30;52;190526;187674;39;378200
53;2020-S33;26;29;55;212098;212015;49;424113
53;2020-S33;22;29;51;223699;219176;59;442875
53;2020-S33;8;9;17;227435;209274;69;436709
53;2020-S33;7;8;15;169992;140910;79;310902
53;2020-S33;2;2;4;118117;69883;89;188000
53;2020-S33;4;1;5;37370;12267;90;49637
53;2020-S33;153;203;357;1718886;1621493;0;3340379
75;2020-S33;9;5;14;293104;305291;09;598395
75;2020-S33;78;35;113;337141;357785;19;694926
75;2020-S33;89;106;195;295024;300618;29;595642
75;2020-S33;40;67;107;347871;331233;39;679104
75;2020-S33;50;39;89;384742;372771;49;757513
75;2020-S33;44;39;83;413361;390880;59;804241
75;2020-S33;16;15;31;425623;384060;69;809683
75;2020-S33;7;15;22;325086;276298;79;601384
75;2020-S33;4;5;9;213986;139308;89;353294
75;2020-S33;2;2;4;77600;28200;90;105800
75;2020-S33;339;328;667;3113538;2886444;0;5999982
76;2020-S33;22;20;42;305956;318589;09;624545
76;2020-S33;83;83;167;338942;356969;19;695911
76;2020-S33;243;231;474;316210;319570;29;635780
76;2020-S33;125;143;268;356758;337587;39;694345
76;2020-S33;121;118;239;376541;363812;49;740353
76;2020-S33;88;84;172;402608;383750;59;786358
76;2020-S33;45;42;87;394889;358997;69;753886
76;2020-S33;25;22;47;308664;263806;79;572470
76;2020-S33;9;9;18;195838;129272;89;325110
76;2020-S33;6;0;6;69372;26728;90;96100
76;2020-S33;767;752;1520;3065778;2859080;0;5924858
84;2020-S33;28;21;49;459549;481088;09;940637
84;2020-S33;93;71;164;487711;511905;19;999616
84;2020-S33;187;223;410;443824;451094;29;894918
84;2020-S33;105;116;221;512522;493262;39;1005784
84;2020-S33;78;75;153;520248;515106;49;1035354
84;2020-S33;69;57;126;529611;514848;59;1044459
84;2020-S33;42;37;79;486720;439940;69;926660
84;2020-S33;24;35;59;372151;315211;79;687362
84;2020-S33;11;16;27;237198;150524;89;387722
84;2020-S33;4;1;5;81185;28680;90;109865
84;2020-S33;641;652;1293;4130719;3901658;0;8032377
93;2020-S33;36;26;62;268834;283093;09;551927
93;2020-S33;159;124;284;280751;296087;19;576838
93;2020-S33;500;486;987;254404;255552;29;509956
93;2020-S33;228;302;530;310704;288398;39;599102
93;2020-S33;179;194;374;325559;305827;49;631386
93;2020-S33;167;196;363;353104;325389;59;678493
93;2020-S33;102;102;204;336327;296459;69;632786
93;2020-S33;47;49;96;279820;229699;79;509519
93;2020-S33;40;26;66;171274;113716;89;284990
93;2020-S33;29;5;34;58896;21758;90;80654
93;2020-S33;1487;1510;3000;2639673;2415978;0;5055651
94;2020-S33;0;0;0;16311;17433;09;33744
94;2020-S33;2;0;2;16679;18132;19;34811
94;2020-S33;3;3;6;16782;16579;29;33361
94;2020-S33;1;0;1;23044;20580;39;43624
94;2020-S33;1;2;3;23065;22140;49;45205
94;2020-S33;0;2;2;24549;23421;59;47970
94;2020-S33;0;0;0;23212;21883;69;45095
94;2020-S33;1;1;2;19544;17141;79;36685
94;2020-S33;0;0;0;11227;8178;89;19405
94;2020-S33;0;0;0;3332;1447;90;4779
94;2020-S33;8;8;16;177745;166934;0;344679
01;2020-S34;2;3;5;19979;20155;09;40134
01;2020-S34;20;8;28;24994;25489;19;50483
01;2020-S34;72;52;124;17868;16690;29;34558
01;2020-S34;43;40;83;22328;14821;39;37149
01;2020-S34;14;16;30;28652;20276;49;48928
01;2020-S34;21;14;35;33264;27260;59;60524
01;2020-S34;8;9;17;27135;23978;69;51113
01;2020-S34;4;5;9;18401;14661;79;33062
01;2020-S34;1;2;3;9633;6375;89;16008
01;2020-S34;0;0;0;3410;1510;90;4920
01;2020-S34;185;149;334;205664;171215;0;376879
02;2020-S34;4;0;4;16881;17110;09;33991
02;2020-S34;11;7;18;21410;21604;19;43014
02;2020-S34;23;10;34;16017;15479;29;31496
02;2020-S34;25;17;42;19825;14455;39;34280
02;2020-S34;11;10;21;24719;18248;49;42967
02;2020-S34;14;17;31;34361;28310;59;62671
02;2020-S34;9;4;14;28061;24495;69;52556
02;2020-S34;2;2;4;18231;15278;79;33509
02;2020-S34;2;2;6;11090;7677;89;18767
02;2020-S34;1;0;1;3992;1506;90;5498
02;2020-S34;102;69;175;194587;164162;0;358749
03;2020-S34;7;9;16;31123;30920;09;62043
03;2020-S34;21;24;46;29370;29268;19;58638
03;2020-S34;35;22;58;21458;18963;29;40421
03;2020-S34;26;15;41;21276;18326;39;39602
03;2020-S34;23;15;38;18164;16593;49;34757
03;2020-S34;13;17;30;13469;13557;59;27026
03;2020-S34;12;8;20;8776;8670;69;17446
03;2020-S34;1;3;4;3777;3591;79;7368
03;2020-S34;2;2;4;1649;1072;89;2721
03;2020-S34;0;0;0;485;184;90;669
03;2020-S34;140;115;257;149547;141144;0;290691
04;2020-S34;12;15;27;60314;61377;09;121691
04;2020-S34;48;40;88;66065;68387;19;134452
04;2020-S34;41;24;65;51059;47156;29;98215
04;2020-S34;33;25;58;58788;45780;39;104568
04;2020-S34;27;20;47;61408;52207;49;113615
04;2020-S34;17;19;36;64838;60759;59;125597
04;2020-S34;18;18;36;47008;42843;69;89851
04;2020-S34;5;7;12;25509;21184;79;46693
04;2020-S34;3;3;6;13168;7647;89;20815
04;2020-S34;1;0;1;3209;1253;90;4462
04;2020-S34;205;171;376;451366;408593;0;859959
05;2020-S34;0;0;0;362.366008612902;341.338819562748;09;703.704828175651
05;2020-S34;0;0;0;353.376145114279;370.349735405642;19;723.725880519921
05;2020-S34;0;0;0;218.593559489256;256.539602589476;29;475.133162078732
05;2020-S34;0;0;0;404.225408693299;360.321910454353;39;764.547319147651
05;2020-S34;0;0;0;520.067953604221;497.108383964256;49;1017.17633756848
05;2020-S34;0;0;0;468.146063921917;510.087601910415;59;978.233665832332
05;2020-S34;0;0;0;340.368470050554;334.366842191253;69;674.735312241807
05;2020-S34;0;0;0;212.598666888387;192.597753227106;79;405.196420115493
05;2020-S34;0;0;0;148.727797095705;61.8681715431829;89;210.595968638888
05;2020-S34;0;0;0;32.9601271090696;10.9909785719784;90;43.9511056810479
05;2020-S34;0;0;0;3061.43020057959;2935.56979942041;0;5997
06;2020-S34;0;0;0;42583;42380;09;84963
06;2020-S34;6;10;17;33369;31925;19;65294
06;2020-S34;10;18;28;21571;15080;29;36651
06;2020-S34;4;10;14;21550;16147;39;37697
06;2020-S34;5;10;15;14193;13939;49;28132
06;2020-S34;2;2;4;7171;7597;59;14768
06;2020-S34;3;3;6;3629;4117;69;7746
06;2020-S34;0;0;0;1577;1457;79;3034
06;2020-S34;0;0;0;531;474;89;1005
06;2020-S34;0;0;0;88;93;90;181
06;2020-S34;30;53;84;146262;133209;0;279471
07;2020-S34;0;0;0;485;549;09;1034
07;2020-S34;0;0;0;403;432;19;835
07;2020-S34;0;0;0;764;841;29;1605
07;2020-S34;0;1;1;824;928;39;1752
07;2020-S34;0;0;0;788;1020;49;1808
07;2020-S34;0;0;0;678;870;59;1548
07;2020-S34;0;0;0;360;382;69;742
07;2020-S34;0;0;0;231;190;79;421
07;2020-S34;0;0;0;114;67;89;181
07;2020-S34;0;0;0;24;11;90;35
07;2020-S34;0;1;1;4671;5290;0;9961
08;2020-S34;2;0;2;2715.22592983026;2997.75551488675;09;5712.98144471701
08;2020-S34;4;1;5;2778.51901080978;3160.9156459093;19;5939.43465671908
08;2020-S34;3;6;9;2080.8882988764;1718.16634315323;29;3799.05464202964
08;2020-S34;5;5;10;2701.8582062647;1896.52641413317;39;4598.38462039786
08;2020-S34;2;6;8;3151.45861023308;2460.52498233809;49;5611.98359257117
08;2020-S34;8;2;10;2620.29868333099;2422.23566154656;59;5042.53434487755
08;2020-S34;5;3;8;1621.44173420671;1438.58325779464;69;3060.02499200135
08;2020-S34;1;2;3;626.575909335673;526.358467843651;79;1152.93437717932
08;2020-S34;0;1;1;205.018522985054;140.993639349697;89;346.012162334751
08;2020-S34;0;0;0;50.0325684687745;20.62259870351;90;70.6551671722846
08;2020-S34;30;26;56;18551.3174743414;16782.6825256586;0;35334
11;2020-S34;75;101;180;783071;811785;09;1594856
11;2020-S34;416;418;837;761456;784653;19;1546109
11;2020-S34;1471;1573;3046;850145;801772;29;1651917
11;2020-S34;741;930;1671;914360;843488;39;1757848
11;2020-S34;424;490;916;845609;826202;49;1671811
11;2020-S34;368;361;730;793566;745070;59;1538636
11;2020-S34;203;242;445;628649;549192;69;1177841
11;2020-S34;78;90;168;434606;358356;79;792962
11;2020-S34;59;52;111;261425;162933;89;424358
11;2020-S34;38;11;49;89253;32619;90;121872
11;2020-S34;3873;4269;8160;6362140;5916070;0;12278210
24;2020-S34;17;10;27;139720;144686;09;284406
24;2020-S34;54;45;99;152979;161185;19;314164
24;2020-S34;101;121;222;122237;126536;29;248773
24;2020-S34;54;57;111;150359;142009;39;292368
24;2020-S34;49;43;92;161829;158758;49;320587
24;2020-S34;33;36;69;172552;168011;59;340563
24;2020-S34;29;19;48;172509;158177;69;330686
24;2020-S34;7;11;18;129428;110593;79;240021
24;2020-S34;8;6;14;87342;56882;89;144224
24;2020-S34;5;0;5;31210;12071;90;43281
24;2020-S34;357;348;705;1320165;1238908;0;2559073
27;2020-S34;6;12;18;143373;149679;09;293052
27;2020-S34;26;36;63;160962;173003;19;333965
27;2020-S34;78;141;219;133746;142254;29;276000
27;2020-S34;39;48;87;160004;155407;39;315411
27;2020-S34;37;38;75;172333;169564;49;341897
27;2020-S34;30;25;55;189979;183788;59;373767
27;2020-S34;14;25;39;192591;178206;69;370797
27;2020-S34;5;6;11;146876;127546;79;274422
27;2020-S34;3;4;7;96896;61575;89;158471
27;2020-S34;3;0;3;33148;12109;90;45257
27;2020-S34;242;337;580;1429908;1353131;0;2783039
28;2020-S34;16;8;27;180735;186856;09;367591
28;2020-S34;28;33;61;200125;213621;19;413746
28;2020-S34;72;80;153;168922;173007;29;341929
28;2020-S34;33;35;68;196628;188487;39;385115
28;2020-S34;31;38;69;205396;201699;49;407095
28;2020-S34;19;19;38;222002;213866;59;435868
28;2020-S34;19;18;37;224688;203758;69;428446
28;2020-S34;9;12;21;163192;135543;79;298735
28;2020-S34;7;5;12;109691;65377;89;175068
28;2020-S34;6;2;8;37222;12685;90;49907
28;2020-S34;240;250;494;1708601;1594899;0;3303500
32;2020-S34;35;26;62;358062;373689;09;731751
32;2020-S34;65;65;130;387045;406742;19;793787
32;2020-S34;162;207;369;342304;348587;29;690891
32;2020-S34;101;111;213;382485;369972;39;752457
32;2020-S34;81;90;171;382510;376716;49;759226
32;2020-S34;59;69;128;386937;376527;59;763464
32;2020-S34;40;44;85;371211;330938;69;702149
32;2020-S34;26;27;53;250542;201459;79;452001
32;2020-S34;12;11;23;163399;89786;89;253185
32;2020-S34;6;3;9;48384;15367;90;63751
32;2020-S34;587;653;1244;3072879;2889783;0;5962662
44;2020-S34;29;17;47;291525;306839;09;598364
44;2020-S34;66;66;133;320255;339504;19;659759
44;2020-S34;155;198;353;302020;314428;29;616448
44;2020-S34;87;106;193;342222;333292;39;675514
44;2020-S34;69;70;139;349727;344491;49;694218
44;2020-S34;54;57;111;381371;373239;59;754610
44;2020-S34;28;24;52;367165;335850;69;703015
44;2020-S34;15;18;33;250387;215436;79;465823
44;2020-S34;10;4;14;170825;105192;89;276017
44;2020-S34;5;0;5;51248;16731;90;67979
44;2020-S34;518;560;1080;2826745;2685002;0;5511747
52;2020-S34;24;15;39;213594;223900;09;437494
52;2020-S34;59;77;136;240818;255197;19;496015
52;2020-S34;133;158;291;197010;200630;29;397640
52;2020-S34;76;93;170;231204;224885;39;456089
52;2020-S34;88;71;159;243874;243418;49;487292
52;2020-S34;62;50;112;244100;239116;59;483216
52;2020-S34;34;30;64;241796;221345;69;463141
52;2020-S34;12;22;34;177805;149903;79;327708
52;2020-S34;7;12;19;119561;75822;89;195383
52;2020-S34;6;0;6;42559;15260;90;57819
52;2020-S34;501;529;1031;1952321;1849476;0;3801797
53;2020-S34;17;7;24;173813;182358;09;356171
53;2020-S34;41;33;75;202720;214740;19;417460
53;2020-S34;89;111;202;163116;173196;29;336312
53;2020-S34;39;47;86;190526;187674;39;378200
53;2020-S34;38;35;73;212098;212015;49;424113
53;2020-S34;33;31;64;223699;219176;59;442875
53;2020-S34;19;15;34;227435;209274;69;436709
53;2020-S34;6;9;15;169992;140910;79;310902
53;2020-S34;4;3;7;118117;69883;89;188000
53;2020-S34;2;2;4;37370;12267;90;49637
53;2020-S34;288;293;584;1718886;1621493;0;3340379
75;2020-S34;25;35;62;293104;305291;09;598395
75;2020-S34;148;120;270;337141;357785;19;694926
75;2020-S34;331;395;726;295024;300618;29;595642
75;2020-S34;131;126;257;347871;331233;39;679104
75;2020-S34;99;99;198;384742;372771;49;757513
75;2020-S34;118;99;217;413361;390880;59;804241
75;2020-S34;51;51;102;425623;384060;69;809683
75;2020-S34;24;19;43;325086;276298;79;601384
75;2020-S34;19;4;23;213986;139308;89;353294
75;2020-S34;6;4;10;77600;28200;90;105800
75;2020-S34;954;952;1910;3113538;2886444;0;5999982
76;2020-S34;28;36;66;305956;318589;09;624545
76;2020-S34;148;121;270;338942;356969;19;695911
76;2020-S34;411;420;832;316210;319570;29;635780
76;2020-S34;246;261;508;356758;337587;39;694345
76;2020-S34;166;201;367;376541;363812;49;740353
76;2020-S34;164;165;329;402608;383750;59;786358
76;2020-S34;91;101;192;394889;358997;69;753886
76;2020-S34;37;61;98;308664;263806;79;572470
76;2020-S34;29;16;45;195838;129272;89;325110
76;2020-S34;13;3;16;69372;26728;90;96100
76;2020-S34;1334;1385;2724;3065778;2859080;0;5924858
84;2020-S34;43;48;91;459549;481088;09;940637
84;2020-S34;160;151;311;487711;511905;19;999616
84;2020-S34;442;523;965;443824;451094;29;894918
84;2020-S34;222;247;469;512522;493262;39;1005784
84;2020-S34;161;180;341;520248;515106;49;1035354
84;2020-S34;141;135;276;529611;514848;59;1044459
84;2020-S34;71;58;130;486720;439940;69;926660
84;2020-S34;38;31;69;372151;315211;79;687362
84;2020-S34;19;10;29;237198;150524;89;387722
84;2020-S34;10;6;16;81185;28680;90;109865
84;2020-S34;1307;1389;2697;4130719;3901658;0;8032377
93;2020-S34;70;53;124;268834;283093;09;551927
93;2020-S34;272;194;467;280751;296087;19;576838
93;2020-S34;834;874;1710;254404;255552;29;509956
93;2020-S34;407;523;930;310704;288398;39;599102
93;2020-S34;341;343;684;325559;305827;49;631386
93;2020-S34;289;283;573;353104;325389;59;678493
93;2020-S34;163;183;346;336327;296459;69;632786
93;2020-S34;80;90;170;279820;229699;79;509519
93;2020-S34;54;53;107;171274;113716;89;284990
93;2020-S34;36;11;47;58896;21758;90;80654
93;2020-S34;2547;2607;5160;2639673;2415978;0;5055651
94;2020-S34;1;1;2;16311;17433;09;33744
94;2020-S34;1;2;3;16679;18132;19;34811
94;2020-S34;4;5;9;16782;16579;29;33361
94;2020-S34;5;5;10;23044;20580;39;43624
94;2020-S34;4;2;6;23065;22140;49;45205
94;2020-S34;2;2;4;24549;23421;59;47970
94;2020-S34;2;1;3;23212;21883;69;45095
94;2020-S34;1;1;2;19544;17141;79;36685
94;2020-S34;0;1;1;11227;8178;89;19405
94;2020-S34;0;0;0;3332;1447;90;4779
94;2020-S34;20;20;40;177745;166934;0;344679
01;2020-S35;4;6;10;19979;20155;09;40134
01;2020-S35;27;16;43;24994;25489;19;50483
01;2020-S35;67;69;136;17868;16690;29;34558
01;2020-S35;73;64;137;22328;14821;39;37149
01;2020-S35;72;53;125;28652;20276;49;48928
01;2020-S35;61;56;117;33264;27260;59;60524
01;2020-S35;26;28;54;27135;23978;69;51113
01;2020-S35;10;15;25;18401;14661;79;33062
01;2020-S35;5;2;7;9633;6375;89;16008
01;2020-S35;0;0;0;3410;1510;90;4920
01;2020-S35;345;309;654;205664;171215;0;376879
02;2020-S35;2;2;4;16881;17110;09;33991
02;2020-S35;11;4;15;21410;21604;19;43014
02;2020-S35;19;13;32;16017;15479;29;31496
02;2020-S35;16;7;24;19825;14455;39;34280
02;2020-S35;7;9;16;24719;18248;49;42967
02;2020-S35;12;11;23;34361;28310;59;62671
02;2020-S35;4;4;8;28061;24495;69;52556
02;2020-S35;2;0;3;18231;15278;79;33509
02;2020-S35;3;2;7;11090;7677;89;18767
02;2020-S35;0;0;0;3992;1506;90;5498
02;2020-S35;76;52;132;194587;164162;0;358749
03;2020-S35;6;3;10;31123;30920;09;62043
03;2020-S35;18;23;41;29370;29268;19;58638
03;2020-S35;32;29;61;21458;18963;29;40421
03;2020-S35;33;12;46;21276;18326;39;39602
03;2020-S35;17;12;29;18164;16593;49;34757
03;2020-S35;10;16;26;13469;13557;59;27026
03;2020-S35;7;8;15;8776;8670;69;17446
03;2020-S35;4;5;9;3777;3591;79;7368
03;2020-S35;0;3;3;1649;1072;89;2721
03;2020-S35;1;0;1;485;184;90;669
03;2020-S35;128;111;241;149547;141144;0;290691
04;2020-S35;29;19;48;60314;61377;09;121691
04;2020-S35;53;43;96;66065;68387;19;134452
04;2020-S35;46;25;71;51059;47156;29;98215
04;2020-S35;49;20;69;58788;45780;39;104568
04;2020-S35;31;27;58;61408;52207;49;113615
04;2020-S35;26;29;55;64838;60759;59;125597
04;2020-S35;21;25;46;47008;42843;69;89851
04;2020-S35;9;8;17;25509;21184;79;46693
04;2020-S35;5;0;5;13168;7647;89;20815
04;2020-S35;0;0;0;3209;1253;90;4462
04;2020-S35;269;196;465;451366;408593;0;859959
05;2020-S35;0;0;0;362.366008612902;341.338819562748;09;703.704828175651
05;2020-S35;0;0;0;353.376145114279;370.349735405642;19;723.725880519921
05;2020-S35;0;0;0;218.593559489256;256.539602589476;29;475.133162078732
05;2020-S35;0;1;1;404.225408693299;360.321910454353;39;764.547319147651
05;2020-S35;0;0;0;520.067953604221;497.108383964256;49;1017.17633756848
05;2020-S35;0;0;0;468.146063921917;510.087601910415;59;978.233665832332
05;2020-S35;0;0;0;340.368470050554;334.366842191253;69;674.735312241807
05;2020-S35;0;0;0;212.598666888387;192.597753227106;79;405.196420115493
05;2020-S35;0;0;0;148.727797095705;61.8681715431829;89;210.595968638888
05;2020-S35;0;0;0;32.9601271090696;10.9909785719784;90;43.9511056810479
05;2020-S35;0;1;1;3061.43020057959;2935.56979942041;0;5997
06;2020-S35;0;1;1;42583;42380;09;84963
06;2020-S35;6;6;12;33369;31925;19;65294
06;2020-S35;10;14;24;21571;15080;29;36651
06;2020-S35;5;10;15;21550;16147;39;37697
06;2020-S35;7;6;13;14193;13939;49;28132
06;2020-S35;4;6;10;7171;7597;59;14768
06;2020-S35;3;1;4;3629;4117;69;7746
06;2020-S35;0;0;0;1577;1457;79;3034
06;2020-S35;0;2;2;531;474;89;1005
06;2020-S35;1;0;1;88;93;90;181
06;2020-S35;36;46;82;146262;133209;0;279471
07;2020-S35;0;0;0;485;549;09;1034
07;2020-S35;0;1;1;403;432;19;835
07;2020-S35;0;1;1;764;841;29;1605
07;2020-S35;2;2;4;824;928;39;1752
07;2020-S35;0;0;0;788;1020;49;1808
07;2020-S35;0;0;0;678;870;59;1548
07;2020-S35;0;1;1;360;382;69;742
07;2020-S35;0;0;0;231;190;79;421
07;2020-S35;0;0;0;114;67;89;181
07;2020-S35;0;0;0;24;11;90;35
07;2020-S35;2;5;7;4671;5290;0;9961
08;2020-S35;0;0;0;2715.22592983026;2997.75551488675;09;5712.98144471701
08;2020-S35;0;3;3;2778.51901080978;3160.9156459093;19;5939.43465671908
08;2020-S35;2;1;3;2080.8882988764;1718.16634315323;29;3799.05464202964
08;2020-S35;7;1;8;2701.8582062647;1896.52641413317;39;4598.38462039786
08;2020-S35;6;3;9;3151.45861023308;2460.52498233809;49;5611.98359257117
08;2020-S35;2;6;8;2620.29868333099;2422.23566154656;59;5042.53434487755
08;2020-S35;3;4;7;1621.44173420671;1438.58325779464;69;3060.02499200135
08;2020-S35;1;5;6;626.575909335673;526.358467843651;79;1152.93437717932
08;2020-S35;1;0;1;205.018522985054;140.993639349697;89;346.012162334751
08;2020-S35;0;0;0;50.0325684687745;20.62259870351;90;70.6551671722846
08;2020-S35;22;23;45;18551.3174743414;16782.6825256586;0;35334
11;2020-S35;168;142;320;783071;811785;09;1594856
11;2020-S35;682;556;1249;761456;784653;19;1546109
11;2020-S35;2431;2307;4747;850145;801772;29;1651917
11;2020-S35;1143;1367;2517;914360;843488;39;1757848
11;2020-S35;710;681;1399;845609;826202;49;1671811
11;2020-S35;587;491;1082;793566;745070;59;1538636
11;2020-S35;341;339;681;628649;549192;69;1177841
11;2020-S35;119;144;264;434606;358356;79;792962
11;2020-S35;79;47;126;261425;162933;89;424358
11;2020-S35;49;11;60;89253;32619;90;121872
11;2020-S35;6311;6089;12468;6362140;5916070;0;12278210
24;2020-S35;20;20;41;139720;144686;09;284406
24;2020-S35;73;60;133;152979;161185;19;314164
24;2020-S35;143;164;308;122237;126536;29;248773
24;2020-S35;71;70;141;150359;142009;39;292368
24;2020-S35;42;43;85;161829;158758;49;320587
24;2020-S35;45;36;81;172552;168011;59;340563
24;2020-S35;29;31;60;172509;158177;69;330686
24;2020-S35;12;14;26;129428;110593;79;240021
24;2020-S35;9;3;12;87342;56882;89;144224
24;2020-S35;4;1;5;31210;12071;90;43281
24;2020-S35;449;442;893;1320165;1238908;0;2559073
27;2020-S35;17;16;33;143373;149679;09;293052
27;2020-S35;62;52;114;160962;173003;19;333965
27;2020-S35;144;147;291;133746;142254;29;276000
27;2020-S35;76;59;135;160004;155407;39;315411
27;2020-S35;71;60;131;172333;169564;49;341897
27;2020-S35;43;42;85;189979;183788;59;373767
27;2020-S35;23;29;52;192591;178206;69;370797
27;2020-S35;16;12;28;146876;127546;79;274422
27;2020-S35;15;11;26;96896;61575;89;158471
27;2020-S35;2;1;3;33148;12109;90;45257
27;2020-S35;470;430;900;1429908;1353131;0;2783039
28;2020-S35;34;21;57;180735;186856;09;367591
28;2020-S35;70;82;154;200125;213621;19;413746
28;2020-S35;159;168;328;168922;173007;29;341929
28;2020-S35;88;81;169;196628;188487;39;385115
28;2020-S35;66;66;132;205396;201699;49;407095
28;2020-S35;58;46;104;222002;213866;59;435868
28;2020-S35;31;27;58;224688;203758;69;428446
28;2020-S35;19;15;34;163192;135543;79;298735
28;2020-S35;11;9;20;109691;65377;89;175068
28;2020-S35;8;1;9;37222;12685;90;49907
28;2020-S35;544;516;1065;1708601;1594899;0;3303500
32;2020-S35;35;32;68;358062;373689;09;731751
32;2020-S35;110;150;262;387045;406742;19;793787
32;2020-S35;218;242;462;342304;348587;29;690891
32;2020-S35;133;157;291;382485;369972;39;752457
32;2020-S35;109;124;234;382510;376716;49;759226
32;2020-S35;96;87;185;386937;376527;59;763464
32;2020-S35;46;50;97;371211;330938;69;702149
32;2020-S35;29;34;63;250542;201459;79;452001
32;2020-S35;12;15;27;163399;89786;89;253185
32;2020-S35;5;2;7;48384;15367;90;63751
32;2020-S35;794;893;1697;3072879;2889783;0;5962662
44;2020-S35;34;42;79;291525;306839;09;598364
44;2020-S35;108;102;212;320255;339504;19;659759
44;2020-S35;226;226;452;302020;314428;29;616448
44;2020-S35;136;136;272;342222;333292;39;675514
44;2020-S35;105;100;205;349727;344491;49;694218
44;2020-S35;76;72;148;381371;373239;59;754610
44;2020-S35;46;47;93;367165;335850;69;703015
44;2020-S35;29;31;60;250387;215436;79;465823
44;2020-S35;15;12;27;170825;105192;89;276017
44;2020-S35;13;5;18;51248;16731;90;67979
44;2020-S35;789;774;1568;2826745;2685002;0;5511747
52;2020-S35;13;17;35;213594;223900;09;437494
52;2020-S35;76;91;171;240818;255197;19;496015
52;2020-S35;139;174;313;197010;200630;29;397640
52;2020-S35;69;95;164;231204;224885;39;456089
52;2020-S35;72;68;140;243874;243418;49;487292
52;2020-S35;61;57;118;244100;239116;59;483216
52;2020-S35;21;26;47;241796;221345;69;463141
52;2020-S35;18;19;37;177805;149903;79;327708
52;2020-S35;8;3;11;119561;75822;89;195383
52;2020-S35;3;1;4;42559;15260;90;57819
52;2020-S35;480;551;1040;1952321;1849476;0;3801797
53;2020-S35;14;9;23;173813;182358;09;356171
53;2020-S35;65;56;122;202720;214740;19;417460
53;2020-S35;123;177;302;163116;173196;29;336312
53;2020-S35;57;60;117;190526;187674;39;378200
53;2020-S35;33;34;67;212098;212015;49;424113
53;2020-S35;27;31;58;223699;219176;59;442875
53;2020-S35;16;22;38;227435;209274;69;436709
53;2020-S35;8;7;15;169992;140910;79;310902
53;2020-S35;8;6;14;118117;69883;89;188000
53;2020-S35;4;1;5;37370;12267;90;49637
53;2020-S35;355;403;761;1718886;1621493;0;3340379
75;2020-S35;47;45;94;293104;305291;09;598395
75;2020-S35;253;200;456;337141;357785;19;694926
75;2020-S35;587;678;1266;295024;300618;29;595642
75;2020-S35;217;278;495;347871;331233;39;679104
75;2020-S35;161;159;320;384742;372771;49;757513
75;2020-S35;137;135;272;413361;390880;59;804241
75;2020-S35;61;74;135;425623;384060;69;809683
75;2020-S35;41;31;72;325086;276298;79;601384
75;2020-S35;18;8;26;213986;139308;89;353294
75;2020-S35;4;2;6;77600;28200;90;105800
75;2020-S35;1526;1613;3145;3113538;2886444;0;5999982
76;2020-S35;38;48;88;305956;318589;09;624545
76;2020-S35;182;157;343;338942;356969;19;695911
76;2020-S35;460;509;970;316210;319570;29;635780
76;2020-S35;254;268;522;356758;337587;39;694345
76;2020-S35;222;208;430;376541;363812;49;740353
76;2020-S35;214;190;404;402608;383750;59;786358
76;2020-S35;97;105;202;394889;358997;69;753886
76;2020-S35;67;64;132;308664;263806;79;572470
76;2020-S35;43;18;61;195838;129272;89;325110
76;2020-S35;21;5;26;69372;26728;90;96100
76;2020-S35;1599;1572;3179;3065778;2859080;0;5924858
84;2020-S35;65;57;123;459549;481088;09;940637
84;2020-S35;219;238;457;487711;511905;19;999616
84;2020-S35;651;709;1360;443824;451094;29;894918
84;2020-S35;341;353;695;512522;493262;39;1005784
84;2020-S35;231;246;477;520248;515106;49;1035354
84;2020-S35;203;206;410;529611;514848;59;1044459
84;2020-S35;102;84;186;486720;439940;69;926660
84;2020-S35;58;56;114;372151;315211;79;687362
84;2020-S35;45;32;77;237198;150524;89;387722
84;2020-S35;39;12;51;81185;28680;90;109865
84;2020-S35;1954;1994;3952;4130719;3901658;0;8032377
93;2020-S35;79;119;198;268834;283093;09;551927
93;2020-S35;377;333;711;280751;296087;19;576838
93;2020-S35;988;902;1893;254404;255552;29;509956
93;2020-S35;580;593;1174;310704;288398;39;599102
93;2020-S35;451;383;836;325559;305827;49;631386
93;2020-S35;433;340;775;353104;325389;59;678493
93;2020-S35;272;227;499;336327;296459;69;632786
93;2020-S35;140;127;267;279820;229699;79;509519
93;2020-S35;88;75;163;171274;113716;89;284990
93;2020-S35;50;16;66;58896;21758;90;80654
93;2020-S35;3460;3115;6594;2639673;2415978;0;5055651
94;2020-S35;0;4;4;16311;17433;09;33744
94;2020-S35;13;9;22;16679;18132;19;34811
94;2020-S35;29;33;62;16782;16579;29;33361
94;2020-S35;22;25;47;23044;20580;39;43624
94;2020-S35;10;19;29;23065;22140;49;45205
94;2020-S35;4;15;19;24549;23421;59;47970
94;2020-S35;5;6;11;23212;21883;69;45095
94;2020-S35;3;3;6;19544;17141;79;36685
94;2020-S35;0;0;0;11227;8178;89;19405
94;2020-S35;2;0;2;3332;1447;90;4779
94;2020-S35;88;114;202;177745;166934;0;344679
01;2020-S36;8;11;19;19979;20155;09;40134
01;2020-S36;33;37;70;24994;25489;19;50483
01;2020-S36;92;76;168;17868;16690;29;34558
01;2020-S36;101;77;178;22328;14821;39;37149
01;2020-S36;84;73;157;28652;20276;49;48928
01;2020-S36;75;50;125;33264;27260;59;60524
01;2020-S36;51;50;101;27135;23978;69;51113
01;2020-S36;19;16;35;18401;14661;79;33062
01;2020-S36;13;8;21;9633;6375;89;16008
01;2020-S36;3;2;5;3410;1510;90;4920
01;2020-S36;479;400;879;205664;171215;0;376879
02;2020-S36;5;2;7;16881;17110;09;33991
02;2020-S36;11;9;20;21410;21604;19;43014
02;2020-S36;27;18;45;16017;15479;29;31496
02;2020-S36;31;22;53;19825;14455;39;34280
02;2020-S36;18;12;30;24719;18248;49;42967
02;2020-S36;22;17;39;34361;28310;59;62671
02;2020-S36;5;6;11;28061;24495;69;52556
02;2020-S36;4;3;7;18231;15278;79;33509
02;2020-S36;1;2;3;11090;7677;89;18767
02;2020-S36;1;0;1;3992;1506;90;5498
02;2020-S36;125;91;216;194587;164162;0;358749
03;2020-S36;9;6;15;31123;30920;09;62043
03;2020-S36;38;26;65;29370;29268;19;58638
03;2020-S36;26;15;41;21458;18963;29;40421
03;2020-S36;23;17;40;21276;18326;39;39602
03;2020-S36;27;15;42;18164;16593;49;34757
03;2020-S36;9;12;22;13469;13557;59;27026
03;2020-S36;5;9;14;8776;8670;69;17446
03;2020-S36;1;4;5;3777;3591;79;7368
03;2020-S36;0;0;0;1649;1072;89;2721
03;2020-S36;0;0;0;485;184;90;669
03;2020-S36;138;105;245;149547;141144;0;290691
04;2020-S36;31;30;61;60314;61377;09;121691
04;2020-S36;72;66;138;66065;68387;19;134452
04;2020-S36;70;48;118;51059;47156;29;98215
04;2020-S36;47;29;76;58788;45780;39;104568
04;2020-S36;68;38;106;61408;52207;49;113615
04;2020-S36;40;31;71;64838;60759;59;125597
04;2020-S36;30;28;58;47008;42843;69;89851
04;2020-S36;10;8;18;25509;21184;79;46693
04;2020-S36;2;6;8;13168;7647;89;20815
04;2020-S36;0;0;0;3209;1253;90;4462
04;2020-S36;370;284;654;451366;408593;0;859959
05;2020-S36;0;0;0;362.366008612902;341.338819562748;09;703.704828175651
05;2020-S36;0;0;0;353.376145114279;370.349735405642;19;723.725880519921
05;2020-S36;0;0;0;218.593559489256;256.539602589476;29;475.133162078732
05;2020-S36;0;1;1;404.225408693299;360.321910454353;39;764.547319147651
05;2020-S36;1;0;1;520.067953604221;497.108383964256;49;1017.17633756848
05;2020-S36;0;0;0;468.146063921917;510.087601910415;59;978.233665832332
05;2020-S36;0;0;0;340.368470050554;334.366842191253;69;674.735312241807
05;2020-S36;0;0;0;212.598666888387;192.597753227106;79;405.196420115493
05;2020-S36;0;0;0;148.727797095705;61.8681715431829;89;210.595968638888
05;2020-S36;0;0;0;32.9601271090696;10.9909785719784;90;43.9511056810479
05;2020-S36;1;1;2;3061.43020057959;2935.56979942041;0;5997
06;2020-S36;0;1;1;42583;42380;09;84963
06;2020-S36;12;9;21;33369;31925;19;65294
06;2020-S36;25;25;50;21571;15080;29;36651
06;2020-S36;7;9;16;21550;16147;39;37697
06;2020-S36;6;4;10;14193;13939;49;28132
06;2020-S36;8;4;12;7171;7597;59;14768
06;2020-S36;2;4;6;3629;4117;69;7746
06;2020-S36;1;0;1;1577;1457;79;3034
06;2020-S36;0;0;0;531;474;89;1005
06;2020-S36;0;0;0;88;93;90;181
06;2020-S36;61;56;117;146262;133209;0;279471
07;2020-S36;0;0;0;485;549;09;1034
07;2020-S36;0;0;0;403;432;19;835
07;2020-S36;0;1;1;764;841;29;1605
07;2020-S36;0;0;0;824;928;39;1752
07;2020-S36;0;2;2;788;1020;49;1808
07;2020-S36;0;1;1;678;870;59;1548
07;2020-S36;0;2;2;360;382;69;742
07;2020-S36;0;0;0;231;190;79;421
07;2020-S36;0;0;0;114;67;89;181
07;2020-S36;0;0;0;24;11;90;35
07;2020-S36;0;6;6;4671;5290;0;9961
08;2020-S36;0;0;0;2715.22592983026;2997.75551488675;09;5712.98144471701
08;2020-S36;0;1;1;2778.51901080978;3160.9156459093;19;5939.43465671908
08;2020-S36;1;2;3;2080.8882988764;1718.16634315323;29;3799.05464202964
08;2020-S36;4;2;6;2701.8582062647;1896.52641413317;39;4598.38462039786
08;2020-S36;4;4;8;3151.45861023308;2460.52498233809;49;5611.98359257117
08;2020-S36;4;7;11;2620.29868333099;2422.23566154656;59;5042.53434487755
08;2020-S36;5;0;5;1621.44173420671;1438.58325779464;69;3060.02499200135
08;2020-S36;1;1;2;626.575909335673;526.358467843651;79;1152.93437717932
08;2020-S36;0;0;0;205.018522985054;140.993639349697;89;346.012162334751
08;2020-S36;0;0;0;50.0325684687745;20.62259870351;90;70.6551671722846
08;2020-S36;19;17;36;18551.3174743414;16782.6825256586;0;35334
11;2020-S36;212;233;470;783071;811785;09;1594856
11;2020-S36;810;646;1482;761456;784653;19;1546109
11;2020-S36;2566;2482;5079;850145;801772;29;1651917
11;2020-S36;1460;1478;2952;914360;843488;39;1757848
11;2020-S36;912;855;1778;845609;826202;49;1671811
11;2020-S36;805;649;1461;793566;745070;59;1538636
11;2020-S36;466;409;888;628649;549192;69;1177841
11;2020-S36;163;171;337;434606;358356;79;792962
11;2020-S36;84;65;151;261425;162933;89;424358
11;2020-S36;48;13;61;89253;32619;90;121872
11;2020-S36;7531;7003;14673;6362140;5916070;0;12278210
24;2020-S36;16;26;43;139720;144686;09;284406
24;2020-S36;90;62;153;152979;161185;19;314164
24;2020-S36;153;170;323;122237;126536;29;248773
24;2020-S36;82;104;186;150359;142009;39;292368
24;2020-S36;79;73;152;161829;158758;49;320587
24;2020-S36;64;45;109;172552;168011;59;340563
24;2020-S36;37;47;84;172509;158177;69;330686
24;2020-S36;14;19;33;129428;110593;79;240021
24;2020-S36;14;10;24;87342;56882;89;144224
24;2020-S36;12;1;13;31210;12071;90;43281
24;2020-S36;561;557;1120;1320165;1238908;0;2559073
27;2020-S36;30;16;46;143373;149679;09;293052
27;2020-S36;75;73;148;160962;173003;19;333965
27;2020-S36;167;163;330;133746;142254;29;276000
27;2020-S36;77;76;153;160004;155407;39;315411
27;2020-S36;76;61;137;172333;169564;49;341897
27;2020-S36;76;77;153;189979;183788;59;373767
27;2020-S36;38;35;73;192591;178206;69;370797
27;2020-S36;18;29;47;146876;127546;79;274422
27;2020-S36;22;10;32;96896;61575;89;158471
27;2020-S36;9;3;12;33148;12109;90;45257
27;2020-S36;588;544;1132;1429908;1353131;0;2783039
28;2020-S36;18;30;49;180735;186856;09;367591
28;2020-S36;113;112;226;200125;213621;19;413746
28;2020-S36;229;219;448;168922;173007;29;341929
28;2020-S36;111;137;249;196628;188487;39;385115
28;2020-S36;95;75;170;205396;201699;49;407095
28;2020-S36;76;82;158;222002;213866;59;435868
28;2020-S36;55;48;103;224688;203758;69;428446
28;2020-S36;25;26;51;163192;135543;79;298735
28;2020-S36;28;5;33;109691;65377;89;175068
28;2020-S36;15;3;18;37222;12685;90;49907
28;2020-S36;765;737;1505;1708601;1594899;0;3303500
32;2020-S36;85;75;160;358062;373689;09;731751
32;2020-S36;500;447;954;387045;406742;19;793787
32;2020-S36;648;692;1347;342304;348587;29;690891
32;2020-S36;280;275;556;382485;369972;39;752457
32;2020-S36;250;216;467;382510;376716;49;759226
32;2020-S36;186;202;388;386937;376527;59;763464
32;2020-S36;111;88;199;371211;330938;69;702149
32;2020-S36;70;67;137;250542;201459;79;452001
32;2020-S36;36;29;65;163399;89786;89;253185
32;2020-S36;18;4;22;48384;15367;90;63751
32;2020-S36;2184;2095;4295;3072879;2889783;0;5962662
44;2020-S36;41;42;83;291525;306839;09;598364
44;2020-S36;115;114;231;320255;339504;19;659759
44;2020-S36;222;263;485;302020;314428;29;616448
44;2020-S36;133;161;294;342222;333292;39;675514
44;2020-S36;121;110;231;349727;344491;49;694218
44;2020-S36;97;90;187;381371;373239;59;754610
44;2020-S36;64;51;115;367165;335850;69;703015
44;2020-S36;30;31;61;250387;215436;79;465823
44;2020-S36;20;11;31;170825;105192;89;276017
44;2020-S36;6;1;7;51248;16731;90;67979
44;2020-S36;849;874;1725;2826745;2685002;0;5511747
52;2020-S36;44;43;92;213594;223900;09;437494
52;2020-S36;145;125;272;240818;255197;19;496015
52;2020-S36;259;268;529;197010;200630;29;397640
52;2020-S36;132;154;286;231204;224885;39;456089
52;2020-S36;99;97;198;243874;243418;49;487292
52;2020-S36;82;80;162;244100;239116;59;483216
52;2020-S36;56;67;123;241796;221345;69;463141
52;2020-S36;14;23;37;177805;149903;79;327708
52;2020-S36;14;14;29;119561;75822;89;195383
52;2020-S36;4;3;7;42559;15260;90;57819
52;2020-S36;849;874;1735;1952321;1849476;0;3801797
53;2020-S36;34;30;65;173813;182358;09;356171
53;2020-S36;117;132;251;202720;214740;19;417460
53;2020-S36;211;268;480;163116;173196;29;336312
53;2020-S36;85;98;183;190526;187674;39;378200
53;2020-S36;72;57;129;212098;212015;49;424113
53;2020-S36;65;53;118;223699;219176;59;442875
53;2020-S36;24;36;60;227435;209274;69;436709
53;2020-S36;13;12;25;169992;140910;79;310902
53;2020-S36;10;6;16;118117;69883;89;188000
53;2020-S36;5;0;5;37370;12267;90;49637
53;2020-S36;636;692;1332;1718886;1621493;0;3340379
75;2020-S36;59;73;134;293104;305291;09;598395
75;2020-S36;330;277;609;337141;357785;19;694926
75;2020-S36;715;860;1578;295024;300618;29;595642
75;2020-S36;341;396;738;347871;331233;39;679104
75;2020-S36;289;257;546;384742;372771;49;757513
75;2020-S36;253;202;455;413361;390880;59;804241
75;2020-S36;110;129;239;425623;384060;69;809683
75;2020-S36;53;52;105;325086;276298;79;601384
75;2020-S36;39;32;71;213986;139308;89;353294
75;2020-S36;19;9;28;77600;28200;90;105800
75;2020-S36;2210;2291;4509;3113538;2886444;0;5999982
76;2020-S36;82;74;163;305956;318589;09;624545
76;2020-S36;270;278;556;338942;356969;19;695911
76;2020-S36;553;649;1203;316210;319570;29;635780
76;2020-S36;364;374;739;356758;337587;39;694345
76;2020-S36;283;271;555;376541;363812;49;740353
76;2020-S36;233;230;463;402608;383750;59;786358
76;2020-S36;128;142;270;394889;358997;69;753886
76;2020-S36;71;84;155;308664;263806;79;572470
76;2020-S36;59;55;114;195838;129272;89;325110
76;2020-S36;33;14;47;69372;26728;90;96100
76;2020-S36;2082;2171;4271;3065778;2859080;0;5924858
84;2020-S36;99;116;218;459549;481088;09;940637
84;2020-S36;356;377;737;487711;511905;19;999616
84;2020-S36;845;834;1680;443824;451094;29;894918
84;2020-S36;506;482;988;512522;493262;39;1005784
84;2020-S36;400;364;764;520248;515106;49;1035354
84;2020-S36;322;284;606;529611;514848;59;1044459
84;2020-S36;165;149;314;486720;439940;69;926660
84;2020-S36;110;111;221;372151;315211;79;687362
84;2020-S36;88;55;143;237198;150524;89;387722
84;2020-S36;70;26;96;81185;28680;90;109865
84;2020-S36;2962;2798;5768;4130719;3901658;0;8032377
93;2020-S36;134;140;274;268834;283093;09;551927
93;2020-S36;434;375;814;280751;296087;19;576838
93;2020-S36;913;870;1785;254404;255552;29;509956
93;2020-S36;651;644;1296;310704;288398;39;599102
93;2020-S36;523;472;997;325559;305827;49;631386
93;2020-S36;521;428;950;353104;325389;59;678493
93;2020-S36;304;323;627;336327;296459;69;632786
93;2020-S36;161;171;332;279820;229699;79;509519
93;2020-S36;135;100;235;171274;113716;89;284990
93;2020-S36;76;33;110;58896;21758;90;80654
93;2020-S36;3854;3556;7422;2639673;2415978;0;5055651
94;2020-S36;4;4;8;16311;17433;09;33744
94;2020-S36;11;17;30;16679;18132;19;34811
94;2020-S36;36;52;88;16782;16579;29;33361
94;2020-S36;30;34;64;23044;20580;39;43624
94;2020-S36;14;24;38;23065;22140;49;45205
94;2020-S36;19;24;43;24549;23421;59;47970
94;2020-S36;14;14;28;23212;21883;69;45095
94;2020-S36;4;14;18;19544;17141;79;36685
94;2020-S36;2;0;2;11227;8178;89;19405
94;2020-S36;2;0;2;3332;1447;90;4779
94;2020-S36;136;183;321;177745;166934;0;344679
01;2020-S37;6;15;21;19979;20155;09;40134
01;2020-S37;46;37;83;24994;25489;19;50483
01;2020-S37;58;58;116;17868;16690;29;34558
01;2020-S37;96;65;161;22328;14821;39;37149
01;2020-S37;111;88;199;28652;20276;49;48928
01;2020-S37;93;90;183;33264;27260;59;60524
01;2020-S37;58;80;138;27135;23978;69;51113
01;2020-S37;24;20;44;18401;14661;79;33062
01;2020-S37;7;10;17;9633;6375;89;16008
01;2020-S37;1;1;2;3410;1510;90;4920
01;2020-S37;500;464;964;205664;171215;0;376879
02;2020-S37;4;1;5;16881;17110;09;33991
02;2020-S37;6;12;18;21410;21604;19;43014
02;2020-S37;21;14;35;16017;15479;29;31496
02;2020-S37;20;15;35;19825;14455;39;34280
02;2020-S37;13;10;23;24719;18248;49;42967
02;2020-S37;20;18;39;34361;28310;59;62671
02;2020-S37;10;9;19;28061;24495;69;52556
02;2020-S37;3;1;4;18231;15278;79;33509
02;2020-S37;3;0;3;11090;7677;89;18767
02;2020-S37;0;0;0;3992;1506;90;5498
02;2020-S37;100;80;181;194587;164162;0;358749
03;2020-S37;6;8;15;31123;30920;09;62043
03;2020-S37;11;17;31;29370;29268;19;58638
03;2020-S37;26;19;47;21458;18963;29;40421
03;2020-S37;20;14;34;21276;18326;39;39602
03;2020-S37;17;15;32;18164;16593;49;34757
03;2020-S37;10;10;20;13469;13557;59;27026
03;2020-S37;5;5;10;8776;8670;69;17446
03;2020-S37;1;1;2;3777;3591;79;7368
03;2020-S37;1;2;3;1649;1072;89;2721
03;2020-S37;0;0;0;485;184;90;669
03;2020-S37;97;91;194;149547;141144;0;290691
04;2020-S37;33;23;56;60314;61377;09;121691
04;2020-S37;67;63;130;66065;68387;19;134452
04;2020-S37;48;41;89;51059;47156;29;98215
04;2020-S37;39;27;66;58788;45780;39;104568
04;2020-S37;55;32;87;61408;52207;49;113615
04;2020-S37;50;39;89;64838;60759;59;125597
04;2020-S37;28;28;56;47008;42843;69;89851
04;2020-S37;7;8;15;25509;21184;79;46693
04;2020-S37;3;2;5;13168;7647;89;20815
04;2020-S37;1;0;1;3209;1253;90;4462
04;2020-S37;331;263;594;451366;408593;0;859959
05;2020-S37;0;0;0;362.366008612902;341.338819562748;09;703.704828175651
05;2020-S37;0;0;0;353.376145114279;370.349735405642;19;723.725880519921
05;2020-S37;0;0;0;218.593559489256;256.539602589476;29;475.133162078732
05;2020-S37;0;0;0;404.225408693299;360.321910454353;39;764.547319147651
05;2020-S37;0;0;0;520.067953604221;497.108383964256;49;1017.17633756848
05;2020-S37;0;0;0;468.146063921917;510.087601910415;59;978.233665832332
05;2020-S37;0;0;0;340.368470050554;334.366842191253;69;674.735312241807
05;2020-S37;0;0;0;212.598666888387;192.597753227106;79;405.196420115493
05;2020-S37;0;0;0;148.727797095705;61.8681715431829;89;210.595968638888
05;2020-S37;0;0;0;32.9601271090696;10.9909785719784;90;43.9511056810479
05;2020-S37;0;0;0;3061.43020057959;2935.56979942041;0;5997
06;2020-S37;1;0;1;42583;42380;09;84963
06;2020-S37;9;11;20;33369;31925;19;65294
06;2020-S37;26;17;43;21571;15080;29;36651
06;2020-S37;12;7;19;21550;16147;39;37697
06;2020-S37;8;7;15;14193;13939;49;28132
06;2020-S37;9;7;16;7171;7597;59;14768
06;2020-S37;0;2;2;3629;4117;69;7746
06;2020-S37;2;0;2;1577;1457;79;3034
06;2020-S37;0;0;0;531;474;89;1005
06;2020-S37;0;0;0;88;93;90;181
06;2020-S37;67;51;118;146262;133209;0;279471
07;2020-S37;0;0;0;485;549;09;1034
07;2020-S37;0;0;0;403;432;19;835
07;2020-S37;0;0;0;764;841;29;1605
07;2020-S37;0;0;0;824;928;39;1752
07;2020-S37;1;2;3;788;1020;49;1808
07;2020-S37;0;0;0;678;870;59;1548
07;2020-S37;0;0;0;360;382;69;742
07;2020-S37;0;0;0;231;190;79;421
07;2020-S37;0;0;0;114;67;89;181
07;2020-S37;0;0;0;24;11;90;35
07;2020-S37;1;2;3;4671;5290;0;9961
08;2020-S37;0;0;0;2715.22592983026;2997.75551488675;09;5712.98144471701
08;2020-S37;0;0;0;2778.51901080978;3160.9156459093;19;5939.43465671908
08;2020-S37;3;2;5;2080.8882988764;1718.16634315323;29;3799.05464202964
08;2020-S37;8;5;13;2701.8582062647;1896.52641413317;39;4598.38462039786
08;2020-S37;8;2;10;3151.45861023308;2460.52498233809;49;5611.98359257117
08;2020-S37;3;7;10;2620.29868333099;2422.23566154656;59;5042.53434487755
08;2020-S37;6;8;14;1621.44173420671;1438.58325779464;69;3060.02499200135
08;2020-S37;3;1;4;626.575909335673;526.358467843651;79;1152.93437717932
08;2020-S37;1;1;2;205.018522985054;140.993639349697;89;346.012162334751
08;2020-S37;1;0;1;50.0325684687745;20.62259870351;90;70.6551671722846
08;2020-S37;33;26;59;18551.3174743414;16782.6825256586;0;35334
11;2020-S37;371;328;725;783071;811785;09;1594856
11;2020-S37;992;964;2012;761456;784653;19;1546109
11;2020-S37;2734;2456;5211;850145;801772;29;1651917
11;2020-S37;1668;1619;3305;914360;843488;39;1757848
11;2020-S37;1250;1111;2370;845609;826202;49;1671811
11;2020-S37;1040;881;1931;793566;745070;59;1538636
11;2020-S37;532;502;1046;628649;549192;69;1177841
11;2020-S37;204;249;456;434606;358356;79;792962
11;2020-S37;118;108;229;261425;162933;89;424358
11;2020-S37;61;30;91;89253;32619;90;121872
11;2020-S37;8971;8251;17387;6362140;5916070;0;12278210
24;2020-S37;27;33;63;139720;144686;09;284406
24;2020-S37;104;101;210;152979;161185;19;314164
24;2020-S37;155;177;332;122237;126536;29;248773
24;2020-S37;116;106;222;150359;142009;39;292368
24;2020-S37;114;97;211;161829;158758;49;320587
24;2020-S37;84;70;154;172552;168011;59;340563
24;2020-S37;46;44;90;172509;158177;69;330686
24;2020-S37;23;24;47;129428;110593;79;240021
24;2020-S37;19;15;34;87342;56882;89;144224
24;2020-S37;12;4;16;31210;12071;90;43281
24;2020-S37;700;671;1379;1320165;1238908;0;2559073
27;2020-S37;48;41;90;143373;149679;09;293052
27;2020-S37;111;109;221;160962;173003;19;333965
27;2020-S37;171;200;371;133746;142254;29;276000
27;2020-S37;118;113;231;160004;155407;39;315411
27;2020-S37;101;100;201;172333;169564;49;341897
27;2020-S37;99;88;187;189979;183788;59;373767
27;2020-S37;57;49;106;192591;178206;69;370797
27;2020-S37;40;30;70;146876;127546;79;274422
27;2020-S37;40;9;49;96896;61575;89;158471
27;2020-S37;17;8;25;33148;12109;90;45257
27;2020-S37;804;747;1553;1429908;1353131;0;2783039
28;2020-S37;49;64;115;180735;186856;09;367591
28;2020-S37;141;171;319;200125;213621;19;413746
28;2020-S37;297;265;562;168922;173007;29;341929
28;2020-S37;199;159;358;196628;188487;39;385115
28;2020-S37;184;131;317;205396;201699;49;407095
28;2020-S37;134;125;259;222002;213866;59;435868
28;2020-S37;78;91;170;224688;203758;69;428446
28;2020-S37;40;48;88;163192;135543;79;298735
28;2020-S37;24;19;43;109691;65377;89;175068
28;2020-S37;10;2;12;37222;12685;90;49907
28;2020-S37;1156;1075;2243;1708601;1594899;0;3303500
32;2020-S37;160;135;301;358062;373689;09;731751
32;2020-S37;643;576;1232;387045;406742;19;793787
32;2020-S37;963;1030;1998;342304;348587;29;690891
32;2020-S37;434;426;866;382485;369972;39;752457
32;2020-S37;444;423;874;382510;376716;49;759226
32;2020-S37;367;311;681;386937;376527;59;763464
32;2020-S37;185;181;368;371211;330938;69;702149
32;2020-S37;114;91;205;250542;201459;79;452001
32;2020-S37;53;37;90;163399;89786;89;253185
32;2020-S37;34;11;45;48384;15367;90;63751
32;2020-S37;3399;3222;6663;3072879;2889783;0;5962662
44;2020-S37;59;73;133;291525;306839;09;598364
44;2020-S37;246;206;453;320255;339504;19;659759
44;2020-S37;309;342;653;302020;314428;29;616448
44;2020-S37;190;162;352;342222;333292;39;675514
44;2020-S37;149;110;259;349727;344491;49;694218
44;2020-S37;132;105;238;381371;373239;59;754610
44;2020-S37;80;72;152;367165;335850;69;703015
44;2020-S37;51;58;109;250387;215436;79;465823
44;2020-S37;29;29;58;170825;105192;89;276017
44;2020-S37;19;5;24;51248;16731;90;67979
44;2020-S37;1265;1163;2433;2826745;2685002;0;5511747
52;2020-S37;68;52;129;213594;223900;09;437494
52;2020-S37;192;188;385;240818;255197;19;496015
52;2020-S37;263;281;544;197010;200630;29;397640
52;2020-S37;144;126;270;231204;224885;39;456089
52;2020-S37;149;108;257;243874;243418;49;487292
52;2020-S37;101;88;189;244100;239116;59;483216
52;2020-S37;56;63;119;241796;221345;69;463141
52;2020-S37;38;29;67;177805;149903;79;327708
52;2020-S37;21;19;40;119561;75822;89;195383
52;2020-S37;7;7;14;42559;15260;90;57819
52;2020-S37;1040;961;2015;1952321;1849476;0;3801797
53;2020-S37;33;44;78;173813;182358;09;356171
53;2020-S37;176;165;343;202720;214740;19;417460
53;2020-S37;240;277;518;163116;173196;29;336312
53;2020-S37;119;97;216;190526;187674;39;378200
53;2020-S37;85;91;176;212098;212015;49;424113
53;2020-S37;67;75;142;223699;219176;59;442875
53;2020-S37;49;39;88;227435;209274;69;436709
53;2020-S37;21;17;38;169992;140910;79;310902
53;2020-S37;25;27;52;118117;69883;89;188000
53;2020-S37;17;7;24;37370;12267;90;49637
53;2020-S37;832;839;1675;1718886;1621493;0;3340379
75;2020-S37;109;106;217;293104;305291;09;598395
75;2020-S37;288;322;614;337141;357785;19;694926
75;2020-S37;591;657;1249;295024;300618;29;595642
75;2020-S37;342;356;699;347871;331233;39;679104
75;2020-S37;309;271;580;384742;372771;49;757513
75;2020-S37;300;241;542;413361;390880;59;804241
75;2020-S37;140;147;288;425623;384060;69;809683
75;2020-S37;82;93;175;325086;276298;79;601384
75;2020-S37;74;42;117;213986;139308;89;353294
75;2020-S37;65;21;86;77600;28200;90;105800
75;2020-S37;2300;2257;4568;3113538;2886444;0;5999982
76;2020-S37;103;120;228;305956;318589;09;624545
76;2020-S37;429;492;930;338942;356969;19;695911
76;2020-S37;723;779;1508;316210;319570;29;635780
76;2020-S37;411;348;759;356758;337587;39;694345
76;2020-S37;390;302;693;376541;363812;49;740353
76;2020-S37;347;302;650;402608;383750;59;786358
76;2020-S37;150;168;318;394889;358997;69;753886
76;2020-S37;123;116;239;308664;263806;79;572470
76;2020-S37;120;72;192;195838;129272;89;325110
76;2020-S37;111;23;134;69372;26728;90;96100
76;2020-S37;2912;2724;5658;3065778;2859080;0;5924858
84;2020-S37;206;199;409;459549;481088;09;940637
84;2020-S37;481;512;1000;487711;511905;19;999616
84;2020-S37;1000;1140;2144;443824;451094;29;894918
84;2020-S37;595;538;1133;512522;493262;39;1005784
84;2020-S37;490;476;967;520248;515106;49;1035354
84;2020-S37;478;443;921;529611;514848;59;1044459
84;2020-S37;228;250;478;486720;439940;69;926660
84;2020-S37;148;134;282;372151;315211;79;687362
84;2020-S37;140;92;232;237198;150524;89;387722
84;2020-S37;120;36;156;81185;28680;90;109865
84;2020-S37;3887;3820;7724;4130719;3901658;0;8032377
93;2020-S37;172;197;378;268834;283093;09;551927
93;2020-S37;434;494;930;280751;296087;19;576838
93;2020-S37;929;744;1675;254404;255552;29;509956
93;2020-S37;703;546;1250;310704;288398;39;599102
93;2020-S37;633;493;1126;325559;305827;49;631386
93;2020-S37;592;515;1107;353104;325389;59;678493
93;2020-S37;384;318;703;336327;296459;69;632786
93;2020-S37;230;208;438;279820;229699;79;509519
93;2020-S37;145;112;257;171274;113716;89;284990
93;2020-S37;119;34;153;58896;21758;90;80654
93;2020-S37;4342;3662;8019;2639673;2415978;0;5055651
94;2020-S37;3;8;11;16311;17433;09;33744
94;2020-S37;16;19;35;16679;18132;19;34811
94;2020-S37;48;37;85;16782;16579;29;33361
94;2020-S37;21;20;41;23044;20580;39;43624
94;2020-S37;21;18;39;23065;22140;49;45205
94;2020-S37;19;26;45;24549;23421;59;47970
94;2020-S37;11;11;22;23212;21883;69;45095
94;2020-S37;11;11;22;19544;17141;79;36685
94;2020-S37;4;6;10;11227;8178;89;19405
94;2020-S37;1;0;1;3332;1447;90;4779
94;2020-S37;155;156;311;177745;166934;0;344679
01;2020-S38;8;10;18;19979;20155;09;40134
01;2020-S38;60;64;124;24994;25489;19;50483
01;2020-S38;83;68;151;17868;16690;29;34558
01;2020-S38;102;63;165;22328;14821;39;37149
01;2020-S38;115;101;216;28652;20276;49;48928
01;2020-S38;113;96;209;33264;27260;59;60524
01;2020-S38;74;69;143;27135;23978;69;51113
01;2020-S38;25;40;65;18401;14661;79;33062
01;2020-S38;16;19;35;9633;6375;89;16008
01;2020-S38;7;1;8;3410;1510;90;4920
01;2020-S38;603;531;1134;205664;171215;0;376879
02;2020-S38;4;5;9;16881;17110;09;33991
02;2020-S38;8;9;17;21410;21604;19;43014
02;2020-S38;10;18;28;16017;15479;29;31496
02;2020-S38;19;17;36;19825;14455;39;34280
02;2020-S38;13;11;25;24719;18248;49;42967
02;2020-S38;19;26;45;34361;28310;59;62671
02;2020-S38;6;8;14;28061;24495;69;52556
02;2020-S38;3;3;6;18231;15278;79;33509
02;2020-S38;0;3;3;11090;7677;89;18767
02;2020-S38;0;1;1;3992;1506;90;5498
02;2020-S38;82;101;184;194587;164162;0;358749
03;2020-S38;5;7;12;31123;30920;09;62043
03;2020-S38;18;15;33;29370;29268;19;58638
03;2020-S38;17;6;23;21458;18963;29;40421
03;2020-S38;23;9;32;21276;18326;39;39602
03;2020-S38;10;9;20;18164;16593;49;34757
03;2020-S38;8;17;25;13469;13557;59;27026
03;2020-S38;4;6;10;8776;8670;69;17446
03;2020-S38;1;1;2;3777;3591;79;7368
03;2020-S38;1;1;2;1649;1072;89;2721
03;2020-S38;0;0;0;485;184;90;669
03;2020-S38;87;71;159;149547;141144;0;290691
04;2020-S38;23;20;43;60314;61377;09;121691
04;2020-S38;55;50;105;66065;68387;19;134452
04;2020-S38;57;33;90;51059;47156;29;98215
04;2020-S38;48;19;67;58788;45780;39;104568
04;2020-S38;36;26;62;61408;52207;49;113615
04;2020-S38;53;42;95;64838;60759;59;125597
04;2020-S38;20;26;46;47008;42843;69;89851
04;2020-S38;20;15;35;25509;21184;79;46693
04;2020-S38;3;3;6;13168;7647;89;20815
04;2020-S38;0;0;0;3209;1253;90;4462
04;2020-S38;315;234;549;451366;408593;0;859959
05;2020-S38;0;0;0;362.366008612902;341.338819562748;09;703.704828175651
05;2020-S38;0;0;0;353.376145114279;370.349735405642;19;723.725880519921
05;2020-S38;0;0;0;218.593559489256;256.539602589476;29;475.133162078732
05;2020-S38;0;0;0;404.225408693299;360.321910454353;39;764.547319147651
05;2020-S38;0;0;0;520.067953604221;497.108383964256;49;1017.17633756848
05;2020-S38;1;0;1;468.146063921917;510.087601910415;59;978.233665832332
05;2020-S38;0;0;0;340.368470050554;334.366842191253;69;674.735312241807
05;2020-S38;0;0;0;212.598666888387;192.597753227106;79;405.196420115493
05;2020-S38;0;0;0;148.727797095705;61.8681715431829;89;210.595968638888
05;2020-S38;0;0;0;32.9601271090696;10.9909785719784;90;43.9511056810479
05;2020-S38;1;0;1;3061.43020057959;2935.56979942041;0;5997
06;2020-S38;0;1;1;42583;42380;09;84963
06;2020-S38;12;4;18;33369;31925;19;65294
06;2020-S38;17;9;26;21571;15080;29;36651
06;2020-S38;11;16;27;21550;16147;39;37697
06;2020-S38;12;12;24;14193;13939;49;28132
06;2020-S38;5;6;11;7171;7597;59;14768
06;2020-S38;1;2;3;3629;4117;69;7746
06;2020-S38;1;1;2;1577;1457;79;3034
06;2020-S38;0;0;0;531;474;89;1005
06;2020-S38;0;0;0;88;93;90;181
06;2020-S38;59;51;112;146262;133209;0;279471
07;2020-S38;0;0;0;485;549;09;1034
07;2020-S38;0;0;0;403;432;19;835
07;2020-S38;0;1;1;764;841;29;1605
07;2020-S38;0;1;1;824;928;39;1752
07;2020-S38;1;1;2;788;1020;49;1808
07;2020-S38;0;1;1;678;870;59;1548
07;2020-S38;2;1;3;360;382;69;742
07;2020-S38;0;0;0;231;190;79;421
07;2020-S38;0;0;0;114;67;89;181
07;2020-S38;0;0;0;24;11;90;35
07;2020-S38;3;5;8;4671;5290;0;9961
08;2020-S38;0;2;2;2715.22592983026;2997.75551488675;09;5712.98144471701
08;2020-S38;0;1;1;2778.51901080978;3160.9156459093;19;5939.43465671908
08;2020-S38;5;4;9;2080.8882988764;1718.16634315323;29;3799.05464202964
08;2020-S38;3;6;9;2701.8582062647;1896.52641413317;39;4598.38462039786
08;2020-S38;3;2;5;3151.45861023308;2460.52498233809;49;5611.98359257117
08;2020-S38;8;2;10;2620.29868333099;2422.23566154656;59;5042.53434487755
08;2020-S38;8;6;14;1621.44173420671;1438.58325779464;69;3060.02499200135
08;2020-S38;0;1;1;626.575909335673;526.358467843651;79;1152.93437717932
08;2020-S38;0;0;0;205.018522985054;140.993639349697;89;346.012162334751
08;2020-S38;0;0;0;50.0325684687745;20.62259870351;90;70.6551671722846
08;2020-S38;27;24;51;18551.3174743414;16782.6825256586;0;35334
11;2020-S38;296;327;648;783071;811785;09;1594856
11;2020-S38;1247;1249;2555;761456;784653;19;1546109
11;2020-S38;3056;2788;5858;850145;801772;29;1651917
11;2020-S38;2047;1900;3962;914360;843488;39;1757848
11;2020-S38;1522;1385;2918;845609;826202;49;1671811
11;2020-S38;1268;1084;2365;793566;745070;59;1538636
11;2020-S38;662;710;1382;628649;549192;69;1177841
11;2020-S38;281;296;578;434606;358356;79;792962
11;2020-S38;162;130;292;261425;162933;89;424358
11;2020-S38;93;42;135;89253;32619;90;121872
11;2020-S38;10637;9919;20722;6362140;5916070;0;12278210
24;2020-S38;39;38;80;139720;144686;09;284406
24;2020-S38;121;110;234;152979;161185;19;314164
24;2020-S38;183;185;368;122237;126536;29;248773
24;2020-S38;153;111;266;150359;142009;39;292368
24;2020-S38;122;100;222;161829;158758;49;320587
24;2020-S38;105;86;191;172552;168011;59;340563
24;2020-S38;71;43;114;172509;158177;69;330686
24;2020-S38;47;28;75;129428;110593;79;240021
24;2020-S38;35;34;69;87342;56882;89;144224
24;2020-S38;25;11;36;31210;12071;90;43281
24;2020-S38;901;746;1655;1320165;1238908;0;2559073
27;2020-S38;35;53;88;143373;149679;09;293052
27;2020-S38;137;165;304;160962;173003;19;333965
27;2020-S38;196;181;378;133746;142254;29;276000
27;2020-S38;134;133;267;160004;155407;39;315411
27;2020-S38;144;79;223;172333;169564;49;341897
27;2020-S38;115;104;219;189979;183788;59;373767
27;2020-S38;74;64;138;192591;178206;69;370797
27;2020-S38;47;42;89;146876;127546;79;274422
27;2020-S38;42;25;67;96896;61575;89;158471
27;2020-S38;14;9;23;33148;12109;90;45257
27;2020-S38;938;855;1796;1429908;1353131;0;2783039
28;2020-S38;65;83;151;180735;186856;09;367591
28;2020-S38;220;201;427;200125;213621;19;413746
28;2020-S38;306;307;613;168922;173007;29;341929
28;2020-S38;255;200;455;196628;188487;39;385115
28;2020-S38;238;209;448;205396;201699;49;407095
28;2020-S38;184;159;343;222002;213866;59;435868
28;2020-S38;133;98;233;224688;203758;69;428446
28;2020-S38;61;60;121;163192;135543;79;298735
28;2020-S38;56;34;90;109691;65377;89;175068
28;2020-S38;43;16;59;37222;12685;90;49907
28;2020-S38;1561;1368;2941;1708601;1594899;0;3303500
32;2020-S38;140;199;343;358062;373689;09;731751
32;2020-S38;883;884;1776;387045;406742;19;793787
32;2020-S38;1228;1285;2520;342304;348587;29;690891
32;2020-S38;607;542;1157;382485;369972;39;752457
32;2020-S38;623;520;1146;382510;376716;49;759226
32;2020-S38;472;432;906;386937;376527;59;763464
32;2020-S38;275;232;510;371211;330938;69;702149
32;2020-S38;165;127;294;250542;201459;79;452001
32;2020-S38;89;66;157;163399;89786;89;253185
32;2020-S38;41;19;60;48384;15367;90;63751
32;2020-S38;4524;4308;8872;3072879;2889783;0;5962662
44;2020-S38;44;44;88;291525;306839;09;598364
44;2020-S38;264;235;501;320255;339504;19;659759
44;2020-S38;345;400;745;302020;314428;29;616448
44;2020-S38;195;191;387;342222;333292;39;675514
44;2020-S38;133;117;250;349727;344491;49;694218
44;2020-S38;136;118;254;381371;373239;59;754610
44;2020-S38;86;82;168;367165;335850;69;703015
44;2020-S38;49;56;105;250387;215436;79;465823
44;2020-S38;44;35;79;170825;105192;89;276017
44;2020-S38;26;5;31;51248;16731;90;67979
44;2020-S38;1325;1284;2613;2826745;2685002;0;5511747
52;2020-S38;32;28;63;213594;223900;09;437494
52;2020-S38;249;210;470;240818;255197;19;496015
52;2020-S38;239;299;540;197010;200630;29;397640
52;2020-S38;144;134;278;231204;224885;39;456089
52;2020-S38;165;137;302;243874;243418;49;487292
52;2020-S38;127;116;243;244100;239116;59;483216
52;2020-S38;69;78;147;241796;221345;69;463141
52;2020-S38;37;45;82;177805;149903;79;327708
52;2020-S38;33;23;56;119561;75822;89;195383
52;2020-S38;12;8;20;42559;15260;90;57819
52;2020-S38;1107;1078;2201;1952321;1849476;0;3801797
53;2020-S38;44;43;89;173813;182358;09;356171
53;2020-S38;219;184;403;202720;214740;19;417460
53;2020-S38;357;365;725;163116;173196;29;336312
53;2020-S38;124;128;252;190526;187674;39;378200
53;2020-S38;105;88;193;212098;212015;49;424113
53;2020-S38;121;114;235;223699;219176;59;442875
53;2020-S38;52;56;108;227435;209274;69;436709
53;2020-S38;39;36;75;169992;140910;79;310902
53;2020-S38;43;22;65;118117;69883;89;188000
53;2020-S38;19;3;22;37370;12267;90;49637
53;2020-S38;1123;1039;2167;1718886;1621493;0;3340379
75;2020-S38;94;102;199;293104;305291;09;598395
75;2020-S38;347;354;709;337141;357785;19;694926
75;2020-S38;558;572;1131;295024;300618;29;595642
75;2020-S38;415;310;726;347871;331233;39;679104
75;2020-S38;364;313;679;384742;372771;49;757513
75;2020-S38;276;269;545;413361;390880;59;804241
75;2020-S38;158;182;340;425623;384060;69;809683
75;2020-S38;103;121;224;325086;276298;79;601384
75;2020-S38;124;59;183;213986;139308;89;353294
75;2020-S38;115;43;158;77600;28200;90;105800
75;2020-S38;2555;2328;4898;3113538;2886444;0;5999982
76;2020-S38;112;111;228;305956;318589;09;624545
76;2020-S38;704;765;1485;338942;356969;19;695911
76;2020-S38;1131;1220;2354;316210;319570;29;635780
76;2020-S38;495;444;939;356758;337587;39;694345
76;2020-S38;448;403;853;376541;363812;49;740353
76;2020-S38;398;332;730;402608;383750;59;786358
76;2020-S38;213;230;444;394889;358997;69;753886
76;2020-S38;138;141;279;308664;263806;79;572470
76;2020-S38;132;60;192;195838;129272;89;325110
76;2020-S38;93;23;116;69372;26728;90;96100
76;2020-S38;3870;3733;7630;3065778;2859080;0;5924858
84;2020-S38;171;208;385;459549;481088;09;940637
84;2020-S38;630;660;1296;487711;511905;19;999616
84;2020-S38;1195;1232;2429;443824;451094;29;894918
84;2020-S38;706;585;1291;512522;493262;39;1005784
84;2020-S38;686;575;1262;520248;515106;49;1035354
84;2020-S38;566;513;1079;529611;514848;59;1044459
84;2020-S38;332;288;620;486720;439940;69;926660
84;2020-S38;175;200;375;372151;315211;79;687362
84;2020-S38;167;131;298;237198;150524;89;387722
84;2020-S38;128;28;156;81185;28680;90;109865
84;2020-S38;4757;4421;9193;4130719;3901658;0;8032377
93;2020-S38;149;148;297;268834;283093;09;551927
93;2020-S38;487;498;988;280751;296087;19;576838
93;2020-S38;829;661;1492;254404;255552;29;509956
93;2020-S38;669;559;1230;310704;288398;39;599102
93;2020-S38;597;443;1041;325559;305827;49;631386
93;2020-S38;589;460;1049;353104;325389;59;678493
93;2020-S38;325;339;664;336327;296459;69;632786
93;2020-S38;202;204;406;279820;229699;79;509519
93;2020-S38;135;104;239;171274;113716;89;284990
93;2020-S38;73;28;101;58896;21758;90;80654
93;2020-S38;4058;3444;7512;2639673;2415978;0;5055651
94;2020-S38;2;2;4;16311;17433;09;33744
94;2020-S38;15;9;25;16679;18132;19;34811
94;2020-S38;27;29;57;16782;16579;29;33361
94;2020-S38;13;15;28;23044;20580;39;43624
94;2020-S38;14;12;26;23065;22140;49;45205
94;2020-S38;15;15;30;24549;23421;59;47970
94;2020-S38;10;13;23;23212;21883;69;45095
94;2020-S38;7;9;16;19544;17141;79;36685
94;2020-S38;7;2;9;11227;8178;89;19405
94;2020-S38;3;0;3;3332;1447;90;4779
94;2020-S38;113;106;221;177745;166934;0;344679
01;2020-S39;4;12;16;19979;20155;09;40134
01;2020-S39;66;56;123;24994;25489;19;50483
01;2020-S39;62;58;120;17868;16690;29;34558
01;2020-S39;96;53;149;22328;14821;39;37149
01;2020-S39;124;82;206;28652;20276;49;48928
01;2020-S39;112;87;199;33264;27260;59;60524
01;2020-S39;75;77;152;27135;23978;69;51113
01;2020-S39;29;40;69;18401;14661;79;33062
01;2020-S39;13;19;32;9633;6375;89;16008
01;2020-S39;3;1;4;3410;1510;90;4920
01;2020-S39;584;486;1071;205664;171215;0;376879
02;2020-S39;6;3;9;16881;17110;09;33991
02;2020-S39;12;18;30;21410;21604;19;43014
02;2020-S39;19;18;37;16017;15479;29;31496
02;2020-S39;30;27;57;19825;14455;39;34280
02;2020-S39;26;22;48;24719;18248;49;42967
02;2020-S39;28;26;54;34361;28310;59;62671
02;2020-S39;14;11;26;28061;24495;69;52556
02;2020-S39;3;3;7;18231;15278;79;33509
02;2020-S39;2;1;4;11090;7677;89;18767
02;2020-S39;1;0;1;3992;1506;90;5498
02;2020-S39;141;129;273;194587;164162;0;358749
03;2020-S39;4;5;10;31123;30920;09;62043
03;2020-S39;16;22;44;29370;29268;19;58638
03;2020-S39;21;16;37;21458;18963;29;40421
03;2020-S39;22;18;41;21276;18326;39;39602
03;2020-S39;10;10;20;18164;16593;49;34757
03;2020-S39;7;7;14;13469;13557;59;27026
03;2020-S39;4;1;6;8776;8670;69;17446
03;2020-S39;4;2;6;3777;3591;79;7368
03;2020-S39;1;0;1;1649;1072;89;2721
03;2020-S39;0;0;0;485;184;90;669
03;2020-S39;89;81;179;149547;141144;0;290691
04;2020-S39;21;23;44;60314;61377;09;121691
04;2020-S39;75;80;155;66065;68387;19;134452
04;2020-S39;41;39;80;51059;47156;29;98215
04;2020-S39;41;26;67;58788;45780;39;104568
04;2020-S39;40;14;54;61408;52207;49;113615
04;2020-S39;39;27;66;64838;60759;59;125597
04;2020-S39;11;16;27;47008;42843;69;89851
04;2020-S39;16;7;23;25509;21184;79;46693
04;2020-S39;2;3;5;13168;7647;89;20815
04;2020-S39;1;0;1;3209;1253;90;4462
04;2020-S39;287;236;523;451366;408593;0;859959
05;2020-S39;0;0;0;362.366008612902;341.338819562748;09;703.704828175651
05;2020-S39;0;0;0;353.376145114279;370.349735405642;19;723.725880519921
05;2020-S39;0;0;0;218.593559489256;256.539602589476;29;475.133162078732
05;2020-S39;0;0;0;404.225408693299;360.321910454353;39;764.547319147651
05;2020-S39;0;0;0;520.067953604221;497.108383964256;49;1017.17633756848
05;2020-S39;0;0;0;468.146063921917;510.087601910415;59;978.233665832332
05;2020-S39;0;0;0;340.368470050554;334.366842191253;69;674.735312241807
05;2020-S39;0;0;0;212.598666888387;192.597753227106;79;405.196420115493
05;2020-S39;0;0;0;148.727797095705;61.8681715431829;89;210.595968638888
05;2020-S39;0;0;0;32.9601271090696;10.9909785719784;90;43.9511056810479
05;2020-S39;0;0;0;3061.43020057959;2935.56979942041;0;5997
06;2020-S39;1;0;1;42583;42380;09;84963
06;2020-S39;5;9;15;33369;31925;19;65294
06;2020-S39;14;4;18;21571;15080;29;36651
06;2020-S39;21;13;34;21550;16147;39;37697
06;2020-S39;10;11;21;14193;13939;49;28132
06;2020-S39;3;5;8;7171;7597;59;14768
06;2020-S39;0;1;1;3629;4117;69;7746
06;2020-S39;0;2;2;1577;1457;79;3034
06;2020-S39;0;1;1;531;474;89;1005
06;2020-S39;0;0;0;88;93;90;181
06;2020-S39;54;46;101;146262;133209;0;279471
07;2020-S39;0;0;0;485;549;09;1034
07;2020-S39;1;0;1;403;432;19;835
07;2020-S39;2;1;3;764;841;29;1605
07;2020-S39;0;2;2;824;928;39;1752
07;2020-S39;1;1;2;788;1020;49;1808
07;2020-S39;2;1;3;678;870;59;1548
07;2020-S39;0;2;2;360;382;69;742
07;2020-S39;0;1;1;231;190;79;421
07;2020-S39;0;0;0;114;67;89;181
07;2020-S39;0;0;0;24;11;90;35
07;2020-S39;6;8;14;4671;5290;0;9961
08;2020-S39;0;0;0;2715.22592983026;2997.75551488675;09;5712.98144471701
08;2020-S39;0;1;1;2778.51901080978;3160.9156459093;19;5939.43465671908
08;2020-S39;6;1;7;2080.8882988764;1718.16634315323;29;3799.05464202964
08;2020-S39;6;2;8;2701.8582062647;1896.52641413317;39;4598.38462039786
08;2020-S39;2;2;4;3151.45861023308;2460.52498233809;49;5611.98359257117
08;2020-S39;5;4;9;2620.29868333099;2422.23566154656;59;5042.53434487755
08;2020-S39;1;2;3;1621.44173420671;1438.58325779464;69;3060.02499200135
08;2020-S39;3;1;4;626.575909335673;526.358467843651;79;1152.93437717932
08;2020-S39;0;0;0;205.018522985054;140.993639349697;89;346.012162334751
08;2020-S39;0;0;0;50.0325684687745;20.62259870351;90;70.6551671722846
08;2020-S39;23;13;36;18551.3174743414;16782.6825256586;0;35334
11;2020-S39;191;215;423;783071;811785;09;1594856
11;2020-S39;1238;1168;2450;761456;784653;19;1546109
11;2020-S39;3282;2839;6129;850145;801772;29;1651917
11;2020-S39;2263;2147;4412;914360;843488;39;1757848
11;2020-S39;1633;1485;3120;845609;826202;49;1671811
11;2020-S39;1479;1228;2709;793566;745070;59;1538636
11;2020-S39;770;755;1525;628649;549192;69;1177841
11;2020-S39;347;341;689;434606;358356;79;792962
11;2020-S39;196;179;375;261425;162933;89;424358
11;2020-S39;98;49;147;89253;32619;90;121872
11;2020-S39;11507;10421;22020;6362140;5916070;0;12278210
24;2020-S39;22;12;35;139720;144686;09;284406
24;2020-S39;93;96;195;152979;161185;19;314164
24;2020-S39;204;156;360;122237;126536;29;248773
24;2020-S39;133;101;234;150359;142009;39;292368
24;2020-S39;97;90;187;161829;158758;49;320587
24;2020-S39;105;81;186;172552;168011;59;340563
24;2020-S39;61;63;124;172509;158177;69;330686
24;2020-S39;48;64;112;129428;110593;79;240021
24;2020-S39;34;30;64;87342;56882;89;144224
24;2020-S39;20;7;27;31210;12071;90;43281
24;2020-S39;817;700;1524;1320165;1238908;0;2559073
27;2020-S39;27;40;68;143373;149679;09;293052
27;2020-S39;127;149;279;160962;173003;19;333965
27;2020-S39;224;211;435;133746;142254;29;276000
27;2020-S39;139;98;238;160004;155407;39;315411
27;2020-S39;133;96;229;172333;169564;49;341897
27;2020-S39;127;118;245;189979;183788;59;373767
27;2020-S39;87;66;153;192591;178206;69;370797
27;2020-S39;54;53;107;146876;127546;79;274422
27;2020-S39;38;30;68;96896;61575;89;158471
27;2020-S39;14;4;18;33148;12109;90;45257
27;2020-S39;970;866;1841;1429908;1353131;0;2783039
28;2020-S39;63;46;111;180735;186856;09;367591
28;2020-S39;194;189;393;200125;213621;19;413746
28;2020-S39;346;296;642;168922;173007;29;341929
28;2020-S39;231;203;435;196628;188487;39;385115
28;2020-S39;192;178;370;205396;201699;49;407095
28;2020-S39;168;142;310;222002;213866;59;435868
28;2020-S39;123;111;234;224688;203758;69;428446
28;2020-S39;64;79;143;163192;135543;79;298735
28;2020-S39;79;34;113;109691;65377;89;175068
28;2020-S39;49;17;66;37222;12685;90;49907
28;2020-S39;1509;1295;2817;1708601;1594899;0;3303500
32;2020-S39;117;126;244;358062;373689;09;731751
32;2020-S39;790;737;1530;387045;406742;19;793787
32;2020-S39;1157;1162;2326;342304;348587;29;690891
32;2020-S39;589;515;1108;382485;369972;39;752457
32;2020-S39;596;454;1054;382510;376716;49;759226
32;2020-S39;506;477;986;386937;376527;59;763464
32;2020-S39;317;262;581;371211;330938;69;702149
32;2020-S39;178;173;351;250542;201459;79;452001
32;2020-S39;128;88;217;163399;89786;89;253185
32;2020-S39;55;21;76;48384;15367;90;63751
32;2020-S39;4434;4018;8477;3072879;2889783;0;5962662
44;2020-S39;32;29;61;291525;306839;09;598364
44;2020-S39;187;166;355;320255;339504;19;659759
44;2020-S39;286;324;610;302020;314428;29;616448
44;2020-S39;163;150;313;342222;333292;39;675514
44;2020-S39;136;121;257;349727;344491;49;694218
44;2020-S39;134;121;255;381371;373239;59;754610
44;2020-S39;99;90;189;367165;335850;69;703015
44;2020-S39;41;42;83;250387;215436;79;465823
44;2020-S39;34;27;61;170825;105192;89;276017
44;2020-S39;23;7;30;51248;16731;90;67979
44;2020-S39;1135;1077;2214;2826745;2685002;0;5511747
52;2020-S39;21;27;49;213594;223900;09;437494
52;2020-S39;244;219;467;240818;255197;19;496015
52;2020-S39;316;325;642;197010;200630;29;397640
52;2020-S39;159;151;310;231204;224885;39;456089
52;2020-S39;163;152;315;243874;243418;49;487292
52;2020-S39;127;126;253;244100;239116;59;483216
52;2020-S39;89;72;161;241796;221345;69;463141
52;2020-S39;57;57;114;177805;149903;79;327708
52;2020-S39;41;31;72;119561;75822;89;195383
52;2020-S39;21;6;27;42559;15260;90;57819
52;2020-S39;1238;1166;2410;1952321;1849476;0;3801797
53;2020-S39;25;29;55;173813;182358;09;356171
53;2020-S39;197;186;385;202720;214740;19;417460
53;2020-S39;330;343;679;163116;173196;29;336312
53;2020-S39;121;126;247;190526;187674;39;378200
53;2020-S39;121;97;218;212098;212015;49;424113
53;2020-S39;112;107;219;223699;219176;59;442875
53;2020-S39;52;53;105;227435;209274;69;436709
53;2020-S39;33;25;58;169992;140910;79;310902
53;2020-S39;28;18;46;118117;69883;89;188000
53;2020-S39;15;8;25;37370;12267;90;49637
53;2020-S39;1034;992;2037;1718886;1621493;0;3340379
75;2020-S39;61;64;126;293104;305291;09;598395
75;2020-S39;332;377;713;337141;357785;19;694926
75;2020-S39;534;577;1111;295024;300618;29;595642
75;2020-S39;284;285;569;347871;331233;39;679104
75;2020-S39;283;231;514;384742;372771;49;757513
75;2020-S39;235;210;445;413361;390880;59;804241
75;2020-S39;141;171;313;425623;384060;69;809683
75;2020-S39;91;89;180;325086;276298;79;601384
75;2020-S39;69;39;108;213986;139308;89;353294
75;2020-S39;53;13;66;77600;28200;90;105800
75;2020-S39;2084;2058;4148;3113538;2886444;0;5999982
76;2020-S39;73;86;164;305956;318589;09;624545
76;2020-S39;606;678;1297;338942;356969;19;695911
76;2020-S39;960;1029;1994;316210;319570;29;635780
76;2020-S39;489;433;922;356758;337587;39;694345
76;2020-S39;470;392;862;376541;363812;49;740353
76;2020-S39;420;380;800;402608;383750;59;786358
76;2020-S39;246;245;491;394889;358997;69;753886
76;2020-S39;130;176;307;308664;263806;79;572470
76;2020-S39;128;82;210;195838;129272;89;325110
76;2020-S39;89;24;113;69372;26728;90;96100
76;2020-S39;3618;3527;7169;3065778;2859080;0;5924858
84;2020-S39;105;103;211;459549;481088;09;940637
84;2020-S39;755;733;1496;487711;511905;19;999616
84;2020-S39;1346;1380;2729;443824;451094;29;894918
84;2020-S39;727;634;1362;512522;493262;39;1005784
84;2020-S39;705;611;1318;520248;515106;49;1035354
84;2020-S39;624;561;1185;529611;514848;59;1044459
84;2020-S39;337;347;684;486720;439940;69;926660
84;2020-S39;216;239;455;372151;315211;79;687362
84;2020-S39;164;101;265;237198;150524;89;387722
84;2020-S39;92;33;125;81185;28680;90;109865
84;2020-S39;5072;4743;9833;4130719;3901658;0;8032377
93;2020-S39;79;86;166;268834;283093;09;551927
93;2020-S39;398;373;774;280751;296087;19;576838
93;2020-S39;687;577;1266;254404;255552;29;509956
93;2020-S39;507;438;945;310704;288398;39;599102
93;2020-S39;506;428;934;325559;305827;49;631386
93;2020-S39;464;431;897;353104;325389;59;678493
93;2020-S39;286;312;598;336327;296459;69;632786
93;2020-S39;168;179;348;279820;229699;79;509519
93;2020-S39;143;94;239;171274;113716;89;284990
93;2020-S39;98;28;126;58896;21758;90;80654
93;2020-S39;3338;2947;6296;2639673;2415978;0;5055651
94;2020-S39;2;3;5;16311;17433;09;33744
94;2020-S39;12;15;27;16679;18132;19;34811
94;2020-S39;22;18;40;16782;16579;29;33361
94;2020-S39;8;12;20;23044;20580;39;43624
94;2020-S39;8;12;20;23065;22140;49;45205
94;2020-S39;19;12;31;24549;23421;59;47970
94;2020-S39;12;11;23;23212;21883;69;45095
94;2020-S39;5;7;12;19544;17141;79;36685
94;2020-S39;3;3;6;11227;8178;89;19405
94;2020-S39;1;1;2;3332;1447;90;4779
94;2020-S39;92;94;186;177745;166934;0;344679
01;2020-S40;5;6;11;19979;20155;09;40134
01;2020-S40;49;52;101;24994;25489;19;50483
01;2020-S40;59;37;96;17868;16690;29;34558
01;2020-S40;71;43;114;22328;14821;39;37149
01;2020-S40;78;59;137;28652;20276;49;48928
01;2020-S40;90;67;157;33264;27260;59;60524
01;2020-S40;50;58;108;27135;23978;69;51113
01;2020-S40;29;25;54;18401;14661;79;33062
01;2020-S40;10;10;20;9633;6375;89;16008
01;2020-S40;5;5;10;3410;1510;90;4920
01;2020-S40;446;362;808;205664;171215;0;376879
02;2020-S40;2;3;5;16881;17110;09;33991
02;2020-S40;24;20;44;21410;21604;19;43014
02;2020-S40;28;25;53;16017;15479;29;31496
02;2020-S40;45;25;70;19825;14455;39;34280
02;2020-S40;25;25;51;24719;18248;49;42967
02;2020-S40;34;22;56;34361;28310;59;62671
02;2020-S40;12;10;22;28061;24495;69;52556
02;2020-S40;10;9;19;18231;15278;79;33509
02;2020-S40;4;2;6;11090;7677;89;18767
02;2020-S40;2;1;3;3992;1506;90;5498
02;2020-S40;186;142;329;194587;164162;0;358749
03;2020-S40;2;3;5;31123;30920;09;62043
03;2020-S40;25;18;44;29370;29268;19;58638
03;2020-S40;11;14;29;21458;18963;29;40421
03;2020-S40;16;11;28;21276;18326;39;39602
03;2020-S40;10;13;23;18164;16593;49;34757
03;2020-S40;12;11;23;13469;13557;59;27026
03;2020-S40;4;8;13;8776;8670;69;17446
03;2020-S40;4;1;5;3777;3591;79;7368
03;2020-S40;0;0;0;1649;1072;89;2721
03;2020-S40;0;0;0;485;184;90;669
03;2020-S40;84;79;170;149547;141144;0;290691
04;2020-S40;10;20;30;60314;61377;09;121691
04;2020-S40;41;38;79;66065;68387;19;134452
04;2020-S40;37;27;64;51059;47156;29;98215
04;2020-S40;33;25;58;58788;45780;39;104568
04;2020-S40;39;19;58;61408;52207;49;113615
04;2020-S40;27;33;60;64838;60759;59;125597
04;2020-S40;14;14;28;47008;42843;69;89851
04;2020-S40;6;10;16;25509;21184;79;46693
04;2020-S40;4;3;7;13168;7647;89;20815
04;2020-S40;0;0;0;3209;1253;90;4462
04;2020-S40;211;189;400;451366;408593;0;859959
05;2020-S40;0;0;0;362.366008612902;341.338819562748;09;703.704828175651
05;2020-S40;0;0;0;353.376145114279;370.349735405642;19;723.725880519921
05;2020-S40;0;0;0;218.593559489256;256.539602589476;29;475.133162078732
05;2020-S40;0;0;0;404.225408693299;360.321910454353;39;764.547319147651
05;2020-S40;0;0;0;520.067953604221;497.108383964256;49;1017.17633756848
05;2020-S40;0;0;0;468.146063921917;510.087601910415;59;978.233665832332
05;2020-S40;0;0;0;340.368470050554;334.366842191253;69;674.735312241807
05;2020-S40;0;0;0;212.598666888387;192.597753227106;79;405.196420115493
05;2020-S40;0;0;0;148.727797095705;61.8681715431829;89;210.595968638888
05;2020-S40;0;0;0;32.9601271090696;10.9909785719784;90;43.9511056810479
05;2020-S40;0;0;0;3061.43020057959;2935.56979942041;0;5997
06;2020-S40;2;0;2;42583;42380;09;84963
06;2020-S40;3;5;9;33369;31925;19;65294
06;2020-S40;14;8;22;21571;15080;29;36651
06;2020-S40;19;8;27;21550;16147;39;37697
06;2020-S40;19;10;29;14193;13939;49;28132
06;2020-S40;6;8;14;7171;7597;59;14768
06;2020-S40;2;4;6;3629;4117;69;7746
06;2020-S40;2;3;5;1577;1457;79;3034
06;2020-S40;0;0;0;531;474;89;1005
06;2020-S40;0;0;0;88;93;90;181
06;2020-S40;67;46;114;146262;133209;0;279471
07;2020-S40;0;0;0;485;549;09;1034
07;2020-S40;1;0;1;403;432;19;835
07;2020-S40;1;1;2;764;841;29;1605
07;2020-S40;0;0;0;824;928;39;1752
07;2020-S40;3;2;5;788;1020;49;1808
07;2020-S40;0;1;1;678;870;59;1548
07;2020-S40;0;0;0;360;382;69;742
07;2020-S40;0;1;1;231;190;79;421
07;2020-S40;0;0;0;114;67;89;181
07;2020-S40;0;0;0;24;11;90;35
07;2020-S40;5;5;10;4671;5290;0;9961
08;2020-S40;0;0;0;2715.22592983026;2997.75551488675;09;5712.98144471701
08;2020-S40;0;0;0;2778.51901080978;3160.9156459093;19;5939.43465671908
08;2020-S40;1;1;2;2080.8882988764;1718.16634315323;29;3799.05464202964
08;2020-S40;3;3;6;2701.8582062647;1896.52641413317;39;4598.38462039786
08;2020-S40;2;2;4;3151.45861023308;2460.52498233809;49;5611.98359257117
08;2020-S40;8;4;12;2620.29868333099;2422.23566154656;59;5042.53434487755
08;2020-S40;3;4;7;1621.44173420671;1438.58325779464;69;3060.02499200135
08;2020-S40;1;0;1;626.575909335673;526.358467843651;79;1152.93437717932
08;2020-S40;0;1;1;205.018522985054;140.993639349697;89;346.012162334751
08;2020-S40;0;0;0;50.0325684687745;20.62259870351;90;70.6551671722846
08;2020-S40;18;15;33;18551.3174743414;16782.6825256586;0;35334
11;2020-S40;217;211;460;783071;811785;09;1594856
11;2020-S40;1417;1342;2835;761456;784653;19;1546109
11;2020-S40;3612;3350;6971;850145;801772;29;1651917
11;2020-S40;2559;2334;4897;914360;843488;39;1757848
11;2020-S40;1966;1752;3725;845609;826202;49;1671811
11;2020-S40;1653;1473;3130;793566;745070;59;1538636
11;2020-S40;913;869;1794;628649;549192;69;1177841
11;2020-S40;381;432;814;434606;358356;79;792962
11;2020-S40;236;187;423;261425;162933;89;424358
11;2020-S40;130;56;186;89253;32619;90;121872
11;2020-S40;13090;12017;25264;6362140;5916070;0;12278210
24;2020-S40;10;15;26;139720;144686;09;284406
24;2020-S40;118;124;243;152979;161185;19;314164
24;2020-S40;180;177;358;122237;126536;29;248773
24;2020-S40;147;109;256;150359;142009;39;292368
24;2020-S40;141;116;257;161829;158758;49;320587
24;2020-S40;130;111;241;172552;168011;59;340563
24;2020-S40;86;86;172;172509;158177;69;330686
24;2020-S40;51;46;97;129428;110593;79;240021
24;2020-S40;30;16;46;87342;56882;89;144224
24;2020-S40;8;1;9;31210;12071;90;43281
24;2020-S40;901;801;1705;1320165;1238908;0;2559073
27;2020-S40;33;21;57;143373;149679;09;293052
27;2020-S40;133;140;275;160962;173003;19;333965
27;2020-S40;191;179;370;133746;142254;29;276000
27;2020-S40;133;129;262;160004;155407;39;315411
27;2020-S40;145;119;264;172333;169564;49;341897
27;2020-S40;147;131;278;189979;183788;59;373767
27;2020-S40;106;74;180;192591;178206;69;370797
27;2020-S40;66;66;132;146876;127546;79;274422
27;2020-S40;47;23;70;96896;61575;89;158471
27;2020-S40;30;10;40;33148;12109;90;45257
27;2020-S40;1031;892;1928;1429908;1353131;0;2783039
28;2020-S40;40;44;87;180735;186856;09;367591
28;2020-S40;189;189;385;200125;213621;19;413746
28;2020-S40;353;303;657;168922;173007;29;341929
28;2020-S40;264;180;444;196628;188487;39;385115
28;2020-S40;242;176;418;205396;201699;49;407095
28;2020-S40;218;180;398;222002;213866;59;435868
28;2020-S40;143;118;261;224688;203758;69;428446
28;2020-S40;86;107;193;163192;135543;79;298735
28;2020-S40;72;45;117;109691;65377;89;175068
28;2020-S40;41;8;49;37222;12685;90;49907
28;2020-S40;1649;1351;3011;1708601;1594899;0;3303500
32;2020-S40;110;110;220;358062;373689;09;731751
32;2020-S40;719;686;1406;387045;406742;19;793787
32;2020-S40;1061;1046;2111;342304;348587;29;690891
32;2020-S40;687;576;1264;382485;369972;39;752457
32;2020-S40;718;593;1312;382510;376716;49;759226
32;2020-S40;586;518;1108;386937;376527;59;763464
32;2020-S40;370;362;734;371211;330938;69;702149
32;2020-S40;229;199;430;250542;201459;79;452001
32;2020-S40;173;115;289;163399;89786;89;253185
32;2020-S40;108;38;147;48384;15367;90;63751
32;2020-S40;4762;4244;9024;3072879;2889783;0;5962662
44;2020-S40;35;27;62;291525;306839;09;598364
44;2020-S40;169;180;349;320255;339504;19;659759
44;2020-S40;295;334;630;302020;314428;29;616448
44;2020-S40;200;168;368;342222;333292;39;675514
44;2020-S40;201;174;375;349727;344491;49;694218
44;2020-S40;164;163;327;381371;373239;59;754610
44;2020-S40;108;99;208;367165;335850;69;703015
44;2020-S40;73;79;153;250387;215436;79;465823
44;2020-S40;45;29;74;170825;105192;89;276017
44;2020-S40;28;7;35;51248;16731;90;67979
44;2020-S40;1318;1260;2581;2826745;2685002;0;5511747
52;2020-S40;26;16;46;213594;223900;09;437494
52;2020-S40;175;190;373;240818;255197;19;496015
52;2020-S40;316;362;679;197010;200630;29;397640
52;2020-S40;203;199;403;231204;224885;39;456089
52;2020-S40;195;167;362;243874;243418;49;487292
52;2020-S40;144;148;292;244100;239116;59;483216
52;2020-S40;94;100;194;241796;221345;69;463141
52;2020-S40;78;74;152;177805;149903;79;327708
52;2020-S40;31;31;62;119561;75822;89;195383
52;2020-S40;10;3;13;42559;15260;90;57819
52;2020-S40;1272;1290;2576;1952321;1849476;0;3801797
53;2020-S40;17;27;45;173813;182358;09;356171
53;2020-S40;142;178;322;202720;214740;19;417460
53;2020-S40;273;277;563;163116;173196;29;336312
53;2020-S40;141;125;266;190526;187674;39;378200
53;2020-S40;106;108;214;212098;212015;49;424113
53;2020-S40;104;104;208;223699;219176;59;442875
53;2020-S40;63;66;129;227435;209274;69;436709
53;2020-S40;51;52;103;169992;140910;79;310902
53;2020-S40;39;25;64;118117;69883;89;188000
53;2020-S40;23;17;41;37370;12267;90;49637
53;2020-S40;959;979;1955;1718886;1621493;0;3340379
75;2020-S40;48;48;99;293104;305291;09;598395
75;2020-S40;307;302;615;337141;357785;19;694926
75;2020-S40;481;504;986;295024;300618;29;595642
75;2020-S40;302;289;592;347871;331233;39;679104
75;2020-S40;264;229;493;384742;372771;49;757513
75;2020-S40;258;216;476;413361;390880;59;804241
75;2020-S40;148;150;298;425623;384060;69;809683
75;2020-S40;92;95;187;325086;276298;79;601384
75;2020-S40;65;69;134;213986;139308;89;353294
75;2020-S40;62;15;77;77600;28200;90;105800
75;2020-S40;2029;1917;3959;3113538;2886444;0;5999982
76;2020-S40;68;75;147;305956;318589;09;624545
76;2020-S40;541;616;1176;338942;356969;19;695911
76;2020-S40;901;819;1723;316210;319570;29;635780
76;2020-S40;561;454;1018;356758;337587;39;694345
76;2020-S40;536;477;1015;376541;363812;49;740353
76;2020-S40;474;422;896;402608;383750;59;786358
76;2020-S40;293;270;563;394889;358997;69;753886
76;2020-S40;166;167;333;308664;263806;79;572470
76;2020-S40;168;75;243;195838;129272;89;325110
76;2020-S40;141;44;186;69372;26728;90;96100
76;2020-S40;3852;3422;7306;3065778;2859080;0;5924858
84;2020-S40;150;131;281;459549;481088;09;940637
84;2020-S40;910;878;1804;487711;511905;19;999616
84;2020-S40;1480;1369;2851;443824;451094;29;894918
84;2020-S40;831;799;1630;512522;493262;39;1005784
84;2020-S40;935;754;1691;520248;515106;49;1035354
84;2020-S40;739;714;1455;529611;514848;59;1044459
84;2020-S40;386;374;760;486720;439940;69;926660
84;2020-S40;251;242;493;372151;315211;79;687362
84;2020-S40;193;131;325;237198;150524;89;387722
84;2020-S40;103;55;159;81185;28680;90;109865
84;2020-S40;5980;5449;11455;4130719;3901658;0;8032377
93;2020-S40;57;78;135;268834;283093;09;551927
93;2020-S40;396;364;762;280751;296087;19;576838
93;2020-S40;668;589;1257;254404;255552;29;509956
93;2020-S40;489;402;891;310704;288398;39;599102
93;2020-S40;486;426;913;325559;305827;49;631386
93;2020-S40;501;415;918;353104;325389;59;678493
93;2020-S40;290;307;598;336327;296459;69;632786
93;2020-S40;171;211;383;279820;229699;79;509519
93;2020-S40;122;90;213;171274;113716;89;284990
93;2020-S40;113;28;141;58896;21758;90;80654
93;2020-S40;3294;2911;6214;2639673;2415978;0;5055651
94;2020-S40;0;1;1;16311;17433;09;33744
94;2020-S40;6;10;16;16679;18132;19;34811
94;2020-S40;14;12;26;16782;16579;29;33361
94;2020-S40;18;12;30;23044;20580;39;43624
94;2020-S40;10;6;16;23065;22140;49;45205
94;2020-S40;9;12;21;24549;23421;59;47970
94;2020-S40;5;13;18;23212;21883;69;45095
94;2020-S40;7;2;9;19544;17141;79;36685
94;2020-S40;2;1;3;11227;8178;89;19405
94;2020-S40;4;0;4;3332;1447;90;4779
94;2020-S40;75;69;144;177745;166934;0;344679
01;2020-S41;4;7;11;19979;20155;09;40134
01;2020-S41;36;33;69;24994;25489;19;50483
01;2020-S41;38;13;51;17868;16690;29;34558
01;2020-S41;55;17;72;22328;14821;39;37149
01;2020-S41;60;38;98;28652;20276;49;48928
01;2020-S41;55;64;119;33264;27260;59;60524
01;2020-S41;49;47;96;27135;23978;69;51113
01;2020-S41;21;24;45;18401;14661;79;33062
01;2020-S41;11;17;28;9633;6375;89;16008
01;2020-S41;2;2;4;3410;1510;90;4920
01;2020-S41;331;262;593;205664;171215;0;376879
02;2020-S41;3;4;7;16881;17110;09;33991
02;2020-S41;29;21;50;21410;21604;19;43014
02;2020-S41;29;28;57;16017;15479;29;31496
02;2020-S41;47;32;79;19825;14455;39;34280
02;2020-S41;45;41;87;24719;18248;49;42967
02;2020-S41;54;35;89;34361;28310;59;62671
02;2020-S41;37;29;67;28061;24495;69;52556
02;2020-S41;14;14;28;18231;15278;79;33509
02;2020-S41;12;3;15;11090;7677;89;18767
02;2020-S41;2;1;3;3992;1506;90;5498
02;2020-S41;272;208;482;194587;164162;0;358749
03;2020-S41;4;3;7;31123;30920;09;62043
03;2020-S41;11;4;15;29370;29268;19;58638
03;2020-S41;21;11;33;21458;18963;29;40421
03;2020-S41;10;6;16;21276;18326;39;39602
03;2020-S41;12;9;21;18164;16593;49;34757
03;2020-S41;16;9;25;13469;13557;59;27026
03;2020-S41;5;2;7;8776;8670;69;17446
03;2020-S41;0;0;0;3777;3591;79;7368
03;2020-S41;0;0;0;1649;1072;89;2721
03;2020-S41;0;0;0;485;184;90;669
03;2020-S41;79;44;124;149547;141144;0;290691
04;2020-S41;4;4;8;60314;61377;09;121691
04;2020-S41;36;39;75;66065;68387;19;134452
04;2020-S41;33;39;72;51059;47156;29;98215
04;2020-S41;21;22;43;58788;45780;39;104568
04;2020-S41;24;26;50;61408;52207;49;113615
04;2020-S41;23;22;45;64838;60759;59;125597
04;2020-S41;15;7;22;47008;42843;69;89851
04;2020-S41;5;5;10;25509;21184;79;46693
04;2020-S41;2;0;2;13168;7647;89;20815
04;2020-S41;1;0;1;3209;1253;90;4462
04;2020-S41;164;164;328;451366;408593;0;859959
05;2020-S41;0;0;0;362.366008612902;341.338819562748;09;703.704828175651
05;2020-S41;0;0;0;353.376145114279;370.349735405642;19;723.725880519921
05;2020-S41;0;0;0;218.593559489256;256.539602589476;29;475.133162078732
05;2020-S41;0;0;0;404.225408693299;360.321910454353;39;764.547319147651
05;2020-S41;0;0;0;520.067953604221;497.108383964256;49;1017.17633756848
05;2020-S41;1;1;2;468.146063921917;510.087601910415;59;978.233665832332
05;2020-S41;0;0;0;340.368470050554;334.366842191253;69;674.735312241807
05;2020-S41;0;0;0;212.598666888387;192.597753227106;79;405.196420115493
05;2020-S41;1;0;1;148.727797095705;61.8681715431829;89;210.595968638888
05;2020-S41;0;0;0;32.9601271090696;10.9909785719784;90;43.9511056810479
05;2020-S41;2;1;3;3061.43020057959;2935.56979942041;0;5997
06;2020-S41;0;1;1;42583;42380;09;84963
06;2020-S41;6;8;14;33369;31925;19;65294
06;2020-S41;19;11;30;21571;15080;29;36651
06;2020-S41;8;12;20;21550;16147;39;37697
06;2020-S41;16;16;32;14193;13939;49;28132
06;2020-S41;7;6;13;7171;7597;59;14768
06;2020-S41;2;6;8;3629;4117;69;7746
06;2020-S41;0;1;1;1577;1457;79;3034
06;2020-S41;0;1;1;531;474;89;1005
06;2020-S41;0;0;0;88;93;90;181
06;2020-S41;58;62;121;146262;133209;0;279471
07;2020-S41;0;0;0;485;549;09;1034
07;2020-S41;0;0;0;403;432;19;835
07;2020-S41;0;1;1;764;841;29;1605
07;2020-S41;0;0;0;824;928;39;1752
07;2020-S41;0;1;1;788;1020;49;1808
07;2020-S41;0;0;0;678;870;59;1548
07;2020-S41;0;1;1;360;382;69;742
07;2020-S41;0;0;0;231;190;79;421
07;2020-S41;0;0;0;114;67;89;181
07;2020-S41;0;0;0;24;11;90;35
07;2020-S41;0;3;3;4671;5290;0;9961
08;2020-S41;1;1;2;2715.22592983026;2997.75551488675;09;5712.98144471701
08;2020-S41;2;1;3;2778.51901080978;3160.9156459093;19;5939.43465671908
08;2020-S41;5;5;10;2080.8882988764;1718.16634315323;29;3799.05464202964
08;2020-S41;12;8;20;2701.8582062647;1896.52641413317;39;4598.38462039786
08;2020-S41;6;6;12;3151.45861023308;2460.52498233809;49;5611.98359257117
08;2020-S41;10;2;12;2620.29868333099;2422.23566154656;59;5042.53434487755
08;2020-S41;3;1;4;1621.44173420671;1438.58325779464;69;3060.02499200135
08;2020-S41;1;1;2;626.575909335673;526.358467843651;79;1152.93437717932
08;2020-S41;0;0;0;205.018522985054;140.993639349697;89;346.012162334751
08;2020-S41;0;0;0;50.0325684687745;20.62259870351;90;70.6551671722846
08;2020-S41;40;25;65;18551.3174743414;16782.6825256586;0;35334
11;2020-S41;326;368;753;783071;811785;09;1594856
11;2020-S41;2128;2090;4341;761456;784653;19;1546109
11;2020-S41;5092;4425;9545;850145;801772;29;1651917
11;2020-S41;3799;3430;7250;914360;843488;39;1757848
11;2020-S41;3205;2715;5936;845609;826202;49;1671811
11;2020-S41;2582;2346;4947;793566;745070;59;1538636
11;2020-S41;1531;1475;3031;628649;549192;69;1177841
11;2020-S41;604;654;1259;434606;358356;79;792962
11;2020-S41;359;294;654;261425;162933;89;424358
11;2020-S41;189;63;253;89253;32619;90;121872
11;2020-S41;19822;17869;38000;6362140;5916070;0;12278210
24;2020-S41;35;31;66;139720;144686;09;284406
24;2020-S41;173;179;357;152979;161185;19;314164
24;2020-S41;271;228;499;122237;126536;29;248773
24;2020-S41;292;224;516;150359;142009;39;292368
24;2020-S41;218;193;411;161829;158758;49;320587
24;2020-S41;205;187;392;172552;168011;59;340563
24;2020-S41;153;123;276;172509;158177;69;330686
24;2020-S41;56;80;136;129428;110593;79;240021
24;2020-S41;39;30;69;87342;56882;89;144224
24;2020-S41;15;7;22;31210;12071;90;43281
24;2020-S41;1457;1283;2745;1320165;1238908;0;2559073
27;2020-S41;34;41;75;143373;149679;09;293052
27;2020-S41;171;215;387;160962;173003;19;333965
27;2020-S41;266;252;518;133746;142254;29;276000
27;2020-S41;240;211;451;160004;155407;39;315411
27;2020-S41;241;237;478;172333;169564;49;341897
27;2020-S41;245;208;453;189979;183788;59;373767
27;2020-S41;178;158;336;192591;178206;69;370797
27;2020-S41;88;113;201;146876;127546;79;274422
27;2020-S41;69;56;125;96896;61575;89;158471
27;2020-S41;46;21;67;33148;12109;90;45257
27;2020-S41;1578;1512;3093;1429908;1353131;0;2783039
28;2020-S41;57;72;133;180735;186856;09;367591
28;2020-S41;304;294;604;200125;213621;19;413746
28;2020-S41;544;492;1036;168922;173007;29;341929
28;2020-S41;354;310;665;196628;188487;39;385115
28;2020-S41;339;301;640;205396;201699;49;407095
28;2020-S41;293;274;567;222002;213866;59;435868
28;2020-S41;230;209;439;224688;203758;69;428446
28;2020-S41;152;141;293;163192;135543;79;298735
28;2020-S41;127;68;195;109691;65377;89;175068
28;2020-S41;97;25;122;37222;12685;90;49907
28;2020-S41;2497;2186;4694;1708601;1594899;0;3303500
32;2020-S41;178;191;370;358062;373689;09;731751
32;2020-S41;1009;970;1983;387045;406742;19;793787
32;2020-S41;1497;1332;2831;342304;348587;29;690891
32;2020-S41;1207;1081;2290;382485;369972;39;752457
32;2020-S41;1127;1009;2138;382510;376716;49;759226
32;2020-S41;980;872;1854;386937;376527;59;763464
32;2020-S41;596;561;1157;371211;330938;69;702149
32;2020-S41;383;328;712;250542;201459;79;452001
32;2020-S41;308;198;507;163399;89786;89;253185
32;2020-S41;137;57;194;48384;15367;90;63751
32;2020-S41;7423;6600;14038;3072879;2889783;0;5962662
44;2020-S41;57;56;113;291525;306839;09;598364
44;2020-S41;338;369;709;320255;339504;19;659759
44;2020-S41;556;570;1126;302020;314428;29;616448
44;2020-S41;412;388;800;342222;333292;39;675514
44;2020-S41;389;362;751;349727;344491;49;694218
44;2020-S41;370;340;711;381371;373239;59;754610
44;2020-S41;238;243;481;367165;335850;69;703015
44;2020-S41;140;132;272;250387;215436;79;465823
44;2020-S41;76;56;132;170825;105192;89;276017
44;2020-S41;52;15;67;51248;16731;90;67979
44;2020-S41;2628;2533;5165;2826745;2685002;0;5511747
52;2020-S41;41;41;88;213594;223900;09;437494
52;2020-S41;267;259;534;240818;255197;19;496015
52;2020-S41;448;435;884;197010;200630;29;397640
52;2020-S41;318;295;615;231204;224885;39;456089
52;2020-S41;260;292;555;243874;243418;49;487292
52;2020-S41;261;274;535;244100;239116;59;483216
52;2020-S41;186;159;346;241796;221345;69;463141
52;2020-S41;119;124;243;177805;149903;79;327708
52;2020-S41;62;48;110;119561;75822;89;195383
52;2020-S41;23;8;31;42559;15260;90;57819
52;2020-S41;1986;1935;3942;1952321;1849476;0;3801797
53;2020-S41;30;32;63;173813;182358;09;356171
53;2020-S41;221;190;414;202720;214740;19;417460
53;2020-S41;319;324;651;163116;173196;29;336312
53;2020-S41;178;148;326;190526;187674;39;378200
53;2020-S41;200;158;358;212098;212015;49;424113
53;2020-S41;165;161;326;223699;219176;59;442875
53;2020-S41;120;128;248;227435;209274;69;436709
53;2020-S41;57;56;113;169992;140910;79;310902
53;2020-S41;57;29;86;118117;69883;89;188000
53;2020-S41;24;15;39;37370;12267;90;49637
53;2020-S41;1371;1241;2624;1718886;1621493;0;3340379
75;2020-S41;58;64;124;293104;305291;09;598395
75;2020-S41;321;370;696;337141;357785;19;694926
75;2020-S41;606;646;1252;295024;300618;29;595642
75;2020-S41;395;402;798;347871;331233;39;679104
75;2020-S41;389;356;746;384742;372771;49;757513
75;2020-S41;380;345;725;413361;390880;59;804241
75;2020-S41;186;192;379;425623;384060;69;809683
75;2020-S41;121;119;240;325086;276298;79;601384
75;2020-S41;94;72;166;213986;139308;89;353294
75;2020-S41;77;19;96;77600;28200;90;105800
75;2020-S41;2627;2588;5225;3113538;2886444;0;5999982
76;2020-S41;114;126;244;305956;318589;09;624545
76;2020-S41;696;766;1483;338942;356969;19;695911
76;2020-S41;1217;970;2191;316210;319570;29;635780
76;2020-S41;892;808;1701;356758;337587;39;694345
76;2020-S41;946;760;1708;376541;363812;49;740353
76;2020-S41;866;774;1640;402608;383750;59;786358
76;2020-S41;528;464;992;394889;358997;69;753886
76;2020-S41;297;310;607;308664;263806;79;572470
76;2020-S41;260;173;433;195838;129272;89;325110
76;2020-S41;193;42;235;69372;26728;90;96100
76;2020-S41;6013;5197;11242;3065778;2859080;0;5924858
84;2020-S41;240;237;477;459549;481088;09;940637
84;2020-S41;1403;1502;2919;487711;511905;19;999616
84;2020-S41;2071;1939;4013;443824;451094;29;894918
84;2020-S41;1677;1475;3155;512522;493262;39;1005784
84;2020-S41;1763;1443;3206;520248;515106;49;1035354
84;2020-S41;1446;1354;2800;529611;514848;59;1044459
84;2020-S41;773;764;1537;486720;439940;69;926660
84;2020-S41;527;476;1003;372151;315211;79;687362
84;2020-S41;433;279;712;237198;150524;89;387722
84;2020-S41;333;90;423;81185;28680;90;109865
84;2020-S41;10667;9560;20247;4130719;3901658;0;8032377
93;2020-S41;108;112;221;268834;283093;09;551927
93;2020-S41;523;527;1053;280751;296087;19;576838
93;2020-S41;838;754;1595;254404;255552;29;509956
93;2020-S41;665;589;1255;310704;288398;39;599102
93;2020-S41;704;577;1284;325559;305827;49;631386
93;2020-S41;650;586;1238;353104;325389;59;678493
93;2020-S41;391;420;811;336327;296459;69;632786
93;2020-S41;257;248;506;279820;229699;79;509519
93;2020-S41;219;143;362;171274;113716;89;284990
93;2020-S41;138;37;175;58896;21758;90;80654
93;2020-S41;4494;3997;8507;2639673;2415978;0;5055651
94;2020-S41;2;3;5;16311;17433;09;33744
94;2020-S41;13;9;23;16679;18132;19;34811
94;2020-S41;32;36;68;16782;16579;29;33361
94;2020-S41;34;21;55;23044;20580;39;43624
94;2020-S41;15;25;40;23065;22140;49;45205
94;2020-S41;19;20;39;24549;23421;59;47970
94;2020-S41;16;17;33;23212;21883;69;45095
94;2020-S41;12;16;28;19544;17141;79;36685
94;2020-S41;9;1;10;11227;8178;89;19405
94;2020-S41;1;2;3;3332;1447;90;4779
94;2020-S41;153;151;305;177745;166934;0;344679
01;2020-S42;2;1;3;19979;20155;09;40134
01;2020-S42;28;20;48;24994;25489;19;50483
01;2020-S42;19;10;29;17868;16690;29;34558
01;2020-S42;38;26;64;22328;14821;39;37149
01;2020-S42;45;29;74;28652;20276;49;48928
01;2020-S42;47;30;77;33264;27260;59;60524
01;2020-S42;21;28;49;27135;23978;69;51113
01;2020-S42;11;20;31;18401;14661;79;33062
01;2020-S42;5;10;15;9633;6375;89;16008
01;2020-S42;3;1;4;3410;1510;90;4920
01;2020-S42;220;175;396;205664;171215;0;376879
02;2020-S42;8;1;9;16881;17110;09;33991
02;2020-S42;50;38;89;21410;21604;19;43014
02;2020-S42;47;26;73;16017;15479;29;31496
02;2020-S42;48;32;80;19825;14455;39;34280
02;2020-S42;59;32;92;24719;18248;49;42967
02;2020-S42;63;58;121;34361;28310;59;62671
02;2020-S42;33;33;67;28061;24495;69;52556
02;2020-S42;16;9;25;18231;15278;79;33509
02;2020-S42;6;1;7;11090;7677;89;18767
02;2020-S42;2;0;2;3992;1506;90;5498
02;2020-S42;332;230;565;194587;164162;0;358749
03;2020-S42;1;6;7;31123;30920;09;62043
03;2020-S42;4;7;11;29370;29268;19;58638
03;2020-S42;14;6;20;21458;18963;29;40421
03;2020-S42;13;11;24;21276;18326;39;39602
03;2020-S42;7;9;16;18164;16593;49;34757
03;2020-S42;8;6;15;13469;13557;59;27026
03;2020-S42;7;5;12;8776;8670;69;17446
03;2020-S42;1;1;2;3777;3591;79;7368
03;2020-S42;0;2;2;1649;1072;89;2721
03;2020-S42;1;0;1;485;184;90;669
03;2020-S42;56;53;110;149547;141144;0;290691
04;2020-S42;10;5;15;60314;61377;09;121691
04;2020-S42;30;30;60;66065;68387;19;134452
04;2020-S42;31;35;66;51059;47156;29;98215
04;2020-S42;21;15;36;58788;45780;39;104568
04;2020-S42;33;26;59;61408;52207;49;113615
04;2020-S42;17;19;37;64838;60759;59;125597
04;2020-S42;16;16;32;47008;42843;69;89851
04;2020-S42;5;6;11;25509;21184;79;46693
04;2020-S42;3;2;5;13168;7647;89;20815
04;2020-S42;2;1;3;3209;1253;90;4462
04;2020-S42;168;155;324;451366;408593;0;859959
05;2020-S42;0;0;0;362.366008612902;341.338819562748;09;703.704828175651
05;2020-S42;0;0;0;353.376145114279;370.349735405642;19;723.725880519921
05;2020-S42;0;0;0;218.593559489256;256.539602589476;29;475.133162078732
05;2020-S42;0;0;0;404.225408693299;360.321910454353;39;764.547319147651
05;2020-S42;0;0;0;520.067953604221;497.108383964256;49;1017.17633756848
05;2020-S42;0;0;0;468.146063921917;510.087601910415;59;978.233665832332
05;2020-S42;0;0;0;340.368470050554;334.366842191253;69;674.735312241807
05;2020-S42;0;0;0;212.598666888387;192.597753227106;79;405.196420115493
05;2020-S42;1;0;1;148.727797095705;61.8681715431829;89;210.595968638888
05;2020-S42;0;0;0;32.9601271090696;10.9909785719784;90;43.9511056810479
05;2020-S42;1;0;1;3061.43020057959;2935.56979942041;0;5997
06;2020-S42;1;1;2;42583;42380;09;84963
06;2020-S42;9;6;15;33369;31925;19;65294
06;2020-S42;22;17;39;21571;15080;29;36651
06;2020-S42;18;18;36;21550;16147;39;37697
06;2020-S42;17;20;37;14193;13939;49;28132
06;2020-S42;9;9;18;7171;7597;59;14768
06;2020-S42;1;3;4;3629;4117;69;7746
06;2020-S42;0;1;1;1577;1457;79;3034
06;2020-S42;1;0;1;531;474;89;1005
06;2020-S42;0;0;0;88;93;90;181
06;2020-S42;78;75;153;146262;133209;0;279471
07;2020-S42;0;0;0;485;549;09;1034
07;2020-S42;1;0;1;403;432;19;835
07;2020-S42;0;1;1;764;841;29;1605
07;2020-S42;0;3;3;824;928;39;1752
07;2020-S42;0;2;2;788;1020;49;1808
07;2020-S42;1;2;3;678;870;59;1548
07;2020-S42;0;0;0;360;382;69;742
07;2020-S42;0;0;0;231;190;79;421
07;2020-S42;0;0;0;114;67;89;181
07;2020-S42;0;0;0;24;11;90;35
07;2020-S42;2;8;10;4671;5290;0;9961
08;2020-S42;0;0;0;2715.22592983026;2997.75551488675;09;5712.98144471701
08;2020-S42;3;0;3;2778.51901080978;3160.9156459093;19;5939.43465671908
08;2020-S42;1;3;4;2080.8882988764;1718.16634315323;29;3799.05464202964
08;2020-S42;5;4;9;2701.8582062647;1896.52641413317;39;4598.38462039786
08;2020-S42;6;1;7;3151.45861023308;2460.52498233809;49;5611.98359257117
08;2020-S42;1;5;6;2620.29868333099;2422.23566154656;59;5042.53434487755
08;2020-S42;2;3;5;1621.44173420671;1438.58325779464;69;3060.02499200135
08;2020-S42;1;2;3;626.575909335673;526.358467843651;79;1152.93437717932
08;2020-S42;0;0;0;205.018522985054;140.993639349697;89;346.012162334751
08;2020-S42;0;0;0;50.0325684687745;20.62259870351;90;70.6551671722846
08;2020-S42;19;18;37;18551.3174743414;16782.6825256586;0;35334
11;2020-S42;410;472;949;783071;811785;09;1594856
11;2020-S42;2670;2600;5447;761456;784653;19;1546109
11;2020-S42;5605;4530;10153;850145;801772;29;1651917
11;2020-S42;4709;4036;8777;914360;843488;39;1757848
11;2020-S42;4083;3485;7595;845609;826202;49;1671811
11;2020-S42;3301;2977;6292;793566;745070;59;1538636
11;2020-S42;2073;2001;4123;628649;549192;69;1177841
11;2020-S42;831;897;1729;434606;358356;79;792962
11;2020-S42;523;409;932;261425;162933;89;424358
11;2020-S42;324;102;427;89253;32619;90;121872
11;2020-S42;24536;21517;46452;6362140;5916070;0;12278210
24;2020-S42;25;33;59;139720;144686;09;284406
24;2020-S42;262;231;499;152979;161185;19;314164
24;2020-S42;406;377;783;122237;126536;29;248773
24;2020-S42;350;261;611;150359;142009;39;292368
24;2020-S42;380;316;696;161829;158758;49;320587
24;2020-S42;331;300;631;172552;168011;59;340563
24;2020-S42;202;211;415;172509;158177;69;330686
24;2020-S42;113;120;233;129428;110593;79;240021
24;2020-S42;116;76;192;87342;56882;89;144224
24;2020-S42;68;31;99;31210;12071;90;43281
24;2020-S42;2253;1956;4218;1320165;1238908;0;2559073
27;2020-S42;59;59;118;143373;149679;09;293052
27;2020-S42;325;368;696;160962;173003;19;333965
27;2020-S42;519;472;991;133746;142254;29;276000
27;2020-S42;431;399;830;160004;155407;39;315411
27;2020-S42;455;374;829;172333;169564;49;341897
27;2020-S42;480;403;883;189979;183788;59;373767
27;2020-S42;335;344;679;192591;178206;69;370797
27;2020-S42;204;186;390;146876;127546;79;274422
27;2020-S42;178;118;296;96896;61575;89;158471
27;2020-S42;123;38;161;33148;12109;90;45257
27;2020-S42;3109;2761;5873;1429908;1353131;0;2783039
28;2020-S42;66;74;145;180735;186856;09;367591
28;2020-S42;384;331;720;200125;213621;19;413746
28;2020-S42;604;520;1125;168922;173007;29;341929
28;2020-S42;523;438;962;196628;188487;39;385115
28;2020-S42;522;379;901;205396;201699;49;407095
28;2020-S42;452;409;862;222002;213866;59;435868
28;2020-S42;334;309;644;224688;203758;69;428446
28;2020-S42;191;216;407;163192;135543;79;298735
28;2020-S42;170;110;280;109691;65377;89;175068
28;2020-S42;128;28;156;37222;12685;90;49907
28;2020-S42;3374;2814;6202;1708601;1594899;0;3303500
32;2020-S42;322;327;651;358062;373689;09;731751
32;2020-S42;1512;1423;2939;387045;406742;19;793787
32;2020-S42;2043;1732;3778;342304;348587;29;690891
32;2020-S42;1831;1552;3387;382485;369972;39;752457
32;2020-S42;1695;1543;3241;382510;376716;49;759226
32;2020-S42;1481;1272;2759;386937;376527;59;763464
32;2020-S42;870;874;1746;371211;330938;69;702149
32;2020-S42;615;537;1153;250542;201459;79;452001
32;2020-S42;467;277;744;163399;89786;89;253185
32;2020-S42;276;73;349;48384;15367;90;63751
32;2020-S42;11114;9612;20751;3072879;2889783;0;5962662
44;2020-S42;108;96;210;291525;306839;09;598364
44;2020-S42;490;540;1035;320255;339504;19;659759
44;2020-S42;909;866;1775;302020;314428;29;616448
44;2020-S42;743;644;1387;342222;333292;39;675514
44;2020-S42;689;631;1320;349727;344491;49;694218
44;2020-S42;667;636;1303;381371;373239;59;754610
44;2020-S42;421;424;845;367165;335850;69;703015
44;2020-S42;249;267;516;250387;215436;79;465823
44;2020-S42;194;113;308;170825;105192;89;276017
44;2020-S42;77;22;99;51248;16731;90;67979
44;2020-S42;4547;4239;8798;2826745;2685002;0;5511747
52;2020-S42;57;82;142;213594;223900;09;437494
52;2020-S42;398;342;748;240818;255197;19;496015
52;2020-S42;577;560;1137;197010;200630;29;397640
52;2020-S42;438;435;874;231204;224885;39;456089
52;2020-S42;489;389;878;243874;243418;49;487292
52;2020-S42;374;382;756;244100;239116;59;483216
52;2020-S42;313;323;636;241796;221345;69;463141
52;2020-S42;192;187;379;177805;149903;79;327708
52;2020-S42;106;75;181;119561;75822;89;195383
52;2020-S42;88;28;116;42559;15260;90;57819
52;2020-S42;3032;2803;5847;1952321;1849476;0;3801797
53;2020-S42;60;56;117;173813;182358;09;356171
53;2020-S42;241;281;528;202720;214740;19;417460
53;2020-S42;382;372;762;163116;173196;29;336312
53;2020-S42;315;288;604;190526;187674;39;378200
53;2020-S42;254;260;515;212098;212015;49;424113
53;2020-S42;269;254;523;223699;219176;59;442875
53;2020-S42;206;203;409;227435;209274;69;436709
53;2020-S42;110;109;219;169992;140910;79;310902
53;2020-S42;66;45;111;118117;69883;89;188000
53;2020-S42;20;10;30;37370;12267;90;49637
53;2020-S42;1924;1878;3820;1718886;1621493;0;3340379
75;2020-S42;80;77;162;293104;305291;09;598395
75;2020-S42;459;462;931;337141;357785;19;694926
75;2020-S42;816;820;1640;295024;300618;29;595642
75;2020-S42;551;491;1043;347871;331233;39;679104
75;2020-S42;581;490;1071;384742;372771;49;757513
75;2020-S42;512;492;1004;413361;390880;59;804241
75;2020-S42;330;326;656;425623;384060;69;809683
75;2020-S42;192;189;381;325086;276298;79;601384
75;2020-S42;159;119;278;213986;139308;89;353294
75;2020-S42;112;38;150;77600;28200;90;105800
75;2020-S42;3793;3506;7319;3113538;2886444;0;5999982
76;2020-S42;139;125;274;305956;318589;09;624545
76;2020-S42;961;894;1878;338942;356969;19;695911
76;2020-S42;1439;1288;2730;316210;319570;29;635780
76;2020-S42;1221;997;2218;356758;337587;39;694345
76;2020-S42;1280;1045;2325;376541;363812;49;740353
76;2020-S42;1157;1020;2179;402608;383750;59;786358
76;2020-S42;707;691;1398;394889;358997;69;753886
76;2020-S42;410;430;840;308664;263806;79;572470
76;2020-S42;378;228;606;195838;129272;89;325110
76;2020-S42;280;82;362;69372;26728;90;96100
76;2020-S42;7981;6808;14827;3065778;2859080;0;5924858
84;2020-S42;343;356;703;459549;481088;09;940637
84;2020-S42;2123;2267;4423;487711;511905;19;999616
84;2020-S42;3299;2800;6102;443824;451094;29;894918
84;2020-S42;2950;2473;5427;512522;493262;39;1005784
84;2020-S42;2871;2428;5304;520248;515106;49;1035354
84;2020-S42;2482;2243;4728;529611;514848;59;1044459
84;2020-S42;1552;1443;2997;486720;439940;69;926660
84;2020-S42;948;1004;1954;372151;315211;79;687362
84;2020-S42;875;571;1446;237198;150524;89;387722
84;2020-S42;648;208;856;81185;28680;90;109865
84;2020-S42;18093;15796;33945;4130719;3901658;0;8032377
93;2020-S42;128;138;267;268834;283093;09;551927
93;2020-S42;701;694;1402;280751;296087;19;576838
93;2020-S42;1046;888;1936;254404;255552;29;509956
93;2020-S42;1097;802;1902;310704;288398;39;599102
93;2020-S42;1073;931;2006;325559;305827;49;631386
93;2020-S42;1081;905;1987;353104;325389;59;678493
93;2020-S42;698;629;1327;336327;296459;69;632786
93;2020-S42;427;395;822;279820;229699;79;509519
93;2020-S42;406;253;659;171274;113716;89;284990
93;2020-S42;304;81;385;58896;21758;90;80654
93;2020-S42;6968;5722;12706;2639673;2415978;0;5055651
94;2020-S42;2;7;9;16311;17433;09;33744
94;2020-S42;29;33;62;16679;18132;19;34811
94;2020-S42;68;61;129;16782;16579;29;33361
94;2020-S42;66;58;124;23044;20580;39;43624
94;2020-S42;46;56;102;23065;22140;49;45205
94;2020-S42;67;53;120;24549;23421;59;47970
94;2020-S42;36;47;83;23212;21883;69;45095
94;2020-S42;24;26;50;19544;17141;79;36685
94;2020-S42;14;9;23;11227;8178;89;19405
94;2020-S42;5;1;6;3332;1447;90;4779
94;2020-S42;357;351;708;177745;166934;0;344679
01;2020-S43;2;3;5;19979;20155;09;40134
01;2020-S43;19;10;29;24994;25489;19;50483
01;2020-S43;20;11;31;17868;16690;29;34558
01;2020-S43;32;15;47;22328;14821;39;37149
01;2020-S43;22;27;49;28652;20276;49;48928
01;2020-S43;24;19;43;33264;27260;59;60524
01;2020-S43;22;19;41;27135;23978;69;51113
01;2020-S43;11;9;20;18401;14661;79;33062
01;2020-S43;2;4;6;9633;6375;89;16008
01;2020-S43;2;1;3;3410;1510;90;4920
01;2020-S43;156;118;274;205664;171215;0;376879
02;2020-S43;11;11;22;16881;17110;09;33991
02;2020-S43;46;57;103;21410;21604;19;43014
02;2020-S43;46;61;107;16017;15479;29;31496
02;2020-S43;74;45;119;19825;14455;39;34280
02;2020-S43;73;56;131;24719;18248;49;42967
02;2020-S43;87;66;155;34361;28310;59;62671
02;2020-S43;47;40;87;28061;24495;69;52556
02;2020-S43;23;19;42;18231;15278;79;33509
02;2020-S43;8;8;16;11090;7677;89;18767
02;2020-S43;5;1;6;3992;1506;90;5498
02;2020-S43;420;364;788;194587;164162;0;358749
03;2020-S43;3;0;3;31123;30920;09;62043
03;2020-S43;9;6;15;29370;29268;19;58638
03;2020-S43;19;13;33;21458;18963;29;40421
03;2020-S43;21;18;39;21276;18326;39;39602
03;2020-S43;12;13;25;18164;16593;49;34757
03;2020-S43;7;6;13;13469;13557;59;27026
03;2020-S43;5;8;13;8776;8670;69;17446
03;2020-S43;1;0;1;3777;3591;79;7368
03;2020-S43;1;0;1;1649;1072;89;2721
03;2020-S43;1;0;1;485;184;90;669
03;2020-S43;79;64;144;149547;141144;0;290691
04;2020-S43;6;6;12;60314;61377;09;121691
04;2020-S43;39;45;84;66065;68387;19;134452
04;2020-S43;56;31;87;51059;47156;29;98215
04;2020-S43;36;28;64;58788;45780;39;104568
04;2020-S43;54;34;88;61408;52207;49;113615
04;2020-S43;51;35;86;64838;60759;59;125597
04;2020-S43;19;19;38;47008;42843;69;89851
04;2020-S43;14;10;24;25509;21184;79;46693
04;2020-S43;6;3;9;13168;7647;89;20815
04;2020-S43;1;0;1;3209;1253;90;4462
04;2020-S43;282;211;493;451366;408593;0;859959
05;2020-S43;0;0;0;362.366008612902;341.338819562748;09;703.704828175651
05;2020-S43;0;0;0;353.376145114279;370.349735405642;19;723.725880519921
05;2020-S43;0;0;0;218.593559489256;256.539602589476;29;475.133162078732
05;2020-S43;0;0;0;404.225408693299;360.321910454353;39;764.547319147651
05;2020-S43;0;0;0;520.067953604221;497.108383964256;49;1017.17633756848
05;2020-S43;0;0;0;468.146063921917;510.087601910415;59;978.233665832332
05;2020-S43;0;0;0;340.368470050554;334.366842191253;69;674.735312241807
05;2020-S43;0;0;0;212.598666888387;192.597753227106;79;405.196420115493
05;2020-S43;0;0;0;148.727797095705;61.8681715431829;89;210.595968638888
05;2020-S43;0;0;0;32.9601271090696;10.9909785719784;90;43.9511056810479
05;2020-S43;0;0;0;3061.43020057959;2935.56979942041;0;5997
06;2020-S43;1;3;4;42583;42380;09;84963
06;2020-S43;9;14;23;33369;31925;19;65294
06;2020-S43;20;21;41;21571;15080;29;36651
06;2020-S43;19;15;34;21550;16147;39;37697
06;2020-S43;13;16;29;14193;13939;49;28132
06;2020-S43;10;7;17;7171;7597;59;14768
06;2020-S43;2;7;9;3629;4117;69;7746
06;2020-S43;1;2;3;1577;1457;79;3034
06;2020-S43;1;0;1;531;474;89;1005
06;2020-S43;0;0;0;88;93;90;181
06;2020-S43;76;85;161;146262;133209;0;279471
07;2020-S43;0;0;0;485;549;09;1034
07;2020-S43;0;0;0;403;432;19;835
07;2020-S43;2;1;3;764;841;29;1605
07;2020-S43;1;1;2;824;928;39;1752
07;2020-S43;0;0;0;788;1020;49;1808
07;2020-S43;1;0;1;678;870;59;1548
07;2020-S43;0;0;0;360;382;69;742
07;2020-S43;0;0;0;231;190;79;421
07;2020-S43;0;0;0;114;67;89;181
07;2020-S43;0;0;0;24;11;90;35
07;2020-S43;4;2;6;4671;5290;0;9961
08;2020-S43;0;0;0;2715.22592983026;2997.75551488675;09;5712.98144471701
08;2020-S43;0;0;0;2778.51901080978;3160.9156459093;19;5939.43465671908
08;2020-S43;2;1;3;2080.8882988764;1718.16634315323;29;3799.05464202964
08;2020-S43;2;2;4;2701.8582062647;1896.52641413317;39;4598.38462039786
08;2020-S43;5;1;6;3151.45861023308;2460.52498233809;49;5611.98359257117
08;2020-S43;5;5;10;2620.29868333099;2422.23566154656;59;5042.53434487755
08;2020-S43;3;3;6;1621.44173420671;1438.58325779464;69;3060.02499200135
08;2020-S43;0;0;0;626.575909335673;526.358467843651;79;1152.93437717932
08;2020-S43;0;0;0;205.018522985054;140.993639349697;89;346.012162334751
08;2020-S43;0;0;0;50.0325684687745;20.62259870351;90;70.6551671722846
08;2020-S43;17;12;29;18551.3174743414;16782.6825256586;0;35334
11;2020-S43;559;577;1198;783071;811785;09;1594856
11;2020-S43;2912;2783;5893;761456;784653;19;1546109
11;2020-S43;7013;5716;12772;850145;801772;29;1651917
11;2020-S43;6160;5477;11655;914360;843488;39;1757848
11;2020-S43;5325;4766;10112;845609;826202;49;1671811
11;2020-S43;4587;4148;8748;793566;745070;59;1538636
11;2020-S43;2694;2740;5476;628649;549192;69;1177841
11;2020-S43;1225;1294;2523;434606;358356;79;792962
11;2020-S43;872;640;1516;261425;162933;89;424358
11;2020-S43;585;212;802;89253;32619;90;121872
11;2020-S43;31941;28375;60737;6362140;5916070;0;12278210
24;2020-S43;48;55;105;139720;144686;09;284406
24;2020-S43;378;387;777;152979;161185;19;314164
24;2020-S43;713;592;1306;122237;126536;29;248773
24;2020-S43;742;552;1294;150359;142009;39;292368
24;2020-S43;715;609;1326;161829;158758;49;320587
24;2020-S43;643;548;1191;172552;168011;59;340563
24;2020-S43;423;373;796;172509;158177;69;330686
24;2020-S43;255;266;521;129428;110593;79;240021
24;2020-S43;211;124;335;87342;56882;89;144224
24;2020-S43;151;65;216;31210;12071;90;43281
24;2020-S43;4280;3572;7870;1320165;1238908;0;2559073
27;2020-S43;85;112;198;143373;149679;09;293052
27;2020-S43;582;558;1141;160962;173003;19;333965
27;2020-S43;901;865;1767;133746;142254;29;276000
27;2020-S43;871;690;1561;160004;155407;39;315411
27;2020-S43;961;748;1709;172333;169564;49;341897
27;2020-S43;892;734;1626;189979;183788;59;373767
27;2020-S43;683;675;1359;192591;178206;69;370797
27;2020-S43;422;481;903;146876;127546;79;274422
27;2020-S43;403;309;712;96896;61575;89;158471
27;2020-S43;270;100;370;33148;12109;90;45257
27;2020-S43;6071;5273;11348;1429908;1353131;0;2783039
28;2020-S43;96;73;175;180735;186856;09;367591
28;2020-S43;463;415;892;200125;213621;19;413746
28;2020-S43;797;699;1497;168922;173007;29;341929
28;2020-S43;815;651;1467;196628;188487;39;385115
28;2020-S43;769;690;1460;205396;201699;49;407095
28;2020-S43;779;638;1419;222002;213866;59;435868
28;2020-S43;587;553;1140;224688;203758;69;428446
28;2020-S43;351;333;684;163192;135543;79;298735
28;2020-S43;321;171;493;109691;65377;89;175068
28;2020-S43;191;62;254;37222;12685;90;49907
28;2020-S43;5169;4285;9481;1708601;1594899;0;3303500
32;2020-S43;393;399;795;358062;373689;09;731751
32;2020-S43;1788;1635;3433;387045;406742;19;793787
32;2020-S43;2937;2469;5422;342304;348587;29;690891
32;2020-S43;2858;2505;5368;382485;369972;39;752457
32;2020-S43;2664;2369;5043;382510;376716;49;759226
32;2020-S43;2203;2111;4322;386937;376527;59;763464
32;2020-S43;1467;1380;2852;371211;330938;69;702149
32;2020-S43;979;872;1854;250542;201459;79;452001
32;2020-S43;894;464;1361;163399;89786;89;253185
32;2020-S43;560;159;719;48384;15367;90;63751
32;2020-S43;16746;14365;31174;3072879;2889783;0;5962662
44;2020-S43;176;157;335;291525;306839;09;598364
44;2020-S43;870;921;1797;320255;339504;19;659759
44;2020-S43;1970;1777;3747;302020;314428;29;616448
44;2020-S43;1535;1362;2898;342222;333292;39;675514
44;2020-S43;1347;1236;2583;349727;344491;49;694218
44;2020-S43;1380;1263;2644;381371;373239;59;754610
44;2020-S43;960;859;1820;367165;335850;69;703015
44;2020-S43;549;536;1085;250387;215436;79;465823
44;2020-S43;434;270;705;170825;105192;89;276017
44;2020-S43;267;82;350;51248;16731;90;67979
44;2020-S43;9489;8464;17966;2826745;2685002;0;5511747
52;2020-S43;93;73;169;213594;223900;09;437494
52;2020-S43;545;571;1130;240818;255197;19;496015
52;2020-S43;953;922;1877;197010;200630;29;397640
52;2020-S43;801;680;1481;231204;224885;39;456089
52;2020-S43;786;706;1492;243874;243418;49;487292
52;2020-S43;732;681;1413;244100;239116;59;483216
52;2020-S43;507;541;1048;241796;221345;69;463141
52;2020-S43;314;320;634;177805;149903;79;327708
52;2020-S43;298;184;482;119561;75822;89;195383
52;2020-S43;198;69;267;42559;15260;90;57819
52;2020-S43;5227;4747;9993;1952321;1849476;0;3801797
53;2020-S43;81;61;148;173813;182358;09;356171
53;2020-S43;307;322;640;202720;214740;19;417460
53;2020-S43;569;573;1155;163116;173196;29;336312
53;2020-S43;463;393;856;190526;187674;39;378200
53;2020-S43;454;421;876;212098;212015;49;424113
53;2020-S43;472;428;901;223699;219176;59;442875
53;2020-S43;317;305;622;227435;209274;69;436709
53;2020-S43;186;173;359;169992;140910;79;310902
53;2020-S43;152;102;254;118117;69883;89;188000
53;2020-S43;79;36;116;37370;12267;90;49637
53;2020-S43;3080;2814;5927;1718886;1621493;0;3340379
75;2020-S43;127;117;247;293104;305291;09;598395
75;2020-S43;685;729;1424;337141;357785;19;694926
75;2020-S43;1344;1248;2598;295024;300618;29;595642
75;2020-S43;1045;853;1900;347871;331233;39;679104
75;2020-S43;1058;921;1982;384742;372771;49;757513
75;2020-S43;1027;874;1903;413361;390880;59;804241
75;2020-S43;607;654;1262;425623;384060;69;809683
75;2020-S43;405;391;797;325086;276298;79;601384
75;2020-S43;407;247;654;213986;139308;89;353294
75;2020-S43;313;96;409;77600;28200;90;105800
75;2020-S43;7018;6133;13179;3113538;2886444;0;5999982
76;2020-S43;180;190;385;305956;318589;09;624545
76;2020-S43;1111;1046;2203;338942;356969;19;695911
76;2020-S43;2202;1843;4047;316210;319570;29;635780
76;2020-S43;1995;1546;3544;356758;337587;39;694345
76;2020-S43;1974;1623;3600;376541;363812;49;740353
76;2020-S43;1865;1571;3438;402608;383750;59;786358
76;2020-S43;1139;1062;2201;394889;358997;69;753886
76;2020-S43;727;653;1381;308664;263806;79;572470
76;2020-S43;632;435;1067;195838;129272;89;325110
76;2020-S43;505;150;655;69372;26728;90;96100
76;2020-S43;12347;10131;22550;3065778;2859080;0;5924858
84;2020-S43;469;525;1001;459549;481088;09;940637
84;2020-S43;2943;2822;5814;487711;511905;19;999616
84;2020-S43;5433;4550;9995;443824;451094;29;894918
84;2020-S43;5101;4177;9287;512522;493262;39;1005784
84;2020-S43;5055;4266;9323;520248;515106;49;1035354
84;2020-S43;4603;4240;8847;529611;514848;59;1044459
84;2020-S43;2892;2663;5558;486720;439940;69;926660
84;2020-S43;1854;1815;3669;372151;315211;79;687362
84;2020-S43;1782;1073;2855;237198;150524;89;387722
84;2020-S43;1225;385;1610;81185;28680;90;109865
84;2020-S43;31359;26523;57970;4130719;3901658;0;8032377
93;2020-S43;187;198;387;268834;283093;09;551927
93;2020-S43;905;916;1826;280751;296087;19;576838
93;2020-S43;1900;1432;3336;254404;255552;29;509956
93;2020-S43;1938;1598;3537;310704;288398;39;599102
93;2020-S43;1905;1570;3478;325559;305827;49;631386
93;2020-S43;1879;1562;3445;353104;325389;59;678493
93;2020-S43;1177;1211;2389;336327;296459;69;632786
93;2020-S43;824;783;1607;279820;229699;79;509519
93;2020-S43;758;452;1210;171274;113716;89;284990
93;2020-S43;581;178;760;58896;21758;90;80654
93;2020-S43;12064;9905;21990;2639673;2415978;0;5055651
94;2020-S43;7;11;19;16311;17433;09;33744
94;2020-S43;36;34;71;16679;18132;19;34811
94;2020-S43;88;73;161;16782;16579;29;33361
94;2020-S43;65;73;138;23044;20580;39;43624
94;2020-S43;68;77;145;23065;22140;49;45205
94;2020-S43;67;66;133;24549;23421;59;47970
94;2020-S43;71;63;134;23212;21883;69;45095
94;2020-S43;29;37;66;19544;17141;79;36685
94;2020-S43;23;20;43;11227;8178;89;19405
94;2020-S43;8;3;11;3332;1447;90;4779
94;2020-S43;463;457;922;177745;166934;0;344679
01;2020-S44;2;2;4;19979;20155;09;40134
01;2020-S44;7;9;16;24994;25489;19;50483
01;2020-S44;23;13;36;17868;16690;29;34558
01;2020-S44;23;17;40;22328;14821;39;37149
01;2020-S44;34;15;49;28652;20276;49;48928
01;2020-S44;33;36;69;33264;27260;59;60524
01;2020-S44;21;28;50;27135;23978;69;51113
01;2020-S44;9;7;16;18401;14661;79;33062
01;2020-S44;6;4;10;9633;6375;89;16008
01;2020-S44;1;2;3;3410;1510;90;4920
01;2020-S44;159;133;293;205664;171215;0;376879
02;2020-S44;8;3;11;16881;17110;09;33991
02;2020-S44;53;38;92;21410;21604;19;43014
02;2020-S44;61;49;110;16017;15479;29;31496
02;2020-S44;70;49;119;19825;14455;39;34280
02;2020-S44;73;43;117;24719;18248;49;42967
02;2020-S44;77;66;144;34361;28310;59;62671
02;2020-S44;51;47;98;28061;24495;69;52556
02;2020-S44;21;14;36;18231;15278;79;33509
02;2020-S44;10;6;16;11090;7677;89;18767
02;2020-S44;8;1;9;3992;1506;90;5498
02;2020-S44;432;316;752;194587;164162;0;358749
03;2020-S44;1;0;1;31123;30920;09;62043
03;2020-S44;5;7;12;29370;29268;19;58638
03;2020-S44;17;17;34;21458;18963;29;40421
03;2020-S44;12;18;30;21276;18326;39;39602
03;2020-S44;8;8;16;18164;16593;49;34757
03;2020-S44;9;8;18;13469;13557;59;27026
03;2020-S44;1;9;10;8776;8670;69;17446
03;2020-S44;2;1;3;3777;3591;79;7368
03;2020-S44;0;0;0;1649;1072;89;2721
03;2020-S44;0;0;0;485;184;90;669
03;2020-S44;55;68;124;149547;141144;0;290691
04;2020-S44;16;9;25;60314;61377;09;121691
04;2020-S44;60;35;95;66065;68387;19;134452
04;2020-S44;55;42;97;51059;47156;29;98215
04;2020-S44;63;35;98;58788;45780;39;104568
04;2020-S44;50;39;89;61408;52207;49;113615
04;2020-S44;50;48;98;64838;60759;59;125597
04;2020-S44;28;26;54;47008;42843;69;89851
04;2020-S44;12;10;22;25509;21184;79;46693
04;2020-S44;8;10;18;13168;7647;89;20815
04;2020-S44;3;1;4;3209;1253;90;4462
04;2020-S44;345;255;600;451366;408593;0;859959
05;2020-S44;0;0;0;362.366008612902;341.338819562748;09;703.704828175651
05;2020-S44;0;0;0;353.376145114279;370.349735405642;19;723.725880519921
05;2020-S44;0;0;0;218.593559489256;256.539602589476;29;475.133162078732
05;2020-S44;1;0;1;404.225408693299;360.321910454353;39;764.547319147651
05;2020-S44;0;0;0;520.067953604221;497.108383964256;49;1017.17633756848
05;2020-S44;1;0;1;468.146063921917;510.087601910415;59;978.233665832332
05;2020-S44;0;0;0;340.368470050554;334.366842191253;69;674.735312241807
05;2020-S44;0;0;0;212.598666888387;192.597753227106;79;405.196420115493
05;2020-S44;0;0;0;148.727797095705;61.8681715431829;89;210.595968638888
05;2020-S44;0;0;0;32.9601271090696;10.9909785719784;90;43.9511056810479
05;2020-S44;2;0;2;3061.43020057959;2935.56979942041;0;5997
06;2020-S44;1;0;2;42583;42380;09;84963
06;2020-S44;22;18;40;33369;31925;19;65294
06;2020-S44;21;16;37;21571;15080;29;36651
06;2020-S44;26;8;34;21550;16147;39;37697
06;2020-S44;21;16;37;14193;13939;49;28132
06;2020-S44;9;6;15;7171;7597;59;14768
06;2020-S44;5;6;11;3629;4117;69;7746
06;2020-S44;1;6;7;1577;1457;79;3034
06;2020-S44;2;1;3;531;474;89;1005
06;2020-S44;0;0;0;88;93;90;181
06;2020-S44;108;77;186;146262;133209;0;279471
07;2020-S44;0;0;0;485;549;09;1034
07;2020-S44;0;0;0;403;432;19;835
07;2020-S44;0;2;2;764;841;29;1605
07;2020-S44;0;2;2;824;928;39;1752
07;2020-S44;2;1;3;788;1020;49;1808
07;2020-S44;1;1;2;678;870;59;1548
07;2020-S44;0;0;0;360;382;69;742
07;2020-S44;1;1;2;231;190;79;421
07;2020-S44;0;0;0;114;67;89;181
07;2020-S44;0;0;0;24;11;90;35
07;2020-S44;4;7;11;4671;5290;0;9961
08;2020-S44;0;0;0;2715.22592983026;2997.75551488675;09;5712.98144471701
08;2020-S44;5;3;8;2778.51901080978;3160.9156459093;19;5939.43465671908
08;2020-S44;3;2;5;2080.8882988764;1718.16634315323;29;3799.05464202964
08;2020-S44;2;2;4;2701.8582062647;1896.52641413317;39;4598.38462039786
08;2020-S44;7;2;9;3151.45861023308;2460.52498233809;49;5611.98359257117
08;2020-S44;5;7;12;2620.29868333099;2422.23566154656;59;5042.53434487755
08;2020-S44;4;4;8;1621.44173420671;1438.58325779464;69;3060.02499200135
08;2020-S44;0;1;1;626.575909335673;526.358467843651;79;1152.93437717932
08;2020-S44;0;0;0;205.018522985054;140.993639349697;89;346.012162334751
08;2020-S44;0;0;0;50.0325684687745;20.62259870351;90;70.6551671722846
08;2020-S44;26;21;47;18551.3174743414;16782.6825256586;0;35334
11;2020-S44;668;708;1472;783071;811785;09;1594856
11;2020-S44;3437;3123;6794;761456;784653;19;1546109
11;2020-S44;6707;5371;12113;850145;801772;29;1651917
11;2020-S44;6351;5263;11646;914360;843488;39;1757848
11;2020-S44;5713;4838;10590;845609;826202;49;1671811
11;2020-S44;4966;4456;9444;793566;745070;59;1538636
11;2020-S44;3412;3216;6682;628649;549192;69;1177841
11;2020-S44;1524;1522;3058;434606;358356;79;792962
11;2020-S44;1046;757;1809;261425;162933;89;424358
11;2020-S44;569;210;783;89253;32619;90;121872
11;2020-S44;34413;29486;64487;6362140;5916070;0;12278210
24;2020-S44;75;73;151;139720;144686;09;284406
24;2020-S44;508;530;1053;152979;161185;19;314164
24;2020-S44;899;677;1576;122237;126536;29;248773
24;2020-S44;876;724;1601;150359;142009;39;292368
24;2020-S44;942;715;1657;161829;158758;49;320587
24;2020-S44;803;737;1540;172552;168011;59;340563
24;2020-S44;598;567;1165;172509;158177;69;330686
24;2020-S44;329;358;687;129428;110593;79;240021
24;2020-S44;267;161;428;87342;56882;89;144224
24;2020-S44;174;58;232;31210;12071;90;43281
24;2020-S44;5474;4603;10096;1320165;1238908;0;2559073
27;2020-S44;146;143;290;143373;149679;09;293052
27;2020-S44;806;765;1577;160962;173003;19;333965
27;2020-S44;1316;1117;2433;133746;142254;29;276000
27;2020-S44;1271;1025;2296;160004;155407;39;315411
27;2020-S44;1396;1162;2558;172333;169564;49;341897
27;2020-S44;1372;1148;2520;189979;183788;59;373767
27;2020-S44;980;916;1896;192591;178206;69;370797
27;2020-S44;616;634;1250;146876;127546;79;274422
27;2020-S44;518;349;867;96896;61575;89;158471
27;2020-S44;336;111;447;33148;12109;90;45257
27;2020-S44;8759;7371;16137;1429908;1353131;0;2783039
28;2020-S44;152;141;305;180735;186856;09;367591
28;2020-S44;652;584;1264;200125;213621;19;413746
28;2020-S44;967;765;1734;168922;173007;29;341929
28;2020-S44;1053;773;1827;196628;188487;39;385115
28;2020-S44;996;771;1768;205396;201699;49;407095
28;2020-S44;987;840;1828;222002;213866;59;435868
28;2020-S44;813;641;1455;224688;203758;69;428446
28;2020-S44;446;459;905;163192;135543;79;298735
28;2020-S44;465;230;695;109691;65377;89;175068
28;2020-S44;275;68;343;37222;12685;90;49907
28;2020-S44;6806;5273;12125;1708601;1594899;0;3303500
32;2020-S44;517;542;1060;358062;373689;09;731751
32;2020-S44;2285;2175;4467;387045;406742;19;793787
32;2020-S44;3227;2656;5891;342304;348587;29;690891
32;2020-S44;3201;2723;5931;382485;369972;39;752457
32;2020-S44;3103;2710;5817;382510;376716;49;759226
32;2020-S44;2716;2528;5247;386937;376527;59;763464
32;2020-S44;1853;1725;3580;371211;330938;69;702149
32;2020-S44;1232;1087;2322;250542;201459;79;452001
32;2020-S44;954;520;1474;163399;89786;89;253185
32;2020-S44;544;171;715;48384;15367;90;63751
32;2020-S44;19637;16842;36515;3072879;2889783;0;5962662
44;2020-S44;275;305;584;291525;306839;09;598364
44;2020-S44;1312;1408;2730;320255;339504;19;659759
44;2020-S44;2387;2179;4570;302020;314428;29;616448
44;2020-S44;2098;1902;4007;342222;333292;39;675514
44;2020-S44;2018;1710;3731;349727;344491;49;694218
44;2020-S44;1957;1894;3857;381371;373239;59;754610
44;2020-S44;1341;1347;2695;367165;335850;69;703015
44;2020-S44;814;823;1640;250387;215436;79;465823
44;2020-S44;652;430;1082;170825;105192;89;276017
44;2020-S44;327;106;434;51248;16731;90;67979
44;2020-S44;13181;12105;25331;2826745;2685002;0;5511747
52;2020-S44;133;116;262;213594;223900;09;437494
52;2020-S44;824;743;1602;240818;255197;19;496015
52;2020-S44;1192;1053;2247;197010;200630;29;397640
52;2020-S44;1105;960;2069;231204;224885;39;456089
52;2020-S44;1125;951;2076;243874;243418;49;487292
52;2020-S44;1013;883;1897;244100;239116;59;483216
52;2020-S44;731;660;1392;241796;221345;69;463141
52;2020-S44;505;473;978;177805;149903;79;327708
52;2020-S44;448;296;744;119561;75822;89;195383
52;2020-S44;320;121;441;42559;15260;90;57819
52;2020-S44;7396;6256;13708;1952321;1849476;0;3801797
53;2020-S44;108;119;236;173813;182358;09;356171
53;2020-S44;453;449;913;202720;214740;19;417460
53;2020-S44;773;606;1399;163116;173196;29;336312
53;2020-S44;625;519;1144;190526;187674;39;378200
53;2020-S44;648;526;1175;212098;212015;49;424113
53;2020-S44;593;516;1109;223699;219176;59;442875
53;2020-S44;404;431;835;227435;209274;69;436709
53;2020-S44;254;238;492;169992;140910;79;310902
53;2020-S44;194;103;297;118117;69883;89;188000
53;2020-S44;88;43;133;37370;12267;90;49637
53;2020-S44;4140;3550;7733;1718886;1621493;0;3340379
75;2020-S44;181;212;406;293104;305291;09;598395
75;2020-S44;918;881;1823;337141;357785;19;694926
75;2020-S44;1662;1377;3046;295024;300618;29;595642
75;2020-S44;1443;1198;2645;347871;331233;39;679104
75;2020-S44;1483;1242;2726;384742;372771;49;757513
75;2020-S44;1348;1237;2586;413361;390880;59;804241
75;2020-S44;945;883;1834;425623;384060;69;809683
75;2020-S44;618;583;1204;325086;276298;79;601384
75;2020-S44;569;425;995;213986;139308;89;353294
75;2020-S44;456;133;590;77600;28200;90;105800
75;2020-S44;9624;8176;17861;3113538;2886444;0;5999982
76;2020-S44;262;243;527;305956;318589;09;624545
76;2020-S44;1364;1263;2684;338942;356969;19;695911
76;2020-S44;2159;1782;3945;316210;319570;29;635780
76;2020-S44;2127;1685;3816;356758;337587;39;694345
76;2020-S44;2270;1848;4122;376541;363812;49;740353
76;2020-S44;2051;1831;3888;402608;383750;59;786358
76;2020-S44;1417;1367;2788;394889;358997;69;753886
76;2020-S44;923;906;1831;308664;263806;79;572470
76;2020-S44;731;517;1249;195838;129272;89;325110
76;2020-S44;540;193;734;69372;26728;90;96100
76;2020-S44;13856;11646;25607;3065778;2859080;0;5924858
84;2020-S44;664;679;1363;459549;481088;09;940637
84;2020-S44;3733;3622;7419;487711;511905;19;999616
84;2020-S44;6162;5074;11251;443824;451094;29;894918
84;2020-S44;6229;5094;11332;512522;493262;39;1005784
84;2020-S44;6343;5128;11476;520248;515106;49;1035354
84;2020-S44;6055;5250;11310;529611;514848;59;1044459
84;2020-S44;3725;3440;7168;486720;439940;69;926660
84;2020-S44;2543;2473;5018;372151;315211;79;687362
84;2020-S44;2322;1524;3846;237198;150524;89;387722
84;2020-S44;1722;507;2229;81185;28680;90;109865
84;2020-S44;39501;32795;72421;4130719;3901658;0;8032377
93;2020-S44;266;306;575;268834;283093;09;551927
93;2020-S44;1345;1236;2587;280751;296087;19;576838
93;2020-S44;2155;1677;3835;254404;255552;29;509956
93;2020-S44;2406;1845;4256;310704;288398;39;599102
93;2020-S44;2492;1911;4410;325559;305827;49;631386
93;2020-S44;2373;2064;4439;353104;325389;59;678493
93;2020-S44;1563;1465;3031;336327;296459;69;632786
93;2020-S44;1070;1045;2116;279820;229699;79;509519
93;2020-S44;894;569;1463;171274;113716;89;284990
93;2020-S44;597;195;792;58896;21758;90;80654
93;2020-S44;15169;12322;27521;2639673;2415978;0;5055651
94;2020-S44;16;19;35;16311;17433;09;33744
94;2020-S44;67;63;131;16679;18132;19;34811
94;2020-S44;121;102;223;16782;16579;29;33361
94;2020-S44;128;114;242;23044;20580;39;43624
94;2020-S44;115;107;222;23065;22140;49;45205
94;2020-S44;117;117;234;24549;23421;59;47970
94;2020-S44;74;89;163;23212;21883;69;45095
94;2020-S44;61;43;104;19544;17141;79;36685
94;2020-S44;25;18;43;11227;8178;89;19405
94;2020-S44;12;5;17;3332;1447;90;4779
94;2020-S44;740;678;1419;177745;166934;0;344679
01;2020-S45;0;2;2;19979;20155;09;40134
01;2020-S45;11;6;17;24994;25489;19;50483
01;2020-S45;8;6;14;17868;16690;29;34558
01;2020-S45;17;11;28;22328;14821;39;37149
01;2020-S45;21;5;26;28652;20276;49;48928
01;2020-S45;19;24;43;33264;27260;59;60524
01;2020-S45;15;20;35;27135;23978;69;51113
01;2020-S45;8;11;19;18401;14661;79;33062
01;2020-S45;3;4;7;9633;6375;89;16008
01;2020-S45;2;0;2;3410;1510;90;4920
01;2020-S45;104;89;193;205664;171215;0;376879
02;2020-S45;3;8;11;16881;17110;09;33991
02;2020-S45;40;22;63;21410;21604;19;43014
02;2020-S45;43;26;70;16017;15479;29;31496
02;2020-S45;32;31;64;19825;14455;39;34280
02;2020-S45;51;35;87;24719;18248;49;42967
02;2020-S45;82;45;127;34361;28310;59;62671
02;2020-S45;36;35;72;28061;24495;69;52556
02;2020-S45;13;12;25;18231;15278;79;33509
02;2020-S45;8;8;17;11090;7677;89;18767
02;2020-S45;4;0;4;3992;1506;90;5498
02;2020-S45;312;222;540;194587;164162;0;358749
03;2020-S45;4;1;5;31123;30920;09;62043
03;2020-S45;6;4;11;29370;29268;19;58638
03;2020-S45;14;9;23;21458;18963;29;40421
03;2020-S45;16;22;38;21276;18326;39;39602
03;2020-S45;14;10;24;18164;16593;49;34757
03;2020-S45;9;11;20;13469;13557;59;27026
03;2020-S45;3;9;12;8776;8670;69;17446
03;2020-S45;2;2;5;3777;3591;79;7368
03;2020-S45;1;0;1;1649;1072;89;2721
03;2020-S45;0;0;0;485;184;90;669
03;2020-S45;69;68;139;149547;141144;0;290691
04;2020-S45;16;15;31;60314;61377;09;121691
04;2020-S45;94;67;162;66065;68387;19;134452
04;2020-S45;54;39;93;51059;47156;29;98215
04;2020-S45;71;47;118;58788;45780;39;104568
04;2020-S45;54;31;85;61408;52207;49;113615
04;2020-S45;57;48;105;64838;60759;59;125597
04;2020-S45;36;30;66;47008;42843;69;89851
04;2020-S45;6;16;22;25509;21184;79;46693
04;2020-S45;4;11;15;13168;7647;89;20815
04;2020-S45;1;1;2;3209;1253;90;4462
04;2020-S45;393;305;699;451366;408593;0;859959
05;2020-S45;0;0;0;362.366008612902;341.338819562748;09;703.704828175651
05;2020-S45;0;0;0;353.376145114279;370.349735405642;19;723.725880519921
05;2020-S45;0;0;0;218.593559489256;256.539602589476;29;475.133162078732
05;2020-S45;0;0;0;404.225408693299;360.321910454353;39;764.547319147651
05;2020-S45;0;0;0;520.067953604221;497.108383964256;49;1017.17633756848
05;2020-S45;0;0;0;468.146063921917;510.087601910415;59;978.233665832332
05;2020-S45;0;0;0;340.368470050554;334.366842191253;69;674.735312241807
05;2020-S45;0;0;0;212.598666888387;192.597753227106;79;405.196420115493
05;2020-S45;0;0;0;148.727797095705;61.8681715431829;89;210.595968638888
05;2020-S45;0;0;0;32.9601271090696;10.9909785719784;90;43.9511056810479
05;2020-S45;0;0;0;3061.43020057959;2935.56979942041;0;5997
06;2020-S45;2;2;4;42583;42380;09;84963
06;2020-S45;20;16;37;33369;31925;19;65294
06;2020-S45;35;17;52;21571;15080;29;36651
06;2020-S45;53;21;74;21550;16147;39;37697
06;2020-S45;42;27;69;14193;13939;49;28132
06;2020-S45;13;12;25;7171;7597;59;14768
06;2020-S45;4;14;18;3629;4117;69;7746
06;2020-S45;4;3;7;1577;1457;79;3034
06;2020-S45;1;2;3;531;474;89;1005
06;2020-S45;0;0;0;88;93;90;181
06;2020-S45;174;114;289;146262;133209;0;279471
07;2020-S45;0;0;0;485;549;09;1034
07;2020-S45;1;1;2;403;432;19;835
07;2020-S45;0;1;1;764;841;29;1605
07;2020-S45;3;2;5;824;928;39;1752
07;2020-S45;0;1;1;788;1020;49;1808
07;2020-S45;0;1;1;678;870;59;1548
07;2020-S45;0;1;1;360;382;69;742
07;2020-S45;0;2;2;231;190;79;421
07;2020-S45;0;0;0;114;67;89;181
07;2020-S45;0;0;0;24;11;90;35
07;2020-S45;4;9;13;4671;5290;0;9961
08;2020-S45;0;0;0;2715.22592983026;2997.75551488675;09;5712.98144471701
08;2020-S45;0;3;3;2778.51901080978;3160.9156459093;19;5939.43465671908
08;2020-S45;2;0;2;2080.8882988764;1718.16634315323;29;3799.05464202964
08;2020-S45;7;6;13;2701.8582062647;1896.52641413317;39;4598.38462039786
08;2020-S45;7;2;9;3151.45861023308;2460.52498233809;49;5611.98359257117
08;2020-S45;3;5;8;2620.29868333099;2422.23566154656;59;5042.53434487755
08;2020-S45;2;4;6;1621.44173420671;1438.58325779464;69;3060.02499200135
08;2020-S45;2;1;3;626.575909335673;526.358467843651;79;1152.93437717932
08;2020-S45;0;0;0;205.018522985054;140.993639349697;89;346.012162334751
08;2020-S45;0;0;0;50.0325684687745;20.62259870351;90;70.6551671722846
08;2020-S45;23;21;44;18551.3174743414;16782.6825256586;0;35334
11;2020-S45;674;733;1514;783071;811785;09;1594856
11;2020-S45;2877;2756;5903;761456;784653;19;1546109
11;2020-S45;4047;3251;7332;850145;801772;29;1651917
11;2020-S45;4325;3502;7861;914360;843488;39;1757848
11;2020-S45;4009;3384;7428;845609;826202;49;1671811
11;2020-S45;3493;3189;6713;793566;745070;59;1538636
11;2020-S45;2581;2630;5261;628649;549192;69;1177841
11;2020-S45;1158;1174;2343;434606;358356;79;792962
11;2020-S45;896;573;1474;261425;162933;89;424358
11;2020-S45;546;174;720;89253;32619;90;121872
11;2020-S45;24616;21382;46604;6362140;5916070;0;12278210
24;2020-S45;95;134;231;139720;144686;09;284406
24;2020-S45;566;577;1153;152979;161185;19;314164
24;2020-S45;718;548;1270;122237;126536;29;248773
24;2020-S45;715;560;1277;150359;142009;39;292368
24;2020-S45;768;600;1369;161829;158758;49;320587
24;2020-S45;721;647;1368;172552;168011;59;340563
24;2020-S45;500;453;953;172509;158177;69;330686
24;2020-S45;378;352;731;129428;110593;79;240021
24;2020-S45;273;211;485;87342;56882;89;144224
24;2020-S45;225;67;292;31210;12071;90;43281
24;2020-S45;4966;4153;9140;1320165;1238908;0;2559073
27;2020-S45;229;231;462;143373;149679;09;293052
27;2020-S45;1118;1023;2151;160962;173003;19;333965
27;2020-S45;1241;1092;2333;133746;142254;29;276000
27;2020-S45;1250;922;2172;160004;155407;39;315411
27;2020-S45;1338;1068;2406;172333;169564;49;341897
27;2020-S45;1367;1178;2545;189979;183788;59;373767
27;2020-S45;965;894;1860;192591;178206;69;370797
27;2020-S45;680;668;1348;146876;127546;79;274422
27;2020-S45;625;411;1036;96896;61575;89;158471
27;2020-S45;360;142;502;33148;12109;90;45257
27;2020-S45;9175;7632;16821;1429908;1353131;0;2783039
28;2020-S45;169;191;369;180735;186856;09;367591
28;2020-S45;673;600;1283;200125;213621;19;413746
28;2020-S45;763;617;1382;168922;173007;29;341929
28;2020-S45;816;606;1423;196628;188487;39;385115
28;2020-S45;823;657;1481;205396;201699;49;407095
28;2020-S45;835;729;1564;222002;213866;59;435868
28;2020-S45;707;637;1345;224688;203758;69;428446
28;2020-S45;446;420;867;163192;135543;79;298735
28;2020-S45;370;240;610;109691;65377;89;175068
28;2020-S45;251;73;324;37222;12685;90;49907
28;2020-S45;5853;4770;10648;1708601;1594899;0;3303500
32;2020-S45;593;611;1206;358062;373689;09;731751
32;2020-S45;2050;2068;4122;387045;406742;19;793787
32;2020-S45;2366;1925;4294;342304;348587;29;690891
32;2020-S45;2504;2007;4514;382485;369972;39;752457
32;2020-S45;2382;2074;4457;382510;376716;49;759226
32;2020-S45;2295;2170;4466;386937;376527;59;763464
32;2020-S45;1668;1553;3221;371211;330938;69;702149
32;2020-S45;1143;971;2114;250542;201459;79;452001
32;2020-S45;925;526;1451;163399;89786;89;253185
32;2020-S45;530;162;692;48384;15367;90;63751
32;2020-S45;16458;14068;30540;3072879;2889783;0;5962662
44;2020-S45;353;414;772;291525;306839;09;598364
44;2020-S45;1421;1415;2856;320255;339504;19;659759
44;2020-S45;1909;1676;3590;302020;314428;29;616448
44;2020-S45;1903;1540;3446;342222;333292;39;675514
44;2020-S45;1885;1573;3464;349727;344491;49;694218
44;2020-S45;1914;1740;3663;381371;373239;59;754610
44;2020-S45;1273;1171;2454;367165;335850;69;703015
44;2020-S45;839;858;1700;250387;215436;79;465823
44;2020-S45;738;519;1265;170825;105192;89;276017
44;2020-S45;374;123;498;51248;16731;90;67979
44;2020-S45;12610;11034;23714;2826745;2685002;0;5511747
52;2020-S45;181;187;380;213594;223900;09;437494
52;2020-S45;877;774;1674;240818;255197;19;496015
52;2020-S45;1064;899;1969;197010;200630;29;397640
52;2020-S45;939;784;1723;231204;224885;39;456089
52;2020-S45;988;833;1821;243874;243418;49;487292
52;2020-S45;946;881;1829;244100;239116;59;483216
52;2020-S45;643;632;1275;241796;221345;69;463141
52;2020-S45;452;440;892;177805;149903;79;327708
52;2020-S45;374;236;610;119561;75822;89;195383
52;2020-S45;270;89;359;42559;15260;90;57819
52;2020-S45;6735;5755;12533;1952321;1849476;0;3801797
53;2020-S45;125;135;271;173813;182358;09;356171
53;2020-S45;480;475;967;202720;214740;19;417460
53;2020-S45;614;600;1226;163116;173196;29;336312
53;2020-S45;561;458;1020;190526;187674;39;378200
53;2020-S45;518;450;968;212098;212015;49;424113
53;2020-S45;562;528;1090;223699;219176;59;442875
53;2020-S45;401;393;794;227435;209274;69;436709
53;2020-S45;285;278;563;169992;140910;79;310902
53;2020-S45;234;124;358;118117;69883;89;188000
53;2020-S45;162;54;217;37370;12267;90;49637
53;2020-S45;3943;3495;7475;1718886;1621493;0;3340379
75;2020-S45;237;246;495;293104;305291;09;598395
75;2020-S45;990;1000;2010;337141;357785;19;694926
75;2020-S45;1340;1120;2466;295024;300618;29;595642
75;2020-S45;1419;1097;2519;347871;331233;39;679104
75;2020-S45;1431;1196;2631;384742;372771;49;757513
75;2020-S45;1234;1149;2384;413361;390880;59;804241
75;2020-S45;940;875;1817;425623;384060;69;809683
75;2020-S45;614;602;1216;325086;276298;79;601384
75;2020-S45;549;375;925;213986;139308;89;353294
75;2020-S45;437;145;582;77600;28200;90;105800
75;2020-S45;9196;7808;17053;3113538;2886444;0;5999982
76;2020-S45;274;284;578;305956;318589;09;624545
76;2020-S45;1258;1317;2614;338942;356969;19;695911
76;2020-S45;1624;1299;2925;316210;319570;29;635780
76;2020-S45;1785;1363;3150;356758;337587;39;694345
76;2020-S45;1767;1472;3242;376541;363812;49;740353
76;2020-S45;1721;1518;3240;402608;383750;59;786358
76;2020-S45;1235;1171;2407;394889;358997;69;753886
76;2020-S45;862;871;1733;308664;263806;79;572470
76;2020-S45;809;521;1331;195838;129272;89;325110
76;2020-S45;588;194;783;69372;26728;90;96100
76;2020-S45;11937;10023;22030;3065778;2859080;0;5924858
84;2020-S45;901;931;1852;459549;481088;09;940637
84;2020-S45;4155;4263;8484;487711;511905;19;999616
84;2020-S45;5266;4309;9581;443824;451094;29;894918
84;2020-S45;5374;4290;9671;512522;493262;39;1005784
84;2020-S45;5586;4630;10222;520248;515106;49;1035354
84;2020-S45;5257;4943;10203;529611;514848;59;1044459
84;2020-S45;3457;3277;6738;486720;439940;69;926660
84;2020-S45;2598;2386;4986;372151;315211;79;687362
84;2020-S45;2480;1495;3975;237198;150524;89;387722
84;2020-S45;1705;566;2271;81185;28680;90;109865
84;2020-S45;36782;31098;67996;4130719;3901658;0;8032377
93;2020-S45;304;328;633;268834;283093;09;551927
93;2020-S45;1366;1372;2748;280751;296087;19;576838
93;2020-S45;1835;1417;3252;254404;255552;29;509956
93;2020-S45;1990;1474;3469;310704;288398;39;599102
93;2020-S45;2055;1627;3684;325559;305827;49;631386
93;2020-S45;2013;1757;3770;353104;325389;59;678493
93;2020-S45;1448;1363;2814;336327;296459;69;632786
93;2020-S45;1050;968;2019;279820;229699;79;509519
93;2020-S45;870;566;1436;171274;113716;89;284990
93;2020-S45;635;192;827;58896;21758;90;80654
93;2020-S45;13574;11072;24687;2639673;2415978;0;5055651
94;2020-S45;8;15;23;16311;17433;09;33744
94;2020-S45;59;65;124;16679;18132;19;34811
94;2020-S45;77;81;158;16782;16579;29;33361
94;2020-S45;74;68;142;23044;20580;39;43624
94;2020-S45;74;70;144;23065;22140;49;45205
94;2020-S45;90;89;179;24549;23421;59;47970
94;2020-S45;60;55;115;23212;21883;69;45095
94;2020-S45;39;32;71;19544;17141;79;36685
94;2020-S45;18;16;34;11227;8178;89;19405
94;2020-S45;5;10;15;3332;1447;90;4779
94;2020-S45;504;501;1005;177745;166934;0;344679
01;2020-S46;1;4;5;19979;20155;09;40134
01;2020-S46;6;9;15;24994;25489;19;50483
01;2020-S46;5;5;10;17868;16690;29;34558
01;2020-S46;16;8;24;22328;14821;39;37149
01;2020-S46;15;11;26;28652;20276;49;48928
01;2020-S46;15;3;18;33264;27260;59;60524
01;2020-S46;10;5;15;27135;23978;69;51113
01;2020-S46;8;7;15;18401;14661;79;33062
01;2020-S46;2;0;2;9633;6375;89;16008
01;2020-S46;0;1;1;3410;1510;90;4920
01;2020-S46;78;53;131;205664;171215;0;376879
02;2020-S46;2;5;7;16881;17110;09;33991
02;2020-S46;33;30;63;21410;21604;19;43014
02;2020-S46;21;16;37;16017;15479;29;31496
02;2020-S46;35;19;54;19825;14455;39;34280
02;2020-S46;45;27;73;24719;18248;49;42967
02;2020-S46;39;34;73;34361;28310;59;62671
02;2020-S46;20;17;39;28061;24495;69;52556
02;2020-S46;13;8;21;18231;15278;79;33509
02;2020-S46;5;6;11;11090;7677;89;18767
02;2020-S46;1;1;2;3992;1506;90;5498
02;2020-S46;214;163;380;194587;164162;0;358749
03;2020-S46;5;5;10;31123;30920;09;62043
03;2020-S46;12;6;18;29370;29268;19;58638
03;2020-S46;16;8;24;21458;18963;29;40421
03;2020-S46;22;20;42;21276;18326;39;39602
03;2020-S46;12;14;26;18164;16593;49;34757
03;2020-S46;12;15;27;13469;13557;59;27026
03;2020-S46;5;4;9;8776;8670;69;17446
03;2020-S46;0;3;3;3777;3591;79;7368
03;2020-S46;0;0;0;1649;1072;89;2721
03;2020-S46;0;0;0;485;184;90;669
03;2020-S46;84;75;159;149547;141144;0;290691
04;2020-S46;11;11;22;60314;61377;09;121691
04;2020-S46;50;53;103;66065;68387;19;134452
04;2020-S46;50;43;93;51059;47156;29;98215
04;2020-S46;48;34;82;58788;45780;39;104568
04;2020-S46;66;42;108;61408;52207;49;113615
04;2020-S46;54;45;99;64838;60759;59;125597
04;2020-S46;22;30;52;47008;42843;69;89851
04;2020-S46;18;9;27;25509;21184;79;46693
04;2020-S46;6;6;12;13168;7647;89;20815
04;2020-S46;1;1;2;3209;1253;90;4462
04;2020-S46;326;274;600;451366;408593;0;859959
05;2020-S46;0;0;0;362.366008612902;341.338819562748;09;703.704828175651
05;2020-S46;0;0;0;353.376145114279;370.349735405642;19;723.725880519921
05;2020-S46;0;0;0;218.593559489256;256.539602589476;29;475.133162078732
05;2020-S46;0;0;0;404.225408693299;360.321910454353;39;764.547319147651
05;2020-S46;0;0;0;520.067953604221;497.108383964256;49;1017.17633756848
05;2020-S46;0;0;0;468.146063921917;510.087601910415;59;978.233665832332
05;2020-S46;0;0;0;340.368470050554;334.366842191253;69;674.735312241807
05;2020-S46;0;0;0;212.598666888387;192.597753227106;79;405.196420115493
05;2020-S46;0;0;0;148.727797095705;61.8681715431829;89;210.595968638888
05;2020-S46;0;0;0;32.9601271090696;10.9909785719784;90;43.9511056810479
05;2020-S46;0;0;0;3061.43020057959;2935.56979942041;0;5997
06;2020-S46;1;2;3;42583;42380;09;84963
06;2020-S46;14;8;22;33369;31925;19;65294
06;2020-S46;31;24;55;21571;15080;29;36651
06;2020-S46;27;20;47;21550;16147;39;37697
06;2020-S46;27;17;44;14193;13939;49;28132
06;2020-S46;14;14;28;7171;7597;59;14768
06;2020-S46;6;6;12;3629;4117;69;7746
06;2020-S46;3;2;5;1577;1457;79;3034
06;2020-S46;0;0;0;531;474;89;1005
06;2020-S46;0;0;0;88;93;90;181
06;2020-S46;123;93;216;146262;133209;0;279471
07;2020-S46;0;0;0;485;549;09;1034
07;2020-S46;1;0;1;403;432;19;835
07;2020-S46;5;0;5;764;841;29;1605
07;2020-S46;6;5;11;824;928;39;1752
07;2020-S46;0;1;1;788;1020;49;1808
07;2020-S46;2;4;6;678;870;59;1548
07;2020-S46;0;1;1;360;382;69;742
07;2020-S46;0;0;0;231;190;79;421
07;2020-S46;0;0;0;114;67;89;181
07;2020-S46;0;0;0;24;11;90;35
07;2020-S46;14;11;25;4671;5290;0;9961
08;2020-S46;0;0;0;2715.22592983026;2997.75551488675;09;5712.98144471701
08;2020-S46;4;1;5;2778.51901080978;3160.9156459093;19;5939.43465671908
08;2020-S46;3;5;8;2080.8882988764;1718.16634315323;29;3799.05464202964
08;2020-S46;4;1;5;2701.8582062647;1896.52641413317;39;4598.38462039786
08;2020-S46;1;0;1;3151.45861023308;2460.52498233809;49;5611.98359257117
08;2020-S46;4;4;8;2620.29868333099;2422.23566154656;59;5042.53434487755
08;2020-S46;1;5;6;1621.44173420671;1438.58325779464;69;3060.02499200135
08;2020-S46;0;0;0;626.575909335673;526.358467843651;79;1152.93437717932
08;2020-S46;0;1;1;205.018522985054;140.993639349697;89;346.012162334751
08;2020-S46;0;0;0;50.0325684687745;20.62259870351;90;70.6551671722846
08;2020-S46;17;17;34;18551.3174743414;16782.6825256586;0;35334
11;2020-S46;408;399;866;783071;811785;09;1594856
11;2020-S46;1653;1490;3258;761456;784653;19;1546109
11;2020-S46;2156;1638;3809;850145;801772;29;1651917
11;2020-S46;2222;1843;4072;914360;843488;39;1757848
11;2020-S46;2217;1803;4029;845609;826202;49;1671811
11;2020-S46;1934;1747;3694;793566;745070;59;1538636
11;2020-S46;1377;1346;2750;628649;549192;69;1177841
11;2020-S46;727;745;1475;434606;358356;79;792962
11;2020-S46;657;443;1102;261425;162933;89;424358
11;2020-S46;492;157;649;89253;32619;90;121872
11;2020-S46;13849;11621;25730;6362140;5916070;0;12278210
24;2020-S46;59;70;134;139720;144686;09;284406
24;2020-S46;368;398;774;152979;161185;19;314164
24;2020-S46;390;319;710;122237;126536;29;248773
24;2020-S46;444;325;769;150359;142009;39;292368
24;2020-S46;472;339;812;161829;158758;49;320587
24;2020-S46;433;377;810;172552;168011;59;340563
24;2020-S46;332;271;604;172509;158177;69;330686
24;2020-S46;213;222;435;129428;110593;79;240021
24;2020-S46;263;166;429;87342;56882;89;144224
24;2020-S46;231;62;293;31210;12071;90;43281
24;2020-S46;3209;2552;5777;1320165;1238908;0;2559073
27;2020-S46;212;183;398;143373;149679;09;293052
27;2020-S46;711;708;1425;160962;173003;19;333965
27;2020-S46;672;564;1236;133746;142254;29;276000
27;2020-S46;729;564;1293;160004;155407;39;315411
27;2020-S46;827;631;1458;172333;169564;49;341897
27;2020-S46;806;659;1465;189979;183788;59;373767
27;2020-S46;569;488;1057;192591;178206;69;370797
27;2020-S46;426;425;851;146876;127546;79;274422
27;2020-S46;468;281;749;96896;61575;89;158471
27;2020-S46;363;105;468;33148;12109;90;45257
27;2020-S46;5785;4609;10403;1429908;1353131;0;2783039
28;2020-S46;119;118;243;180735;186856;09;367591
28;2020-S46;367;325;705;200125;213621;19;413746
28;2020-S46;470;327;797;168922;173007;29;341929
28;2020-S46;468;338;806;196628;188487;39;385115
28;2020-S46;503;374;877;205396;201699;49;407095
28;2020-S46;481;458;939;222002;213866;59;435868
28;2020-S46;362;343;707;224688;203758;69;428446
28;2020-S46;262;254;516;163192;135543;79;298735
28;2020-S46;343;191;535;109691;65377;89;175068
28;2020-S46;253;84;337;37222;12685;90;49907
28;2020-S46;3628;2813;6469;1708601;1594899;0;3303500
32;2020-S46;363;380;745;358062;373689;09;731751
32;2020-S46;1267;1175;2447;387045;406742;19;793787
32;2020-S46;1364;1040;2410;342304;348587;29;690891
32;2020-S46;1353;1088;2446;382485;369972;39;752457
32;2020-S46;1374;1126;2508;382510;376716;49;759226
32;2020-S46;1341;1155;2502;386937;376527;59;763464
32;2020-S46;910;813;1724;371211;330938;69;702149
32;2020-S46;631;600;1231;250542;201459;79;452001
32;2020-S46;686;357;1046;163399;89786;89;253185
32;2020-S46;408;93;502;48384;15367;90;63751
32;2020-S46;9698;7830;17565;3072879;2889783;0;5962662
44;2020-S46;240;276;518;291525;306839;09;598364
44;2020-S46;928;962;1898;320255;339504;19;659759
44;2020-S46;985;810;1801;302020;314428;29;616448
44;2020-S46;1063;797;1864;342222;333292;39;675514
44;2020-S46;1137;846;1988;349727;344491;49;694218
44;2020-S46;1115;970;2091;381371;373239;59;754610
44;2020-S46;728;699;1439;367165;335850;69;703015
44;2020-S46;550;514;1067;250387;215436;79;465823
44;2020-S46;721;409;1133;170825;105192;89;276017
44;2020-S46;413;138;554;51248;16731;90;67979
44;2020-S46;7881;6421;14362;2826745;2685002;0;5511747
52;2020-S46;143;135;283;213594;223900;09;437494
52;2020-S46;526;510;1058;240818;255197;19;496015
52;2020-S46;516;438;954;197010;200630;29;397640
52;2020-S46;567;455;1023;231204;224885;39;456089
52;2020-S46;611;469;1080;243874;243418;49;487292
52;2020-S46;554;516;1070;244100;239116;59;483216
52;2020-S46;370;390;760;241796;221345;69;463141
52;2020-S46;265;283;548;177805;149903;79;327708
52;2020-S46;320;201;521;119561;75822;89;195383
52;2020-S46;256;88;344;42559;15260;90;57819
52;2020-S46;4128;3486;7642;1952321;1849476;0;3801797
53;2020-S46;89;129;223;173813;182358;09;356171
53;2020-S46;297;282;589;202720;214740;19;417460
53;2020-S46;319;293;623;163116;173196;29;336312
53;2020-S46;283;245;528;190526;187674;39;378200
53;2020-S46;328;229;557;212098;212015;49;424113
53;2020-S46;292;270;562;223699;219176;59;442875
53;2020-S46;174;229;403;227435;209274;69;436709
53;2020-S46;143;129;272;169992;140910;79;310902
53;2020-S46;195;132;327;118117;69883;89;188000
53;2020-S46;154;43;199;37370;12267;90;49637
53;2020-S46;2275;1981;4284;1718886;1621493;0;3340379
75;2020-S46;172;174;359;293104;305291;09;598395
75;2020-S46;600;570;1178;337141;357785;19;694926
75;2020-S46;757;635;1395;295024;300618;29;595642
75;2020-S46;745;579;1325;347871;331233;39;679104
75;2020-S46;799;725;1525;384742;372771;49;757513
75;2020-S46;810;763;1573;413361;390880;59;804241
75;2020-S46;567;538;1105;425623;384060;69;809683
75;2020-S46;410;395;805;325086;276298;79;601384
75;2020-S46;536;323;859;213986;139308;89;353294
75;2020-S46;463;133;596;77600;28200;90;105800
75;2020-S46;5861;4835;10722;3113538;2886444;0;5999982
76;2020-S46;189;191;393;305956;318589;09;624545
76;2020-S46;742;766;1532;338942;356969;19;695911
76;2020-S46;899;692;1592;316210;319570;29;635780
76;2020-S46;894;679;1574;356758;337587;39;694345
76;2020-S46;943;772;1716;376541;363812;49;740353
76;2020-S46;988;760;1748;402608;383750;59;786358
76;2020-S46;699;653;1354;394889;358997;69;753886
76;2020-S46;529;502;1031;308664;263806;79;572470
76;2020-S46;685;370;1057;195838;129272;89;325110
76;2020-S46;568;187;756;69372;26728;90;96100
76;2020-S46;7149;5582;12776;3065778;2859080;0;5924858
84;2020-S46;568;557;1131;459549;481088;09;940637
84;2020-S46;2437;2512;5000;487711;511905;19;999616
84;2020-S46;2617;2076;4696;443824;451094;29;894918
84;2020-S46;2715;2039;4757;512522;493262;39;1005784
84;2020-S46;2816;2287;5103;520248;515106;49;1035354
84;2020-S46;2920;2548;5474;529611;514848;59;1044459
84;2020-S46;1820;1824;3647;486720;439940;69;926660
84;2020-S46;1464;1432;2898;372151;315211;79;687362
84;2020-S46;1678;959;2638;237198;150524;89;387722
84;2020-S46;1354;417;1772;81185;28680;90;109865
84;2020-S46;20392;16652;37121;4130719;3901658;0;8032377
93;2020-S46;183;191;375;268834;283093;09;551927
93;2020-S46;782;755;1540;280751;296087;19;576838
93;2020-S46;965;757;1724;254404;255552;29;509956
93;2020-S46;1065;811;1876;310704;288398;39;599102
93;2020-S46;1071;887;1961;325559;305827;49;631386
93;2020-S46;1214;926;2141;353104;325389;59;678493
93;2020-S46;778;777;1557;336327;296459;69;632786
93;2020-S46;642;637;1280;279820;229699;79;509519
93;2020-S46;715;394;1109;171274;113716;89;284990
93;2020-S46;524;164;688;58896;21758;90;80654
93;2020-S46;7947;6307;14267;2639673;2415978;0;5055651
94;2020-S46;7;3;12;16311;17433;09;33744
94;2020-S46;18;21;39;16679;18132;19;34811
94;2020-S46;21;17;38;16782;16579;29;33361
94;2020-S46;24;32;56;23044;20580;39;43624
94;2020-S46;38;30;68;23065;22140;49;45205
94;2020-S46;30;31;61;24549;23421;59;47970
94;2020-S46;25;33;58;23212;21883;69;45095
94;2020-S46;15;18;33;19544;17141;79;36685
94;2020-S46;11;14;25;11227;8178;89;19405
94;2020-S46;7;2;9;3332;1447;90;4779
94;2020-S46;196;201;399;177745;166934;0;344679
01;2020-S47;1;1;2;19979;20155;09;40134
01;2020-S47;6;8;14;24994;25489;19;50483
01;2020-S47;6;3;9;17868;16690;29;34558
01;2020-S47;9;11;20;22328;14821;39;37149
01;2020-S47;9;7;16;28652;20276;49;48928
01;2020-S47;14;7;21;33264;27260;59;60524
01;2020-S47;9;2;11;27135;23978;69;51113
01;2020-S47;3;4;7;18401;14661;79;33062
01;2020-S47;3;2;5;9633;6375;89;16008
01;2020-S47;4;1;5;3410;1510;90;4920
01;2020-S47;64;46;110;205664;171215;0;376879
02;2020-S47;1;1;2;16881;17110;09;33991
02;2020-S47;19;13;32;21410;21604;19;43014
02;2020-S47;11;16;27;16017;15479;29;31496
02;2020-S47;21;21;42;19825;14455;39;34280
02;2020-S47;23;15;38;24719;18248;49;42967
02;2020-S47;26;15;41;34361;28310;59;62671
02;2020-S47;15;6;22;28061;24495;69;52556
02;2020-S47;6;12;18;18231;15278;79;33509
02;2020-S47;3;1;4;11090;7677;89;18767
02;2020-S47;2;0;2;3992;1506;90;5498
02;2020-S47;127;100;228;194587;164162;0;358749
03;2020-S47;4;2;6;31123;30920;09;62043
03;2020-S47;19;10;29;29370;29268;19;58638
03;2020-S47;18;9;27;21458;18963;29;40421
03;2020-S47;23;14;37;21276;18326;39;39602
03;2020-S47;17;13;30;18164;16593;49;34757
03;2020-S47;10;6;16;13469;13557;59;27026
03;2020-S47;5;1;6;8776;8670;69;17446
03;2020-S47;1;2;3;3777;3591;79;7368
03;2020-S47;1;1;2;1649;1072;89;2721
03;2020-S47;2;3;5;485;184;90;669
03;2020-S47;100;62;162;149547;141144;0;290691
04;2020-S47;27;16;43;60314;61377;09;121691
04;2020-S47;58;55;114;66065;68387;19;134452
04;2020-S47;51;36;88;51059;47156;29;98215
04;2020-S47;49;35;84;58788;45780;39;104568
04;2020-S47;43;36;79;61408;52207;49;113615
04;2020-S47;54;28;83;64838;60759;59;125597
04;2020-S47;30;32;62;47008;42843;69;89851
04;2020-S47;7;10;17;25509;21184;79;46693
04;2020-S47;6;3;9;13168;7647;89;20815
04;2020-S47;1;1;2;3209;1253;90;4462
04;2020-S47;326;252;581;451366;408593;0;859959
05;2020-S47;0;0;0;362.366008612902;341.338819562748;09;703.704828175651
05;2020-S47;0;0;0;353.376145114279;370.349735405642;19;723.725880519921
05;2020-S47;0;0;0;218.593559489256;256.539602589476;29;475.133162078732
05;2020-S47;0;0;0;404.225408693299;360.321910454353;39;764.547319147651
05;2020-S47;0;0;0;520.067953604221;497.108383964256;49;1017.17633756848
05;2020-S47;0;0;0;468.146063921917;510.087601910415;59;978.233665832332
05;2020-S47;0;0;0;340.368470050554;334.366842191253;69;674.735312241807
05;2020-S47;0;0;0;212.598666888387;192.597753227106;79;405.196420115493
05;2020-S47;0;0;0;148.727797095705;61.8681715431829;89;210.595968638888
05;2020-S47;0;0;0;32.9601271090696;10.9909785719784;90;43.9511056810479
05;2020-S47;0;0;0;3061.43020057959;2935.56979942041;0;5997
06;2020-S47;3;0;3;42583;42380;09;84963
06;2020-S47;14;11;26;33369;31925;19;65294
06;2020-S47;15;8;23;21571;15080;29;36651
06;2020-S47;20;15;35;21550;16147;39;37697
06;2020-S47;14;18;32;14193;13939;49;28132
06;2020-S47;14;9;23;7171;7597;59;14768
06;2020-S47;6;8;14;3629;4117;69;7746
06;2020-S47;2;1;3;1577;1457;79;3034
06;2020-S47;0;1;1;531;474;89;1005
06;2020-S47;0;0;0;88;93;90;181
06;2020-S47;89;71;161;146262;133209;0;279471
07;2020-S47;0;0;0;485;549;09;1034
07;2020-S47;0;0;0;403;432;19;835
07;2020-S47;1;6;7;764;841;29;1605
07;2020-S47;1;2;3;824;928;39;1752
07;2020-S47;0;3;3;788;1020;49;1808
07;2020-S47;2;0;2;678;870;59;1548
07;2020-S47;0;1;1;360;382;69;742
07;2020-S47;1;0;1;231;190;79;421
07;2020-S47;0;0;0;114;67;89;181
07;2020-S47;0;0;0;24;11;90;35
07;2020-S47;5;12;17;4671;5290;0;9961
08;2020-S47;0;0;0;2715.22592983026;2997.75551488675;09;5712.98144471701
08;2020-S47;3;2;5;2778.51901080978;3160.9156459093;19;5939.43465671908
08;2020-S47;2;2;4;2080.8882988764;1718.16634315323;29;3799.05464202964
08;2020-S47;4;6;10;2701.8582062647;1896.52641413317;39;4598.38462039786
08;2020-S47;3;4;7;3151.45861023308;2460.52498233809;49;5611.98359257117
08;2020-S47;1;0;1;2620.29868333099;2422.23566154656;59;5042.53434487755
08;2020-S47;0;2;2;1621.44173420671;1438.58325779464;69;3060.02499200135
08;2020-S47;1;0;1;626.575909335673;526.358467843651;79;1152.93437717932
08;2020-S47;0;0;0;205.018522985054;140.993639349697;89;346.012162334751
08;2020-S47;0;0;0;50.0325684687745;20.62259870351;90;70.6551671722846
08;2020-S47;14;16;30;18551.3174743414;16782.6825256586;0;35334
11;2020-S47;333;349;712;783071;811785;09;1594856
11;2020-S47;1256;1247;2575;761456;784653;19;1546109
11;2020-S47;1489;1237;2732;850145;801772;29;1651917
11;2020-S47;1716;1361;3082;914360;843488;39;1757848
11;2020-S47;1658;1391;3056;845609;826202;49;1671811
11;2020-S47;1376;1278;2662;793566;745070;59;1538636
11;2020-S47;908;880;1810;628649;549192;69;1177841
11;2020-S47;581;542;1125;434606;358356;79;792962
11;2020-S47;530;337;869;261425;162933;89;424358
11;2020-S47;382;119;501;89253;32619;90;121872
11;2020-S47;10232;8753;19156;6362140;5916070;0;12278210
24;2020-S47;55;41;97;139720;144686;09;284406
24;2020-S47;251;245;498;152979;161185;19;314164
24;2020-S47;263;193;457;122237;126536;29;248773
24;2020-S47;280;215;495;150359;142009;39;292368
24;2020-S47;349;237;586;161829;158758;49;320587
24;2020-S47;271;244;515;172552;168011;59;340563
24;2020-S47;170;189;359;172509;158177;69;330686
24;2020-S47;118;140;258;129428;110593;79;240021
24;2020-S47;172;120;292;87342;56882;89;144224
24;2020-S47;164;42;206;31210;12071;90;43281
24;2020-S47;2093;1666;3763;1320165;1238908;0;2559073
27;2020-S47;124;144;270;143373;149679;09;293052
27;2020-S47;480;503;984;160962;173003;19;333965
27;2020-S47;497;373;871;133746;142254;29;276000
27;2020-S47;473;336;809;160004;155407;39;315411
27;2020-S47;523;413;936;172333;169564;49;341897
27;2020-S47;497;433;930;189979;183788;59;373767
27;2020-S47;353;325;678;192591;178206;69;370797
27;2020-S47;292;255;547;146876;127546;79;274422
27;2020-S47;358;239;597;96896;61575;89;158471
27;2020-S47;281;96;377;33148;12109;90;45257
27;2020-S47;3879;3118;7001;1429908;1353131;0;2783039
28;2020-S47;93;109;207;180735;186856;09;367591
28;2020-S47;294;310;611;200125;213621;19;413746
28;2020-S47;371;270;642;168922;173007;29;341929
28;2020-S47;360;208;568;196628;188487;39;385115
28;2020-S47;398;256;655;205396;201699;49;407095
28;2020-S47;359;278;637;222002;213866;59;435868
28;2020-S47;243;236;480;224688;203758;69;428446
28;2020-S47;179;163;342;163192;135543;79;298735
28;2020-S47;276;148;424;109691;65377;89;175068
28;2020-S47;199;57;256;37222;12685;90;49907
28;2020-S47;2773;2035;4823;1708601;1594899;0;3303500
32;2020-S47;268;237;507;358062;373689;09;731751
32;2020-S47;843;817;1663;387045;406742;19;793787
32;2020-S47;829;683;1514;342304;348587;29;690891
32;2020-S47;920;661;1581;382485;369972;39;752457
32;2020-S47;872;718;1590;382510;376716;49;759226
32;2020-S47;818;719;1539;386937;376527;59;763464
32;2020-S47;543;527;1071;371211;330938;69;702149
32;2020-S47;429;376;805;250542;201459;79;452001
32;2020-S47;524;261;785;163399;89786;89;253185
32;2020-S47;356;93;449;48384;15367;90;63751
32;2020-S47;6403;5093;11508;3072879;2889783;0;5962662
44;2020-S47;184;220;413;291525;306839;09;598364
44;2020-S47;677;702;1395;320255;339504;19;659759
44;2020-S47;729;553;1288;302020;314428;29;616448
44;2020-S47;844;622;1472;342222;333292;39;675514
44;2020-S47;825;630;1462;349727;344491;49;694218
44;2020-S47;786;693;1488;381371;373239;59;754610
44;2020-S47;467;431;907;367165;335850;69;703015
44;2020-S47;357;374;735;250387;215436;79;465823
44;2020-S47;569;293;865;170825;105192;89;276017
44;2020-S47;409;114;526;51248;16731;90;67979
44;2020-S47;5847;4632;10551;2826745;2685002;0;5511747
52;2020-S47;62;84;157;213594;223900;09;437494
52;2020-S47;298;256;568;240818;255197;19;496015
52;2020-S47;297;219;516;197010;200630;29;397640
52;2020-S47;340;231;571;231204;224885;39;456089
52;2020-S47;354;277;632;243874;243418;49;487292
52;2020-S47;325;251;577;244100;239116;59;483216
52;2020-S47;175;195;370;241796;221345;69;463141
52;2020-S47;155;122;277;177805;149903;79;327708
52;2020-S47;258;130;389;119561;75822;89;195383
52;2020-S47;222;73;295;42559;15260;90;57819
52;2020-S47;2486;1838;4352;1952321;1849476;0;3801797
53;2020-S47;43;48;97;173813;182358;09;356171
53;2020-S47;141;130;280;202720;214740;19;417460
53;2020-S47;156;140;312;163116;173196;29;336312
53;2020-S47;129;112;241;190526;187674;39;378200
53;2020-S47;165;126;291;212098;212015;49;424113
53;2020-S47;162;133;295;223699;219176;59;442875
53;2020-S47;92;98;190;227435;209274;69;436709
53;2020-S47;76;67;143;169992;140910;79;310902
53;2020-S47;148;70;218;118117;69883;89;188000
53;2020-S47;138;30;168;37370;12267;90;49637
53;2020-S47;1250;954;2235;1718886;1621493;0;3340379
75;2020-S47;126;125;258;293104;305291;09;598395
75;2020-S47;395;401;802;337141;357785;19;694926
75;2020-S47;496;343;839;295024;300618;29;595642
75;2020-S47;474;356;830;347871;331233;39;679104
75;2020-S47;554;400;954;384742;372771;49;757513
75;2020-S47;508;420;928;413361;390880;59;804241
75;2020-S47;296;305;602;425623;384060;69;809683
75;2020-S47;258;221;480;325086;276298;79;601384
75;2020-S47;386;231;618;213986;139308;89;353294
75;2020-S47;398;120;518;77600;28200;90;105800
75;2020-S47;3892;2922;6830;3113538;2886444;0;5999982
76;2020-S47;102;118;226;305956;318589;09;624545
76;2020-S47;402;377;788;338942;356969;19;695911
76;2020-S47;509;413;923;316210;319570;29;635780
76;2020-S47;541;393;935;356758;337587;39;694345
76;2020-S47;566;413;981;376541;363812;49;740353
76;2020-S47;597;476;1073;402608;383750;59;786358
76;2020-S47;367;380;747;394889;358997;69;753886
76;2020-S47;271;280;553;308664;263806;79;572470
76;2020-S47;385;238;624;195838;129272;89;325110
76;2020-S47;329;89;418;69372;26728;90;96100
76;2020-S47;4079;3183;7284;3065778;2859080;0;5924858
84;2020-S47;366;423;801;459549;481088;09;940637
84;2020-S47;1551;1562;3134;487711;511905;19;999616
84;2020-S47;1596;1240;2841;443824;451094;29;894918
84;2020-S47;1702;1276;2980;512522;493262;39;1005784
84;2020-S47;1899;1485;3384;520248;515106;49;1035354
84;2020-S47;1685;1535;3220;529611;514848;59;1044459
84;2020-S47;1007;989;1996;486720;439940;69;926660
84;2020-S47;747;749;1496;372151;315211;79;687362
84;2020-S47;1103;568;1671;237198;150524;89;387722
84;2020-S47;935;259;1194;81185;28680;90;109865
84;2020-S47;12593;10088;22721;4130719;3901658;0;8032377
93;2020-S47;207;216;463;268834;283093;09;551927
93;2020-S47;485;586;1075;280751;296087;19;576838
93;2020-S47;675;549;1224;254404;255552;29;509956
93;2020-S47;687;596;1286;310704;288398;39;599102
93;2020-S47;749;583;1332;325559;305827;49;631386
93;2020-S47;742;590;1337;353104;325389;59;678493
93;2020-S47;500;462;963;336327;296459;69;632786
93;2020-S47;381;373;754;279820;229699;79;509519
93;2020-S47;461;279;741;171274;113716;89;284990
93;2020-S47;357;121;479;58896;21758;90;80654
93;2020-S47;5278;4376;9808;2639673;2415978;0;5055651
94;2020-S47;4;3;7;16311;17433;09;33744
94;2020-S47;9;7;17;16679;18132;19;34811
94;2020-S47;9;10;19;16782;16579;29;33361
94;2020-S47;10;19;29;23044;20580;39;43624
94;2020-S47;14;22;36;23065;22140;49;45205
94;2020-S47;12;15;27;24549;23421;59;47970
94;2020-S47;10;15;25;23212;21883;69;45095
94;2020-S47;5;9;14;19544;17141;79;36685
94;2020-S47;3;7;10;11227;8178;89;19405
94;2020-S47;1;0;1;3332;1447;90;4779
94;2020-S47;77;107;185;177745;166934;0;344679
01;2020-S48;1;0;1;19979;20155;09;40134
01;2020-S48;4;6;10;24994;25489;19;50483
01;2020-S48;6;3;9;17868;16690;29;34558
01;2020-S48;5;3;8;22328;14821;39;37149
01;2020-S48;2;5;7;28652;20276;49;48928
01;2020-S48;6;4;10;33264;27260;59;60524
01;2020-S48;6;8;14;27135;23978;69;51113
01;2020-S48;7;5;12;18401;14661;79;33062
01;2020-S48;1;1;2;9633;6375;89;16008
01;2020-S48;0;0;0;3410;1510;90;4920
01;2020-S48;38;35;73;205664;171215;0;376879
02;2020-S48;0;0;0;16881;17110;09;33991
02;2020-S48;11;9;20;21410;21604;19;43014
02;2020-S48;5;9;14;16017;15479;29;31496
02;2020-S48;9;17;26;19825;14455;39;34280
02;2020-S48;7;6;13;24719;18248;49;42967
02;2020-S48;11;5;17;34361;28310;59;62671
02;2020-S48;6;5;11;28061;24495;69;52556
02;2020-S48;3;0;3;18231;15278;79;33509
02;2020-S48;0;0;0;11090;7677;89;18767
02;2020-S48;1;0;1;3992;1506;90;5498
02;2020-S48;53;51;105;194587;164162;0;358749
03;2020-S48;2;5;7;31123;30920;09;62043
03;2020-S48;20;22;42;29370;29268;19;58638
03;2020-S48;15;11;26;21458;18963;29;40421
03;2020-S48;22;18;40;21276;18326;39;39602
03;2020-S48;6;10;16;18164;16593;49;34757
03;2020-S48;9;10;19;13469;13557;59;27026
03;2020-S48;5;7;12;8776;8670;69;17446
03;2020-S48;4;3;7;3777;3591;79;7368
03;2020-S48;2;1;3;1649;1072;89;2721
03;2020-S48;0;0;0;485;184;90;669
03;2020-S48;85;87;173;149547;141144;0;290691
04;2020-S48;9;8;17;60314;61377;09;121691
04;2020-S48;37;35;72;66065;68387;19;134452
04;2020-S48;30;32;62;51059;47156;29;98215
04;2020-S48;25;17;42;58788;45780;39;104568
04;2020-S48;23;19;42;61408;52207;49;113615
04;2020-S48;20;27;47;64838;60759;59;125597
04;2020-S48;13;17;30;47008;42843;69;89851
04;2020-S48;10;4;14;25509;21184;79;46693
04;2020-S48;5;3;8;13168;7647;89;20815
04;2020-S48;0;0;0;3209;1253;90;4462
04;2020-S48;172;162;334;451366;408593;0;859959
05;2020-S48;0;0;0;362.366008612902;341.338819562748;09;703.704828175651
05;2020-S48;0;0;0;353.376145114279;370.349735405642;19;723.725880519921
05;2020-S48;0;0;0;218.593559489256;256.539602589476;29;475.133162078732
05;2020-S48;0;0;0;404.225408693299;360.321910454353;39;764.547319147651
05;2020-S48;0;0;0;520.067953604221;497.108383964256;49;1017.17633756848
05;2020-S48;0;0;0;468.146063921917;510.087601910415;59;978.233665832332
05;2020-S48;0;0;0;340.368470050554;334.366842191253;69;674.735312241807
05;2020-S48;0;0;0;212.598666888387;192.597753227106;79;405.196420115493
05;2020-S48;0;0;0;148.727797095705;61.8681715431829;89;210.595968638888
05;2020-S48;0;0;0;32.9601271090696;10.9909785719784;90;43.9511056810479
05;2020-S48;0;0;0;3061.43020057959;2935.56979942041;0;5997
06;2020-S48;2;0;3;42583;42380;09;84963
06;2020-S48;10;4;16;33369;31925;19;65294
06;2020-S48;18;10;29;21571;15080;29;36651
06;2020-S48;17;11;28;21550;16147;39;37697
06;2020-S48;14;8;22;14193;13939;49;28132
06;2020-S48;9;5;14;7171;7597;59;14768
06;2020-S48;1;3;4;3629;4117;69;7746
06;2020-S48;1;3;4;1577;1457;79;3034
06;2020-S48;0;1;1;531;474;89;1005
06;2020-S48;1;0;1;88;93;90;181
06;2020-S48;73;45;122;146262;133209;0;279471
07;2020-S48;0;0;0;485;549;09;1034
07;2020-S48;1;1;2;403;432;19;835
07;2020-S48;2;0;2;764;841;29;1605
07;2020-S48;3;1;4;824;928;39;1752
07;2020-S48;0;2;2;788;1020;49;1808
07;2020-S48;0;2;2;678;870;59;1548
07;2020-S48;1;0;1;360;382;69;742
07;2020-S48;0;0;0;231;190;79;421
07;2020-S48;0;0;0;114;67;89;181
07;2020-S48;0;0;0;24;11;90;35
07;2020-S48;7;6;13;4671;5290;0;9961
08;2020-S48;0;1;1;2715.22592983026;2997.75551488675;09;5712.98144471701
08;2020-S48;4;6;10;2778.51901080978;3160.9156459093;19;5939.43465671908
08;2020-S48;8;8;16;2080.8882988764;1718.16634315323;29;3799.05464202964
08;2020-S48;12;6;18;2701.8582062647;1896.52641413317;39;4598.38462039786
08;2020-S48;6;7;13;3151.45861023308;2460.52498233809;49;5611.98359257117
08;2020-S48;5;5;10;2620.29868333099;2422.23566154656;59;5042.53434487755
08;2020-S48;1;5;6;1621.44173420671;1438.58325779464;69;3060.02499200135
08;2020-S48;0;0;0;626.575909335673;526.358467843651;79;1152.93437717932
08;2020-S48;0;0;0;205.018522985054;140.993639349697;89;346.012162334751
08;2020-S48;0;0;0;50.0325684687745;20.62259870351;90;70.6551671722846
08;2020-S48;36;38;74;18551.3174743414;16782.6825256586;0;35334
11;2020-S48;259;233;518;783071;811785;09;1594856
11;2020-S48;900;905;1862;761456;784653;19;1546109
11;2020-S48;1199;998;2207;850145;801772;29;1651917
11;2020-S48;1353;1034;2393;914360;843488;39;1757848
11;2020-S48;1202;1082;2299;845609;826202;49;1671811
11;2020-S48;1028;972;2007;793566;745070;59;1538636
11;2020-S48;677;638;1321;628649;549192;69;1177841
11;2020-S48;375;403;780;434606;358356;79;792962
11;2020-S48;395;277;675;261425;162933;89;424358
11;2020-S48;292;114;406;89253;32619;90;121872
11;2020-S48;7683;6661;14479;6362140;5916070;0;12278210
24;2020-S48;32;31;64;139720;144686;09;284406
24;2020-S48;147;163;312;152979;161185;19;314164
24;2020-S48;191;117;308;122237;126536;29;248773
24;2020-S48;210;136;346;150359;142009;39;292368
24;2020-S48;220;140;362;161829;158758;49;320587
24;2020-S48;204;207;412;172552;168011;59;340563
24;2020-S48;124;114;239;172509;158177;69;330686
24;2020-S48;116;92;208;129428;110593;79;240021
24;2020-S48;148;110;258;87342;56882;89;144224
24;2020-S48;155;48;203;31210;12071;90;43281
24;2020-S48;1549;1159;2715;1320165;1238908;0;2559073
27;2020-S48;84;85;171;143373;149679;09;293052
27;2020-S48;320;294;617;160962;173003;19;333965
27;2020-S48;324;254;578;133746;142254;29;276000
27;2020-S48;342;263;605;160004;155407;39;315411
27;2020-S48;454;270;724;172333;169564;49;341897
27;2020-S48;410;313;723;189979;183788;59;373767
27;2020-S48;204;217;422;192591;178206;69;370797
27;2020-S48;192;186;378;146876;127546;79;274422
27;2020-S48;330;170;500;96896;61575;89;158471
27;2020-S48;282;86;368;33148;12109;90;45257
27;2020-S48;2942;2138;5087;1429908;1353131;0;2783039
28;2020-S48;46;56;105;180735;186856;09;367591
28;2020-S48;195;178;379;200125;213621;19;413746
28;2020-S48;195;135;330;168922;173007;29;341929
28;2020-S48;233;135;370;196628;188487;39;385115
28;2020-S48;240;173;413;205396;201699;49;407095
28;2020-S48;205;172;378;222002;213866;59;435868
28;2020-S48;148;132;280;224688;203758;69;428446
28;2020-S48;111;103;215;163192;135543;79;298735
28;2020-S48;183;98;281;109691;65377;89;175068
28;2020-S48;145;46;191;37222;12685;90;49907
28;2020-S48;1701;1229;2943;1708601;1594899;0;3303500
32;2020-S48;160;144;304;358062;373689;09;731751
32;2020-S48;520;466;986;387045;406742;19;793787
32;2020-S48;561;422;983;342304;348587;29;690891
32;2020-S48;629;417;1046;382485;369972;39;752457
32;2020-S48;588;429;1017;382510;376716;49;759226
32;2020-S48;554;498;1052;386937;376527;59;763464
32;2020-S48;339;312;651;371211;330938;69;702149
32;2020-S48;316;262;578;250542;201459;79;452001
32;2020-S48;364;169;533;163399;89786;89;253185
32;2020-S48;288;61;349;48384;15367;90;63751
32;2020-S48;4319;3181;7500;3072879;2889783;0;5962662
44;2020-S48;131;155;291;291525;306839;09;598364
44;2020-S48;444;426;873;320255;339504;19;659759
44;2020-S48;513;387;903;302020;314428;29;616448
44;2020-S48;543;417;964;342222;333292;39;675514
44;2020-S48;598;453;1056;349727;344491;49;694218
44;2020-S48;574;454;1034;381371;373239;59;754610
44;2020-S48;332;316;652;367165;335850;69;703015
44;2020-S48;274;265;541;250387;215436;79;465823
44;2020-S48;485;232;723;170825;105192;89;276017
44;2020-S48;355;111;470;51248;16731;90;67979
44;2020-S48;4249;3216;7507;2826745;2685002;0;5511747
52;2020-S48;45;42;87;213594;223900;09;437494
52;2020-S48;186;150;345;240818;255197;19;496015
52;2020-S48;219;158;377;197010;200630;29;397640
52;2020-S48;194;158;352;231204;224885;39;456089
52;2020-S48;206;174;380;243874;243418;49;487292
52;2020-S48;219;170;389;244100;239116;59;483216
52;2020-S48;102;85;187;241796;221345;69;463141
52;2020-S48;77;68;145;177805;149903;79;327708
52;2020-S48;179;95;275;119561;75822;89;195383
52;2020-S48;164;60;224;42559;15260;90;57819
52;2020-S48;1591;1160;2761;1952321;1849476;0;3801797
53;2020-S48;32;49;83;173813;182358;09;356171
53;2020-S48;93;80;176;202720;214740;19;417460
53;2020-S48;105;72;182;163116;173196;29;336312
53;2020-S48;104;77;182;190526;187674;39;378200
53;2020-S48;120;86;206;212098;212015;49;424113
53;2020-S48;109;77;186;223699;219176;59;442875
53;2020-S48;59;61;120;227435;209274;69;436709
53;2020-S48;42;29;71;169992;140910;79;310902
53;2020-S48;85;48;133;118117;69883;89;188000
53;2020-S48;58;16;74;37370;12267;90;49637
53;2020-S48;808;595;1414;1718886;1621493;0;3340379
75;2020-S48;77;69;150;293104;305291;09;598395
75;2020-S48;260;234;498;337141;357785;19;694926
75;2020-S48;385;261;647;295024;300618;29;595642
75;2020-S48;392;269;661;347871;331233;39;679104
75;2020-S48;410;264;675;384742;372771;49;757513
75;2020-S48;409;262;671;413361;390880;59;804241
75;2020-S48;196;192;388;425623;384060;69;809683
75;2020-S48;179;174;353;325086;276298;79;601384
75;2020-S48;311;158;469;213986;139308;89;353294
75;2020-S48;300;79;380;77600;28200;90;105800
75;2020-S48;2920;1962;4893;3113538;2886444;0;5999982
76;2020-S48;68;70;142;305956;318589;09;624545
76;2020-S48;277;270;557;338942;356969;19;695911
76;2020-S48;310;231;542;316210;319570;29;635780
76;2020-S48;386;276;662;356758;337587;39;694345
76;2020-S48;407;319;728;376541;363812;49;740353
76;2020-S48;396;271;667;402608;383750;59;786358
76;2020-S48;247;208;456;394889;358997;69;753886
76;2020-S48;187;190;377;308664;263806;79;572470
76;2020-S48;302;150;452;195838;129272;89;325110
76;2020-S48;266;94;360;69372;26728;90;96100
76;2020-S48;2851;2084;4953;3065778;2859080;0;5924858
84;2020-S48;231;266;504;459549;481088;09;940637
84;2020-S48;964;1018;1993;487711;511905;19;999616
84;2020-S48;1026;718;1746;443824;451094;29;894918
84;2020-S48;1088;787;1878;512522;493262;39;1005784
84;2020-S48;1166;932;2099;520248;515106;49;1035354
84;2020-S48;1089;908;1999;529611;514848;59;1044459
84;2020-S48;589;581;1170;486720;439940;69;926660
84;2020-S48;506;496;1002;372151;315211;79;687362
84;2020-S48;804;410;1214;237198;150524;89;387722
84;2020-S48;718;193;911;81185;28680;90;109865
84;2020-S48;8181;6310;14519;4130719;3901658;0;8032377
93;2020-S48;101;113;214;268834;283093;09;551927
93;2020-S48;405;407;814;280751;296087;19;576838
93;2020-S48;527;441;970;254404;255552;29;509956
93;2020-S48;506;422;932;310704;288398;39;599102
93;2020-S48;555;430;985;325559;305827;49;631386
93;2020-S48;541;430;974;353104;325389;59;678493
93;2020-S48;323;332;659;336327;296459;69;632786
93;2020-S48;259;260;519;279820;229699;79;509519
93;2020-S48;366;192;558;171274;113716;89;284990
93;2020-S48;255;72;327;58896;21758;90;80654
93;2020-S48;3840;3101;6956;2639673;2415978;0;5055651
94;2020-S48;1;2;3;16311;17433;09;33744
94;2020-S48;8;10;18;16679;18132;19;34811
94;2020-S48;7;9;16;16782;16579;29;33361
94;2020-S48;2;12;14;23044;20580;39;43624
94;2020-S48;8;11;19;23065;22140;49;45205
94;2020-S48;7;6;13;24549;23421;59;47970
94;2020-S48;6;5;11;23212;21883;69;45095
94;2020-S48;5;4;9;19544;17141;79;36685
94;2020-S48;6;3;9;11227;8178;89;19405
94;2020-S48;3;0;3;3332;1447;90;4779
94;2020-S48;53;63;116;177745;166934;0;344679
01;2020-S49;0;1;1;19979;20155;09;40134
01;2020-S49;2;2;4;24994;25489;19;50483
01;2020-S49;2;3;5;17868;16690;29;34558
01;2020-S49;7;3;10;22328;14821;39;37149
01;2020-S49;5;4;9;28652;20276;49;48928
01;2020-S49;3;6;9;33264;27260;59;60524
01;2020-S49;3;4;7;27135;23978;69;51113
01;2020-S49;1;2;3;18401;14661;79;33062
01;2020-S49;0;0;0;9633;6375;89;16008
01;2020-S49;0;0;0;3410;1510;90;4920
01;2020-S49;23;25;49;205664;171215;0;376879
02;2020-S49;0;2;2;16881;17110;09;33991
02;2020-S49;2;1;3;21410;21604;19;43014
02;2020-S49;5;2;7;16017;15479;29;31496
02;2020-S49;5;1;6;19825;14455;39;34280
02;2020-S49;2;9;11;24719;18248;49;42967
02;2020-S49;7;8;15;34361;28310;59;62671
02;2020-S49;4;6;10;28061;24495;69;52556
02;2020-S49;2;1;3;18231;15278;79;33509
02;2020-S49;1;0;1;11090;7677;89;18767
02;2020-S49;1;0;1;3992;1506;90;5498
02;2020-S49;29;30;59;194587;164162;0;358749
03;2020-S49;3;2;6;31123;30920;09;62043
03;2020-S49;32;17;50;29370;29268;19;58638
03;2020-S49;29;28;58;21458;18963;29;40421
03;2020-S49;30;28;58;21276;18326;39;39602
03;2020-S49;19;19;38;18164;16593;49;34757
03;2020-S49;9;12;21;13469;13557;59;27026
03;2020-S49;4;12;16;8776;8670;69;17446
03;2020-S49;3;1;4;3777;3591;79;7368
03;2020-S49;0;0;0;1649;1072;89;2721
03;2020-S49;0;0;0;485;184;90;669
03;2020-S49;129;119;251;149547;141144;0;290691
04;2020-S49;8;8;16;60314;61377;09;121691
04;2020-S49;29;38;67;66065;68387;19;134452
04;2020-S49;32;21;53;51059;47156;29;98215
04;2020-S49;19;8;27;58788;45780;39;104568
04;2020-S49;19;12;31;61408;52207;49;113615
04;2020-S49;21;12;33;64838;60759;59;125597
04;2020-S49;7;7;14;47008;42843;69;89851
04;2020-S49;8;4;12;25509;21184;79;46693
04;2020-S49;2;1;3;13168;7647;89;20815
04;2020-S49;0;0;0;3209;1253;90;4462
04;2020-S49;145;111;256;451366;408593;0;859959
05;2020-S49;0;0;0;362.366008612902;341.338819562748;09;703.704828175651
05;2020-S49;0;0;0;353.376145114279;370.349735405642;19;723.725880519921
05;2020-S49;0;0;0;218.593559489256;256.539602589476;29;475.133162078732
05;2020-S49;0;0;0;404.225408693299;360.321910454353;39;764.547319147651
05;2020-S49;0;0;0;520.067953604221;497.108383964256;49;1017.17633756848
05;2020-S49;1;0;1;468.146063921917;510.087601910415;59;978.233665832332
05;2020-S49;0;0;0;340.368470050554;334.366842191253;69;674.735312241807
05;2020-S49;0;0;0;212.598666888387;192.597753227106;79;405.196420115493
05;2020-S49;0;0;0;148.727797095705;61.8681715431829;89;210.595968638888
05;2020-S49;0;0;0;32.9601271090696;10.9909785719784;90;43.9511056810479
05;2020-S49;1;0;1;3061.43020057959;2935.56979942041;0;5997
06;2020-S49;0;2;2;42583;42380;09;84963
06;2020-S49;13;5;18;33369;31925;19;65294
06;2020-S49;22;23;45;21571;15080;29;36651
06;2020-S49;29;25;54;21550;16147;39;37697
06;2020-S49;19;17;36;14193;13939;49;28132
06;2020-S49;5;11;16;7171;7597;59;14768
06;2020-S49;4;11;15;3629;4117;69;7746
06;2020-S49;0;2;2;1577;1457;79;3034
06;2020-S49;1;0;1;531;474;89;1005
06;2020-S49;1;0;1;88;93;90;181
06;2020-S49;94;96;190;146262;133209;0;279471
07;2020-S49;0;0;0;485;549;09;1034
07;2020-S49;0;0;0;403;432;19;835
07;2020-S49;2;0;2;764;841;29;1605
07;2020-S49;2;0;2;824;928;39;1752
07;2020-S49;0;2;2;788;1020;49;1808
07;2020-S49;1;0;1;678;870;59;1548
07;2020-S49;2;0;2;360;382;69;742
07;2020-S49;0;1;1;231;190;79;421
07;2020-S49;1;0;1;114;67;89;181
07;2020-S49;0;0;0;24;11;90;35
07;2020-S49;8;3;11;4671;5290;0;9961
08;2020-S49;0;0;0;2715.22592983026;2997.75551488675;09;5712.98144471701
08;2020-S49;6;3;9;2778.51901080978;3160.9156459093;19;5939.43465671908
08;2020-S49;9;4;13;2080.8882988764;1718.16634315323;29;3799.05464202964
08;2020-S49;14;6;20;2701.8582062647;1896.52641413317;39;4598.38462039786
08;2020-S49;5;9;14;3151.45861023308;2460.52498233809;49;5611.98359257117
08;2020-S49;2;8;10;2620.29868333099;2422.23566154656;59;5042.53434487755
08;2020-S49;3;1;4;1621.44173420671;1438.58325779464;69;3060.02499200135
08;2020-S49;1;3;4;626.575909335673;526.358467843651;79;1152.93437717932
08;2020-S49;0;0;0;205.018522985054;140.993639349697;89;346.012162334751
08;2020-S49;0;0;0;50.0325684687745;20.62259870351;90;70.6551671722846
08;2020-S49;40;34;74;18551.3174743414;16782.6825256586;0;35334
11;2020-S49;220;237;481;783071;811785;09;1594856
11;2020-S49;693;733;1464;761456;784653;19;1546109
11;2020-S49;1143;912;2062;850145;801772;29;1651917
11;2020-S49;1199;1049;2260;914360;843488;39;1757848
11;2020-S49;1095;955;2058;845609;826202;49;1671811
11;2020-S49;969;819;1798;793566;745070;59;1538636
11;2020-S49;596;585;1199;628649;549192;69;1177841
11;2020-S49;321;364;685;434606;358356;79;792962
11;2020-S49;351;236;587;261425;162933;89;424358
11;2020-S49;225;89;314;89253;32619;90;121872
11;2020-S49;6815;5982;12916;6362140;5916070;0;12278210
24;2020-S49;23;37;60;139720;144686;09;284406
24;2020-S49;165;177;345;152979;161185;19;314164
24;2020-S49;179;129;308;122237;126536;29;248773
24;2020-S49;231;132;363;150359;142009;39;292368
24;2020-S49;231;165;396;161829;158758;49;320587
24;2020-S49;201;160;361;172552;168011;59;340563
24;2020-S49;118;120;238;172509;158177;69;330686
24;2020-S49;95;88;184;129428;110593;79;240021
24;2020-S49;162;87;249;87342;56882;89;144224
24;2020-S49;133;61;194;31210;12071;90;43281
24;2020-S49;1539;1157;2700;1320165;1238908;0;2559073
27;2020-S49;70;82;155;143373;149679;09;293052
27;2020-S49;258;296;557;160962;173003;19;333965
27;2020-S49;353;241;594;133746;142254;29;276000
27;2020-S49;344;230;574;160004;155407;39;315411
27;2020-S49;380;310;690;172333;169564;49;341897
27;2020-S49;400;312;712;189979;183788;59;373767
27;2020-S49;250;233;483;192591;178206;69;370797
27;2020-S49;191;191;383;146876;127546;79;274422
27;2020-S49;279;169;448;96896;61575;89;158471
27;2020-S49;312;97;409;33148;12109;90;45257
27;2020-S49;2837;2161;5005;1429908;1353131;0;2783039
28;2020-S49;45;43;93;180735;186856;09;367591
28;2020-S49;164;113;284;200125;213621;19;413746
28;2020-S49;202;134;336;168922;173007;29;341929
28;2020-S49;172;133;305;196628;188487;39;385115
28;2020-S49;183;143;326;205396;201699;49;407095
28;2020-S49;183;141;324;222002;213866;59;435868
28;2020-S49;122;113;235;224688;203758;69;428446
28;2020-S49;98;82;180;163192;135543;79;298735
28;2020-S49;156;67;223;109691;65377;89;175068
28;2020-S49;146;32;178;37222;12685;90;49907
28;2020-S49;1471;1002;2485;1708601;1594899;0;3303500
32;2020-S49;131;123;255;358062;373689;09;731751
32;2020-S49;416;369;785;387045;406742;19;793787
32;2020-S49;573;414;987;342304;348587;29;690891
32;2020-S49;542;392;935;382485;369972;39;752457
32;2020-S49;549;450;999;382510;376716;49;759226
32;2020-S49;484;419;903;386937;376527;59;763464
32;2020-S49;293;285;579;371211;330938;69;702149
32;2020-S49;251;216;467;250542;201459;79;452001
32;2020-S49;383;186;569;163399;89786;89;253185
32;2020-S49;352;65;417;48384;15367;90;63751
32;2020-S49;3974;2920;6897;3072879;2889783;0;5962662
44;2020-S49;133;147;282;291525;306839;09;598364
44;2020-S49;429;402;834;320255;339504;19;659759
44;2020-S49;577;447;1032;302020;314428;29;616448
44;2020-S49;613;452;1070;342222;333292;39;675514
44;2020-S49;600;474;1080;349727;344491;49;694218
44;2020-S49;625;516;1147;381371;373239;59;754610
44;2020-S49;395;341;737;367165;335850;69;703015
44;2020-S49;298;279;582;250387;215436;79;465823
44;2020-S49;482;255;740;170825;105192;89;276017
44;2020-S49;398;83;482;51248;16731;90;67979
44;2020-S49;4550;3396;7987;2826745;2685002;0;5511747
52;2020-S49;33;43;79;213594;223900;09;437494
52;2020-S49;138;139;285;240818;255197;19;496015
52;2020-S49;255;153;409;197010;200630;29;397640
52;2020-S49;247;136;384;231204;224885;39;456089
52;2020-S49;223;172;395;243874;243418;49;487292
52;2020-S49;224;174;398;244100;239116;59;483216
52;2020-S49;103;113;216;241796;221345;69;463141
52;2020-S49;88;96;185;177805;149903;79;327708
52;2020-S49;207;95;302;119561;75822;89;195383
52;2020-S49;185;70;255;42559;15260;90;57819
52;2020-S49;1703;1191;2908;1952321;1849476;0;3801797
53;2020-S49;34;30;69;173813;182358;09;356171
53;2020-S49;93;67;160;202720;214740;19;417460
53;2020-S49;111;80;194;163116;173196;29;336312
53;2020-S49;126;74;200;190526;187674;39;378200
53;2020-S49;112;76;189;212098;212015;49;424113
53;2020-S49;118;68;186;223699;219176;59;442875
53;2020-S49;65;50;115;227435;209274;69;436709
53;2020-S49;52;33;85;169992;140910;79;310902
53;2020-S49;88;47;135;118117;69883;89;188000
53;2020-S49;72;19;91;37370;12267;90;49637
53;2020-S49;871;544;1425;1718886;1621493;0;3340379
75;2020-S49;77;86;167;293104;305291;09;598395
75;2020-S49;258;243;510;337141;357785;19;694926
75;2020-S49;392;260;652;295024;300618;29;595642
75;2020-S49;418;264;682;347871;331233;39;679104
75;2020-S49;417;252;669;384742;372771;49;757513
75;2020-S49;387;302;689;413361;390880;59;804241
75;2020-S49;237;221;458;425623;384060;69;809683
75;2020-S49;170;150;320;325086;276298;79;601384
75;2020-S49;358;201;559;213986;139308;89;353294
75;2020-S49;330;104;434;77600;28200;90;105800
75;2020-S49;3046;2083;5142;3113538;2886444;0;5999982
76;2020-S49;45;60;114;305956;318589;09;624545
76;2020-S49;289;273;578;338942;356969;19;695911
76;2020-S49;370;269;640;316210;319570;29;635780
76;2020-S49;365;262;627;356758;337587;39;694345
76;2020-S49;378;286;664;376541;363812;49;740353
76;2020-S49;348;269;617;402608;383750;59;786358
76;2020-S49;191;239;430;394889;358997;69;753886
76;2020-S49;187;151;339;308664;263806;79;572470
76;2020-S49;255;155;410;195838;129272;89;325110
76;2020-S49;266;77;343;69372;26728;90;96100
76;2020-S49;2696;2044;4767;3065778;2859080;0;5924858
84;2020-S49;211;228;441;459549;481088;09;940637
84;2020-S49;795;798;1601;487711;511905;19;999616
84;2020-S49;953;750;1704;443824;451094;29;894918
84;2020-S49;988;741;1730;512522;493262;39;1005784
84;2020-S49;990;751;1741;520248;515106;49;1035354
84;2020-S49;911;770;1681;529611;514848;59;1044459
84;2020-S49;587;572;1159;486720;439940;69;926660
84;2020-S49;474;411;885;372151;315211;79;687362
84;2020-S49;727;407;1134;237198;150524;89;387722
84;2020-S49;645;177;822;81185;28680;90;109865
84;2020-S49;7281;5605;12899;4130719;3901658;0;8032377
93;2020-S49;114;197;312;268834;283093;09;551927
93;2020-S49;346;390;740;280751;296087;19;576838
93;2020-S49;491;339;830;254404;255552;29;509956
93;2020-S49;546;386;932;310704;288398;39;599102
93;2020-S49;505;387;895;325559;305827;49;631386
93;2020-S49;482;410;893;353104;325389;59;678493
93;2020-S49;307;305;613;336327;296459;69;632786
93;2020-S49;230;203;433;279820;229699;79;509519
93;2020-S49;336;176;512;171274;113716;89;284990
93;2020-S49;282;72;354;58896;21758;90;80654
93;2020-S49;3640;2865;6516;2639673;2415978;0;5055651
94;2020-S49;1;3;4;16311;17433;09;33744
94;2020-S49;3;8;11;16679;18132;19;34811
94;2020-S49;7;11;18;16782;16579;29;33361
94;2020-S49;6;6;12;23044;20580;39;43624
94;2020-S49;6;8;14;23065;22140;49;45205
94;2020-S49;9;5;14;24549;23421;59;47970
94;2020-S49;1;6;7;23212;21883;69;45095
94;2020-S49;2;4;6;19544;17141;79;36685
94;2020-S49;10;1;11;11227;8178;89;19405
94;2020-S49;6;7;13;3332;1447;90;4779
94;2020-S49;51;59;110;177745;166934;0;344679
01;2020-S50;0;0;0;19979;20155;09;40134
01;2020-S50;3;1;4;24994;25489;19;50483
01;2020-S50;7;1;8;17868;16690;29;34558
01;2020-S50;3;4;7;22328;14821;39;37149
01;2020-S50;7;3;10;28652;20276;49;48928
01;2020-S50;7;3;10;33264;27260;59;60524
01;2020-S50;2;2;4;27135;23978;69;51113
01;2020-S50;0;3;3;18401;14661;79;33062
01;2020-S50;0;0;0;9633;6375;89;16008
01;2020-S50;1;0;1;3410;1510;90;4920
01;2020-S50;30;17;47;205664;171215;0;376879
02;2020-S50;1;0;1;16881;17110;09;33991
02;2020-S50;7;1;8;21410;21604;19;43014
02;2020-S50;4;5;9;16017;15479;29;31496
02;2020-S50;4;3;7;19825;14455;39;34280
02;2020-S50;6;5;11;24719;18248;49;42967
02;2020-S50;7;7;14;34361;28310;59;62671
02;2020-S50;4;3;7;28061;24495;69;52556
02;2020-S50;6;0;6;18231;15278;79;33509
02;2020-S50;0;3;3;11090;7677;89;18767
02;2020-S50;0;0;0;3992;1506;90;5498
02;2020-S50;39;27;66;194587;164162;0;358749
03;2020-S50;0;5;5;31123;30920;09;62043
03;2020-S50;26;19;45;29370;29268;19;58638
03;2020-S50;52;56;108;21458;18963;29;40421
03;2020-S50;58;44;102;21276;18326;39;39602
03;2020-S50;30;37;68;18164;16593;49;34757
03;2020-S50;22;21;43;13469;13557;59;27026
03;2020-S50;16;14;30;8776;8670;69;17446
03;2020-S50;1;3;4;3777;3591;79;7368
03;2020-S50;2;0;2;1649;1072;89;2721
03;2020-S50;0;0;0;485;184;90;669
03;2020-S50;207;199;407;149547;141144;0;290691
04;2020-S50;7;4;11;60314;61377;09;121691
04;2020-S50;28;14;42;66065;68387;19;134452
04;2020-S50;19;15;34;51059;47156;29;98215
04;2020-S50;19;14;33;58788;45780;39;104568
04;2020-S50;23;25;48;61408;52207;49;113615
04;2020-S50;15;23;38;64838;60759;59;125597
04;2020-S50;13;13;26;47008;42843;69;89851
04;2020-S50;4;3;7;25509;21184;79;46693
04;2020-S50;1;1;2;13168;7647;89;20815
04;2020-S50;0;0;0;3209;1253;90;4462
04;2020-S50;129;112;241;451366;408593;0;859959
05;2020-S50;0;0;0;362.366008612902;341.338819562748;09;703.704828175651
05;2020-S50;0;0;0;353.376145114279;370.349735405642;19;723.725880519921
05;2020-S50;0;0;0;218.593559489256;256.539602589476;29;475.133162078732
05;2020-S50;0;0;0;404.225408693299;360.321910454353;39;764.547319147651
05;2020-S50;0;0;0;520.067953604221;497.108383964256;49;1017.17633756848
05;2020-S50;0;0;0;468.146063921917;510.087601910415;59;978.233665832332
05;2020-S50;0;0;0;340.368470050554;334.366842191253;69;674.735312241807
05;2020-S50;0;0;0;212.598666888387;192.597753227106;79;405.196420115493
05;2020-S50;0;0;0;148.727797095705;61.8681715431829;89;210.595968638888
05;2020-S50;0;0;0;32.9601271090696;10.9909785719784;90;43.9511056810479
05;2020-S50;0;0;0;3061.43020057959;2935.56979942041;0;5997
06;2020-S50;1;0;1;42583;42380;09;84963
06;2020-S50;7;10;17;33369;31925;19;65294
06;2020-S50;14;9;23;21571;15080;29;36651
06;2020-S50;17;11;28;21550;16147;39;37697
06;2020-S50;20;17;37;14193;13939;49;28132
06;2020-S50;8;9;17;7171;7597;59;14768
06;2020-S50;7;6;13;3629;4117;69;7746
06;2020-S50;1;2;3;1577;1457;79;3034
06;2020-S50;2;1;3;531;474;89;1005
06;2020-S50;1;1;2;88;93;90;181
06;2020-S50;78;66;144;146262;133209;0;279471
07;2020-S50;0;0;0;485;549;09;1034
07;2020-S50;0;0;0;403;432;19;835
07;2020-S50;0;0;0;764;841;29;1605
07;2020-S50;0;0;0;824;928;39;1752
07;2020-S50;0;1;1;788;1020;49;1808
07;2020-S50;1;0;1;678;870;59;1548
07;2020-S50;0;0;0;360;382;69;742
07;2020-S50;0;0;0;231;190;79;421
07;2020-S50;0;0;0;114;67;89;181
07;2020-S50;0;0;0;24;11;90;35
07;2020-S50;1;1;2;4671;5290;0;9961
08;2020-S50;1;0;1;2715.22592983026;2997.75551488675;09;5712.98144471701
08;2020-S50;1;2;3;2778.51901080978;3160.9156459093;19;5939.43465671908
08;2020-S50;7;3;10;2080.8882988764;1718.16634315323;29;3799.05464202964
08;2020-S50;8;4;12;2701.8582062647;1896.52641413317;39;4598.38462039786
08;2020-S50;11;2;13;3151.45861023308;2460.52498233809;49;5611.98359257117
08;2020-S50;4;3;7;2620.29868333099;2422.23566154656;59;5042.53434487755
08;2020-S50;4;6;10;1621.44173420671;1438.58325779464;69;3060.02499200135
08;2020-S50;1;1;2;626.575909335673;526.358467843651;79;1152.93437717932
08;2020-S50;0;0;0;205.018522985054;140.993639349697;89;346.012162334751
08;2020-S50;0;0;0;50.0325684687745;20.62259870351;90;70.6551671722846
08;2020-S50;37;21;58;18551.3174743414;16782.6825256586;0;35334
11;2020-S50;242;245;510;783071;811785;09;1594856
11;2020-S50;808;858;1710;761456;784653;19;1546109
11;2020-S50;1341;1072;2418;850145;801772;29;1651917
11;2020-S50;1421;1192;2618;914360;843488;39;1757848
11;2020-S50;1197;1084;2296;845609;826202;49;1671811
11;2020-S50;1031;920;1969;793566;745070;59;1538636
11;2020-S50;642;633;1284;628649;549192;69;1177841
11;2020-S50;387;388;779;434606;358356;79;792962
11;2020-S50;375;280;656;261425;162933;89;424358
11;2020-S50;259;99;358;89253;32619;90;121872
11;2020-S50;7704;6774;14607;6362140;5916070;0;12278210
24;2020-S50;32;45;79;139720;144686;09;284406
24;2020-S50;142;172;314;152979;161185;19;314164
24;2020-S50;232;160;393;122237;126536;29;248773
24;2020-S50;228;178;406;150359;142009;39;292368
24;2020-S50;248;174;422;161829;158758;49;320587
24;2020-S50;247;173;420;172552;168011;59;340563
24;2020-S50;147;146;293;172509;158177;69;330686
24;2020-S50;119;124;243;129428;110593;79;240021
24;2020-S50;172;87;259;87342;56882;89;144224
24;2020-S50;150;54;204;31210;12071;90;43281
24;2020-S50;1718;1313;3034;1320165;1238908;0;2559073
27;2020-S50;89;96;188;143373;149679;09;293052
27;2020-S50;292;331;625;160962;173003;19;333965
27;2020-S50;402;287;689;133746;142254;29;276000
27;2020-S50;462;309;771;160004;155407;39;315411
27;2020-S50;447;338;785;172333;169564;49;341897
27;2020-S50;425;360;785;189979;183788;59;373767
27;2020-S50;294;271;566;192591;178206;69;370797
27;2020-S50;237;229;466;146876;127546;79;274422
27;2020-S50;345;199;544;96896;61575;89;158471
27;2020-S50;337;100;437;33148;12109;90;45257
27;2020-S50;3330;2520;5856;1429908;1353131;0;2783039
28;2020-S50;60;76;139;180735;186856;09;367591
28;2020-S50;170;135;312;200125;213621;19;413746
28;2020-S50;229;158;387;168922;173007;29;341929
28;2020-S50;237;149;387;196628;188487;39;385115
28;2020-S50;240;158;398;205396;201699;49;407095
28;2020-S50;214;174;388;222002;213866;59;435868
28;2020-S50;118;129;247;224688;203758;69;428446
28;2020-S50;107;105;212;163192;135543;79;298735
28;2020-S50;207;94;301;109691;65377;89;175068
28;2020-S50;169;41;210;37222;12685;90;49907
28;2020-S50;1751;1219;2981;1708601;1594899;0;3303500
32;2020-S50;137;128;266;358062;373689;09;731751
32;2020-S50;429;433;862;387045;406742;19;793787
32;2020-S50;619;459;1079;342304;348587;29;690891
32;2020-S50;613;477;1092;382485;369972;39;752457
32;2020-S50;578;442;1021;382510;376716;49;759226
32;2020-S50;485;482;967;386937;376527;59;763464
32;2020-S50;351;342;693;371211;330938;69;702149
32;2020-S50;269;259;528;250542;201459;79;452001
32;2020-S50;387;191;578;163399;89786;89;253185
32;2020-S50;312;70;382;48384;15367;90;63751
32;2020-S50;4181;3284;7470;3072879;2889783;0;5962662
44;2020-S50;189;181;373;291525;306839;09;598364
44;2020-S50;542;496;1047;320255;339504;19;659759
44;2020-S50;782;628;1415;302020;314428;29;616448
44;2020-S50;794;664;1464;342222;333292;39;675514
44;2020-S50;780;613;1399;349727;344491;49;694218
44;2020-S50;772;663;1442;381371;373239;59;754610
44;2020-S50;462;454;923;367165;335850;69;703015
44;2020-S50;400;391;796;250387;215436;79;465823
44;2020-S50;517;334;853;170825;105192;89;276017
44;2020-S50;407;101;510;51248;16731;90;67979
44;2020-S50;5645;4525;10222;2826745;2685002;0;5511747
52;2020-S50;26;25;52;213594;223900;09;437494
52;2020-S50;154;170;330;240818;255197;19;496015
52;2020-S50;251;197;448;197010;200630;29;397640
52;2020-S50;239;162;403;231204;224885;39;456089
52;2020-S50;250;160;411;243874;243418;49;487292
52;2020-S50;235;196;431;244100;239116;59;483216
52;2020-S50;149;155;305;241796;221345;69;463141
52;2020-S50;104;98;202;177805;149903;79;327708
52;2020-S50;229;111;342;119561;75822;89;195383
52;2020-S50;216;59;275;42559;15260;90;57819
52;2020-S50;1853;1334;3200;1952321;1849476;0;3801797
53;2020-S50;28;31;59;173813;182358;09;356171
53;2020-S50;84;60;146;202720;214740;19;417460
53;2020-S50;116;113;238;163116;173196;29;336312
53;2020-S50;111;88;199;190526;187674;39;378200
53;2020-S50;105;66;171;212098;212015;49;424113
53;2020-S50;103;70;173;223699;219176;59;442875
53;2020-S50;64;85;149;227435;209274;69;436709
53;2020-S50;54;51;105;169992;140910;79;310902
53;2020-S50;125;49;174;118117;69883;89;188000
53;2020-S50;67;27;94;37370;12267;90;49637
53;2020-S50;857;640;1508;1718886;1621493;0;3340379
75;2020-S50;98;92;190;293104;305291;09;598395
75;2020-S50;298;289;589;337141;357785;19;694926
75;2020-S50;415;292;708;295024;300618;29;595642
75;2020-S50;366;312;678;347871;331233;39;679104
75;2020-S50;410;306;717;384742;372771;49;757513
75;2020-S50;366;319;686;413361;390880;59;804241
75;2020-S50;230;235;465;425623;384060;69;809683
75;2020-S50;181;175;356;325086;276298;79;601384
75;2020-S50;270;159;430;213986;139308;89;353294
75;2020-S50;258;77;335;77600;28200;90;105800
75;2020-S50;2893;2259;5158;3113538;2886444;0;5999982
76;2020-S50;58;56;116;305956;318589;09;624545
76;2020-S50;269;252;530;338942;356969;19;695911
76;2020-S50;358;305;664;316210;319570;29;635780
76;2020-S50;349;292;641;356758;337587;39;694345
76;2020-S50;406;314;722;376541;363812;49;740353
76;2020-S50;344;317;662;402608;383750;59;786358
76;2020-S50;230;208;438;394889;358997;69;753886
76;2020-S50;182;145;327;308664;263806;79;572470
76;2020-S50;223;116;339;195838;129272;89;325110
76;2020-S50;213;50;263;69372;26728;90;96100
76;2020-S50;2636;2055;4706;3065778;2859080;0;5924858
84;2020-S50;208;264;474;459549;481088;09;940637
84;2020-S50;868;871;1749;487711;511905;19;999616
84;2020-S50;1001;777;1781;443824;451094;29;894918
84;2020-S50;1078;797;1876;512522;493262;39;1005784
84;2020-S50;1080;856;1936;520248;515106;49;1035354
84;2020-S50;969;862;1831;529611;514848;59;1044459
84;2020-S50;659;601;1260;486720;439940;69;926660
84;2020-S50;471;416;887;372151;315211;79;687362
84;2020-S50;609;336;945;237198;150524;89;387722
84;2020-S50;540;169;709;81185;28680;90;109865
84;2020-S50;7486;5949;13452;4130719;3901658;0;8032377
93;2020-S50;101;88;191;268834;283093;09;551927
93;2020-S50;395;431;828;280751;296087;19;576838
93;2020-S50;545;418;964;254404;255552;29;509956
93;2020-S50;566;419;989;310704;288398;39;599102
93;2020-S50;534;444;985;325559;305827;49;631386
93;2020-S50;527;447;977;353104;325389;59;678493
93;2020-S50;337;325;663;336327;296459;69;632786
93;2020-S50;260;250;510;279820;229699;79;509519
93;2020-S50;296;169;465;171274;113716;89;284990
93;2020-S50;239;75;314;58896;21758;90;80654
93;2020-S50;3802;3066;6888;2639673;2415978;0;5055651
94;2020-S50;0;0;0;16311;17433;09;33744
94;2020-S50;3;4;7;16679;18132;19;34811
94;2020-S50;2;9;11;16782;16579;29;33361
94;2020-S50;2;5;7;23044;20580;39;43624
94;2020-S50;4;8;12;23065;22140;49;45205
94;2020-S50;6;2;8;24549;23421;59;47970
94;2020-S50;4;7;11;23212;21883;69;45095
94;2020-S50;3;4;7;19544;17141;79;36685
94;2020-S50;5;3;8;11227;8178;89;19405
94;2020-S50;5;0;5;3332;1447;90;4779
94;2020-S50;34;42;79;177745;166934;0;344679
01;2020-S51;0;2;2;19979;20155;09;40134
01;2020-S51;3;5;8;24994;25489;19;50483
01;2020-S51;6;3;9;17868;16690;29;34558
01;2020-S51;8;5;13;22328;14821;39;37149
01;2020-S51;7;6;13;28652;20276;49;48928
01;2020-S51;9;2;11;33264;27260;59;60524
01;2020-S51;6;3;9;27135;23978;69;51113
01;2020-S51;1;5;6;18401;14661;79;33062
01;2020-S51;0;1;1;9633;6375;89;16008
01;2020-S51;1;0;1;3410;1510;90;4920
01;2020-S51;41;32;73;205664;171215;0;376879
02;2020-S51;1;2;3;16881;17110;09;33991
02;2020-S51;4;3;7;21410;21604;19;43014
02;2020-S51;10;2;12;16017;15479;29;31496
02;2020-S51;6;9;15;19825;14455;39;34280
02;2020-S51;6;6;12;24719;18248;49;42967
02;2020-S51;15;7;23;34361;28310;59;62671
02;2020-S51;5;10;15;28061;24495;69;52556
02;2020-S51;4;2;6;18231;15278;79;33509
02;2020-S51;2;0;2;11090;7677;89;18767
02;2020-S51;0;1;1;3992;1506;90;5498
02;2020-S51;53;42;96;194587;164162;0;358749
03;2020-S51;4;6;11;31123;30920;09;62043
03;2020-S51;30;32;62;29370;29268;19;58638
03;2020-S51;55;56;111;21458;18963;29;40421
03;2020-S51;79;60;140;21276;18326;39;39602
03;2020-S51;43;60;103;18164;16593;49;34757
03;2020-S51;44;36;80;13469;13557;59;27026
03;2020-S51;16;25;41;8776;8670;69;17446
03;2020-S51;6;7;13;3777;3591;79;7368
03;2020-S51;1;2;3;1649;1072;89;2721
03;2020-S51;0;0;0;485;184;90;669
03;2020-S51;278;284;564;149547;141144;0;290691
04;2020-S51;7;12;19;60314;61377;09;121691
04;2020-S51;25;30;55;66065;68387;19;134452
04;2020-S51;24;21;45;51059;47156;29;98215
04;2020-S51;21;14;35;58788;45780;39;104568
04;2020-S51;23;9;32;61408;52207;49;113615
04;2020-S51;26;19;45;64838;60759;59;125597
04;2020-S51;5;11;16;47008;42843;69;89851
04;2020-S51;2;6;8;25509;21184;79;46693
04;2020-S51;0;3;3;13168;7647;89;20815
04;2020-S51;0;0;0;3209;1253;90;4462
04;2020-S51;133;125;258;451366;408593;0;859959
05;2020-S51;0;0;0;362.366008612902;341.338819562748;09;703.704828175651
05;2020-S51;0;0;0;353.376145114279;370.349735405642;19;723.725880519921
05;2020-S51;0;0;0;218.593559489256;256.539602589476;29;475.133162078732
05;2020-S51;0;0;0;404.225408693299;360.321910454353;39;764.547319147651
05;2020-S51;0;0;0;520.067953604221;497.108383964256;49;1017.17633756848
05;2020-S51;0;0;0;468.146063921917;510.087601910415;59;978.233665832332
05;2020-S51;0;0;0;340.368470050554;334.366842191253;69;674.735312241807
05;2020-S51;0;0;0;212.598666888387;192.597753227106;79;405.196420115493
05;2020-S51;0;0;0;148.727797095705;61.8681715431829;89;210.595968638888
05;2020-S51;0;0;0;32.9601271090696;10.9909785719784;90;43.9511056810479
05;2020-S51;0;0;0;3061.43020057959;2935.56979942041;0;5997
06;2020-S51;0;2;2;42583;42380;09;84963
06;2020-S51;17;11;28;33369;31925;19;65294
06;2020-S51;11;8;19;21571;15080;29;36651
06;2020-S51;21;13;34;21550;16147;39;37697
06;2020-S51;16;16;32;14193;13939;49;28132
06;2020-S51;8;7;15;7171;7597;59;14768
06;2020-S51;6;8;14;3629;4117;69;7746
06;2020-S51;0;2;2;1577;1457;79;3034
06;2020-S51;1;1;2;531;474;89;1005
06;2020-S51;0;0;0;88;93;90;181
06;2020-S51;80;68;148;146262;133209;0;279471
07;2020-S51;0;0;0;485;549;09;1034
07;2020-S51;0;0;0;403;432;19;835
07;2020-S51;3;2;5;764;841;29;1605
07;2020-S51;0;2;2;824;928;39;1752
07;2020-S51;1;0;1;788;1020;49;1808
07;2020-S51;0;1;1;678;870;59;1548
07;2020-S51;0;0;0;360;382;69;742
07;2020-S51;0;0;0;231;190;79;421
07;2020-S51;0;0;0;114;67;89;181
07;2020-S51;0;0;0;24;11;90;35
07;2020-S51;4;5;9;4671;5290;0;9961
08;2020-S51;0;0;0;2715.22592983026;2997.75551488675;09;5712.98144471701
08;2020-S51;0;1;1;2778.51901080978;3160.9156459093;19;5939.43465671908
08;2020-S51;4;2;6;2080.8882988764;1718.16634315323;29;3799.05464202964
08;2020-S51;8;2;10;2701.8582062647;1896.52641413317;39;4598.38462039786
08;2020-S51;3;3;6;3151.45861023308;2460.52498233809;49;5611.98359257117
08;2020-S51;6;4;10;2620.29868333099;2422.23566154656;59;5042.53434487755
08;2020-S51;3;1;4;1621.44173420671;1438.58325779464;69;3060.02499200135
08;2020-S51;0;1;1;626.575909335673;526.358467843651;79;1152.93437717932
08;2020-S51;1;0;1;205.018522985054;140.993639349697;89;346.012162334751
08;2020-S51;0;0;0;50.0325684687745;20.62259870351;90;70.6551671722846
08;2020-S51;25;14;39;18551.3174743414;16782.6825256586;0;35334
11;2020-S51;267;252;542;783071;811785;09;1594856
11;2020-S51;941;857;1853;761456;784653;19;1546109
11;2020-S51;1676;1317;2997;850145;801772;29;1651917
11;2020-S51;1729;1504;3237;914360;843488;39;1757848
11;2020-S51;1380;1258;2643;845609;826202;49;1671811
11;2020-S51;1228;1103;2335;793566;745070;59;1538636
11;2020-S51;784;790;1583;628649;549192;69;1177841
11;2020-S51;453;408;862;434606;358356;79;792962
11;2020-S51;435;263;699;261425;162933;89;424358
11;2020-S51;331;102;433;89253;32619;90;121872
11;2020-S51;9228;7862;17198;6362140;5916070;0;12278210
24;2020-S51;40;48;91;139720;144686;09;284406
24;2020-S51;191;165;361;152979;161185;19;314164
24;2020-S51;268;187;455;122237;126536;29;248773
24;2020-S51;248;207;455;150359;142009;39;292368
24;2020-S51;260;225;485;161829;158758;49;320587
24;2020-S51;237;254;491;172552;168011;59;340563
24;2020-S51;155;165;320;172509;158177;69;330686
24;2020-S51;129;122;251;129428;110593;79;240021
24;2020-S51;222;98;320;87342;56882;89;144224
24;2020-S51;191;52;243;31210;12071;90;43281
24;2020-S51;1942;1523;3473;1320165;1238908;0;2559073
27;2020-S51;102;98;203;143373;149679;09;293052
27;2020-S51;381;426;809;160962;173003;19;333965
27;2020-S51;514;342;856;133746;142254;29;276000
27;2020-S51;505;385;890;160004;155407;39;315411
27;2020-S51;513;380;893;172333;169564;49;341897
27;2020-S51;528;448;976;189979;183788;59;373767
27;2020-S51;344;349;693;192591;178206;69;370797
27;2020-S51;254;269;523;146876;127546;79;274422
27;2020-S51;396;229;625;96896;61575;89;158471
27;2020-S51;393;106;499;33148;12109;90;45257
27;2020-S51;3930;3034;6969;1429908;1353131;0;2783039
28;2020-S51;47;59;107;180735;186856;09;367591
28;2020-S51;188;164;354;200125;213621;19;413746
28;2020-S51;266;190;456;168922;173007;29;341929
28;2020-S51;285;213;498;196628;188487;39;385115
28;2020-S51;272;208;481;205396;201699;49;407095
28;2020-S51;273;218;491;222002;213866;59;435868
28;2020-S51;158;175;333;224688;203758;69;428446
28;2020-S51;116;103;219;163192;135543;79;298735
28;2020-S51;172;107;279;109691;65377;89;175068
28;2020-S51;154;38;193;37222;12685;90;49907
28;2020-S51;1931;1476;3413;1708601;1594899;0;3303500
32;2020-S51;123;141;264;358062;373689;09;731751
32;2020-S51;508;423;932;387045;406742;19;793787
32;2020-S51;700;503;1203;342304;348587;29;690891
32;2020-S51;669;573;1242;382485;369972;39;752457
32;2020-S51;665;537;1203;382510;376716;49;759226
32;2020-S51;628;537;1165;386937;376527;59;763464
32;2020-S51;440;438;878;371211;330938;69;702149
32;2020-S51;325;306;631;250542;201459;79;452001
32;2020-S51;425;223;648;163399;89786;89;253185
32;2020-S51;305;83;388;48384;15367;90;63751
32;2020-S51;4789;3766;8557;3072879;2889783;0;5962662
44;2020-S51;176;215;396;291525;306839;09;598364
44;2020-S51;715;644;1368;320255;339504;19;659759
44;2020-S51;1033;757;1803;302020;314428;29;616448
44;2020-S51;1074;781;1865;342222;333292;39;675514
44;2020-S51;1021;810;1837;349727;344491;49;694218
44;2020-S51;969;874;1853;381371;373239;59;754610
44;2020-S51;648;571;1229;367165;335850;69;703015
44;2020-S51;495;421;921;250387;215436;79;465823
44;2020-S51;589;362;959;170825;105192;89;276017
44;2020-S51;441;137;582;51248;16731;90;67979
44;2020-S51;7161;5573;12814;2826745;2685002;0;5511747
52;2020-S51;41;53;96;213594;223900;09;437494
52;2020-S51;184;182;372;240818;255197;19;496015
52;2020-S51;296;184;480;197010;200630;29;397640
52;2020-S51;293;216;509;231204;224885;39;456089
52;2020-S51;280;228;510;243874;243418;49;487292
52;2020-S51;253;204;458;244100;239116;59;483216
52;2020-S51;161;162;324;241796;221345;69;463141
52;2020-S51;125;114;239;177805;149903;79;327708
52;2020-S51;186;116;302;119561;75822;89;195383
52;2020-S51;178;51;229;42559;15260;90;57819
52;2020-S51;1997;1510;3519;1952321;1849476;0;3801797
53;2020-S51;23;21;49;173813;182358;09;356171
53;2020-S51;114;110;224;202720;214740;19;417460
53;2020-S51;161;92;265;163116;173196;29;336312
53;2020-S51;126;65;191;190526;187674;39;378200
53;2020-S51;133;70;203;212098;212015;49;424113
53;2020-S51;102;96;199;223699;219176;59;442875
53;2020-S51;66;73;139;227435;209274;69;436709
53;2020-S51;86;78;164;169992;140910;79;310902
53;2020-S51;110;65;175;118117;69883;89;188000
53;2020-S51;90;28;120;37370;12267;90;49637
53;2020-S51;1011;698;1730;1718886;1621493;0;3340379
75;2020-S51;79;89;170;293104;305291;09;598395
75;2020-S51;309;280;590;337141;357785;19;694926
75;2020-S51;404;276;683;295024;300618;29;595642
75;2020-S51;423;314;738;347871;331233;39;679104
75;2020-S51;410;279;689;384742;372771;49;757513
75;2020-S51;410;307;717;413361;390880;59;804241
75;2020-S51;249;256;505;425623;384060;69;809683
75;2020-S51;172;172;344;325086;276298;79;601384
75;2020-S51;258;155;413;213986;139308;89;353294
75;2020-S51;235;83;319;77600;28200;90;105800
75;2020-S51;2950;2213;5171;3113538;2886444;0;5999982
76;2020-S51;82;74;159;305956;318589;09;624545
76;2020-S51;309;270;582;338942;356969;19;695911
76;2020-S51;435;403;838;316210;319570;29;635780
76;2020-S51;430;370;800;356758;337587;39;694345
76;2020-S51;472;370;842;376541;363812;49;740353
76;2020-S51;420;372;793;402608;383750;59;786358
76;2020-S51;269;296;566;394889;358997;69;753886
76;2020-S51;195;188;384;308664;263806;79;572470
76;2020-S51;247;147;394;195838;129272;89;325110
76;2020-S51;194;67;261;69372;26728;90;96100
76;2020-S51;3059;2557;5632;3065778;2859080;0;5924858
84;2020-S51;275;284;563;459549;481088;09;940637
84;2020-S51;1335;1431;2783;487711;511905;19;999616
84;2020-S51;1427;1056;2486;443824;451094;29;894918
84;2020-S51;1549;1191;2742;512522;493262;39;1005784
84;2020-S51;1575;1197;2777;520248;515106;49;1035354
84;2020-S51;1400;1183;2587;529611;514848;59;1044459
84;2020-S51;996;964;1960;486720;439940;69;926660
84;2020-S51;791;761;1553;372151;315211;79;687362
84;2020-S51;692;430;1122;237198;150524;89;387722
84;2020-S51;515;156;671;81185;28680;90;109865
84;2020-S51;10557;8656;19251;4130719;3901658;0;8032377
93;2020-S51;106;120;226;268834;283093;09;551927
93;2020-S51;486;521;1009;280751;296087;19;576838
93;2020-S51;730;570;1300;254404;255552;29;509956
93;2020-S51;804;689;1494;310704;288398;39;599102
93;2020-S51;800;616;1420;325559;305827;49;631386
93;2020-S51;750;653;1405;353104;325389;59;678493
93;2020-S51;502;478;981;336327;296459;69;632786
93;2020-S51;369;318;687;279820;229699;79;509519
93;2020-S51;405;220;625;171274;113716;89;284990
93;2020-S51;328;104;432;58896;21758;90;80654
93;2020-S51;5280;4290;9581;2639673;2415978;0;5055651
94;2020-S51;2;0;2;16311;17433;09;33744
94;2020-S51;1;2;4;16679;18132;19;34811
94;2020-S51;2;6;8;16782;16579;29;33361
94;2020-S51;6;12;18;23044;20580;39;43624
94;2020-S51;6;6;12;23065;22140;49;45205
94;2020-S51;6;12;18;24549;23421;59;47970
94;2020-S51;4;7;11;23212;21883;69;45095
94;2020-S51;7;5;12;19544;17141;79;36685
94;2020-S51;1;0;1;11227;8178;89;19405
94;2020-S51;2;0;2;3332;1447;90;4779
94;2020-S51;37;50;89;177745;166934;0;344679
01;2020-S52;0;0;0;19979;20155;09;40134
01;2020-S52;1;6;7;24994;25489;19;50483
01;2020-S52;8;2;10;17868;16690;29;34558
01;2020-S52;11;2;13;22328;14821;39;37149
01;2020-S52;6;5;11;28652;20276;49;48928
01;2020-S52;7;5;12;33264;27260;59;60524
01;2020-S52;4;6;10;27135;23978;69;51113
01;2020-S52;2;1;3;18401;14661;79;33062
01;2020-S52;3;0;3;9633;6375;89;16008
01;2020-S52;0;1;1;3410;1510;90;4920
01;2020-S52;42;28;70;205664;171215;0;376879
02;2020-S52;0;0;0;16881;17110;09;33991
02;2020-S52;4;2;6;21410;21604;19;43014
02;2020-S52;3;1;4;16017;15479;29;31496
02;2020-S52;2;3;5;19825;14455;39;34280
02;2020-S52;4;2;6;24719;18248;49;42967
02;2020-S52;4;3;7;34361;28310;59;62671
02;2020-S52;4;5;9;28061;24495;69;52556
02;2020-S52;1;1;2;18231;15278;79;33509
02;2020-S52;3;0;3;11090;7677;89;18767
02;2020-S52;0;1;1;3992;1506;90;5498
02;2020-S52;25;18;43;194587;164162;0;358749
03;2020-S52;1;4;5;31123;30920;09;62043
03;2020-S52;16;18;34;29370;29268;19;58638
03;2020-S52;45;31;76;21458;18963;29;40421
03;2020-S52;52;37;89;21276;18326;39;39602
03;2020-S52;48;41;89;18164;16593;49;34757
03;2020-S52;16;33;49;13469;13557;59;27026
03;2020-S52;19;20;40;8776;8670;69;17446
03;2020-S52;3;3;6;3777;3591;79;7368
03;2020-S52;2;2;4;1649;1072;89;2721
03;2020-S52;0;0;0;485;184;90;669
03;2020-S52;202;189;392;149547;141144;0;290691
04;2020-S52;4;1;5;60314;61377;09;121691
04;2020-S52;10;6;16;66065;68387;19;134452
04;2020-S52;14;11;25;51059;47156;29;98215
04;2020-S52;13;11;24;58788;45780;39;104568
04;2020-S52;10;15;25;61408;52207;49;113615
04;2020-S52;14;11;25;64838;60759;59;125597
04;2020-S52;3;4;7;47008;42843;69;89851
04;2020-S52;2;6;8;25509;21184;79;46693
04;2020-S52;1;0;1;13168;7647;89;20815
04;2020-S52;0;0;0;3209;1253;90;4462
04;2020-S52;71;65;136;451366;408593;0;859959
05;2020-S52;0;0;0;362.366008612902;341.338819562748;09;703.704828175651
05;2020-S52;0;0;0;353.376145114279;370.349735405642;19;723.725880519921
05;2020-S52;0;0;0;218.593559489256;256.539602589476;29;475.133162078732
05;2020-S52;0;0;0;404.225408693299;360.321910454353;39;764.547319147651
05;2020-S52;0;0;0;520.067953604221;497.108383964256;49;1017.17633756848
05;2020-S52;0;0;0;468.146063921917;510.087601910415;59;978.233665832332
05;2020-S52;0;0;0;340.368470050554;334.366842191253;69;674.735312241807
05;2020-S52;0;0;0;212.598666888387;192.597753227106;79;405.196420115493
05;2020-S52;0;0;0;148.727797095705;61.8681715431829;89;210.595968638888
05;2020-S52;0;0;0;32.9601271090696;10.9909785719784;90;43.9511056810479
05;2020-S52;0;0;0;3061.43020057959;2935.56979942041;0;5997
06;2020-S52;0;1;1;42583;42380;09;84963
06;2020-S52;7;6;13;33369;31925;19;65294
06;2020-S52;18;7;25;21571;15080;29;36651
06;2020-S52;28;9;37;21550;16147;39;37697
06;2020-S52;19;15;34;14193;13939;49;28132
06;2020-S52;11;12;23;7171;7597;59;14768
06;2020-S52;1;5;6;3629;4117;69;7746
06;2020-S52;1;0;1;1577;1457;79;3034
06;2020-S52;0;2;2;531;474;89;1005
06;2020-S52;0;0;0;88;93;90;181
06;2020-S52;85;57;142;146262;133209;0;279471
07;2020-S52;0;0;0;485;549;09;1034
07;2020-S52;0;0;0;403;432;19;835
07;2020-S52;0;0;0;764;841;29;1605
07;2020-S52;0;0;0;824;928;39;1752
07;2020-S52;1;1;2;788;1020;49;1808
07;2020-S52;0;2;2;678;870;59;1548
07;2020-S52;0;0;0;360;382;69;742
07;2020-S52;1;1;2;231;190;79;421
07;2020-S52;0;0;0;114;67;89;181
07;2020-S52;0;0;0;24;11;90;35
07;2020-S52;2;4;6;4671;5290;0;9961
08;2020-S52;0;1;1;2715.22592983026;2997.75551488675;09;5712.98144471701
08;2020-S52;2;3;5;2778.51901080978;3160.9156459093;19;5939.43465671908
08;2020-S52;1;4;5;2080.8882988764;1718.16634315323;29;3799.05464202964
08;2020-S52;2;3;5;2701.8582062647;1896.52641413317;39;4598.38462039786
08;2020-S52;3;4;7;3151.45861023308;2460.52498233809;49;5611.98359257117
08;2020-S52;2;5;7;2620.29868333099;2422.23566154656;59;5042.53434487755
08;2020-S52;0;2;2;1621.44173420671;1438.58325779464;69;3060.02499200135
08;2020-S52;0;1;1;626.575909335673;526.358467843651;79;1152.93437717932
08;2020-S52;0;0;0;205.018522985054;140.993639349697;89;346.012162334751
08;2020-S52;0;0;0;50.0325684687745;20.62259870351;90;70.6551671722846
08;2020-S52;10;23;33;18551.3174743414;16782.6825256586;0;35334
11;2020-S52;205;216;438;783071;811785;09;1594856
11;2020-S52;769;713;1513;761456;784653;19;1546109
11;2020-S52;1554;1270;2829;850145;801772;29;1651917
11;2020-S52;1537;1269;2811;914360;843488;39;1757848
11;2020-S52;1202;1133;2340;845609;826202;49;1671811
11;2020-S52;1094;914;2010;793566;745070;59;1538636
11;2020-S52;718;678;1409;628649;549192;69;1177841
11;2020-S52;394;375;769;434606;358356;79;792962
11;2020-S52;398;248;647;261425;162933;89;424358
11;2020-S52;261;94;355;89253;32619;90;121872
11;2020-S52;8135;6913;15130;6362140;5916070;0;12278210
24;2020-S52;26;33;61;139720;144686;09;284406
24;2020-S52;107;108;217;152979;161185;19;314164
24;2020-S52;221;184;405;122237;126536;29;248773
24;2020-S52;220;159;379;150359;142009;39;292368
24;2020-S52;198;180;378;161829;158758;49;320587
24;2020-S52;232;176;408;172552;168011;59;340563
24;2020-S52;142;136;278;172509;158177;69;330686
24;2020-S52;104;124;228;129428;110593;79;240021
24;2020-S52;149;85;234;87342;56882;89;144224
24;2020-S52;130;59;189;31210;12071;90;43281
24;2020-S52;1529;1244;2777;1320165;1238908;0;2559073
27;2020-S52;83;99;182;143373;149679;09;293052
27;2020-S52;293;327;620;160962;173003;19;333965
27;2020-S52;461;284;745;133746;142254;29;276000
27;2020-S52;454;295;749;160004;155407;39;315411
27;2020-S52;445;351;797;172333;169564;49;341897
27;2020-S52;484;424;908;189979;183788;59;373767
27;2020-S52;303;330;633;192591;178206;69;370797
27;2020-S52;268;222;490;146876;127546;79;274422
27;2020-S52;315;193;508;96896;61575;89;158471
27;2020-S52;268;72;340;33148;12109;90;45257
27;2020-S52;3375;2597;5973;1429908;1353131;0;2783039
28;2020-S52;47;55;102;180735;186856;09;367591
28;2020-S52;190;168;365;200125;213621;19;413746
28;2020-S52;244;189;433;168922;173007;29;341929
28;2020-S52;240;201;442;196628;188487;39;385115
28;2020-S52;239;232;472;205396;201699;49;407095
28;2020-S52;240;212;452;222002;213866;59;435868
28;2020-S52;148;179;327;224688;203758;69;428446
28;2020-S52;130;111;241;163192;135543;79;298735
28;2020-S52;140;80;220;109691;65377;89;175068
28;2020-S52;92;33;125;37222;12685;90;49907
28;2020-S52;1710;1461;3184;1708601;1594899;0;3303500
32;2020-S52;114;88;202;358062;373689;09;731751
32;2020-S52;405;338;744;387045;406742;19;793787
32;2020-S52;580;473;1053;342304;348587;29;690891
32;2020-S52;614;510;1124;382485;369972;39;752457
32;2020-S52;542;499;1041;382510;376716;49;759226
32;2020-S52;488;473;962;386937;376527;59;763464
32;2020-S52;363;351;715;371211;330938;69;702149
32;2020-S52;278;248;526;250542;201459;79;452001
32;2020-S52;403;189;592;163399;89786;89;253185
32;2020-S52;241;64;305;48384;15367;90;63751
32;2020-S52;4029;3233;7265;3072879;2889783;0;5962662
44;2020-S52;158;131;293;291525;306839;09;598364
44;2020-S52;521;519;1046;320255;339504;19;659759
44;2020-S52;825;646;1474;302020;314428;29;616448
44;2020-S52;923;647;1572;342222;333292;39;675514
44;2020-S52;831;665;1499;349727;344491;49;694218
44;2020-S52;835;729;1568;381371;373239;59;754610
44;2020-S52;561;591;1157;367165;335850;69;703015
44;2020-S52;463;371;845;250387;215436;79;465823
44;2020-S52;530;276;813;170825;105192;89;276017
44;2020-S52;363;108;473;51248;16731;90;67979
44;2020-S52;6011;4685;10744;2826745;2685002;0;5511747
52;2020-S52;34;30;67;213594;223900;09;437494
52;2020-S52;172;203;380;240818;255197;19;496015
52;2020-S52;258;194;452;197010;200630;29;397640
52;2020-S52;213;184;398;231204;224885;39;456089
52;2020-S52;253;194;448;243874;243418;49;487292
52;2020-S52;229;195;424;244100;239116;59;483216
52;2020-S52;153;158;312;241796;221345;69;463141
52;2020-S52;109;110;219;177805;149903;79;327708
52;2020-S52;132;87;220;119561;75822;89;195383
52;2020-S52;118;47;165;42559;15260;90;57819
52;2020-S52;1672;1402;3086;1952321;1849476;0;3801797
53;2020-S52;19;22;43;173813;182358;09;356171
53;2020-S52;88;100;194;202720;214740;19;417460
53;2020-S52;131;117;259;163116;173196;29;336312
53;2020-S52;118;68;186;190526;187674;39;378200
53;2020-S52;98;73;171;212098;212015;49;424113
53;2020-S52;115;111;226;223699;219176;59;442875
53;2020-S52;55;66;121;227435;209274;69;436709
53;2020-S52;48;47;95;169992;140910;79;310902
53;2020-S52;52;32;84;118117;69883;89;188000
53;2020-S52;33;11;44;37370;12267;90;49637
53;2020-S52;757;647;1423;1718886;1621493;0;3340379
75;2020-S52;75;78;154;293104;305291;09;598395
75;2020-S52;209;208;419;337141;357785;19;694926
75;2020-S52;364;248;613;295024;300618;29;595642
75;2020-S52;344;237;582;347871;331233;39;679104
75;2020-S52;314;248;563;384742;372771;49;757513
75;2020-S52;298;261;560;413361;390880;59;804241
75;2020-S52;204;204;408;425623;384060;69;809683
75;2020-S52;158;120;278;325086;276298;79;601384
75;2020-S52;248;125;373;213986;139308;89;353294
75;2020-S52;221;68;289;77600;28200;90;105800
75;2020-S52;2438;1797;4242;3113538;2886444;0;5999982
76;2020-S52;48;54;108;305956;318589;09;624545
76;2020-S52;283;266;553;338942;356969;19;695911
76;2020-S52;437;417;855;316210;319570;29;635780
76;2020-S52;436;386;822;356758;337587;39;694345
76;2020-S52;434;356;792;376541;363812;49;740353
76;2020-S52;423;337;761;402608;383750;59;786358
76;2020-S52;289;264;553;394889;358997;69;753886
76;2020-S52;212;177;390;308664;263806;79;572470
76;2020-S52;195;128;323;195838;129272;89;325110
76;2020-S52;169;70;239;69372;26728;90;96100
76;2020-S52;2926;2456;5397;3065778;2859080;0;5924858
84;2020-S52;189;221;410;459549;481088;09;940637
84;2020-S52;742;717;1465;487711;511905;19;999616
84;2020-S52;1014;785;1800;443824;451094;29;894918
84;2020-S52;1073;797;1871;512522;493262;39;1005784
84;2020-S52;1007;852;1861;520248;515106;49;1035354
84;2020-S52;971;833;1805;529611;514848;59;1044459
84;2020-S52;584;621;1205;486720;439940;69;926660
84;2020-S52;479;428;907;372151;315211;79;687362
84;2020-S52;520;296;816;237198;150524;89;387722
84;2020-S52;392;126;518;81185;28680;90;109865
84;2020-S52;6971;5678;12661;4130719;3901658;0;8032377
93;2020-S52;96;103;202;268834;283093;09;551927
93;2020-S52;492;448;943;280751;296087;19;576838
93;2020-S52;798;646;1446;254404;255552;29;509956
93;2020-S52;811;647;1461;310704;288398;39;599102
93;2020-S52;788;633;1424;325559;305827;49;631386
93;2020-S52;799;690;1489;353104;325389;59;678493
93;2020-S52;533;511;1044;336327;296459;69;632786
93;2020-S52;335;348;683;279820;229699;79;509519
93;2020-S52;402;247;649;171274;113716;89;284990
93;2020-S52;358;96;454;58896;21758;90;80654
93;2020-S52;5414;4370;9798;2639673;2415978;0;5055651
94;2020-S52;1;0;1;16311;17433;09;33744
94;2020-S52;2;7;9;16679;18132;19;34811
94;2020-S52;12;13;25;16782;16579;29;33361
94;2020-S52;13;10;23;23044;20580;39;43624
94;2020-S52;9;9;18;23065;22140;49;45205
94;2020-S52;10;15;25;24549;23421;59;47970
94;2020-S52;11;13;24;23212;21883;69;45095
94;2020-S52;9;8;17;19544;17141;79;36685
94;2020-S52;2;3;5;11227;8178;89;19405
94;2020-S52;2;0;2;3332;1447;90;4779
94;2020-S52;71;78;155;177745;166934;0;344679
01;2020-S53;0;1;1;19979;20155;09;40134
01;2020-S53;11;4;15;24994;25489;19;50483
01;2020-S53;14;6;20;17868;16690;29;34558
01;2020-S53;11;7;18;22328;14821;39;37149
01;2020-S53;10;11;21;28652;20276;49;48928
01;2020-S53;12;4;16;33264;27260;59;60524
01;2020-S53;4;1;5;27135;23978;69;51113
01;2020-S53;1;3;4;18401;14661;79;33062
01;2020-S53;1;1;2;9633;6375;89;16008
01;2020-S53;0;0;0;3410;1510;90;4920
01;2020-S53;64;38;102;205664;171215;0;376879
02;2020-S53;1;0;2;16881;17110;09;33991
02;2020-S53;5;2;7;21410;21604;19;43014
02;2020-S53;7;0;7;16017;15479;29;31496
02;2020-S53;8;9;17;19825;14455;39;34280
02;2020-S53;9;8;17;24719;18248;49;42967
02;2020-S53;9;8;17;34361;28310;59;62671
02;2020-S53;10;3;13;28061;24495;69;52556
02;2020-S53;2;4;6;18231;15278;79;33509
02;2020-S53;1;0;1;11090;7677;89;18767
02;2020-S53;2;0;2;3992;1506;90;5498
02;2020-S53;54;34;89;194587;164162;0;358749
03;2020-S53;7;4;11;31123;30920;09;62043
03;2020-S53;45;26;73;29370;29268;19;58638
03;2020-S53;73;37;111;21458;18963;29;40421
03;2020-S53;64;48;113;21276;18326;39;39602
03;2020-S53;50;43;94;18164;16593;49;34757
03;2020-S53;31;32;64;13469;13557;59;27026
03;2020-S53;25;22;47;8776;8670;69;17446
03;2020-S53;8;4;12;3777;3591;79;7368
03;2020-S53;2;1;3;1649;1072;89;2721
03;2020-S53;0;0;0;485;184;90;669
03;2020-S53;305;217;528;149547;141144;0;290691
04;2020-S53;6;5;11;60314;61377;09;121691
04;2020-S53;20;11;31;66065;68387;19;134452
04;2020-S53;16;13;29;51059;47156;29;98215
04;2020-S53;20;13;33;58788;45780;39;104568
04;2020-S53;17;26;43;61408;52207;49;113615
04;2020-S53;20;13;34;64838;60759;59;125597
04;2020-S53;13;9;22;47008;42843;69;89851
04;2020-S53;1;2;3;25509;21184;79;46693
04;2020-S53;1;1;2;13168;7647;89;20815
04;2020-S53;0;0;0;3209;1253;90;4462
04;2020-S53;114;93;208;451366;408593;0;859959
05;2020-S53;0;0;0;362.366008612902;341.338819562748;09;703.704828175651
05;2020-S53;0;0;0;353.376145114279;370.349735405642;19;723.725880519921
05;2020-S53;0;0;0;218.593559489256;256.539602589476;29;475.133162078732
05;2020-S53;0;0;0;404.225408693299;360.321910454353;39;764.547319147651
05;2020-S53;0;0;0;520.067953604221;497.108383964256;49;1017.17633756848
05;2020-S53;0;0;0;468.146063921917;510.087601910415;59;978.233665832332
05;2020-S53;0;0;0;340.368470050554;334.366842191253;69;674.735312241807
05;2020-S53;0;0;0;212.598666888387;192.597753227106;79;405.196420115493
05;2020-S53;0;0;0;148.727797095705;61.8681715431829;89;210.595968638888
05;2020-S53;0;0;0;32.9601271090696;10.9909785719784;90;43.9511056810479
05;2020-S53;0;0;0;3061.43020057959;2935.56979942041;0;5997
06;2020-S53;4;1;5;42583;42380;09;84963
06;2020-S53;13;10;23;33369;31925;19;65294
06;2020-S53;18;18;36;21571;15080;29;36651
06;2020-S53;29;13;42;21550;16147;39;37697
06;2020-S53;14;17;31;14193;13939;49;28132
06;2020-S53;11;15;26;7171;7597;59;14768
06;2020-S53;4;5;9;3629;4117;69;7746
06;2020-S53;2;3;5;1577;1457;79;3034
06;2020-S53;0;3;3;531;474;89;1005
06;2020-S53;0;0;0;88;93;90;181
06;2020-S53;95;85;180;146262;133209;0;279471
07;2020-S53;0;0;0;485;549;09;1034
07;2020-S53;0;1;1;403;432;19;835
07;2020-S53;2;0;2;764;841;29;1605
07;2020-S53;3;0;3;824;928;39;1752
07;2020-S53;4;3;7;788;1020;49;1808
07;2020-S53;0;0;0;678;870;59;1548
07;2020-S53;1;0;1;360;382;69;742
07;2020-S53;0;1;1;231;190;79;421
07;2020-S53;0;0;0;114;67;89;181
07;2020-S53;0;0;0;24;11;90;35
07;2020-S53;10;5;15;4671;5290;0;9961
08;2020-S53;0;0;0;2715.22592983026;2997.75551488675;09;5712.98144471701
08;2020-S53;4;0;4;2778.51901080978;3160.9156459093;19;5939.43465671908
08;2020-S53;2;2;4;2080.8882988764;1718.16634315323;29;3799.05464202964
08;2020-S53;1;1;2;2701.8582062647;1896.52641413317;39;4598.38462039786
08;2020-S53;2;4;6;3151.45861023308;2460.52498233809;49;5611.98359257117
08;2020-S53;3;1;4;2620.29868333099;2422.23566154656;59;5042.53434487755
08;2020-S53;1;0;1;1621.44173420671;1438.58325779464;69;3060.02499200135
08;2020-S53;1;0;1;626.575909335673;526.358467843651;79;1152.93437717932
08;2020-S53;0;0;0;205.018522985054;140.993639349697;89;346.012162334751
08;2020-S53;0;0;0;50.0325684687745;20.62259870351;90;70.6551671722846
08;2020-S53;14;8;22;18551.3174743414;16782.6825256586;0;35334
11;2020-S53;227;223;463;783071;811785;09;1594856
11;2020-S53;876;836;1750;761456;784653;19;1546109
11;2020-S53;1770;1467;3243;850145;801772;29;1651917
11;2020-S53;1682;1445;3131;914360;843488;39;1757848
11;2020-S53;1337;1221;2566;845609;826202;49;1671811
11;2020-S53;1143;1001;2148;793566;745070;59;1538636
11;2020-S53;837;765;1615;628649;549192;69;1177841
11;2020-S53;518;442;963;434606;358356;79;792962
11;2020-S53;380;235;617;261425;162933;89;424358
11;2020-S53;224;95;319;89253;32619;90;121872
11;2020-S53;8998;7734;16827;6362140;5916070;0;12278210
24;2020-S53;36;36;73;139720;144686;09;284406
24;2020-S53;176;166;343;152979;161185;19;314164
24;2020-S53;258;216;474;122237;126536;29;248773
24;2020-S53;275;214;490;150359;142009;39;292368
24;2020-S53;239;201;440;161829;158758;49;320587
24;2020-S53;269;209;479;172552;168011;59;340563
24;2020-S53;184;160;345;172509;158177;69;330686
24;2020-S53;127;132;259;129428;110593;79;240021
24;2020-S53;136;58;194;87342;56882;89;144224
24;2020-S53;88;37;125;31210;12071;90;43281
24;2020-S53;1788;1429;3222;1320165;1238908;0;2559073
27;2020-S53;76;92;168;143373;149679;09;293052
27;2020-S53;381;396;778;160962;173003;19;333965
27;2020-S53;525;406;931;133746;142254;29;276000
27;2020-S53;486;409;896;160004;155407;39;315411
27;2020-S53;498;407;905;172333;169564;49;341897
27;2020-S53;521;439;960;189979;183788;59;373767
27;2020-S53;372;399;772;192591;178206;69;370797
27;2020-S53;314;275;589;146876;127546;79;274422
27;2020-S53;332;207;539;96896;61575;89;158471
27;2020-S53;255;77;332;33148;12109;90;45257
27;2020-S53;3760;3108;6871;1429908;1353131;0;2783039
28;2020-S53;41;48;92;180735;186856;09;367591
28;2020-S53;220;191;416;200125;213621;19;413746
28;2020-S53;330;283;614;168922;173007;29;341929
28;2020-S53;320;256;576;196628;188487;39;385115
28;2020-S53;260;248;508;205396;201699;49;407095
28;2020-S53;292;259;551;222002;213866;59;435868
28;2020-S53;222;211;433;224688;203758;69;428446
28;2020-S53;158;149;307;163192;135543;79;298735
28;2020-S53;205;95;300;109691;65377;89;175068
28;2020-S53;129;33;162;37222;12685;90;49907
28;2020-S53;2177;1773;3959;1708601;1594899;0;3303500
32;2020-S53;117;132;250;358062;373689;09;731751
32;2020-S53;459;437;898;387045;406742;19;793787
32;2020-S53;714;620;1334;342304;348587;29;690891
32;2020-S53;706;586;1294;382485;369972;39;752457
32;2020-S53;607;513;1120;382510;376716;49;759226
32;2020-S53;601;547;1150;386937;376527;59;763464
32;2020-S53;444;415;859;371211;330938;69;702149
32;2020-S53;294;264;559;250542;201459;79;452001
32;2020-S53;315;158;474;163399;89786;89;253185
32;2020-S53;206;51;257;48384;15367;90;63751
32;2020-S53;4464;3723;8196;3072879;2889783;0;5962662
44;2020-S53;186;162;349;291525;306839;09;598364
44;2020-S53;705;642;1357;320255;339504;19;659759
44;2020-S53;1024;882;1906;302020;314428;29;616448
44;2020-S53;1010;886;1897;342222;333292;39;675514
44;2020-S53;895;792;1688;349727;344491;49;694218
44;2020-S53;952;811;1765;381371;373239;59;754610
44;2020-S53;712;698;1412;367165;335850;69;703015
44;2020-S53;494;468;967;250387;215436;79;465823
44;2020-S53;525;306;832;170825;105192;89;276017
44;2020-S53;321;111;433;51248;16731;90;67979
44;2020-S53;6824;5758;12606;2826745;2685002;0;5511747
52;2020-S53;65;56;126;213594;223900;09;437494
52;2020-S53;215;230;448;240818;255197;19;496015
52;2020-S53;308;265;573;197010;200630;29;397640
52;2020-S53;323;240;565;231204;224885;39;456089
52;2020-S53;290;242;533;243874;243418;49;487292
52;2020-S53;293;260;553;244100;239116;59;483216
52;2020-S53;173;187;362;241796;221345;69;463141
52;2020-S53;120;133;258;177805;149903;79;327708
52;2020-S53;129;80;210;119561;75822;89;195383
52;2020-S53;101;43;144;42559;15260;90;57819
52;2020-S53;2017;1736;3773;1952321;1849476;0;3801797
53;2020-S53;24;26;50;173813;182358;09;356171
53;2020-S53;105;117;222;202720;214740;19;417460
53;2020-S53;216;201;423;163116;173196;29;336312
53;2020-S53;134;108;242;190526;187674;39;378200
53;2020-S53;124;124;248;212098;212015;49;424113
53;2020-S53;146;119;265;223699;219176;59;442875
53;2020-S53;114;96;210;227435;209274;69;436709
53;2020-S53;61;65;126;169992;140910;79;310902
53;2020-S53;65;46;111;118117;69883;89;188000
53;2020-S53;40;22;63;37370;12267;90;49637
53;2020-S53;1029;924;1960;1718886;1621493;0;3340379
75;2020-S53;88;96;186;293104;305291;09;598395
75;2020-S53;315;306;627;337141;357785;19;694926
75;2020-S53;449;355;805;295024;300618;29;595642
75;2020-S53;442;333;776;347871;331233;39;679104
75;2020-S53;437;362;799;384742;372771;49;757513
75;2020-S53;424;384;808;413361;390880;59;804241
75;2020-S53;282;273;555;425623;384060;69;809683
75;2020-S53;215;191;406;325086;276298;79;601384
75;2020-S53;261;151;412;213986;139308;89;353294
75;2020-S53;210;50;261;77600;28200;90;105800
75;2020-S53;3123;2501;5635;3113538;2886444;0;5999982
76;2020-S53;72;78;155;305956;318589;09;624545
76;2020-S53;385;335;727;338942;356969;19;695911
76;2020-S53;571;512;1083;316210;319570;29;635780
76;2020-S53;573;457;1030;356758;337587;39;694345
76;2020-S53;516;424;940;376541;363812;49;740353
76;2020-S53;498;404;902;402608;383750;59;786358
76;2020-S53;386;343;729;394889;358997;69;753886
76;2020-S53;270;261;531;308664;263806;79;572470
76;2020-S53;286;178;464;195838;129272;89;325110
76;2020-S53;187;51;238;69372;26728;90;96100
76;2020-S53;3746;3043;6801;3065778;2859080;0;5924858
84;2020-S53;215;183;401;459549;481088;09;940637
84;2020-S53;795;779;1580;487711;511905;19;999616
84;2020-S53;1215;929;2147;443824;451094;29;894918
84;2020-S53;1229;988;2218;512522;493262;39;1005784
84;2020-S53;1047;855;1903;520248;515106;49;1035354
84;2020-S53;1010;925;1935;529611;514848;59;1044459
84;2020-S53;726;664;1391;486720;439940;69;926660
84;2020-S53;519;454;973;372151;315211;79;687362
84;2020-S53;526;304;830;237198;150524;89;387722
84;2020-S53;378;119;497;81185;28680;90;109865
84;2020-S53;7662;6200;13878;4130719;3901658;0;8032377
93;2020-S53;145;145;296;268834;283093;09;551927
93;2020-S53;604;561;1167;280751;296087;19;576838
93;2020-S53;974;789;1765;254404;255552;29;509956
93;2020-S53;982;751;1737;310704;288398;39;599102
93;2020-S53;938;777;1716;325559;305827;49;631386
93;2020-S53;940;799;1741;353104;325389;59;678493
93;2020-S53;684;646;1332;336327;296459;69;632786
93;2020-S53;487;441;928;279820;229699;79;509519
93;2020-S53;475;298;773;171274;113716;89;284990
93;2020-S53;318;86;404;58896;21758;90;80654
93;2020-S53;6548;5295;11862;2639673;2415978;0;5055651
94;2020-S53;1;1;2;16311;17433;09;33744
94;2020-S53;13;13;27;16679;18132;19;34811
94;2020-S53;14;15;29;16782;16579;29;33361
94;2020-S53;17;17;34;23044;20580;39;43624
94;2020-S53;16;18;34;23065;22140;49;45205
94;2020-S53;22;19;41;24549;23421;59;47970
94;2020-S53;12;18;30;23212;21883;69;45095
94;2020-S53;14;9;23;19544;17141;79;36685
94;2020-S53;5;2;7;11227;8178;89;19405
94;2020-S53;2;1;3;3332;1447;90;4779
94;2020-S53;116;113;230;177745;166934;0;344679
01;2021-S01;0;0;0;19979;20155;09;40134
01;2021-S01;2;7;9;24994;25489;19;50483
01;2021-S01;13;5;18;17868;16690;29;34558
01;2021-S01;10;11;21;22328;14821;39;37149
01;2021-S01;15;7;22;28652;20276;49;48928
01;2021-S01;17;7;24;33264;27260;59;60524
01;2021-S01;8;7;15;27135;23978;69;51113
01;2021-S01;2;4;6;18401;14661;79;33062
01;2021-S01;3;2;5;9633;6375;89;16008
01;2021-S01;0;0;0;3410;1510;90;4920
01;2021-S01;70;50;120;205664;171215;0;376879
02;2021-S01;2;1;3;16881;17110;09;33991
02;2021-S01;3;2;5;21410;21604;19;43014
02;2021-S01;9;6;15;16017;15479;29;31496
02;2021-S01;6;2;8;19825;14455;39;34280
02;2021-S01;7;9;16;24719;18248;49;42967
02;2021-S01;6;8;14;34361;28310;59;62671
02;2021-S01;4;5;9;28061;24495;69;52556
02;2021-S01;4;2;6;18231;15278;79;33509
02;2021-S01;2;0;2;11090;7677;89;18767
02;2021-S01;0;0;0;3992;1506;90;5498
02;2021-S01;43;35;78;194587;164162;0;358749
03;2021-S01;11;9;20;31123;30920;09;62043
03;2021-S01;73;58;133;29370;29268;19;58638
03;2021-S01;107;77;185;21458;18963;29;40421
03;2021-S01;115;61;177;21276;18326;39;39602
03;2021-S01;80;61;141;18164;16593;49;34757
03;2021-S01;60;39;100;13469;13557;59;27026
03;2021-S01;35;46;81;8776;8670;69;17446
03;2021-S01;11;11;22;3777;3591;79;7368
03;2021-S01;2;1;3;1649;1072;89;2721
03;2021-S01;0;1;1;485;184;90;669
03;2021-S01;494;364;863;149547;141144;0;290691
04;2021-S01;6;5;11;60314;61377;09;121691
04;2021-S01;18;17;35;66065;68387;19;134452
04;2021-S01;21;25;46;51059;47156;29;98215
04;2021-S01;29;26;55;58788;45780;39;104568
04;2021-S01;17;24;41;61408;52207;49;113615
04;2021-S01;27;27;54;64838;60759;59;125597
04;2021-S01;6;16;22;47008;42843;69;89851
04;2021-S01;6;4;10;25509;21184;79;46693
04;2021-S01;1;3;4;13168;7647;89;20815
04;2021-S01;0;0;0;3209;1253;90;4462
04;2021-S01;131;147;278;451366;408593;0;859959
05;2021-S01;0;0;0;362.366008612902;341.338819562748;09;703.704828175651
05;2021-S01;0;0;0;353.376145114279;370.349735405642;19;723.725880519921
05;2021-S01;0;0;0;218.593559489256;256.539602589476;29;475.133162078732
05;2021-S01;0;0;0;404.225408693299;360.321910454353;39;764.547319147651
05;2021-S01;0;0;0;520.067953604221;497.108383964256;49;1017.17633756848
05;2021-S01;0;0;0;468.146063921917;510.087601910415;59;978.233665832332
05;2021-S01;0;0;0;340.368470050554;334.366842191253;69;674.735312241807
05;2021-S01;0;0;0;212.598666888387;192.597753227106;79;405.196420115493
05;2021-S01;0;0;0;148.727797095705;61.8681715431829;89;210.595968638888
05;2021-S01;0;0;0;32.9601271090696;10.9909785719784;90;43.9511056810479
05;2021-S01;0;0;0;3061.43020057959;2935.56979942041;0;5997
06;2021-S01;1;0;1;42583;42380;09;84963
06;2021-S01;15;10;25;33369;31925;19;65294
06;2021-S01;36;16;52;21571;15080;29;36651
06;2021-S01;45;17;62;21550;16147;39;37697
06;2021-S01;31;26;57;14193;13939;49;28132
06;2021-S01;25;19;44;7171;7597;59;14768
06;2021-S01;11;5;16;3629;4117;69;7746
06;2021-S01;2;2;4;1577;1457;79;3034
06;2021-S01;0;1;1;531;474;89;1005
06;2021-S01;0;0;0;88;93;90;181
06;2021-S01;166;96;262;146262;133209;0;279471
07;2021-S01;0;0;0;485;549;09;1034
07;2021-S01;0;1;1;403;432;19;835
07;2021-S01;8;2;10;764;841;29;1605
07;2021-S01;7;6;13;824;928;39;1752
07;2021-S01;5;7;12;788;1020;49;1808
07;2021-S01;2;3;5;678;870;59;1548
07;2021-S01;0;0;0;360;382;69;742
07;2021-S01;1;0;1;231;190;79;421
07;2021-S01;0;1;1;114;67;89;181
07;2021-S01;0;0;0;24;11;90;35
07;2021-S01;23;20;43;4671;5290;0;9961
08;2021-S01;0;0;0;2715.22592983026;2997.75551488675;09;5712.98144471701
08;2021-S01;5;3;8;2778.51901080978;3160.9156459093;19;5939.43465671908
08;2021-S01;3;2;5;2080.8882988764;1718.16634315323;29;3799.05464202964
08;2021-S01;2;13;15;2701.8582062647;1896.52641413317;39;4598.38462039786
08;2021-S01;4;2;6;3151.45861023308;2460.52498233809;49;5611.98359257117
08;2021-S01;5;5;10;2620.29868333099;2422.23566154656;59;5042.53434487755
08;2021-S01;0;1;1;1621.44173420671;1438.58325779464;69;3060.02499200135
08;2021-S01;1;1;2;626.575909335673;526.358467843651;79;1152.93437717932
08;2021-S01;0;0;0;205.018522985054;140.993639349697;89;346.012162334751
08;2021-S01;0;0;0;50.0325684687745;20.62259870351;90;70.6551671722846
08;2021-S01;20;27;47;18551.3174743414;16782.6825256586;0;35334
11;2021-S01;310;356;694;783071;811785;09;1594856
11;2021-S01;1358;1275;2692;761456;784653;19;1546109
11;2021-S01;2626;2129;4776;850145;801772;29;1651917
11;2021-S01;2243;2026;4282;914360;843488;39;1757848
11;2021-S01;1766;1570;3354;845609;826202;49;1671811
11;2021-S01;1551;1366;2927;793566;745070;59;1538636
11;2021-S01;1033;912;1958;628649;549192;69;1177841
11;2021-S01;566;512;1078;434606;358356;79;792962
11;2021-S01;480;302;784;261425;162933;89;424358
11;2021-S01;318;96;414;89253;32619;90;121872
11;2021-S01;12252;10547;22966;6362140;5916070;0;12278210
24;2021-S01;54;59;114;139720;144686;09;284406
24;2021-S01;281;237;519;152979;161185;19;314164
24;2021-S01;370;304;674;122237;126536;29;248773
24;2021-S01;367;273;640;150359;142009;39;292368
24;2021-S01;324;267;591;161829;158758;49;320587
24;2021-S01;386;274;660;172552;168011;59;340563
24;2021-S01;220;261;481;172509;158177;69;330686
24;2021-S01;169;135;304;129428;110593;79;240021
24;2021-S01;208;107;315;87342;56882;89;144224
24;2021-S01;162;56;218;31210;12071;90;43281
24;2021-S01;2541;1974;4517;1320165;1238908;0;2559073
27;2021-S01;123;141;264;143373;149679;09;293052
27;2021-S01;498;554;1055;160962;173003;19;333965
27;2021-S01;558;540;1098;133746;142254;29;276000
27;2021-S01;595;442;1037;160004;155407;39;315411
27;2021-S01;556;475;1031;172333;169564;49;341897
27;2021-S01;566;512;1078;189979;183788;59;373767
27;2021-S01;409;371;780;192591;178206;69;370797
27;2021-S01;316;335;651;146876;127546;79;274422
27;2021-S01;354;229;583;96896;61575;89;158471
27;2021-S01;269;89;358;33148;12109;90;45257
27;2021-S01;4245;3689;7937;1429908;1353131;0;2783039
28;2021-S01;78;99;182;180735;186856;09;367591
28;2021-S01;349;324;677;200125;213621;19;413746
28;2021-S01;517;463;980;168922;173007;29;341929
28;2021-S01;415;341;756;196628;188487;39;385115
28;2021-S01;419;335;754;205396;201699;49;407095
28;2021-S01;411;349;760;222002;213866;59;435868
28;2021-S01;292;314;606;224688;203758;69;428446
28;2021-S01;198;178;376;163192;135543;79;298735
28;2021-S01;231;137;368;109691;65377;89;175068
28;2021-S01;108;42;150;37222;12685;90;49907
28;2021-S01;3018;2582;5609;1708601;1594899;0;3303500
32;2021-S01;164;210;375;358062;373689;09;731751
32;2021-S01;705;598;1306;387045;406742;19;793787
32;2021-S01;946;766;1714;342304;348587;29;690891
32;2021-S01;915;789;1704;382485;369972;39;752457
32;2021-S01;768;676;1445;382510;376716;49;759226
32;2021-S01;783;680;1463;386937;376527;59;763464
32;2021-S01;569;488;1058;371211;330938;69;702149
32;2021-S01;376;350;726;250542;201459;79;452001
32;2021-S01;441;196;637;163399;89786;89;253185
32;2021-S01;296;94;390;48384;15367;90;63751
32;2021-S01;5964;4849;10821;3072879;2889783;0;5962662
44;2021-S01;231;232;468;291525;306839;09;598364
44;2021-S01;758;713;1483;320255;339504;19;659759
44;2021-S01;1127;961;2089;302020;314428;29;616448
44;2021-S01;1056;814;1880;342222;333292;39;675514
44;2021-S01;940;795;1743;349727;344491;49;694218
44;2021-S01;892;822;1717;381371;373239;59;754610
44;2021-S01;750;678;1433;367165;335850;69;703015
44;2021-S01;508;478;995;250387;215436;79;465823
44;2021-S01;609;343;956;170825;105192;89;276017
44;2021-S01;318;123;441;51248;16731;90;67979
44;2021-S01;7190;5959;13206;2826745;2685002;0;5511747
52;2021-S01;70;76;146;213594;223900;09;437494
52;2021-S01;314;318;643;240818;255197;19;496015
52;2021-S01;397;355;752;197010;200630;29;397640
52;2021-S01;307;273;583;231204;224885;39;456089
52;2021-S01;340;276;617;243874;243418;49;487292
52;2021-S01;355;268;629;244100;239116;59;483216
52;2021-S01;217;219;441;241796;221345;69;463141
52;2021-S01;161;166;332;177805;149903;79;327708
52;2021-S01;191;120;312;119561;75822;89;195383
52;2021-S01;150;58;208;42559;15260;90;57819
52;2021-S01;2502;2129;4663;1952321;1849476;0;3801797
53;2021-S01;49;50;101;173813;182358;09;356171
53;2021-S01;183;189;377;202720;214740;19;417460
53;2021-S01;286;284;575;163116;173196;29;336312
53;2021-S01;207;155;362;190526;187674;39;378200
53;2021-S01;205;181;386;212098;212015;49;424113
53;2021-S01;202;174;376;223699;219176;59;442875
53;2021-S01;128;134;262;227435;209274;69;436709
53;2021-S01;102;81;183;169992;140910;79;310902
53;2021-S01;96;57;153;118117;69883;89;188000
53;2021-S01;75;23;99;37370;12267;90;49637
53;2021-S01;1533;1328;2874;1718886;1621493;0;3340379
75;2021-S01;121;143;269;293104;305291;09;598395
75;2021-S01;521;475;1003;337141;357785;19;694926
75;2021-S01;697;564;1262;295024;300618;29;595642
75;2021-S01;604;507;1112;347871;331233;39;679104
75;2021-S01;701;584;1286;384742;372771;49;757513
75;2021-S01;552;481;1034;413361;390880;59;804241
75;2021-S01;394;417;815;425623;384060;69;809683
75;2021-S01;256;261;518;325086;276298;79;601384
75;2021-S01;335;177;514;213986;139308;89;353294
75;2021-S01;252;96;349;77600;28200;90;105800
75;2021-S01;4434;3706;8164;3113538;2886444;0;5999982
76;2021-S01;130;139;275;305956;318589;09;624545
76;2021-S01;681;603;1302;338942;356969;19;695911
76;2021-S01;927;780;1710;316210;319570;29;635780
76;2021-S01;795;642;1437;356758;337587;39;694345
76;2021-S01;755;674;1430;376541;363812;49;740353
76;2021-S01;742;587;1329;402608;383750;59;786358
76;2021-S01;520;502;1024;394889;358997;69;753886
76;2021-S01;381;335;716;308664;263806;79;572470
76;2021-S01;370;223;593;195838;129272;89;325110
76;2021-S01;282;92;374;69372;26728;90;96100
76;2021-S01;5588;4582;10200;3065778;2859080;0;5924858
84;2021-S01;293;283;583;459549;481088;09;940637
84;2021-S01;1150;1155;2310;487711;511905;19;999616
84;2021-S01;1517;1421;2940;443824;451094;29;894918
84;2021-S01;1439;1222;2665;512522;493262;39;1005784
84;2021-S01;1279;1138;2417;520248;515106;49;1035354
84;2021-S01;1294;1157;2453;529611;514848;59;1044459
84;2021-S01;900;880;1781;486720;439940;69;926660
84;2021-S01;643;613;1257;372151;315211;79;687362
84;2021-S01;602;376;979;237198;150524;89;387722
84;2021-S01;428;148;576;81185;28680;90;109865
84;2021-S01;9545;8395;17967;4130719;3901658;0;8032377
93;2021-S01;176;210;388;268834;283093;09;551927
93;2021-S01;917;876;1799;280751;296087;19;576838
93;2021-S01;1293;1100;2397;254404;255552;29;509956
93;2021-S01;1266;1098;2371;310704;288398;39;599102
93;2021-S01;1207;994;2204;325559;305827;49;631386
93;2021-S01;1248;998;2252;353104;325389;59;678493
93;2021-S01;910;801;1715;336327;296459;69;632786
93;2021-S01;650;513;1163;279820;229699;79;509519
93;2021-S01;590;368;958;171274;113716;89;284990
93;2021-S01;467;141;608;58896;21758;90;80654
93;2021-S01;8726;7100;15859;2639673;2415978;0;5055651
94;2021-S01;8;3;11;16311;17433;09;33744
94;2021-S01;12;15;27;16679;18132;19;34811
94;2021-S01;29;25;54;16782;16579;29;33361
94;2021-S01;31;15;46;23044;20580;39;43624
94;2021-S01;18;20;38;23065;22140;49;45205
94;2021-S01;18;23;41;24549;23421;59;47970
94;2021-S01;11;19;30;23212;21883;69;45095
94;2021-S01;14;15;29;19544;17141;79;36685
94;2021-S01;5;1;6;11227;8178;89;19405
94;2021-S01;1;1;2;3332;1447;90;4779
94;2021-S01;147;137;284;177745;166934;0;344679
01;2021-S02;1;2;3;19979;20155;09;40134
01;2021-S02;4;9;13;24994;25489;19;50483
01;2021-S02;9;7;16;17868;16690;29;34558
01;2021-S02;5;5;10;22328;14821;39;37149
01;2021-S02;11;8;19;28652;20276;49;48928
01;2021-S02;8;8;16;33264;27260;59;60524
01;2021-S02;1;4;5;27135;23978;69;51113
01;2021-S02;5;7;12;18401;14661;79;33062
01;2021-S02;4;1;5;9633;6375;89;16008
01;2021-S02;2;0;2;3410;1510;90;4920
01;2021-S02;50;51;101;205664;171215;0;376879
02;2021-S02;0;0;0;16881;17110;09;33991
02;2021-S02;3;3;6;21410;21604;19;43014
02;2021-S02;11;4;15;16017;15479;29;31496
02;2021-S02;3;5;8;19825;14455;39;34280
02;2021-S02;4;3;7;24719;18248;49;42967
02;2021-S02;9;7;16;34361;28310;59;62671
02;2021-S02;5;9;14;28061;24495;69;52556
02;2021-S02;4;1;5;18231;15278;79;33509
02;2021-S02;2;0;2;11090;7677;89;18767
02;2021-S02;0;0;0;3992;1506;90;5498
02;2021-S02;41;32;73;194587;164162;0;358749
03;2021-S02;4;9;13;31123;30920;09;62043
03;2021-S02;85;52;137;29370;29268;19;58638
03;2021-S02;100;60;161;21458;18963;29;40421
03;2021-S02;95;56;151;21276;18326;39;39602
03;2021-S02;89;57;146;18164;16593;49;34757
03;2021-S02;48;61;109;13469;13557;59;27026
03;2021-S02;43;36;79;8776;8670;69;17446
03;2021-S02;7;7;14;3777;3591;79;7368
03;2021-S02;1;4;5;1649;1072;89;2721
03;2021-S02;2;0;2;485;184;90;669
03;2021-S02;474;343;818;149547;141144;0;290691
04;2021-S02;2;4;7;60314;61377;09;121691
04;2021-S02;26;12;38;66065;68387;19;134452
04;2021-S02;23;15;38;51059;47156;29;98215
04;2021-S02;21;15;36;58788;45780;39;104568
04;2021-S02;27;17;44;61408;52207;49;113615
04;2021-S02;17;19;36;64838;60759;59;125597
04;2021-S02;12;11;23;47008;42843;69;89851
04;2021-S02;2;2;4;25509;21184;79;46693
04;2021-S02;3;0;3;13168;7647;89;20815
04;2021-S02;0;0;0;3209;1253;90;4462
04;2021-S02;133;95;229;451366;408593;0;859959
05;2021-S02;0;0;0;362.366008612902;341.338819562748;09;703.704828175651
05;2021-S02;0;0;0;353.376145114279;370.349735405642;19;723.725880519921
05;2021-S02;0;0;0;218.593559489256;256.539602589476;29;475.133162078732
05;2021-S02;0;0;0;404.225408693299;360.321910454353;39;764.547319147651
05;2021-S02;0;0;0;520.067953604221;497.108383964256;49;1017.17633756848
05;2021-S02;1;0;1;468.146063921917;510.087601910415;59;978.233665832332
05;2021-S02;0;1;1;340.368470050554;334.366842191253;69;674.735312241807
05;2021-S02;0;0;0;212.598666888387;192.597753227106;79;405.196420115493
05;2021-S02;0;0;0;148.727797095705;61.8681715431829;89;210.595968638888
05;2021-S02;0;0;0;32.9601271090696;10.9909785719784;90;43.9511056810479
05;2021-S02;1;1;2;3061.43020057959;2935.56979942041;0;5997
06;2021-S02;4;0;4;42583;42380;09;84963
06;2021-S02;49;38;87;33369;31925;19;65294
06;2021-S02;56;40;96;21571;15080;29;36651
06;2021-S02;68;44;112;21550;16147;39;37697
06;2021-S02;59;61;120;14193;13939;49;28132
06;2021-S02;30;50;80;7171;7597;59;14768
06;2021-S02;11;23;34;3629;4117;69;7746
06;2021-S02;3;5;8;1577;1457;79;3034
06;2021-S02;3;0;3;531;474;89;1005
06;2021-S02;1;0;1;88;93;90;181
06;2021-S02;284;261;545;146262;133209;0;279471
07;2021-S02;0;0;0;485;549;09;1034
07;2021-S02;1;2;3;403;432;19;835
07;2021-S02;7;4;11;764;841;29;1605
07;2021-S02;6;7;13;824;928;39;1752
07;2021-S02;2;10;12;788;1020;49;1808
07;2021-S02;6;0;6;678;870;59;1548
07;2021-S02;1;5;6;360;382;69;742
07;2021-S02;0;0;0;231;190;79;421
07;2021-S02;0;0;0;114;67;89;181
07;2021-S02;0;0;0;24;11;90;35
07;2021-S02;23;28;51;4671;5290;0;9961
08;2021-S02;0;0;0;2715.22592983026;2997.75551488675;09;5712.98144471701
08;2021-S02;2;1;3;2778.51901080978;3160.9156459093;19;5939.43465671908
08;2021-S02;11;3;14;2080.8882988764;1718.16634315323;29;3799.05464202964
08;2021-S02;13;9;22;2701.8582062647;1896.52641413317;39;4598.38462039786
08;2021-S02;7;3;10;3151.45861023308;2460.52498233809;49;5611.98359257117
08;2021-S02;6;5;11;2620.29868333099;2422.23566154656;59;5042.53434487755
08;2021-S02;5;12;17;1621.44173420671;1438.58325779464;69;3060.02499200135
08;2021-S02;1;3;4;626.575909335673;526.358467843651;79;1152.93437717932
08;2021-S02;0;0;0;205.018522985054;140.993639349697;89;346.012162334751
08;2021-S02;0;0;0;50.0325684687745;20.62259870351;90;70.6551671722846
08;2021-S02;45;36;81;18551.3174743414;16782.6825256586;0;35334
11;2021-S02;405;426;870;783071;811785;09;1594856
11;2021-S02;1480;1435;3001;761456;784653;19;1546109
11;2021-S02;2401;1994;4410;850145;801772;29;1651917
11;2021-S02;2296;2105;4417;914360;843488;39;1757848
11;2021-S02;1966;1733;3712;845609;826202;49;1671811
11;2021-S02;1644;1462;3113;793566;745070;59;1538636
11;2021-S02;1112;1010;2138;628649;549192;69;1177841
11;2021-S02;568;591;1162;434606;358356;79;792962
11;2021-S02;516;323;841;261425;162933;89;424358
11;2021-S02;335;119;454;89253;32619;90;121872
11;2021-S02;12725;11209;24139;6362140;5916070;0;12278210
24;2021-S02;59;58;119;139720;144686;09;284406
24;2021-S02;273;296;577;152979;161185;19;314164
24;2021-S02;333;263;596;122237;126536;29;248773
24;2021-S02;364;261;625;150359;142009;39;292368
24;2021-S02;349;280;629;161829;158758;49;320587
24;2021-S02;352;302;655;172552;168011;59;340563
24;2021-S02;209;239;448;172509;158177;69;330686
24;2021-S02;192;163;355;129428;110593;79;240021
24;2021-S02;220;132;352;87342;56882;89;144224
24;2021-S02;187;55;242;31210;12071;90;43281
24;2021-S02;2539;2049;4599;1320165;1238908;0;2559073
27;2021-S02;105;112;218;143373;149679;09;293052
27;2021-S02;459;433;895;160962;173003;19;333965
27;2021-S02;437;336;773;133746;142254;29;276000
27;2021-S02;419;344;763;160004;155407;39;315411
27;2021-S02;492;404;896;172333;169564;49;341897
27;2021-S02;536;484;1020;189979;183788;59;373767
27;2021-S02;346;372;718;192591;178206;69;370797
27;2021-S02;322;289;611;146876;127546;79;274422
27;2021-S02;338;200;538;96896;61575;89;158471
27;2021-S02;265;76;341;33148;12109;90;45257
27;2021-S02;3719;3050;6773;1429908;1353131;0;2783039
28;2021-S02;125;102;234;180735;186856;09;367591
28;2021-S02;341;314;661;200125;213621;19;413746
28;2021-S02;458;382;842;168922;173007;29;341929
28;2021-S02;470;341;811;196628;188487;39;385115
28;2021-S02;423;357;781;205396;201699;49;407095
28;2021-S02;425;379;804;222002;213866;59;435868
28;2021-S02;286;359;646;224688;203758;69;428446
28;2021-S02;234;235;469;163192;135543;79;298735
28;2021-S02;267;137;404;109691;65377;89;175068
28;2021-S02;209;42;251;37222;12685;90;49907
28;2021-S02;3239;2648;5904;1708601;1594899;0;3303500
32;2021-S02;204;229;437;358062;373689;09;731751
32;2021-S02;799;752;1554;387045;406742;19;793787
32;2021-S02;933;725;1658;342304;348587;29;690891
32;2021-S02;947;785;1734;382485;369972;39;752457
32;2021-S02;899;752;1651;382510;376716;49;759226
32;2021-S02;865;778;1644;386937;376527;59;763464
32;2021-S02;578;530;1108;371211;330938;69;702149
32;2021-S02;443;384;828;250542;201459;79;452001
32;2021-S02;478;267;745;163399;89786;89;253185
32;2021-S02;308;94;402;48384;15367;90;63751
32;2021-S02;6455;5296;11762;3072879;2889783;0;5962662
44;2021-S02;210;220;433;291525;306839;09;598364
44;2021-S02;719;721;1447;320255;339504;19;659759
44;2021-S02;872;746;1621;302020;314428;29;616448
44;2021-S02;830;699;1540;342222;333292;39;675514
44;2021-S02;812;624;1442;349727;344491;49;694218
44;2021-S02;827;741;1574;381371;373239;59;754610
44;2021-S02;541;545;1094;367165;335850;69;703015
44;2021-S02;404;378;783;250387;215436;79;465823
44;2021-S02;542;312;859;170825;105192;89;276017
44;2021-S02;357;115;474;51248;16731;90;67979
44;2021-S02;6114;5101;11280;2826745;2685002;0;5511747
52;2021-S02;82;93;187;213594;223900;09;437494
52;2021-S02;321;362;688;240818;255197;19;496015
52;2021-S02;429;361;792;197010;200630;29;397640
52;2021-S02;404;293;697;231204;224885;39;456089
52;2021-S02;429;383;815;243874;243418;49;487292
52;2021-S02;418;336;754;244100;239116;59;483216
52;2021-S02;269;289;559;241796;221345;69;463141
52;2021-S02;192;190;383;177805;149903;79;327708
52;2021-S02;273;149;423;119561;75822;89;195383
52;2021-S02;198;57;255;42559;15260;90;57819
52;2021-S02;3015;2513;5553;1952321;1849476;0;3801797
53;2021-S02;57;76;136;173813;182358;09;356171
53;2021-S02;210;218;432;202720;214740;19;417460
53;2021-S02;266;236;517;163116;173196;29;336312
53;2021-S02;227;199;426;190526;187674;39;378200
53;2021-S02;224;198;423;212098;212015;49;424113
53;2021-S02;234;188;422;223699;219176;59;442875
53;2021-S02;141;154;295;227435;209274;69;436709
53;2021-S02;103;107;210;169992;140910;79;310902
53;2021-S02;129;76;205;118117;69883;89;188000
53;2021-S02;114;41;161;37370;12267;90;49637
53;2021-S02;1705;1493;3227;1718886;1621493;0;3340379
75;2021-S02;162;172;338;293104;305291;09;598395
75;2021-S02;505;542;1052;337141;357785;19;694926
75;2021-S02;689;594;1283;295024;300618;29;595642
75;2021-S02;698;526;1224;347871;331233;39;679104
75;2021-S02;774;545;1321;384742;372771;49;757513
75;2021-S02;645;564;1212;413361;390880;59;804241
75;2021-S02;461;438;900;425623;384060;69;809683
75;2021-S02;331;312;643;325086;276298;79;601384
75;2021-S02;400;249;650;213986;139308;89;353294
75;2021-S02;356;118;476;77600;28200;90;105800
75;2021-S02;5022;4061;9101;3113538;2886444;0;5999982
76;2021-S02;166;195;369;305956;318589;09;624545
76;2021-S02;652;638;1308;338942;356969;19;695911
76;2021-S02;877;721;1598;316210;319570;29;635780
76;2021-S02;883;698;1581;356758;337587;39;694345
76;2021-S02;868;692;1560;376541;363812;49;740353
76;2021-S02;837;702;1540;402608;383750;59;786358
76;2021-S02;556;517;1073;394889;358997;69;753886
76;2021-S02;397;349;746;308664;263806;79;572470
76;2021-S02;468;293;761;195838;129272;89;325110
76;2021-S02;365;152;517;69372;26728;90;96100
76;2021-S02;6074;4960;11061;3065778;2859080;0;5924858
84;2021-S02;286;264;554;459549;481088;09;940637
84;2021-S02;1009;1082;2098;487711;511905;19;999616
84;2021-S02;1295;1075;2371;443824;451094;29;894918
84;2021-S02;1283;1097;2381;512522;493262;39;1005784
84;2021-S02;1301;1091;2392;520248;515106;49;1035354
84;2021-S02;1208;1063;2271;529611;514848;59;1044459
84;2021-S02;756;787;1545;486720;439940;69;926660
84;2021-S02;671;625;1296;372151;315211;79;687362
84;2021-S02;634;420;1054;237198;150524;89;387722
84;2021-S02;512;159;671;81185;28680;90;109865
84;2021-S02;8957;7664;16637;4130719;3901658;0;8032377
93;2021-S02;227;242;473;268834;283093;09;551927
93;2021-S02;954;993;1953;280751;296087;19;576838
93;2021-S02;1287;1009;2297;254404;255552;29;509956
93;2021-S02;1329;1037;2369;310704;288398;39;599102
93;2021-S02;1326;1141;2469;325559;305827;49;631386
93;2021-S02;1356;1151;2510;353104;325389;59;678493
93;2021-S02;840;833;1674;336327;296459;69;632786
93;2021-S02;610;551;1163;279820;229699;79;509519
93;2021-S02;660;386;1051;171274;113716;89;284990
93;2021-S02;596;170;768;58896;21758;90;80654
93;2021-S02;9187;7516;16797;2639673;2415978;0;5055651
94;2021-S02;4;1;5;16311;17433;09;33744
94;2021-S02;8;33;41;16679;18132;19;34811
94;2021-S02;19;19;38;16782;16579;29;33361
94;2021-S02;19;26;45;23044;20580;39;43624
94;2021-S02;15;21;36;23065;22140;49;45205
94;2021-S02;14;27;41;24549;23421;59;47970
94;2021-S02;21;12;33;23212;21883;69;45095
94;2021-S02;11;11;22;19544;17141;79;36685
94;2021-S02;12;12;24;11227;8178;89;19405
94;2021-S02;5;2;7;3332;1447;90;4779
94;2021-S02;128;164;292;177745;166934;0;344679
01;2021-S03;1;2;3;19979;20155;09;40134
01;2021-S03;6;7;13;24994;25489;19;50483
01;2021-S03;6;6;12;17868;16690;29;34558
01;2021-S03;9;8;17;22328;14821;39;37149
01;2021-S03;8;9;17;28652;20276;49;48928
01;2021-S03;11;10;21;33264;27260;59;60524
01;2021-S03;8;8;16;27135;23978;69;51113
01;2021-S03;7;1;8;18401;14661;79;33062
01;2021-S03;4;3;7;9633;6375;89;16008
01;2021-S03;2;2;4;3410;1510;90;4920
01;2021-S03;62;56;118;205664;171215;0;376879
02;2021-S03;3;0;5;16881;17110;09;33991
02;2021-S03;2;0;2;21410;21604;19;43014
02;2021-S03;5;3;8;16017;15479;29;31496
02;2021-S03;7;2;9;19825;14455;39;34280
02;2021-S03;7;5;12;24719;18248;49;42967
02;2021-S03;8;9;17;34361;28310;59;62671
02;2021-S03;8;6;14;28061;24495;69;52556
02;2021-S03;2;2;4;18231;15278;79;33509
02;2021-S03;1;2;3;11090;7677;89;18767
02;2021-S03;0;1;1;3992;1506;90;5498
02;2021-S03;43;30;75;194587;164162;0;358749
03;2021-S03;19;11;31;31123;30920;09;62043
03;2021-S03;59;51;112;29370;29268;19;58638
03;2021-S03;74;51;126;21458;18963;29;40421
03;2021-S03;68;43;112;21276;18326;39;39602
03;2021-S03;36;47;83;18164;16593;49;34757
03;2021-S03;46;32;78;13469;13557;59;27026
03;2021-S03;24;50;74;8776;8670;69;17446
03;2021-S03;5;9;14;3777;3591;79;7368
03;2021-S03;1;3;4;1649;1072;89;2721
03;2021-S03;2;2;4;485;184;90;669
03;2021-S03;334;299;638;149547;141144;0;290691
04;2021-S03;6;7;14;60314;61377;09;121691
04;2021-S03;30;24;56;66065;68387;19;134452
04;2021-S03;30;29;59;51059;47156;29;98215
04;2021-S03;25;22;47;58788;45780;39;104568
04;2021-S03;29;38;67;61408;52207;49;113615
04;2021-S03;22;28;50;64838;60759;59;125597
04;2021-S03;14;17;31;47008;42843;69;89851
04;2021-S03;10;7;17;25509;21184;79;46693
04;2021-S03;1;5;6;13168;7647;89;20815
04;2021-S03;2;0;2;3209;1253;90;4462
04;2021-S03;169;177;349;451366;408593;0;859959
05;2021-S03;0;0;0;362.366008612902;341.338819562748;09;703.704828175651
05;2021-S03;0;0;0;353.376145114279;370.349735405642;19;723.725880519921
05;2021-S03;0;0;0;218.593559489256;256.539602589476;29;475.133162078732
05;2021-S03;0;0;0;404.225408693299;360.321910454353;39;764.547319147651
05;2021-S03;0;0;0;520.067953604221;497.108383964256;49;1017.17633756848
05;2021-S03;0;0;0;468.146063921917;510.087601910415;59;978.233665832332
05;2021-S03;0;1;1;340.368470050554;334.366842191253;69;674.735312241807
05;2021-S03;0;0;0;212.598666888387;192.597753227106;79;405.196420115493
05;2021-S03;0;0;0;148.727797095705;61.8681715431829;89;210.595968638888
05;2021-S03;0;0;0;32.9601271090696;10.9909785719784;90;43.9511056810479
05;2021-S03;0;1;1;3061.43020057959;2935.56979942041;0;5997
06;2021-S03;10;6;16;42583;42380;09;84963
06;2021-S03;67;60;132;33369;31925;19;65294
06;2021-S03;87;57;144;21571;15080;29;36651
06;2021-S03;72;66;138;21550;16147;39;37697
06;2021-S03;74;68;142;14193;13939;49;28132
06;2021-S03;39;39;78;7171;7597;59;14768
06;2021-S03;27;44;72;3629;4117;69;7746
06;2021-S03;11;16;27;1577;1457;79;3034
06;2021-S03;1;3;4;531;474;89;1005
06;2021-S03;0;1;1;88;93;90;181
06;2021-S03;388;360;754;146262;133209;0;279471
07;2021-S03;0;0;0;485;549;09;1034
07;2021-S03;2;0;2;403;432;19;835
07;2021-S03;7;7;14;764;841;29;1605
07;2021-S03;9;11;20;824;928;39;1752
07;2021-S03;4;5;9;788;1020;49;1808
07;2021-S03;5;4;9;678;870;59;1548
07;2021-S03;1;1;2;360;382;69;742
07;2021-S03;1;1;2;231;190;79;421
07;2021-S03;0;1;1;114;67;89;181
07;2021-S03;0;0;0;24;11;90;35
07;2021-S03;29;30;59;4671;5290;0;9961
08;2021-S03;0;1;1;2715.22592983026;2997.75551488675;09;5712.98144471701
08;2021-S03;5;5;10;2778.51901080978;3160.9156459093;19;5939.43465671908
08;2021-S03;3;7;10;2080.8882988764;1718.16634315323;29;3799.05464202964
08;2021-S03;17;6;23;2701.8582062647;1896.52641413317;39;4598.38462039786
08;2021-S03;6;3;9;3151.45861023308;2460.52498233809;49;5611.98359257117
08;2021-S03;10;6;16;2620.29868333099;2422.23566154656;59;5042.53434487755
08;2021-S03;5;4;9;1621.44173420671;1438.58325779464;69;3060.02499200135
08;2021-S03;1;1;2;626.575909335673;526.358467843651;79;1152.93437717932
08;2021-S03;1;0;1;205.018522985054;140.993639349697;89;346.012162334751
08;2021-S03;0;0;0;50.0325684687745;20.62259870351;90;70.6551671722846
08;2021-S03;48;33;81;18551.3174743414;16782.6825256586;0;35334
11;2021-S03;562;602;1225;783071;811785;09;1594856
11;2021-S03;1702;1741;3531;761456;784653;19;1546109
11;2021-S03;2422;2060;4490;850145;801772;29;1651917
11;2021-S03;2399;2092;4502;914360;843488;39;1757848
11;2021-S03;2186;1938;4127;845609;826202;49;1671811
11;2021-S03;1791;1710;3503;793566;745070;59;1538636
11;2021-S03;1159;1190;2377;628649;549192;69;1177841
11;2021-S03;633;605;1240;434606;358356;79;792962
11;2021-S03;527;341;868;261425;162933;89;424358
11;2021-S03;337;111;449;89253;32619;90;121872
11;2021-S03;13722;12399;26335;6362140;5916070;0;12278210
24;2021-S03;97;74;174;139720;144686;09;284406
24;2021-S03;375;397;779;152979;161185;19;314164
24;2021-S03;352;256;608;122237;126536;29;248773
24;2021-S03;399;287;686;150359;142009;39;292368
24;2021-S03;412;319;732;161829;158758;49;320587
24;2021-S03;378;293;671;172552;168011;59;340563
24;2021-S03;258;228;486;172509;158177;69;330686
24;2021-S03;180;179;359;129428;110593;79;240021
24;2021-S03;206;133;339;87342;56882;89;144224
24;2021-S03;176;56;232;31210;12071;90;43281
24;2021-S03;2833;2223;5069;1320165;1238908;0;2559073
27;2021-S03;129;121;251;143373;149679;09;293052
27;2021-S03;431;511;950;160962;173003;19;333965
27;2021-S03;441;322;763;133746;142254;29;276000
27;2021-S03;461;330;791;160004;155407;39;315411
27;2021-S03;525;400;925;172333;169564;49;341897
27;2021-S03;515;483;998;189979;183788;59;373767
27;2021-S03;363;353;717;192591;178206;69;370797
27;2021-S03;305;284;589;146876;127546;79;274422
27;2021-S03;319;215;535;96896;61575;89;158471
27;2021-S03;264;70;334;33148;12109;90;45257
27;2021-S03;3753;3089;6855;1429908;1353131;0;2783039
28;2021-S03;134;137;273;180735;186856;09;367591
28;2021-S03;340;338;689;200125;213621;19;413746
28;2021-S03;494;328;822;168922;173007;29;341929
28;2021-S03;457;368;826;196628;188487;39;385115
28;2021-S03;493;385;878;205396;201699;49;407095
28;2021-S03;478;390;868;222002;213866;59;435868
28;2021-S03;347;314;661;224688;203758;69;428446
28;2021-S03;235;225;460;163192;135543;79;298735
28;2021-S03;310;155;465;109691;65377;89;175068
28;2021-S03;224;76;300;37222;12685;90;49907
28;2021-S03;3512;2716;6244;1708601;1594899;0;3303500
32;2021-S03;269;294;566;358062;373689;09;731751
32;2021-S03;820;894;1719;387045;406742;19;793787
32;2021-S03;930;783;1713;342304;348587;29;690891
32;2021-S03;1022;747;1769;382485;369972;39;752457
32;2021-S03;991;875;1866;382510;376716;49;759226
32;2021-S03;890;827;1717;386937;376527;59;763464
32;2021-S03;630;578;1208;371211;330938;69;702149
32;2021-S03;488;416;904;250542;201459;79;452001
32;2021-S03;461;249;711;163399;89786;89;253185
32;2021-S03;264;67;331;48384;15367;90;63751
32;2021-S03;6766;5732;12512;3072879;2889783;0;5962662
44;2021-S03;279;268;554;291525;306839;09;598364
44;2021-S03;807;775;1589;320255;339504;19;659759
44;2021-S03;969;787;1759;302020;314428;29;616448
44;2021-S03;991;743;1738;342222;333292;39;675514
44;2021-S03;920;783;1708;349727;344491;49;694218
44;2021-S03;948;830;1787;381371;373239;59;754610
44;2021-S03;566;587;1156;367165;335850;69;703015
44;2021-S03;417;400;820;250387;215436;79;465823
44;2021-S03;528;300;831;170825;105192;89;276017
44;2021-S03;361;94;457;51248;16731;90;67979
44;2021-S03;6786;5568;12403;2826745;2685002;0;5511747
52;2021-S03;111;106;225;213594;223900;09;437494
52;2021-S03;371;388;766;240818;255197;19;496015
52;2021-S03;441;420;862;197010;200630;29;397640
52;2021-S03;479;372;856;231204;224885;39;456089
52;2021-S03;483;373;860;243874;243418;49;487292
52;2021-S03;452;412;871;244100;239116;59;483216
52;2021-S03;309;320;632;241796;221345;69;463141
52;2021-S03;229;221;450;177805;149903;79;327708
52;2021-S03;297;171;468;119561;75822;89;195383
52;2021-S03;210;66;276;42559;15260;90;57819
52;2021-S03;3382;2849;6266;1952321;1849476;0;3801797
53;2021-S03;88;89;182;173813;182358;09;356171
53;2021-S03;240;218;464;202720;214740;19;417460
53;2021-S03;254;214;479;163116;173196;29;336312
53;2021-S03;252;196;448;190526;187674;39;378200
53;2021-S03;256;223;479;212098;212015;49;424113
53;2021-S03;197;202;399;223699;219176;59;442875
53;2021-S03;173;161;334;227435;209274;69;436709
53;2021-S03;106;104;210;169992;140910;79;310902
53;2021-S03;147;88;235;118117;69883;89;188000
53;2021-S03;108;27;140;37370;12267;90;49637
53;2021-S03;1821;1522;3371;1718886;1621493;0;3340379
75;2021-S03;213;227;444;293104;305291;09;598395
75;2021-S03;589;679;1273;337141;357785;19;694926
75;2021-S03;698;612;1310;295024;300618;29;595642
75;2021-S03;725;586;1311;347871;331233;39;679104
75;2021-S03;815;686;1502;384742;372771;49;757513
75;2021-S03;745;642;1388;413361;390880;59;804241
75;2021-S03;477;517;994;425623;384060;69;809683
75;2021-S03;345;336;681;325086;276298;79;601384
75;2021-S03;428;228;657;213986;139308;89;353294
75;2021-S03;339;123;465;77600;28200;90;105800
75;2021-S03;5375;4638;10032;3113538;2886444;0;5999982
76;2021-S03;231;254;498;305956;318589;09;624545
76;2021-S03;765;802;1589;338942;356969;19;695911
76;2021-S03;892;702;1596;316210;319570;29;635780
76;2021-S03;988;747;1735;356758;337587;39;694345
76;2021-S03;1031;795;1829;376541;363812;49;740353
76;2021-S03;942;807;1751;402608;383750;59;786358
76;2021-S03;651;599;1250;394889;358997;69;753886
76;2021-S03;463;405;868;308664;263806;79;572470
76;2021-S03;485;307;793;195838;129272;89;325110
76;2021-S03;431;130;562;69372;26728;90;96100
76;2021-S03;6879;5553;12476;3065778;2859080;0;5924858
84;2021-S03;390;425;819;459549;481088;09;940637
84;2021-S03;1245;1268;2524;487711;511905;19;999616
84;2021-S03;1356;1106;2465;443824;451094;29;894918
84;2021-S03;1503;1209;2713;512522;493262;39;1005784
84;2021-S03;1521;1241;2763;520248;515106;49;1035354
84;2021-S03;1349;1222;2573;529611;514848;59;1044459
84;2021-S03;844;839;1683;486720;439940;69;926660
84;2021-S03;634;561;1195;372151;315211;79;687362
84;2021-S03;621;382;1003;237198;150524;89;387722
84;2021-S03;471;147;618;81185;28680;90;109865
84;2021-S03;9936;8402;18367;4130719;3901658;0;8032377
93;2021-S03;309;323;640;268834;283093;09;551927
93;2021-S03;1172;1088;2265;280751;296087;19;576838
93;2021-S03;1433;1111;2548;254404;255552;29;509956
93;2021-S03;1570;1211;2781;310704;288398;39;599102
93;2021-S03;1598;1284;2888;325559;305827;49;631386
93;2021-S03;1548;1262;2814;353104;325389;59;678493
93;2021-S03;936;928;1865;336327;296459;69;632786
93;2021-S03;722;617;1340;279820;229699;79;509519
93;2021-S03;756;501;1257;171274;113716;89;284990
93;2021-S03;625;175;802;58896;21758;90;80654
93;2021-S03;10670;8501;19206;2639673;2415978;0;5055651
94;2021-S03;4;1;5;16311;17433;09;33744
94;2021-S03;15;21;36;16679;18132;19;34811
94;2021-S03;23;20;43;16782;16579;29;33361
94;2021-S03;22;22;44;23044;20580;39;43624
94;2021-S03;23;22;45;23065;22140;49;45205
94;2021-S03;26;25;51;24549;23421;59;47970
94;2021-S03;21;25;46;23212;21883;69;45095
94;2021-S03;20;22;42;19544;17141;79;36685
94;2021-S03;13;11;24;11227;8178;89;19405
94;2021-S03;15;4;19;3332;1447;90;4779
94;2021-S03;182;173;355;177745;166934;0;344679
01;2021-S04;1;0;2;19979;20155;09;40134
01;2021-S04;3;6;9;24994;25489;19;50483
01;2021-S04;7;9;16;17868;16690;29;34558
01;2021-S04;12;11;23;22328;14821;39;37149
01;2021-S04;8;5;13;28652;20276;49;48928
01;2021-S04;12;13;26;33264;27260;59;60524
01;2021-S04;7;7;15;27135;23978;69;51113
01;2021-S04;4;5;9;18401;14661;79;33062
01;2021-S04;2;0;2;9633;6375;89;16008
01;2021-S04;0;0;0;3410;1510;90;4920
01;2021-S04;56;58;117;205664;171215;0;376879
02;2021-S04;2;0;2;16881;17110;09;33991
02;2021-S04;5;5;11;21410;21604;19;43014
02;2021-S04;3;3;6;16017;15479;29;31496
02;2021-S04;9;5;14;19825;14455;39;34280
02;2021-S04;10;4;14;24719;18248;49;42967
02;2021-S04;6;9;15;34361;28310;59;62671
02;2021-S04;7;6;13;28061;24495;69;52556
02;2021-S04;1;3;4;18231;15278;79;33509
02;2021-S04;0;0;0;11090;7677;89;18767
02;2021-S04;0;0;0;3992;1506;90;5498
02;2021-S04;43;35;79;194587;164162;0;358749
03;2021-S04;6;3;9;31123;30920;09;62043
03;2021-S04;50;39;90;29370;29268;19;58638
03;2021-S04;43;33;79;21458;18963;29;40421
03;2021-S04;43;25;68;21276;18326;39;39602
03;2021-S04;38;40;79;18164;16593;49;34757
03;2021-S04;26;21;47;13469;13557;59;27026
03;2021-S04;34;27;61;8776;8670;69;17446
03;2021-S04;6;6;12;3777;3591;79;7368
03;2021-S04;5;1;6;1649;1072;89;2721
03;2021-S04;0;0;0;485;184;90;669
03;2021-S04;251;195;451;149547;141144;0;290691
04;2021-S04;11;9;21;60314;61377;09;121691
04;2021-S04;35;27;62;66065;68387;19;134452
04;2021-S04;47;33;80;51059;47156;29;98215
04;2021-S04;36;25;61;58788;45780;39;104568
04;2021-S04;33;21;54;61408;52207;49;113615
04;2021-S04;25;26;51;64838;60759;59;125597
04;2021-S04;23;7;30;47008;42843;69;89851
04;2021-S04;6;2;8;25509;21184;79;46693
04;2021-S04;1;1;2;13168;7647;89;20815
04;2021-S04;2;0;2;3209;1253;90;4462
04;2021-S04;219;151;371;451366;408593;0;859959
05;2021-S04;0;0;0;362.366008612902;341.338819562748;09;703.704828175651
05;2021-S04;0;0;0;353.376145114279;370.349735405642;19;723.725880519921
05;2021-S04;0;0;0;218.593559489256;256.539602589476;29;475.133162078732
05;2021-S04;1;0;1;404.225408693299;360.321910454353;39;764.547319147651
05;2021-S04;0;0;0;520.067953604221;497.108383964256;49;1017.17633756848
05;2021-S04;0;0;0;468.146063921917;510.087601910415;59;978.233665832332
05;2021-S04;0;0;0;340.368470050554;334.366842191253;69;674.735312241807
05;2021-S04;0;0;0;212.598666888387;192.597753227106;79;405.196420115493
05;2021-S04;0;0;0;148.727797095705;61.8681715431829;89;210.595968638888
05;2021-S04;0;0;0;32.9601271090696;10.9909785719784;90;43.9511056810479
05;2021-S04;1;0;1;3061.43020057959;2935.56979942041;0;5997
06;2021-S04;6;13;19;42583;42380;09;84963
06;2021-S04;140;79;221;33369;31925;19;65294
06;2021-S04;170;112;282;21571;15080;29;36651
06;2021-S04;163;105;268;21550;16147;39;37697
06;2021-S04;109;111;220;14193;13939;49;28132
06;2021-S04;69;73;142;7171;7597;59;14768
06;2021-S04;71;77;152;3629;4117;69;7746
06;2021-S04;9;14;23;1577;1457;79;3034
06;2021-S04;3;2;5;531;474;89;1005
06;2021-S04;2;0;2;88;93;90;181
06;2021-S04;742;586;1335;146262;133209;0;279471
07;2021-S04;0;0;0;485;549;09;1034
07;2021-S04;1;3;4;403;432;19;835
07;2021-S04;6;9;15;764;841;29;1605
07;2021-S04;6;9;15;824;928;39;1752
07;2021-S04;0;4;4;788;1020;49;1808
07;2021-S04;1;6;7;678;870;59;1548
07;2021-S04;0;2;2;360;382;69;742
07;2021-S04;1;0;1;231;190;79;421
07;2021-S04;0;0;0;114;67;89;181
07;2021-S04;0;0;0;24;11;90;35
07;2021-S04;15;33;48;4671;5290;0;9961
08;2021-S04;2;0;2;2715.22592983026;2997.75551488675;09;5712.98144471701
08;2021-S04;9;2;11;2778.51901080978;3160.9156459093;19;5939.43465671908
08;2021-S04;2;8;10;2080.8882988764;1718.16634315323;29;3799.05464202964
08;2021-S04;7;14;21;2701.8582062647;1896.52641413317;39;4598.38462039786
08;2021-S04;16;8;24;3151.45861023308;2460.52498233809;49;5611.98359257117
08;2021-S04;14;16;30;2620.29868333099;2422.23566154656;59;5042.53434487755
08;2021-S04;4;5;9;1621.44173420671;1438.58325779464;69;3060.02499200135
08;2021-S04;3;2;5;626.575909335673;526.358467843651;79;1152.93437717932
08;2021-S04;0;1;1;205.018522985054;140.993639349697;89;346.012162334751
08;2021-S04;0;0;0;50.0325684687745;20.62259870351;90;70.6551671722846
08;2021-S04;57;56;113;18551.3174743414;16782.6825256586;0;35334
11;2021-S04;616;649;1350;783071;811785;09;1594856
11;2021-S04;1809;1888;3833;761456;784653;19;1546109
11;2021-S04;2569;2066;4652;850145;801772;29;1651917
11;2021-S04;2673;2247;4938;914360;843488;39;1757848
11;2021-S04;2388;2063;4462;845609;826202;49;1671811
11;2021-S04;1946;1762;3718;793566;745070;59;1538636
11;2021-S04;1249;1198;2479;628649;549192;69;1177841
11;2021-S04;649;702;1356;434606;358356;79;792962
11;2021-S04;590;381;974;261425;162933;89;424358
11;2021-S04;333;140;473;89253;32619;90;121872
11;2021-S04;14829;13102;28251;6362140;5916070;0;12278210
24;2021-S04;69;84;159;139720;144686;09;284406
24;2021-S04;336;369;712;152979;161185;19;314164
24;2021-S04;372;255;627;122237;126536;29;248773
24;2021-S04;398;275;673;150359;142009;39;292368
24;2021-S04;461;322;784;161829;158758;49;320587
24;2021-S04;355;325;680;172552;168011;59;340563
24;2021-S04;244;216;460;172509;158177;69;330686
24;2021-S04;188;190;378;129428;110593;79;240021
24;2021-S04;254;145;399;87342;56882;89;144224
24;2021-S04;219;61;280;31210;12071;90;43281
24;2021-S04;2896;2244;5155;1320165;1238908;0;2559073
27;2021-S04;126;118;244;143373;149679;09;293052
27;2021-S04;400;405;806;160962;173003;19;333965
27;2021-S04;424;332;756;133746;142254;29;276000
27;2021-S04;449;340;789;160004;155407;39;315411
27;2021-S04;467;351;818;172333;169564;49;341897
27;2021-S04;479;396;875;189979;183788;59;373767
27;2021-S04;342;342;684;192591;178206;69;370797
27;2021-S04;269;254;523;146876;127546;79;274422
27;2021-S04;273;187;460;96896;61575;89;158471
27;2021-S04;228;67;295;33148;12109;90;45257
27;2021-S04;3458;2792;6251;1429908;1353131;0;2783039
28;2021-S04;118;123;250;180735;186856;09;367591
28;2021-S04;325;318;649;200125;213621;19;413746
28;2021-S04;400;296;696;168922;173007;29;341929
28;2021-S04;469;334;803;196628;188487;39;385115
28;2021-S04;438;364;803;205396;201699;49;407095
28;2021-S04;416;313;729;222002;213866;59;435868
28;2021-S04;335;313;648;224688;203758;69;428446
28;2021-S04;225;217;442;163192;135543;79;298735
28;2021-S04;301;170;472;109691;65377;89;175068
28;2021-S04;218;52;270;37222;12685;90;49907
28;2021-S04;3245;2502;5764;1708601;1594899;0;3303500
32;2021-S04;283;327;610;358062;373689;09;731751
32;2021-S04;865;958;1826;387045;406742;19;793787
32;2021-S04;955;813;1768;342304;348587;29;690891
32;2021-S04;1047;840;1887;382485;369972;39;752457
32;2021-S04;1005;872;1877;382510;376716;49;759226
32;2021-S04;883;812;1695;386937;376527;59;763464
32;2021-S04;601;563;1164;371211;330938;69;702149
32;2021-S04;472;442;914;250542;201459;79;452001
32;2021-S04;438;281;719;163399;89786;89;253185
32;2021-S04;285;75;360;48384;15367;90;63751
32;2021-S04;6837;5988;12831;3072879;2889783;0;5962662
44;2021-S04;269;307;582;291525;306839;09;598364
44;2021-S04;883;818;1713;320255;339504;19;659759
44;2021-S04;882;791;1676;302020;314428;29;616448
44;2021-S04;991;832;1823;342222;333292;39;675514
44;2021-S04;954;779;1737;349727;344491;49;694218
44;2021-S04;883;764;1659;381371;373239;59;754610
44;2021-S04;612;624;1238;367165;335850;69;703015
44;2021-S04;388;351;743;250387;215436;79;465823
44;2021-S04;496;284;793;170825;105192;89;276017
44;2021-S04;280;98;380;51248;16731;90;67979
44;2021-S04;6638;5648;12344;2826745;2685002;0;5511747
52;2021-S04;113;117;241;213594;223900;09;437494
52;2021-S04;386;432;826;240818;255197;19;496015
52;2021-S04;442;420;864;197010;200630;29;397640
52;2021-S04;452;344;799;231204;224885;39;456089
52;2021-S04;552;422;975;243874;243418;49;487292
52;2021-S04;411;383;795;244100;239116;59;483216
52;2021-S04;297;275;576;241796;221345;69;463141
52;2021-S04;241;213;458;177805;149903;79;327708
52;2021-S04;328;194;522;119561;75822;89;195383
52;2021-S04;300;78;378;42559;15260;90;57819
52;2021-S04;3522;2878;6434;1952321;1849476;0;3801797
53;2021-S04;73;87;164;173813;182358;09;356171
53;2021-S04;220;237;465;202720;214740;19;417460
53;2021-S04;278;249;551;163116;173196;29;336312
53;2021-S04;273;205;478;190526;187674;39;378200
53;2021-S04;280;190;470;212098;212015;49;424113
53;2021-S04;269;212;481;223699;219176;59;442875
53;2021-S04;144;153;297;227435;209274;69;436709
53;2021-S04;138;115;253;169992;140910;79;310902
53;2021-S04;169;111;280;118117;69883;89;188000
53;2021-S04;102;41;147;37370;12267;90;49637
53;2021-S04;1946;1600;3586;1718886;1621493;0;3340379
75;2021-S04;241;232;481;293104;305291;09;598395
75;2021-S04;605;608;1221;337141;357785;19;694926
75;2021-S04;760;603;1364;295024;300618;29;595642
75;2021-S04;872;593;1465;347871;331233;39;679104
75;2021-S04;825;706;1532;384742;372771;49;757513
75;2021-S04;795;634;1429;413361;390880;59;804241
75;2021-S04;522;507;1029;425623;384060;69;809683
75;2021-S04;390;403;793;325086;276298;79;601384
75;2021-S04;491;301;794;213986;139308;89;353294
75;2021-S04;478;133;611;77600;28200;90;105800
75;2021-S04;5979;4721;10720;3113538;2886444;0;5999982
76;2021-S04;259;284;553;305956;318589;09;624545
76;2021-S04;836;942;1804;338942;356969;19;695911
76;2021-S04;971;736;1707;316210;319570;29;635780
76;2021-S04;1024;736;1762;356758;337587;39;694345
76;2021-S04;1086;827;1913;376541;363812;49;740353
76;2021-S04;988;870;1858;402608;383750;59;786358
76;2021-S04;660;582;1242;394889;358997;69;753886
76;2021-S04;495;482;978;308664;263806;79;572470
76;2021-S04;539;318;857;195838;129272;89;325110
76;2021-S04;453;134;587;69372;26728;90;96100
76;2021-S04;7316;5914;13269;3065778;2859080;0;5924858
84;2021-S04;403;426;840;459549;481088;09;940637
84;2021-S04;1210;1281;2504;487711;511905;19;999616
84;2021-S04;1276;1117;2395;443824;451094;29;894918
84;2021-S04;1461;1152;2614;512522;493262;39;1005784
84;2021-S04;1406;1205;2613;520248;515106;49;1035354
84;2021-S04;1185;1121;2309;529611;514848;59;1044459
84;2021-S04;878;803;1681;486720;439940;69;926660
84;2021-S04;632;593;1226;372151;315211;79;687362
84;2021-S04;607;395;1002;237198;150524;89;387722
84;2021-S04;436;135;571;81185;28680;90;109865
84;2021-S04;9494;8228;17755;4130719;3901658;0;8032377
93;2021-S04;310;330;642;268834;283093;09;551927
93;2021-S04;1096;1097;2200;280751;296087;19;576838
93;2021-S04;1384;1028;2414;254404;255552;29;509956
93;2021-S04;1578;1160;2741;310704;288398;39;599102
93;2021-S04;1526;1258;2786;325559;305827;49;631386
93;2021-S04;1415;1338;2756;353104;325389;59;678493
93;2021-S04;979;992;1974;336327;296459;69;632786
93;2021-S04;749;680;1431;279820;229699;79;509519
93;2021-S04;736;465;1201;171274;113716;89;284990
93;2021-S04;591;163;754;58896;21758;90;80654
93;2021-S04;10367;8511;18902;2639673;2415978;0;5055651
94;2021-S04;6;8;15;16311;17433;09;33744
94;2021-S04;8;11;20;16679;18132;19;34811
94;2021-S04;19;18;37;16782;16579;29;33361
94;2021-S04;25;33;58;23044;20580;39;43624
94;2021-S04;22;29;51;23065;22140;49;45205
94;2021-S04;35;24;59;24549;23421;59;47970
94;2021-S04;24;26;50;23212;21883;69;45095
94;2021-S04;21;19;40;19544;17141;79;36685
94;2021-S04;15;11;26;11227;8178;89;19405
94;2021-S04;20;8;28;3332;1447;90;4779
94;2021-S04;195;188;385;177745;166934;0;344679
01;2021-S05;1;1;2;19979;20155;09;40134
01;2021-S05;6;4;10;24994;25489;19;50483
01;2021-S05;10;11;21;17868;16690;29;34558
01;2021-S05;18;4;22;22328;14821;39;37149
01;2021-S05;19;7;26;28652;20276;49;48928
01;2021-S05;8;10;18;33264;27260;59;60524
01;2021-S05;15;9;24;27135;23978;69;51113
01;2021-S05;3;8;11;18401;14661;79;33062
01;2021-S05;3;1;4;9633;6375;89;16008
01;2021-S05;0;0;0;3410;1510;90;4920
01;2021-S05;84;55;139;205664;171215;0;376879
02;2021-S05;0;0;0;16881;17110;09;33991
02;2021-S05;1;5;6;21410;21604;19;43014
02;2021-S05;5;10;15;16017;15479;29;31496
02;2021-S05;7;3;10;19825;14455;39;34280
02;2021-S05;3;6;9;24719;18248;49;42967
02;2021-S05;10;5;15;34361;28310;59;62671
02;2021-S05;9;3;12;28061;24495;69;52556
02;2021-S05;1;1;2;18231;15278;79;33509
02;2021-S05;1;0;1;11090;7677;89;18767
02;2021-S05;0;0;0;3992;1506;90;5498
02;2021-S05;37;33;70;194587;164162;0;358749
03;2021-S05;2;2;4;31123;30920;09;62043
03;2021-S05;20;14;34;29370;29268;19;58638
03;2021-S05;24;19;43;21458;18963;29;40421
03;2021-S05;19;16;35;21276;18326;39;39602
03;2021-S05;12;14;26;18164;16593;49;34757
03;2021-S05;11;12;23;13469;13557;59;27026
03;2021-S05;18;18;36;8776;8670;69;17446
03;2021-S05;1;2;3;3777;3591;79;7368
03;2021-S05;1;0;1;1649;1072;89;2721
03;2021-S05;0;0;0;485;184;90;669
03;2021-S05;108;97;205;149547;141144;0;290691
04;2021-S05;10;15;25;60314;61377;09;121691
04;2021-S05;61;45;106;66065;68387;19;134452
04;2021-S05;42;40;82;51059;47156;29;98215
04;2021-S05;53;39;92;58788;45780;39;104568
04;2021-S05;58;37;95;61408;52207;49;113615
04;2021-S05;60;33;93;64838;60759;59;125597
04;2021-S05;30;21;51;47008;42843;69;89851
04;2021-S05;4;7;11;25509;21184;79;46693
04;2021-S05;3;2;5;13168;7647;89;20815
04;2021-S05;2;0;2;3209;1253;90;4462
04;2021-S05;323;239;562;451366;408593;0;859959
05;2021-S05;0;0;0;362.366008612902;341.338819562748;09;703.704828175651
05;2021-S05;0;0;0;353.376145114279;370.349735405642;19;723.725880519921
05;2021-S05;0;1;1;218.593559489256;256.539602589476;29;475.133162078732
05;2021-S05;0;0;0;404.225408693299;360.321910454353;39;764.547319147651
05;2021-S05;0;0;0;520.067953604221;497.108383964256;49;1017.17633756848
05;2021-S05;0;0;0;468.146063921917;510.087601910415;59;978.233665832332
05;2021-S05;0;0;0;340.368470050554;334.366842191253;69;674.735312241807
05;2021-S05;0;0;0;212.598666888387;192.597753227106;79;405.196420115493
05;2021-S05;0;0;0;148.727797095705;61.8681715431829;89;210.595968638888
05;2021-S05;0;0;0;32.9601271090696;10.9909785719784;90;43.9511056810479
05;2021-S05;0;1;1;3061.43020057959;2935.56979942041;0;5997
06;2021-S05;19;10;31;42583;42380;09;84963
06;2021-S05;234;174;419;33369;31925;19;65294
06;2021-S05;280;208;488;21571;15080;29;36651
06;2021-S05;321;226;547;21550;16147;39;37697
06;2021-S05;253;198;451;14193;13939;49;28132
06;2021-S05;121;148;269;7171;7597;59;14768
06;2021-S05;92;107;204;3629;4117;69;7746
06;2021-S05;12;20;32;1577;1457;79;3034
06;2021-S05;9;5;14;531;474;89;1005
06;2021-S05;0;0;0;88;93;90;181
06;2021-S05;1342;1096;2456;146262;133209;0;279471
07;2021-S05;0;0;0;485;549;09;1034
07;2021-S05;1;0;1;403;432;19;835
07;2021-S05;5;4;9;764;841;29;1605
07;2021-S05;9;7;16;824;928;39;1752
07;2021-S05;4;7;11;788;1020;49;1808
07;2021-S05;9;5;14;678;870;59;1548
07;2021-S05;2;3;5;360;382;69;742
07;2021-S05;0;1;1;231;190;79;421
07;2021-S05;0;0;0;114;67;89;181
07;2021-S05;0;0;0;24;11;90;35
07;2021-S05;30;27;57;4671;5290;0;9961
08;2021-S05;2;0;2;2715.22592983026;2997.75551488675;09;5712.98144471701
08;2021-S05;6;3;9;2778.51901080978;3160.9156459093;19;5939.43465671908
08;2021-S05;10;5;15;2080.8882988764;1718.16634315323;29;3799.05464202964
08;2021-S05;10;4;14;2701.8582062647;1896.52641413317;39;4598.38462039786
08;2021-S05;9;7;16;3151.45861023308;2460.52498233809;49;5611.98359257117
08;2021-S05;8;4;12;2620.29868333099;2422.23566154656;59;5042.53434487755
08;2021-S05;4;3;7;1621.44173420671;1438.58325779464;69;3060.02499200135
08;2021-S05;0;0;0;626.575909335673;526.358467843651;79;1152.93437717932
08;2021-S05;0;0;0;205.018522985054;140.993639349697;89;346.012162334751
08;2021-S05;0;0;0;50.0325684687745;20.62259870351;90;70.6551671722846
08;2021-S05;49;26;75;18551.3174743414;16782.6825256586;0;35334
11;2021-S05;697;718;1491;783071;811785;09;1594856
11;2021-S05;2101;2186;4424;761456;784653;19;1546109
11;2021-S05;2644;2235;4889;850145;801772;29;1651917
11;2021-S05;2623;2312;4949;914360;843488;39;1757848
11;2021-S05;2464;2145;4619;845609;826202;49;1671811
11;2021-S05;1987;1869;3865;793566;745070;59;1538636
11;2021-S05;1320;1301;2661;628649;549192;69;1177841
11;2021-S05;655;675;1334;434606;358356;79;792962
11;2021-S05;582;388;972;261425;162933;89;424358
11;2021-S05;354;123;478;89253;32619;90;121872
11;2021-S05;15435;13966;29704;6362140;5916070;0;12278210
24;2021-S05;87;77;171;139720;144686;09;284406
24;2021-S05;327;321;659;152979;161185;19;314164
24;2021-S05;321;265;587;122237;126536;29;248773
24;2021-S05;379;240;619;150359;142009;39;292368
24;2021-S05;401;326;727;161829;158758;49;320587
24;2021-S05;352;283;635;172552;168011;59;340563
24;2021-S05;203;208;411;172509;158177;69;330686
24;2021-S05;187;168;355;129428;110593;79;240021
24;2021-S05;207;122;330;87342;56882;89;144224
24;2021-S05;165;47;212;31210;12071;90;43281
24;2021-S05;2631;2058;4711;1320165;1238908;0;2559073
27;2021-S05;89;99;188;143373;149679;09;293052
27;2021-S05;311;310;622;160962;173003;19;333965
27;2021-S05;355;305;660;133746;142254;29;276000
27;2021-S05;373;288;662;160004;155407;39;315411
27;2021-S05;424;342;766;172333;169564;49;341897
27;2021-S05;410;382;792;189979;183788;59;373767
27;2021-S05;287;285;572;192591;178206;69;370797
27;2021-S05;230;232;463;146876;127546;79;274422
27;2021-S05;218;164;382;96896;61575;89;158471
27;2021-S05;192;71;263;33148;12109;90;45257
27;2021-S05;2889;2478;5370;1429908;1353131;0;2783039
28;2021-S05;137;128;265;180735;186856;09;367591
28;2021-S05;313;330;650;200125;213621;19;413746
28;2021-S05;358;291;650;168922;173007;29;341929
28;2021-S05;459;320;779;196628;188487;39;385115
28;2021-S05;435;340;775;205396;201699;49;407095
28;2021-S05;414;297;711;222002;213866;59;435868
28;2021-S05;273;303;576;224688;203758;69;428446
28;2021-S05;236;214;450;163192;135543;79;298735
28;2021-S05;226;136;362;109691;65377;89;175068
28;2021-S05;161;43;204;37222;12685;90;49907
28;2021-S05;3012;2402;5422;1708601;1594899;0;3303500
32;2021-S05;278;324;605;358062;373689;09;731751
32;2021-S05;918;898;1817;387045;406742;19;793787
32;2021-S05;1018;803;1822;342304;348587;29;690891
32;2021-S05;1076;894;1970;382485;369972;39;752457
32;2021-S05;1085;952;2037;382510;376716;49;759226
32;2021-S05;884;909;1793;386937;376527;59;763464
32;2021-S05;718;655;1373;371211;330938;69;702149
32;2021-S05;503;422;925;250542;201459;79;452001
32;2021-S05;476;243;721;163399;89786;89;253185
32;2021-S05;314;66;380;48384;15367;90;63751
32;2021-S05;7274;6169;13452;3072879;2889783;0;5962662
44;2021-S05;300;310;614;291525;306839;09;598364
44;2021-S05;804;833;1641;320255;339504;19;659759
44;2021-S05;821;728;1554;302020;314428;29;616448
44;2021-S05;955;748;1707;342222;333292;39;675514
44;2021-S05;834;696;1534;349727;344491;49;694218
44;2021-S05;797;770;1571;381371;373239;59;754610
44;2021-S05;516;499;1021;367165;335850;69;703015
44;2021-S05;362;349;713;250387;215436;79;465823
44;2021-S05;372;252;626;170825;105192;89;276017
44;2021-S05;239;71;313;51248;16731;90;67979
44;2021-S05;6000;5257;11299;2826745;2685002;0;5511747
52;2021-S05;128;111;244;213594;223900;09;437494
52;2021-S05;367;359;737;240818;255197;19;496015
52;2021-S05;417;409;827;197010;200630;29;397640
52;2021-S05;409;310;720;231204;224885;39;456089
52;2021-S05;420;351;772;243874;243418;49;487292
52;2021-S05;368;346;714;244100;239116;59;483216
52;2021-S05;249;221;473;241796;221345;69;463141
52;2021-S05;168;190;359;177805;149903;79;327708
52;2021-S05;225;144;370;119561;75822;89;195383
52;2021-S05;184;47;231;42559;15260;90;57819
52;2021-S05;2935;2488;5447;1952321;1849476;0;3801797
53;2021-S05;103;97;201;173813;182358;09;356171
53;2021-S05;261;224;490;202720;214740;19;417460
53;2021-S05;290;259;567;163116;173196;29;336312
53;2021-S05;240;208;448;190526;187674;39;378200
53;2021-S05;274;237;512;212098;212015;49;424113
53;2021-S05;241;233;474;223699;219176;59;442875
53;2021-S05;168;141;309;227435;209274;69;436709
53;2021-S05;137;118;255;169992;140910;79;310902
53;2021-S05;188;104;292;118117;69883;89;188000
53;2021-S05;105;46;151;37370;12267;90;49637
53;2021-S05;2008;1667;3700;1718886;1621493;0;3340379
75;2021-S05;194;220;418;293104;305291;09;598395
75;2021-S05;506;544;1052;337141;357785;19;694926
75;2021-S05;686;520;1207;295024;300618;29;595642
75;2021-S05;670;560;1232;347871;331233;39;679104
75;2021-S05;724;587;1311;384742;372771;49;757513
75;2021-S05;680;618;1298;413361;390880;59;804241
75;2021-S05;493;494;987;425623;384060;69;809683
75;2021-S05;359;310;669;325086;276298;79;601384
75;2021-S05;427;244;671;213986;139308;89;353294
75;2021-S05;383;120;503;77600;28200;90;105800
75;2021-S05;5125;4220;9354;3113538;2886444;0;5999982
76;2021-S05;217;237;463;305956;318589;09;624545
76;2021-S05;713;811;1541;338942;356969;19;695911
76;2021-S05;918;706;1626;316210;319570;29;635780
76;2021-S05;939;707;1646;356758;337587;39;694345
76;2021-S05;987;808;1795;376541;363812;49;740353
76;2021-S05;885;747;1632;402608;383750;59;786358
76;2021-S05;630;614;1245;394889;358997;69;753886
76;2021-S05;428;382;810;308664;263806;79;572470
76;2021-S05;445;290;735;195838;129272;89;325110
76;2021-S05;343;124;467;69372;26728;90;96100
76;2021-S05;6507;5428;11964;3065778;2859080;0;5924858
84;2021-S05;331;361;693;459549;481088;09;940637
84;2021-S05;1186;1175;2369;487711;511905;19;999616
84;2021-S05;1254;1057;2311;443824;451094;29;894918
84;2021-S05;1335;1123;2458;512522;493262;39;1005784
84;2021-S05;1406;1193;2600;520248;515106;49;1035354
84;2021-S05;1167;1111;2279;529611;514848;59;1044459
84;2021-S05;808;814;1623;486720;439940;69;926660
84;2021-S05;598;579;1177;372151;315211;79;687362
84;2021-S05;603;376;979;237198;150524;89;387722
84;2021-S05;420;136;556;81185;28680;90;109865
84;2021-S05;9109;7927;17058;4130719;3901658;0;8032377
93;2021-S05;278;321;600;268834;283093;09;551927
93;2021-S05;1137;1127;2274;280751;296087;19;576838
93;2021-S05;1396;1097;2496;254404;255552;29;509956
93;2021-S05;1482;1136;2618;310704;288398;39;599102
93;2021-S05;1553;1266;2824;325559;305827;49;631386
93;2021-S05;1461;1290;2754;353104;325389;59;678493
93;2021-S05;1000;980;1982;336327;296459;69;632786
93;2021-S05;728;632;1360;279820;229699;79;509519
93;2021-S05;681;438;1120;171274;113716;89;284990
93;2021-S05;483;151;634;58896;21758;90;80654
93;2021-S05;10200;8440;18665;2639673;2415978;0;5055651
94;2021-S05;8;4;13;16311;17433;09;33744
94;2021-S05;9;17;27;16679;18132;19;34811
94;2021-S05;24;28;52;16782;16579;29;33361
94;2021-S05;23;26;49;23044;20580;39;43624
94;2021-S05;38;23;61;23065;22140;49;45205
94;2021-S05;28;38;66;24549;23421;59;47970
94;2021-S05;32;26;58;23212;21883;69;45095
94;2021-S05;16;13;29;19544;17141;79;36685
94;2021-S05;17;13;30;11227;8178;89;19405
94;2021-S05;7;3;10;3332;1447;90;4779
94;2021-S05;202;191;395;177745;166934;0;344679
01;2021-S06;0;0;0;19979;20155;09;40134
01;2021-S06;8;9;17;24994;25489;19;50483
01;2021-S06;15;15;30;17868;16690;29;34558
01;2021-S06;19;17;36;22328;14821;39;37149
01;2021-S06;22;14;36;28652;20276;49;48928
01;2021-S06;16;18;34;33264;27260;59;60524
01;2021-S06;13;10;23;27135;23978;69;51113
01;2021-S06;6;4;10;18401;14661;79;33062
01;2021-S06;1;3;4;9633;6375;89;16008
01;2021-S06;2;0;2;3410;1510;90;4920
01;2021-S06;102;90;192;205664;171215;0;376879
02;2021-S06;0;2;2;16881;17110;09;33991
02;2021-S06;2;8;10;21410;21604;19;43014
02;2021-S06;7;4;11;16017;15479;29;31496
02;2021-S06;8;5;13;19825;14455;39;34280
02;2021-S06;5;4;9;24719;18248;49;42967
02;2021-S06;6;5;11;34361;28310;59;62671
02;2021-S06;9;3;12;28061;24495;69;52556
02;2021-S06;1;1;2;18231;15278;79;33509
02;2021-S06;1;0;1;11090;7677;89;18767
02;2021-S06;0;1;1;3992;1506;90;5498
02;2021-S06;39;33;72;194587;164162;0;358749
03;2021-S06;0;0;0;31123;30920;09;62043
03;2021-S06;5;7;14;29370;29268;19;58638
03;2021-S06;7;10;17;21458;18963;29;40421
03;2021-S06;7;19;26;21276;18326;39;39602
03;2021-S06;12;9;21;18164;16593;49;34757
03;2021-S06;8;7;15;13469;13557;59;27026
03;2021-S06;8;10;18;8776;8670;69;17446
03;2021-S06;1;3;4;3777;3591;79;7368
03;2021-S06;0;1;1;1649;1072;89;2721
03;2021-S06;0;0;0;485;184;90;669
03;2021-S06;48;66;116;149547;141144;0;290691
04;2021-S06;18;13;31;60314;61377;09;121691
04;2021-S06;42;57;99;66065;68387;19;134452
04;2021-S06;54;54;108;51059;47156;29;98215
04;2021-S06;71;50;121;58788;45780;39;104568
04;2021-S06;53;54;107;61408;52207;49;113615
04;2021-S06;33;48;82;64838;60759;59;125597
04;2021-S06;24;27;51;47008;42843;69;89851
04;2021-S06;11;10;21;25509;21184;79;46693
04;2021-S06;5;3;8;13168;7647;89;20815
04;2021-S06;1;0;1;3209;1253;90;4462
04;2021-S06;312;316;629;451366;408593;0;859959
05;2021-S06;0;0;0;362.366008612902;341.338819562748;09;703.704828175651
05;2021-S06;0;0;0;353.376145114279;370.349735405642;19;723.725880519921
05;2021-S06;0;0;0;218.593559489256;256.539602589476;29;475.133162078732
05;2021-S06;0;0;0;404.225408693299;360.321910454353;39;764.547319147651
05;2021-S06;0;0;0;520.067953604221;497.108383964256;49;1017.17633756848
05;2021-S06;0;0;0;468.146063921917;510.087601910415;59;978.233665832332
05;2021-S06;0;0;0;340.368470050554;334.366842191253;69;674.735312241807
05;2021-S06;0;0;0;212.598666888387;192.597753227106;79;405.196420115493
05;2021-S06;0;0;0;148.727797095705;61.8681715431829;89;210.595968638888
05;2021-S06;0;0;0;32.9601271090696;10.9909785719784;90;43.9511056810479
05;2021-S06;0;0;0;3061.43020057959;2935.56979942041;0;5997
06;2021-S06;15;18;33;42583;42380;09;84963
06;2021-S06;137;109;246;33369;31925;19;65294
06;2021-S06;300;191;492;21571;15080;29;36651
06;2021-S06;291;264;555;21550;16147;39;37697
06;2021-S06;219;190;409;14193;13939;49;28132
06;2021-S06;134;176;310;7171;7597;59;14768
06;2021-S06;173;175;361;3629;4117;69;7746
06;2021-S06;26;44;70;1577;1457;79;3034
06;2021-S06;6;10;16;531;474;89;1005
06;2021-S06;4;4;8;88;93;90;181
06;2021-S06;1305;1181;2501;146262;133209;0;279471
07;2021-S06;0;0;0;485;549;09;1034
07;2021-S06;1;0;1;403;432;19;835
07;2021-S06;5;7;12;764;841;29;1605
07;2021-S06;6;5;11;824;928;39;1752
07;2021-S06;3;1;4;788;1020;49;1808
07;2021-S06;5;8;13;678;870;59;1548
07;2021-S06;2;3;5;360;382;69;742
07;2021-S06;1;0;1;231;190;79;421
07;2021-S06;0;0;0;114;67;89;181
07;2021-S06;0;0;0;24;11;90;35
07;2021-S06;23;24;47;4671;5290;0;9961
08;2021-S06;0;0;0;2715.22592983026;2997.75551488675;09;5712.98144471701
08;2021-S06;2;3;5;2778.51901080978;3160.9156459093;19;5939.43465671908
08;2021-S06;7;3;10;2080.8882988764;1718.16634315323;29;3799.05464202964
08;2021-S06;9;3;12;2701.8582062647;1896.52641413317;39;4598.38462039786
08;2021-S06;12;2;14;3151.45861023308;2460.52498233809;49;5611.98359257117
08;2021-S06;11;7;18;2620.29868333099;2422.23566154656;59;5042.53434487755
08;2021-S06;8;6;14;1621.44173420671;1438.58325779464;69;3060.02499200135
08;2021-S06;2;2;4;626.575909335673;526.358467843651;79;1152.93437717932
08;2021-S06;0;1;1;205.018522985054;140.993639349697;89;346.012162334751
08;2021-S06;0;0;0;50.0325684687745;20.62259870351;90;70.6551671722846
08;2021-S06;51;27;78;18551.3174743414;16782.6825256586;0;35334
11;2021-S06;705;736;1594;783071;811785;09;1594856
11;2021-S06;2166;2195;4493;761456;784653;19;1546109
11;2021-S06;2613;2089;4714;850145;801772;29;1651917
11;2021-S06;2774;2297;5077;914360;843488;39;1757848
11;2021-S06;2586;2264;4854;845609;826202;49;1671811
11;2021-S06;1933;1772;3713;793566;745070;59;1538636
11;2021-S06;1286;1279;2604;628649;549192;69;1177841
11;2021-S06;618;614;1232;434606;358356;79;792962
11;2021-S06;506;362;868;261425;162933;89;424358
11;2021-S06;298;133;433;89253;32619;90;121872
11;2021-S06;15486;13744;29591;6362140;5916070;0;12278210
24;2021-S06;79;83;167;139720;144686;09;284406
24;2021-S06;274;262;538;152979;161185;19;314164
24;2021-S06;298;245;543;122237;126536;29;248773
24;2021-S06;342;225;567;150359;142009;39;292368
24;2021-S06;331;258;589;161829;158758;49;320587
24;2021-S06;256;239;495;172552;168011;59;340563
24;2021-S06;186;180;366;172509;158177;69;330686
24;2021-S06;126;120;246;129428;110593;79;240021
24;2021-S06;133;96;229;87342;56882;89;144224
24;2021-S06;95;38;133;31210;12071;90;43281
24;2021-S06;2120;1746;3874;1320165;1238908;0;2559073
27;2021-S06;69;97;166;143373;149679;09;293052
27;2021-S06;230;260;494;160962;173003;19;333965
27;2021-S06;326;257;583;133746;142254;29;276000
27;2021-S06;344;249;593;160004;155407;39;315411
27;2021-S06;340;303;643;172333;169564;49;341897
27;2021-S06;339;301;640;189979;183788;59;373767
27;2021-S06;260;275;535;192591;178206;69;370797
27;2021-S06;181;185;366;146876;127546;79;274422
27;2021-S06;206;148;354;96896;61575;89;158471
27;2021-S06;171;42;213;33148;12109;90;45257
27;2021-S06;2466;2117;4587;1429908;1353131;0;2783039
28;2021-S06;120;133;258;180735;186856;09;367591
28;2021-S06;308;323;640;200125;213621;19;413746
28;2021-S06;314;239;554;168922;173007;29;341929
28;2021-S06;336;286;622;196628;188487;39;385115
28;2021-S06;349;291;640;205396;201699;49;407095
28;2021-S06;301;284;585;222002;213866;59;435868
28;2021-S06;265;229;494;224688;203758;69;428446
28;2021-S06;154;137;291;163192;135543;79;298735
28;2021-S06;159;92;251;109691;65377;89;175068
28;2021-S06;88;33;121;37222;12685;90;49907
28;2021-S06;2394;2047;4456;1708601;1594899;0;3303500
32;2021-S06;391;417;809;358062;373689;09;731751
32;2021-S06;991;1073;2066;387045;406742;19;793787
32;2021-S06;1108;872;1982;342304;348587;29;690891
32;2021-S06;1262;938;2202;382485;369972;39;752457
32;2021-S06;1129;991;2120;382510;376716;49;759226
32;2021-S06;959;971;1932;386937;376527;59;763464
32;2021-S06;709;632;1341;371211;330938;69;702149
32;2021-S06;489;419;908;250542;201459;79;452001
32;2021-S06;448;259;707;163399;89786;89;253185
32;2021-S06;304;72;377;48384;15367;90;63751
32;2021-S06;7796;6645;14451;3072879;2889783;0;5962662
44;2021-S06;317;264;584;291525;306839;09;598364
44;2021-S06;697;715;1420;320255;339504;19;659759
44;2021-S06;763;669;1436;302020;314428;29;616448
44;2021-S06;815;714;1535;342222;333292;39;675514
44;2021-S06;722;619;1345;349727;344491;49;694218
44;2021-S06;653;610;1274;381371;373239;59;754610
44;2021-S06;489;422;915;367165;335850;69;703015
44;2021-S06;275;263;538;250387;215436;79;465823
44;2021-S06;298;183;485;170825;105192;89;276017
44;2021-S06;184;62;246;51248;16731;90;67979
44;2021-S06;5214;4521;9779;2826745;2685002;0;5511747
52;2021-S06;98;107;209;213594;223900;09;437494
52;2021-S06;298;346;646;240818;255197;19;496015
52;2021-S06;372;355;727;197010;200630;29;397640
52;2021-S06;337;255;593;231204;224885;39;456089
52;2021-S06;345;325;670;243874;243418;49;487292
52;2021-S06;319;303;622;244100;239116;59;483216
52;2021-S06;194;218;412;241796;221345;69;463141
52;2021-S06;160;130;290;177805;149903;79;327708
52;2021-S06;172;92;264;119561;75822;89;195383
52;2021-S06;121;41;162;42559;15260;90;57819
52;2021-S06;2416;2172;4596;1952321;1849476;0;3801797
53;2021-S06;94;119;213;173813;182358;09;356171
53;2021-S06;186;209;398;202720;214740;19;417460
53;2021-S06;273;278;553;163116;173196;29;336312
53;2021-S06;212;175;387;190526;187674;39;378200
53;2021-S06;227;185;412;212098;212015;49;424113
53;2021-S06;194;189;383;223699;219176;59;442875
53;2021-S06;115;123;238;227435;209274;69;436709
53;2021-S06;63;69;132;169992;140910;79;310902
53;2021-S06;104;63;167;118117;69883;89;188000
53;2021-S06;63;23;87;37370;12267;90;49637
53;2021-S06;1531;1433;2970;1718886;1621493;0;3340379
75;2021-S06;136;127;266;293104;305291;09;598395
75;2021-S06;384;368;752;337141;357785;19;694926
75;2021-S06;515;473;990;295024;300618;29;595642
75;2021-S06;522;391;914;347871;331233;39;679104
75;2021-S06;574;464;1038;384742;372771;49;757513
75;2021-S06;498;452;950;413361;390880;59;804241
75;2021-S06;320;337;657;425623;384060;69;809683
75;2021-S06;253;216;469;325086;276298;79;601384
75;2021-S06;304;181;485;213986;139308;89;353294
75;2021-S06;222;83;305;77600;28200;90;105800
75;2021-S06;3729;3092;6827;3113538;2886444;0;5999982
76;2021-S06;183;201;404;305956;318589;09;624545
76;2021-S06;616;648;1289;338942;356969;19;695911
76;2021-S06;777;600;1377;316210;319570;29;635780
76;2021-S06;870;611;1481;356758;337587;39;694345
76;2021-S06;846;633;1479;376541;363812;49;740353
76;2021-S06;819;702;1521;402608;383750;59;786358
76;2021-S06;503;542;1045;394889;358997;69;753886
76;2021-S06;320;324;644;308664;263806;79;572470
76;2021-S06;332;232;564;195838;129272;89;325110
76;2021-S06;230;95;325;69372;26728;90;96100
76;2021-S06;5499;4590;10134;3065778;2859080;0;5924858
84;2021-S06;303;290;597;459549;481088;09;940637
84;2021-S06;968;926;1906;487711;511905;19;999616
84;2021-S06;1126;1024;2153;443824;451094;29;894918
84;2021-S06;1265;1032;2298;512522;493262;39;1005784
84;2021-S06;1188;1033;2222;520248;515106;49;1035354
84;2021-S06;1051;988;2039;529611;514848;59;1044459
84;2021-S06;691;702;1394;486720;439940;69;926660
84;2021-S06;530;452;982;372151;315211;79;687362
84;2021-S06;461;308;769;237198;150524;89;387722
84;2021-S06;321;100;422;81185;28680;90;109865
84;2021-S06;7905;6855;14785;4130719;3901658;0;8032377
93;2021-S06;301;345;649;268834;283093;09;551927
93;2021-S06;1231;1136;2374;280751;296087;19;576838
93;2021-S06;1430;1170;2606;254404;255552;29;509956
93;2021-S06;1608;1252;2862;310704;288398;39;599102
93;2021-S06;1528;1301;2832;325559;305827;49;631386
93;2021-S06;1382;1225;2609;353104;325389;59;678493
93;2021-S06;956;920;1877;336327;296459;69;632786
93;2021-S06;667;615;1282;279820;229699;79;509519
93;2021-S06;624;400;1025;171274;113716;89;284990
93;2021-S06;458;131;589;58896;21758;90;80654
93;2021-S06;10187;8496;18716;2639673;2415978;0;5055651
94;2021-S06;3;8;15;16311;17433;09;33744
94;2021-S06;13;11;25;16679;18132;19;34811
94;2021-S06;17;18;35;16782;16579;29;33361
94;2021-S06;30;26;56;23044;20580;39;43624
94;2021-S06;28;29;57;23065;22140;49;45205
94;2021-S06;26;20;46;24549;23421;59;47970
94;2021-S06;25;28;53;23212;21883;69;45095
94;2021-S06;13;14;27;19544;17141;79;36685
94;2021-S06;10;5;15;11227;8178;89;19405
94;2021-S06;2;1;3;3332;1447;90;4779
94;2021-S06;167;161;333;177745;166934;0;344679
01;2021-S07;0;1;1;19979;20155;09;40134
01;2021-S07;10;7;17;24994;25489;19;50483
01;2021-S07;24;12;36;17868;16690;29;34558
01;2021-S07;27;18;45;22328;14821;39;37149
01;2021-S07;18;11;29;28652;20276;49;48928
01;2021-S07;21;21;42;33264;27260;59;60524
01;2021-S07;12;21;33;27135;23978;69;51113
01;2021-S07;7;3;10;18401;14661;79;33062
01;2021-S07;1;2;3;9633;6375;89;16008
01;2021-S07;2;0;2;3410;1510;90;4920
01;2021-S07;122;96;218;205664;171215;0;376879
02;2021-S07;0;0;0;16881;17110;09;33991
02;2021-S07;4;1;5;21410;21604;19;43014
02;2021-S07;10;5;15;16017;15479;29;31496
02;2021-S07;4;4;9;19825;14455;39;34280
02;2021-S07;4;3;7;24719;18248;49;42967
02;2021-S07;6;2;8;34361;28310;59;62671
02;2021-S07;2;3;5;28061;24495;69;52556
02;2021-S07;3;2;5;18231;15278;79;33509
02;2021-S07;6;2;8;11090;7677;89;18767
02;2021-S07;0;0;0;3992;1506;90;5498
02;2021-S07;39;22;62;194587;164162;0;358749
03;2021-S07;1;1;2;31123;30920;09;62043
03;2021-S07;9;2;11;29370;29268;19;58638
03;2021-S07;6;8;14;21458;18963;29;40421
03;2021-S07;9;8;17;21276;18326;39;39602
03;2021-S07;7;11;18;18164;16593;49;34757
03;2021-S07;6;7;13;13469;13557;59;27026
03;2021-S07;4;2;6;8776;8670;69;17446
03;2021-S07;0;1;1;3777;3591;79;7368
03;2021-S07;1;0;2;1649;1072;89;2721
03;2021-S07;1;0;1;485;184;90;669
03;2021-S07;44;40;85;149547;141144;0;290691
04;2021-S07;22;31;53;60314;61377;09;121691
04;2021-S07;61;75;136;66065;68387;19;134452
04;2021-S07;76;66;142;51059;47156;29;98215
04;2021-S07;102;50;152;58788;45780;39;104568
04;2021-S07;103;65;169;61408;52207;49;113615
04;2021-S07;59;49;108;64838;60759;59;125597
04;2021-S07;23;27;50;47008;42843;69;89851
04;2021-S07;8;12;20;25509;21184;79;46693
04;2021-S07;6;5;11;13168;7647;89;20815
04;2021-S07;1;0;1;3209;1253;90;4462
04;2021-S07;461;380;842;451366;408593;0;859959
05;2021-S07;0;0;0;362.366008612902;341.338819562748;09;703.704828175651
05;2021-S07;0;0;0;353.376145114279;370.349735405642;19;723.725880519921
05;2021-S07;0;0;0;218.593559489256;256.539602589476;29;475.133162078732
05;2021-S07;0;0;0;404.225408693299;360.321910454353;39;764.547319147651
05;2021-S07;0;0;0;520.067953604221;497.108383964256;49;1017.17633756848
05;2021-S07;0;0;0;468.146063921917;510.087601910415;59;978.233665832332
05;2021-S07;0;0;0;340.368470050554;334.366842191253;69;674.735312241807
05;2021-S07;0;0;0;212.598666888387;192.597753227106;79;405.196420115493
05;2021-S07;0;0;0;148.727797095705;61.8681715431829;89;210.595968638888
05;2021-S07;0;0;0;32.9601271090696;10.9909785719784;90;43.9511056810479
05;2021-S07;0;0;0;3061.43020057959;2935.56979942041;0;5997
06;2021-S07;26;16;45;42583;42380;09;84963
06;2021-S07;166;113;283;33369;31925;19;65294
06;2021-S07;269;211;480;21571;15080;29;36651
06;2021-S07;308;231;540;21550;16147;39;37697
06;2021-S07;196;224;420;14193;13939;49;28132
06;2021-S07;118;179;297;7171;7597;59;14768
06;2021-S07;149;123;277;3629;4117;69;7746
06;2021-S07;27;30;57;1577;1457;79;3034
06;2021-S07;4;7;11;531;474;89;1005
06;2021-S07;3;4;7;88;93;90;181
06;2021-S07;1266;1138;2417;146262;133209;0;279471
07;2021-S07;0;0;0;485;549;09;1034
07;2021-S07;6;2;8;403;432;19;835
07;2021-S07;7;2;9;764;841;29;1605
07;2021-S07;13;5;18;824;928;39;1752
07;2021-S07;6;5;11;788;1020;49;1808
07;2021-S07;5;5;10;678;870;59;1548
07;2021-S07;4;2;6;360;382;69;742
07;2021-S07;1;0;1;231;190;79;421
07;2021-S07;0;0;0;114;67;89;181
07;2021-S07;0;0;0;24;11;90;35
07;2021-S07;42;21;63;4671;5290;0;9961
08;2021-S07;0;0;0;2715.22592983026;2997.75551488675;09;5712.98144471701
08;2021-S07;2;0;2;2778.51901080978;3160.9156459093;19;5939.43465671908
08;2021-S07;1;3;4;2080.8882988764;1718.16634315323;29;3799.05464202964
08;2021-S07;3;5;8;2701.8582062647;1896.52641413317;39;4598.38462039786
08;2021-S07;9;5;14;3151.45861023308;2460.52498233809;49;5611.98359257117
08;2021-S07;5;6;11;2620.29868333099;2422.23566154656;59;5042.53434487755
08;2021-S07;5;5;10;1621.44173420671;1438.58325779464;69;3060.02499200135
08;2021-S07;2;0;2;626.575909335673;526.358467843651;79;1152.93437717932
08;2021-S07;0;0;0;205.018522985054;140.993639349697;89;346.012162334751
08;2021-S07;0;0;0;50.0325684687745;20.62259870351;90;70.6551671722846
08;2021-S07;27;24;51;18551.3174743414;16782.6825256586;0;35334
11;2021-S07;718;778;1564;783071;811785;09;1594856
11;2021-S07;2021;2145;4304;761456;784653;19;1546109
11;2021-S07;3256;2895;6171;850145;801772;29;1651917
11;2021-S07;3414;2880;6317;914360;843488;39;1757848
11;2021-S07;3101;2928;6052;845609;826202;49;1671811
11;2021-S07;2408;2243;4666;793566;745070;59;1538636
11;2021-S07;1551;1516;3107;628649;549192;69;1177841
11;2021-S07;802;769;1575;434606;358356;79;792962
11;2021-S07;589;415;1007;261425;162933;89;424358
11;2021-S07;304;101;406;89253;32619;90;121872
11;2021-S07;18165;16681;35186;6362140;5916070;0;12278210
24;2021-S07;72;64;143;139720;144686;09;284406
24;2021-S07;256;275;535;152979;161185;19;314164
24;2021-S07;317;283;601;122237;126536;29;248773
24;2021-S07;336;256;592;150359;142009;39;292368
24;2021-S07;362;290;652;161829;158758;49;320587
24;2021-S07;311;266;579;172552;168011;59;340563
24;2021-S07;216;229;445;172509;158177;69;330686
24;2021-S07;126;152;278;129428;110593;79;240021
24;2021-S07;113;98;212;87342;56882;89;144224
24;2021-S07;104;44;148;31210;12071;90;43281
24;2021-S07;2213;1957;4186;1320165;1238908;0;2559073
27;2021-S07;73;90;164;143373;149679;09;293052
27;2021-S07;240;256;501;160962;173003;19;333965
27;2021-S07;317;278;595;133746;142254;29;276000
27;2021-S07;321;283;604;160004;155407;39;315411
27;2021-S07;325;276;601;172333;169564;49;341897
27;2021-S07;311;297;608;189979;183788;59;373767
27;2021-S07;252;246;498;192591;178206;69;370797
27;2021-S07;185;177;362;146876;127546;79;274422
27;2021-S07;163;112;275;96896;61575;89;158471
27;2021-S07;123;38;161;33148;12109;90;45257
27;2021-S07;2310;2053;4369;1429908;1353131;0;2783039
28;2021-S07;107;109;222;180735;186856;09;367591
28;2021-S07;388;376;769;200125;213621;19;413746
28;2021-S07;379;309;689;168922;173007;29;341929
28;2021-S07;419;328;748;196628;188487;39;385115
28;2021-S07;423;354;778;205396;201699;49;407095
28;2021-S07;346;349;695;222002;213866;59;435868
28;2021-S07;296;253;549;224688;203758;69;428446
28;2021-S07;165;167;332;163192;135543;79;298735
28;2021-S07;136;102;238;109691;65377;89;175068
28;2021-S07;68;25;93;37222;12685;90;49907
28;2021-S07;2728;2372;5114;1708601;1594899;0;3303500
32;2021-S07;409;435;845;358062;373689;09;731751
32;2021-S07;1272;1290;2564;387045;406742;19;793787
32;2021-S07;1407;1203;2612;342304;348587;29;690891
32;2021-S07;1507;1310;2818;382485;369972;39;752457
32;2021-S07;1547;1363;2911;382510;376716;49;759226
32;2021-S07;1224;1271;2496;386937;376527;59;763464
32;2021-S07;853;832;1685;371211;330938;69;702149
32;2021-S07;605;486;1091;250542;201459;79;452001
32;2021-S07;524;322;847;163399;89786;89;253185
32;2021-S07;249;79;328;48384;15367;90;63751
32;2021-S07;9602;8593;18204;3072879;2889783;0;5962662
44;2021-S07;257;283;547;291525;306839;09;598364
44;2021-S07;708;785;1504;320255;339504;19;659759
44;2021-S07;802;836;1642;302020;314428;29;616448
44;2021-S07;804;738;1548;342222;333292;39;675514
44;2021-S07;804;721;1531;349727;344491;49;694218
44;2021-S07;662;671;1344;381371;373239;59;754610
44;2021-S07;458;435;899;367165;335850;69;703015
44;2021-S07;299;271;576;250387;215436;79;465823
44;2021-S07;276;172;453;170825;105192;89;276017
44;2021-S07;147;47;195;51248;16731;90;67979
44;2021-S07;5217;4959;10241;2826745;2685002;0;5511747
52;2021-S07;109;102;215;213594;223900;09;437494
52;2021-S07;377;440;832;240818;255197;19;496015
52;2021-S07;416;403;820;197010;200630;29;397640
52;2021-S07;415;333;748;231204;224885;39;456089
52;2021-S07;424;368;792;243874;243418;49;487292
52;2021-S07;383;362;745;244100;239116;59;483216
52;2021-S07;260;254;514;241796;221345;69;463141
52;2021-S07;167;156;323;177805;149903;79;327708
52;2021-S07;163;105;268;119561;75822;89;195383
52;2021-S07;121;47;168;42559;15260;90;57819
52;2021-S07;2836;2571;5427;1952321;1849476;0;3801797
53;2021-S07;113;94;210;173813;182358;09;356171
53;2021-S07;238;241;487;202720;214740;19;417460
53;2021-S07;319;282;606;163116;173196;29;336312
53;2021-S07;296;215;511;190526;187674;39;378200
53;2021-S07;272;228;500;212098;212015;49;424113
53;2021-S07;234;242;476;223699;219176;59;442875
53;2021-S07;118;123;241;227435;209274;69;436709
53;2021-S07;86;83;169;169992;140910;79;310902
53;2021-S07;126;70;196;118117;69883;89;188000
53;2021-S07;87;28;116;37370;12267;90;49637
53;2021-S07;1889;1606;3514;1718886;1621493;0;3340379
75;2021-S07;149;132;283;293104;305291;09;598395
75;2021-S07;410;435;850;337141;357785;19;694926
75;2021-S07;509;492;1005;295024;300618;29;595642
75;2021-S07;549;459;1009;347871;331233;39;679104
75;2021-S07;533;424;959;384742;372771;49;757513
75;2021-S07;459;448;910;413361;390880;59;804241
75;2021-S07;294;307;603;425623;384060;69;809683
75;2021-S07;222;208;430;325086;276298;79;601384
75;2021-S07;204;151;355;213986;139308;89;353294
75;2021-S07;192;61;253;77600;28200;90;105800
75;2021-S07;3522;3118;6659;3113538;2886444;0;5999982
76;2021-S07;171;175;351;305956;318589;09;624545
76;2021-S07;543;568;1126;338942;356969;19;695911
76;2021-S07;751;634;1389;316210;319570;29;635780
76;2021-S07;782;640;1422;356758;337587;39;694345
76;2021-S07;752;597;1349;376541;363812;49;740353
76;2021-S07;643;638;1283;402608;383750;59;786358
76;2021-S07;419;408;827;394889;358997;69;753886
76;2021-S07;285;265;550;308664;263806;79;572470
76;2021-S07;283;189;472;195838;129272;89;325110
76;2021-S07;240;75;315;69372;26728;90;96100
76;2021-S07;4879;4197;9103;3065778;2859080;0;5924858
84;2021-S07;294;350;646;459549;481088;09;940637
84;2021-S07;956;979;1937;487711;511905;19;999616
84;2021-S07;1154;965;2119;443824;451094;29;894918
84;2021-S07;1251;1048;2299;512522;493262;39;1005784
84;2021-S07;1179;1084;2266;520248;515106;49;1035354
84;2021-S07;1093;1056;2152;529611;514848;59;1044459
84;2021-S07;731;670;1402;486720;439940;69;926660
84;2021-S07;525;507;1032;372151;315211;79;687362
84;2021-S07;460;305;765;237198;150524;89;387722
84;2021-S07;290;88;379;81185;28680;90;109865
84;2021-S07;7933;7053;15004;4130719;3901658;0;8032377
93;2021-S07;321;356;683;268834;283093;09;551927
93;2021-S07;1205;1217;2431;280751;296087;19;576838
93;2021-S07;1496;1223;2725;254404;255552;29;509956
93;2021-S07;1589;1337;2932;310704;288398;39;599102
93;2021-S07;1629;1287;2918;325559;305827;49;631386
93;2021-S07;1411;1263;2677;353104;325389;59;678493
93;2021-S07;940;924;1865;336327;296459;69;632786
93;2021-S07;668;584;1253;279820;229699;79;509519
93;2021-S07;482;322;805;171274;113716;89;284990
93;2021-S07;324;119;443;58896;21758;90;80654
93;2021-S07;10065;8633;18735;2639673;2415978;0;5055651
94;2021-S07;6;5;11;16311;17433;09;33744
94;2021-S07;20;19;39;16679;18132;19;34811
94;2021-S07;27;19;46;16782;16579;29;33361
94;2021-S07;28;35;63;23044;20580;39;43624
94;2021-S07;22;30;52;23065;22140;49;45205
94;2021-S07;32;31;63;24549;23421;59;47970
94;2021-S07;33;24;57;23212;21883;69;45095
94;2021-S07;14;14;28;19544;17141;79;36685
94;2021-S07;6;8;14;11227;8178;89;19405
94;2021-S07;2;1;3;3332;1447;90;4779
94;2021-S07;190;186;376;177745;166934;0;344679
01;2021-S08;0;9;9;19979;20155;09;40134
01;2021-S08;27;24;51;24994;25489;19;50483
01;2021-S08;36;23;59;17868;16690;29;34558
01;2021-S08;33;25;58;22328;14821;39;37149
01;2021-S08;50;27;77;28652;20276;49;48928
01;2021-S08;48;35;83;33264;27260;59;60524
01;2021-S08;23;35;58;27135;23978;69;51113
01;2021-S08;6;4;10;18401;14661;79;33062
01;2021-S08;5;3;8;9633;6375;89;16008
01;2021-S08;1;1;2;3410;1510;90;4920
01;2021-S08;229;186;415;205664;171215;0;376879
02;2021-S08;4;0;4;16881;17110;09;33991
02;2021-S08;5;5;10;21410;21604;19;43014
02;2021-S08;14;6;20;16017;15479;29;31496
02;2021-S08;22;10;32;19825;14455;39;34280
02;2021-S08;9;10;19;24719;18248;49;42967
02;2021-S08;8;7;15;34361;28310;59;62671
02;2021-S08;5;4;10;28061;24495;69;52556
02;2021-S08;4;1;6;18231;15278;79;33509
02;2021-S08;3;1;4;11090;7677;89;18767
02;2021-S08;3;1;4;3992;1506;90;5498
02;2021-S08;77;45;124;194587;164162;0;358749
03;2021-S08;2;2;4;31123;30920;09;62043
03;2021-S08;7;8;15;29370;29268;19;58638
03;2021-S08;5;7;12;21458;18963;29;40421
03;2021-S08;7;4;11;21276;18326;39;39602
03;2021-S08;7;4;11;18164;16593;49;34757
03;2021-S08;7;10;17;13469;13557;59;27026
03;2021-S08;5;6;11;8776;8670;69;17446
03;2021-S08;2;2;4;3777;3591;79;7368
03;2021-S08;2;0;2;1649;1072;89;2721
03;2021-S08;0;0;0;485;184;90;669
03;2021-S08;44;43;87;149547;141144;0;290691
04;2021-S08;24;27;51;60314;61377;09;121691
04;2021-S08;101;84;185;66065;68387;19;134452
04;2021-S08;81;64;145;51059;47156;29;98215
04;2021-S08;68;64;132;58788;45780;39;104568
04;2021-S08;85;76;161;61408;52207;49;113615
04;2021-S08;63;57;120;64838;60759;59;125597
04;2021-S08;43;38;81;47008;42843;69;89851
04;2021-S08;19;10;29;25509;21184;79;46693
04;2021-S08;5;3;8;13168;7647;89;20815
04;2021-S08;0;0;0;3209;1253;90;4462
04;2021-S08;489;423;912;451366;408593;0;859959
05;2021-S08;0;0;0;362.366008612902;341.338819562748;09;703.704828175651
05;2021-S08;0;0;0;353.376145114279;370.349735405642;19;723.725880519921
05;2021-S08;0;0;0;218.593559489256;256.539602589476;29;475.133162078732
05;2021-S08;0;0;0;404.225408693299;360.321910454353;39;764.547319147651
05;2021-S08;0;0;0;520.067953604221;497.108383964256;49;1017.17633756848
05;2021-S08;0;0;0;468.146063921917;510.087601910415;59;978.233665832332
05;2021-S08;0;0;0;340.368470050554;334.366842191253;69;674.735312241807
05;2021-S08;0;0;0;212.598666888387;192.597753227106;79;405.196420115493
05;2021-S08;0;0;0;148.727797095705;61.8681715431829;89;210.595968638888
05;2021-S08;0;0;0;32.9601271090696;10.9909785719784;90;43.9511056810479
05;2021-S08;0;0;0;3061.43020057959;2935.56979942041;0;5997
06;2021-S08;15;12;28;42583;42380;09;84963
06;2021-S08;74;47;124;33369;31925;19;65294
06;2021-S08;160;86;246;21571;15080;29;36651
06;2021-S08;167;124;291;21550;16147;39;37697
06;2021-S08;120;131;251;14193;13939;49;28132
06;2021-S08;63;83;146;7171;7597;59;14768
06;2021-S08;115;114;231;3629;4117;69;7746
06;2021-S08;21;24;45;1577;1457;79;3034
06;2021-S08;10;11;21;531;474;89;1005
06;2021-S08;2;0;2;88;93;90;181
06;2021-S08;748;632;1386;146262;133209;0;279471
07;2021-S08;0;0;0;485;549;09;1034
07;2021-S08;8;6;14;403;432;19;835
07;2021-S08;9;2;11;764;841;29;1605
07;2021-S08;6;7;13;824;928;39;1752
07;2021-S08;6;3;9;788;1020;49;1808
07;2021-S08;4;1;5;678;870;59;1548
07;2021-S08;2;5;7;360;382;69;742
07;2021-S08;1;1;2;231;190;79;421
07;2021-S08;0;0;0;114;67;89;181
07;2021-S08;0;1;1;24;11;90;35
07;2021-S08;36;26;62;4671;5290;0;9961
08;2021-S08;0;0;0;2715.22592983026;2997.75551488675;09;5712.98144471701
08;2021-S08;3;1;4;2778.51901080978;3160.9156459093;19;5939.43465671908
08;2021-S08;1;1;2;2080.8882988764;1718.16634315323;29;3799.05464202964
08;2021-S08;6;2;8;2701.8582062647;1896.52641413317;39;4598.38462039786
08;2021-S08;3;2;5;3151.45861023308;2460.52498233809;49;5611.98359257117
08;2021-S08;2;1;3;2620.29868333099;2422.23566154656;59;5042.53434487755
08;2021-S08;1;3;4;1621.44173420671;1438.58325779464;69;3060.02499200135
08;2021-S08;0;0;0;626.575909335673;526.358467843651;79;1152.93437717932
08;2021-S08;0;0;0;205.018522985054;140.993639349697;89;346.012162334751
08;2021-S08;0;0;0;50.0325684687745;20.62259870351;90;70.6551671722846
08;2021-S08;16;10;26;18551.3174743414;16782.6825256586;0;35334
11;2021-S08;864;892;1852;783071;811785;09;1594856
11;2021-S08;2460;2422;5058;761456;784653;19;1546109
11;2021-S08;3966;3538;7534;850145;801772;29;1651917
11;2021-S08;3890;3484;7413;914360;843488;39;1757848
11;2021-S08;3487;3248;6765;845609;826202;49;1671811
11;2021-S08;2842;2740;5620;793566;745070;59;1538636
11;2021-S08;1836;1805;3675;628649;549192;69;1177841
11;2021-S08;917;869;1789;434606;358356;79;792962
11;2021-S08;608;402;1013;261425;162933;89;424358
11;2021-S08;284;116;405;89253;32619;90;121872
11;2021-S08;21155;19524;41135;6362140;5916070;0;12278210
24;2021-S08;68;64;133;139720;144686;09;284406
24;2021-S08;271;302;584;152979;161185;19;314164
24;2021-S08;320;353;673;122237;126536;29;248773
24;2021-S08;359;312;671;150359;142009;39;292368
24;2021-S08;345;315;660;161829;158758;49;320587
24;2021-S08;334;328;662;172552;168011;59;340563
24;2021-S08;235;257;492;172509;158177;69;330686
24;2021-S08;175;166;341;129428;110593;79;240021
24;2021-S08;141;87;228;87342;56882;89;144224
24;2021-S08;102;40;142;31210;12071;90;43281
24;2021-S08;2350;2224;4586;1320165;1238908;0;2559073
27;2021-S08;73;95;168;143373;149679;09;293052
27;2021-S08;287;345;635;160962;173003;19;333965
27;2021-S08;329;317;646;133746;142254;29;276000
27;2021-S08;310;309;619;160004;155407;39;315411
27;2021-S08;364;315;680;172333;169564;49;341897
27;2021-S08;336;348;684;189979;183788;59;373767
27;2021-S08;254;245;500;192591;178206;69;370797
27;2021-S08;167;158;326;146876;127546;79;274422
27;2021-S08;132;105;237;96896;61575;89;158471
27;2021-S08;48;32;80;33148;12109;90;45257
27;2021-S08;2300;2269;4575;1429908;1353131;0;2783039
28;2021-S08;98;134;239;180735;186856;09;367591
28;2021-S08;405;342;752;200125;213621;19;413746
28;2021-S08;381;371;752;168922;173007;29;341929
28;2021-S08;462;361;823;196628;188487;39;385115
28;2021-S08;465;405;870;205396;201699;49;407095
28;2021-S08;413;422;836;222002;213866;59;435868
28;2021-S08;371;337;708;224688;203758;69;428446
28;2021-S08;211;195;407;163192;135543;79;298735
28;2021-S08;157;88;246;109691;65377;89;175068
28;2021-S08;71;39;110;37222;12685;90;49907
28;2021-S08;3034;2694;5747;1708601;1594899;0;3303500
32;2021-S08;451;556;1008;358062;373689;09;731751
32;2021-S08;1331;1371;2705;387045;406742;19;793787
32;2021-S08;1567;1404;2972;342304;348587;29;690891
32;2021-S08;1663;1417;3081;382485;369972;39;752457
32;2021-S08;1681;1550;3232;382510;376716;49;759226
32;2021-S08;1496;1476;2972;386937;376527;59;763464
32;2021-S08;1044;928;1972;371211;330938;69;702149
32;2021-S08;700;632;1332;250542;201459;79;452001
32;2021-S08;538;296;834;163399;89786;89;253185
32;2021-S08;258;84;343;48384;15367;90;63751
32;2021-S08;10730;9718;20461;3072879;2889783;0;5962662
44;2021-S08;232;225;470;291525;306839;09;598364
44;2021-S08;646;690;1341;320255;339504;19;659759
44;2021-S08;875;779;1662;302020;314428;29;616448
44;2021-S08;863;792;1665;342222;333292;39;675514
44;2021-S08;791;661;1462;349727;344491;49;694218
44;2021-S08;735;673;1412;381371;373239;59;754610
44;2021-S08;450;517;973;367165;335850;69;703015
44;2021-S08;329;295;628;250387;215436;79;465823
44;2021-S08;244;168;413;170825;105192;89;276017
44;2021-S08;129;49;178;51248;16731;90;67979
44;2021-S08;5297;4851;10209;2826745;2685002;0;5511747
52;2021-S08;118;117;240;213594;223900;09;437494
52;2021-S08;431;427;865;240818;255197;19;496015
52;2021-S08;425;369;795;197010;200630;29;397640
52;2021-S08;438;342;782;231204;224885;39;456089
52;2021-S08;444;385;830;243874;243418;49;487292
52;2021-S08;390;376;767;244100;239116;59;483216
52;2021-S08;238;271;509;241796;221345;69;463141
52;2021-S08;209;178;388;177805;149903;79;327708
52;2021-S08;158;115;273;119561;75822;89;195383
52;2021-S08;119;43;162;42559;15260;90;57819
52;2021-S08;2970;2623;5615;1952321;1849476;0;3801797
53;2021-S08;74;96;175;173813;182358;09;356171
53;2021-S08;283;334;628;202720;214740;19;417460
53;2021-S08;324;315;641;163116;173196;29;336312
53;2021-S08;228;229;457;190526;187674;39;378200
53;2021-S08;290;269;559;212098;212015;49;424113
53;2021-S08;243;233;477;223699;219176;59;442875
53;2021-S08;135;147;282;227435;209274;69;436709
53;2021-S08;106;99;205;169992;140910;79;310902
53;2021-S08;86;40;126;118117;69883;89;188000
53;2021-S08;60;10;70;37370;12267;90;49637
53;2021-S08;1829;1772;3621;1718886;1621493;0;3340379
75;2021-S08;158;162;320;293104;305291;09;598395
75;2021-S08;548;525;1073;337141;357785;19;694926
75;2021-S08;608;518;1126;295024;300618;29;595642
75;2021-S08;548;437;987;347871;331233;39;679104
75;2021-S08;544;496;1040;384742;372771;49;757513
75;2021-S08;539;465;1004;413361;390880;59;804241
75;2021-S08;411;363;775;425623;384060;69;809683
75;2021-S08;241;250;491;325086;276298;79;601384
75;2021-S08;213;122;335;213986;139308;89;353294
75;2021-S08;163;51;214;77600;28200;90;105800
75;2021-S08;3975;3390;7368;3113538;2886444;0;5999982
76;2021-S08;170;178;355;305956;318589;09;624545
76;2021-S08;578;621;1215;338942;356969;19;695911
76;2021-S08;726;655;1382;316210;319570;29;635780
76;2021-S08;769;672;1443;356758;337587;39;694345
76;2021-S08;769;641;1410;376541;363812;49;740353
76;2021-S08;667;635;1302;402608;383750;59;786358
76;2021-S08;473;422;895;394889;358997;69;753886
76;2021-S08;289;276;565;308664;263806;79;572470
76;2021-S08;208;156;365;195838;129272;89;325110
76;2021-S08;130;47;177;69372;26728;90;96100
76;2021-S08;4784;4305;9116;3065778;2859080;0;5924858
84;2021-S08;371;397;774;459549;481088;09;940637
84;2021-S08;1080;1132;2219;487711;511905;19;999616
84;2021-S08;1249;1144;2395;443824;451094;29;894918
84;2021-S08;1293;1134;2427;512522;493262;39;1005784
84;2021-S08;1214;1095;2311;520248;515106;49;1035354
84;2021-S08;1118;1080;2198;529611;514848;59;1044459
84;2021-S08;739;698;1439;486720;439940;69;926660
84;2021-S08;534;496;1030;372151;315211;79;687362
84;2021-S08;373;268;642;237198;150524;89;387722
84;2021-S08;220;76;296;81185;28680;90;109865
84;2021-S08;8192;7520;15733;4130719;3901658;0;8032377
93;2021-S08;301;336;638;268834;283093;09;551927
93;2021-S08;1086;1048;2139;280751;296087;19;576838
93;2021-S08;1519;1211;2731;254404;255552;29;509956
93;2021-S08;1572;1278;2853;310704;288398;39;599102
93;2021-S08;1596;1332;2930;325559;305827;49;631386
93;2021-S08;1491;1384;2877;353104;325389;59;678493
93;2021-S08;960;912;1875;336327;296459;69;632786
93;2021-S08;648;609;1259;279820;229699;79;509519
93;2021-S08;430;304;735;171274;113716;89;284990
93;2021-S08;265;113;378;58896;21758;90;80654
93;2021-S08;9868;8528;18417;2639673;2415978;0;5055651
94;2021-S08;9;7;16;16311;17433;09;33744
94;2021-S08;26;33;60;16679;18132;19;34811
94;2021-S08;36;31;67;16782;16579;29;33361
94;2021-S08;41;29;70;23044;20580;39;43624
94;2021-S08;37;27;64;23065;22140;49;45205
94;2021-S08;35;54;89;24549;23421;59;47970
94;2021-S08;31;23;54;23212;21883;69;45095
94;2021-S08;22;17;39;19544;17141;79;36685
94;2021-S08;13;5;18;11227;8178;89;19405
94;2021-S08;9;1;10;3332;1447;90;4779
94;2021-S08;259;227;487;177745;166934;0;344679
01;2021-S09;2;6;8;19979;20155;09;40134
01;2021-S09;27;40;67;24994;25489;19;50483
01;2021-S09;32;27;59;17868;16690;29;34558
01;2021-S09;49;15;64;22328;14821;39;37149
01;2021-S09;41;41;82;28652;20276;49;48928
01;2021-S09;40;36;76;33264;27260;59;60524
01;2021-S09;23;26;49;27135;23978;69;51113
01;2021-S09;8;7;15;18401;14661;79;33062
01;2021-S09;2;2;4;9633;6375;89;16008
01;2021-S09;0;0;0;3410;1510;90;4920
01;2021-S09;224;201;425;205664;171215;0;376879
02;2021-S09;3;0;3;16881;17110;09;33991
02;2021-S09;2;0;3;21410;21604;19;43014
02;2021-S09;6;6;12;16017;15479;29;31496
02;2021-S09;16;8;24;19825;14455;39;34280
02;2021-S09;7;11;18;24719;18248;49;42967
02;2021-S09;24;9;33;34361;28310;59;62671
02;2021-S09;8;13;21;28061;24495;69;52556
02;2021-S09;1;3;4;18231;15278;79;33509
02;2021-S09;4;1;5;11090;7677;89;18767
02;2021-S09;4;1;5;3992;1506;90;5498
02;2021-S09;75;52;128;194587;164162;0;358749
03;2021-S09;1;2;4;31123;30920;09;62043
03;2021-S09;6;2;8;29370;29268;19;58638
03;2021-S09;5;4;9;21458;18963;29;40421
03;2021-S09;7;2;9;21276;18326;39;39602
03;2021-S09;13;9;22;18164;16593;49;34757
03;2021-S09;7;4;11;13469;13557;59;27026
03;2021-S09;7;3;11;8776;8670;69;17446
03;2021-S09;0;1;1;3777;3591;79;7368
03;2021-S09;0;0;0;1649;1072;89;2721
03;2021-S09;0;0;0;485;184;90;669
03;2021-S09;46;27;75;149547;141144;0;290691
04;2021-S09;29;29;58;60314;61377;09;121691
04;2021-S09;74;98;172;66065;68387;19;134452
04;2021-S09;126;78;204;51059;47156;29;98215
04;2021-S09;101;70;171;58788;45780;39;104568
04;2021-S09;87;62;149;61408;52207;49;113615
04;2021-S09;77;70;147;64838;60759;59;125597
04;2021-S09;52;48;100;47008;42843;69;89851
04;2021-S09;12;23;35;25509;21184;79;46693
04;2021-S09;8;14;22;13168;7647;89;20815
04;2021-S09;1;2;3;3209;1253;90;4462
04;2021-S09;567;494;1061;451366;408593;0;859959
05;2021-S09;0;0;0;362.366008612902;341.338819562748;09;703.704828175651
05;2021-S09;0;0;0;353.376145114279;370.349735405642;19;723.725880519921
05;2021-S09;0;0;0;218.593559489256;256.539602589476;29;475.133162078732
05;2021-S09;0;0;0;404.225408693299;360.321910454353;39;764.547319147651
05;2021-S09;0;0;0;520.067953604221;497.108383964256;49;1017.17633756848
05;2021-S09;0;0;0;468.146063921917;510.087601910415;59;978.233665832332
05;2021-S09;0;0;0;340.368470050554;334.366842191253;69;674.735312241807
05;2021-S09;0;0;0;212.598666888387;192.597753227106;79;405.196420115493
05;2021-S09;0;0;0;148.727797095705;61.8681715431829;89;210.595968638888
05;2021-S09;0;0;0;32.9601271090696;10.9909785719784;90;43.9511056810479
05;2021-S09;0;0;0;3061.43020057959;2935.56979942041;0;5997
06;2021-S09;5;2;7;42583;42380;09;84963
06;2021-S09;34;22;61;33369;31925;19;65294
06;2021-S09;60;57;117;21571;15080;29;36651
06;2021-S09;69;69;138;21550;16147;39;37697
06;2021-S09;53;62;115;14193;13939;49;28132
06;2021-S09;31;27;58;7171;7597;59;14768
06;2021-S09;54;67;121;3629;4117;69;7746
06;2021-S09;14;9;23;1577;1457;79;3034
06;2021-S09;3;8;11;531;474;89;1005
06;2021-S09;0;0;0;88;93;90;181
06;2021-S09;323;323;651;146262;133209;0;279471
07;2021-S09;0;0;0;485;549;09;1034
07;2021-S09;3;1;4;403;432;19;835
07;2021-S09;4;5;9;764;841;29;1605
07;2021-S09;11;5;16;824;928;39;1752
07;2021-S09;2;5;7;788;1020;49;1808
07;2021-S09;8;4;12;678;870;59;1548
07;2021-S09;3;3;6;360;382;69;742
07;2021-S09;1;2;3;231;190;79;421
07;2021-S09;1;0;1;114;67;89;181
07;2021-S09;0;0;0;24;11;90;35
07;2021-S09;33;25;58;4671;5290;0;9961
08;2021-S09;0;0;0;2715.22592983026;2997.75551488675;09;5712.98144471701
08;2021-S09;0;0;0;2778.51901080978;3160.9156459093;19;5939.43465671908
08;2021-S09;1;3;4;2080.8882988764;1718.16634315323;29;3799.05464202964
08;2021-S09;2;3;5;2701.8582062647;1896.52641413317;39;4598.38462039786
08;2021-S09;4;1;5;3151.45861023308;2460.52498233809;49;5611.98359257117
08;2021-S09;3;4;7;2620.29868333099;2422.23566154656;59;5042.53434487755
08;2021-S09;0;5;5;1621.44173420671;1438.58325779464;69;3060.02499200135
08;2021-S09;0;1;1;626.575909335673;526.358467843651;79;1152.93437717932
08;2021-S09;1;1;2;205.018522985054;140.993639349697;89;346.012162334751
08;2021-S09;0;0;0;50.0325684687745;20.62259870351;90;70.6551671722846
08;2021-S09;11;18;29;18551.3174743414;16782.6825256586;0;35334
11;2021-S09;915;1029;2071;783071;811785;09;1594856
11;2021-S09;2847;2820;5871;761456;784653;19;1546109
11;2021-S09;4371;3768;8168;850145;801772;29;1651917
11;2021-S09;4095;3760;7886;914360;843488;39;1757848
11;2021-S09;3626;3255;6925;845609;826202;49;1671811
11;2021-S09;2967;2863;5865;793566;745070;59;1538636
11;2021-S09;1946;1797;3793;628649;549192;69;1177841
11;2021-S09;992;859;1857;434606;358356;79;792962
11;2021-S09;630;392;1024;261425;162933;89;424358
11;2021-S09;271;121;392;89253;32619;90;121872
11;2021-S09;22667;20673;43872;6362140;5916070;0;12278210
24;2021-S09;67;81;149;139720;144686;09;284406
24;2021-S09;288;295;594;152979;161185;19;314164
24;2021-S09;348;279;628;122237;126536;29;248773
24;2021-S09;350;278;628;150359;142009;39;292368
24;2021-S09;331;302;634;161829;158758;49;320587
24;2021-S09;298;319;617;172552;168011;59;340563
24;2021-S09;258;208;466;172509;158177;69;330686
24;2021-S09;142;146;288;129428;110593;79;240021
24;2021-S09;92;77;169;87342;56882;89;144224
24;2021-S09;64;30;94;31210;12071;90;43281
24;2021-S09;2239;2015;4268;1320165;1238908;0;2559073
27;2021-S09;83;70;153;143373;149679;09;293052
27;2021-S09;316;365;683;160962;173003;19;333965
27;2021-S09;322;301;623;133746;142254;29;276000
27;2021-S09;287;279;566;160004;155407;39;315411
27;2021-S09;324;260;585;172333;169564;49;341897
27;2021-S09;321;310;632;189979;183788;59;373767
27;2021-S09;238;206;444;192591;178206;69;370797
27;2021-S09;153;165;318;146876;127546;79;274422
27;2021-S09;83;77;160;96896;61575;89;158471
27;2021-S09;41;21;62;33148;12109;90;45257
27;2021-S09;2168;2054;4226;1429908;1353131;0;2783039
28;2021-S09;127;154;289;180735;186856;09;367591
28;2021-S09;474;422;905;200125;213621;19;413746
28;2021-S09;444;428;873;168922;173007;29;341929
28;2021-S09;445;372;817;196628;188487;39;385115
28;2021-S09;537;412;949;205396;201699;49;407095
28;2021-S09;466;463;929;222002;213866;59;435868
28;2021-S09;351;335;687;224688;203758;69;428446
28;2021-S09;237;198;435;163192;135543;79;298735
28;2021-S09;171;113;284;109691;65377;89;175068
28;2021-S09;85;29;114;37222;12685;90;49907
28;2021-S09;3337;2926;6282;1708601;1594899;0;3303500
32;2021-S09;507;586;1093;358062;373689;09;731751
32;2021-S09;1456;1399;2858;387045;406742;19;793787
32;2021-S09;1625;1464;3090;342304;348587;29;690891
32;2021-S09;1705;1385;3091;382485;369972;39;752457
32;2021-S09;1628;1394;3023;382510;376716;49;759226
32;2021-S09;1343;1314;2657;386937;376527;59;763464
32;2021-S09;1026;907;1934;371211;330938;69;702149
32;2021-S09;702;566;1268;250542;201459;79;452001
32;2021-S09;420;254;674;163399;89786;89;253185
32;2021-S09;155;57;212;48384;15367;90;63751
32;2021-S09;10569;9331;19907;3072879;2889783;0;5962662
44;2021-S09;215;263;483;291525;306839;09;598364
44;2021-S09;663;700;1375;320255;339504;19;659759
44;2021-S09;861;775;1647;302020;314428;29;616448
44;2021-S09;818;781;1603;342222;333292;39;675514
44;2021-S09;859;699;1563;349727;344491;49;694218
44;2021-S09;706;720;1432;381371;373239;59;754610
44;2021-S09;523;518;1044;367165;335850;69;703015
44;2021-S09;318;349;670;250387;215436;79;465823
44;2021-S09;244;152;397;170825;105192;89;276017
44;2021-S09;108;38;146;51248;16731;90;67979
44;2021-S09;5315;4996;10361;2826745;2685002;0;5511747
52;2021-S09;140;133;278;213594;223900;09;437494
52;2021-S09;468;489;965;240818;255197;19;496015
52;2021-S09;488;455;943;197010;200630;29;397640
52;2021-S09;420;394;816;231204;224885;39;456089
52;2021-S09;459;382;841;243874;243418;49;487292
52;2021-S09;360;378;738;244100;239116;59;483216
52;2021-S09;280;262;542;241796;221345;69;463141
52;2021-S09;160;172;332;177805;149903;79;327708
52;2021-S09;120;95;215;119561;75822;89;195383
52;2021-S09;54;23;77;42559;15260;90;57819
52;2021-S09;2949;2783;5753;1952321;1849476;0;3801797
53;2021-S09;77;95;175;173813;182358;09;356171
53;2021-S09;325;365;701;202720;214740;19;417460
53;2021-S09;345;373;721;163116;173196;29;336312
53;2021-S09;266;234;501;190526;187674;39;378200
53;2021-S09;282;263;545;212098;212015;49;424113
53;2021-S09;249;251;502;223699;219176;59;442875
53;2021-S09;144;134;278;227435;209274;69;436709
53;2021-S09;112;97;209;169992;140910;79;310902
53;2021-S09;77;44;121;118117;69883;89;188000
53;2021-S09;37;24;61;37370;12267;90;49637
53;2021-S09;1915;1880;3815;1718886;1621493;0;3340379
75;2021-S09;166;175;342;293104;305291;09;598395
75;2021-S09;442;526;977;337141;357785;19;694926
75;2021-S09;498;513;1012;295024;300618;29;595642
75;2021-S09;490;431;921;347871;331233;39;679104
75;2021-S09;479;421;900;384742;372771;49;757513
75;2021-S09;429;427;856;413361;390880;59;804241
75;2021-S09;344;310;654;425623;384060;69;809683
75;2021-S09;194;189;383;325086;276298;79;601384
75;2021-S09;153;95;248;213986;139308;89;353294
75;2021-S09;89;44;133;77600;28200;90;105800
75;2021-S09;3285;3131;6427;3113538;2886444;0;5999982
76;2021-S09;234;214;466;305956;318589;09;624545
76;2021-S09;724;708;1446;338942;356969;19;695911
76;2021-S09;800;657;1459;316210;319570;29;635780
76;2021-S09;760;602;1364;356758;337587;39;694345
76;2021-S09;775;574;1349;376541;363812;49;740353
76;2021-S09;681;572;1253;402608;383750;59;786358
76;2021-S09;469;388;858;394889;358997;69;753886
76;2021-S09;280;270;550;308664;263806;79;572470
76;2021-S09;181;144;325;195838;129272;89;325110
76;2021-S09;83;35;118;69372;26728;90;96100
76;2021-S09;4995;4170;9203;3065778;2859080;0;5924858
84;2021-S09;382;412;797;459549;481088;09;940637
84;2021-S09;937;1016;1957;487711;511905;19;999616
84;2021-S09;1225;1135;2362;443824;451094;29;894918
84;2021-S09;1261;1070;2333;512522;493262;39;1005784
84;2021-S09;1134;1036;2172;520248;515106;49;1035354
84;2021-S09;1006;980;1989;529611;514848;59;1044459
84;2021-S09;679;690;1371;486720;439940;69;926660
84;2021-S09;459;459;918;372151;315211;79;687362
84;2021-S09;319;219;538;237198;150524;89;387722
84;2021-S09;168;52;220;81185;28680;90;109865
84;2021-S09;7570;7070;14658;4130719;3901658;0;8032377
93;2021-S09;316;330;647;268834;283093;09;551927
93;2021-S09;1065;1064;2134;280751;296087;19;576838
93;2021-S09;1388;1092;2487;254404;255552;29;509956
93;2021-S09;1380;1194;2578;310704;288398;39;599102
93;2021-S09;1461;1280;2746;325559;305827;49;631386
93;2021-S09;1309;1208;2517;353104;325389;59;678493
93;2021-S09;909;890;1799;336327;296459;69;632786
93;2021-S09;607;492;1100;279820;229699;79;509519
93;2021-S09;397;268;665;171274;113716;89;284990
93;2021-S09;162;76;238;58896;21758;90;80654
93;2021-S09;8995;7895;16940;2639673;2415978;0;5055651
94;2021-S09;3;13;16;16311;17433;09;33744
94;2021-S09;37;28;66;16679;18132;19;34811
94;2021-S09;34;44;78;16782;16579;29;33361
94;2021-S09;48;46;94;23044;20580;39;43624
94;2021-S09;40;32;72;23065;22140;49;45205
94;2021-S09;39;35;74;24549;23421;59;47970
94;2021-S09;35;33;68;23212;21883;69;45095
94;2021-S09;15;14;29;19544;17141;79;36685
94;2021-S09;14;13;27;11227;8178;89;19405
94;2021-S09;5;1;6;3332;1447;90;4779
94;2021-S09;270;259;530;177745;166934;0;344679
01;2021-S10;1;2;3;19979;20155;09;40134
01;2021-S10;21;15;36;24994;25489;19;50483
01;2021-S10;25;18;43;17868;16690;29;34558
01;2021-S10;21;15;36;22328;14821;39;37149
01;2021-S10;29;15;44;28652;20276;49;48928
01;2021-S10;38;49;87;33264;27260;59;60524
01;2021-S10;19;27;46;27135;23978;69;51113
01;2021-S10;4;7;11;18401;14661;79;33062
01;2021-S10;6;1;7;9633;6375;89;16008
01;2021-S10;2;0;2;3410;1510;90;4920
01;2021-S10;166;149;315;205664;171215;0;376879
02;2021-S10;0;0;0;16881;17110;09;33991
02;2021-S10;14;24;38;21410;21604;19;43014
02;2021-S10;31;17;48;16017;15479;29;31496
02;2021-S10;24;24;48;19825;14455;39;34280
02;2021-S10;20;23;43;24719;18248;49;42967
02;2021-S10;23;12;35;34361;28310;59;62671
02;2021-S10;13;9;22;28061;24495;69;52556
02;2021-S10;4;5;9;18231;15278;79;33509
02;2021-S10;3;2;5;11090;7677;89;18767
02;2021-S10;0;0;0;3992;1506;90;5498
02;2021-S10;132;116;248;194587;164162;0;358749
03;2021-S10;0;2;2;31123;30920;09;62043
03;2021-S10;4;13;17;29370;29268;19;58638
03;2021-S10;8;2;10;21458;18963;29;40421
03;2021-S10;2;8;10;21276;18326;39;39602
03;2021-S10;5;10;15;18164;16593;49;34757
03;2021-S10;2;1;3;13469;13557;59;27026
03;2021-S10;3;3;6;8776;8670;69;17446
03;2021-S10;0;1;1;3777;3591;79;7368
03;2021-S10;0;0;0;1649;1072;89;2721
03;2021-S10;0;0;0;485;184;90;669
03;2021-S10;24;40;64;149547;141144;0;290691
04;2021-S10;31;19;50;60314;61377;09;121691
04;2021-S10;64;65;129;66065;68387;19;134452
04;2021-S10;97;79;176;51059;47156;29;98215
04;2021-S10;105;80;185;58788;45780;39;104568
04;2021-S10;94;70;164;61408;52207;49;113615
04;2021-S10;79;68;147;64838;60759;59;125597
04;2021-S10;37;44;81;47008;42843;69;89851
04;2021-S10;21;10;31;25509;21184;79;46693
04;2021-S10;18;11;29;13168;7647;89;20815
04;2021-S10;2;0;2;3209;1253;90;4462
04;2021-S10;548;446;994;451366;408593;0;859959
05;2021-S10;0;0;0;362.366008612902;341.338819562748;09;703.704828175651
05;2021-S10;0;1;1;353.376145114279;370.349735405642;19;723.725880519921
05;2021-S10;0;0;0;218.593559489256;256.539602589476;29;475.133162078732
05;2021-S10;0;0;0;404.225408693299;360.321910454353;39;764.547319147651
05;2021-S10;0;0;0;520.067953604221;497.108383964256;49;1017.17633756848
05;2021-S10;0;0;0;468.146063921917;510.087601910415;59;978.233665832332
05;2021-S10;0;0;0;340.368470050554;334.366842191253;69;674.735312241807
05;2021-S10;0;0;0;212.598666888387;192.597753227106;79;405.196420115493
05;2021-S10;0;0;0;148.727797095705;61.8681715431829;89;210.595968638888
05;2021-S10;0;0;0;32.9601271090696;10.9909785719784;90;43.9511056810479
05;2021-S10;0;1;1;3061.43020057959;2935.56979942041;0;5997
06;2021-S10;17;23;40;42583;42380;09;84963
06;2021-S10;55;54;109;33369;31925;19;65294
06;2021-S10;44;57;101;21571;15080;29;36651
06;2021-S10;55;41;96;21550;16147;39;37697
06;2021-S10;37;41;78;14193;13939;49;28132
06;2021-S10;14;35;49;7171;7597;59;14768
06;2021-S10;29;38;68;3629;4117;69;7746
06;2021-S10;7;3;10;1577;1457;79;3034
06;2021-S10;1;1;2;531;474;89;1005
06;2021-S10;0;0;0;88;93;90;181
06;2021-S10;259;293;553;146262;133209;0;279471
07;2021-S10;0;0;0;485;549;09;1034
07;2021-S10;0;2;2;403;432;19;835
07;2021-S10;10;12;22;764;841;29;1605
07;2021-S10;4;7;11;824;928;39;1752
07;2021-S10;2;5;7;788;1020;49;1808
07;2021-S10;4;4;8;678;870;59;1548
07;2021-S10;5;0;5;360;382;69;742
07;2021-S10;0;0;0;231;190;79;421
07;2021-S10;0;1;1;114;67;89;181
07;2021-S10;0;0;0;24;11;90;35
07;2021-S10;25;31;56;4671;5290;0;9961
08;2021-S10;0;1;1;2715.22592983026;2997.75551488675;09;5712.98144471701
08;2021-S10;4;0;4;2778.51901080978;3160.9156459093;19;5939.43465671908
08;2021-S10;1;1;2;2080.8882988764;1718.16634315323;29;3799.05464202964
08;2021-S10;0;0;0;2701.8582062647;1896.52641413317;39;4598.38462039786
08;2021-S10;1;1;2;3151.45861023308;2460.52498233809;49;5611.98359257117
08;2021-S10;5;2;7;2620.29868333099;2422.23566154656;59;5042.53434487755
08;2021-S10;2;2;4;1621.44173420671;1438.58325779464;69;3060.02499200135
08;2021-S10;1;1;2;626.575909335673;526.358467843651;79;1152.93437717932
08;2021-S10;0;0;0;205.018522985054;140.993639349697;89;346.012162334751
08;2021-S10;0;0;0;50.0325684687745;20.62259870351;90;70.6551671722846
08;2021-S10;14;8;22;18551.3174743414;16782.6825256586;0;35334
11;2021-S10;1414;1508;3111;783071;811785;09;1594856
11;2021-S10;3878;3919;8098;761456;784653;19;1546109
11;2021-S10;5640;5006;10680;850145;801772;29;1651917
11;2021-S10;5486;4904;10424;914360;843488;39;1757848
11;2021-S10;4762;4365;9156;845609;826202;49;1671811
11;2021-S10;3917;3688;7639;793566;745070;59;1538636
11;2021-S10;2356;2242;4671;628649;549192;69;1177841
11;2021-S10;1037;1017;2060;434606;358356;79;792962
11;2021-S10;602;417;1023;261425;162933;89;424358
11;2021-S10;247;97;344;89253;32619;90;121872
11;2021-S10;29344;27168;57220;6362140;5916070;0;12278210
24;2021-S10;91;114;208;139720;144686;09;284406
24;2021-S10;331;410;749;152979;161185;19;314164
24;2021-S10;416;457;875;122237;126536;29;248773
24;2021-S10;425;382;808;150359;142009;39;292368
24;2021-S10;397;413;811;161829;158758;49;320587
24;2021-S10;357;383;740;172552;168011;59;340563
24;2021-S10;260;251;512;172509;158177;69;330686
24;2021-S10;156;148;304;129428;110593;79;240021
24;2021-S10;94;62;156;87342;56882;89;144224
24;2021-S10;46;13;59;31210;12071;90;43281
24;2021-S10;2573;2633;5225;1320165;1238908;0;2559073
27;2021-S10;112;147;259;143373;149679;09;293052
27;2021-S10;443;503;951;160962;173003;19;333965
27;2021-S10;423;417;840;133746;142254;29;276000
27;2021-S10;409;342;752;160004;155407;39;315411
27;2021-S10;391;355;746;172333;169564;49;341897
27;2021-S10;355;325;680;189979;183788;59;373767
27;2021-S10;268;269;537;192591;178206;69;370797
27;2021-S10;162;164;326;146876;127546;79;274422
27;2021-S10;87;75;162;96896;61575;89;158471
27;2021-S10;49;18;67;33148;12109;90;45257
27;2021-S10;2699;2615;5321;1429908;1353131;0;2783039
28;2021-S10;190;181;378;180735;186856;09;367591
28;2021-S10;529;534;1075;200125;213621;19;413746
28;2021-S10;619;557;1178;168922;173007;29;341929
28;2021-S10;584;494;1078;196628;188487;39;385115
28;2021-S10;611;548;1159;205396;201699;49;407095
28;2021-S10;549;471;1021;222002;213866;59;435868
28;2021-S10;394;364;758;224688;203758;69;428446
28;2021-S10;271;227;498;163192;135543;79;298735
28;2021-S10;153;111;264;109691;65377;89;175068
28;2021-S10;77;35;112;37222;12685;90;49907
28;2021-S10;3977;3522;7521;1708601;1594899;0;3303500
32;2021-S10;634;760;1394;358062;373689;09;731751
32;2021-S10;1712;1720;3433;387045;406742;19;793787
32;2021-S10;1966;1752;3720;342304;348587;29;690891
32;2021-S10;1916;1655;3572;382485;369972;39;752457
32;2021-S10;1802;1738;3541;382510;376716;49;759226
32;2021-S10;1551;1494;3045;386937;376527;59;763464
32;2021-S10;1127;1018;2146;371211;330938;69;702149
32;2021-S10;744;644;1388;250542;201459;79;452001
32;2021-S10;472;276;748;163399;89786;89;253185
32;2021-S10;193;66;259;48384;15367;90;63751
32;2021-S10;12118;11126;23250;3072879;2889783;0;5962662
44;2021-S10;310;348;667;291525;306839;09;598364
44;2021-S10;893;928;1828;320255;339504;19;659759
44;2021-S10;1013;978;1994;302020;314428;29;616448
44;2021-S10;965;898;1871;342222;333292;39;675514
44;2021-S10;940;876;1821;349727;344491;49;694218
44;2021-S10;874;931;1813;381371;373239;59;754610
44;2021-S10;620;589;1212;367165;335850;69;703015
44;2021-S10;351;324;683;250387;215436;79;465823
44;2021-S10;290;188;484;170825;105192;89;276017
44;2021-S10;120;49;170;51248;16731;90;67979
44;2021-S10;6376;6111;12545;2826745;2685002;0;5511747
52;2021-S10;162;153;328;213594;223900;09;437494
52;2021-S10;478;513;1005;240818;255197;19;496015
52;2021-S10;552;551;1105;197010;200630;29;397640
52;2021-S10;438;426;864;231204;224885;39;456089
52;2021-S10;503;463;966;243874;243418;49;487292
52;2021-S10;440;444;885;244100;239116;59;483216
52;2021-S10;280;292;572;241796;221345;69;463141
52;2021-S10;209;190;399;177805;149903;79;327708
52;2021-S10;136;93;229;119561;75822;89;195383
52;2021-S10;64;25;89;42559;15260;90;57819
52;2021-S10;3262;3152;6444;1952321;1849476;0;3801797
53;2021-S10;109;115;226;173813;182358;09;356171
53;2021-S10;395;475;874;202720;214740;19;417460
53;2021-S10;454;432;890;163116;173196;29;336312
53;2021-S10;322;281;603;190526;187674;39;378200
53;2021-S10;346;355;701;212098;212015;49;424113
53;2021-S10;288;288;576;223699;219176;59;442875
53;2021-S10;202;171;373;227435;209274;69;436709
53;2021-S10;106;109;215;169992;140910;79;310902
53;2021-S10;73;36;109;118117;69883;89;188000
53;2021-S10;29;10;39;37370;12267;90;49637
53;2021-S10;2324;2272;4606;1718886;1621493;0;3340379
75;2021-S10;252;245;502;293104;305291;09;598395
75;2021-S10;665;700;1371;337141;357785;19;694926
75;2021-S10;624;596;1220;295024;300618;29;595642
75;2021-S10;634;528;1162;347871;331233;39;679104
75;2021-S10;638;551;1190;384742;372771;49;757513
75;2021-S10;538;480;1019;413361;390880;59;804241
75;2021-S10;359;374;734;425623;384060;69;809683
75;2021-S10;244;233;478;325086;276298;79;601384
75;2021-S10;145;119;264;213986;139308;89;353294
75;2021-S10;69;42;111;77600;28200;90;105800
75;2021-S10;4169;3870;8054;3113538;2886444;0;5999982
76;2021-S10;250;274;537;305956;318589;09;624545
76;2021-S10;775;789;1573;338942;356969;19;695911
76;2021-S10;801;677;1479;316210;319570;29;635780
76;2021-S10;840;697;1540;356758;337587;39;694345
76;2021-S10;829;697;1529;376541;363812;49;740353
76;2021-S10;704;682;1387;402608;383750;59;786358
76;2021-S10;496;439;936;394889;358997;69;753886
76;2021-S10;324;259;583;308664;263806;79;572470
76;2021-S10;190;115;306;195838;129272;89;325110
76;2021-S10;79;63;142;69372;26728;90;96100
76;2021-S10;5294;4696;10023;3065778;2859080;0;5924858
84;2021-S10;520;520;1064;459549;481088;09;940637
84;2021-S10;1442;1375;2824;487711;511905;19;999616
84;2021-S10;1494;1386;2880;443824;451094;29;894918
84;2021-S10;1448;1300;2750;512522;493262;39;1005784
84;2021-S10;1398;1275;2673;520248;515106;49;1035354
84;2021-S10;1127;1138;2267;529611;514848;59;1044459
84;2021-S10;818;762;1581;486720;439940;69;926660
84;2021-S10;487;465;952;372151;315211;79;687362
84;2021-S10;305;250;555;237198;150524;89;387722
84;2021-S10;145;63;208;81185;28680;90;109865
84;2021-S10;9184;8535;17756;4130719;3901658;0;8032377
93;2021-S10;362;378;741;268834;283093;09;551927
93;2021-S10;1235;1257;2500;280751;296087;19;576838
93;2021-S10;1506;1224;2734;254404;255552;29;509956
93;2021-S10;1518;1248;2772;310704;288398;39;599102
93;2021-S10;1607;1370;2980;325559;305827;49;631386
93;2021-S10;1453;1294;2750;353104;325389;59;678493
93;2021-S10;985;929;1917;336327;296459;69;632786
93;2021-S10;645;541;1188;279820;229699;79;509519
93;2021-S10;382;252;634;171274;113716;89;284990
93;2021-S10;170;84;254;58896;21758;90;80654
93;2021-S10;9866;8578;18481;2639673;2415978;0;5055651
94;2021-S10;12;11;23;16311;17433;09;33744
94;2021-S10;33;33;67;16679;18132;19;34811
94;2021-S10;39;30;69;16782;16579;29;33361
94;2021-S10;52;35;87;23044;20580;39;43624
94;2021-S10;35;48;83;23065;22140;49;45205
94;2021-S10;42;29;71;24549;23421;59;47970
94;2021-S10;21;39;60;23212;21883;69;45095
94;2021-S10;22;24;46;19544;17141;79;36685
94;2021-S10;13;14;27;11227;8178;89;19405
94;2021-S10;14;3;17;3332;1447;90;4779
94;2021-S10;283;266;550;177745;166934;0;344679
01;2021-S11;3;0;3;19979;20155;09;40134
01;2021-S11;26;24;50;24994;25489;19;50483
01;2021-S11;34;18;52;17868;16690;29;34558
01;2021-S11;47;28;75;22328;14821;39;37149
01;2021-S11;40;37;77;28652;20276;49;48928
01;2021-S11;52;35;87;33264;27260;59;60524
01;2021-S11;24;26;50;27135;23978;69;51113
01;2021-S11;11;13;24;18401;14661;79;33062
01;2021-S11;4;4;8;9633;6375;89;16008
01;2021-S11;2;1;3;3410;1510;90;4920
01;2021-S11;243;186;429;205664;171215;0;376879
02;2021-S11;5;4;9;16881;17110;09;33991
02;2021-S11;22;18;40;21410;21604;19;43014
02;2021-S11;44;29;73;16017;15479;29;31496
02;2021-S11;52;26;78;19825;14455;39;34280
02;2021-S11;37;32;69;24719;18248;49;42967
02;2021-S11;46;33;79;34361;28310;59;62671
02;2021-S11;18;24;42;28061;24495;69;52556
02;2021-S11;11;11;22;18231;15278;79;33509
02;2021-S11;3;2;5;11090;7677;89;18767
02;2021-S11;0;0;0;3992;1506;90;5498
02;2021-S11;238;179;417;194587;164162;0;358749
03;2021-S11;0;1;1;31123;30920;09;62043
03;2021-S11;7;9;16;29370;29268;19;58638
03;2021-S11;6;9;15;21458;18963;29;40421
03;2021-S11;15;8;23;21276;18326;39;39602
03;2021-S11;11;7;18;18164;16593;49;34757
03;2021-S11;6;8;14;13469;13557;59;27026
03;2021-S11;6;4;10;8776;8670;69;17446
03;2021-S11;2;2;4;3777;3591;79;7368
03;2021-S11;0;1;1;1649;1072;89;2721
03;2021-S11;0;0;0;485;184;90;669
03;2021-S11;53;49;102;149547;141144;0;290691
04;2021-S11;26;25;51;60314;61377;09;121691
04;2021-S11;90;62;152;66065;68387;19;134452
04;2021-S11;94;59;153;51059;47156;29;98215
04;2021-S11;90;77;167;58788;45780;39;104568
04;2021-S11;85;82;167;61408;52207;49;113615
04;2021-S11;80;80;160;64838;60759;59;125597
04;2021-S11;48;44;92;47008;42843;69;89851
04;2021-S11;18;15;33;25509;21184;79;46693
04;2021-S11;7;13;20;13168;7647;89;20815
04;2021-S11;3;1;4;3209;1253;90;4462
04;2021-S11;541;458;999;451366;408593;0;859959
05;2021-S11;0;0;0;362.366008612902;341.338819562748;09;703.704828175651
05;2021-S11;0;0;0;353.376145114279;370.349735405642;19;723.725880519921
05;2021-S11;0;0;0;218.593559489256;256.539602589476;29;475.133162078732
05;2021-S11;0;0;0;404.225408693299;360.321910454353;39;764.547319147651
05;2021-S11;0;0;0;520.067953604221;497.108383964256;49;1017.17633756848
05;2021-S11;0;0;0;468.146063921917;510.087601910415;59;978.233665832332
05;2021-S11;1;0;1;340.368470050554;334.366842191253;69;674.735312241807
05;2021-S11;0;0;0;212.598666888387;192.597753227106;79;405.196420115493
05;2021-S11;0;0;0;148.727797095705;61.8681715431829;89;210.595968638888
05;2021-S11;0;0;0;32.9601271090696;10.9909785719784;90;43.9511056810479
05;2021-S11;1;0;1;3061.43020057959;2935.56979942041;0;5997
06;2021-S11;6;5;11;42583;42380;09;84963
06;2021-S11;25;14;40;33369;31925;19;65294
06;2021-S11;30;16;46;21571;15080;29;36651
06;2021-S11;34;23;57;21550;16147;39;37697
06;2021-S11;25;28;53;14193;13939;49;28132
06;2021-S11;16;21;37;7171;7597;59;14768
06;2021-S11;25;25;50;3629;4117;69;7746
06;2021-S11;2;1;3;1577;1457;79;3034
06;2021-S11;3;1;4;531;474;89;1005
06;2021-S11;0;0;0;88;93;90;181
06;2021-S11;166;134;301;146262;133209;0;279471
07;2021-S11;2;3;5;485;549;09;1034
07;2021-S11;3;3;6;403;432;19;835
07;2021-S11;13;13;26;764;841;29;1605
07;2021-S11;8;11;19;824;928;39;1752
07;2021-S11;6;5;11;788;1020;49;1808
07;2021-S11;4;8;12;678;870;59;1548
07;2021-S11;3;2;5;360;382;69;742
07;2021-S11;1;0;1;231;190;79;421
07;2021-S11;0;0;0;114;67;89;181
07;2021-S11;0;0;0;24;11;90;35
07;2021-S11;40;45;85;4671;5290;0;9961
08;2021-S11;0;1;1;2715.22592983026;2997.75551488675;09;5712.98144471701
08;2021-S11;2;3;5;2778.51901080978;3160.9156459093;19;5939.43465671908
08;2021-S11;2;1;3;2080.8882988764;1718.16634315323;29;3799.05464202964
08;2021-S11;2;2;4;2701.8582062647;1896.52641413317;39;4598.38462039786
08;2021-S11;3;1;4;3151.45861023308;2460.52498233809;49;5611.98359257117
08;2021-S11;4;1;5;2620.29868333099;2422.23566154656;59;5042.53434487755
08;2021-S11;0;1;1;1621.44173420671;1438.58325779464;69;3060.02499200135
08;2021-S11;2;0;2;626.575909335673;526.358467843651;79;1152.93437717932
08;2021-S11;0;0;0;205.018522985054;140.993639349697;89;346.012162334751
08;2021-S11;0;0;0;50.0325684687745;20.62259870351;90;70.6551671722846
08;2021-S11;15;10;25;18551.3174743414;16782.6825256586;0;35334
11;2021-S11;2107;2303;4658;783071;811785;09;1594856
11;2021-S11;5100;5346;10880;761456;784653;19;1546109
11;2021-S11;6451;5556;12046;850145;801772;29;1651917
11;2021-S11;7027;5701;12778;914360;843488;39;1757848
11;2021-S11;6022;5440;11517;845609;826202;49;1671811
11;2021-S11;4560;4522;9126;793566;745070;59;1538636
11;2021-S11;2914;2738;5752;628649;549192;69;1177841
11;2021-S11;1230;1150;2389;434606;358356;79;792962
11;2021-S11;656;481;1140;261425;162933;89;424358
11;2021-S11;322;120;443;89253;32619;90;121872
11;2021-S11;36396;33365;70745;6362140;5916070;0;12278210
24;2021-S11;143;162;309;139720;144686;09;284406
24;2021-S11;514;501;1031;152979;161185;19;314164
24;2021-S11;490;487;978;122237;126536;29;248773
24;2021-S11;472;445;917;150359;142009;39;292368
24;2021-S11;532;443;976;161829;158758;49;320587
24;2021-S11;478;411;889;172552;168011;59;340563
24;2021-S11;303;312;615;172509;158177;69;330686
24;2021-S11;157;195;352;129428;110593;79;240021
24;2021-S11;119;76;195;87342;56882;89;144224
24;2021-S11;51;28;79;31210;12071;90;43281
24;2021-S11;3260;3060;6343;1320165;1238908;0;2559073
27;2021-S11;175;189;367;143373;149679;09;293052
27;2021-S11;495;518;1017;160962;173003;19;333965
27;2021-S11;461;493;954;133746;142254;29;276000
27;2021-S11;485;371;856;160004;155407;39;315411
27;2021-S11;475;376;851;172333;169564;49;341897
27;2021-S11;411;421;832;189979;183788;59;373767
27;2021-S11;313;310;623;192591;178206;69;370797
27;2021-S11;190;182;372;146876;127546;79;274422
27;2021-S11;115;71;186;96896;61575;89;158471
27;2021-S11;59;25;84;33148;12109;90;45257
27;2021-S11;3179;2956;6142;1429908;1353131;0;2783039
28;2021-S11;245;250;506;180735;186856;09;367591
28;2021-S11;635;714;1359;200125;213621;19;413746
28;2021-S11;777;677;1455;168922;173007;29;341929
28;2021-S11;806;683;1489;196628;188487;39;385115
28;2021-S11;740;653;1393;205396;201699;49;407095
28;2021-S11;695;622;1317;222002;213866;59;435868
28;2021-S11;566;512;1078;224688;203758;69;428446
28;2021-S11;295;250;545;163192;135543;79;298735
28;2021-S11;203;127;330;109691;65377;89;175068
28;2021-S11;118;39;157;37222;12685;90;49907
28;2021-S11;5080;4528;9630;1708601;1594899;0;3303500
32;2021-S11;893;1022;1920;358062;373689;09;731751
32;2021-S11;1970;1961;3935;387045;406742;19;793787
32;2021-S11;2205;1930;4138;342304;348587;29;690891
32;2021-S11;2208;1988;4199;382485;369972;39;752457
32;2021-S11;2117;1845;3963;382510;376716;49;759226
32;2021-S11;1834;1757;3592;386937;376527;59;763464
32;2021-S11;1222;1134;2356;371211;330938;69;702149
32;2021-S11;732;640;1372;250542;201459;79;452001
32;2021-S11;509;308;819;163399;89786;89;253185
32;2021-S11;226;83;309;48384;15367;90;63751
32;2021-S11;13920;12674;26613;3072879;2889783;0;5962662
44;2021-S11;480;422;913;291525;306839;09;598364
44;2021-S11;1075;1087;2174;320255;339504;19;659759
44;2021-S11;1171;1130;2304;302020;314428;29;616448
44;2021-S11;1132;980;2114;342222;333292;39;675514
44;2021-S11;1029;997;2030;349727;344491;49;694218
44;2021-S11;995;915;1914;381371;373239;59;754610
44;2021-S11;710;655;1369;367165;335850;69;703015
44;2021-S11;425;377;811;250387;215436;79;465823
44;2021-S11;261;171;437;170825;105192;89;276017
44;2021-S11;124;56;181;51248;16731;90;67979
44;2021-S11;7402;6790;14247;2826745;2685002;0;5511747
52;2021-S11;212;222;443;213594;223900;09;437494
52;2021-S11;614;660;1283;240818;255197;19;496015
52;2021-S11;641;622;1263;197010;200630;29;397640
52;2021-S11;614;488;1102;231204;224885;39;456089
52;2021-S11;573;484;1057;243874;243418;49;487292
52;2021-S11;475;488;964;244100;239116;59;483216
52;2021-S11;380;354;734;241796;221345;69;463141
52;2021-S11;226;211;437;177805;149903;79;327708
52;2021-S11;182;108;290;119561;75822;89;195383
52;2021-S11;95;35;130;42559;15260;90;57819
52;2021-S11;4012;3673;7704;1952321;1849476;0;3801797
53;2021-S11;182;160;345;173813;182358;09;356171
53;2021-S11;446;507;956;202720;214740;19;417460
53;2021-S11;533;539;1076;163116;173196;29;336312
53;2021-S11;424;388;813;190526;187674;39;378200
53;2021-S11;472;384;856;212098;212015;49;424113
53;2021-S11;329;314;643;223699;219176;59;442875
53;2021-S11;235;200;435;227435;209274;69;436709
53;2021-S11;120;112;232;169992;140910;79;310902
53;2021-S11;67;55;122;118117;69883;89;188000
53;2021-S11;30;15;45;37370;12267;90;49637
53;2021-S11;2838;2674;5524;1718886;1621493;0;3340379
75;2021-S11;293;299;600;293104;305291;09;598395
75;2021-S11;797;864;1666;337141;357785;19;694926
75;2021-S11;737;701;1440;295024;300618;29;595642
75;2021-S11;767;650;1418;347871;331233;39;679104
75;2021-S11;833;740;1575;384742;372771;49;757513
75;2021-S11;617;571;1188;413361;390880;59;804241
75;2021-S11;453;394;847;425623;384060;69;809683
75;2021-S11;257;235;493;325086;276298;79;601384
75;2021-S11;183;137;320;213986;139308;89;353294
75;2021-S11;94;39;133;77600;28200;90;105800
75;2021-S11;5033;4632;9684;3113538;2886444;0;5999982
76;2021-S11;360;345;720;305956;318589;09;624545
76;2021-S11;964;922;1909;338942;356969;19;695911
76;2021-S11;920;919;1840;316210;319570;29;635780
76;2021-S11;1052;837;1892;356758;337587;39;694345
76;2021-S11;975;885;1862;376541;363812;49;740353
76;2021-S11;836;697;1534;402608;383750;59;786358
76;2021-S11;594;504;1098;394889;358997;69;753886
76;2021-S11;349;363;714;308664;263806;79;572470
76;2021-S11;237;162;399;195838;129272;89;325110
76;2021-S11;110;47;157;69372;26728;90;96100
76;2021-S11;6401;5686;12135;3065778;2859080;0;5924858
84;2021-S11;666;687;1367;459549;481088;09;940637
84;2021-S11;1868;1928;3815;487711;511905;19;999616
84;2021-S11;1804;1602;3410;443824;451094;29;894918
84;2021-S11;1931;1566;3500;512522;493262;39;1005784
84;2021-S11;1816;1686;3503;520248;515106;49;1035354
84;2021-S11;1525;1426;2952;529611;514848;59;1044459
84;2021-S11;1059;918;1977;486720;439940;69;926660
84;2021-S11;583;545;1130;372151;315211;79;687362
84;2021-S11;305;233;538;237198;150524;89;387722
84;2021-S11;129;48;178;81185;28680;90;109865
84;2021-S11;11687;10641;22375;4130719;3901658;0;8032377
93;2021-S11;425;466;895;268834;283093;09;551927
93;2021-S11;1152;1162;2318;280751;296087;19;576838
93;2021-S11;1529;1264;2796;254404;255552;29;509956
93;2021-S11;1572;1298;2873;310704;288398;39;599102
93;2021-S11;1425;1278;2706;325559;305827;49;631386
93;2021-S11;1329;1225;2556;353104;325389;59;678493
93;2021-S11;935;823;1762;336327;296459;69;632786
93;2021-S11;567;535;1102;279820;229699;79;509519
93;2021-S11;383;249;632;171274;113716;89;284990
93;2021-S11;174;67;242;58896;21758;90;80654
93;2021-S11;9492;8369;17886;2639673;2415978;0;5055651
94;2021-S11;16;14;30;16311;17433;09;33744
94;2021-S11;28;30;60;16679;18132;19;34811
94;2021-S11;27;30;57;16782;16579;29;33361
94;2021-S11;50;26;76;23044;20580;39;43624
94;2021-S11;31;27;58;23065;22140;49;45205
94;2021-S11;40;25;65;24549;23421;59;47970
94;2021-S11;29;32;61;23212;21883;69;45095
94;2021-S11;21;16;37;19544;17141;79;36685
94;2021-S11;7;7;14;11227;8178;89;19405
94;2021-S11;5;0;5;3332;1447;90;4779
94;2021-S11;255;207;464;177745;166934;0;344679
01;2021-S12;1;9;10;19979;20155;09;40134
01;2021-S12;15;22;37;24994;25489;19;50483
01;2021-S12;32;22;54;17868;16690;29;34558
01;2021-S12;26;17;43;22328;14821;39;37149
01;2021-S12;35;30;65;28652;20276;49;48928
01;2021-S12;40;39;79;33264;27260;59;60524
01;2021-S12;30;24;54;27135;23978;69;51113
01;2021-S12;17;10;27;18401;14661;79;33062
01;2021-S12;7;4;11;9633;6375;89;16008
01;2021-S12;2;0;2;3410;1510;90;4920
01;2021-S12;205;177;382;205664;171215;0;376879
02;2021-S12;3;3;6;16881;17110;09;33991
02;2021-S12;43;31;74;21410;21604;19;43014
02;2021-S12;57;32;89;16017;15479;29;31496
02;2021-S12;53;35;88;19825;14455;39;34280
02;2021-S12;58;50;108;24719;18248;49;42967
02;2021-S12;65;44;109;34361;28310;59;62671
02;2021-S12;34;45;79;28061;24495;69;52556
02;2021-S12;20;23;44;18231;15278;79;33509
02;2021-S12;9;6;15;11090;7677;89;18767
02;2021-S12;4;0;4;3992;1506;90;5498
02;2021-S12;346;269;616;194587;164162;0;358749
03;2021-S12;3;3;6;31123;30920;09;62043
03;2021-S12;9;7;16;29370;29268;19;58638
03;2021-S12;8;7;15;21458;18963;29;40421
03;2021-S12;25;10;36;21276;18326;39;39602
03;2021-S12;8;23;31;18164;16593;49;34757
03;2021-S12;14;18;32;13469;13557;59;27026
03;2021-S12;19;10;29;8776;8670;69;17446
03;2021-S12;3;1;4;3777;3591;79;7368
03;2021-S12;3;1;4;1649;1072;89;2721
03;2021-S12;0;0;0;485;184;90;669
03;2021-S12;92;80;173;149547;141144;0;290691
04;2021-S12;36;25;61;60314;61377;09;121691
04;2021-S12;86;87;173;66065;68387;19;134452
04;2021-S12;94;73;168;51059;47156;29;98215
04;2021-S12;108;79;187;58788;45780;39;104568
04;2021-S12;86;71;157;61408;52207;49;113615
04;2021-S12;88;82;170;64838;60759;59;125597
04;2021-S12;63;69;132;47008;42843;69;89851
04;2021-S12;14;26;40;25509;21184;79;46693
04;2021-S12;12;7;19;13168;7647;89;20815
04;2021-S12;6;0;6;3209;1253;90;4462
04;2021-S12;593;519;1113;451366;408593;0;859959
05;2021-S12;0;0;0;362.366008612902;341.338819562748;09;703.704828175651
05;2021-S12;0;0;0;353.376145114279;370.349735405642;19;723.725880519921
05;2021-S12;0;0;0;218.593559489256;256.539602589476;29;475.133162078732
05;2021-S12;0;0;0;404.225408693299;360.321910454353;39;764.547319147651
05;2021-S12;0;0;0;520.067953604221;497.108383964256;49;1017.17633756848
05;2021-S12;0;0;0;468.146063921917;510.087601910415;59;978.233665832332
05;2021-S12;0;0;0;340.368470050554;334.366842191253;69;674.735312241807
05;2021-S12;0;0;0;212.598666888387;192.597753227106;79;405.196420115493
05;2021-S12;0;0;0;148.727797095705;61.8681715431829;89;210.595968638888
05;2021-S12;0;0;0;32.9601271090696;10.9909785719784;90;43.9511056810479
05;2021-S12;0;0;0;3061.43020057959;2935.56979942041;0;5997
06;2021-S12;2;2;4;42583;42380;09;84963
06;2021-S12;11;14;25;33369;31925;19;65294
06;2021-S12;20;14;34;21571;15080;29;36651
06;2021-S12;26;14;40;21550;16147;39;37697
06;2021-S12;17;15;32;14193;13939;49;28132
06;2021-S12;8;10;18;7171;7597;59;14768
06;2021-S12;17;15;32;3629;4117;69;7746
06;2021-S12;2;0;2;1577;1457;79;3034
06;2021-S12;2;0;2;531;474;89;1005
06;2021-S12;0;0;0;88;93;90;181
06;2021-S12;105;84;189;146262;133209;0;279471
07;2021-S12;0;1;1;485;549;09;1034
07;2021-S12;2;0;2;403;432;19;835
07;2021-S12;8;9;17;764;841;29;1605
07;2021-S12;8;9;17;824;928;39;1752
07;2021-S12;5;1;6;788;1020;49;1808
07;2021-S12;5;3;8;678;870;59;1548
07;2021-S12;0;2;2;360;382;69;742
07;2021-S12;2;0;2;231;190;79;421
07;2021-S12;0;0;0;114;67;89;181
07;2021-S12;0;0;0;24;11;90;35
07;2021-S12;30;25;55;4671;5290;0;9961
08;2021-S12;0;0;0;2715.22592983026;2997.75551488675;09;5712.98144471701
08;2021-S12;0;2;2;2778.51901080978;3160.9156459093;19;5939.43465671908
08;2021-S12;6;1;7;2080.8882988764;1718.16634315323;29;3799.05464202964
08;2021-S12;2;1;3;2701.8582062647;1896.52641413317;39;4598.38462039786
08;2021-S12;5;3;8;3151.45861023308;2460.52498233809;49;5611.98359257117
08;2021-S12;3;6;9;2620.29868333099;2422.23566154656;59;5042.53434487755
08;2021-S12;1;0;1;1621.44173420671;1438.58325779464;69;3060.02499200135
08;2021-S12;2;0;2;626.575909335673;526.358467843651;79;1152.93437717932
08;2021-S12;0;0;0;205.018522985054;140.993639349697;89;346.012162334751
08;2021-S12;0;0;0;50.0325684687745;20.62259870351;90;70.6551671722846
08;2021-S12;19;13;32;18551.3174743414;16782.6825256586;0;35334
11;2021-S12;2561;2714;5528;783071;811785;09;1594856
11;2021-S12;6610;6759;13854;761456;784653;19;1546109
11;2021-S12;7374;6325;13743;850145;801772;29;1651917
11;2021-S12;8193;6719;14949;914360;843488;39;1757848
11;2021-S12;7366;6528;13941;845609;826202;49;1671811
11;2021-S12;5167;5081;10286;793566;745070;59;1538636
11;2021-S12;3297;3180;6619;628649;549192;69;1177841
11;2021-S12;1364;1256;2625;434606;358356;79;792962
11;2021-S12;714;517;1235;261425;162933;89;424358
11;2021-S12;335;146;482;89253;32619;90;121872
11;2021-S12;42990;39242;83293;6362140;5916070;0;12278210
24;2021-S12;214;211;438;139720;144686;09;284406
24;2021-S12;613;636;1264;152979;161185;19;314164
24;2021-S12;592;512;1105;122237;126536;29;248773
24;2021-S12;660;533;1195;150359;142009;39;292368
24;2021-S12;703;584;1289;161829;158758;49;320587
24;2021-S12;569;537;1106;172552;168011;59;340563
24;2021-S12;342;343;686;172509;158177;69;330686
24;2021-S12;217;237;454;129428;110593;79;240021
24;2021-S12;120;77;197;87342;56882;89;144224
24;2021-S12;65;30;95;31210;12071;90;43281
24;2021-S12;4095;3700;7829;1320165;1238908;0;2559073
27;2021-S12;217;240;459;143373;149679;09;293052
27;2021-S12;703;745;1453;160962;173003;19;333965
27;2021-S12;563;539;1102;133746;142254;29;276000
27;2021-S12;617;540;1158;160004;155407;39;315411
27;2021-S12;686;632;1318;172333;169564;49;341897
27;2021-S12;541;588;1129;189979;183788;59;373767
27;2021-S12;419;439;858;192591;178206;69;370797
27;2021-S12;237;244;481;146876;127546;79;274422
27;2021-S12;134;100;234;96896;61575;89;158471
27;2021-S12;63;26;89;33148;12109;90;45257
27;2021-S12;4180;4093;8281;1429908;1353131;0;2783039
28;2021-S12;379;369;771;180735;186856;09;367591
28;2021-S12;932;914;1866;200125;213621;19;413746
28;2021-S12;874;760;1636;168922;173007;29;341929
28;2021-S12;933;822;1756;196628;188487;39;385115
28;2021-S12;865;766;1631;205396;201699;49;407095
28;2021-S12;802;746;1548;222002;213866;59;435868
28;2021-S12;549;511;1060;224688;203758;69;428446
28;2021-S12;342;312;654;163192;135543;79;298735
28;2021-S12;226;137;363;109691;65377;89;175068
28;2021-S12;89;39;128;37222;12685;90;49907
28;2021-S12;5992;5376;11414;1708601;1594899;0;3303500
32;2021-S12;1174;1246;2424;358062;373689;09;731751
32;2021-S12;2530;2549;5087;387045;406742;19;793787
32;2021-S12;2588;2186;4778;342304;348587;29;690891
32;2021-S12;2611;2312;4925;382485;369972;39;752457
32;2021-S12;2474;2286;4761;382510;376716;49;759226
32;2021-S12;2163;1957;4123;386937;376527;59;763464
32;2021-S12;1308;1201;2512;371211;330938;69;702149
32;2021-S12;753;666;1419;250542;201459;79;452001
32;2021-S12;530;290;820;163399;89786;89;253185
32;2021-S12;246;90;336;48384;15367;90;63751
32;2021-S12;16381;14785;31191;3072879;2889783;0;5962662
44;2021-S12;532;635;1180;291525;306839;09;598364
44;2021-S12;1382;1377;2767;320255;339504;19;659759
44;2021-S12;1180;1149;2332;302020;314428;29;616448
44;2021-S12;1300;1123;2431;342222;333292;39;675514
44;2021-S12;1336;1225;2565;349727;344491;49;694218
44;2021-S12;1086;1108;2205;381371;373239;59;754610
44;2021-S12;810;770;1587;367165;335850;69;703015
44;2021-S12;433;433;869;250387;215436;79;465823
44;2021-S12;301;189;495;170825;105192;89;276017
44;2021-S12;137;52;190;51248;16731;90;67979
44;2021-S12;8497;8062;16623;2826745;2685002;0;5511747
52;2021-S12;365;333;709;213594;223900;09;437494
52;2021-S12;892;897;1805;240818;255197;19;496015
52;2021-S12;748;695;1443;197010;200630;29;397640
52;2021-S12;825;758;1583;231204;224885;39;456089
52;2021-S12;812;713;1525;243874;243418;49;487292
52;2021-S12;650;612;1262;244100;239116;59;483216
52;2021-S12;490;431;922;241796;221345;69;463141
52;2021-S12;267;240;507;177805;149903;79;327708
52;2021-S12;183;110;294;119561;75822;89;195383
52;2021-S12;81;37;118;42559;15260;90;57819
52;2021-S12;5313;4826;10168;1952321;1849476;0;3801797
53;2021-S12;240;258;498;173813;182358;09;356171
53;2021-S12;549;659;1215;202720;214740;19;417460
53;2021-S12;524;531;1069;163116;173196;29;336312
53;2021-S12;520;428;949;190526;187674;39;378200
53;2021-S12;477;401;879;212098;212015;49;424113
53;2021-S12;371;386;757;223699;219176;59;442875
53;2021-S12;259;275;535;227435;209274;69;436709
53;2021-S12;156;132;288;169992;140910;79;310902
53;2021-S12;95;72;167;118117;69883;89;188000
53;2021-S12;19;20;39;37370;12267;90;49637
53;2021-S12;3212;3162;6400;1718886;1621493;0;3340379
75;2021-S12;348;375;726;293104;305291;09;598395
75;2021-S12;1023;1213;2243;337141;357785;19;694926
75;2021-S12;926;872;1798;295024;300618;29;595642
75;2021-S12;906;838;1745;347871;331233;39;679104
75;2021-S12;1028;879;1907;384742;372771;49;757513
75;2021-S12;781;773;1554;413361;390880;59;804241
75;2021-S12;498;509;1007;425623;384060;69;809683
75;2021-S12;255;299;554;325086;276298;79;601384
75;2021-S12;190;113;303;213986;139308;89;353294
75;2021-S12;107;41;148;77600;28200;90;105800
75;2021-S12;6064;5915;11990;3113538;2886444;0;5999982
76;2021-S12;452;463;943;305956;318589;09;624545
76;2021-S12;1379;1418;2828;338942;356969;19;695911
76;2021-S12;1272;1102;2374;316210;319570;29;635780
76;2021-S12;1407;1160;2569;356758;337587;39;694345
76;2021-S12;1344;1279;2624;376541;363812;49;740353
76;2021-S12;1104;1047;2154;402608;383750;59;786358
76;2021-S12;791;728;1519;394889;358997;69;753886
76;2021-S12;462;420;883;308664;263806;79;572470
76;2021-S12;307;204;511;195838;129272;89;325110
76;2021-S12;133;67;200;69372;26728;90;96100
76;2021-S12;8662;7894;16622;3065778;2859080;0;5924858
84;2021-S12;842;874;1725;459549;481088;09;940637
84;2021-S12;2373;2562;4951;487711;511905;19;999616
84;2021-S12;2198;2059;4259;443824;451094;29;894918
84;2021-S12;2478;1941;4422;512522;493262;39;1005784
84;2021-S12;2321;2142;4466;520248;515106;49;1035354
84;2021-S12;1972;1925;3897;529611;514848;59;1044459
84;2021-S12;1195;1144;2341;486720;439940;69;926660
84;2021-S12;757;688;1445;372151;315211;79;687362
84;2021-S12;449;316;765;237198;150524;89;387722
84;2021-S12;194;85;279;81185;28680;90;109865
84;2021-S12;14782;13738;28560;4130719;3901658;0;8032377
93;2021-S12;543;593;1144;268834;283093;09;551927
93;2021-S12;1770;1760;3549;280751;296087;19;576838
93;2021-S12;1973;1621;3596;254404;255552;29;509956
93;2021-S12;2160;1744;3906;310704;288398;39;599102
93;2021-S12;1911;1735;3651;325559;305827;49;631386
93;2021-S12;1773;1543;3319;353104;325389;59;678493
93;2021-S12;1192;1079;2273;336327;296459;69;632786
93;2021-S12;671;617;1289;279820;229699;79;509519
93;2021-S12;416;271;687;171274;113716;89;284990
93;2021-S12;193;51;244;58896;21758;90;80654
93;2021-S12;12603;11018;23663;2639673;2415978;0;5055651
94;2021-S12;8;11;19;16311;17433;09;33744
94;2021-S12;25;28;53;16679;18132;19;34811
94;2021-S12;37;32;69;16782;16579;29;33361
94;2021-S12;48;38;86;23044;20580;39;43624
94;2021-S12;34;34;68;23065;22140;49;45205
94;2021-S12;40;36;76;24549;23421;59;47970
94;2021-S12;40;33;73;23212;21883;69;45095
94;2021-S12;24;28;52;19544;17141;79;36685
94;2021-S12;13;10;23;11227;8178;89;19405
94;2021-S12;12;0;12;3332;1447;90;4779
94;2021-S12;281;250;531;177745;166934;0;344679
01;2021-S13;1;2;3;19979;20155;09;40134
01;2021-S13;9;15;24;24994;25489;19;50483
01;2021-S13;35;17;52;17868;16690;29;34558
01;2021-S13;53;24;77;22328;14821;39;37149
01;2021-S13;35;31;66;28652;20276;49;48928
01;2021-S13;50;45;95;33264;27260;59;60524
01;2021-S13;37;26;63;27135;23978;69;51113
01;2021-S13;20;13;33;18401;14661;79;33062
01;2021-S13;13;8;21;9633;6375;89;16008
01;2021-S13;5;0;5;3410;1510;90;4920
01;2021-S13;258;181;439;205664;171215;0;376879
02;2021-S13;6;8;14;16881;17110;09;33991
02;2021-S13;36;23;59;21410;21604;19;43014
02;2021-S13;50;41;92;16017;15479;29;31496
02;2021-S13;55;42;97;19825;14455;39;34280
02;2021-S13;75;53;128;24719;18248;49;42967
02;2021-S13;85;63;148;34361;28310;59;62671
02;2021-S13;53;52;107;28061;24495;69;52556
02;2021-S13;27;37;64;18231;15278;79;33509
02;2021-S13;10;11;21;11090;7677;89;18767
02;2021-S13;2;1;3;3992;1506;90;5498
02;2021-S13;399;331;733;194587;164162;0;358749
03;2021-S13;4;3;7;31123;30920;09;62043
03;2021-S13;10;9;19;29370;29268;19;58638
03;2021-S13;19;12;31;21458;18963;29;40421
03;2021-S13;19;17;36;21276;18326;39;39602
03;2021-S13;30;27;57;18164;16593;49;34757
03;2021-S13;21;30;52;13469;13557;59;27026
03;2021-S13;16;12;28;8776;8670;69;17446
03;2021-S13;5;3;8;3777;3591;79;7368
03;2021-S13;4;1;5;1649;1072;89;2721
03;2021-S13;0;1;1;485;184;90;669
03;2021-S13;128;115;244;149547;141144;0;290691
04;2021-S13;43;40;83;60314;61377;09;121691
04;2021-S13;87;83;170;66065;68387;19;134452
04;2021-S13;82;68;150;51059;47156;29;98215
04;2021-S13;93;85;178;58788;45780;39;104568
04;2021-S13;74;72;146;61408;52207;49;113615
04;2021-S13;82;52;134;64838;60759;59;125597
04;2021-S13;41;35;76;47008;42843;69;89851
04;2021-S13;21;25;46;25509;21184;79;46693
04;2021-S13;9;8;17;13168;7647;89;20815
04;2021-S13;4;0;4;3209;1253;90;4462
04;2021-S13;536;468;1004;451366;408593;0;859959
05;2021-S13;0;0;0;362.366008612902;341.338819562748;09;703.704828175651
05;2021-S13;0;0;0;353.376145114279;370.349735405642;19;723.725880519921
05;2021-S13;0;0;0;218.593559489256;256.539602589476;29;475.133162078732
05;2021-S13;0;0;0;404.225408693299;360.321910454353;39;764.547319147651
05;2021-S13;1;0;1;520.067953604221;497.108383964256;49;1017.17633756848
05;2021-S13;0;0;0;468.146063921917;510.087601910415;59;978.233665832332
05;2021-S13;0;0;0;340.368470050554;334.366842191253;69;674.735312241807
05;2021-S13;0;0;0;212.598666888387;192.597753227106;79;405.196420115493
05;2021-S13;0;0;0;148.727797095705;61.8681715431829;89;210.595968638888
05;2021-S13;0;0;0;32.9601271090696;10.9909785719784;90;43.9511056810479
05;2021-S13;1;0;1;3061.43020057959;2935.56979942041;0;5997
06;2021-S13;6;0;6;42583;42380;09;84963
06;2021-S13;24;14;40;33369;31925;19;65294
06;2021-S13;24;17;41;21571;15080;29;36651
06;2021-S13;16;16;32;21550;16147;39;37697
06;2021-S13;19;4;23;14193;13939;49;28132
06;2021-S13;11;8;19;7171;7597;59;14768
06;2021-S13;5;5;10;3629;4117;69;7746
06;2021-S13;3;1;4;1577;1457;79;3034
06;2021-S13;0;1;1;531;474;89;1005
06;2021-S13;0;0;0;88;93;90;181
06;2021-S13;108;66;176;146262;133209;0;279471
07;2021-S13;0;0;0;485;549;09;1034
07;2021-S13;1;0;1;403;432;19;835
07;2021-S13;2;1;3;764;841;29;1605
07;2021-S13;2;2;4;824;928;39;1752
07;2021-S13;2;2;4;788;1020;49;1808
07;2021-S13;1;2;3;678;870;59;1548
07;2021-S13;2;2;4;360;382;69;742
07;2021-S13;1;0;1;231;190;79;421
07;2021-S13;0;0;0;114;67;89;181
07;2021-S13;0;0;0;24;11;90;35
07;2021-S13;11;9;20;4671;5290;0;9961
08;2021-S13;0;0;0;2715.22592983026;2997.75551488675;09;5712.98144471701
08;2021-S13;3;3;6;2778.51901080978;3160.9156459093;19;5939.43465671908
08;2021-S13;2;0;2;2080.8882988764;1718.16634315323;29;3799.05464202964
08;2021-S13;3;0;3;2701.8582062647;1896.52641413317;39;4598.38462039786
08;2021-S13;3;0;3;3151.45861023308;2460.52498233809;49;5611.98359257117
08;2021-S13;0;2;2;2620.29868333099;2422.23566154656;59;5042.53434487755
08;2021-S13;1;1;2;1621.44173420671;1438.58325779464;69;3060.02499200135
08;2021-S13;0;0;0;626.575909335673;526.358467843651;79;1152.93437717932
08;2021-S13;0;0;0;205.018522985054;140.993639349697;89;346.012162334751
08;2021-S13;0;0;0;50.0325684687745;20.62259870351;90;70.6551671722846
08;2021-S13;12;6;18;18551.3174743414;16782.6825256586;0;35334
11;2021-S13;2529;2601;5414;783071;811785;09;1594856
11;2021-S13;6693;6695;13913;761456;784653;19;1546109
11;2021-S13;7422;6656;14127;850145;801772;29;1651917
11;2021-S13;8146;7089;15277;914360;843488;39;1757848
11;2021-S13;7386;6954;14400;845609;826202;49;1671811
11;2021-S13;5319;5264;10623;793566;745070;59;1538636
11;2021-S13;3071;2852;6003;628649;549192;69;1177841
11;2021-S13;1291;1258;2559;434606;358356;79;792962
11;2021-S13;776;546;1326;261425;162933;89;424358
11;2021-S13;358;169;527;89253;32619;90;121872
11;2021-S13;43001;40105;84205;6362140;5916070;0;12278210
24;2021-S13;202;219;429;139720;144686;09;284406
24;2021-S13;655;717;1393;152979;161185;19;314164
24;2021-S13;707;625;1332;122237;126536;29;248773
24;2021-S13;740;616;1361;150359;142009;39;292368
24;2021-S13;686;668;1355;161829;158758;49;320587
24;2021-S13;617;594;1212;172552;168011;59;340563
24;2021-S13;361;397;760;172509;158177;69;330686
24;2021-S13;253;246;500;129428;110593;79;240021
24;2021-S13;143;89;232;87342;56882;89;144224
24;2021-S13;65;39;104;31210;12071;90;43281
24;2021-S13;4431;4210;8681;1320165;1238908;0;2559073
27;2021-S13;247;270;521;143373;149679;09;293052
27;2021-S13;762;770;1538;160962;173003;19;333965
27;2021-S13;702;693;1395;133746;142254;29;276000
27;2021-S13;755;614;1369;160004;155407;39;315411
27;2021-S13;761;724;1485;172333;169564;49;341897
27;2021-S13;661;637;1298;189979;183788;59;373767
27;2021-S13;487;478;965;192591;178206;69;370797
27;2021-S13;301;253;554;146876;127546;79;274422
27;2021-S13;199;113;312;96896;61575;89;158471
27;2021-S13;94;36;130;33148;12109;90;45257
27;2021-S13;4969;4589;9568;1429908;1353131;0;2783039
28;2021-S13;352;361;738;180735;186856;09;367591
28;2021-S13;926;1045;1995;200125;213621;19;413746
28;2021-S13;863;836;1704;168922;173007;29;341929
28;2021-S13;846;790;1639;196628;188487;39;385115
28;2021-S13;912;880;1793;205396;201699;49;407095
28;2021-S13;785;785;1570;222002;213866;59;435868
28;2021-S13;571;559;1130;224688;203758;69;428446
28;2021-S13;333;279;612;163192;135543;79;298735
28;2021-S13;238;114;352;109691;65377;89;175068
28;2021-S13;109;51;160;37222;12685;90;49907
28;2021-S13;5936;5704;11699;1708601;1594899;0;3303500
32;2021-S13;1076;1085;2169;358062;373689;09;731751
32;2021-S13;2547;2620;5175;387045;406742;19;793787
32;2021-S13;2370;2152;4527;342304;348587;29;690891
32;2021-S13;2545;2177;4726;382485;369972;39;752457
32;2021-S13;2372;2238;4613;382510;376716;49;759226
32;2021-S13;2064;2015;4083;386937;376527;59;763464
32;2021-S13;1337;1142;2481;371211;330938;69;702149
32;2021-S13;702;653;1355;250542;201459;79;452001
32;2021-S13;501;299;800;163399;89786;89;253185
32;2021-S13;198;85;283;48384;15367;90;63751
32;2021-S13;15718;14470;30222;3072879;2889783;0;5962662
44;2021-S13;560;566;1134;291525;306839;09;598364
44;2021-S13;1418;1428;2863;320255;339504;19;659759
44;2021-S13;1370;1283;2656;302020;314428;29;616448
44;2021-S13;1419;1254;2680;342222;333292;39;675514
44;2021-S13;1349;1301;2656;349727;344491;49;694218
44;2021-S13;1146;1209;2361;381371;373239;59;754610
44;2021-S13;868;813;1685;367165;335850;69;703015
44;2021-S13;451;467;922;250387;215436;79;465823
44;2021-S13;309;194;510;170825;105192;89;276017
44;2021-S13;133;52;185;51248;16731;90;67979
44;2021-S13;9025;8567;17655;2826745;2685002;0;5511747
52;2021-S13;350;346;705;213594;223900;09;437494
52;2021-S13;1058;1106;2177;240818;255197;19;496015
52;2021-S13;985;993;1980;197010;200630;29;397640
52;2021-S13;900;782;1682;231204;224885;39;456089
52;2021-S13;929;823;1753;243874;243418;49;487292
52;2021-S13;740;703;1443;244100;239116;59;483216
52;2021-S13;471;485;956;241796;221345;69;463141
52;2021-S13;302;281;583;177805;149903;79;327708
52;2021-S13;160;119;279;119561;75822;89;195383
52;2021-S13;63;42;105;42559;15260;90;57819
52;2021-S13;5959;5681;11665;1952321;1849476;0;3801797
53;2021-S13;231;240;474;173813;182358;09;356171
53;2021-S13;625;675;1306;202720;214740;19;417460
53;2021-S13;537;548;1091;163116;173196;29;336312
53;2021-S13;524;486;1011;190526;187674;39;378200
53;2021-S13;559;510;1070;212098;212015;49;424113
53;2021-S13;447;449;896;223699;219176;59;442875
53;2021-S13;242;290;532;227435;209274;69;436709
53;2021-S13;202;151;353;169992;140910;79;310902
53;2021-S13;95;71;166;118117;69883;89;188000
53;2021-S13;40;18;58;37370;12267;90;49637
53;2021-S13;3502;3439;6960;1718886;1621493;0;3340379
75;2021-S13;351;336;692;293104;305291;09;598395
75;2021-S13;1274;1305;2590;337141;357785;19;694926
75;2021-S13;1135;1160;2297;295024;300618;29;595642
75;2021-S13;1035;850;1888;347871;331233;39;679104
75;2021-S13;1136;1041;2179;384742;372771;49;757513
75;2021-S13;877;873;1750;413361;390880;59;804241
75;2021-S13;596;573;1169;425623;384060;69;809683
75;2021-S13;282;326;609;325086;276298;79;601384
75;2021-S13;179;124;304;213986;139308;89;353294
75;2021-S13;108;44;152;77600;28200;90;105800
75;2021-S13;6975;6636;13636;3113538;2886444;0;5999982
76;2021-S13;470;490;981;305956;318589;09;624545
76;2021-S13;1443;1564;3042;338942;356969;19;695911
76;2021-S13;1539;1428;2969;316210;319570;29;635780
76;2021-S13;1568;1293;2865;356758;337587;39;694345
76;2021-S13;1653;1440;3096;376541;363812;49;740353
76;2021-S13;1301;1278;2584;402608;383750;59;786358
76;2021-S13;873;770;1644;394889;358997;69;753886
76;2021-S13;536;477;1014;308664;263806;79;572470
76;2021-S13;367;219;586;195838;129272;89;325110
76;2021-S13;204;93;297;69372;26728;90;96100
76;2021-S13;9961;9060;19093;3065778;2859080;0;5924858
84;2021-S13;887;908;1808;459549;481088;09;940637
84;2021-S13;2730;2920;5667;487711;511905;19;999616
84;2021-S13;2610;2503;5120;443824;451094;29;894918
84;2021-S13;2708;2249;4959;512522;493262;39;1005784
84;2021-S13;2681;2403;5088;520248;515106;49;1035354
84;2021-S13;2224;2199;4424;529611;514848;59;1044459
84;2021-S13;1380;1301;2682;486720;439940;69;926660
84;2021-S13;842;789;1631;372151;315211;79;687362
84;2021-S13;465;358;823;237198;150524;89;387722
84;2021-S13;184;82;266;81185;28680;90;109865
84;2021-S13;16714;15715;32475;4130719;3901658;0;8032377
93;2021-S13;617;625;1249;268834;283093;09;551927
93;2021-S13;1860;1910;3793;280751;296087;19;576838
93;2021-S13;2083;1822;3912;254404;255552;29;509956
93;2021-S13;2228;1833;4072;310704;288398;39;599102
93;2021-S13;2228;1927;4157;325559;305827;49;631386
93;2021-S13;2027;1741;3773;353104;325389;59;678493
93;2021-S13;1267;1166;2435;336327;296459;69;632786
93;2021-S13;691;604;1295;279820;229699;79;509519
93;2021-S13;389;286;677;171274;113716;89;284990
93;2021-S13;178;68;246;58896;21758;90;80654
93;2021-S13;13570;11989;25626;2639673;2415978;0;5055651
94;2021-S13;13;15;29;16311;17433;09;33744
94;2021-S13;26;37;63;16679;18132;19;34811
94;2021-S13;27;39;66;16782;16579;29;33361
94;2021-S13;52;34;86;23044;20580;39;43624
94;2021-S13;48;53;101;23065;22140;49;45205
94;2021-S13;38;33;72;24549;23421;59;47970
94;2021-S13;31;33;64;23212;21883;69;45095
94;2021-S13;31;10;41;19544;17141;79;36685
94;2021-S13;10;9;19;11227;8178;89;19405
94;2021-S13;3;4;7;3332;1447;90;4779
94;2021-S13;279;267;548;177745;166934;0;344679
01;2021-S14;7;4;11;19979;20155;09;40134
01;2021-S14;32;22;54;24994;25489;19;50483
01;2021-S14;45;29;74;17868;16690;29;34558
01;2021-S14;60;34;94;22328;14821;39;37149
01;2021-S14;80;49;129;28652;20276;49;48928
01;2021-S14;73;53;126;33264;27260;59;60524
01;2021-S14;55;41;96;27135;23978;69;51113
01;2021-S14;31;25;56;18401;14661;79;33062
01;2021-S14;7;9;16;9633;6375;89;16008
01;2021-S14;1;1;2;3410;1510;90;4920
01;2021-S14;391;267;658;205664;171215;0;376879
02;2021-S14;11;16;27;16881;17110;09;33991
02;2021-S14;30;30;60;21410;21604;19;43014
02;2021-S14;43;37;80;16017;15479;29;31496
02;2021-S14;74;41;115;19825;14455;39;34280
02;2021-S14;83;65;148;24719;18248;49;42967
02;2021-S14;117;89;206;34361;28310;59;62671
02;2021-S14;80;65;145;28061;24495;69;52556
02;2021-S14;29;29;58;18231;15278;79;33509
02;2021-S14;11;13;24;11090;7677;89;18767
02;2021-S14;7;3;10;3992;1506;90;5498
02;2021-S14;485;388;873;194587;164162;0;358749
03;2021-S14;9;10;19;31123;30920;09;62043
03;2021-S14;21;15;36;29370;29268;19;58638
03;2021-S14;45;39;84;21458;18963;29;40421
03;2021-S14;52;40;92;21276;18326;39;39602
03;2021-S14;39;36;75;18164;16593;49;34757
03;2021-S14;30;21;51;13469;13557;59;27026
03;2021-S14;29;16;45;8776;8670;69;17446
03;2021-S14;5;5;10;3777;3591;79;7368
03;2021-S14;2;2;4;1649;1072;89;2721
03;2021-S14;1;0;1;485;184;90;669
03;2021-S14;234;184;418;149547;141144;0;290691
04;2021-S14;55;46;101;60314;61377;09;121691
04;2021-S14;95;89;184;66065;68387;19;134452
04;2021-S14;96;69;165;51059;47156;29;98215
04;2021-S14;85;77;162;58788;45780;39;104568
04;2021-S14;84;75;159;61408;52207;49;113615
04;2021-S14;59;63;122;64838;60759;59;125597
04;2021-S14;27;26;53;47008;42843;69;89851
04;2021-S14;19;15;34;25509;21184;79;46693
04;2021-S14;12;2;14;13168;7647;89;20815
04;2021-S14;3;2;5;3209;1253;90;4462
04;2021-S14;535;464;999;451366;408593;0;859959
05;2021-S14;0;0;0;362.366008612902;341.338819562748;09;703.704828175651
05;2021-S14;0;0;0;353.376145114279;370.349735405642;19;723.725880519921
05;2021-S14;0;0;0;218.593559489256;256.539602589476;29;475.133162078732
05;2021-S14;0;0;0;404.225408693299;360.321910454353;39;764.547319147651
05;2021-S14;0;0;0;520.067953604221;497.108383964256;49;1017.17633756848
05;2021-S14;0;0;0;468.146063921917;510.087601910415;59;978.233665832332
05;2021-S14;1;0;1;340.368470050554;334.366842191253;69;674.735312241807
05;2021-S14;0;0;0;212.598666888387;192.597753227106;79;405.196420115493
05;2021-S14;0;0;0;148.727797095705;61.8681715431829;89;210.595968638888
05;2021-S14;0;0;0;32.9601271090696;10.9909785719784;90;43.9511056810479
05;2021-S14;1;0;1;3061.43020057959;2935.56979942041;0;5997
06;2021-S14;5;1;6;42583;42380;09;84963
06;2021-S14;21;11;32;33369;31925;19;65294
06;2021-S14;13;12;26;21571;15080;29;36651
06;2021-S14;11;12;23;21550;16147;39;37697
06;2021-S14;20;11;31;14193;13939;49;28132
06;2021-S14;4;6;10;7171;7597;59;14768
06;2021-S14;5;0;5;3629;4117;69;7746
06;2021-S14;0;1;1;1577;1457;79;3034
06;2021-S14;1;0;1;531;474;89;1005
06;2021-S14;0;0;0;88;93;90;181
06;2021-S14;80;54;135;146262;133209;0;279471
07;2021-S14;0;0;0;485;549;09;1034
07;2021-S14;1;0;1;403;432;19;835
07;2021-S14;3;1;4;764;841;29;1605
07;2021-S14;2;2;4;824;928;39;1752
07;2021-S14;1;3;4;788;1020;49;1808
07;2021-S14;4;2;6;678;870;59;1548
07;2021-S14;5;0;5;360;382;69;742
07;2021-S14;1;1;2;231;190;79;421
07;2021-S14;0;1;1;114;67;89;181
07;2021-S14;0;0;0;24;11;90;35
07;2021-S14;17;10;27;4671;5290;0;9961
08;2021-S14;0;0;0;2715.22592983026;2997.75551488675;09;5712.98144471701
08;2021-S14;0;0;0;2778.51901080978;3160.9156459093;19;5939.43465671908
08;2021-S14;1;1;2;2080.8882988764;1718.16634315323;29;3799.05464202964
08;2021-S14;0;0;0;2701.8582062647;1896.52641413317;39;4598.38462039786
08;2021-S14;3;0;3;3151.45861023308;2460.52498233809;49;5611.98359257117
08;2021-S14;0;0;0;2620.29868333099;2422.23566154656;59;5042.53434487755
08;2021-S14;0;0;0;1621.44173420671;1438.58325779464;69;3060.02499200135
08;2021-S14;1;0;1;626.575909335673;526.358467843651;79;1152.93437717932
08;2021-S14;1;0;1;205.018522985054;140.993639349697;89;346.012162334751
08;2021-S14;0;0;0;50.0325684687745;20.62259870351;90;70.6551671722846
08;2021-S14;6;1;7;18551.3174743414;16782.6825256586;0;35334
11;2021-S14;1445;1515;3175;783071;811785;09;1594856
11;2021-S14;4352;4079;8809;761456;784653;19;1546109
11;2021-S14;6714;6141;12915;850145;801772;29;1651917
11;2021-S14;6997;6196;13261;914360;843488;39;1757848
11;2021-S14;6177;5899;12137;845609;826202;49;1671811
11;2021-S14;4819;4670;9550;793566;745070;59;1538636
11;2021-S14;2647;2450;5123;628649;549192;69;1177841
11;2021-S14;1203;1145;2351;434606;358356;79;792962
11;2021-S14;643;405;1050;261425;162933;89;424358
11;2021-S14;294;131;427;89253;32619;90;121872
11;2021-S14;35298;32647;68830;6362140;5916070;0;12278210
24;2021-S14;139;158;311;139720;144686;09;284406
24;2021-S14;525;505;1050;152979;161185;19;314164
24;2021-S14;621;549;1172;122237;126536;29;248773
24;2021-S14;640;527;1168;150359;142009;39;292368
24;2021-S14;685;569;1255;161829;158758;49;320587
24;2021-S14;560;578;1140;172552;168011;59;340563
24;2021-S14;366;331;697;172509;158177;69;330686
24;2021-S14;202;186;388;129428;110593;79;240021
24;2021-S14;120;65;185;87342;56882;89;144224
24;2021-S14;53;25;78;31210;12071;90;43281
24;2021-S14;3913;3493;7446;1320165;1238908;0;2559073
27;2021-S14;181;159;342;143373;149679;09;293052
27;2021-S14;656;638;1299;160962;173003;19;333965
27;2021-S14;698;675;1374;133746;142254;29;276000
27;2021-S14;645;551;1196;160004;155407;39;315411
27;2021-S14;708;629;1338;172333;169564;49;341897
27;2021-S14;559;607;1166;189979;183788;59;373767
27;2021-S14;453;465;918;192591;178206;69;370797
27;2021-S14;254;238;492;146876;127546;79;274422
27;2021-S14;168;105;273;96896;61575;89;158471
27;2021-S14;80;25;105;33148;12109;90;45257
27;2021-S14;4402;4092;8503;1429908;1353131;0;2783039
28;2021-S14;235;277;534;180735;186856;09;367591
28;2021-S14;769;764;1554;200125;213621;19;413746
28;2021-S14;839;834;1676;168922;173007;29;341929
28;2021-S14;863;773;1639;196628;188487;39;385115
28;2021-S14;898;763;1664;205396;201699;49;407095
28;2021-S14;743;700;1445;222002;213866;59;435868
28;2021-S14;502;488;991;224688;203758;69;428446
28;2021-S14;270;248;519;163192;135543;79;298735
28;2021-S14;180;117;297;109691;65377;89;175068
28;2021-S14;77;36;114;37222;12685;90;49907
28;2021-S14;5376;5003;10436;1708601;1594899;0;3303500
32;2021-S14;697;692;1393;358062;373689;09;731751
32;2021-S14;1872;1710;3598;387045;406742;19;793787
32;2021-S14;2131;1962;4125;342304;348587;29;690891
32;2021-S14;2167;1838;4014;382485;369972;39;752457
32;2021-S14;1970;1802;3776;382510;376716;49;759226
32;2021-S14;1675;1598;3279;386937;376527;59;763464
32;2021-S14;1104;973;2077;371211;330938;69;702149
32;2021-S14;607;531;1140;250542;201459;79;452001
32;2021-S14;397;223;620;163399;89786;89;253185
32;2021-S14;168;75;243;48384;15367;90;63751
32;2021-S14;12797;11409;24279;3072879;2889783;0;5962662
44;2021-S14;351;398;753;291525;306839;09;598364
44;2021-S14;1114;1172;2302;320255;339504;19;659759
44;2021-S14;1435;1250;2693;302020;314428;29;616448
44;2021-S14;1367;1235;2607;342222;333292;39;675514
44;2021-S14;1370;1322;2699;349727;344491;49;694218
44;2021-S14;1130;1177;2314;381371;373239;59;754610
44;2021-S14;781;738;1524;367165;335850;69;703015
44;2021-S14;436;405;848;250387;215436;79;465823
44;2021-S14;288;210;503;170825;105192;89;276017
44;2021-S14;101;41;143;51248;16731;90;67979
44;2021-S14;8374;7949;16389;2826745;2685002;0;5511747
52;2021-S14;262;255;531;213594;223900;09;437494
52;2021-S14;797;816;1624;240818;255197;19;496015
52;2021-S14;864;882;1746;197010;200630;29;397640
52;2021-S14;788;674;1462;231204;224885;39;456089
52;2021-S14;855;819;1674;243874;243418;49;487292
52;2021-S14;696;705;1401;244100;239116;59;483216
52;2021-S14;504;479;983;241796;221345;69;463141
52;2021-S14;268;267;536;177805;149903;79;327708
52;2021-S14;158;116;274;119561;75822;89;195383
52;2021-S14;76;35;111;42559;15260;90;57819
52;2021-S14;5269;5049;10344;1952321;1849476;0;3801797
53;2021-S14;143;170;314;173813;182358;09;356171
53;2021-S14;509;561;1074;202720;214740;19;417460
53;2021-S14;541;571;1118;163116;173196;29;336312
53;2021-S14;497;373;870;190526;187674;39;378200
53;2021-S14;475;504;979;212098;212015;49;424113
53;2021-S14;370;419;790;223699;219176;59;442875
53;2021-S14;253;237;490;227435;209274;69;436709
53;2021-S14;144;129;273;169992;140910;79;310902
53;2021-S14;74;51;125;118117;69883;89;188000
53;2021-S14;39;28;67;37370;12267;90;49637
53;2021-S14;3045;3044;6102;1718886;1621493;0;3340379
75;2021-S14;267;273;544;293104;305291;09;598395
75;2021-S14;877;915;1806;337141;357785;19;694926
75;2021-S14;1047;966;2016;295024;300618;29;595642
75;2021-S14;927;795;1724;347871;331233;39;679104
75;2021-S14;1022;884;1908;384742;372771;49;757513
75;2021-S14;905;848;1754;413361;390880;59;804241
75;2021-S14;569;536;1105;425623;384060;69;809683
75;2021-S14;307;305;612;325086;276298;79;601384
75;2021-S14;187;105;292;213986;139308;89;353294
75;2021-S14;93;43;136;77600;28200;90;105800
75;2021-S14;6205;5672;11903;3113538;2886444;0;5999982
76;2021-S14;286;321;623;305956;318589;09;624545
76;2021-S14;995;1054;2073;338942;356969;19;695911
76;2021-S14;1413;1239;2657;316210;319570;29;635780
76;2021-S14;1259;1094;2355;356758;337587;39;694345
76;2021-S14;1388;1211;2602;376541;363812;49;740353
76;2021-S14;1218;1059;2280;402608;383750;59;786358
76;2021-S14;784;726;1511;394889;358997;69;753886
76;2021-S14;462;419;881;308664;263806;79;572470
76;2021-S14;313;185;498;195838;129272;89;325110
76;2021-S14;201;68;269;69372;26728;90;96100
76;2021-S14;8325;7379;15758;3065778;2859080;0;5924858
84;2021-S14;560;581;1145;459549;481088;09;940637
84;2021-S14;2116;2146;4280;487711;511905;19;999616
84;2021-S14;2301;2170;4473;443824;451094;29;894918
84;2021-S14;2317;2100;4419;512522;493262;39;1005784
84;2021-S14;2525;2097;4624;520248;515106;49;1035354
84;2021-S14;1947;1954;3901;529611;514848;59;1044459
84;2021-S14;1250;1107;2357;486720;439940;69;926660
84;2021-S14;741;667;1408;372151;315211;79;687362
84;2021-S14;436;348;784;237198;150524;89;387722
84;2021-S14;214;76;290;81185;28680;90;109865
84;2021-S14;14412;13250;27690;4130719;3901658;0;8032377
93;2021-S14;339;331;674;268834;283093;09;551927
93;2021-S14;1281;1209;2501;280751;296087;19;576838
93;2021-S14;1734;1513;3251;254404;255552;29;509956
93;2021-S14;1758;1476;3236;310704;288398;39;599102
93;2021-S14;1783;1556;3343;325559;305827;49;631386
93;2021-S14;1630;1471;3111;353104;325389;59;678493
93;2021-S14;1047;960;2009;336327;296459;69;632786
93;2021-S14;532;533;1067;279820;229699;79;509519
93;2021-S14;360;293;653;171274;113716;89;284990
93;2021-S14;124;64;188;58896;21758;90;80654
93;2021-S14;10590;9409;20039;2639673;2415978;0;5055651
94;2021-S14;8;17;25;16311;17433;09;33744
94;2021-S14;24;29;55;16679;18132;19;34811
94;2021-S14;46;23;69;16782;16579;29;33361
94;2021-S14;40;38;78;23044;20580;39;43624
94;2021-S14;38;38;76;23065;22140;49;45205
94;2021-S14;41;33;74;24549;23421;59;47970
94;2021-S14;18;28;46;23212;21883;69;45095
94;2021-S14;10;17;27;19544;17141;79;36685
94;2021-S14;16;8;24;11227;8178;89;19405
94;2021-S14;4;0;4;3332;1447;90;4779
94;2021-S14;245;231;478;177745;166934;0;344679
01;2021-S15;9;11;20;19979;20155;09;40134
01;2021-S15;52;44;96;24994;25489;19;50483
01;2021-S15;68;49;117;17868;16690;29;34558
01;2021-S15;80;42;122;22328;14821;39;37149
01;2021-S15;79;52;131;28652;20276;49;48928
01;2021-S15;89;86;175;33264;27260;59;60524
01;2021-S15;52;54;106;27135;23978;69;51113
01;2021-S15;34;27;61;18401;14661;79;33062
01;2021-S15;9;19;28;9633;6375;89;16008
01;2021-S15;3;1;4;3410;1510;90;4920
01;2021-S15;475;385;860;205664;171215;0;376879
02;2021-S15;7;11;18;16881;17110;09;33991
02;2021-S15;41;34;76;21410;21604;19;43014
02;2021-S15;49;29;78;16017;15479;29;31496
02;2021-S15;55;36;91;19825;14455;39;34280
02;2021-S15;71;42;113;24719;18248;49;42967
02;2021-S15;103;82;185;34361;28310;59;62671
02;2021-S15;63;47;110;28061;24495;69;52556
02;2021-S15;25;19;44;18231;15278;79;33509
02;2021-S15;13;4;17;11090;7677;89;18767
02;2021-S15;3;1;4;3992;1506;90;5498
02;2021-S15;430;305;736;194587;164162;0;358749
03;2021-S15;6;11;17;31123;30920;09;62043
03;2021-S15;33;36;69;29370;29268;19;58638
03;2021-S15;73;54;128;21458;18963;29;40421
03;2021-S15;65;51;116;21276;18326;39;39602
03;2021-S15;44;45;89;18164;16593;49;34757
03;2021-S15;41;30;71;13469;13557;59;27026
03;2021-S15;30;28;58;8776;8670;69;17446
03;2021-S15;11;6;17;3777;3591;79;7368
03;2021-S15;2;1;3;1649;1072;89;2721
03;2021-S15;0;0;0;485;184;90;669
03;2021-S15;305;262;568;149547;141144;0;290691
04;2021-S15;47;36;83;60314;61377;09;121691
04;2021-S15;80;93;173;66065;68387;19;134452
04;2021-S15;87;50;137;51059;47156;29;98215
04;2021-S15;84;62;148;58788;45780;39;104568
04;2021-S15;78;67;145;61408;52207;49;113615
04;2021-S15;68;60;128;64838;60759;59;125597
04;2021-S15;42;30;72;47008;42843;69;89851
04;2021-S15;14;17;31;25509;21184;79;46693
04;2021-S15;12;7;19;13168;7647;89;20815
04;2021-S15;2;0;2;3209;1253;90;4462
04;2021-S15;514;422;938;451366;408593;0;859959
05;2021-S15;0;0;0;362.366008612902;341.338819562748;09;703.704828175651
05;2021-S15;0;0;0;353.376145114279;370.349735405642;19;723.725880519921
05;2021-S15;0;0;0;218.593559489256;256.539602589476;29;475.133162078732
05;2021-S15;0;0;0;404.225408693299;360.321910454353;39;764.547319147651
05;2021-S15;0;0;0;520.067953604221;497.108383964256;49;1017.17633756848
05;2021-S15;0;0;0;468.146063921917;510.087601910415;59;978.233665832332
05;2021-S15;0;0;0;340.368470050554;334.366842191253;69;674.735312241807
05;2021-S15;0;0;0;212.598666888387;192.597753227106;79;405.196420115493
05;2021-S15;0;0;0;148.727797095705;61.8681715431829;89;210.595968638888
05;2021-S15;0;0;0;32.9601271090696;10.9909785719784;90;43.9511056810479
05;2021-S15;0;0;0;3061.43020057959;2935.56979942041;0;5997
06;2021-S15;1;0;1;42583;42380;09;84963
06;2021-S15;10;12;22;33369;31925;19;65294
06;2021-S15;18;23;41;21571;15080;29;36651
06;2021-S15;12;14;26;21550;16147;39;37697
06;2021-S15;10;13;23;14193;13939;49;28132
06;2021-S15;6;17;23;7171;7597;59;14768
06;2021-S15;3;0;3;3629;4117;69;7746
06;2021-S15;1;0;1;1577;1457;79;3034
06;2021-S15;0;2;2;531;474;89;1005
06;2021-S15;1;0;1;88;93;90;181
06;2021-S15;62;81;143;146262;133209;0;279471
07;2021-S15;0;0;0;485;549;09;1034
07;2021-S15;0;1;1;403;432;19;835
07;2021-S15;1;2;3;764;841;29;1605
07;2021-S15;6;0;6;824;928;39;1752
07;2021-S15;2;1;3;788;1020;49;1808
07;2021-S15;3;4;7;678;870;59;1548
07;2021-S15;4;1;5;360;382;69;742
07;2021-S15;0;1;1;231;190;79;421
07;2021-S15;0;0;0;114;67;89;181
07;2021-S15;0;0;0;24;11;90;35
07;2021-S15;16;10;26;4671;5290;0;9961
08;2021-S15;0;0;0;2715.22592983026;2997.75551488675;09;5712.98144471701
08;2021-S15;4;1;5;2778.51901080978;3160.9156459093;19;5939.43465671908
08;2021-S15;1;0;1;2080.8882988764;1718.16634315323;29;3799.05464202964
08;2021-S15;2;2;4;2701.8582062647;1896.52641413317;39;4598.38462039786
08;2021-S15;0;1;1;3151.45861023308;2460.52498233809;49;5611.98359257117
08;2021-S15;2;3;5;2620.29868333099;2422.23566154656;59;5042.53434487755
08;2021-S15;1;2;3;1621.44173420671;1438.58325779464;69;3060.02499200135
08;2021-S15;0;0;0;626.575909335673;526.358467843651;79;1152.93437717932
08;2021-S15;0;0;0;205.018522985054;140.993639349697;89;346.012162334751
08;2021-S15;0;0;0;50.0325684687745;20.62259870351;90;70.6551671722846
08;2021-S15;10;9;19;18551.3174743414;16782.6825256586;0;35334
11;2021-S15;1198;1236;2605;783071;811785;09;1594856
11;2021-S15;3884;3614;7806;761456;784653;19;1546109
11;2021-S15;6798;6244;13134;850145;801772;29;1651917
11;2021-S15;6358;6131;12591;914360;843488;39;1757848
11;2021-S15;5687;5501;11258;845609;826202;49;1671811
11;2021-S15;4551;4588;9205;793566;745070;59;1538636
11;2021-S15;2650;2468;5148;628649;549192;69;1177841
11;2021-S15;1150;1144;2302;434606;358356;79;792962
11;2021-S15;578;468;1050;261425;162933;89;424358
11;2021-S15;257;122;379;89253;32619;90;121872
11;2021-S15;33118;31523;65515;6362140;5916070;0;12278210
24;2021-S15;141;153;300;139720;144686;09;284406
24;2021-S15;542;605;1155;152979;161185;19;314164
24;2021-S15;573;594;1170;122237;126536;29;248773
24;2021-S15;604;581;1189;150359;142009;39;292368
24;2021-S15;641;578;1219;161829;158758;49;320587
24;2021-S15;579;601;1182;172552;168011;59;340563
24;2021-S15;387;400;788;172509;158177;69;330686
24;2021-S15;212;231;444;129428;110593;79;240021
24;2021-S15;132;80;212;87342;56882;89;144224
24;2021-S15;63;33;96;31210;12071;90;43281
24;2021-S15;3874;3857;7756;1320165;1238908;0;2559073
27;2021-S15;139;173;315;143373;149679;09;293052
27;2021-S15;556;569;1127;160962;173003;19;333965
27;2021-S15;633;673;1308;133746;142254;29;276000
27;2021-S15;612;542;1155;160004;155407;39;315411
27;2021-S15;624;576;1201;172333;169564;49;341897
27;2021-S15;618;602;1220;189979;183788;59;373767
27;2021-S15;439;425;864;192591;178206;69;370797
27;2021-S15;246;250;496;146876;127546;79;274422
27;2021-S15;152;112;264;96896;61575;89;158471
27;2021-S15;75;31;106;33148;12109;90;45257
27;2021-S15;4094;3953;8056;1429908;1353131;0;2783039
28;2021-S15;275;258;554;180735;186856;09;367591
28;2021-S15;720;699;1436;200125;213621;19;413746
28;2021-S15;795;760;1560;168922;173007;29;341929
28;2021-S15;838;754;1598;196628;188487;39;385115
28;2021-S15;811;757;1574;205396;201699;49;407095
28;2021-S15;770;812;1587;222002;213866;59;435868
28;2021-S15;523;497;1023;224688;203758;69;428446
28;2021-S15;299;281;580;163192;135543;79;298735
28;2021-S15;164;117;281;109691;65377;89;175068
28;2021-S15;103;31;134;37222;12685;90;49907
28;2021-S15;5298;4966;10330;1708601;1594899;0;3303500
32;2021-S15;639;689;1332;358062;373689;09;731751
32;2021-S15;1807;1769;3600;387045;406742;19;793787
32;2021-S15;2168;1900;4097;342304;348587;29;690891
32;2021-S15;2057;1931;4008;382485;369972;39;752457
32;2021-S15;1870;1893;3792;382510;376716;49;759226
32;2021-S15;1659;1657;3324;386937;376527;59;763464
32;2021-S15;1065;950;2021;371211;330938;69;702149
32;2021-S15;559;487;1048;250542;201459;79;452001
32;2021-S15;402;212;615;163399;89786;89;253185
32;2021-S15;186;71;257;48384;15367;90;63751
32;2021-S15;12417;11562;24103;3072879;2889783;0;5962662
44;2021-S15;357;390;752;291525;306839;09;598364
44;2021-S15;1161;1122;2298;320255;339504;19;659759
44;2021-S15;1353;1230;2593;302020;314428;29;616448
44;2021-S15;1314;1222;2543;342222;333292;39;675514
44;2021-S15;1219;1147;2368;349727;344491;49;694218
44;2021-S15;1157;1201;2368;381371;373239;59;754610
44;2021-S15;756;700;1461;367165;335850;69;703015
44;2021-S15;435;418;862;250387;215436;79;465823
44;2021-S15;298;192;492;170825;105192;89;276017
44;2021-S15;121;38;162;51248;16731;90;67979
44;2021-S15;8172;7660;15900;2826745;2685002;0;5511747
52;2021-S15;275;269;558;213594;223900;09;437494
52;2021-S15;854;880;1756;240818;255197;19;496015
52;2021-S15;896;953;1849;197010;200630;29;397640
52;2021-S15;834;732;1566;231204;224885;39;456089
52;2021-S15;894;851;1746;243874;243418;49;487292
52;2021-S15;780;762;1542;244100;239116;59;483216
52;2021-S15;503;489;992;241796;221345;69;463141
52;2021-S15;232;238;470;177805;149903;79;327708
52;2021-S15;155;105;261;119561;75822;89;195383
52;2021-S15;102;33;135;42559;15260;90;57819
52;2021-S15;5525;5312;10875;1952321;1849476;0;3801797
53;2021-S15;167;189;358;173813;182358;09;356171
53;2021-S15;536;531;1073;202720;214740;19;417460
53;2021-S15;585;600;1196;163116;173196;29;336312
53;2021-S15;513;518;1033;190526;187674;39;378200
53;2021-S15;539;517;1057;212098;212015;49;424113
53;2021-S15;440;452;893;223699;219176;59;442875
53;2021-S15;281;300;581;227435;209274;69;436709
53;2021-S15;163;147;310;169992;140910;79;310902
53;2021-S15;119;75;194;118117;69883;89;188000
53;2021-S15;44;26;70;37370;12267;90;49637
53;2021-S15;3387;3355;6766;1718886;1621493;0;3340379
75;2021-S15;228;253;486;293104;305291;09;598395
75;2021-S15;893;854;1757;337141;357785;19;694926
75;2021-S15;980;974;1956;295024;300618;29;595642
75;2021-S15;973;819;1798;347871;331233;39;679104
75;2021-S15;1044;921;1965;384742;372771;49;757513
75;2021-S15;871;890;1763;413361;390880;59;804241
75;2021-S15;568;554;1124;425623;384060;69;809683
75;2021-S15;332;308;642;325086;276298;79;601384
75;2021-S15;222;154;376;213986;139308;89;353294
75;2021-S15;154;34;188;77600;28200;90;105800
75;2021-S15;6267;5764;12060;3113538;2886444;0;5999982
76;2021-S15;256;282;550;305956;318589;09;624545
76;2021-S15;1021;1057;2109;338942;356969;19;695911
76;2021-S15;1354;1355;2717;316210;319570;29;635780
76;2021-S15;1260;1029;2301;356758;337587;39;694345
76;2021-S15;1289;1152;2447;376541;363812;49;740353
76;2021-S15;1115;1062;2185;402608;383750;59;786358
76;2021-S15;725;679;1409;394889;358997;69;753886
76;2021-S15;455;416;873;308664;263806;79;572470
76;2021-S15;304;210;515;195838;129272;89;325110
76;2021-S15;196;87;283;69372;26728;90;96100
76;2021-S15;7983;7334;15402;3065778;2859080;0;5924858
84;2021-S15;592;612;1214;459549;481088;09;940637
84;2021-S15;2007;1920;3939;487711;511905;19;999616
84;2021-S15;2179;2182;4369;443824;451094;29;894918
84;2021-S15;2266;2070;4341;512522;493262;39;1005784
84;2021-S15;2254;2155;4411;520248;515106;49;1035354
84;2021-S15;1938;1974;3918;529611;514848;59;1044459
84;2021-S15;1260;1188;2451;486720;439940;69;926660
84;2021-S15;712;690;1404;372151;315211;79;687362
84;2021-S15;433;292;726;237198;150524;89;387722
84;2021-S15;167;87;254;81185;28680;90;109865
84;2021-S15;13811;13174;27035;4130719;3901658;0;8032377
93;2021-S15;337;390;732;268834;283093;09;551927
93;2021-S15;1165;1211;2382;280751;296087;19;576838
93;2021-S15;1700;1516;3223;254404;255552;29;509956
93;2021-S15;1683;1344;3031;310704;288398;39;599102
93;2021-S15;1674;1471;3151;325559;305827;49;631386
93;2021-S15;1570;1460;3033;353104;325389;59;678493
93;2021-S15;1007;929;1936;336327;296459;69;632786
93;2021-S15;518;531;1049;279820;229699;79;509519
93;2021-S15;348;231;579;171274;113716;89;284990
93;2021-S15;126;55;181;58896;21758;90;80654
93;2021-S15;10131;9141;19303;2639673;2415978;0;5055651
94;2021-S15;12;9;21;16311;17433;09;33744
94;2021-S15;33;56;90;16679;18132;19;34811
94;2021-S15;47;35;82;16782;16579;29;33361
94;2021-S15;46;42;88;23044;20580;39;43624
94;2021-S15;39;44;83;23065;22140;49;45205
94;2021-S15;43;48;91;24549;23421;59;47970
94;2021-S15;30;34;64;23212;21883;69;45095
94;2021-S15;14;14;28;19544;17141;79;36685
94;2021-S15;15;6;21;11227;8178;89;19405
94;2021-S15;7;4;11;3332;1447;90;4779
94;2021-S15;286;292;579;177745;166934;0;344679
01;2021-S16;6;7;13;19979;20155;09;40134
01;2021-S16;63;48;111;24994;25489;19;50483
01;2021-S16;66;42;108;17868;16690;29;34558
01;2021-S16;71;38;109;22328;14821;39;37149
01;2021-S16;90;67;157;28652;20276;49;48928
01;2021-S16;91;85;176;33264;27260;59;60524
01;2021-S16;54;55;109;27135;23978;69;51113
01;2021-S16;34;29;63;18401;14661;79;33062
01;2021-S16;15;9;24;9633;6375;89;16008
01;2021-S16;3;3;6;3410;1510;90;4920
01;2021-S16;493;383;876;205664;171215;0;376879
02;2021-S16;12;13;25;16881;17110;09;33991
02;2021-S16;31;18;50;21410;21604;19;43014
02;2021-S16;49;31;80;16017;15479;29;31496
02;2021-S16;52;37;89;19825;14455;39;34280
02;2021-S16;49;47;96;24719;18248;49;42967
02;2021-S16;75;55;130;34361;28310;59;62671
02;2021-S16;51;53;104;28061;24495;69;52556
02;2021-S16;24;23;47;18231;15278;79;33509
02;2021-S16;14;7;21;11090;7677;89;18767
02;2021-S16;4;2;6;3992;1506;90;5498
02;2021-S16;361;286;648;194587;164162;0;358749
03;2021-S16;15;14;29;31123;30920;09;62043
03;2021-S16;60;54;115;29370;29268;19;58638
03;2021-S16;63;61;125;21458;18963;29;40421
03;2021-S16;93;71;164;21276;18326;39;39602
03;2021-S16;54;51;105;18164;16593;49;34757
03;2021-S16;50;35;85;13469;13557;59;27026
03;2021-S16;23;38;61;8776;8670;69;17446
03;2021-S16;13;11;24;3777;3591;79;7368
03;2021-S16;6;2;8;1649;1072;89;2721
03;2021-S16;0;1;1;485;184;90;669
03;2021-S16;377;338;717;149547;141144;0;290691
04;2021-S16;39;59;98;60314;61377;09;121691
04;2021-S16;126;105;231;66065;68387;19;134452
04;2021-S16;89;87;176;51059;47156;29;98215
04;2021-S16;85;68;153;58788;45780;39;104568
04;2021-S16;90;70;160;61408;52207;49;113615
04;2021-S16;71;71;142;64838;60759;59;125597
04;2021-S16;43;43;86;47008;42843;69;89851
04;2021-S16;14;16;30;25509;21184;79;46693
04;2021-S16;13;7;20;13168;7647;89;20815
04;2021-S16;1;2;3;3209;1253;90;4462
04;2021-S16;571;528;1099;451366;408593;0;859959
05;2021-S16;0;0;0;362.366008612902;341.338819562748;09;703.704828175651
05;2021-S16;0;0;0;353.376145114279;370.349735405642;19;723.725880519921
05;2021-S16;0;0;0;218.593559489256;256.539602589476;29;475.133162078732
05;2021-S16;0;0;0;404.225408693299;360.321910454353;39;764.547319147651
05;2021-S16;0;0;0;520.067953604221;497.108383964256;49;1017.17633756848
05;2021-S16;0;0;0;468.146063921917;510.087601910415;59;978.233665832332
05;2021-S16;0;0;0;340.368470050554;334.366842191253;69;674.735312241807
05;2021-S16;0;0;0;212.598666888387;192.597753227106;79;405.196420115493
05;2021-S16;0;0;0;148.727797095705;61.8681715431829;89;210.595968638888
05;2021-S16;0;0;0;32.9601271090696;10.9909785719784;90;43.9511056810479
05;2021-S16;0;0;0;3061.43020057959;2935.56979942041;0;5997
06;2021-S16;5;2;7;42583;42380;09;84963
06;2021-S16;17;12;30;33369;31925;19;65294
06;2021-S16;15;27;42;21571;15080;29;36651
06;2021-S16;12;14;26;21550;16147;39;37697
06;2021-S16;13;5;18;14193;13939;49;28132
06;2021-S16;8;8;16;7171;7597;59;14768
06;2021-S16;3;5;8;3629;4117;69;7746
06;2021-S16;0;1;1;1577;1457;79;3034
06;2021-S16;0;2;2;531;474;89;1005
06;2021-S16;0;0;0;88;93;90;181
06;2021-S16;73;76;150;146262;133209;0;279471
07;2021-S16;0;0;0;485;549;09;1034
07;2021-S16;0;0;0;403;432;19;835
07;2021-S16;4;1;5;764;841;29;1605
07;2021-S16;2;0;2;824;928;39;1752
07;2021-S16;1;1;2;788;1020;49;1808
07;2021-S16;0;2;2;678;870;59;1548
07;2021-S16;0;0;0;360;382;69;742
07;2021-S16;0;1;1;231;190;79;421
07;2021-S16;0;0;0;114;67;89;181
07;2021-S16;0;0;0;24;11;90;35
07;2021-S16;7;5;12;4671;5290;0;9961
08;2021-S16;0;0;0;2715.22592983026;2997.75551488675;09;5712.98144471701
08;2021-S16;0;0;0;2778.51901080978;3160.9156459093;19;5939.43465671908
08;2021-S16;3;1;4;2080.8882988764;1718.16634315323;29;3799.05464202964
08;2021-S16;3;1;4;2701.8582062647;1896.52641413317;39;4598.38462039786
08;2021-S16;1;4;5;3151.45861023308;2460.52498233809;49;5611.98359257117
08;2021-S16;2;0;2;2620.29868333099;2422.23566154656;59;5042.53434487755
08;2021-S16;1;2;3;1621.44173420671;1438.58325779464;69;3060.02499200135
08;2021-S16;1;1;2;626.575909335673;526.358467843651;79;1152.93437717932
08;2021-S16;0;0;0;205.018522985054;140.993639349697;89;346.012162334751
08;2021-S16;1;0;1;50.0325684687745;20.62259870351;90;70.6551671722846
08;2021-S16;12;9;21;18551.3174743414;16782.6825256586;0;35334
11;2021-S16;1226;1224;2604;783071;811785;09;1594856
11;2021-S16;3355;3051;6624;761456;784653;19;1546109
11;2021-S16;5961;5697;11745;850145;801772;29;1651917
11;2021-S16;5515;5279;10863;914360;843488;39;1757848
11;2021-S16;4550;4479;9081;845609;826202;49;1671811
11;2021-S16;3934;3949;7935;793566;745070;59;1538636
11;2021-S16;2300;2159;4484;628649;549192;69;1177841
11;2021-S16;984;928;1915;434606;358356;79;792962
11;2021-S16;508;368;877;261425;162933;89;424358
11;2021-S16;306;120;427;89253;32619;90;121872
11;2021-S16;28646;27271;56592;6362140;5916070;0;12278210
24;2021-S16;124;146;284;139720;144686;09;284406
24;2021-S16;531;521;1068;152979;161185;19;314164
24;2021-S16;586;579;1169;122237;126536;29;248773
24;2021-S16;557;479;1038;150359;142009;39;292368
24;2021-S16;541;514;1059;161829;158758;49;320587
24;2021-S16;536;484;1021;172552;168011;59;340563
24;2021-S16;332;336;669;172509;158177;69;330686
24;2021-S16;183;176;359;129428;110593;79;240021
24;2021-S16;112;89;201;87342;56882;89;144224
24;2021-S16;76;40;116;31210;12071;90;43281
24;2021-S16;3578;3367;6987;1320165;1238908;0;2559073
27;2021-S16;174;189;364;143373;149679;09;293052
27;2021-S16;557;475;1036;160962;173003;19;333965
27;2021-S16;655;678;1336;133746;142254;29;276000
27;2021-S16;569;516;1086;160004;155407;39;315411
27;2021-S16;549;552;1102;172333;169564;49;341897
27;2021-S16;532;582;1115;189979;183788;59;373767
27;2021-S16;414;395;809;192591;178206;69;370797
27;2021-S16;227;210;437;146876;127546;79;274422
27;2021-S16;153;93;246;96896;61575;89;158471
27;2021-S16;94;33;127;33148;12109;90;45257
27;2021-S16;3924;3723;7658;1429908;1353131;0;2783039
28;2021-S16;243;249;504;180735;186856;09;367591
28;2021-S16;739;691;1450;200125;213621;19;413746
28;2021-S16;748;768;1526;168922;173007;29;341929
28;2021-S16;728;632;1366;196628;188487;39;385115
28;2021-S16;804;701;1509;205396;201699;49;407095
28;2021-S16;684;765;1454;222002;213866;59;435868
28;2021-S16;489;460;952;224688;203758;69;428446
28;2021-S16;287;266;554;163192;135543;79;298735
28;2021-S16;149;108;258;109691;65377;89;175068
28;2021-S16;119;45;165;37222;12685;90;49907
28;2021-S16;4992;4685;9742;1708601;1594899;0;3303500
32;2021-S16;636;621;1264;358062;373689;09;731751
32;2021-S16;1536;1488;3037;387045;406742;19;793787
32;2021-S16;1946;1852;3837;342304;348587;29;690891
32;2021-S16;1730;1666;3413;382485;369972;39;752457
32;2021-S16;1694;1660;3372;382510;376716;49;759226
32;2021-S16;1454;1431;2895;386937;376527;59;763464
32;2021-S16;1029;849;1885;371211;330938;69;702149
32;2021-S16;526;456;983;250542;201459;79;452001
32;2021-S16;347;204;551;163399;89786;89;253185
32;2021-S16;121;52;173;48384;15367;90;63751
32;2021-S16;11025;10279;21416;3072879;2889783;0;5962662
44;2021-S16;380;421;811;291525;306839;09;598364
44;2021-S16;955;982;1950;320255;339504;19;659759
44;2021-S16;1248;1166;2420;302020;314428;29;616448
44;2021-S16;1113;1100;2223;342222;333292;39;675514
44;2021-S16;1129;1050;2182;349727;344491;49;694218
44;2021-S16;1033;1012;2052;381371;373239;59;754610
44;2021-S16;632;594;1228;367165;335850;69;703015
44;2021-S16;342;331;678;250387;215436;79;465823
44;2021-S16;224;155;381;170825;105192;89;276017
44;2021-S16;110;41;151;51248;16731;90;67979
44;2021-S16;7167;6854;14082;2826745;2685002;0;5511747
52;2021-S16;272;259;541;213594;223900;09;437494
52;2021-S16;750;747;1516;240818;255197;19;496015
52;2021-S16;787;868;1656;197010;200630;29;397640
52;2021-S16;688;670;1360;231204;224885;39;456089
52;2021-S16;725;733;1459;243874;243418;49;487292
52;2021-S16;710;708;1422;244100;239116;59;483216
52;2021-S16;419;449;869;241796;221345;69;463141
52;2021-S16;245;237;482;177805;149903;79;327708
52;2021-S16;182;119;301;119561;75822;89;195383
52;2021-S16;100;47;147;42559;15260;90;57819
52;2021-S16;4879;4837;9754;1952321;1849476;0;3801797
53;2021-S16;190;201;398;173813;182358;09;356171
53;2021-S16;471;442;916;202720;214740;19;417460
53;2021-S16;514;578;1098;163116;173196;29;336312
53;2021-S16;452;433;885;190526;187674;39;378200
53;2021-S16;436;454;890;212098;212015;49;424113
53;2021-S16;403;433;836;223699;219176;59;442875
53;2021-S16;250;251;502;227435;209274;69;436709
53;2021-S16;155;128;283;169992;140910;79;310902
53;2021-S16;95;72;167;118117;69883;89;188000
53;2021-S16;52;16;68;37370;12267;90;49637
53;2021-S16;3018;3008;6044;1718886;1621493;0;3340379
75;2021-S16;239;255;504;293104;305291;09;598395
75;2021-S16;724;714;1448;337141;357785;19;694926
75;2021-S16;849;929;1782;295024;300618;29;595642
75;2021-S16;858;744;1603;347871;331233;39;679104
75;2021-S16;897;810;1714;384742;372771;49;757513
75;2021-S16;732;763;1496;413361;390880;59;804241
75;2021-S16;534;459;995;425623;384060;69;809683
75;2021-S16;281;286;569;325086;276298;79;601384
75;2021-S16;213;136;349;213986;139308;89;353294
75;2021-S16;136;65;206;77600;28200;90;105800
75;2021-S16;5468;5165;10676;3113538;2886444;0;5999982
76;2021-S16;295;319;628;305956;318589;09;624545
76;2021-S16;941;992;1961;338942;356969;19;695911
76;2021-S16;1271;1203;2491;316210;319570;29;635780
76;2021-S16;1137;1040;2183;356758;337587;39;694345
76;2021-S16;1166;1051;2226;376541;363812;49;740353
76;2021-S16;981;988;1976;402608;383750;59;786358
76;2021-S16;641;651;1298;394889;358997;69;753886
76;2021-S16;370;395;765;308664;263806;79;572470
76;2021-S16;283;183;467;195838;129272;89;325110
76;2021-S16;160;64;224;69372;26728;90;96100
76;2021-S16;7256;6894;14238;3065778;2859080;0;5924858
84;2021-S16;571;599;1177;459549;481088;09;940637
84;2021-S16;1698;1711;3418;487711;511905;19;999616
84;2021-S16;2123;2001;4131;443824;451094;29;894918
84;2021-S16;1887;1782;3676;512522;493262;39;1005784
84;2021-S16;1939;1969;3911;520248;515106;49;1035354
84;2021-S16;1658;1695;3354;529611;514848;59;1044459
84;2021-S16;1146;1051;2199;486720;439940;69;926660
84;2021-S16;606;573;1179;372151;315211;79;687362
84;2021-S16;367;243;610;237198;150524;89;387722
84;2021-S16;156;66;222;81185;28680;90;109865
84;2021-S16;12155;11690;23883;4130719;3901658;0;8032377
93;2021-S16;338;387;729;268834;283093;09;551927
93;2021-S16;1035;1104;2145;280751;296087;19;576838
93;2021-S16;1510;1439;2955;254404;255552;29;509956
93;2021-S16;1621;1406;3031;310704;288398;39;599102
93;2021-S16;1470;1386;2862;325559;305827;49;631386
93;2021-S16;1281;1331;2617;353104;325389;59;678493
93;2021-S16;851;752;1605;336327;296459;69;632786
93;2021-S16;443;417;860;279820;229699;79;509519
93;2021-S16;264;199;463;171274;113716;89;284990
93;2021-S16;131;50;181;58896;21758;90;80654
93;2021-S16;8949;8475;17457;2639673;2415978;0;5055651
94;2021-S16;16;19;35;16311;17433;09;33744
94;2021-S16;26;42;68;16679;18132;19;34811
94;2021-S16;36;34;70;16782;16579;29;33361
94;2021-S16;31;33;64;23044;20580;39;43624
94;2021-S16;38;36;74;23065;22140;49;45205
94;2021-S16;28;25;53;24549;23421;59;47970
94;2021-S16;25;19;44;23212;21883;69;45095
94;2021-S16;12;17;29;19544;17141;79;36685
94;2021-S16;8;2;10;11227;8178;89;19405
94;2021-S16;11;4;15;3332;1447;90;4779
94;2021-S16;231;232;463;177745;166934;0;344679
01;2021-S17;23;9;32;19979;20155;09;40134
01;2021-S17;49;40;89;24994;25489;19;50483
01;2021-S17;62;43;105;17868;16690;29;34558
01;2021-S17;63;51;114;22328;14821;39;37149
01;2021-S17;85;52;137;28652;20276;49;48928
01;2021-S17;78;57;135;33264;27260;59;60524
01;2021-S17;48;58;106;27135;23978;69;51113
01;2021-S17;23;29;52;18401;14661;79;33062
01;2021-S17;7;13;20;9633;6375;89;16008
01;2021-S17;6;3;9;3410;1510;90;4920
01;2021-S17;444;355;799;205664;171215;0;376879
02;2021-S17;8;8;16;16881;17110;09;33991
02;2021-S17;11;14;25;21410;21604;19;43014
02;2021-S17;32;28;60;16017;15479;29;31496
02;2021-S17;29;27;56;19825;14455;39;34280
02;2021-S17;26;27;53;24719;18248;49;42967
02;2021-S17;44;25;69;34361;28310;59;62671
02;2021-S17;22;30;52;28061;24495;69;52556
02;2021-S17;9;13;22;18231;15278;79;33509
02;2021-S17;2;0;2;11090;7677;89;18767
02;2021-S17;3;1;4;3992;1506;90;5498
02;2021-S17;186;173;359;194587;164162;0;358749
03;2021-S17;15;30;46;31123;30920;09;62043
03;2021-S17;56;35;94;29370;29268;19;58638
03;2021-S17;78;47;126;21458;18963;29;40421
03;2021-S17;65;54;120;21276;18326;39;39602
03;2021-S17;63;49;112;18164;16593;49;34757
03;2021-S17;42;54;96;13469;13557;59;27026
03;2021-S17;31;39;70;8776;8670;69;17446
03;2021-S17;9;6;15;3777;3591;79;7368
03;2021-S17;3;7;10;1649;1072;89;2721
03;2021-S17;0;0;0;485;184;90;669
03;2021-S17;362;321;689;149547;141144;0;290691
04;2021-S17;43;31;74;60314;61377;09;121691
04;2021-S17;104;120;224;66065;68387;19;134452
04;2021-S17;95;57;152;51059;47156;29;98215
04;2021-S17;105;83;188;58788;45780;39;104568
04;2021-S17;89;72;161;61408;52207;49;113615
04;2021-S17;83;72;155;64838;60759;59;125597
04;2021-S17;56;54;110;47008;42843;69;89851
04;2021-S17;31;15;46;25509;21184;79;46693
04;2021-S17;16;13;29;13168;7647;89;20815
04;2021-S17;7;3;10;3209;1253;90;4462
04;2021-S17;629;520;1149;451366;408593;0;859959
05;2021-S17;0;0;0;362.366008612902;341.338819562748;09;703.704828175651
05;2021-S17;0;0;0;353.376145114279;370.349735405642;19;723.725880519921
05;2021-S17;0;0;0;218.593559489256;256.539602589476;29;475.133162078732
05;2021-S17;0;0;0;404.225408693299;360.321910454353;39;764.547319147651
05;2021-S17;0;0;0;520.067953604221;497.108383964256;49;1017.17633756848
05;2021-S17;0;0;0;468.146063921917;510.087601910415;59;978.233665832332
05;2021-S17;0;0;0;340.368470050554;334.366842191253;69;674.735312241807
05;2021-S17;0;0;0;212.598666888387;192.597753227106;79;405.196420115493
05;2021-S17;0;0;0;148.727797095705;61.8681715431829;89;210.595968638888
05;2021-S17;0;0;0;32.9601271090696;10.9909785719784;90;43.9511056810479
05;2021-S17;0;0;0;3061.43020057959;2935.56979942041;0;5997
06;2021-S17;1;0;1;42583;42380;09;84963
06;2021-S17;6;10;17;33369;31925;19;65294
06;2021-S17;15;10;25;21571;15080;29;36651
06;2021-S17;8;6;14;21550;16147;39;37697
06;2021-S17;2;4;6;14193;13939;49;28132
06;2021-S17;5;3;8;7171;7597;59;14768
06;2021-S17;3;7;10;3629;4117;69;7746
06;2021-S17;0;3;3;1577;1457;79;3034
06;2021-S17;1;3;4;531;474;89;1005
06;2021-S17;0;0;0;88;93;90;181
06;2021-S17;41;46;88;146262;133209;0;279471
07;2021-S17;0;0;0;485;549;09;1034
07;2021-S17;0;0;0;403;432;19;835
07;2021-S17;0;2;2;764;841;29;1605
07;2021-S17;1;1;2;824;928;39;1752
07;2021-S17;1;0;1;788;1020;49;1808
07;2021-S17;1;0;1;678;870;59;1548
07;2021-S17;0;0;0;360;382;69;742
07;2021-S17;0;0;0;231;190;79;421
07;2021-S17;0;0;0;114;67;89;181
07;2021-S17;0;0;0;24;11;90;35
07;2021-S17;3;3;6;4671;5290;0;9961
08;2021-S17;0;0;0;2715.22592983026;2997.75551488675;09;5712.98144471701
08;2021-S17;0;1;1;2778.51901080978;3160.9156459093;19;5939.43465671908
08;2021-S17;1;2;3;2080.8882988764;1718.16634315323;29;3799.05464202964
08;2021-S17;3;1;4;2701.8582062647;1896.52641413317;39;4598.38462039786
08;2021-S17;2;2;4;3151.45861023308;2460.52498233809;49;5611.98359257117
08;2021-S17;6;3;9;2620.29868333099;2422.23566154656;59;5042.53434487755
08;2021-S17;3;5;8;1621.44173420671;1438.58325779464;69;3060.02499200135
08;2021-S17;0;0;0;626.575909335673;526.358467843651;79;1152.93437717932
08;2021-S17;0;0;0;205.018522985054;140.993639349697;89;346.012162334751
08;2021-S17;0;0;0;50.0325684687745;20.62259870351;90;70.6551671722846
08;2021-S17;15;14;29;18551.3174743414;16782.6825256586;0;35334
11;2021-S17;1132;1185;2453;783071;811785;09;1594856
11;2021-S17;2668;2486;5309;761456;784653;19;1546109
11;2021-S17;4290;3984;8343;850145;801772;29;1651917
11;2021-S17;3942;3888;7884;914360;843488;39;1757848
11;2021-S17;3258;3192;6488;845609;826202;49;1671811
11;2021-S17;2806;2807;5657;793566;745070;59;1538636
11;2021-S17;1535;1487;3037;628649;549192;69;1177841
11;2021-S17;686;699;1390;434606;358356;79;792962
11;2021-S17;422;247;671;261425;162933;89;424358
11;2021-S17;194;87;281;89253;32619;90;121872
11;2021-S17;20940;20070;41531;6362140;5916070;0;12278210
24;2021-S17;103;127;236;139720;144686;09;284406
24;2021-S17;364;377;752;152979;161185;19;314164
24;2021-S17;456;409;871;122237;126536;29;248773
24;2021-S17;394;351;746;150359;142009;39;292368
24;2021-S17;410;364;776;161829;158758;49;320587
24;2021-S17;377;369;747;172552;168011;59;340563
24;2021-S17;254;242;499;172509;158177;69;330686
24;2021-S17;122;148;270;129428;110593;79;240021
24;2021-S17;117;63;180;87342;56882;89;144224
24;2021-S17;60;22;82;31210;12071;90;43281
24;2021-S17;2658;2472;5160;1320165;1238908;0;2559073
27;2021-S17;150;163;314;143373;149679;09;293052
27;2021-S17;416;385;802;160962;173003;19;333965
27;2021-S17;372;459;831;133746;142254;29;276000
27;2021-S17;424;366;792;160004;155407;39;315411
27;2021-S17;438;416;855;172333;169564;49;341897
27;2021-S17;407;360;767;189979;183788;59;373767
27;2021-S17;286;249;535;192591;178206;69;370797
27;2021-S17;156;163;319;146876;127546;79;274422
27;2021-S17;96;64;160;96896;61575;89;158471
27;2021-S17;82;24;106;33148;12109;90;45257
27;2021-S17;2828;2649;5482;1429908;1353131;0;2783039
28;2021-S17;258;260;540;180735;186856;09;367591
28;2021-S17;530;544;1087;200125;213621;19;413746
28;2021-S17;653;626;1286;168922;173007;29;341929
28;2021-S17;589;581;1173;196628;188487;39;385115
28;2021-S17;574;531;1112;205396;201699;49;407095
28;2021-S17;486;446;937;222002;213866;59;435868
28;2021-S17;387;345;735;224688;203758;69;428446
28;2021-S17;195;181;377;163192;135543;79;298735
28;2021-S17;138;56;194;109691;65377;89;175068
28;2021-S17;92;35;127;37222;12685;90;49907
28;2021-S17;3903;3605;7569;1708601;1594899;0;3303500
32;2021-S17;614;625;1247;358062;373689;09;731751
32;2021-S17;1246;1289;2557;387045;406742;19;793787
32;2021-S17;1444;1407;2876;342304;348587;29;690891
32;2021-S17;1307;1191;2517;382485;369972;39;752457
32;2021-S17;1294;1181;2487;382510;376716;49;759226
32;2021-S17;1090;1125;2227;386937;376527;59;763464
32;2021-S17;705;647;1353;371211;330938;69;702149
32;2021-S17;346;340;687;250542;201459;79;452001
32;2021-S17;211;145;356;163399;89786;89;253185
32;2021-S17;147;41;188;48384;15367;90;63751
32;2021-S17;8405;7993;16503;3072879;2889783;0;5962662
44;2021-S17;376;383;769;291525;306839;09;598364
44;2021-S17;789;700;1505;320255;339504;19;659759
44;2021-S17;927;941;1873;302020;314428;29;616448
44;2021-S17;865;772;1647;342222;333292;39;675514
44;2021-S17;822;706;1532;349727;344491;49;694218
44;2021-S17;721;741;1468;381371;373239;59;754610
44;2021-S17;473;468;947;367165;335850;69;703015
44;2021-S17;247;251;500;250387;215436;79;465823
44;2021-S17;194;103;299;170825;105192;89;276017
44;2021-S17;91;40;131;51248;16731;90;67979
44;2021-S17;5505;5105;10671;2826745;2685002;0;5511747
52;2021-S17;202;244;459;213594;223900;09;437494
52;2021-S17;565;558;1136;240818;255197;19;496015
52;2021-S17;556;603;1159;197010;200630;29;397640
52;2021-S17;521;469;991;231204;224885;39;456089
52;2021-S17;589;489;1081;243874;243418;49;487292
52;2021-S17;496;527;1023;244100;239116;59;483216
52;2021-S17;270;333;604;241796;221345;69;463141
52;2021-S17;148;148;297;177805;149903;79;327708
52;2021-S17;134;44;178;119561;75822;89;195383
52;2021-S17;61;25;86;42559;15260;90;57819
52;2021-S17;3542;3440;7014;1952321;1849476;0;3801797
53;2021-S17;153;161;316;173813;182358;09;356171
53;2021-S17;369;366;738;202720;214740;19;417460
53;2021-S17;399;406;810;163116;173196;29;336312
53;2021-S17;342;300;642;190526;187674;39;378200
53;2021-S17;302;291;593;212098;212015;49;424113
53;2021-S17;280;327;608;223699;219176;59;442875
53;2021-S17;156;165;321;227435;209274;69;436709
53;2021-S17;101;72;173;169992;140910;79;310902
53;2021-S17;65;55;120;118117;69883;89;188000
53;2021-S17;34;15;49;37370;12267;90;49637
53;2021-S17;2201;2160;4373;1718886;1621493;0;3340379
75;2021-S17;248;223;474;293104;305291;09;598395
75;2021-S17;556;574;1137;337141;357785;19;694926
75;2021-S17;704;678;1385;295024;300618;29;595642
75;2021-S17;607;567;1175;347871;331233;39;679104
75;2021-S17;620;558;1180;384742;372771;49;757513
75;2021-S17;523;591;1115;413361;390880;59;804241
75;2021-S17;387;363;752;425623;384060;69;809683
75;2021-S17;201;223;424;325086;276298;79;601384
75;2021-S17;179;124;303;213986;139308;89;353294
75;2021-S17;114;44;158;77600;28200;90;105800
75;2021-S17;4142;3947;8108;3113538;2886444;0;5999982
76;2021-S17;301;294;612;305956;318589;09;624545
76;2021-S17;773;778;1570;338942;356969;19;695911
76;2021-S17;895;881;1788;316210;319570;29;635780
76;2021-S17;875;791;1672;356758;337587;39;694345
76;2021-S17;865;780;1648;376541;363812;49;740353
76;2021-S17;752;739;1494;402608;383750;59;786358
76;2021-S17;512;496;1010;394889;358997;69;753886
76;2021-S17;260;250;510;308664;263806;79;572470
76;2021-S17;187;136;323;195838;129272;89;325110
76;2021-S17;105;57;162;69372;26728;90;96100
76;2021-S17;5529;5209;10801;3065778;2859080;0;5924858
84;2021-S17;594;585;1185;459549;481088;09;940637
84;2021-S17;1321;1401;2735;487711;511905;19;999616
84;2021-S17;1457;1422;2883;443824;451094;29;894918
84;2021-S17;1430;1366;2799;512522;493262;39;1005784
84;2021-S17;1358;1282;2645;520248;515106;49;1035354
84;2021-S17;1167;1230;2399;529611;514848;59;1044459
84;2021-S17;774;712;1487;486720;439940;69;926660
84;2021-S17;429;378;807;372151;315211;79;687362
84;2021-S17;281;175;456;237198;150524;89;387722
84;2021-S17;160;57;217;81185;28680;90;109865
84;2021-S17;8974;8611;17622;4130719;3901658;0;8032377
93;2021-S17;308;342;655;268834;283093;09;551927
93;2021-S17;750;812;1567;280751;296087;19;576838
93;2021-S17;994;907;1905;254404;255552;29;509956
93;2021-S17;1050;832;1890;310704;288398;39;599102
93;2021-S17;943;894;1838;325559;305827;49;631386
93;2021-S17;968;911;1881;353104;325389;59;678493
93;2021-S17;608;550;1159;336327;296459;69;632786
93;2021-S17;304;274;578;279820;229699;79;509519
93;2021-S17;197;112;309;171274;113716;89;284990
93;2021-S17;102;44;146;58896;21758;90;80654
93;2021-S17;6227;5679;11978;2639673;2415978;0;5055651
94;2021-S17;9;13;22;16311;17433;09;33744
94;2021-S17;35;38;73;16679;18132;19;34811
94;2021-S17;32;27;59;16782;16579;29;33361
94;2021-S17;29;28;57;23044;20580;39;43624
94;2021-S17;30;27;57;23065;22140;49;45205
94;2021-S17;27;22;49;24549;23421;59;47970
94;2021-S17;13;11;24;23212;21883;69;45095
94;2021-S17;6;13;19;19544;17141;79;36685
94;2021-S17;10;5;15;11227;8178;89;19405
94;2021-S17;11;2;13;3332;1447;90;4779
94;2021-S17;202;186;388;177745;166934;0;344679
